GLOVER.txt,0,3994,3994,20,N,N,-,-1,-1
GLOVER.txt,157,7196,7039,20,Y,N,-,-1,-1
GLOVER.txt,1302,11467,10165,20,Y,N,-,-1,-1
GLOVER.txt,2603,15511,12908,20,Y,N,-,-1,-1
GLOVER.txt,3995,16363,12368,20,Y,N,-,-1,-1
GLOVER.txt,7197,17590,10393,20,Y,N,-,-1,-1
GLOVER.txt,11468,18754,7286,20,Y,N,-,-1,-1
GLOVER.txt,15514,20075,4561,20,Y,N,-,-1,-1
GLOVER.txt,16364,20786,4422,20,Y,N,-,-1,-1
GLOVER.txt,17592,21810,4218,20,Y,N,-,-1,-1
GLOVER.txt,18757,22790,4033,20,Y,N,-,-1,-1
GLOVER.txt,20076,23617,3541,20,Y,N,-,-1,-1
GLOVER.txt,20789,24428,3639,20,Y,N,-,-1,-1
GLOVER.txt,21811,24644,2833,20,N,N,-,-1,-1
GLOVER.txt,22791,25726,2935,20,N,N,-,-1,-1
GLOVER.txt,23618,26678,3060,20,Y,N,-,-1,-1
GLOVER.txt,24429,27271,2842,20,Y,N,-,-1,-1
GLOVER.txt,24645,27890,3245,20,Y,N,-,-1,-1
GLOVER.txt,25731,29377,3646,20,Y,N,-,-1,-1
GLOVER.txt,26680,30590,3910,20,Y,N,-,-1,-1
GLOVER.txt,27272,31921,4649,20,Y,N,-,-1,-1
GLOVER.txt,27891,33075,5184,20,Y,N,-,-1,-1
GLOVER.txt,29378,33372,3994,20,Y,N,-,-1,-1
GLOVER.txt,30593,34270,3677,20,Y,N,-,-1,-1
GLOVER.txt,31922,35169,3247,20,Y,N,-,-1,-1
GLOVER.txt,33078,35858,2780,20,Y,N,-,-1,-1
GLOVER.txt,33373,36684,3311,20,Y,N,-,-1,-1
GLOVER.txt,34271,37902,3631,20,Y,N,-,-1,-1
GLOVER.txt,35171,38824,3653,20,Y,N,-,-1,-1
GLOVER.txt,35859,39214,3355,20,Y,N,-,-1,-1
GLOVER.txt,36685,40559,3874,20,Y,N,-,-1,-1
GLOVER.txt,37905,41633,3728,20,Y,N,-,-1,-1
GLOVER.txt,38825,42834,4009,20,Y,N,-,-1,-1
GLOVER.txt,39217,43849,4632,20,Y,N,-,-1,-1
GLOVER.txt,40560,44368,3808,20,Y,N,-,-1,-1
GLOVER.txt,41634,44893,3259,20,Y,N,-,-1,-1
GLOVER.txt,42834,45108,2274,20,N,N,-,-1,-1
GLOVER.txt,43850,45855,2005,20,N,N,-,-1,-1
GLOVER.txt,44369,45973,1604,20,N,N,-,-1,-1
GLOVER.txt,44894,46066,1172,20,N,N,-,-1,-1
GLOVER.txt,45109,46321,1212,20,N,N,-,-1,-1
GLOVER.txt,45856,46630,774,20,N,N,-,-1,-1
GLOVER.txt,45974,46931,957,20,N,N,-,-1,-1
GLOVER.txt,46067,47200,1133,20,N,N,-,-1,-1
GLOVER.txt,46322,47632,1310,20,N,N,-,-1,-1
GLOVER.txt,46632,48839,2207,20,N,N,-,-1,-1
GLOVER.txt,46932,49516,2584,20,N,N,-,-1,-1
GLOVER.txt,47201,50459,3258,20,N,N,-,-1,-1
GLOVER.txt,47633,51487,3854,20,N,N,-,-1,-1
GLOVER.txt,48840,52266,3426,20,N,N,-,-1,-1
GLOVER.txt,49517,52905,3388,20,N,N,-,-1,-1
GLOVER.txt,50462,53412,2950,20,N,N,-,-1,-1
GLOVER.txt,51490,54018,2528,20,N,N,-,-1,-1
GLOVER.txt,52269,54398,2129,20,N,N,-,-1,-1
GLOVER.txt,52906,54679,1773,20,N,N,-,-1,-1
GLOVER.txt,53413,55368,1955,20,N,N,-,-1,-1
GLOVER.txt,54019,56585,2566,20,N,N,-,-1,-1
GLOVER.txt,54399,57573,3174,20,N,N,-,-1,-1
GLOVER.txt,54680,58108,3428,20,N,N,-,-1,-1
GLOVER.txt,55370,59066,3696,20,Y,N,-,-1,-1
GLOVER.txt,56586,59931,3345,20,N,N,-,-1,-1
GLOVER.txt,57576,60683,3107,20,N,N,-,-1,-1
GLOVER.txt,58109,62385,4276,20,N,N,-,-1,-1
GLOVER.txt,59069,63424,4355,20,N,N,-,-1,-1
GLOVER.txt,59934,64142,4208,20,N,N,-,-1,-1
GLOVER.txt,60684,64894,4210,20,N,N,-,-1,-1
GLOVER.txt,62388,65652,3264,20,N,N,-,-1,-1
GLOVER.txt,63425,66399,2974,20,N,N,-,-1,-1
GLOVER.txt,64143,67838,3695,20,N,N,-,-1,-1
GLOVER.txt,64897,68793,3896,20,N,N,-,-1,-1
GLOVER.txt,65653,69760,4107,20,N,N,-,-1,-1
GLOVER.txt,66402,70950,4548,20,N,N,-,-1,-1
GLOVER.txt,67839,72139,4300,20,N,N,-,-1,-1
GLOVER.txt,68794,73239,4445,20,N,N,-,-1,-1
GLOVER.txt,69761,74651,4890,20,N,N,-,-1,-1
GLOVER.txt,70952,75406,4454,20,N,N,-,-1,-1
GLOVER.txt,72142,76383,4241,20,N,N,-,-1,-1
GLOVER.txt,73240,77412,4172,20,N,N,-,-1,-1
GLOVER.txt,74654,78666,4012,20,N,N,-,-1,-1
GLOVER.txt,75409,79974,4565,20,N,N,-,-1,-1
GLOVER.txt,76384,81497,5113,20,Y,N,-,-1,-1
GLOVER.txt,77413,82469,5056,20,Y,N,-,-1,-1
GLOVER.txt,78667,83739,5072,20,Y,N,-,-1,-1
GLOVER.txt,79975,84841,4866,20,Y,N,-,-1,-1
GLOVER.txt,81500,86480,4980,20,N,N,-,-1,-1
GLOVER.txt,82470,87212,4742,20,N,N,-,-1,-1
GLOVER.txt,83740,88226,4486,20,Y,N,-,-1,-1
GLOVER.txt,84842,88775,3933,20,Y,N,-,-1,-1
GLOVER.txt,86481,89144,2663,20,Y,N,-,-1,-1
GLOVER.txt,87213,89711,2498,20,Y,N,-,-1,-1
GLOVER.txt,88227,90339,2112,20,Y,N,-,-1,-1
GLOVER.txt,88776,91938,3162,20,N,N,-,-1,-1
GLOVER.txt,89144,93266,4122,20,Y,N,-,-1,-1
GLOVER.txt,89712,93996,4284,20,Y,N,-,-1,-1
GLOVER.txt,90340,94525,4185,20,Y,N,-,-1,-1
GLOVER.txt,91939,96128,4189,20,Y,N,-,-1,-1
GLOVER.txt,93267,96552,3285,20,Y,N,-,-1,-1
GLOVER.txt,93997,97560,3563,20,Y,N,-,-1,-1
GLOVER.txt,94526,98325,3799,20,Y,N,-,-1,-1
GLOVER.txt,96129,99363,3234,20,Y,N,-,-1,-1
GLOVER.txt,96554,100433,3879,20,Y,N,-,-1,-1
GLOVER.txt,97563,100901,3338,20,Y,N,-,-1,-1
GLOVER.txt,98326,101615,3289,20,Y,N,-,-1,-1
GLOVER.txt,99364,102035,2671,20,Y,N,-,-1,-1
GLOVER.txt,100434,102765,2331,20,N,N,-,-1,-1
GLOVER.txt,100903,103902,2999,20,N,N,-,-1,-1
GLOVER.txt,101616,104972,3356,20,N,N,-,-1,-1
GLOVER.txt,102036,105769,3733,20,N,Y,1436867017136,105674,106651
GLOVER.txt,102768,107082,4314,20,Y,Y,1436867017136,105674,106651
GLOVER.txt,103903,108118,4215,20,Y,Y,1436867017136,105674,106651
GLOVER.txt,104975,109242,4267,20,Y,Y,1436867017136,105674,106651
GLOVER.txt,105770,110055,4285,20,Y,Y,1436867017136,105674,106651
GLOVER.txt,107083,110511,3428,20,N,N,-,-1,-1
GLOVER.txt,108119,111385,3266,20,N,N,-,-1,-1
GLOVER.txt,109243,112511,3268,20,Y,N,-,-1,-1
GLOVER.txt,110056,113040,2984,20,Y,N,-,-1,-1
GLOVER.txt,110514,113817,3303,20,Y,N,-,-1,-1
GLOVER.txt,111386,114360,2974,20,Y,N,-,-1,-1
GLOVER.txt,112513,115452,2939,20,Y,N,-,-1,-1
GLOVER.txt,113041,116395,3354,20,Y,N,-,-1,-1
GLOVER.txt,113818,117354,3536,20,Y,N,-,-1,-1
GLOVER.txt,114361,117690,3329,20,Y,N,-,-1,-1
GLOVER.txt,115455,118847,3392,20,Y,N,-,-1,-1
GLOVER.txt,116396,119246,2850,20,Y,N,-,-1,-1
GLOVER.txt,117357,120141,2784,20,Y,N,-,-1,-1
GLOVER.txt,117691,121270,3579,20,Y,N,-,-1,-1
GLOVER.txt,118850,121872,3022,20,Y,Y,1437028092146,121457,123204
GLOVER.txt,119247,122519,3272,20,Y,Y,1437028092146,121457,123204
GLOVER.txt,120144,123497,3353,20,Y,Y,1437028092146,121457,123204
GLOVER.txt,121273,124702,3429,20,Y,Y,1437028092146,121457,123204
GLOVER.txt,121873,125433,3560,20,Y,Y,1437028092146,121457,123204
GLOVER.txt,122520,126316,3796,20,Y,Y,1437028092146,121457,123204
GLOVER.txt,123502,126669,3167,20,Y,N,-,-1,-1
GLOVER.txt,124703,127361,2658,20,Y,N,-,-1,-1
GLOVER.txt,125434,127977,2543,20,Y,N,-,-1,-1
GLOVER.txt,126319,129418,3099,20,Y,N,-,-1,-1
GLOVER.txt,126670,130778,4108,20,Y,N,-,-1,-1
GLOVER.txt,127364,131147,3783,20,Y,N,-,-1,-1
GLOVER.txt,127978,132228,4250,20,N,N,-,-1,-1
GLOVER.txt,129419,133436,4017,20,N,N,-,-1,-1
GLOVER.txt,130779,134743,3964,20,N,N,-,-1,-1
GLOVER.txt,131148,136023,4875,20,N,N,-,-1,-1
GLOVER.txt,132229,136706,4477,20,N,N,-,-1,-1
GLOVER.txt,133439,137883,4444,20,N,N,-,-1,-1
GLOVER.txt,134744,138576,3832,20,N,N,-,-1,-1
GLOVER.txt,136024,138858,2834,20,N,N,-,-1,-1
GLOVER.txt,136708,139529,2821,20,N,N,-,-1,-1
GLOVER.txt,137884,139737,1853,20,N,N,-,-1,-1
GLOVER.txt,138577,140141,1564,20,N,N,-,-1,-1
GLOVER.txt,138859,140752,1893,20,N,N,-,-1,-1
GLOVER.txt,139530,141669,2139,20,N,N,-,-1,-1
GLOVER.txt,139738,142926,3188,20,N,N,-,-1,-1
GLOVER.txt,140142,143963,3821,20,N,N,-,-1,-1
GLOVER.txt,140753,144921,4168,20,Y,N,-,-1,-1
GLOVER.txt,141670,145863,4193,20,Y,N,-,-1,-1
GLOVER.txt,142927,146277,3350,20,Y,N,-,-1,-1
GLOVER.txt,143964,146650,2686,20,N,N,-,-1,-1
GLOVER.txt,144922,146792,1870,20,N,N,-,-1,-1
GLOVER.txt,145864,147346,1482,20,N,N,-,-1,-1
GLOVER.txt,146278,147552,1274,20,N,N,-,-1,-1
GLOVER.txt,146651,148185,1534,20,N,N,-,-1,-1
GLOVER.txt,146793,148488,1695,20,N,N,-,-1,-1
GLOVER.txt,147347,149227,1880,20,Y,N,-,-1,-1
GLOVER.txt,147553,149633,2080,20,Y,N,-,-1,-1
GLOVER.txt,148186,150116,1930,20,Y,N,-,-1,-1
GLOVER.txt,148489,150409,1920,20,N,N,-,-1,-1
GLOVER.txt,149229,150971,1742,20,N,N,-,-1,-1
GLOVER.txt,149635,151988,2353,20,N,N,-,-1,-1
GLOVER.txt,150117,152510,2393,20,N,Y,1437470299748,152207,152889
GLOVER.txt,150410,152902,2492,20,Y,Y,1437470299748,152207,152889
GLOVER.txt,150973,153400,2427,20,Y,Y,1437470299748,152207,152889
GLOVER.txt,151991,153766,1775,20,Y,Y,1437470299748,152207,152889
GLOVER.txt,152511,154241,1730,20,Y,Y,1437470299748,152207,152889
GLOVER.txt,152903,155326,2423,20,N,N,-,-1,-1
GLOVER.txt,153401,156573,3172,20,N,N,-,-1,-1
GLOVER.txt,153767,157682,3915,20,Y,N,-,-1,-1
GLOVER.txt,154243,158980,4737,20,Y,N,-,-1,-1
GLOVER.txt,155329,159479,4150,20,Y,N,-,-1,-1
GLOVER.txt,156576,160267,3691,20,Y,N,-,-1,-1
GLOVER.txt,157683,161231,3548,20,N,N,-,-1,-1
GLOVER.txt,158981,162023,3042,20,N,N,-,-1,-1
GLOVER.txt,159480,162933,3453,20,Y,N,-,-1,-1
GLOVER.txt,160268,163926,3658,20,Y,N,-,-1,-1
GLOVER.txt,161232,165023,3791,20,Y,N,-,-1,-1
GLOVER.txt,162025,166069,4044,20,Y,N,-,-1,-1
GLOVER.txt,162938,166822,3884,20,Y,N,-,-1,-1
GLOVER.txt,163929,167609,3680,20,Y,N,-,-1,-1
GLOVER.txt,165024,168775,3751,20,Y,N,-,-1,-1
GLOVER.txt,166072,169547,3475,20,N,N,-,-1,-1
GLOVER.txt,166823,170246,3423,20,Y,N,-,-1,-1
GLOVER.txt,167610,170867,3257,20,Y,N,-,-1,-1
GLOVER.txt,168777,172250,3473,20,Y,N,-,-1,-1
GLOVER.txt,169548,173316,3768,20,Y,N,-,-1,-1
GLOVER.txt,170249,173918,3669,20,Y,N,-,-1,-1
GLOVER.txt,170872,174811,3939,20,Y,N,-,-1,-1
GLOVER.txt,172252,175590,3338,20,N,N,-,-1,-1
GLOVER.txt,173318,176589,3271,20,N,N,-,-1,-1
GLOVER.txt,173920,177860,3940,20,Y,N,-,-1,-1
GLOVER.txt,174814,178673,3859,20,N,N,-,-1,-1
GLOVER.txt,175591,179306,3715,20,N,N,-,-1,-1
GLOVER.txt,176592,179719,3127,20,N,N,-,-1,-1
GLOVER.txt,177863,179979,2116,20,N,N,-,-1,-1
GLOVER.txt,178674,180342,1668,20,N,N,-,-1,-1
GLOVER.txt,179307,181182,1875,20,N,N,-,-1,-1
GLOVER.txt,179720,182253,2533,20,N,N,-,-1,-1
GLOVER.txt,179980,182665,2685,20,N,N,-,-1,-1
GLOVER.txt,180344,183444,3100,20,N,N,-,-1,-1
GLOVER.txt,181183,184173,2990,20,N,N,-,-1,-1
GLOVER.txt,182256,184751,2495,20,N,N,-,-1,-1
GLOVER.txt,182666,185438,2772,20,N,N,-,-1,-1
GLOVER.txt,183445,186398,2953,20,N,N,-,-1,-1
GLOVER.txt,184176,187086,2910,20,N,N,-,-1,-1
GLOVER.txt,184752,187924,3172,20,N,N,-,-1,-1
GLOVER.txt,185439,188827,3388,20,N,N,-,-1,-1
GLOVER.txt,186399,189346,2947,20,N,N,-,-1,-1
GLOVER.txt,187087,189761,2674,20,Y,N,-,-1,-1
GLOVER.txt,187925,190178,2253,20,Y,N,-,-1,-1
GLOVER.txt,188828,190991,2163,20,Y,N,-,-1,-1
GLOVER.txt,189347,192225,2878,20,Y,N,-,-1,-1
GLOVER.txt,189763,192995,3232,20,Y,N,-,-1,-1
GLOVER.txt,190179,193895,3716,20,N,N,-,-1,-1
GLOVER.txt,190994,194811,3817,20,N,N,-,-1,-1
GLOVER.txt,192226,195632,3406,20,N,N,-,-1,-1
GLOVER.txt,192996,196024,3028,20,N,N,-,-1,-1
GLOVER.txt,193898,197145,3247,20,N,N,-,-1,-1
GLOVER.txt,194812,197803,2991,20,N,N,-,-1,-1
GLOVER.txt,195633,198385,2752,20,N,N,-,-1,-1
GLOVER.txt,196025,198940,2915,20,Y,N,-,-1,-1
GLOVER.txt,197146,199632,2486,20,N,N,-,-1,-1
GLOVER.txt,197805,200287,2482,20,N,N,-,-1,-1
GLOVER.txt,198388,201002,2614,20,N,N,-,-1,-1
GLOVER.txt,198943,202829,3886,20,N,N,-,-1,-1
GLOVER.txt,199633,203710,4077,20,Y,N,-,-1,-1
GLOVER.txt,200288,204950,4662,20,Y,N,-,-1,-1
GLOVER.txt,201004,206217,5213,20,Y,N,-,-1,-1
GLOVER.txt,202830,207014,4184,20,Y,N,-,-1,-1
GLOVER.txt,203711,207737,4026,20,Y,N,-,-1,-1
GLOVER.txt,204951,208887,3936,20,Y,N,-,-1,-1
GLOVER.txt,206218,209662,3444,20,Y,N,-,-1,-1
GLOVER.txt,207015,210533,3518,20,Y,N,-,-1,-1
GLOVER.txt,207740,211375,3635,20,Y,N,-,-1,-1
GLOVER.txt,208889,211858,2969,20,Y,N,-,-1,-1
GLOVER.txt,209663,212854,3191,20,Y,N,-,-1,-1
GLOVER.txt,210534,213213,2679,20,Y,N,-,-1,-1
GLOVER.txt,211378,213392,2014,20,N,N,-,-1,-1
GLOVER.txt,211861,213670,1809,20,N,N,-,-1,-1
GLOVER.txt,212857,213955,1098,20,N,N,-,-1,-1
GLOVER.txt,213214,214335,1121,20,N,N,-,-1,-1
GLOVER.txt,213393,214864,1471,20,N,N,-,-1,-1
GLOVER.txt,213671,215502,1831,20,N,N,-,-1,-1
GLOVER.txt,213956,216509,2553,20,N,N,-,-1,-1
GLOVER.txt,214336,217598,3262,20,N,N,-,-1,-1
GLOVER.txt,214865,218180,3315,20,Y,N,-,-1,-1
GLOVER.txt,215505,218822,3317,20,Y,N,-,-1,-1
GLOVER.txt,216510,219964,3454,20,Y,N,-,-1,-1
GLOVER.txt,217600,220750,3150,20,Y,N,-,-1,-1
GLOVER.txt,218181,221599,3418,20,Y,N,-,-1,-1
GLOVER.txt,218823,222953,4130,20,Y,N,-,-1,-1
GLOVER.txt,219967,223890,3923,20,Y,N,-,-1,-1
GLOVER.txt,220751,224860,4109,20,Y,N,-,-1,-1
GLOVER.txt,221600,225508,3908,20,Y,N,-,-1,-1
GLOVER.txt,222956,226202,3246,20,Y,N,-,-1,-1
GLOVER.txt,223891,227088,3197,20,Y,N,-,-1,-1
GLOVER.txt,224862,228187,3325,20,Y,N,-,-1,-1
GLOVER.txt,225509,228587,3078,20,Y,N,-,-1,-1
GLOVER.txt,226205,229024,2819,20,Y,N,-,-1,-1
GLOVER.txt,227089,229612,2523,20,Y,N,-,-1,-1
GLOVER.txt,228188,230426,2238,20,Y,N,-,-1,-1
GLOVER.txt,228588,231285,2697,20,Y,N,-,-1,-1
GLOVER.txt,229025,231650,2625,20,N,N,-,-1,-1
GLOVER.txt,229613,231972,2359,20,N,N,-,-1,-1
GLOVER.txt,230428,232600,2172,20,N,N,-,-1,-1
GLOVER.txt,231286,233799,2513,20,N,N,-,-1,-1
GLOVER.txt,231651,234569,2918,20,Y,N,-,-1,-1
GLOVER.txt,231973,235034,3061,20,N,N,-,-1,-1
GLOVER.txt,232601,235533,2932,20,N,N,-,-1,-1
GLOVER.txt,233802,236569,2767,20,N,N,-,-1,-1
GLOVER.txt,234572,237306,2734,20,N,N,-,-1,-1
GLOVER.txt,235035,237786,2751,20,N,N,-,-1,-1
GLOVER.txt,235534,238464,2930,20,N,N,-,-1,-1
GLOVER.txt,236570,240133,3563,20,N,N,-,-1,-1
GLOVER.txt,237309,241127,3818,20,Y,N,-,-1,-1
GLOVER.txt,237787,242338,4551,20,Y,N,-,-1,-1
GLOVER.txt,238465,243211,4746,20,Y,N,-,-1,-1
GLOVER.txt,240136,243299,3163,20,Y,N,-,-1,-1
GLOVER.txt,241130,243634,2504,20,N,N,-,-1,-1
GLOVER.txt,242341,244643,2302,20,Y,N,-,-1,-1
GLOVER.txt,243212,244897,1685,20,Y,N,-,-1,-1
GLOVER.txt,243300,245271,1971,20,Y,N,-,-1,-1
GLOVER.txt,243637,246164,2527,20,Y,N,-,-1,-1
GLOVER.txt,244644,247625,2981,20,Y,N,-,-1,-1
GLOVER.txt,244898,248473,3575,20,N,N,-,-1,-1
GLOVER.txt,245274,249393,4119,20,N,N,-,-1,-1
GLOVER.txt,246165,250505,4340,20,N,N,-,-1,-1
GLOVER.txt,247626,251224,3598,20,N,N,-,-1,-1
GLOVER.txt,248476,251710,3234,20,N,N,-,-1,-1
GLOVER.txt,249394,252290,2896,20,N,N,-,-1,-1
GLOVER.txt,250507,253488,2981,20,N,N,-,-1,-1
GLOVER.txt,251225,254173,2948,20,N,N,-,-1,-1
GLOVER.txt,251711,254581,2870,20,N,N,-,-1,-1
GLOVER.txt,252293,255329,3036,20,N,N,-,-1,-1
GLOVER.txt,253489,256204,2715,20,N,N,-,-1,-1
GLOVER.txt,254174,257102,2928,20,Y,N,-,-1,-1
GLOVER.txt,254582,257846,3264,20,Y,N,-,-1,-1
GLOVER.txt,255330,258594,3264,20,Y,N,-,-1,-1
GLOVER.txt,256205,259501,3296,20,Y,N,-,-1,-1
GLOVER.txt,257105,259797,2692,20,Y,N,-,-1,-1
GLOVER.txt,257849,260357,2508,20,Y,N,-,-1,-1
GLOVER.txt,258597,261105,2508,20,Y,N,-,-1,-1
GLOVER.txt,259502,261986,2484,20,N,N,-,-1,-1
GLOVER.txt,259798,262561,2763,20,N,N,-,-1,-1
GLOVER.txt,260359,263763,3404,20,Y,N,-,-1,-1
GLOVER.txt,261106,264184,3078,20,N,N,-,-1,-1
GLOVER.txt,261987,264694,2707,20,N,N,-,-1,-1
GLOVER.txt,262566,265396,2830,20,N,N,-,-1,-1
GLOVER.txt,263764,266281,2517,20,N,N,-,-1,-1
GLOVER.txt,264185,267049,2864,20,N,N,-,-1,-1
GLOVER.txt,264695,267333,2638,20,N,N,-,-1,-1
GLOVER.txt,265397,268541,3144,20,N,N,-,-1,-1
GLOVER.txt,266282,269145,2863,20,N,N,-,-1,-1
GLOVER.txt,267050,269800,2750,20,N,N,-,-1,-1
GLOVER.txt,267336,270817,3481,20,Y,N,-,-1,-1
GLOVER.txt,268542,271121,2579,20,Y,N,-,-1,-1
GLOVER.txt,269146,271515,2369,20,Y,N,-,-1,-1
GLOVER.txt,269803,272070,2267,20,Y,N,-,-1,-1
GLOVER.txt,270818,272851,2033,20,N,N,-,-1,-1
GLOVER.txt,271122,273412,2290,20,Y,N,-,-1,-1
GLOVER.txt,271516,274202,2686,20,N,N,-,-1,-1
GLOVER.txt,272071,275341,3270,20,N,N,-,-1,-1
GLOVER.txt,272854,275706,2852,20,N,N,-,-1,-1
GLOVER.txt,273413,276311,2898,20,N,N,-,-1,-1
GLOVER.txt,274203,277133,2930,20,N,N,-,-1,-1
GLOVER.txt,275342,277942,2600,20,N,N,-,-1,-1
GLOVER.txt,275708,278396,2688,20,Y,N,-,-1,-1
GLOVER.txt,276312,278905,2593,20,Y,N,-,-1,-1
GLOVER.txt,277136,279485,2349,20,Y,N,-,-1,-1
GLOVER.txt,277943,279807,1864,20,Y,N,-,-1,-1
GLOVER.txt,278397,280209,1812,20,N,N,-,-1,-1
GLOVER.txt,278908,280417,1509,20,N,N,-,-1,-1
GLOVER.txt,279486,281208,1722,20,N,N,-,-1,-1
GLOVER.txt,279808,281705,1897,20,N,N,-,-1,-1
GLOVER.txt,280210,282480,2270,20,N,N,-,-1,-1
GLOVER.txt,280418,283995,3577,20,N,N,-,-1,-1
GLOVER.txt,281209,284469,3260,20,N,N,-,-1,-1
GLOVER.txt,281707,285316,3609,20,N,N,-,-1,-1
GLOVER.txt,282481,286696,4215,20,N,N,-,-1,-1
GLOVER.txt,283998,287874,3876,20,N,N,-,-1,-1
GLOVER.txt,284470,288505,4035,20,N,N,-,-1,-1
GLOVER.txt,285317,288918,3601,20,N,N,-,-1,-1
GLOVER.txt,286701,289778,3077,20,Y,N,-,-1,-1
GLOVER.txt,287877,290554,2677,20,Y,N,-,-1,-1
GLOVER.txt,288506,291328,2822,20,Y,N,-,-1,-1
GLOVER.txt,288919,291876,2957,20,Y,N,-,-1,-1
GLOVER.txt,289779,292038,2259,20,N,N,-,-1,-1
GLOVER.txt,290559,292594,2035,20,N,N,-,-1,-1
GLOVER.txt,291331,292907,1576,20,N,N,-,-1,-1
GLOVER.txt,291877,293047,1170,20,N,N,-,-1,-1
GLOVER.txt,292040,293268,1228,20,N,N,-,-1,-1
GLOVER.txt,292595,293549,954,20,N,N,-,-1,-1
GLOVER.txt,292908,293947,1039,20,N,N,-,-1,-1
GLOVER.txt,293049,294164,1115,20,N,N,-,-1,-1
GLOVER.txt,293269,294684,1415,20,N,N,-,-1,-1
GLOVER.txt,293550,295367,1817,20,N,N,-,-1,-1
GLOVER.txt,293948,295764,1816,20,N,N,-,-1,-1
GLOVER.txt,294165,296691,2526,20,N,N,-,-1,-1
GLOVER.txt,294685,297223,2538,20,N,N,-,-1,-1
GLOVER.txt,295368,297793,2425,20,N,N,-,-1,-1
GLOVER.txt,295765,298125,2360,20,N,N,-,-1,-1
GLOVER.txt,296691,298719,2028,20,N,N,-,-1,-1
GLOVER.txt,297224,298941,1717,20,Y,N,-,-1,-1
GLOVER.txt,297796,299411,1615,20,N,N,-,-1,-1
GLOVER.txt,298126,299677,1551,20,Y,N,-,-1,-1
GLOVER.txt,298721,300167,1446,20,N,N,-,-1,-1
GLOVER.txt,298942,301051,2109,20,N,N,-,-1,-1
GLOVER.txt,299412,301460,2048,20,N,N,-,-1,-1
GLOVER.txt,299678,302025,2347,20,N,N,-,-1,-1
GLOVER.txt,300168,302277,2109,20,N,N,-,-1,-1
GLOVER.txt,301052,302783,1731,20,N,N,-,-1,-1
GLOVER.txt,301463,303310,1847,20,N,N,-,-1,-1
GLOVER.txt,302026,304051,2025,20,N,N,-,-1,-1
GLOVER.txt,302278,304644,2366,20,N,N,-,-1,-1
GLOVER.txt,302784,305337,2553,20,N,N,-,-1,-1
GLOVER.txt,303311,306019,2708,20,N,N,-,-1,-1
GLOVER.txt,304052,306957,2905,20,Y,N,-,-1,-1
GLOVER.txt,304645,307656,3011,20,Y,N,-,-1,-1
GLOVER.txt,305338,307783,2445,20,Y,N,-,-1,-1
GLOVER.txt,306020,308071,2051,20,Y,N,-,-1,-1
GLOVER.txt,306960,308339,1379,20,Y,N,-,-1,-1
GLOVER.txt,307657,308894,1237,20,N,N,-,-1,-1
GLOVER.txt,307786,309545,1759,20,N,N,-,-1,-1
GLOVER.txt,308072,310487,2415,20,N,N,-,-1,-1
GLOVER.txt,308340,310988,2648,20,N,N,-,-1,-1
GLOVER.txt,308895,312115,3220,20,Y,N,-,-1,-1
GLOVER.txt,309546,313037,3491,20,Y,N,-,-1,-1
GLOVER.txt,310488,314041,3553,20,Y,N,-,-1,-1
GLOVER.txt,310989,315009,4020,20,Y,N,-,-1,-1
GLOVER.txt,312116,315622,3506,20,Y,N,-,-1,-1
GLOVER.txt,313040,316314,3274,20,Y,N,-,-1,-1
GLOVER.txt,314044,317026,2982,20,Y,N,-,-1,-1
GLOVER.txt,315010,317397,2387,20,Y,N,-,-1,-1
GLOVER.txt,315623,318083,2460,20,Y,N,-,-1,-1
GLOVER.txt,316315,318986,2671,20,Y,N,-,-1,-1
GLOVER.txt,317027,319113,2086,20,Y,N,-,-1,-1
GLOVER.txt,317398,319329,1931,20,Y,N,-,-1,-1
GLOVER.txt,318084,320008,1924,20,Y,N,-,-1,-1
GLOVER.txt,318987,320999,2012,20,Y,N,-,-1,-1
GLOVER.txt,319114,321438,2324,20,Y,N,-,-1,-1
GLOVER.txt,319330,322198,2868,20,Y,N,-,-1,-1
GLOVER.txt,320011,322758,2747,20,Y,N,-,-1,-1
GLOVER.txt,321000,324014,3014,20,Y,N,-,-1,-1
GLOVER.txt,321439,325299,3860,20,Y,N,-,-1,-1
GLOVER.txt,322199,326037,3838,20,Y,N,-,-1,-1
GLOVER.txt,322759,326730,3971,20,Y,N,-,-1,-1
GLOVER.txt,324017,327514,3497,20,Y,N,-,-1,-1
GLOVER.txt,325300,328058,2758,20,Y,N,-,-1,-1
GLOVER.txt,326038,329345,3307,20,Y,N,-,-1,-1
GLOVER.txt,326731,330302,3571,20,Y,N,-,-1,-1
GLOVER.txt,327515,331220,3705,20,Y,N,-,-1,-1
GLOVER.txt,328059,332096,4037,20,Y,N,-,-1,-1
GLOVER.txt,329346,333250,3904,20,Y,N,-,-1,-1
GLOVER.txt,330303,334236,3933,20,Y,N,-,-1,-1
GLOVER.txt,331222,335682,4460,20,Y,N,-,-1,-1
GLOVER.txt,332097,337038,4941,20,Y,N,-,-1,-1
GLOVER.txt,333253,337636,4383,20,Y,N,-,-1,-1
GLOVER.txt,334239,338044,3805,20,N,N,-,-1,-1
GLOVER.txt,335684,338639,2955,20,N,N,-,-1,-1
GLOVER.txt,337041,339505,2464,20,Y,N,-,-1,-1
GLOVER.txt,337637,339770,2133,20,Y,N,-,-1,-1
GLOVER.txt,338045,339883,1838,20,Y,N,-,-1,-1
GLOVER.txt,338640,340502,1862,20,Y,N,-,-1,-1
GLOVER.txt,339506,341564,2058,20,Y,N,-,-1,-1
GLOVER.txt,339776,342233,2457,20,Y,N,-,-1,-1
GLOVER.txt,339885,342518,2633,20,Y,N,-,-1,-1
GLOVER.txt,340503,343486,2983,20,Y,N,-,-1,-1
GLOVER.txt,341565,344011,2446,20,Y,N,-,-1,-1
GLOVER.txt,342234,344550,2316,20,Y,N,-,-1,-1
GLOVER.txt,342519,345268,2749,20,Y,N,-,-1,-1
GLOVER.txt,343487,345949,2462,20,Y,N,-,-1,-1
GLOVER.txt,344012,346614,2602,20,Y,N,-,-1,-1
GLOVER.txt,344551,347274,2723,20,Y,N,-,-1,-1
GLOVER.txt,345269,347836,2567,20,Y,N,-,-1,-1
GLOVER.txt,345950,348693,2743,20,Y,N,-,-1,-1
GLOVER.txt,346615,349515,2900,20,Y,N,-,-1,-1
GLOVER.txt,347275,350006,2731,20,Y,N,-,-1,-1
GLOVER.txt,347837,350565,2728,20,Y,N,-,-1,-1
GLOVER.txt,348694,350994,2300,20,Y,Y,1437471397525,350644,351290
GLOVER.txt,349516,351769,2253,20,Y,Y,1437471397525,350644,351290
GLOVER.txt,350009,352240,2231,20,Y,Y,1437471397525,350644,351290
GLOVER.txt,350566,353067,2501,20,Y,Y,1437471397525,350644,351290
GLOVER.txt,350995,353700,2705,20,Y,Y,1437471397525,350644,351290
GLOVER.txt,351770,354423,2653,20,Y,Y,1437471855423,351318,351853
GLOVER.txt,352241,354984,2743,20,Y,Y,1437472380836,351899,352666
GLOVER.txt,353069,355939,2870,20,Y,N,-,-1,-1
GLOVER.txt,353701,356707,3006,20,Y,N,-,-1,-1
GLOVER.txt,354425,357278,2853,20,Y,N,-,-1,-1
GLOVER.txt,354987,357994,3007,20,Y,N,-,-1,-1
GLOVER.txt,355940,358878,2938,20,N,N,-,-1,-1
GLOVER.txt,356708,359057,2349,20,N,N,-,-1,-1
GLOVER.txt,357279,359918,2639,20,N,N,-,-1,-1
GLOVER.txt,357995,360784,2789,20,Y,N,-,-1,-1
GLOVER.txt,358881,361983,3102,20,Y,N,-,-1,-1
GLOVER.txt,359060,362820,3760,20,Y,N,-,-1,-1
GLOVER.txt,359919,363232,3313,20,Y,N,-,-1,-1
GLOVER.txt,360785,363689,2904,20,Y,N,-,-1,-1
GLOVER.txt,361985,364108,2123,20,Y,N,-,-1,-1
GLOVER.txt,362825,364506,1681,20,Y,N,-,-1,-1
GLOVER.txt,363233,365328,2095,20,Y,N,-,-1,-1
GLOVER.txt,363690,366103,2413,20,Y,N,-,-1,-1
GLOVER.txt,364109,367635,3526,20,Y,N,-,-1,-1
GLOVER.txt,364507,369058,4551,20,Y,N,-,-1,-1
GLOVER.txt,365329,369764,4435,20,Y,N,-,-1,-1
GLOVER.txt,366104,370387,4283,20,Y,N,-,-1,-1
GLOVER.txt,367638,371150,3512,20,Y,N,-,-1,-1
GLOVER.txt,369059,371943,2884,20,Y,N,-,-1,-1
GLOVER.txt,369765,372746,2981,20,N,N,-,-1,-1
GLOVER.txt,370390,372929,2539,20,Y,N,-,-1,-1
GLOVER.txt,371153,373288,2135,20,Y,N,-,-1,-1
GLOVER.txt,371946,373969,2023,20,Y,N,-,-1,-1
GLOVER.txt,372749,374867,2118,20,Y,N,-,-1,-1
GLOVER.txt,372932,375606,2674,20,Y,N,-,-1,-1
GLOVER.txt,373289,376713,3424,20,Y,N,-,-1,-1
GLOVER.txt,373970,377541,3571,20,Y,N,-,-1,-1
GLOVER.txt,374868,377882,3014,20,Y,N,-,-1,-1
GLOVER.txt,375609,378456,2847,20,Y,N,-,-1,-1
GLOVER.txt,376715,379390,2675,20,Y,N,-,-1,-1
GLOVER.txt,377542,380049,2507,20,Y,N,-,-1,-1
GLOVER.txt,377883,380915,3032,20,Y,N,-,-1,-1
GLOVER.txt,378458,381421,2963,20,Y,N,-,-1,-1
GLOVER.txt,379391,382393,3002,20,Y,N,-,-1,-1
GLOVER.txt,380050,383021,2971,20,Y,N,-,-1,-1
GLOVER.txt,380916,383555,2639,20,Y,N,-,-1,-1
GLOVER.txt,381422,384323,2901,20,Y,N,-,-1,-1
GLOVER.txt,382394,384987,2593,20,Y,N,-,-1,-1
GLOVER.txt,383022,386001,2979,20,Y,N,-,-1,-1
GLOVER.txt,383556,386489,2933,20,Y,N,-,-1,-1
GLOVER.txt,384325,387291,2966,20,Y,N,-,-1,-1
GLOVER.txt,384988,387548,2560,20,Y,N,-,-1,-1
GLOVER.txt,386002,388543,2541,20,Y,N,-,-1,-1
GLOVER.txt,386490,389025,2535,20,Y,N,-,-1,-1
GLOVER.txt,387292,389444,2152,20,Y,N,-,-1,-1
GLOVER.txt,387549,390136,2587,20,Y,N,-,-1,-1
GLOVER.txt,388544,390669,2125,20,N,N,-,-1,-1
GLOVER.txt,389026,391274,2248,20,Y,N,-,-1,-1
GLOVER.txt,389445,391997,2552,20,Y,N,-,-1,-1
GLOVER.txt,390137,392627,2490,20,Y,N,-,-1,-1
GLOVER.txt,390670,393662,2992,20,Y,N,-,-1,-1
GLOVER.txt,391275,394414,3139,20,Y,N,-,-1,-1
GLOVER.txt,391998,395334,3336,20,Y,Y,1437472966198,394609,395892
GLOVER.txt,392628,395977,3349,20,Y,Y,1437472966198,394609,395892
GLOVER.txt,393664,396787,3123,20,N,Y,1437472966198,394609,395892
GLOVER.txt,394415,397360,2945,20,N,Y,1437472966198,394609,395892
GLOVER.txt,395337,398268,2931,20,N,Y,1437472966198,394609,395892
GLOVER.txt,395980,398784,2804,20,N,N,-,-1,-1
GLOVER.txt,396788,399079,2291,20,N,N,-,-1,-1
GLOVER.txt,397361,399664,2303,20,N,N,-,-1,-1
GLOVER.txt,398270,400579,2309,20,Y,N,-,-1,-1
GLOVER.txt,398785,401662,2877,20,Y,N,-,-1,-1
GLOVER.txt,399080,402676,3596,20,Y,N,-,-1,-1
GLOVER.txt,399665,403278,3613,20,N,N,-,-1,-1
GLOVER.txt,400580,404128,3548,20,N,N,-,-1,-1
GLOVER.txt,401665,404961,3296,20,N,N,-,-1,-1
GLOVER.txt,402677,405474,2797,20,N,N,-,-1,-1
GLOVER.txt,403280,406676,3396,20,N,N,-,-1,-1
GLOVER.txt,404129,407082,2953,20,N,N,-,-1,-1
GLOVER.txt,404962,407840,2878,20,N,N,-,-1,-1
GLOVER.txt,405475,408440,2965,20,N,N,-,-1,-1
GLOVER.txt,406681,409443,2762,20,N,N,-,-1,-1
GLOVER.txt,407083,410491,3408,20,N,N,-,-1,-1
GLOVER.txt,407841,411467,3626,20,N,N,-,-1,-1
GLOVER.txt,408442,412109,3667,20,N,N,-,-1,-1
GLOVER.txt,409446,412846,3400,20,N,N,-,-1,-1
GLOVER.txt,410492,413660,3168,20,N,N,-,-1,-1
GLOVER.txt,411468,414453,2985,20,N,N,-,-1,-1
GLOVER.txt,412112,415485,3373,20,N,N,-,-1,-1
GLOVER.txt,412849,415942,3093,20,N,N,-,-1,-1
GLOVER.txt,413661,416258,2597,20,N,N,-,-1,-1
GLOVER.txt,414456,416503,2047,20,Y,N,-,-1,-1
GLOVER.txt,415487,417677,2190,20,Y,N,-,-1,-1
GLOVER.txt,415945,418549,2604,20,Y,N,-,-1,-1
GLOVER.txt,416261,420047,3786,20,Y,N,-,-1,-1
GLOVER.txt,416506,420873,4367,20,Y,N,-,-1,-1
GLOVER.txt,417678,421137,3459,20,Y,N,-,-1,-1
GLOVER.txt,418550,421259,2709,20,Y,N,-,-1,-1
GLOVER.txt,420048,421732,1684,20,N,N,-,-1,-1
GLOVER.txt,420874,422581,1707,20,N,N,-,-1,-1
GLOVER.txt,421138,423080,1942,20,N,N,-,-1,-1
GLOVER.txt,421262,424141,2879,20,N,N,-,-1,-1
GLOVER.txt,421735,424679,2944,20,N,N,-,-1,-1
GLOVER.txt,422582,425152,2570,20,N,N,-,-1,-1
GLOVER.txt,423081,425463,2382,20,Y,N,-,-1,-1
GLOVER.txt,424142,425629,1487,20,N,N,-,-1,-1
GLOVER.txt,424680,426017,1337,20,N,N,-,-1,-1
GLOVER.txt,425153,426505,1352,20,N,N,-,-1,-1
GLOVER.txt,425464,426683,1219,20,N,N,-,-1,-1
GLOVER.txt,425630,426979,1349,20,N,N,-,-1,-1
GLOVER.txt,426018,427238,1220,20,N,N,-,-1,-1
GLOVER.txt,426506,427495,989,20,N,N,-,-1,-1
GLOVER.txt,426684,427791,1107,20,N,N,-,-1,-1
GLOVER.txt,426980,428532,1552,20,N,N,-,-1,-1
GLOVER.txt,427239,429039,1800,20,N,N,-,-1,-1
GLOVER.txt,427496,429080,1584,20,N,N,-,-1,-1
GLOVER.txt,427792,429187,1395,20,N,N,-,-1,-1
GLOVER.txt,428533,429460,927,20,N,N,-,-1,-1
GLOVER.txt,429040,430567,1527,20,N,N,-,-1,-1
GLOVER.txt,429081,431413,2332,20,N,N,-,-1,-1
GLOVER.txt,429188,432112,2924,20,Y,N,-,-1,-1
GLOVER.txt,429461,432759,3298,20,Y,N,-,-1,-1
GLOVER.txt,430569,433692,3123,20,Y,N,-,-1,-1
GLOVER.txt,431416,434326,2910,20,Y,N,-,-1,-1
GLOVER.txt,432113,435037,2924,20,Y,N,-,-1,-1
GLOVER.txt,432760,435552,2792,20,Y,N,-,-1,-1
GLOVER.txt,433693,436406,2713,20,Y,N,-,-1,-1
GLOVER.txt,434328,437002,2674,20,Y,N,-,-1,-1
GLOVER.txt,435038,438348,3310,20,Y,N,-,-1,-1
GLOVER.txt,435553,439565,4012,20,Y,N,-,-1,-1
GLOVER.txt,436407,440793,4386,20,Y,N,-,-1,-1
GLOVER.txt,437003,441822,4819,20,Y,N,-,-1,-1
GLOVER.txt,438351,442569,4218,20,Y,N,-,-1,-1
GLOVER.txt,439566,443532,3966,20,Y,N,-,-1,-1
GLOVER.txt,440793,444843,4050,20,N,N,-,-1,-1
GLOVER.txt,441823,445694,3871,20,Y,N,-,-1,-1
GLOVER.txt,442572,446378,3806,20,Y,N,-,-1,-1
GLOVER.txt,443534,447292,3758,20,Y,N,-,-1,-1
GLOVER.txt,444844,447967,3123,20,Y,N,-,-1,-1
GLOVER.txt,445695,448588,2893,20,Y,N,-,-1,-1
GLOVER.txt,446379,449274,2895,20,Y,N,-,-1,-1
GLOVER.txt,447293,449997,2704,20,Y,N,-,-1,-1
GLOVER.txt,447969,450952,2983,20,Y,N,-,-1,-1
GLOVER.txt,448589,451811,3222,20,N,N,-,-1,-1
GLOVER.txt,449277,452635,3358,20,Y,N,-,-1,-1
GLOVER.txt,449998,453770,3772,20,Y,N,-,-1,-1
GLOVER.txt,450952,455236,4284,20,Y,N,-,-1,-1
GLOVER.txt,451812,455654,3842,20,Y,N,-,-1,-1
GLOVER.txt,452638,456974,4336,20,N,N,-,-1,-1
GLOVER.txt,453772,457704,3932,20,N,N,-,-1,-1
GLOVER.txt,455238,458075,2837,20,N,N,-,-1,-1
GLOVER.txt,455655,458526,2871,20,N,N,-,-1,-1
GLOVER.txt,456977,459224,2247,20,N,N,-,-1,-1
GLOVER.txt,457705,459856,2151,20,N,N,-,-1,-1
GLOVER.txt,458076,460085,2009,20,N,N,-,-1,-1
GLOVER.txt,458527,460829,2302,20,N,N,-,-1,-1
GLOVER.txt,459225,462096,2871,20,N,N,-,-1,-1
GLOVER.txt,459857,462788,2931,20,Y,N,-,-1,-1
GLOVER.txt,460087,463208,3121,20,Y,N,-,-1,-1
GLOVER.txt,460830,463779,2949,20,Y,N,-,-1,-1
GLOVER.txt,462099,465054,2955,20,Y,N,-,-1,-1
GLOVER.txt,462789,465945,3156,20,Y,N,-,-1,-1
GLOVER.txt,463209,466563,3354,20,N,N,-,-1,-1
GLOVER.txt,463782,466920,3138,20,Y,N,-,-1,-1
GLOVER.txt,465055,467539,2484,20,N,N,-,-1,-1
GLOVER.txt,465946,467906,1960,20,N,N,-,-1,-1
GLOVER.txt,466564,468519,1955,20,N,N,-,-1,-1
GLOVER.txt,466922,469241,2319,20,N,N,-,-1,-1
GLOVER.txt,467540,470148,2608,20,N,N,-,-1,-1
GLOVER.txt,467907,471442,3535,20,N,N,-,-1,-1
GLOVER.txt,468522,472660,4138,20,N,N,-,-1,-1
GLOVER.txt,469242,473014,3772,20,N,N,-,-1,-1
GLOVER.txt,470151,474020,3869,20,Y,N,-,-1,-1
GLOVER.txt,471445,474579,3134,20,Y,N,-,-1,-1
GLOVER.txt,472661,474938,2277,20,N,N,-,-1,-1
GLOVER.txt,473017,475631,2614,20,N,N,-,-1,-1
GLOVER.txt,474021,475812,1791,20,N,N,-,-1,-1
GLOVER.txt,474580,476066,1486,20,N,N,-,-1,-1
GLOVER.txt,474939,476277,1338,20,N,N,-,-1,-1
GLOVER.txt,475632,476405,773,20,N,N,-,-1,-1
GLOVER.txt,475813,476588,775,20,N,N,-,-1,-1
GLOVER.txt,476067,476845,778,20,N,N,-,-1,-1
GLOVER.txt,476280,477495,1215,20,N,N,-,-1,-1
GLOVER.txt,476406,478304,1898,20,N,N,-,-1,-1
GLOVER.txt,476591,479012,2421,20,N,N,-,-1,-1
GLOVER.txt,476846,480351,3505,20,Y,N,-,-1,-1
GLOVER.txt,477496,481382,3886,20,Y,N,-,-1,-1
GLOVER.txt,478305,482579,4274,20,N,N,-,-1,-1
GLOVER.txt,479014,483500,4486,20,N,N,-,-1,-1
GLOVER.txt,480354,484338,3984,20,N,N,-,-1,-1
GLOVER.txt,481387,484576,3189,20,N,N,-,-1,-1
GLOVER.txt,482580,484723,2143,20,N,N,-,-1,-1
GLOVER.txt,483501,485031,1530,20,N,N,-,-1,-1
GLOVER.txt,484341,485368,1027,20,N,N,-,-1,-1
GLOVER.txt,484577,485855,1278,20,Y,N,-,-1,-1
GLOVER.txt,484726,486515,1789,20,Y,N,-,-1,-1
GLOVER.txt,485034,486862,1828,20,Y,N,-,-1,-1
GLOVER.txt,485371,487190,1819,20,Y,N,-,-1,-1
GLOVER.txt,485860,487692,1832,20,Y,N,-,-1,-1
GLOVER.txt,486516,487815,1299,20,N,N,-,-1,-1
GLOVER.txt,486863,488126,1263,20,N,N,-,-1,-1
GLOVER.txt,487193,488434,1241,20,N,N,-,-1,-1
GLOVER.txt,487693,488741,1048,20,N,N,-,-1,-1
GLOVER.txt,487816,489010,1194,20,N,N,-,-1,-1
GLOVER.txt,488127,489716,1589,20,N,N,-,-1,-1
GLOVER.txt,488435,490279,1844,20,N,N,-,-1,-1
GLOVER.txt,488744,490510,1766,20,N,N,-,-1,-1
GLOVER.txt,489011,490715,1704,20,N,N,-,-1,-1
GLOVER.txt,489717,491048,1331,20,N,N,-,-1,-1
GLOVER.txt,490280,491340,1060,20,N,N,-,-1,-1
GLOVER.txt,490511,491601,1090,20,Y,N,-,-1,-1
GLOVER.txt,490716,491790,1074,20,Y,N,-,-1,-1
GLOVER.txt,491049,492283,1234,20,Y,N,-,-1,-1
GLOVER.txt,491341,492492,1151,20,Y,N,-,-1,-1
GLOVER.txt,491604,492784,1180,20,Y,N,-,-1,-1
GLOVER.txt,491791,493082,1291,20,Y,N,-,-1,-1
GLOVER.txt,492284,493347,1063,20,Y,N,-,-1,-1
GLOVER.txt,492493,493582,1089,20,Y,N,-,-1,-1
GLOVER.txt,492785,493846,1061,20,Y,N,-,-1,-1
GLOVER.txt,493083,494078,995,20,N,N,-,-1,-1
GLOVER.txt,493350,495579,2229,20,N,N,-,-1,-1
GLOVER.txt,493585,495883,2298,20,N,N,-,-1,-1
GLOVER.txt,493847,496058,2211,20,N,N,-,-1,-1
GLOVER.txt,494079,496742,2663,20,N,N,-,-1,-1
GLOVER.txt,495580,497222,1642,20,N,N,-,-1,-1
GLOVER.txt,495884,497343,1459,20,N,N,-,-1,-1
GLOVER.txt,496059,497460,1401,20,N,N,-,-1,-1
GLOVER.txt,496743,497584,841,20,N,N,-,-1,-1
GLOVER.txt,497227,497727,500,20,N,N,-,-1,-1
GLOVER.txt,497345,497805,460,20,N,N,-,-1,-1
GLOVER.txt,497462,497945,483,20,N,N,-,-1,-1
GLOVER.txt,497589,498046,457,20,N,N,-,-1,-1
GLOVER.txt,497730,498130,400,20,N,N,-,-1,-1
GLOVER.txt,497808,498196,388,20,N,N,-,-1,-1
GLOVER.txt,497948,498938,990,20,Y,N,-,-1,-1
GLOVER.txt,498049,499430,1381,20,Y,N,-,-1,-1
GLOVER.txt,498133,500682,2549,20,Y,N,-,-1,-1
GLOVER.txt,498197,501408,3211,20,Y,N,-,-1,-1
GLOVER.txt,498941,502245,3304,20,Y,N,-,-1,-1
GLOVER.txt,499431,502921,3490,20,Y,N,-,-1,-1
GLOVER.txt,500683,503495,2812,20,N,N,-,-1,-1
GLOVER.txt,501409,504379,2970,20,Y,N,-,-1,-1
GLOVER.txt,502246,504916,2670,20,Y,N,-,-1,-1
GLOVER.txt,502922,505374,2452,20,Y,N,-,-1,-1
GLOVER.txt,503496,506134,2638,20,Y,N,-,-1,-1
GLOVER.txt,504380,506980,2600,20,Y,N,-,-1,-1
GLOVER.txt,504917,507340,2423,20,Y,N,-,-1,-1
GLOVER.txt,505375,507743,2368,20,Y,N,-,-1,-1
GLOVER.txt,506135,508072,1937,20,Y,N,-,-1,-1
GLOVER.txt,506985,508343,1358,20,N,N,-,-1,-1
GLOVER.txt,507341,509001,1660,20,N,N,-,-1,-1
GLOVER.txt,507746,510300,2554,20,Y,N,-,-1,-1
GLOVER.txt,508073,510763,2690,20,Y,N,-,-1,-1
GLOVER.txt,508344,511107,2763,20,Y,N,-,-1,-1
GLOVER.txt,509002,512095,3093,20,Y,N,-,-1,-1
GLOVER.txt,510301,512476,2175,20,Y,N,-,-1,-1
GLOVER.txt,510764,515312,4548,20,Y,N,-,-1,-1
GLOVER.txt,511108,526494,15386,20,Y,N,-,-1,-1
GLOVER.txt,512096,526992,14896,20,N,N,-,-1,-1
GRONOW.txt,0,1501,1501,20,N,N,-,-1,-1
GRONOW.txt,371,2152,1781,20,N,N,-,-1,-1
GRONOW.txt,602,3182,2580,20,N,N,-,-1,-1
GRONOW.txt,1253,3568,2315,20,N,N,-,-1,-1
GRONOW.txt,1504,3749,2245,20,N,N,-,-1,-1
GRONOW.txt,2155,4266,2111,20,N,N,-,-1,-1
GRONOW.txt,3183,5540,2357,20,N,N,-,-1,-1
GRONOW.txt,3569,7547,3978,20,N,N,-,-1,-1
GRONOW.txt,3752,7993,4241,20,N,N,-,-1,-1
GRONOW.txt,4268,8496,4228,20,N,N,-,-1,-1
GRONOW.txt,5541,9014,3473,20,N,N,-,-1,-1
GRONOW.txt,7548,9512,1964,20,N,N,-,-1,-1
GRONOW.txt,7994,10632,2638,20,N,N,-,-1,-1
GRONOW.txt,8497,11248,2751,20,N,N,-,-1,-1
GRONOW.txt,9016,12335,3319,20,N,N,-,-1,-1
GRONOW.txt,9513,13224,3711,20,N,N,-,-1,-1
GRONOW.txt,10635,14151,3516,20,N,N,-,-1,-1
GRONOW.txt,11249,15065,3816,20,N,N,-,-1,-1
GRONOW.txt,12338,16326,3988,20,N,N,-,-1,-1
GRONOW.txt,13225,17279,4054,20,Y,N,-,-1,-1
GRONOW.txt,14154,18219,4065,20,Y,N,-,-1,-1
GRONOW.txt,15066,18948,3882,20,N,N,-,-1,-1
GRONOW.txt,16329,20063,3734,20,Y,N,-,-1,-1
GRONOW.txt,17282,20916,3634,20,Y,N,-,-1,-1
GRONOW.txt,18224,21877,3653,20,N,N,-,-1,-1
GRONOW.txt,18949,22355,3406,20,N,N,-,-1,-1
GRONOW.txt,20066,23233,3167,20,N,N,-,-1,-1
GRONOW.txt,20919,23963,3044,20,N,N,-,-1,-1
GRONOW.txt,21878,24848,2970,20,N,N,-,-1,-1
GRONOW.txt,22356,25759,3403,20,N,N,-,-1,-1
GRONOW.txt,23236,26525,3289,20,N,N,-,-1,-1
GRONOW.txt,23964,27032,3068,20,N,N,-,-1,-1
GRONOW.txt,24849,28008,3159,20,N,N,-,-1,-1
GRONOW.txt,25760,28760,3000,20,N,N,-,-1,-1
GRONOW.txt,26526,29961,3435,20,N,N,-,-1,-1
GRONOW.txt,27033,31128,4095,20,N,N,-,-1,-1
GRONOW.txt,28009,32298,4289,20,N,N,-,-1,-1
GRONOW.txt,28761,33255,4494,20,N,N,-,-1,-1
GRONOW.txt,29962,34021,4059,20,N,N,-,-1,-1
GRONOW.txt,31129,34911,3782,20,N,N,-,-1,-1
GRONOW.txt,32301,35747,3446,20,N,N,-,-1,-1
GRONOW.txt,33257,36888,3631,20,N,N,-,-1,-1
GRONOW.txt,34022,37743,3721,20,N,N,-,-1,-1
GRONOW.txt,34916,38636,3720,20,N,N,-,-1,-1
GRONOW.txt,35748,39703,3955,20,N,N,-,-1,-1
GRONOW.txt,36889,40144,3255,20,N,N,-,-1,-1
GRONOW.txt,37744,40821,3077,20,N,N,-,-1,-1
GRONOW.txt,38637,41742,3105,20,N,N,-,-1,-1
GRONOW.txt,39704,42368,2664,20,N,N,-,-1,-1
GRONOW.txt,40145,42706,2561,20,N,N,-,-1,-1
GRONOW.txt,40822,43463,2641,20,N,N,-,-1,-1
GRONOW.txt,41745,44506,2761,20,N,N,-,-1,-1
GRONOW.txt,42369,44988,2619,20,N,N,-,-1,-1
GRONOW.txt,42707,45481,2774,20,N,N,-,-1,-1
GRONOW.txt,43464,46001,2537,20,N,N,-,-1,-1
GRONOW.txt,44508,46772,2264,20,N,N,-,-1,-1
GRONOW.txt,44989,47271,2282,20,N,N,-,-1,-1
GRONOW.txt,45482,47755,2273,20,N,N,-,-1,-1
GRONOW.txt,46002,48548,2546,20,N,N,-,-1,-1
GRONOW.txt,46775,49255,2480,20,N,N,-,-1,-1
GRONOW.txt,47273,50045,2772,20,N,N,-,-1,-1
GRONOW.txt,47756,50717,2961,20,N,N,-,-1,-1
GRONOW.txt,48549,51487,2938,20,N,N,-,-1,-1
GRONOW.txt,49256,52214,2958,20,N,N,-,-1,-1
GRONOW.txt,50046,53007,2961,20,N,N,-,-1,-1
GRONOW.txt,50718,53784,3066,20,N,N,-,-1,-1
GRONOW.txt,51488,54619,3131,20,N,N,-,-1,-1
GRONOW.txt,52215,55378,3163,20,N,N,-,-1,-1
GRONOW.txt,53008,56200,3192,20,N,N,-,-1,-1
GRONOW.txt,53786,57038,3252,20,N,N,-,-1,-1
GRONOW.txt,54622,57889,3267,20,N,N,-,-1,-1
GRONOW.txt,55379,58834,3455,20,N,N,-,-1,-1
GRONOW.txt,56201,59313,3112,20,N,N,-,-1,-1
GRONOW.txt,57039,59828,2789,20,N,N,-,-1,-1
GRONOW.txt,57890,60825,2935,20,N,N,-,-1,-1
GRONOW.txt,58839,61519,2680,20,N,N,-,-1,-1
GRONOW.txt,59314,62465,3151,20,N,N,-,-1,-1
GRONOW.txt,59829,63250,3421,20,N,N,-,-1,-1
GRONOW.txt,60826,64091,3265,20,N,N,-,-1,-1
GRONOW.txt,61520,64872,3352,20,N,N,-,-1,-1
GRONOW.txt,62466,65720,3254,20,N,N,-,-1,-1
GRONOW.txt,63251,66085,2834,20,N,N,-,-1,-1
GRONOW.txt,64094,66591,2497,20,N,N,-,-1,-1
GRONOW.txt,64873,67264,2391,20,N,N,-,-1,-1
GRONOW.txt,65721,67789,2068,20,N,N,-,-1,-1
GRONOW.txt,66086,68243,2157,20,N,N,-,-1,-1
GRONOW.txt,66592,68660,2068,20,N,N,-,-1,-1
GRONOW.txt,67267,68845,1578,20,N,N,-,-1,-1
GRONOW.txt,67792,69645,1853,20,N,N,-,-1,-1
GRONOW.txt,68245,70401,2156,20,N,N,-,-1,-1
GRONOW.txt,68662,70900,2238,20,N,N,-,-1,-1
GRONOW.txt,68846,71990,3144,20,N,N,-,-1,-1
GRONOW.txt,69646,72252,2606,20,N,N,-,-1,-1
GRONOW.txt,70404,72976,2572,20,N,N,-,-1,-1
GRONOW.txt,70901,73781,2880,20,N,N,-,-1,-1
GRONOW.txt,71993,74804,2811,20,N,N,-,-1,-1
GRONOW.txt,72253,75210,2957,20,N,N,-,-1,-1
GRONOW.txt,72979,76009,3030,20,N,N,-,-1,-1
GRONOW.txt,73782,76913,3131,20,N,N,-,-1,-1
GRONOW.txt,74805,77678,2873,20,N,N,-,-1,-1
GRONOW.txt,75211,78668,3457,20,N,N,-,-1,-1
GRONOW.txt,76010,79663,3653,20,N,N,-,-1,-1
GRONOW.txt,76916,80928,4012,20,N,N,-,-1,-1
GRONOW.txt,77679,82045,4366,20,N,N,-,-1,-1
GRONOW.txt,78669,82562,3893,20,N,N,-,-1,-1
GRONOW.txt,79664,83432,3768,20,N,N,-,-1,-1
GRONOW.txt,80931,84277,3346,20,N,N,-,-1,-1
GRONOW.txt,82046,85113,3067,20,N,N,-,-1,-1
GRONOW.txt,82563,85838,3275,20,N,N,-,-1,-1
GRONOW.txt,83433,87099,3666,20,N,N,-,-1,-1
GRONOW.txt,84278,87927,3649,20,N,N,-,-1,-1
GRONOW.txt,85116,88559,3443,20,N,N,-,-1,-1
GRONOW.txt,85839,89261,3422,20,N,N,-,-1,-1
GRONOW.txt,87104,89770,2666,20,N,N,-,-1,-1
GRONOW.txt,87928,90400,2472,20,Y,N,-,-1,-1
GRONOW.txt,88560,91377,2817,20,N,N,-,-1,-1
GRONOW.txt,89263,93289,4026,20,N,N,-,-1,-1
GRONOW.txt,89771,94038,4267,20,N,N,-,-1,-1
GRONOW.txt,90401,94730,4329,20,N,N,-,-1,-1
GRONOW.txt,91378,95475,4097,20,N,N,-,-1,-1
GRONOW.txt,93290,96113,2823,20,N,N,-,-1,-1
GRONOW.txt,94041,96764,2723,20,N,N,-,-1,-1
GRONOW.txt,94732,97358,2626,20,N,N,-,-1,-1
GRONOW.txt,95476,98454,2978,20,N,N,-,-1,-1
GRONOW.txt,96114,99462,3348,20,N,Y,1437475017618,98942,100041
GRONOW.txt,96765,100488,3723,20,N,Y,1437475017618,98942,100041
GRONOW.txt,97359,101155,3796,20,N,Y,1437475017618,98942,100041
GRONOW.txt,98456,101980,3524,20,N,Y,1437475017618,98942,100041
GRONOW.txt,99463,102983,3520,20,N,Y,1437475017618,98942,100041
GRONOW.txt,100489,103667,3178,20,Y,N,-,-1,-1
GRONOW.txt,101156,104361,3205,20,Y,N,-,-1,-1
GRONOW.txt,101981,105371,3390,20,Y,N,-,-1,-1
GRONOW.txt,102986,106382,3396,20,Y,N,-,-1,-1
GRONOW.txt,103668,107494,3826,20,N,N,-,-1,-1
GRONOW.txt,104364,108181,3817,20,Y,N,-,-1,-1
GRONOW.txt,105373,109138,3765,20,N,N,-,-1,-1
GRONOW.txt,106383,109895,3512,20,N,N,-,-1,-1
GRONOW.txt,107499,110780,3281,20,N,N,-,-1,-1
GRONOW.txt,108183,112303,4120,20,N,N,-,-1,-1
GRONOW.txt,109139,113479,4340,20,N,N,-,-1,-1
GRONOW.txt,109896,114151,4255,20,N,N,-,-1,-1
GRONOW.txt,110781,114605,3824,20,Y,N,-,-1,-1
GRONOW.txt,112304,115340,3036,20,Y,N,-,-1,-1
GRONOW.txt,113480,116495,3015,20,Y,N,-,-1,-1
GRONOW.txt,114156,117633,3477,20,Y,N,-,-1,-1
GRONOW.txt,114606,119001,4395,20,Y,N,-,-1,-1
GRONOW.txt,115342,119823,4481,20,Y,N,-,-1,-1
GRONOW.txt,116498,120642,4144,20,Y,N,-,-1,-1
GRONOW.txt,117636,121223,3587,20,Y,N,-,-1,-1
GRONOW.txt,119002,122132,3130,20,Y,N,-,-1,-1
GRONOW.txt,119824,122738,2914,20,Y,N,-,-1,-1
GRONOW.txt,120643,123388,2745,20,Y,N,-,-1,-1
GRONOW.txt,121225,124214,2989,20,Y,N,-,-1,-1
GRONOW.txt,122133,124489,2356,20,Y,N,-,-1,-1
GRONOW.txt,122739,125056,2317,20,N,N,-,-1,-1
GRONOW.txt,123389,126251,2862,20,N,N,-,-1,-1
GRONOW.txt,124215,126994,2779,20,N,N,-,-1,-1
GRONOW.txt,124490,127983,3493,20,N,N,-,-1,-1
GRONOW.txt,125057,128942,3885,20,N,N,-,-1,-1
GRONOW.txt,126252,129912,3660,20,N,N,-,-1,-1
GRONOW.txt,126995,131089,4094,20,N,N,-,-1,-1
GRONOW.txt,127984,131967,3983,20,N,N,-,-1,-1
GRONOW.txt,128943,133066,4123,20,N,N,-,-1,-1
GRONOW.txt,129915,134113,4198,20,N,N,-,-1,-1
GRONOW.txt,131092,134992,3900,20,N,N,-,-1,-1
GRONOW.txt,131968,135722,3754,20,N,N,-,-1,-1
GRONOW.txt,133067,136639,3572,20,N,N,-,-1,-1
GRONOW.txt,134114,137186,3072,20,N,N,-,-1,-1
GRONOW.txt,134993,137743,2750,20,N,N,-,-1,-1
GRONOW.txt,135723,138367,2644,20,N,N,-,-1,-1
GRONOW.txt,136640,139206,2566,20,N,N,-,-1,-1
GRONOW.txt,137187,139777,2590,20,N,N,-,-1,-1
GRONOW.txt,137744,140114,2370,20,N,N,-,-1,-1
GRONOW.txt,138368,140822,2454,20,N,N,-,-1,-1
GRONOW.txt,139207,141874,2667,20,N,N,-,-1,-1
GRONOW.txt,139778,143180,3402,20,N,N,-,-1,-1
GRONOW.txt,140115,143636,3521,20,N,N,-,-1,-1
GRONOW.txt,140823,144337,3514,20,N,N,-,-1,-1
GRONOW.txt,141875,144849,2974,20,N,N,-,-1,-1
GRONOW.txt,143183,146099,2916,20,N,N,-,-1,-1
GRONOW.txt,143637,146628,2991,20,N,N,-,-1,-1
GRONOW.txt,144338,147915,3577,20,Y,N,-,-1,-1
GRONOW.txt,144852,148877,4025,20,Y,N,-,-1,-1
GRONOW.txt,146100,150336,4236,20,Y,N,-,-1,-1
GRONOW.txt,146629,151375,4746,20,Y,N,-,-1,-1
GRONOW.txt,147916,152095,4179,20,N,N,-,-1,-1
GRONOW.txt,148879,153309,4430,20,N,N,-,-1,-1
GRONOW.txt,150339,154642,4303,20,N,N,-,-1,-1
GRONOW.txt,151376,155067,3691,20,N,N,-,-1,-1
GRONOW.txt,152096,156161,4065,20,N,N,-,-1,-1
GRONOW.txt,153311,156900,3589,20,N,N,-,-1,-1
GRONOW.txt,154644,157885,3241,20,Y,N,-,-1,-1
GRONOW.txt,155072,158808,3736,20,Y,N,-,-1,-1
GRONOW.txt,156162,159986,3824,20,Y,N,-,-1,-1
GRONOW.txt,156901,160560,3659,20,Y,N,-,-1,-1
GRONOW.txt,157886,161471,3585,20,N,N,-,-1,-1
GRONOW.txt,158811,162552,3741,20,N,N,-,-1,-1
GRONOW.txt,159987,163144,3157,20,N,N,-,-1,-1
GRONOW.txt,160563,163966,3403,20,N,N,-,-1,-1
GRONOW.txt,161472,165071,3599,20,N,N,-,-1,-1
GRONOW.txt,162553,165944,3391,20,N,N,-,-1,-1
GRONOW.txt,163145,167050,3905,20,N,N,-,-1,-1
GRONOW.txt,163967,167703,3736,20,N,N,-,-1,-1
GRONOW.txt,165072,168601,3529,20,N,N,-,-1,-1
GRONOW.txt,165945,169531,3586,20,Y,N,-,-1,-1
GRONOW.txt,167051,170023,2972,20,Y,N,-,-1,-1
GRONOW.txt,167704,170846,3142,20,N,N,-,-1,-1
GRONOW.txt,168602,172192,3590,20,Y,N,-,-1,-1
GRONOW.txt,169532,173579,4047,20,N,N,-,-1,-1
GRONOW.txt,170024,174613,4589,20,Y,N,-,-1,-1
GRONOW.txt,170847,175572,4725,20,Y,N,-,-1,-1
GRONOW.txt,172197,176744,4547,20,N,N,-,-1,-1
GRONOW.txt,173580,177657,4077,20,N,N,-,-1,-1
GRONOW.txt,174614,178471,3857,20,N,N,-,-1,-1
GRONOW.txt,175577,178899,3322,20,N,N,-,-1,-1
GRONOW.txt,176745,179483,2738,20,N,N,-,-1,-1
GRONOW.txt,177659,180363,2704,20,N,N,-,-1,-1
GRONOW.txt,178472,181047,2575,20,N,N,-,-1,-1
GRONOW.txt,178900,181989,3089,20,N,N,-,-1,-1
GRONOW.txt,179484,182430,2946,20,Y,N,-,-1,-1
GRONOW.txt,180364,183385,3021,20,Y,N,-,-1,-1
GRONOW.txt,181048,183951,2903,20,Y,N,-,-1,-1
GRONOW.txt,181991,185349,3358,20,Y,N,-,-1,-1
GRONOW.txt,182433,186387,3954,20,Y,N,-,-1,-1
GRONOW.txt,183386,187212,3826,20,N,N,-,-1,-1
GRONOW.txt,183952,187704,3752,20,N,N,-,-1,-1
GRONOW.txt,185350,188859,3509,20,N,N,-,-1,-1
GRONOW.txt,186388,189544,3156,20,Y,N,-,-1,-1
GRONOW.txt,187213,190074,2861,20,Y,N,-,-1,-1
GRONOW.txt,187705,191012,3307,20,Y,N,-,-1,-1
GRONOW.txt,188860,192318,3458,20,Y,N,-,-1,-1
GRONOW.txt,189545,193419,3874,20,Y,N,-,-1,-1
GRONOW.txt,190075,194244,4169,20,Y,N,-,-1,-1
GRONOW.txt,191013,195788,4775,20,Y,N,-,-1,-1
GRONOW.txt,192323,196495,4172,20,Y,N,-,-1,-1
GRONOW.txt,193421,197653,4232,20,Y,N,-,-1,-1
GRONOW.txt,194245,198746,4501,20,N,N,-,-1,-1
GRONOW.txt,195793,199727,3934,20,N,N,-,-1,-1
GRONOW.txt,196498,200539,4041,20,N,N,-,-1,-1
GRONOW.txt,197654,201431,3777,20,N,N,-,-1,-1
GRONOW.txt,198749,202241,3492,20,N,N,-,-1,-1
GRONOW.txt,199730,203407,3677,20,N,N,-,-1,-1
GRONOW.txt,200542,204107,3565,20,N,N,-,-1,-1
GRONOW.txt,201432,205162,3730,20,N,N,-,-1,-1
GRONOW.txt,202242,206070,3828,20,N,N,-,-1,-1
GRONOW.txt,203408,206667,3259,20,N,N,-,-1,-1
GRONOW.txt,204108,207583,3475,20,Y,N,-,-1,-1
GRONOW.txt,205163,208646,3483,20,Y,N,-,-1,-1
GRONOW.txt,206071,209837,3766,20,Y,N,-,-1,-1
GRONOW.txt,206668,210201,3533,20,Y,N,-,-1,-1
GRONOW.txt,207584,211008,3424,20,Y,N,-,-1,-1
GRONOW.txt,208648,211348,2700,20,Y,N,-,-1,-1
GRONOW.txt,209838,212254,2416,20,Y,N,-,-1,-1
GRONOW.txt,210202,212818,2616,20,Y,N,-,-1,-1
GRONOW.txt,211009,213803,2794,20,Y,N,-,-1,-1
GRONOW.txt,211349,214233,2884,20,Y,N,-,-1,-1
GRONOW.txt,212257,215149,2892,20,Y,N,-,-1,-1
GRONOW.txt,212819,216019,3200,20,Y,N,-,-1,-1
GRONOW.txt,213804,217280,3476,20,Y,N,-,-1,-1
GRONOW.txt,214234,217759,3525,20,Y,N,-,-1,-1
GRONOW.txt,215150,218497,3347,20,N,N,-,-1,-1
GRONOW.txt,216020,219244,3224,20,N,N,-,-1,-1
GRONOW.txt,217283,220007,2724,20,Y,N,-,-1,-1
GRONOW.txt,217760,221034,3274,20,Y,N,-,-1,-1
GRONOW.txt,218500,221790,3290,20,Y,Y,1437476486340,221621,222520
GRONOW.txt,219249,222715,3466,20,Y,Y,1437476486340,221621,222520
GRONOW.txt,220008,223636,3628,20,Y,Y,1437476486340,221621,222520
GRONOW.txt,221037,224366,3329,20,Y,Y,1437476486340,221621,222520
GRONOW.txt,221791,225902,4111,20,Y,Y,1437476486340,221621,222520
GRONOW.txt,222716,226711,3995,20,N,N,-,-1,-1
GRONOW.txt,223637,227601,3964,20,N,N,-,-1,-1
GRONOW.txt,224367,228138,3771,20,N,N,-,-1,-1
GRONOW.txt,225904,228839,2935,20,N,N,-,-1,-1
GRONOW.txt,226713,229510,2797,20,N,N,-,-1,-1
GRONOW.txt,227602,230086,2484,20,N,N,-,-1,-1
GRONOW.txt,228139,230628,2489,20,N,N,-,-1,-1
GRONOW.txt,228840,231550,2710,20,N,N,-,-1,-1
GRONOW.txt,229513,232285,2772,20,N,N,-,-1,-1
GRONOW.txt,230087,233432,3345,20,N,N,-,-1,-1
GRONOW.txt,230629,234583,3954,20,N,N,-,-1,-1
GRONOW.txt,231551,235311,3760,20,N,N,-,-1,-1
GRONOW.txt,232286,236399,4113,20,N,N,-,-1,-1
GRONOW.txt,233433,237637,4204,20,N,N,-,-1,-1
GRONOW.txt,234584,238271,3687,20,N,N,-,-1,-1
GRONOW.txt,235312,239535,4223,20,N,N,-,-1,-1
GRONOW.txt,236404,240781,4377,20,N,N,-,-1,-1
GRONOW.txt,237638,241592,3954,20,N,N,-,-1,-1
GRONOW.txt,238274,243023,4749,20,N,N,-,-1,-1
GRONOW.txt,239536,243692,4156,20,N,N,-,-1,-1
GRONOW.txt,240782,244672,3890,20,Y,N,-,-1,-1
GRONOW.txt,241593,245973,4380,20,Y,N,-,-1,-1
GRONOW.txt,243026,247315,4289,20,Y,N,-,-1,-1
GRONOW.txt,243693,248306,4613,20,N,N,-,-1,-1
GRONOW.txt,244673,249176,4503,20,N,N,-,-1,-1
GRONOW.txt,245975,249744,3769,20,Y,N,-,-1,-1
GRONOW.txt,247316,250909,3593,20,Y,N,-,-1,-1
GRONOW.txt,248309,252400,4091,20,Y,N,-,-1,-1
GRONOW.txt,249177,253248,4071,20,N,N,-,-1,-1
GRONOW.txt,249745,254036,4291,20,N,N,-,-1,-1
GRONOW.txt,250910,255194,4284,20,Y,N,-,-1,-1
GRONOW.txt,252403,256283,3880,20,Y,N,-,-1,-1
GRONOW.txt,253250,257259,4009,20,Y,N,-,-1,-1
GRONOW.txt,254037,258426,4389,20,Y,N,-,-1,-1
GRONOW.txt,255195,259295,4100,20,Y,N,-,-1,-1
GRONOW.txt,256284,260766,4482,20,N,N,-,-1,-1
GRONOW.txt,257262,261514,4252,20,N,N,-,-1,-1
GRONOW.txt,258427,262447,4020,20,N,N,-,-1,-1
GRONOW.txt,259296,263390,4094,20,N,N,-,-1,-1
GRONOW.txt,260769,264740,3971,20,N,N,-,-1,-1
GRONOW.txt,261515,265498,3983,20,N,N,-,-1,-1
GRONOW.txt,262448,266372,3924,20,N,N,-,-1,-1
GRONOW.txt,263391,266945,3554,20,Y,N,-,-1,-1
GRONOW.txt,264741,267516,2775,20,Y,N,-,-1,-1
GRONOW.txt,265500,268257,2757,20,Y,N,-,-1,-1
GRONOW.txt,266375,269256,2881,20,Y,N,-,-1,-1
GRONOW.txt,266946,270420,3474,20,Y,N,-,-1,-1
GRONOW.txt,267517,271531,4014,20,Y,N,-,-1,-1
GRONOW.txt,268260,272588,4328,20,Y,N,-,-1,-1
GRONOW.txt,269257,273827,4570,20,N,N,-,-1,-1
GRONOW.txt,270423,274813,4390,20,Y,N,-,-1,-1
GRONOW.txt,271532,275906,4374,20,N,N,-,-1,-1
GRONOW.txt,272589,276732,4143,20,N,N,-,-1,-1
GRONOW.txt,273828,277616,3788,20,N,N,-,-1,-1
GRONOW.txt,274816,278900,4084,20,N,N,-,-1,-1
GRONOW.txt,275907,279705,3798,20,Y,N,-,-1,-1
GRONOW.txt,276733,281050,4317,20,Y,N,-,-1,-1
GRONOW.txt,277619,282133,4514,20,Y,N,-,-1,-1
GRONOW.txt,278901,283239,4338,20,N,N,-,-1,-1
GRONOW.txt,279706,284259,4553,20,N,N,-,-1,-1
GRONOW.txt,281055,285992,4937,20,N,N,-,-1,-1
GRONOW.txt,282134,286809,4675,20,N,N,-,-1,-1
GRONOW.txt,283240,288019,4779,20,N,N,-,-1,-1
GRONOW.txt,284261,289352,5091,20,N,N,-,-1,-1
GRONOW.txt,285993,290285,4292,20,Y,N,-,-1,-1
GRONOW.txt,286810,292019,5209,20,N,N,-,-1,-1
GRONOW.txt,288020,293120,5100,20,N,N,-,-1,-1
GRONOW.txt,289353,294853,5500,20,N,N,-,-1,-1
GRONOW.txt,290286,296224,5938,20,N,N,-,-1,-1
GRONOW.txt,292022,297135,5113,20,N,N,-,-1,-1
GRONOW.txt,293121,298210,5089,20,N,N,-,-1,-1
GRONOW.txt,294856,299074,4218,20,N,N,-,-1,-1
GRONOW.txt,296225,299987,3762,20,N,N,-,-1,-1
GRONOW.txt,297136,301194,4058,20,N,N,-,-1,-1
GRONOW.txt,298213,302034,3821,20,N,N,-,-1,-1
GRONOW.txt,299075,303172,4097,20,N,N,-,-1,-1
GRONOW.txt,299988,304135,4147,20,N,N,-,-1,-1
GRONOW.txt,301195,305197,4002,20,N,N,-,-1,-1
GRONOW.txt,302035,306968,4933,20,N,N,-,-1,-1
GRONOW.txt,303173,307875,4702,20,N,N,-,-1,-1
GRONOW.txt,304136,309195,5059,20,N,N,-,-1,-1
GRONOW.txt,305202,309690,4488,20,N,N,-,-1,-1
GRONOW.txt,306969,310222,3253,20,N,N,-,-1,-1
GRONOW.txt,307876,311433,3557,20,N,N,-,-1,-1
GRONOW.txt,309196,312772,3576,20,N,N,-,-1,-1
GRONOW.txt,309692,313606,3914,20,N,N,-,-1,-1
GRONOW.txt,310223,314756,4533,20,N,N,-,-1,-1
GRONOW.txt,311434,315955,4521,20,N,N,-,-1,-1
GRONOW.txt,312775,316815,4040,20,N,N,-,-1,-1
GRONOW.txt,313607,318114,4507,20,N,N,-,-1,-1
GRONOW.txt,314757,319133,4376,20,N,N,-,-1,-1
GRONOW.txt,315956,320207,4251,20,N,N,-,-1,-1
GRONOW.txt,316818,320875,4057,20,N,N,-,-1,-1
GRONOW.txt,318115,321903,3788,20,N,N,-,-1,-1
GRONOW.txt,319134,323001,3867,20,N,N,-,-1,-1
GRONOW.txt,320210,323956,3746,20,N,N,-,-1,-1
GRONOW.txt,320876,324580,3704,20,N,N,-,-1,-1
GRONOW.txt,321904,325210,3306,20,N,N,-,-1,-1
GRONOW.txt,323004,325917,2913,20,N,N,-,-1,-1
GRONOW.txt,323959,326821,2862,20,N,N,-,-1,-1
GRONOW.txt,324581,327666,3085,20,N,N,-,-1,-1
GRONOW.txt,325212,328263,3051,20,N,N,-,-1,-1
GRONOW.txt,325920,328895,2975,20,N,N,-,-1,-1
GRONOW.txt,326824,329531,2707,20,N,N,-,-1,-1
GRONOW.txt,327667,330225,2558,20,N,N,-,-1,-1
GRONOW.txt,328264,331093,2829,20,N,N,-,-1,-1
GRONOW.txt,328895,332169,3274,20,N,N,-,-1,-1
GRONOW.txt,329534,332948,3414,20,N,N,-,-1,-1
GRONOW.txt,330226,333733,3507,20,N,N,-,-1,-1
GRONOW.txt,331094,334646,3552,20,N,N,-,-1,-1
GRONOW.txt,332171,335944,3773,20,N,N,-,-1,-1
GRONOW.txt,332949,336448,3499,20,N,N,-,-1,-1
GRONOW.txt,333734,337683,3949,20,N,N,-,-1,-1
GRONOW.txt,334647,338471,3824,20,N,N,-,-1,-1
GRONOW.txt,335947,339732,3785,20,N,N,-,-1,-1
GRONOW.txt,336449,340513,4064,20,N,N,-,-1,-1
GRONOW.txt,337684,341600,3916,20,Y,N,-,-1,-1
GRONOW.txt,338474,343035,4561,20,N,N,-,-1,-1
GRONOW.txt,339733,343654,3921,20,Y,N,-,-1,-1
GRONOW.txt,340515,344590,4075,20,N,N,-,-1,-1
GRONOW.txt,341601,345254,3653,20,N,N,-,-1,-1
GRONOW.txt,343036,346259,3223,20,N,N,-,-1,-1
GRONOW.txt,343655,346834,3179,20,N,N,-,-1,-1
GRONOW.txt,344591,347662,3071,20,N,N,-,-1,-1
GRONOW.txt,345255,348502,3247,20,N,N,-,-1,-1
GRONOW.txt,346260,349511,3251,20,N,N,-,-1,-1
GRONOW.txt,346835,350203,3368,20,N,N,-,-1,-1
GRONOW.txt,347663,351159,3496,20,N,N,-,-1,-1
GRONOW.txt,348503,351895,3392,20,N,N,-,-1,-1
GRONOW.txt,349514,352645,3131,20,N,N,-,-1,-1
GRONOW.txt,350206,353560,3354,20,N,N,-,-1,-1
GRONOW.txt,351161,354156,2995,20,N,N,-,-1,-1
GRONOW.txt,351896,355280,3384,20,N,N,-,-1,-1
GRONOW.txt,352646,356098,3452,20,N,N,-,-1,-1
GRONOW.txt,353561,356894,3333,20,N,N,-,-1,-1
GRONOW.txt,354157,358020,3863,20,N,N,-,-1,-1
GRONOW.txt,355281,358852,3571,20,N,N,-,-1,-1
GRONOW.txt,356100,360552,4452,20,N,N,-,-1,-1
GRONOW.txt,356895,361432,4537,20,N,N,-,-1,-1
GRONOW.txt,358021,362250,4229,20,N,N,-,-1,-1
GRONOW.txt,358853,363142,4289,20,N,N,-,-1,-1
GRONOW.txt,360555,363772,3217,20,N,N,-,-1,-1
GRONOW.txt,361433,364341,2908,20,N,N,-,-1,-1
GRONOW.txt,362251,364883,2632,20,N,N,-,-1,-1
GRONOW.txt,363143,365550,2407,20,N,N,-,-1,-1
GRONOW.txt,363773,366208,2435,20,N,N,-,-1,-1
GRONOW.txt,364342,367098,2756,20,N,N,-,-1,-1
GRONOW.txt,364884,368438,3554,20,N,N,-,-1,-1
GRONOW.txt,365551,369059,3508,20,N,N,-,-1,-1
GRONOW.txt,366211,370415,4204,20,N,N,-,-1,-1
GRONOW.txt,367099,370822,3723,20,N,N,-,-1,-1
GRONOW.txt,368439,371671,3232,20,N,N,-,-1,-1
GRONOW.txt,369060,372213,3153,20,N,N,-,-1,-1
GRONOW.txt,370416,372818,2402,20,N,N,-,-1,-1
GRONOW.txt,370823,373619,2796,20,N,N,-,-1,-1
GRONOW.txt,371674,374606,2932,20,N,N,-,-1,-1
GRONOW.txt,372215,375700,3485,20,N,N,-,-1,-1
GRONOW.txt,372819,376397,3578,20,N,N,-,-1,-1
GRONOW.txt,373620,377243,3623,20,N,N,-,-1,-1
GRONOW.txt,374607,378543,3936,20,N,N,-,-1,-1
GRONOW.txt,375701,379443,3742,20,N,N,-,-1,-1
GRONOW.txt,376400,380128,3728,20,N,N,-,-1,-1
GRONOW.txt,377245,380961,3716,20,N,N,-,-1,-1
GRONOW.txt,378546,382130,3584,20,N,N,-,-1,-1
GRONOW.txt,379446,383407,3961,20,N,N,-,-1,-1
GRONOW.txt,380129,384175,4046,20,N,N,-,-1,-1
GRONOW.txt,380962,385235,4273,20,N,N,-,-1,-1
GRONOW.txt,382131,385986,3855,20,N,N,-,-1,-1
GRONOW.txt,383410,386548,3138,20,N,N,-,-1,-1
GRONOW.txt,384176,387325,3149,20,N,N,-,-1,-1
GRONOW.txt,385236,388176,2940,20,N,N,-,-1,-1
GRONOW.txt,385989,389002,3013,20,N,N,-,-1,-1
GRONOW.txt,386549,389968,3419,20,N,N,-,-1,-1
GRONOW.txt,387326,390793,3467,20,N,N,-,-1,-1
GRONOW.txt,388179,391762,3583,20,N,N,-,-1,-1
GRONOW.txt,389003,392487,3484,20,N,N,-,-1,-1
GRONOW.txt,389969,393660,3691,20,N,N,-,-1,-1
GRONOW.txt,390796,394393,3597,20,N,N,-,-1,-1
GRONOW.txt,391765,395111,3346,20,N,N,-,-1,-1
GRONOW.txt,392488,395759,3271,20,N,N,-,-1,-1
GRONOW.txt,393661,396340,2679,20,N,N,-,-1,-1
GRONOW.txt,394394,397179,2785,20,N,N,-,-1,-1
GRONOW.txt,395112,397846,2734,20,N,N,-,-1,-1
GRONOW.txt,395761,398820,3059,20,N,N,-,-1,-1
GRONOW.txt,396341,399374,3033,20,N,N,-,-1,-1
GRONOW.txt,397180,400315,3135,20,N,N,-,-1,-1
GRONOW.txt,397847,401026,3179,20,N,N,-,-1,-1
GRONOW.txt,398823,401763,2940,20,N,N,-,-1,-1
GRONOW.txt,399375,402752,3377,20,N,N,-,-1,-1
GRONOW.txt,400316,403516,3200,20,N,N,-,-1,-1
GRONOW.txt,401027,404283,3256,20,N,N,-,-1,-1
GRONOW.txt,401764,405002,3238,20,N,N,-,-1,-1
GRONOW.txt,402753,406324,3571,20,Y,N,-,-1,-1
GRONOW.txt,403519,407032,3513,20,Y,N,-,-1,-1
GRONOW.txt,404284,407894,3610,20,Y,N,-,-1,-1
GRONOW.txt,405003,408815,3812,20,Y,N,-,-1,-1
GRONOW.txt,406325,409421,3096,20,N,N,-,-1,-1
GRONOW.txt,407033,410101,3068,20,N,N,-,-1,-1
GRONOW.txt,407895,411125,3230,20,N,N,-,-1,-1
GRONOW.txt,408816,412199,3383,20,N,N,-,-1,-1
GRONOW.txt,409422,412888,3466,20,N,N,-,-1,-1
GRONOW.txt,410103,413589,3486,20,N,N,-,-1,-1
GRONOW.txt,411126,414395,3269,20,N,N,-,-1,-1
GRONOW.txt,412200,415187,2987,20,Y,N,-,-1,-1
GRONOW.txt,412889,416273,3384,20,Y,N,-,-1,-1
GRONOW.txt,413590,416790,3200,20,Y,N,-,-1,-1
GRONOW.txt,414396,418000,3604,20,Y,N,-,-1,-1
GRONOW.txt,415190,419001,3811,20,Y,N,-,-1,-1
GRONOW.txt,416278,419841,3563,20,N,N,-,-1,-1
GRONOW.txt,416791,420634,3843,20,N,N,-,-1,-1
GRONOW.txt,418003,421389,3386,20,N,N,-,-1,-1
GRONOW.txt,419004,422302,3298,20,N,N,-,-1,-1
GRONOW.txt,419842,422793,2951,20,N,N,-,-1,-1
GRONOW.txt,420635,423066,2431,20,Y,N,-,-1,-1
GRONOW.txt,421394,423542,2148,20,Y,N,-,-1,-1
GRONOW.txt,422303,424367,2064,20,Y,N,-,-1,-1
GRONOW.txt,422794,425044,2250,20,Y,Y,1437477480340,424837,425856
GRONOW.txt,423067,425887,2820,20,Y,Y,1437477480340,424837,425856
GRONOW.txt,423543,426562,3019,20,Y,Y,1437477480340,424837,425856
GRONOW.txt,424368,427165,2797,20,Y,Y,1437477480340,424837,425856
GRONOW.txt,425045,427825,2780,20,Y,Y,1437477480340,424837,425856
GRONOW.txt,425888,428511,2623,20,Y,Y,1437477878183,427206,428439
GRONOW.txt,426563,429008,2445,20,Y,Y,1437477878183,427206,428439
GRONOW.txt,427166,429570,2404,20,Y,Y,1437477878183,427206,428439
GRONOW.txt,427826,429982,2156,20,Y,Y,1437477878183,427206,428439
GRONOW.txt,428514,430456,1942,20,Y,N,-,-1,-1
GRONOW.txt,429009,431434,2425,20,Y,N,-,-1,-1
GRONOW.txt,429571,432404,2833,20,Y,N,-,-1,-1
GRONOW.txt,429983,433557,3574,20,Y,N,-,-1,-1
GRONOW.txt,430457,434104,3647,20,Y,N,-,-1,-1
GRONOW.txt,431437,434669,3232,20,N,N,-,-1,-1
GRONOW.txt,432406,435553,3147,20,N,N,-,-1,-1
GRONOW.txt,433557,436137,2580,20,N,N,-,-1,-1
GRONOW.txt,434105,436567,2462,20,N,N,-,-1,-1
GRONOW.txt,434670,437441,2771,20,N,N,-,-1,-1
GRONOW.txt,435555,437987,2432,20,N,N,-,-1,-1
GRONOW.txt,436140,438821,2681,20,N,N,-,-1,-1
GRONOW.txt,436568,439491,2923,20,N,N,-,-1,-1
GRONOW.txt,437442,439755,2313,20,Y,N,-,-1,-1
GRONOW.txt,437988,440553,2565,20,Y,N,-,-1,-1
GRONOW.txt,438822,441128,2306,20,Y,N,-,-1,-1
GRONOW.txt,439492,441934,2442,20,Y,N,-,-1,-1
GRONOW.txt,439756,443049,3293,20,N,N,-,-1,-1
GRONOW.txt,440554,443754,3200,20,N,N,-,-1,-1
GRONOW.txt,441129,444293,3164,20,N,N,-,-1,-1
GRONOW.txt,441935,445447,3512,20,N,N,-,-1,-1
GRONOW.txt,443050,446560,3510,20,N,N,-,-1,-1
GRONOW.txt,443755,447259,3504,20,N,N,-,-1,-1
GRONOW.txt,444294,448234,3940,20,N,N,-,-1,-1
GRONOW.txt,445448,448865,3417,20,N,N,-,-1,-1
GRONOW.txt,446563,449462,2899,20,N,N,-,-1,-1
GRONOW.txt,447260,450336,3076,20,N,N,-,-1,-1
GRONOW.txt,448235,451274,3039,20,N,N,-,-1,-1
GRONOW.txt,448868,451951,3083,20,N,N,-,-1,-1
GRONOW.txt,449465,452500,3035,20,N,N,-,-1,-1
GRONOW.txt,450337,453368,3031,20,N,N,-,-1,-1
GRONOW.txt,451275,453981,2706,20,N,N,-,-1,-1
GRONOW.txt,451953,455090,3137,20,N,N,-,-1,-1
GRONOW.txt,452501,456264,3763,20,N,N,-,-1,-1
GRONOW.txt,453369,457075,3706,20,N,N,-,-1,-1
GRONOW.txt,453984,458507,4523,20,Y,N,-,-1,-1
GRONOW.txt,455095,459280,4185,20,N,N,-,-1,-1
GRONOW.txt,456267,460279,4012,20,N,N,-,-1,-1
GRONOW.txt,457076,460653,3577,20,N,N,-,-1,-1
GRONOW.txt,458510,461556,3046,20,Y,Y,1437490253936,460795,462238
GRONOW.txt,459283,462304,3021,20,Y,Y,1437490253936,460795,462238
GRONOW.txt,460280,462950,2670,20,Y,Y,1437490253936,460795,462238
GRONOW.txt,460654,463645,2991,20,Y,Y,1437490253936,460795,462238
GRONOW.txt,461558,464310,2752,20,Y,Y,1437490253936,460795,462238
GRONOW.txt,462305,465085,2780,20,N,N,-,-1,-1
GRONOW.txt,462951,465560,2609,20,N,N,-,-1,-1
GRONOW.txt,463646,466415,2769,20,Y,N,-,-1,-1
GRONOW.txt,464311,467622,3311,20,Y,N,-,-1,-1
GRONOW.txt,465088,468649,3561,20,N,N,-,-1,-1
GRONOW.txt,465562,469870,4308,20,N,N,-,-1,-1
GRONOW.txt,466416,471047,4631,20,N,N,-,-1,-1
GRONOW.txt,467623,471655,4032,20,N,N,-,-1,-1
GRONOW.txt,468654,472114,3460,20,N,N,-,-1,-1
GRONOW.txt,469873,472525,2652,20,N,N,-,-1,-1
GRONOW.txt,471050,473385,2335,20,N,N,-,-1,-1
GRONOW.txt,471658,474177,2519,20,N,N,-,-1,-1
GRONOW.txt,472115,474945,2830,20,N,N,-,-1,-1
GRONOW.txt,472526,475913,3387,20,N,N,-,-1,-1
GRONOW.txt,473388,476549,3161,20,N,N,-,-1,-1
GRONOW.txt,474178,477274,3096,20,N,N,-,-1,-1
GRONOW.txt,474948,478056,3108,20,N,N,-,-1,-1
GRONOW.txt,475914,479315,3401,20,N,N,-,-1,-1
GRONOW.txt,476550,480203,3653,20,N,N,-,-1,-1
GRONOW.txt,477277,480914,3637,20,N,N,-,-1,-1
GRONOW.txt,478057,481529,3472,20,N,N,-,-1,-1
GRONOW.txt,479318,482240,2922,20,N,N,-,-1,-1
GRONOW.txt,480204,482872,2668,20,N,N,-,-1,-1
GRONOW.txt,480915,483664,2749,20,N,N,-,-1,-1
GRONOW.txt,481530,484646,3116,20,N,N,-,-1,-1
GRONOW.txt,482241,485408,3167,20,N,N,-,-1,-1
GRONOW.txt,482873,486397,3524,20,N,N,-,-1,-1
GRONOW.txt,483665,487457,3792,20,N,N,-,-1,-1
GRONOW.txt,484647,487992,3345,20,N,N,-,-1,-1
GRONOW.txt,485413,488965,3552,20,N,N,-,-1,-1
GRONOW.txt,486398,490041,3643,20,N,N,-,-1,-1
GRONOW.txt,487458,491078,3620,20,N,N,-,-1,-1
GRONOW.txt,487993,492101,4108,20,N,N,-,-1,-1
GRONOW.txt,488966,492773,3807,20,Y,N,-,-1,-1
GRONOW.txt,490042,493829,3787,20,Y,N,-,-1,-1
GRONOW.txt,491079,494478,3399,20,Y,N,-,-1,-1
GRONOW.txt,492102,495235,3133,20,N,N,-,-1,-1
GRONOW.txt,492776,495866,3090,20,N,N,-,-1,-1
GRONOW.txt,493830,496611,2781,20,N,N,-,-1,-1
GRONOW.txt,494479,497300,2821,20,N,N,-,-1,-1
GRONOW.txt,495236,498114,2878,20,N,N,-,-1,-1
GRONOW.txt,495867,498912,3045,20,N,N,-,-1,-1
GRONOW.txt,496612,499434,2822,20,N,N,-,-1,-1
GRONOW.txt,497301,500513,3212,20,N,N,-,-1,-1
GRONOW.txt,498115,501095,2980,20,N,N,-,-1,-1
GRONOW.txt,498913,502347,3434,20,N,N,-,-1,-1
GRONOW.txt,499435,503271,3836,20,N,N,-,-1,-1
GRONOW.txt,500516,504725,4209,20,N,N,-,-1,-1
GRONOW.txt,501096,505433,4337,20,N,N,-,-1,-1
GRONOW.txt,502350,506476,4126,20,N,N,-,-1,-1
GRONOW.txt,503272,507365,4093,20,N,N,-,-1,-1
GRONOW.txt,504726,508155,3429,20,N,N,-,-1,-1
GRONOW.txt,505434,509270,3836,20,N,N,-,-1,-1
GRONOW.txt,506477,510047,3570,20,N,N,-,-1,-1
GRONOW.txt,507366,510799,3433,20,N,N,-,-1,-1
GRONOW.txt,508156,511312,3156,20,N,N,-,-1,-1
GRONOW.txt,509273,512211,2938,20,N,N,-,-1,-1
GRONOW.txt,510048,513158,3110,20,N,N,-,-1,-1
GRONOW.txt,510800,514103,3303,20,N,N,-,-1,-1
GRONOW.txt,511313,514835,3522,20,N,N,-,-1,-1
GRONOW.txt,512212,515880,3668,20,N,N,-,-1,-1
GRONOW.txt,513160,516584,3424,20,N,N,-,-1,-1
GRONOW.txt,514104,517287,3183,20,N,N,-,-1,-1
GRONOW.txt,514836,518053,3217,20,N,N,-,-1,-1
GRONOW.txt,515883,518659,2776,20,N,N,-,-1,-1
GRONOW.txt,516585,519191,2606,20,N,N,-,-1,-1
GRONOW.txt,517292,519819,2527,20,N,N,-,-1,-1
GRONOW.txt,518054,520796,2742,20,N,N,-,-1,-1
GRONOW.txt,518661,521967,3306,20,N,N,-,-1,-1
GRONOW.txt,519193,522547,3354,20,N,N,-,-1,-1
GRONOW.txt,519820,523217,3397,20,N,N,-,-1,-1
GRONOW.txt,520797,524137,3340,20,N,N,-,-1,-1
GRONOW.txt,521970,524920,2950,20,N,N,-,-1,-1
GRONOW.txt,522548,525749,3201,20,N,N,-,-1,-1
GRONOW.txt,523218,526186,2968,20,N,N,-,-1,-1
GRONOW.txt,524138,526678,2540,20,N,N,-,-1,-1
GRONOW.txt,524923,527252,2329,20,N,N,-,-1,-1
GRONOW.txt,525750,528076,2326,20,N,N,-,-1,-1
GRONOW.txt,526187,529110,2923,20,N,N,-,-1,-1
GRONOW.txt,526680,529827,3147,20,N,N,-,-1,-1
GRONOW.txt,527253,530487,3234,20,N,N,-,-1,-1
GRONOW.txt,528077,531408,3331,20,N,N,-,-1,-1
GRONOW.txt,529111,532394,3283,20,N,N,-,-1,-1
GRONOW.txt,529830,533453,3623,20,N,N,-,-1,-1
GRONOW.txt,530488,534511,4023,20,N,N,-,-1,-1
GRONOW.txt,531409,535223,3814,20,N,N,-,-1,-1
GRONOW.txt,532397,536098,3701,20,N,N,-,-1,-1
GRONOW.txt,533454,536833,3379,20,N,N,-,-1,-1
GRONOW.txt,534512,537652,3140,20,N,N,-,-1,-1
GRONOW.txt,535224,538466,3242,20,N,N,-,-1,-1
GRONOW.txt,536099,538910,2811,20,N,N,-,-1,-1
GRONOW.txt,536834,539189,2355,20,N,N,-,-1,-1
GRONOW.txt,537653,539943,2290,20,N,N,-,-1,-1
GRONOW.txt,538467,540416,1949,20,N,N,-,-1,-1
GRONOW.txt,538911,541520,2609,20,N,N,-,-1,-1
GRONOW.txt,539194,542431,3237,20,N,N,-,-1,-1
GRONOW.txt,539946,543042,3096,20,Y,N,-,-1,-1
GRONOW.txt,540417,544347,3930,20,Y,N,-,-1,-1
GRONOW.txt,541521,545264,3743,20,Y,N,-,-1,-1
GRONOW.txt,542434,545796,3362,20,Y,N,-,-1,-1
GRONOW.txt,543044,546508,3464,20,N,N,-,-1,-1
GRONOW.txt,544348,547775,3427,20,N,N,-,-1,-1
GRONOW.txt,545265,548617,3352,20,N,N,-,-1,-1
GRONOW.txt,545799,549086,3287,20,N,N,-,-1,-1
GRONOW.txt,546510,549474,2964,20,N,N,-,-1,-1
GRONOW.txt,547778,550498,2720,20,N,N,-,-1,-1
GRONOW.txt,548618,551259,2641,20,N,N,-,-1,-1
GRONOW.txt,549089,552514,3425,20,N,N,-,-1,-1
GRONOW.txt,549475,553162,3687,20,N,N,-,-1,-1
GRONOW.txt,550501,554071,3570,20,Y,N,-,-1,-1
GRONOW.txt,551261,554858,3597,20,N,N,-,-1,-1
GRONOW.txt,552517,555296,2779,20,N,N,-,-1,-1
GRONOW.txt,553163,555870,2707,20,N,N,-,-1,-1
GRONOW.txt,554072,556501,2429,20,N,N,-,-1,-1
GRONOW.txt,554859,557387,2528,20,N,N,-,-1,-1
GRONOW.txt,555297,557879,2582,20,N,N,-,-1,-1
GRONOW.txt,555873,558588,2715,20,N,N,-,-1,-1
GRONOW.txt,556504,559135,2631,20,N,N,-,-1,-1
GRONOW.txt,557392,560015,2623,20,Y,N,-,-1,-1
GRONOW.txt,557880,561007,3127,20,Y,N,-,-1,-1
GRONOW.txt,558589,562172,3583,20,Y,N,-,-1,-1
GRONOW.txt,559138,562909,3771,20,Y,N,-,-1,-1
GRONOW.txt,560016,563725,3709,20,N,N,-,-1,-1
GRONOW.txt,561008,563809,2801,20,N,N,-,-1,-1
GRONOW.txt,562173,563882,1709,20,N,N,-,-1,-1
GRONOW.txt,562912,564015,1103,20,N,N,-,-1,-1
GRONOW.txt,563726,564191,465,20,N,N,-,-1,-1
GRONOW.txt,563810,564255,445,20,N,N,-,-1,-1
GRONOW.txt,563883,564367,484,20,N,N,-,-1,-1
GRONOW.txt,564018,564494,476,20,N,N,-,-1,-1
GRONOW.txt,564191,564675,484,20,N,N,-,-1,-1
GRONOW.txt,564256,564868,612,20,N,N,-,-1,-1
GRONOW.txt,564370,564985,615,20,N,N,-,-1,-1
GRONOW.txt,564496,565126,630,20,N,N,-,-1,-1
GRONOW.txt,564676,565318,642,20,N,N,-,-1,-1
GRONOW.txt,564870,565412,542,20,N,N,-,-1,-1
GRONOW.txt,564986,565499,513,20,N,N,-,-1,-1
GRONOW.txt,565131,565632,501,20,N,N,-,-1,-1
GRONOW.txt,565320,565767,447,20,N,N,-,-1,-1
MASONB.txt,0,2793,2793,20,Y,N,-,-1,-1
MASONB.txt,632,3304,2672,20,N,N,-,-1,-1
MASONB.txt,1442,3605,2163,20,N,N,-,-1,-1
MASONB.txt,2139,4647,2508,20,Y,N,-,-1,-1
MASONB.txt,2794,5538,2744,20,Y,N,-,-1,-1
MASONB.txt,3309,6008,2699,20,Y,N,-,-1,-1
MASONB.txt,3608,6669,3061,20,Y,N,-,-1,-1
MASONB.txt,4650,7190,2540,20,Y,N,-,-1,-1
MASONB.txt,5539,7807,2268,20,Y,N,-,-1,-1
MASONB.txt,6011,8188,2177,20,Y,N,-,-1,-1
MASONB.txt,6672,8333,1661,20,Y,N,-,-1,-1
MASONB.txt,7193,8811,1618,20,Y,N,-,-1,-1
MASONB.txt,7810,9388,1578,20,Y,N,-,-1,-1
MASONB.txt,8191,9768,1577,20,Y,N,-,-1,-1
MASONB.txt,8334,10495,2161,20,Y,N,-,-1,-1
MASONB.txt,8814,11414,2600,20,Y,N,-,-1,-1
MASONB.txt,9389,11846,2457,20,Y,N,-,-1,-1
MASONB.txt,9769,12732,2963,20,Y,N,-,-1,-1
MASONB.txt,10496,13385,2889,20,N,N,-,-1,-1
MASONB.txt,11417,13905,2488,20,N,N,-,-1,-1
MASONB.txt,11847,14396,2549,20,Y,Y,1448037533268,13930,15031
MASONB.txt,12737,14709,1972,20,Y,Y,1448037533268,13930,15031
MASONB.txt,13387,15219,1832,20,Y,Y,1448038101349,15101,17486
MASONB.txt,13908,15982,2074,20,Y,Y,1448038101349,15101,17486
MASONB.txt,14397,16370,1973,20,Y,Y,1448038101349,15101,17486
MASONB.txt,14710,16658,1948,20,Y,Y,1448038101349,15101,17486
MASONB.txt,15220,17571,2351,20,Y,Y,1448038101349,15101,17486
MASONB.txt,15983,18423,2440,20,Y,Y,1448038101349,15101,17486
MASONB.txt,16371,19011,2640,20,Y,Y,1448038803075,18895,19670
MASONB.txt,16659,19830,3171,20,Y,Y,1448038803075,18895,19670
MASONB.txt,17574,20637,3063,20,Y,Y,1448038803075,18895,19670
MASONB.txt,18426,21032,2606,20,Y,Y,1448038803075,18895,19670
MASONB.txt,19013,21783,2770,20,Y,Y,1448038803075,18895,19670
MASONB.txt,19831,22155,2324,20,Y,Y,1448039370049,20775,21297
MASONB.txt,20640,22685,2045,20,Y,Y,1448039370049,20775,21297
MASONB.txt,21033,23426,2393,20,Y,Y,1448039370049,20775,21297
MASONB.txt,21786,24060,2274,20,Y,Y,1448274783410,21836,25159
MASONB.txt,22156,24436,2280,20,Y,Y,1448274783410,21836,25159
MASONB.txt,22686,24903,2217,20,Y,Y,1448274783410,21836,25159
MASONB.txt,23427,25472,2045,20,Y,Y,1448274893770,25386,26202
MASONB.txt,24061,26181,2120,20,Y,Y,1448274893770,25386,26202
MASONB.txt,24437,26847,2410,20,Y,Y,1448274893770,25386,26202
MASONB.txt,24904,27169,2265,20,Y,Y,1448275407308,26987,29181
MASONB.txt,25473,27767,2294,20,Y,Y,1448275407308,26987,29181
MASONB.txt,26182,28914,2732,20,Y,Y,1448275407308,26987,29181
MASONB.txt,26852,29373,2521,20,Y,Y,1448275407308,26987,29181
MASONB.txt,27170,29840,2670,20,Y,Y,1448275407308,26987,29181
MASONB.txt,27768,30281,2513,20,Y,Y,1448275407308,26987,29181
MASONB.txt,28916,32207,3291,20,Y,Y,1448275407308,26987,29181
MASONB.txt,29374,33150,3776,20,Y,Y,1448276340407,30017,39003
MASONB.txt,29843,34224,4381,20,Y,Y,1448276340407,30017,39003
MASONB.txt,30282,35168,4886,20,Y,Y,1448276340407,30017,39003
MASONB.txt,32208,36088,3880,20,Y,Y,1448276340407,30017,39003
MASONB.txt,33153,36612,3459,20,Y,Y,1448276340407,30017,39003
MASONB.txt,34227,36899,2672,20,Y,Y,1448276340407,30017,39003
MASONB.txt,35169,37398,2229,20,Y,Y,1448276340407,30017,39003
MASONB.txt,36089,37904,1815,20,Y,Y,1448276340407,30017,39003
MASONB.txt,36613,38335,1722,20,Y,Y,1448276340407,30017,39003
MASONB.txt,36902,38917,2015,20,Y,Y,1448276340407,30017,39003
MASONB.txt,37401,39938,2537,20,Y,Y,1448276340407,30017,39003
MASONB.txt,37905,40685,2780,20,Y,Y,1448276340407,30017,39003
MASONB.txt,38336,41037,2701,20,Y,Y,1448277167610,40886,47737
MASONB.txt,38918,41536,2618,20,Y,Y,1448277167610,40886,47737
MASONB.txt,39939,42127,2188,20,Y,Y,1448277167610,40886,47737
MASONB.txt,40686,43195,2509,20,Y,Y,1448277167610,40886,47737
MASONB.txt,41038,44017,2979,20,Y,Y,1448277167610,40886,47737
MASONB.txt,41537,44886,3349,20,Y,Y,1448277167610,40886,47737
MASONB.txt,42128,46087,3959,20,Y,Y,1448277167610,40886,47737
MASONB.txt,43198,47028,3830,20,Y,Y,1448277167610,40886,47737
MASONB.txt,44020,47710,3690,20,Y,Y,1448277167610,40886,47737
MASONB.txt,44887,48041,3154,20,Y,Y,1448277167610,40886,47737
MASONB.txt,46088,48717,2629,20,Y,Y,1448277167610,40886,47737
MASONB.txt,47029,49763,2734,20,Y,Y,1448277167610,40886,47737
MASONB.txt,47711,51111,3400,20,Y,Y,1448277167610,40886,47737
MASONB.txt,48046,52494,4448,20,Y,N,-,-1,-1
MASONB.txt,48718,52986,4268,20,Y,Y,1448277582432,52552,54595
MASONB.txt,49766,53850,4084,20,Y,Y,1448277582432,52552,54595
MASONB.txt,51112,54946,3834,20,Y,Y,1448277582432,52552,54595
MASONB.txt,52497,55413,2916,20,Y,Y,1448277582432,52552,54595
MASONB.txt,52988,56405,3417,20,Y,Y,1448277582432,52552,54595
MASONB.txt,53851,57207,3356,20,Y,Y,1448277582432,52552,54595
MASONB.txt,54947,57881,2934,20,Y,Y,1448278147591,54631,55869
MASONB.txt,55414,58640,3226,20,Y,Y,1448278147591,54631,55869
MASONB.txt,56407,59452,3045,20,Y,Y,1448278279697,58861,59444
MASONB.txt,57210,60262,3052,20,Y,Y,1448278279697,58861,59444
MASONB.txt,57882,61023,3141,20,Y,Y,1448278279697,58861,59444
MASONB.txt,58645,61899,3254,20,Y,Y,1448278279697,58861,59444
MASONB.txt,59455,62587,3132,20,Y,N,-,-1,-1
MASONB.txt,60263,63146,2883,20,Y,N,-,-1,-1
MASONB.txt,61024,63827,2803,20,Y,N,-,-1,-1
MASONB.txt,61900,64727,2827,20,Y,N,-,-1,-1
MASONB.txt,62588,65922,3334,20,Y,Y,1448278425221,65586,65914
MASONB.txt,63148,66462,3314,20,Y,Y,1448278425221,65586,65914
MASONB.txt,63828,67075,3247,20,Y,Y,1448278425221,65586,65914
MASONB.txt,64730,67689,2959,20,Y,Y,1448278425221,65586,65914
MASONB.txt,65922,68328,2406,20,Y,Y,1448279089520,67624,69991
MASONB.txt,66463,68689,2226,20,Y,Y,1448279089520,67624,69991
MASONB.txt,67076,69172,2096,20,Y,Y,1448279089520,67624,69991
MASONB.txt,67690,69754,2064,20,Y,Y,1448279089520,67624,69991
MASONB.txt,68331,70260,1929,20,Y,Y,1448279620157,70041,71486
MASONB.txt,68690,71045,2355,20,Y,Y,1448279620157,70041,71486
MASONB.txt,69174,71513,2339,20,Y,Y,1448279620157,70041,71486
MASONB.txt,69755,71895,2140,20,Y,Y,1448279620157,70041,71486
MASONB.txt,70262,72288,2026,20,Y,Y,1448279620157,70041,71486
MASONB.txt,71046,73140,2094,20,Y,Y,1448279620157,70041,71486
MASONB.txt,71516,73970,2454,20,Y,Y,1448279941918,72406,72905
MASONB.txt,71896,75219,3323,20,Y,Y,1448279941918,72406,72905
MASONB.txt,72289,76373,4084,20,Y,Y,1448279941918,72406,72905
MASONB.txt,73141,77514,4373,20,Y,N,-,-1,-1
MASONB.txt,73973,78545,4572,20,Y,N,-,-1,-1
MASONB.txt,75220,79176,3956,20,Y,N,-,-1,-1
MASONB.txt,76373,80274,3901,20,Y,N,-,-1,-1
MASONB.txt,77515,81327,3812,20,Y,N,-,-1,-1
MASONB.txt,78546,82503,3957,20,Y,N,-,-1,-1
MASONB.txt,79177,83234,4057,20,Y,N,-,-1,-1
MASONB.txt,80275,83633,3358,20,Y,N,-,-1,-1
MASONB.txt,81328,83940,2612,20,Y,N,-,-1,-1
MASONB.txt,82504,84831,2327,20,Y,Y,1448280297446,84055,84972
MASONB.txt,83236,85312,2076,20,Y,Y,1448280297446,84055,84972
MASONB.txt,83634,85854,2220,20,Y,Y,1448280423373,85694,86154
MASONB.txt,83943,86398,2455,20,Y,Y,1448280423373,85694,86154
MASONB.txt,84832,86972,2140,20,Y,Y,1448280423373,85694,86154
MASONB.txt,85313,87443,2130,20,Y,Y,1448280423373,85694,86154
MASONB.txt,85855,88133,2278,20,Y,Y,1448280423373,85694,86154
MASONB.txt,86399,88832,2433,20,Y,Y,1448280884746,88496,89294
MASONB.txt,86973,89527,2554,20,Y,Y,1448281320115,89144,91129
MASONB.txt,87444,89855,2411,20,Y,Y,1448281320115,89144,91129
MASONB.txt,88134,89949,1815,20,Y,Y,1448281320115,89144,91129
MASONB.txt,88833,90052,1219,20,Y,Y,1448281320115,89144,91129
MASONB.txt,89529,90468,939,20,Y,Y,1448281320115,89144,91129
MASONB.txt,89856,90911,1055,20,Y,Y,1448281320115,89144,91129
MASONB.txt,89950,91420,1470,20,Y,Y,1448281320115,89144,91129
MASONB.txt,90053,92554,2501,20,Y,Y,1448281320115,89144,91129
MASONB.txt,90469,93170,2701,20,Y,Y,1448281320115,89144,91129
MASONB.txt,90913,94343,3430,20,Y,Y,1448281320115,89144,91129
MASONB.txt,91421,94986,3565,20,Y,N,-,-1,-1
MASONB.txt,92555,95974,3419,20,Y,N,-,-1,-1
MASONB.txt,93171,97180,4009,20,Y,N,-,-1,-1
MASONB.txt,94344,97749,3405,20,Y,N,-,-1,-1
MASONB.txt,94987,98313,3326,20,Y,Y,1448281491382,97818,98860
MASONB.txt,95975,98914,2939,20,Y,Y,1448281888079,98877,102290
MASONB.txt,97181,99774,2593,20,Y,Y,1448281888079,98877,102290
MASONB.txt,97752,100525,2773,20,Y,Y,1448281888079,98877,102290
MASONB.txt,98314,101545,3231,20,Y,Y,1448281888079,98877,102290
MASONB.txt,98915,102096,3181,20,Y,Y,1448281888079,98877,102290
MASONB.txt,99775,102521,2746,20,Y,Y,1448281888079,98877,102290
MASONB.txt,100527,102930,2403,20,Y,Y,1448281888079,98877,102290
MASONB.txt,101548,103519,1971,20,Y,Y,1448281888079,98877,102290
MASONB.txt,102097,104355,2258,20,Y,Y,1448281888079,98877,102290
MASONB.txt,102524,105342,2818,20,Y,Y,1448285563397,102964,108476
MASONB.txt,102931,106112,3181,20,Y,Y,1448285563397,102964,108476
MASONB.txt,103520,106867,3347,20,Y,Y,1448285563397,102964,108476
MASONB.txt,104356,107642,3286,20,Y,Y,1448285563397,102964,108476
MASONB.txt,105343,108276,2933,20,Y,Y,1448285563397,102964,108476
MASONB.txt,106115,108659,2544,20,Y,Y,1448285563397,102964,108476
MASONB.txt,106868,109245,2377,20,Y,Y,1448285913012,108803,110925
MASONB.txt,107643,109698,2055,20,Y,Y,1448285913012,108803,110925
MASONB.txt,108277,110273,1996,20,Y,Y,1448285913012,108803,110925
MASONB.txt,108664,111186,2522,20,Y,Y,1448285913012,108803,110925
MASONB.txt,109246,111389,2143,20,Y,Y,1448285913012,108803,110925
MASONB.txt,109699,111575,1876,20,Y,Y,1448285913012,108803,110925
MASONB.txt,110274,112133,1859,20,Y,Y,1448285913012,108803,110925
MASONB.txt,111187,112848,1661,20,Y,Y,1448286451685,111065,112127
MASONB.txt,111390,113573,2183,20,Y,Y,1448286451685,111065,112127
MASONB.txt,111578,114009,2431,20,Y,Y,1448286451685,111065,112127
MASONB.txt,112136,114947,2811,20,Y,Y,1448287306770,114686,120152
MASONB.txt,112849,115525,2676,20,Y,Y,1448287306770,114686,120152
MASONB.txt,113576,116010,2434,20,Y,Y,1448287306770,114686,120152
MASONB.txt,114010,116800,2790,20,Y,Y,1448287306770,114686,120152
MASONB.txt,114949,117413,2464,20,Y,Y,1448287306770,114686,120152
MASONB.txt,115526,118130,2604,20,Y,Y,1448287306770,114686,120152
MASONB.txt,116011,118602,2591,20,Y,Y,1448287306770,114686,120152
MASONB.txt,116801,119461,2660,20,Y,Y,1448287306770,114686,120152
MASONB.txt,117414,120672,3258,20,Y,Y,1448287306770,114686,120152
MASONB.txt,118131,121195,3064,20,Y,Y,1448287306770,114686,120152
MASONB.txt,118603,121960,3357,20,Y,Y,1448287306770,114686,120152
MASONB.txt,119462,122808,3346,20,Y,Y,1448287306770,114686,120152
MASONB.txt,120675,123440,2765,20,Y,Y,1448287490368,120754,123385
MASONB.txt,121196,123896,2700,20,Y,Y,1448287490368,120754,123385
MASONB.txt,121961,124832,2871,20,Y,Y,1448287490368,120754,123385
MASONB.txt,122809,125598,2789,20,Y,Y,1448287490368,120754,123385
MASONB.txt,123445,126475,3030,20,Y,N,-,-1,-1
MASONB.txt,123897,127468,3571,20,Y,N,-,-1,-1
MASONB.txt,124835,128137,3302,20,Y,N,-,-1,-1
MASONB.txt,125599,128712,3113,20,Y,N,-,-1,-1
MASONB.txt,126476,129345,2869,20,Y,N,-,-1,-1
MASONB.txt,127469,130001,2532,20,Y,N,-,-1,-1
MASONB.txt,128138,130662,2524,20,Y,N,-,-1,-1
MASONB.txt,128713,131446,2733,20,Y,N,-,-1,-1
MASONB.txt,129347,132141,2794,20,Y,N,-,-1,-1
MASONB.txt,130002,132654,2652,20,Y,N,-,-1,-1
MASONB.txt,130663,133414,2751,20,Y,N,-,-1,-1
MASONB.txt,131447,134311,2864,20,Y,N,-,-1,-1
MASONB.txt,132142,135083,2941,20,Y,N,-,-1,-1
MASONB.txt,132655,136110,3455,20,Y,N,-,-1,-1
MASONB.txt,133415,136801,3386,20,Y,N,-,-1,-1
MASONB.txt,134314,137512,3198,20,Y,Y,1448310549245,137491,141408
MASONB.txt,135086,138224,3138,20,Y,Y,1448310549245,137491,141408
MASONB.txt,136113,139103,2990,20,Y,Y,1448310549245,137491,141408
MASONB.txt,136806,140012,3206,20,Y,Y,1448310549245,137491,141408
MASONB.txt,137513,140623,3110,20,Y,Y,1448310549245,137491,141408
MASONB.txt,138225,141044,2819,20,Y,Y,1448310549245,137491,141408
MASONB.txt,139106,141478,2372,20,Y,Y,1448310549245,137491,141408
MASONB.txt,140013,141971,1958,20,Y,Y,1448310549245,137491,141408
MASONB.txt,140624,143007,2383,20,Y,Y,1448310549245,137491,141408
MASONB.txt,141047,143726,2679,20,Y,Y,1448310549245,137491,141408
MASONB.txt,141479,143852,2373,20,Y,Y,1448311366799,143137,146264
MASONB.txt,141972,143966,1994,20,Y,Y,1448311366799,143137,146264
MASONB.txt,143008,144119,1111,20,Y,Y,1448311366799,143137,146264
MASONB.txt,143729,144332,603,20,Y,Y,1448311366799,143137,146264
MASONB.txt,143853,144945,1092,20,Y,Y,1448311366799,143137,146264
MASONB.txt,143969,145564,1595,20,Y,Y,1448311366799,143137,146264
MASONB.txt,144120,146249,2129,20,Y,Y,1448311366799,143137,146264
MASONB.txt,144333,146797,2464,20,Y,Y,1448311366799,143137,146264
MASONB.txt,144946,147398,2452,20,Y,Y,1448311366799,143137,146264
MASONB.txt,145565,147805,2240,20,Y,Y,1448311366799,143137,146264
MASONB.txt,146250,148932,2682,20,Y,Y,1448311366799,143137,146264
MASONB.txt,146798,149840,3042,20,Y,N,-,-1,-1
MASONB.txt,147403,150565,3162,20,Y,N,-,-1,-1
MASONB.txt,147807,151423,3616,20,Y,N,-,-1,-1
MASONB.txt,148934,152673,3739,20,Y,N,-,-1,-1
MASONB.txt,149841,153311,3470,20,Y,N,-,-1,-1
MASONB.txt,150567,154343,3776,20,Y,N,-,-1,-1
MASONB.txt,151425,155255,3830,20,Y,N,-,-1,-1
MASONB.txt,152674,156325,3651,20,Y,Y,1448311594480,155711,156312
MASONB.txt,153314,156681,3367,20,Y,Y,1448311594480,155711,156312
MASONB.txt,154344,157355,3011,20,Y,Y,1448311594480,155711,156312
MASONB.txt,155256,157787,2531,20,Y,Y,1448311811907,157566,161100
MASONB.txt,156330,158687,2357,20,Y,Y,1448311811907,157566,161100
MASONB.txt,156682,159660,2978,20,Y,Y,1448311811907,157566,161100
MASONB.txt,157356,160409,3053,20,Y,Y,1448311811907,157566,161100
MASONB.txt,157788,161185,3397,20,Y,Y,1448311811907,157566,161100
MASONB.txt,158690,161724,3034,20,Y,Y,1448311811907,157566,161100
MASONB.txt,159661,162151,2490,20,Y,Y,1448311811907,157566,161100
MASONB.txt,160410,162394,1984,20,N,Y,1448311811907,157566,161100
MASONB.txt,161188,162903,1715,20,Y,N,-,-1,-1
MASONB.txt,161727,163382,1655,20,Y,N,-,-1,-1
MASONB.txt,162151,164414,2263,20,Y,N,-,-1,-1
MASONB.txt,162394,164964,2570,20,Y,N,-,-1,-1
MASONB.txt,162904,165243,2339,20,Y,N,-,-1,-1
MASONB.txt,163384,165760,2376,20,Y,N,-,-1,-1
MASONB.txt,164417,166168,1751,20,Y,N,-,-1,-1
MASONB.txt,164967,167185,2218,20,Y,N,-,-1,-1
MASONB.txt,165246,167756,2510,20,Y,N,-,-1,-1
MASONB.txt,165762,168737,2975,20,Y,N,-,-1,-1
MASONB.txt,166171,169466,3295,20,Y,N,-,-1,-1
MASONB.txt,167186,169942,2756,20,Y,N,-,-1,-1
MASONB.txt,167757,170616,2859,20,Y,N,-,-1,-1
MASONB.txt,168738,171699,2961,20,Y,N,-,-1,-1
MASONB.txt,169467,172352,2885,20,Y,N,-,-1,-1
MASONB.txt,169945,173036,3091,20,Y,Y,1448312128598,172353,173027
MASONB.txt,170617,173963,3346,20,Y,Y,1448312844411,173573,174472
MASONB.txt,171702,174565,2863,20,Y,Y,1448312844411,173573,174472
MASONB.txt,172353,175224,2871,20,Y,Y,1448312844411,173573,174472
MASONB.txt,173037,175724,2687,20,Y,Y,1448312844411,173573,174472
MASONB.txt,173964,176871,2907,20,Y,Y,1448312844411,173573,174472
MASONB.txt,174566,177707,3141,20,Y,Y,1448313482895,176553,176862
MASONB.txt,175225,178514,3289,20,Y,Y,1448313482895,176553,176862
MASONB.txt,175725,179024,3299,20,Y,Y,1448313482895,176553,176862
MASONB.txt,176872,179483,2611,20,Y,Y,1448313800274,179025,179317
MASONB.txt,177710,179955,2245,20,Y,Y,1448313800274,179025,179317
MASONB.txt,178515,180634,2119,20,Y,Y,1448313800274,179025,179317
MASONB.txt,179027,181770,2743,20,Y,Y,1448315012079,181380,182053
MASONB.txt,179485,182363,2878,20,Y,Y,1448315012079,181380,182053
MASONB.txt,179956,183224,3268,20,Y,Y,1448315012079,181380,182053
MASONB.txt,180635,183803,3168,20,Y,Y,1448315012079,181380,182053
MASONB.txt,181771,184476,2705,20,Y,Y,1448315012079,181380,182053
MASONB.txt,182366,185158,2792,20,Y,Y,1448316079788,183824,184995
MASONB.txt,183227,185268,2041,20,Y,Y,1448316079788,183824,184995
MASONB.txt,183804,185747,1943,20,Y,Y,1448316079788,183824,184995
MASONB.txt,184477,186825,2348,20,Y,Y,1448316079788,183824,184995
MASONB.txt,185163,187586,2423,20,Y,N,-,-1,-1
MASONB.txt,185271,188378,3107,20,Y,N,-,-1,-1
MASONB.txt,185748,189729,3981,20,Y,N,-,-1,-1
MASONB.txt,186826,190248,3422,20,Y,N,-,-1,-1
MASONB.txt,187588,191319,3731,20,Y,N,-,-1,-1
MASONB.txt,188379,191637,3258,20,Y,N,-,-1,-1
MASONB.txt,189730,192163,2433,20,Y,N,-,-1,-1
MASONB.txt,190249,192362,2113,20,Y,N,-,-1,-1
MASONB.txt,191320,192528,1208,20,Y,N,-,-1,-1
MASONB.txt,191638,192639,1001,20,Y,N,-,-1,-1
MASONB.txt,192164,192808,644,20,Y,N,-,-1,-1
MASONB.txt,192363,192930,567,20,Y,N,-,-1,-1
MASONB.txt,192529,193064,535,20,Y,N,-,-1,-1
MASONB.txt,192642,193256,614,20,Y,N,-,-1,-1
MASONB.txt,192811,193537,726,20,Y,N,-,-1,-1
MASONB.txt,192931,193762,831,20,Y,N,-,-1,-1
MASONB.txt,193065,194009,944,20,Y,N,-,-1,-1
MASONB.txt,193257,194116,859,20,Y,N,-,-1,-1
MASONB.txt,193540,194201,661,20,Y,N,-,-1,-1
MASONB.txt,193763,194520,757,20,Y,N,-,-1,-1
MASONB.txt,194012,194847,835,20,Y,N,-,-1,-1
MASONB.txt,194119,195198,1079,20,N,N,-,-1,-1
MASONB.txt,194202,195319,1117,20,Y,N,-,-1,-1
MASONB.txt,194521,195512,991,20,Y,N,-,-1,-1
MASONB.txt,194848,195610,762,20,N,N,-,-1,-1
MASONB.txt,195198,195818,620,20,N,N,-,-1,-1
MASONB.txt,195320,195995,675,20,N,N,-,-1,-1
MASONB.txt,195515,196161,646,20,N,N,-,-1,-1
MASONB.txt,195613,197258,1645,20,Y,N,-,-1,-1
MASONB.txt,195819,198814,2995,20,Y,N,-,-1,-1
MASONB.txt,195998,200262,4264,20,Y,N,-,-1,-1
MASONB.txt,196162,201638,5476,20,Y,N,-,-1,-1
MASONB.txt,197259,202452,5193,20,Y,N,-,-1,-1
MASONB.txt,198815,203876,5061,20,Y,N,-,-1,-1
MASONB.txt,200263,204735,4472,20,Y,N,-,-1,-1
MASONB.txt,201639,205768,4129,20,Y,N,-,-1,-1
MASONB.txt,202455,206392,3937,20,Y,N,-,-1,-1
MASONB.txt,203877,206672,2795,20,Y,Y,1448316411409,206556,208475
MASONB.txt,204736,207359,2623,20,Y,Y,1448316411409,206556,208475
MASONB.txt,205769,208121,2352,20,Y,Y,1448316411409,206556,208475
MASONB.txt,206395,209079,2684,20,Y,Y,1448316411409,206556,208475
MASONB.txt,206673,210236,3563,20,Y,Y,1448316586529,210063,210674
MASONB.txt,207360,210791,3431,20,Y,Y,1448316586529,210063,210674
MASONB.txt,208122,211651,3529,20,Y,Y,1448316586529,210063,210674
MASONB.txt,209080,212206,3126,20,Y,Y,1448316586529,210063,210674
MASONB.txt,210239,212973,2734,20,Y,Y,1448316586529,210063,210674
MASONB.txt,210792,213770,2978,20,Y,Y,1448321627053,211159,212725
MASONB.txt,211652,214072,2420,20,Y,Y,1448321627053,211159,212725
MASONB.txt,212207,214313,2106,20,Y,Y,1448321627053,211159,212725
MASONB.txt,212976,215098,2122,20,Y,Y,1448322095209,213778,214023
MASONB.txt,213773,215904,2131,20,N,Y,1448322095209,213778,214023
MASONB.txt,214075,216932,2857,20,N,N,-,-1,-1
MASONB.txt,214314,219078,4764,20,N,N,-,-1,-1
MASONB.txt,215099,219937,4838,20,N,Y,1448322273366,219239,219544
MASONB.txt,215905,220419,4514,20,Y,Y,1448322514970,220165,221397
MASONB.txt,216933,221328,4395,20,Y,Y,1448322514970,220165,221397
MASONB.txt,219079,221621,2542,20,Y,Y,1448322514970,220165,221397
MASONB.txt,219938,222179,2241,20,Y,Y,1448322514970,220165,221397
MASONB.txt,220420,223042,2622,20,Y,Y,1448322514970,220165,221397
MASONB.txt,221329,224031,2702,20,Y,Y,1448322514970,220165,221397
MASONB.txt,221624,224702,3078,20,Y,Y,1448322713112,221941,223038
MASONB.txt,222180,225421,3241,20,Y,Y,1448322713112,221941,223038
MASONB.txt,223044,226394,3350,20,Y,N,-,-1,-1
MASONB.txt,224032,226765,2733,20,Y,N,-,-1,-1
MASONB.txt,224704,227393,2689,20,Y,Y,1448322979449,227304,227638
MASONB.txt,225424,227964,2540,20,Y,Y,1448323072174,227638,227786
MASONB.txt,226395,228499,2104,20,Y,Y,1448323072174,227638,227786
MASONB.txt,226768,229108,2340,20,Y,Y,1448323072174,227638,227786
MASONB.txt,227394,229592,2198,20,Y,Y,1448323072174,227638,227786
MASONB.txt,227965,230271,2306,20,Y,Y,1448323254416,230223,230526
MASONB.txt,228501,231022,2521,20,Y,Y,1448325046337,230539,231128
MASONB.txt,229109,231475,2366,20,Y,Y,1448325046337,230539,231128
MASONB.txt,229593,232203,2610,20,Y,Y,1448325046337,230539,231128
MASONB.txt,230272,233030,2758,20,Y,Y,1448325046337,230539,231128
MASONB.txt,231023,234051,3028,20,Y,Y,1448325046337,230539,231128
MASONB.txt,231476,234675,3199,20,Y,Y,1448357582358,234204,234401
MASONB.txt,232204,235099,2895,20,Y,Y,1448357582358,234204,234401
MASONB.txt,233033,236200,3167,20,Y,Y,1448357582358,234204,234401
MASONB.txt,234052,237025,2973,20,Y,Y,1448357582358,234204,234401
MASONB.txt,234676,237467,2791,20,Y,Y,1448358276684,234999,235995
MASONB.txt,235100,238047,2947,20,Y,Y,1448358276684,234999,235995
MASONB.txt,236201,238849,2648,20,Y,Y,1448358538400,238461,240031
MASONB.txt,237026,239531,2505,20,Y,Y,1448358538400,238461,240031
MASONB.txt,237470,240151,2681,20,Y,Y,1448358538400,238461,240031
MASONB.txt,238048,240881,2833,20,Y,Y,1448358538400,238461,240031
MASONB.txt,238850,241400,2550,20,Y,Y,1448358538400,238461,240031
MASONB.txt,239532,241713,2181,20,Y,Y,1448358538400,238461,240031
MASONB.txt,240152,242214,2062,20,Y,Y,1448358806100,240524,240915
MASONB.txt,240882,242972,2090,20,Y,Y,1448358806100,240524,240915
MASONB.txt,241401,243908,2507,20,Y,N,-,-1,-1
MASONB.txt,241716,244664,2948,20,Y,N,-,-1,-1
MASONB.txt,242215,245546,3331,20,Y,N,-,-1,-1
MASONB.txt,242973,245921,2948,20,Y,N,-,-1,-1
MASONB.txt,243911,246626,2715,20,Y,N,-,-1,-1
MASONB.txt,244667,247023,2356,20,Y,N,-,-1,-1
MASONB.txt,245548,247612,2064,20,Y,Y,1448359079273,247104,249268
MASONB.txt,245922,248302,2380,20,Y,Y,1448359079273,247104,249268
MASONB.txt,246627,249193,2566,20,Y,Y,1448359079273,247104,249268
MASONB.txt,247024,249785,2761,20,Y,Y,1448359079273,247104,249268
MASONB.txt,247613,250616,3003,20,Y,Y,1448359079273,247104,249268
MASONB.txt,248304,251284,2980,20,Y,Y,1448359079273,247104,249268
MASONB.txt,249194,251706,2512,20,Y,Y,1448359079273,247104,249268
MASONB.txt,249788,252024,2236,20,Y,N,-,-1,-1
MASONB.txt,250619,252720,2101,20,Y,N,-,-1,-1
MASONB.txt,251285,253129,1844,20,Y,N,-,-1,-1
MASONB.txt,251707,253490,1783,20,Y,N,-,-1,-1
MASONB.txt,252025,254046,2021,20,Y,N,-,-1,-1
MASONB.txt,252721,254811,2090,20,N,N,-,-1,-1
MASONB.txt,253130,255363,2233,20,Y,N,-,-1,-1
MASONB.txt,253491,255956,2465,20,Y,N,-,-1,-1
MASONB.txt,254049,256762,2713,20,Y,N,-,-1,-1
MASONB.txt,254816,257584,2768,20,Y,N,-,-1,-1
MASONB.txt,255364,258005,2641,20,Y,N,-,-1,-1
MASONB.txt,255957,259228,3271,20,Y,N,-,-1,-1
MASONB.txt,256763,259938,3175,20,Y,N,-,-1,-1
MASONB.txt,257586,260601,3015,20,Y,N,-,-1,-1
MASONB.txt,258006,260949,2943,20,Y,N,-,-1,-1
MASONB.txt,259229,261442,2213,20,Y,N,-,-1,-1
MASONB.txt,259939,261836,1897,20,Y,N,-,-1,-1
MASONB.txt,260603,262390,1787,20,Y,N,-,-1,-1
MASONB.txt,260950,263081,2131,20,Y,Y,1448359440819,262798,263079
MASONB.txt,261443,263496,2053,20,Y,Y,1448359440819,262798,263079
MASONB.txt,261839,263955,2116,20,Y,Y,1448359440819,262798,263079
MASONB.txt,262391,264662,2271,20,Y,Y,1448359440819,262798,263079
MASONB.txt,263084,265206,2122,20,Y,N,-,-1,-1
MASONB.txt,263497,265782,2285,20,Y,Y,1448359608080,265546,265784
MASONB.txt,263957,266403,2446,20,Y,Y,1448359878707,265791,267089
MASONB.txt,264663,267348,2685,20,Y,Y,1448359878707,265791,267089
MASONB.txt,265209,267834,2625,20,Y,Y,1448359878707,265791,267089
MASONB.txt,265783,268821,3038,20,Y,Y,1448359878707,265791,267089
MASONB.txt,266404,269806,3402,20,Y,Y,1448359878707,265791,267089
MASONB.txt,267349,270645,3296,20,Y,Y,1448360140810,268069,269800
MASONB.txt,267836,271577,3741,20,Y,Y,1448360140810,268069,269800
MASONB.txt,268822,272078,3256,20,Y,Y,1448366107348,271942,274308
MASONB.txt,269807,272794,2987,20,Y,Y,1448366107348,271942,274308
MASONB.txt,270646,273208,2562,20,Y,Y,1448366107348,271942,274308
MASONB.txt,271578,273748,2170,20,Y,Y,1448366107348,271942,274308
MASONB.txt,272079,274654,2575,20,Y,Y,1448366107348,271942,274308
MASONB.txt,272796,275527,2731,20,Y,Y,1448366107348,271942,274308
MASONB.txt,273209,276579,3370,20,Y,Y,1448366492754,275659,275884
MASONB.txt,273749,277455,3706,20,Y,Y,1448366492754,275659,275884
MASONB.txt,274655,278011,3356,20,Y,Y,1448366492754,275659,275884
MASONB.txt,275528,278593,3065,20,Y,Y,1448366492754,275659,275884
MASONB.txt,276580,279184,2604,20,Y,Y,1448367094347,278355,278591
MASONB.txt,277458,279877,2419,20,Y,Y,1448367094347,278355,278591
MASONB.txt,278016,280497,2481,20,Y,Y,1448367094347,278355,278591
MASONB.txt,278594,281817,3223,20,Y,Y,1448369133400,279084,280004
MASONB.txt,279185,283078,3893,20,Y,Y,1448369133400,279084,280004
MASONB.txt,279878,283917,4039,20,Y,Y,1448369133400,279084,280004
MASONB.txt,280500,284461,3961,20,Y,Y,1448393386565,284140,284575
MASONB.txt,281819,284884,3065,20,Y,Y,1448393386565,284140,284575
MASONB.txt,283081,285742,2661,20,Y,Y,1448393386565,284140,284575
MASONB.txt,283918,286115,2197,20,Y,Y,1448393386565,284140,284575
MASONB.txt,284464,286793,2329,20,Y,Y,1448393386565,284140,284575
MASONB.txt,284885,287420,2535,20,Y,N,-,-1,-1
MASONB.txt,285743,287737,1994,20,Y,N,-,-1,-1
MASONB.txt,286116,288272,2156,20,Y,Y,1448393552252,287738,288962
MASONB.txt,286794,289018,2224,20,Y,Y,1448393552252,287738,288962
MASONB.txt,287422,289667,2245,20,Y,Y,1448393918391,289044,290517
MASONB.txt,287740,290352,2612,20,Y,Y,1448393918391,289044,290517
MASONB.txt,288273,290723,2450,20,Y,Y,1448393918391,289044,290517
MASONB.txt,289021,291096,2075,20,Y,Y,1448393918391,289044,290517
MASONB.txt,289668,291260,1592,20,Y,Y,1448393918391,289044,290517
MASONB.txt,290353,291420,1067,20,Y,Y,1448393918391,289044,290517
MASONB.txt,290726,291812,1086,20,Y,Y,1448394436678,290724,292129
MASONB.txt,291097,292539,1442,20,Y,Y,1448394636895,292272,293963
MASONB.txt,291263,292791,1528,20,Y,Y,1448394636895,292272,293963
MASONB.txt,291425,292965,1540,20,Y,Y,1448394636895,292272,293963
MASONB.txt,291813,293275,1462,20,Y,Y,1448394636895,292272,293963
MASONB.txt,292540,293972,1432,20,Y,Y,1448394636895,292272,293963
MASONB.txt,292793,294390,1597,20,Y,Y,1448394636895,292272,293963
MASONB.txt,292966,295049,2083,20,Y,Y,1448394636895,292272,293963
MASONB.txt,293276,295834,2558,20,Y,Y,1448396118064,295199,297352
MASONB.txt,293975,296762,2787,20,Y,Y,1448396118064,295199,297352
MASONB.txt,294391,297690,3299,20,Y,Y,1448396118064,295199,297352
MASONB.txt,295052,298503,3451,20,Y,Y,1448396118064,295199,297352
MASONB.txt,295835,298975,3140,20,Y,Y,1448396118064,295199,297352
MASONB.txt,296765,299600,2835,20,Y,Y,1448396118064,295199,297352
MASONB.txt,297693,300145,2452,20,Y,Y,1448396244435,298633,299110
MASONB.txt,298504,300400,1896,20,Y,Y,1448396244435,298633,299110
MASONB.txt,298978,300584,1606,20,Y,Y,1448396244435,298633,299110
MASONB.txt,299603,301211,1608,20,Y,Y,1448396441082,299649,301294
MASONB.txt,300148,301745,1597,20,Y,Y,1448396441082,299649,301294
MASONB.txt,300402,302598,2196,20,Y,Y,1448396441082,299649,301294
MASONB.txt,300585,302841,2256,20,Y,Y,1448396441082,299649,301294
MASONB.txt,301212,303331,2119,20,Y,Y,1448396441082,299649,301294
MASONB.txt,301746,303923,2177,20,Y,Y,1448396898923,302722,302823
MASONB.txt,302599,304043,1444,20,N,Y,1448396898923,302722,302823
MASONB.txt,302844,304520,1676,20,N,N,-,-1,-1
MASONB.txt,303332,305381,2049,20,N,N,-,-1,-1
MASONB.txt,303924,306136,2212,20,Y,Y,1448397101672,305423,307582
MASONB.txt,304046,306788,2742,20,Y,Y,1448397101672,305423,307582
MASONB.txt,304521,307621,3100,20,Y,Y,1448397101672,305423,307582
MASONB.txt,305382,308689,3307,20,Y,Y,1448397101672,305423,307582
MASONB.txt,306139,309485,3346,20,Y,Y,1448397101672,305423,307582
MASONB.txt,306789,310445,3656,20,Y,Y,1448397101672,305423,307582
MASONB.txt,307622,311260,3638,20,Y,Y,1448397400459,310446,310619
MASONB.txt,308690,311905,3215,20,Y,Y,1448397400459,310446,310619
MASONB.txt,309488,312718,3230,20,Y,Y,1448397400459,310446,310619
MASONB.txt,310446,312979,2533,20,Y,Y,1448397400459,310446,310619
MASONB.txt,311261,313181,1920,20,Y,Y,1448658303622,312507,313648
MASONB.txt,311906,314063,2157,20,Y,Y,1448658303622,312507,313648
MASONB.txt,312720,314791,2071,20,Y,Y,1448658303622,312507,313648
MASONB.txt,312982,315819,2837,20,Y,Y,1448658303622,312507,313648
MASONB.txt,313184,316679,3495,20,Y,Y,1448658612805,316427,316672
MASONB.txt,314064,317455,3391,20,Y,Y,1448658612805,316427,316672
MASONB.txt,314792,318668,3876,20,Y,Y,1448658612805,316427,316672
MASONB.txt,315820,319417,3597,20,Y,Y,1448658612805,316427,316672
MASONB.txt,316681,321288,4607,20,Y,Y,1448658736891,316691,317030
MASONB.txt,317458,321878,4420,20,Y,Y,1448659006435,318991,319718
MASONB.txt,318669,323110,4441,20,Y,Y,1448659006435,318991,319718
MASONB.txt,319418,323747,4329,20,Y,Y,1448659006435,318991,319718
MASONB.txt,321289,324784,3495,20,Y,Y,1448659532009,324326,325031
MASONB.txt,321879,325513,3634,20,Y,Y,1448659532009,324326,325031
MASONB.txt,323111,326584,3473,20,Y,Y,1448659532009,324326,325031
MASONB.txt,323748,327298,3550,20,Y,Y,1448659532009,324326,325031
MASONB.txt,324785,328015,3230,20,Y,Y,1448659532009,324326,325031
MASONB.txt,325514,329202,3688,20,Y,Y,1448660077114,325649,326955
MASONB.txt,326585,329766,3181,20,Y,Y,1448660077114,325649,326955
MASONB.txt,327299,331132,3833,20,Y,Y,1448660677535,329295,329761
MASONB.txt,328016,331898,3882,20,Y,Y,1448706327916,331732,332605
MASONB.txt,329203,333052,3849,20,Y,Y,1448706327916,331732,332605
MASONB.txt,329767,333391,3624,20,Y,Y,1448707430181,333075,333132
MASONB.txt,331133,334265,3132,20,Y,Y,1448707430181,333075,333132
MASONB.txt,331899,335040,3141,20,Y,Y,1448707430181,333075,333132
MASONB.txt,333055,335242,2187,20,Y,Y,1448707430181,333075,333132
MASONB.txt,333394,335489,2095,20,Y,Y,1448707642133,333165,333450
MASONB.txt,334266,335641,1375,20,Y,Y,1448709266671,335017,336316
MASONB.txt,335041,335852,811,20,Y,Y,1448709266671,335017,336316
MASONB.txt,335245,336039,794,20,Y,Y,1448709266671,335017,336316
MASONB.txt,335492,336123,631,20,Y,Y,1448709266671,335017,336316
MASONB.txt,335644,336220,576,20,Y,Y,1448709266671,335017,336316
MASONB.txt,335853,336760,907,20,Y,Y,1448709266671,335017,336316
MASONB.txt,336040,337116,1076,20,Y,Y,1448709266671,335017,336316
MASONB.txt,336126,337435,1309,20,Y,Y,1448709417506,337306,338419
MASONB.txt,336221,337794,1573,20,N,Y,1448709417506,337306,338419
MASONB.txt,336762,338835,2073,20,Y,Y,1448709417506,337306,338419
MASONB.txt,337119,339325,2206,20,Y,Y,1448709670572,338913,339172
MASONB.txt,337437,340137,2700,20,Y,Y,1448709670572,338913,339172
MASONB.txt,337797,340782,2985,20,Y,Y,1448709670572,338913,339172
MASONB.txt,338836,341405,2569,20,Y,Y,1448709670572,338913,339172
MASONB.txt,339326,341818,2492,20,Y,Y,1448835299579,341107,342636
MASONB.txt,340138,342033,1895,20,Y,Y,1448835299579,341107,342636
MASONB.txt,340784,342580,1796,20,Y,Y,1448835299579,341107,342636
MASONB.txt,341406,342912,1506,20,Y,Y,1448835299579,341107,342636
MASONB.txt,341821,343023,1202,20,Y,Y,1448835299579,341107,342636
MASONB.txt,342034,343128,1094,20,Y,Y,1448835299579,341107,342636
MASONB.txt,342583,343236,653,20,N,Y,1448835299579,341107,342636
MASONB.txt,342915,343351,436,20,N,N,-,-1,-1
MASONB.txt,343024,343526,502,20,N,N,-,-1,-1
MASONB.txt,343129,343671,542,20,N,N,-,-1,-1
MASONB.txt,343237,343865,628,20,N,N,-,-1,-1
MASONB.txt,343351,344031,680,20,N,N,-,-1,-1
MASONB.txt,343527,344153,626,20,N,N,-,-1,-1
MASONB.txt,343672,344280,608,20,N,N,-,-1,-1
MASONB.txt,343866,344463,597,20,N,N,-,-1,-1
MASONB.txt,344034,344599,565,20,N,N,-,-1,-1
MASONB.txt,344153,344692,539,20,N,N,-,-1,-1
MASONB.txt,344283,344859,576,20,N,N,-,-1,-1
MASONB.txt,344464,345238,774,20,N,N,-,-1,-1
MASONB.txt,344599,345540,941,20,N,N,-,-1,-1
MASONB.txt,344693,346241,1548,20,N,Y,1448835409437,345709,346338
MASONB.txt,344862,346513,1651,20,N,Y,1448835409437,345709,346338
MASONB.txt,345239,346767,1528,20,N,Y,1448835409437,345709,346338
MASONB.txt,345543,347384,1841,20,N,Y,1448835409437,345709,346338
MASONB.txt,346242,348244,2002,20,Y,Y,1448835409437,345709,346338
MASONB.txt,346516,349005,2489,20,Y,Y,1448919978818,348008,348718
MASONB.txt,346770,349831,3061,20,Y,Y,1448919978818,348008,348718
MASONB.txt,347385,350699,3314,20,Y,Y,1448919978818,348008,348718
MASONB.txt,348246,351060,2814,20,Y,Y,1448919978818,348008,348718
MASONB.txt,349010,351921,2911,20,Y,Y,1448920117937,349054,349858
MASONB.txt,349832,352905,3073,20,Y,Y,1448920117937,349054,349858
MASONB.txt,350700,353231,2531,20,Y,N,-,-1,-1
MASONB.txt,351063,354659,3596,20,Y,N,-,-1,-1
MASONB.txt,351922,355020,3098,20,Y,N,-,-1,-1
MASONB.txt,352910,355826,2916,20,Y,N,-,-1,-1
MASONB.txt,353234,356775,3541,20,Y,N,-,-1,-1
MASONB.txt,354662,357527,2865,20,Y,N,-,-1,-1
MASONB.txt,355021,358433,3412,20,Y,Y,1448920293515,357836,358190
MASONB.txt,355828,358867,3039,20,Y,Y,1448920293515,357836,358190
MASONB.txt,356777,360159,3382,20,Y,Y,1448920293515,357836,358190
MASONB.txt,357528,360626,3098,20,Y,Y,1448920293515,357836,358190
MASONB.txt,358436,361287,2851,20,Y,N,-,-1,-1
MASONB.txt,358868,362257,3389,20,Y,N,-,-1,-1
MASONB.txt,360160,363340,3180,20,Y,Y,1448920858487,363333,364839
MASONB.txt,360627,364645,4018,20,Y,Y,1448920858487,363333,364839
MASONB.txt,361288,365236,3948,20,Y,Y,1448920858487,363333,364839
MASONB.txt,362258,365975,3717,20,Y,Y,1448920858487,363333,364839
MASONB.txt,363341,366490,3149,20,Y,Y,1448920858487,363333,364839
MASONB.txt,364646,367052,2406,20,Y,Y,1448920858487,363333,364839
MASONB.txt,365237,368572,3335,20,Y,Y,1448921338450,367291,368573
MASONB.txt,365978,369144,3166,20,Y,Y,1448921338450,367291,368573
MASONB.txt,366491,369468,2977,20,Y,Y,1448921338450,367291,368573
MASONB.txt,367053,370263,3210,20,Y,Y,1448921338450,367291,368573
MASONB.txt,368575,370663,2088,20,Y,N,-,-1,-1
MASONB.txt,369145,371023,1878,20,Y,Y,1448921716519,370956,371267
MASONB.txt,369469,371725,2256,20,Y,Y,1448921716519,370956,371267
MASONB.txt,370264,372506,2242,20,Y,Y,1448921716519,370956,371267
MASONB.txt,370666,373320,2654,20,Y,Y,1448921716519,370956,371267
MASONB.txt,371024,373846,2822,20,Y,Y,1448921716519,370956,371267
MASONB.txt,371726,374656,2930,20,Y,Y,1448922003968,373392,374323
MASONB.txt,372507,375316,2809,20,Y,Y,1448922003968,373392,374323
MASONB.txt,373321,375790,2469,20,Y,Y,1448922003968,373392,374323
MASONB.txt,373847,376431,2584,20,Y,Y,1448922003968,373392,374323
MASONB.txt,374657,377123,2466,20,Y,N,-,-1,-1
MASONB.txt,375317,377736,2419,20,Y,Y,1448922458482,377161,378772
MASONB.txt,375791,378066,2275,20,Y,Y,1448922458482,377161,378772
MASONB.txt,376432,378864,2432,20,Y,Y,1448922458482,377161,378772
MASONB.txt,377123,379517,2394,20,Y,Y,1448922458482,377161,378772
MASONB.txt,377737,380575,2838,20,Y,Y,1448922458482,377161,378772
MASONB.txt,378067,381233,3166,20,Y,Y,1448922458482,377161,378772
MASONB.txt,378865,382014,3149,20,Y,Y,1448923016815,381625,382381
MASONB.txt,379518,383071,3553,20,Y,Y,1448923016815,381625,382381
MASONB.txt,380577,383692,3115,20,Y,Y,1448923016815,381625,382381
MASONB.txt,381235,384316,3081,20,Y,Y,1448923016815,381625,382381
MASONB.txt,382015,384635,2620,20,Y,Y,1448923016815,381625,382381
MASONB.txt,383072,384984,1912,20,Y,N,-,-1,-1
MASONB.txt,383693,385652,1959,20,Y,N,-,-1,-1
MASONB.txt,384317,386230,1913,20,Y,N,-,-1,-1
MASONB.txt,384637,386759,2122,20,Y,N,-,-1,-1
MASONB.txt,384985,387202,2217,20,Y,N,-,-1,-1
MASONB.txt,385655,387680,2025,20,Y,N,-,-1,-1
MASONB.txt,386231,388119,1888,20,Y,N,-,-1,-1
MASONB.txt,386760,388806,2046,20,Y,N,-,-1,-1
MASONB.txt,387203,389674,2471,20,Y,N,-,-1,-1
MASONB.txt,387681,390189,2508,20,Y,N,-,-1,-1
MASONB.txt,388120,391051,2931,20,Y,N,-,-1,-1
MASONB.txt,388807,391732,2925,20,Y,N,-,-1,-1
MASONB.txt,389677,392835,3158,20,Y,N,-,-1,-1
MASONB.txt,390190,394137,3947,20,Y,N,-,-1,-1
MASONB.txt,391052,394653,3601,20,Y,N,-,-1,-1
MASONB.txt,391733,395126,3393,20,Y,N,-,-1,-1
MASONB.txt,392838,395470,2632,20,Y,N,-,-1,-1
MASONB.txt,394140,395768,1628,20,Y,N,-,-1,-1
MASONB.txt,394653,396078,1425,20,Y,N,-,-1,-1
MASONB.txt,395128,396435,1307,20,Y,N,-,-1,-1
MASONB.txt,395472,396834,1362,20,Y,N,-,-1,-1
MASONB.txt,395768,397158,1390,20,Y,N,-,-1,-1
MASONB.txt,396078,397356,1278,20,Y,N,-,-1,-1
MASONB.txt,396435,397557,1122,20,Y,N,-,-1,-1
MASONB.txt,396837,397717,880,20,Y,N,-,-1,-1
MASONB.txt,397159,397888,729,20,Y,N,-,-1,-1
MASONB.txt,397357,398158,801,20,N,N,-,-1,-1
MASONB.txt,397558,398490,932,20,Y,N,-,-1,-1
MASONB.txt,397720,398802,1082,20,N,N,-,-1,-1
MASONB.txt,397889,399575,1686,20,Y,N,-,-1,-1
MASONB.txt,398158,400005,1847,20,Y,N,-,-1,-1
MASONB.txt,398491,400620,2129,20,Y,N,-,-1,-1
MASONB.txt,398803,401211,2408,20,Y,N,-,-1,-1
MASONB.txt,399577,402073,2496,20,Y,N,-,-1,-1
MASONB.txt,400008,402731,2723,20,Y,N,-,-1,-1
MASONB.txt,400623,403378,2755,20,Y,N,-,-1,-1
MASONB.txt,401212,403996,2784,20,Y,N,-,-1,-1
MASONB.txt,402074,404698,2624,20,Y,N,-,-1,-1
MASONB.txt,402732,405573,2841,20,Y,N,-,-1,-1
MASONB.txt,403379,406269,2890,20,Y,N,-,-1,-1
MASONB.txt,403997,406795,2798,20,Y,N,-,-1,-1
MASONB.txt,404699,407413,2714,20,Y,N,-,-1,-1
MASONB.txt,405574,408178,2604,20,Y,N,-,-1,-1
MASONB.txt,406270,408574,2304,20,Y,N,-,-1,-1
MASONB.txt,406796,409096,2300,20,Y,N,-,-1,-1
MASONB.txt,407414,409681,2267,20,Y,N,-,-1,-1
MASONB.txt,408179,410367,2188,20,Y,N,-,-1,-1
MASONB.txt,408575,410769,2194,20,Y,N,-,-1,-1
MASONB.txt,409097,411471,2374,20,Y,N,-,-1,-1
MASONB.txt,409682,412233,2551,20,Y,N,-,-1,-1
MASONB.txt,410369,412726,2357,20,Y,N,-,-1,-1
MASONB.txt,410770,413175,2405,20,Y,N,-,-1,-1
MASONB.txt,411472,414000,2528,20,Y,N,-,-1,-1
MASONB.txt,412234,414204,1970,20,Y,N,-,-1,-1
MASONB.txt,412727,414354,1627,20,Y,N,-,-1,-1
MASONB.txt,413176,414525,1349,20,Y,N,-,-1,-1
MASONB.txt,414003,414635,632,20,Y,N,-,-1,-1
MASONB.txt,414205,414695,490,20,Y,N,-,-1,-1
MASONB.txt,414355,414930,575,20,Y,N,-,-1,-1
MASONB.txt,414526,415325,799,20,Y,N,-,-1,-1
MASONB.txt,414638,415490,852,20,Y,N,-,-1,-1
MASONB.txt,414696,415631,935,20,Y,N,-,-1,-1
MASONB.txt,414930,416266,1336,20,Y,N,-,-1,-1
MASONB.txt,415325,416656,1331,20,Y,N,-,-1,-1
MASONB.txt,415491,417307,1816,20,Y,N,-,-1,-1
MASONB.txt,415632,417989,2357,20,Y,N,-,-1,-1
MASONB.txt,416269,418686,2417,20,Y,N,-,-1,-1
MASONB.txt,416657,419434,2777,20,Y,N,-,-1,-1
MASONB.txt,417308,419803,2495,20,Y,N,-,-1,-1
MASONB.txt,417990,420333,2343,20,Y,N,-,-1,-1
MASONB.txt,418687,421223,2536,20,Y,N,-,-1,-1
MASONB.txt,419435,421890,2455,20,Y,N,-,-1,-1
MASONB.txt,419804,422458,2654,20,Y,N,-,-1,-1
MASONB.txt,420334,422826,2492,20,Y,N,-,-1,-1
MASONB.txt,421224,423604,2380,20,Y,N,-,-1,-1
MASONB.txt,421891,424146,2255,20,Y,N,-,-1,-1
MASONB.txt,422459,424743,2284,20,Y,N,-,-1,-1
MASONB.txt,422827,425376,2549,20,Y,N,-,-1,-1
MASONB.txt,423605,426109,2504,20,Y,N,-,-1,-1
MASONB.txt,424147,427016,2869,20,Y,N,-,-1,-1
MASONB.txt,424746,427208,2462,20,Y,N,-,-1,-1
MASONB.txt,425377,428151,2774,20,Y,N,-,-1,-1
MASONB.txt,426110,428812,2702,20,Y,N,-,-1,-1
MASONB.txt,427017,429593,2576,20,Y,N,-,-1,-1
MASONB.txt,427209,430389,3180,20,Y,N,-,-1,-1
MASONB.txt,428153,431115,2962,20,Y,N,-,-1,-1
MASONB.txt,428813,431568,2755,20,Y,N,-,-1,-1
MASONB.txt,429594,432063,2469,20,Y,N,-,-1,-1
MASONB.txt,430390,432551,2161,20,Y,N,-,-1,-1
MASONB.txt,431116,433428,2312,20,Y,N,-,-1,-1
MASONB.txt,431569,434111,2542,20,Y,N,-,-1,-1
MASONB.txt,432064,434641,2577,20,Y,N,-,-1,-1
MASONB.txt,432552,435201,2649,20,Y,N,-,-1,-1
MASONB.txt,433429,435663,2234,20,Y,N,-,-1,-1
MASONB.txt,434112,436237,2125,20,Y,N,-,-1,-1
MASONB.txt,434642,436778,2136,20,Y,N,-,-1,-1
MASONB.txt,435202,438093,2891,20,Y,N,-,-1,-1
MASONB.txt,435664,438724,3060,20,Y,N,-,-1,-1
MASONB.txt,436238,439671,3433,20,Y,N,-,-1,-1
MASONB.txt,436780,440566,3786,20,Y,N,-,-1,-1
MASONB.txt,438096,441318,3222,20,Y,N,-,-1,-1
MASONB.txt,438725,441964,3239,20,Y,N,-,-1,-1
MASONB.txt,439672,442762,3090,20,Y,N,-,-1,-1
MASONB.txt,440567,443775,3208,20,Y,N,-,-1,-1
MASONB.txt,441319,444556,3237,20,Y,N,-,-1,-1
MASONB.txt,441965,445794,3829,20,Y,N,-,-1,-1
MASONB.txt,442763,446042,3279,20,Y,N,-,-1,-1
MASONB.txt,443776,446385,2609,20,Y,N,-,-1,-1
MASONB.txt,444557,446842,2285,20,Y,N,-,-1,-1
MASONB.txt,445797,447879,2082,20,Y,N,-,-1,-1
MASONB.txt,446043,448337,2294,20,Y,N,-,-1,-1
MASONB.txt,446387,448730,2343,20,Y,N,-,-1,-1
MASONB.txt,446843,449018,2175,20,Y,N,-,-1,-1
MASONB.txt,447880,449159,1279,20,N,N,-,-1,-1
MASONB.txt,448340,449372,1032,20,Y,N,-,-1,-1
MASONB.txt,448731,449595,864,20,Y,N,-,-1,-1
MASONB.txt,449021,449738,717,20,Y,N,-,-1,-1
MASONB.txt,449160,449956,796,20,Y,N,-,-1,-1
MASONB.txt,449373,450092,719,20,N,N,-,-1,-1
MASONB.txt,449598,450425,827,20,N,N,-,-1,-1
MASONB.txt,449739,451203,1464,20,Y,N,-,-1,-1
MASONB.txt,449957,451561,1604,20,Y,N,-,-1,-1
MASONB.txt,450093,452338,2245,20,Y,N,-,-1,-1
MASONB.txt,450427,452807,2380,20,Y,N,-,-1,-1
MASONB.txt,451204,453714,2510,20,Y,N,-,-1,-1
MASONB.txt,451562,454149,2587,20,N,N,-,-1,-1
MASONB.txt,452339,454748,2409,20,N,N,-,-1,-1
MASONB.txt,452808,455422,2614,20,Y,N,-,-1,-1
MASONB.txt,453716,455992,2276,20,Y,N,-,-1,-1
MASONB.txt,454150,456541,2391,20,Y,N,-,-1,-1
MASONB.txt,454749,457464,2715,20,Y,N,-,-1,-1
MASONB.txt,455423,457900,2477,20,Y,N,-,-1,-1
MASONB.txt,455995,458500,2505,20,Y,N,-,-1,-1
MASONB.txt,456542,458854,2312,20,Y,N,-,-1,-1
MASONB.txt,457465,459115,1650,20,Y,N,-,-1,-1
MASONB.txt,457901,459473,1572,20,Y,N,-,-1,-1
MASONB.txt,458503,459763,1260,20,Y,N,-,-1,-1
MASONB.txt,458854,460116,1262,20,Y,N,-,-1,-1
MASONB.txt,459116,460498,1382,20,Y,N,-,-1,-1
MASONB.txt,459476,460819,1343,20,Y,N,-,-1,-1
MASONB.txt,459765,461171,1406,20,Y,N,-,-1,-1
MASONB.txt,460118,461365,1247,20,N,N,-,-1,-1
MASONB.txt,460500,461925,1425,20,Y,N,-,-1,-1
MASONB.txt,460821,462370,1549,20,Y,N,-,-1,-1
MASONB.txt,461174,462626,1452,20,Y,N,-,-1,-1
MASONB.txt,461366,462903,1537,20,Y,N,-,-1,-1
MASONB.txt,461930,463418,1488,20,Y,N,-,-1,-1
MASONB.txt,462375,463962,1587,20,Y,N,-,-1,-1
MASONB.txt,462629,464543,1914,20,Y,N,-,-1,-1
MASONB.txt,462904,465286,2382,20,Y,N,-,-1,-1
MASONB.txt,463419,466251,2832,20,Y,N,-,-1,-1
MASONB.txt,463965,466385,2420,20,Y,N,-,-1,-1
MASONB.txt,464544,466703,2159,20,Y,N,-,-1,-1
MASONB.txt,465287,467366,2079,20,Y,N,-,-1,-1
MASONB.txt,466253,468087,1834,20,Y,N,-,-1,-1
MASONB.txt,466387,468244,1857,20,Y,N,-,-1,-1
MASONB.txt,466704,468429,1725,20,Y,N,-,-1,-1
MASONB.txt,467367,469197,1830,20,Y,N,-,-1,-1
MASONB.txt,468090,469872,1782,20,Y,N,-,-1,-1
MASONB.txt,468245,470104,1859,20,Y,N,-,-1,-1
MASONB.txt,468429,470943,2514,20,Y,N,-,-1,-1
MASONB.txt,469198,471317,2119,20,Y,Y,1448923619461,471131,472718
MASONB.txt,469873,471775,1902,20,Y,Y,1448923619461,471131,472718
MASONB.txt,470107,472321,2214,20,Y,Y,1448923619461,471131,472718
MASONB.txt,470948,472916,1968,20,Y,Y,1448923619461,471131,472718
MASONB.txt,471318,473611,2293,20,Y,Y,1448923619461,471131,472718
MASONB.txt,471776,474137,2361,20,Y,Y,1448923619461,471131,472718
MASONB.txt,472323,474507,2184,20,Y,Y,1448923619461,471131,472718
MASONB.txt,472919,474905,1986,20,Y,Y,1449009694213,473488,474410
MASONB.txt,473612,475880,2268,20,Y,Y,1449009694213,473488,474410
MASONB.txt,474138,476640,2502,20,Y,Y,1449009694213,473488,474410
MASONB.txt,474510,477569,3059,20,Y,N,-,-1,-1
MASONB.txt,474907,478644,3737,20,Y,N,-,-1,-1
MASONB.txt,475882,479156,3274,20,Y,N,-,-1,-1
MASONB.txt,476643,479408,2765,20,Y,N,-,-1,-1
MASONB.txt,477571,479724,2153,20,Y,N,-,-1,-1
MASONB.txt,478647,480357,1710,20,Y,N,-,-1,-1
MASONB.txt,479157,481492,2335,20,Y,N,-,-1,-1
MASONB.txt,479411,482142,2731,20,Y,N,-,-1,-1
MASONB.txt,479725,482366,2641,20,Y,N,-,-1,-1
MASONB.txt,480358,482500,2142,20,Y,N,-,-1,-1
MASONB.txt,481493,482745,1252,20,Y,N,-,-1,-1
MASONB.txt,482145,482848,703,20,Y,N,-,-1,-1
MASONB.txt,482367,482930,563,20,Y,N,-,-1,-1
MASONB.txt,482501,483049,548,20,Y,N,-,-1,-1
MASONB.txt,482746,483312,566,20,Y,N,-,-1,-1
MASONB.txt,482849,483570,721,20,Y,N,-,-1,-1
MASONB.txt,482930,483685,755,20,Y,N,-,-1,-1
MASONB.txt,483050,484626,1576,20,Y,N,-,-1,-1
MASONB.txt,483313,485391,2078,20,Y,N,-,-1,-1
MASONB.txt,483571,486152,2581,20,Y,N,-,-1,-1
MASONB.txt,483690,486446,2756,20,Y,N,-,-1,-1
MASONB.txt,484627,487477,2850,20,Y,N,-,-1,-1
MASONB.txt,485392,488152,2760,20,Y,N,-,-1,-1
MASONB.txt,486153,488240,2087,20,Y,N,-,-1,-1
MASONB.txt,486449,488442,1993,20,Y,N,-,-1,-1
MASONB.txt,487478,488602,1124,20,Y,N,-,-1,-1
MASONB.txt,488153,488768,615,20,Y,N,-,-1,-1
MASONB.txt,488241,489055,814,20,Y,N,-,-1,-1
MASONB.txt,488443,489183,740,20,Y,N,-,-1,-1
MASONB.txt,488603,489406,803,20,Y,N,-,-1,-1
MASONB.txt,488771,489599,828,20,Y,N,-,-1,-1
MASONB.txt,489056,489789,733,20,Y,N,-,-1,-1
MASONB.txt,489186,489994,808,20,Y,N,-,-1,-1
MASONB.txt,489409,490972,1563,20,Y,N,-,-1,-1
MASONB.txt,489600,492180,2580,20,Y,N,-,-1,-1
MASONB.txt,489789,493287,3498,20,Y,N,-,-1,-1
MASONB.txt,489995,493904,3909,20,Y,N,-,-1,-1
MASONB.txt,490972,494661,3689,20,Y,N,-,-1,-1
MASONB.txt,492182,495109,2927,20,Y,N,-,-1,-1
MASONB.txt,493288,495711,2423,20,Y,N,-,-1,-1
MASONB.txt,493905,496177,2272,20,Y,N,-,-1,-1
MASONB.txt,494664,496983,2319,20,Y,N,-,-1,-1
MASONB.txt,495110,498192,3082,20,Y,N,-,-1,-1
MASONB.txt,495712,498638,2926,20,Y,N,-,-1,-1
MASONB.txt,496179,498889,2710,20,Y,N,-,-1,-1
MASONB.txt,496986,499238,2252,20,Y,N,-,-1,-1
MASONB.txt,498193,500002,1809,20,Y,N,-,-1,-1
MASONB.txt,498639,500452,1813,20,N,N,-,-1,-1
MASONB.txt,498892,501322,2430,20,Y,N,-,-1,-1
MASONB.txt,499239,502447,3208,20,Y,N,-,-1,-1
MASONB.txt,500003,503088,3085,20,Y,N,-,-1,-1
MASONB.txt,500454,503890,3436,20,Y,N,-,-1,-1
MASONB.txt,501323,504628,3305,20,Y,N,-,-1,-1
MASONB.txt,502448,505397,2949,20,Y,N,-,-1,-1
MASONB.txt,503089,506231,3142,20,Y,N,-,-1,-1
MASONB.txt,503891,506737,2846,20,Y,N,-,-1,-1
MASONB.txt,504629,507351,2722,20,Y,N,-,-1,-1
MASONB.txt,505398,507809,2411,20,Y,N,-,-1,-1
MASONB.txt,506232,508226,1994,20,Y,N,-,-1,-1
MASONB.txt,506738,508976,2238,20,Y,N,-,-1,-1
MASONB.txt,507352,509338,1986,20,Y,N,-,-1,-1
MASONB.txt,507810,509812,2002,20,Y,N,-,-1,-1
MASONB.txt,508229,510061,1832,20,Y,N,-,-1,-1
MASONB.txt,508979,510293,1314,20,Y,N,-,-1,-1
MASONB.txt,509341,510487,1146,20,Y,N,-,-1,-1
MASONB.txt,509815,510711,896,20,Y,N,-,-1,-1
MASONB.txt,510062,511027,965,20,Y,N,-,-1,-1
MASONB.txt,510294,511344,1050,20,Y,N,-,-1,-1
MASONB.txt,510490,511914,1424,20,Y,N,-,-1,-1
MASONB.txt,510714,512479,1765,20,Y,N,-,-1,-1
MASONB.txt,511028,512803,1775,20,Y,N,-,-1,-1
MASONB.txt,511345,513812,2467,20,Y,N,-,-1,-1
MASONB.txt,511915,514544,2629,20,Y,N,-,-1,-1
MASONB.txt,512480,515215,2735,20,Y,N,-,-1,-1
MASONB.txt,512804,516152,3348,20,Y,N,-,-1,-1
MASONB.txt,513814,516969,3155,20,Y,N,-,-1,-1
MASONB.txt,514547,517356,2809,20,Y,N,-,-1,-1
MASONB.txt,515216,518011,2795,20,Y,N,-,-1,-1
MASONB.txt,516153,518627,2474,20,Y,N,-,-1,-1
MASONB.txt,516970,519123,2153,20,Y,N,-,-1,-1
MASONB.txt,517359,519809,2450,20,Y,N,-,-1,-1
MASONB.txt,518012,520167,2155,20,Y,N,-,-1,-1
MASONB.txt,518628,520739,2111,20,Y,N,-,-1,-1
MASONB.txt,519125,521087,1962,20,Y,N,-,-1,-1
MASONB.txt,519810,521624,1814,20,Y,N,-,-1,-1
MASONB.txt,520168,522164,1996,20,Y,N,-,-1,-1
MASONB.txt,520740,522765,2025,20,Y,N,-,-1,-1
MASONB.txt,521088,523363,2275,20,Y,N,-,-1,-1
MASONB.txt,521626,523952,2326,20,Y,N,-,-1,-1
MASONB.txt,522165,524557,2392,20,Y,N,-,-1,-1
MASONB.txt,522767,525063,2296,20,Y,N,-,-1,-1
MASONB.txt,523364,525538,2174,20,Y,N,-,-1,-1
MASONB.txt,523953,526535,2582,20,Y,N,-,-1,-1
MASONB.txt,524558,526741,2183,20,Y,N,-,-1,-1
MASONB.txt,525064,527147,2083,20,Y,N,-,-1,-1
MASONB.txt,525539,527696,2157,20,Y,N,-,-1,-1
MASONB.txt,526536,528450,1914,20,Y,Y,1449011557797,528395,529262
MASONB.txt,526742,529101,2359,20,Y,Y,1449011557797,528395,529262
MASONB.txt,527148,529609,2461,20,Y,Y,1449011557797,528395,529262
MASONB.txt,527697,530035,2338,20,Y,Y,1449011557797,528395,529262
MASONB.txt,528451,530496,2045,20,Y,Y,1449011557797,528395,529262
MASONB.txt,529102,531359,2257,20,N,Y,1449011557797,528395,529262
MASONB.txt,529612,532907,3295,20,Y,N,-,-1,-1
MASONB.txt,530036,533120,3084,20,Y,N,-,-1,-1
MASONB.txt,530497,533794,3297,20,Y,Y,1449011929492,533126,533951
MASONB.txt,531361,534232,2871,20,Y,Y,1461670558474,533968,535655
MASONB.txt,532910,535336,2426,20,Y,Y,1461670558474,533968,535655
MASONB.txt,533123,535838,2715,20,Y,Y,1461670707714,535735,535836
MASONB.txt,533796,536422,2626,20,Y,Y,1461670707714,535735,535836
MASONB.txt,534233,536934,2701,20,Y,Y,1461670707714,535735,535836
MASONB.txt,535337,537833,2496,20,Y,Y,1461670707714,535735,535836
MASONB.txt,535841,538286,2445,20,Y,Y,1461671039271,535897,538614
MASONB.txt,536424,538690,2266,20,Y,Y,1461671039271,535897,538614
MASONB.txt,536935,539237,2302,20,Y,Y,1461671039271,535897,538614
MASONB.txt,537834,539722,1888,20,Y,Y,1461671039271,535897,538614
MASONB.txt,538289,540375,2086,20,Y,Y,1461671039271,535897,538614
MASONB.txt,538695,540996,2301,20,Y,Y,1461682939139,540732,541471
MASONB.txt,539238,541587,2349,20,Y,Y,1461682939139,540732,541471
MASONB.txt,539723,541752,2029,20,Y,Y,1461682939139,540732,541471
MASONB.txt,540376,542022,1646,20,Y,Y,1461682939139,540732,541471
MASONB.txt,540997,542215,1218,20,Y,Y,1461682939139,540732,541471
MASONB.txt,541595,542518,923,20,N,N,-,-1,-1
MASONB.txt,541753,542694,941,20,N,N,-,-1,-1
MASONB.txt,542025,543005,980,20,N,N,-,-1,-1
MASONB.txt,542216,543271,1055,20,N,N,-,-1,-1
MASONB.txt,542521,543546,1025,20,N,N,-,-1,-1
MASONB.txt,542695,544089,1394,20,N,Y,1461777193721,543550,543984
MASONB.txt,543006,544841,1835,20,N,Y,1461777193721,543550,543984
MASONB.txt,543274,545247,1973,20,N,Y,1461777193721,543550,543984
MASONB.txt,543547,546070,2523,20,N,Y,1461777193721,543550,543984
MASONB.txt,544090,546531,2441,20,N,Y,1461777612954,544164,545194
MASONB.txt,544842,547048,2206,20,Y,Y,1461777612954,544164,545194
MASONB.txt,545250,547979,2729,20,Y,Y,1461779662782,546686,549591
MASONB.txt,546073,548406,2333,20,Y,Y,1461779662782,546686,549591
MASONB.txt,546536,549146,2610,20,Y,Y,1461779662782,546686,549591
MASONB.txt,547049,549690,2641,20,Y,Y,1461779662782,546686,549591
MASONB.txt,547982,550058,2076,20,Y,Y,1461790279048,549743,550180
MASONB.txt,548407,550833,2426,20,Y,Y,1461790554025,550059,551049
MASONB.txt,549147,551407,2260,20,Y,Y,1461790554025,550059,551049
MASONB.txt,549693,552121,2428,20,Y,Y,1461790554025,550059,551049
MASONB.txt,550059,552614,2555,20,Y,Y,1461790554025,550059,551049
MASONB.txt,550834,553082,2248,20,Y,Y,1461790554025,550059,551049
MASONB.txt,551408,553671,2263,20,Y,Y,1461791817263,551075,551983
MASONB.txt,552124,554436,2312,20,Y,Y,1462035341084,552137,553334
MASONB.txt,552615,554839,2224,20,Y,Y,1462037372440,554649,554769
MASONB.txt,553083,555264,2181,20,Y,Y,1462037372440,554649,554769
MASONB.txt,553672,556425,2753,20,Y,Y,1462038250768,556311,558014
MASONB.txt,554437,557292,2855,20,Y,Y,1462038250768,556311,558014
MASONB.txt,554840,558247,3407,20,Y,Y,1462038250768,556311,558014
MASONB.txt,555265,558800,3535,20,Y,Y,1462038250768,556311,558014
MASONB.txt,556427,559177,2750,20,Y,Y,1462038250768,556311,558014
MASONB.txt,557294,559887,2593,20,Y,Y,1462038250768,556311,558014
MASONB.txt,558248,560488,2240,20,Y,Y,1462038377036,558101,558326
MASONB.txt,558801,560686,1885,20,Y,N,-,-1,-1
MASONB.txt,559178,560808,1630,20,Y,N,-,-1,-1
MASONB.txt,559892,560986,1094,20,Y,N,-,-1,-1
MASONB.txt,560493,561069,576,20,Y,N,-,-1,-1
MASONB.txt,560687,561536,849,20,Y,N,-,-1,-1
MASONB.txt,560809,562257,1448,20,Y,N,-,-1,-1
MASONB.txt,560987,562728,1741,20,Y,N,-,-1,-1
MASONB.txt,561070,563155,2085,20,Y,N,-,-1,-1
MASONB.txt,561537,563765,2228,20,Y,N,-,-1,-1
MASONB.txt,562262,564191,1929,20,Y,N,-,-1,-1
MASONB.txt,562729,564613,1884,20,Y,N,-,-1,-1
MASONB.txt,563156,565023,1867,20,Y,N,-,-1,-1
MASONB.txt,563768,565684,1916,20,Y,N,-,-1,-1
MASONB.txt,564192,566207,2015,20,Y,N,-,-1,-1
MASONB.txt,564614,566684,2070,20,Y,N,-,-1,-1
MASONB.txt,565024,567340,2316,20,Y,N,-,-1,-1
MASONB.txt,565687,567919,2232,20,Y,N,-,-1,-1
MASONB.txt,566210,568630,2420,20,Y,N,-,-1,-1
MASONB.txt,566685,569622,2937,20,Y,N,-,-1,-1
MASONB.txt,567342,570235,2893,20,Y,N,-,-1,-1
MASONB.txt,567920,570967,3047,20,Y,N,-,-1,-1
MASONB.txt,568631,571521,2890,20,Y,N,-,-1,-1
MEMMUS.txt,0,11007,11007,20,Y,N,-,-1,-1
MEMMUS.txt,5856,11429,5573,20,Y,N,-,-1,-1
MEMMUS.txt,7940,11611,3671,20,Y,N,-,-1,-1
MEMMUS.txt,9717,11644,1927,20,N,N,-,-1,-1
MEMMUS.txt,11008,13127,2119,20,N,N,-,-1,-1
MEMMUS.txt,11430,13834,2404,20,Y,N,-,-1,-1
MEMMUS.txt,11612,14807,3195,20,Y,N,-,-1,-1
MEMMUS.txt,11645,15818,4173,20,Y,N,-,-1,-1
MEMMUS.txt,13130,16124,2994,20,Y,N,-,-1,-1
MEMMUS.txt,13837,16679,2842,20,Y,N,-,-1,-1
MEMMUS.txt,14808,17212,2404,20,Y,N,-,-1,-1
MEMMUS.txt,15821,17655,1834,20,Y,N,-,-1,-1
MEMMUS.txt,16126,18455,2329,20,Y,Y,1435840591315,18262,18851
MEMMUS.txt,16680,18840,2160,20,Y,Y,1435840591315,18262,18851
MEMMUS.txt,17213,19363,2150,20,Y,Y,1435840591315,18262,18851
MEMMUS.txt,17656,19941,2285,20,Y,Y,1435840591315,18262,18851
MEMMUS.txt,18456,20220,1764,20,Y,Y,1435840591315,18262,18851
MEMMUS.txt,18841,20542,1701,20,Y,Y,1435840591315,18262,18851
MEMMUS.txt,19364,21041,1677,20,Y,N,-,-1,-1
MEMMUS.txt,19942,21908,1966,20,Y,N,-,-1,-1
MEMMUS.txt,20221,22360,2139,20,Y,Y,1435915325286,22285,22827
MEMMUS.txt,20543,22934,2391,20,Y,Y,1435915325286,22285,22827
MEMMUS.txt,21044,23503,2459,20,Y,Y,1435915325286,22285,22827
MEMMUS.txt,21909,24033,2124,20,Y,Y,1435915325286,22285,22827
MEMMUS.txt,22361,24851,2490,20,Y,Y,1435915981952,24325,25472
MEMMUS.txt,22935,25922,2987,20,Y,Y,1435916345649,25766,26337
MEMMUS.txt,23504,26359,2855,20,Y,Y,1435916345649,25766,26337
MEMMUS.txt,24034,27487,3453,20,Y,Y,1435916345649,25766,26337
MEMMUS.txt,24852,28241,3389,20,Y,Y,1435916345649,25766,26337
MEMMUS.txt,25923,28840,2917,20,Y,Y,1435916345649,25766,26337
MEMMUS.txt,26362,29732,3370,20,Y,Y,1435916831062,28859,29721
MEMMUS.txt,27488,30543,3055,20,Y,Y,1435916831062,28859,29721
MEMMUS.txt,28244,31063,2819,20,Y,Y,1435916831062,28859,29721
MEMMUS.txt,28843,31973,3130,20,Y,Y,1435916831062,28859,29721
MEMMUS.txt,29735,32671,2936,20,Y,Y,1435926808950,31555,32153
MEMMUS.txt,30544,33573,3029,20,Y,Y,1435926808950,31555,32153
MEMMUS.txt,31064,34195,3131,20,Y,Y,1435927129543,33653,34022
MEMMUS.txt,31974,35006,3032,20,Y,Y,1435927129543,33653,34022
MEMMUS.txt,32672,35776,3104,20,Y,Y,1435927129543,33653,34022
MEMMUS.txt,33574,36282,2708,20,Y,Y,1435928087149,36052,37379
MEMMUS.txt,34196,37431,3235,20,Y,Y,1435928087149,36052,37379
MEMMUS.txt,35007,38277,3270,20,Y,Y,1435928087149,36052,37379
MEMMUS.txt,35777,38764,2987,20,Y,Y,1435928087149,36052,37379
MEMMUS.txt,36283,39278,2995,20,Y,Y,1435928087149,36052,37379
MEMMUS.txt,37434,39747,2313,20,Y,N,-,-1,-1
MEMMUS.txt,38280,40636,2356,20,Y,N,-,-1,-1
MEMMUS.txt,38767,41517,2750,20,Y,N,-,-1,-1
MEMMUS.txt,39279,42327,3048,20,Y,N,-,-1,-1
MEMMUS.txt,39750,42993,3243,20,Y,N,-,-1,-1
MEMMUS.txt,40639,43573,2934,20,Y,N,-,-1,-1
MEMMUS.txt,41520,44285,2765,20,Y,N,-,-1,-1
MEMMUS.txt,42330,44964,2634,20,Y,N,-,-1,-1
MEMMUS.txt,42995,45590,2595,20,Y,N,-,-1,-1
MEMMUS.txt,43574,46067,2493,20,Y,N,-,-1,-1
MEMMUS.txt,44286,46460,2174,20,Y,Y,1435929264418,46072,46536
MEMMUS.txt,44965,46757,1792,20,Y,Y,1435930107895,46560,46927
MEMMUS.txt,45591,47352,1761,20,Y,Y,1435930107895,46560,46927
MEMMUS.txt,46070,47747,1677,20,Y,Y,1435930107895,46560,46927
MEMMUS.txt,46461,48514,2053,20,Y,Y,1435930107895,46560,46927
MEMMUS.txt,46758,49285,2527,20,Y,Y,1435930107895,46560,46927
MEMMUS.txt,47353,50311,2958,20,Y,Y,1435930476313,46955,47602
MEMMUS.txt,47748,50999,3251,20,Y,N,-,-1,-1
MEMMUS.txt,48515,51963,3448,20,Y,N,-,-1,-1
MEMMUS.txt,49286,53347,4061,20,Y,Y,1435930984335,53222,54022
MEMMUS.txt,50314,53872,3558,20,Y,Y,1435930984335,53222,54022
MEMMUS.txt,51000,54642,3642,20,Y,Y,1435930984335,53222,54022
MEMMUS.txt,51966,55295,3329,20,Y,Y,1435930984335,53222,54022
MEMMUS.txt,53349,55894,2545,20,Y,Y,1435930984335,53222,54022
MEMMUS.txt,53873,56783,2910,20,Y,Y,1435930984335,53222,54022
MEMMUS.txt,54643,57708,3065,20,Y,N,-,-1,-1
MEMMUS.txt,55296,58611,3315,20,Y,N,-,-1,-1
MEMMUS.txt,55897,59108,3211,20,Y,N,-,-1,-1
MEMMUS.txt,56784,59964,3180,20,Y,N,-,-1,-1
MEMMUS.txt,57710,60689,2979,20,Y,N,-,-1,-1
MEMMUS.txt,58612,61715,3103,20,Y,N,-,-1,-1
MEMMUS.txt,59109,62574,3465,20,Y,N,-,-1,-1
MEMMUS.txt,59966,63059,3093,20,Y,N,-,-1,-1
MEMMUS.txt,60690,63653,2963,20,Y,N,-,-1,-1
MEMMUS.txt,61718,64299,2581,20,Y,N,-,-1,-1
MEMMUS.txt,62577,65142,2565,20,Y,Y,1435931512268,64554,65135
MEMMUS.txt,63062,65783,2721,20,Y,Y,1435931512268,64554,65135
MEMMUS.txt,63654,66659,3005,20,Y,Y,1435931512268,64554,65135
MEMMUS.txt,64300,67281,2981,20,Y,Y,1435931512268,64554,65135
MEMMUS.txt,65147,67983,2836,20,Y,Y,1436164309168,67698,68227
MEMMUS.txt,65785,69123,3338,20,Y,Y,1436164309168,67698,68227
MEMMUS.txt,66660,69901,3241,20,Y,Y,1436164309168,67698,68227
MEMMUS.txt,67284,70577,3293,20,Y,Y,1436164309168,67698,68227
MEMMUS.txt,67984,71447,3463,20,Y,Y,1436164309168,67698,68227
MEMMUS.txt,69124,72026,2902,20,Y,Y,1436164628291,70081,70559
MEMMUS.txt,69902,72801,2899,20,Y,Y,1436173608702,72553,73111
MEMMUS.txt,70580,73317,2737,20,Y,Y,1436173608702,72553,73111
MEMMUS.txt,71450,73607,2157,20,Y,Y,1436173608702,72553,73111
MEMMUS.txt,72027,74201,2174,20,Y,Y,1436173608702,72553,73111
MEMMUS.txt,72804,74986,2182,20,Y,Y,1436173608702,72553,73111
MEMMUS.txt,73318,75851,2533,20,Y,N,-,-1,-1
MEMMUS.txt,73608,76623,3015,20,Y,Y,1436174454662,76332,76889
MEMMUS.txt,74202,77124,2922,20,Y,Y,1436174454662,76332,76889
MEMMUS.txt,74989,78103,3114,20,Y,Y,1436174454662,76332,76889
MEMMUS.txt,75852,78751,2899,20,Y,Y,1436174454662,76332,76889
MEMMUS.txt,76624,79127,2503,20,Y,Y,1436174454662,76332,76889
MEMMUS.txt,77125,79603,2478,20,N,N,-,-1,-1
MEMMUS.txt,78104,80521,2417,20,N,N,-,-1,-1
MEMMUS.txt,78752,81402,2650,20,Y,N,-,-1,-1
MEMMUS.txt,79128,82322,3194,20,Y,Y,1436174968369,81917,82485
MEMMUS.txt,79606,82959,3353,20,Y,Y,1436174968369,81917,82485
MEMMUS.txt,80522,83394,2872,20,Y,Y,1436174968369,81917,82485
MEMMUS.txt,81407,84103,2696,20,Y,Y,1436174968369,81917,82485
MEMMUS.txt,82323,84507,2184,20,Y,Y,1436174968369,81917,82485
MEMMUS.txt,82960,85368,2408,20,Y,Y,1436175572082,83734,84298
MEMMUS.txt,83395,86582,3187,20,Y,Y,1436175572082,83734,84298
MEMMUS.txt,84104,87493,3389,20,Y,Y,1436175572082,83734,84298
MEMMUS.txt,84508,88485,3977,20,Y,Y,1436176439600,86589,87384
MEMMUS.txt,85369,89087,3718,20,Y,Y,1436176439600,86589,87384
MEMMUS.txt,86585,89698,3113,20,Y,Y,1436176439600,86589,87384
MEMMUS.txt,87496,89992,2496,20,Y,N,-,-1,-1
MEMMUS.txt,88488,90160,1672,20,Y,N,-,-1,-1
MEMMUS.txt,89088,90300,1212,20,Y,N,-,-1,-1
MEMMUS.txt,89701,90528,827,20,Y,N,-,-1,-1
MEMMUS.txt,89997,91202,1205,20,Y,N,-,-1,-1
MEMMUS.txt,90162,91703,1541,20,Y,N,-,-1,-1
MEMMUS.txt,90301,92098,1797,20,Y,N,-,-1,-1
MEMMUS.txt,90530,92839,2309,20,Y,N,-,-1,-1
MEMMUS.txt,91203,93331,2128,20,Y,N,-,-1,-1
MEMMUS.txt,91706,94079,2373,20,Y,N,-,-1,-1
MEMMUS.txt,92100,95112,3012,20,Y,Y,1436178232441,94736,96568
MEMMUS.txt,92840,96130,3290,20,Y,Y,1436178232441,94736,96568
MEMMUS.txt,93332,96689,3357,20,Y,Y,1436178232441,94736,96568
MEMMUS.txt,94080,97384,3304,20,Y,Y,1436178232441,94736,96568
MEMMUS.txt,95113,98222,3109,20,Y,Y,1436178232441,94736,96568
MEMMUS.txt,96131,99120,2989,20,Y,Y,1436178232441,94736,96568
MEMMUS.txt,96691,99866,3175,20,Y,Y,1436180874507,96703,97450
MEMMUS.txt,97386,100611,3225,20,Y,Y,1436180874507,96703,97450
MEMMUS.txt,98225,101487,3262,20,Y,N,-,-1,-1
MEMMUS.txt,99123,102194,3071,20,Y,N,-,-1,-1
MEMMUS.txt,99867,103028,3161,20,Y,N,-,-1,-1
MEMMUS.txt,100614,103618,3004,20,Y,N,-,-1,-1
MEMMUS.txt,101490,104392,2902,20,Y,N,-,-1,-1
MEMMUS.txt,102196,105034,2838,20,Y,N,-,-1,-1
MEMMUS.txt,103029,105810,2781,20,Y,N,-,-1,-1
MEMMUS.txt,103621,106864,3243,20,Y,N,-,-1,-1
MEMMUS.txt,104393,107608,3215,20,Y,N,-,-1,-1
MEMMUS.txt,105035,108609,3574,20,Y,N,-,-1,-1
MEMMUS.txt,105811,109542,3731,20,Y,Y,1436181440816,109452,110419
MEMMUS.txt,106865,110186,3321,20,Y,Y,1436181440816,109452,110419
MEMMUS.txt,107611,110505,2894,20,Y,Y,1436181440816,109452,110419
MEMMUS.txt,108612,111276,2664,20,Y,Y,1436181440816,109452,110419
MEMMUS.txt,109543,111753,2210,20,Y,Y,1436181440816,109452,110419
MEMMUS.txt,110187,112627,2440,20,Y,Y,1436181440816,109452,110419
MEMMUS.txt,110508,113199,2691,20,Y,N,-,-1,-1
MEMMUS.txt,111277,113629,2352,20,Y,N,-,-1,-1
MEMMUS.txt,111758,114109,2351,20,Y,N,-,-1,-1
MEMMUS.txt,112629,114772,2143,20,Y,N,-,-1,-1
MEMMUS.txt,113201,115548,2347,20,Y,N,-,-1,-1
MEMMUS.txt,113630,117177,3547,20,Y,Y,1436182135916,116723,117609
MEMMUS.txt,114112,117931,3819,20,Y,Y,1436182498768,117674,118815
MEMMUS.txt,114777,118588,3811,20,Y,Y,1436182498768,117674,118815
MEMMUS.txt,115553,119393,3840,20,Y,Y,1436182498768,117674,118815
MEMMUS.txt,117180,120320,3140,20,Y,Y,1436182942743,119767,120353
MEMMUS.txt,117934,120898,2964,20,Y,Y,1436182942743,119767,120353
MEMMUS.txt,118589,121541,2952,20,Y,Y,1436182942743,119767,120353
MEMMUS.txt,119394,122541,3147,20,Y,Y,1436182942743,119767,120353
MEMMUS.txt,120322,123283,2961,20,Y,Y,1436182942743,119767,120353
MEMMUS.txt,120899,124002,3103,20,Y,Y,1436183373358,121001,122265
MEMMUS.txt,121542,124662,3120,20,Y,Y,1436183373358,121001,122265
MEMMUS.txt,122542,125277,2735,20,Y,N,-,-1,-1
MEMMUS.txt,123284,125911,2627,20,Y,N,-,-1,-1
MEMMUS.txt,124003,126466,2463,20,Y,N,-,-1,-1
MEMMUS.txt,124663,127119,2456,20,Y,N,-,-1,-1
MEMMUS.txt,125278,127677,2399,20,Y,N,-,-1,-1
MEMMUS.txt,125912,128306,2394,20,Y,N,-,-1,-1
MEMMUS.txt,126467,129478,3011,20,Y,N,-,-1,-1
MEMMUS.txt,127120,130720,3600,20,Y,N,-,-1,-1
MEMMUS.txt,127679,131397,3718,20,Y,N,-,-1,-1
MEMMUS.txt,128307,132017,3710,20,Y,N,-,-1,-1
MEMMUS.txt,129481,132603,3122,20,Y,N,-,-1,-1
MEMMUS.txt,130723,133472,2749,20,Y,N,-,-1,-1
MEMMUS.txt,131400,134403,3003,20,Y,Y,1436192343938,134271,135042
MEMMUS.txt,132018,134950,2932,20,Y,Y,1436192343938,134271,135042
MEMMUS.txt,132604,135800,3196,20,Y,Y,1436192343938,134271,135042
MEMMUS.txt,133474,136321,2847,20,Y,Y,1436192343938,134271,135042
MEMMUS.txt,134405,137367,2962,20,Y,Y,1436192343938,134271,135042
MEMMUS.txt,134951,138362,3411,20,Y,Y,1436192343938,134271,135042
MEMMUS.txt,135801,139287,3486,20,Y,Y,1436193426140,136824,137579
MEMMUS.txt,136322,140002,3680,20,Y,Y,1436193426140,136824,137579
MEMMUS.txt,137368,140634,3266,20,Y,Y,1436193426140,136824,137579
MEMMUS.txt,138363,141943,3580,20,Y,Y,1436193727777,138272,139069
MEMMUS.txt,139288,142677,3389,20,Y,N,-,-1,-1
MEMMUS.txt,140003,143502,3499,20,Y,N,-,-1,-1
MEMMUS.txt,140635,144326,3691,20,Y,N,-,-1,-1
MEMMUS.txt,141946,144918,2972,20,Y,N,-,-1,-1
MEMMUS.txt,142678,145587,2909,20,Y,N,-,-1,-1
MEMMUS.txt,143503,146232,2729,20,Y,N,-,-1,-1
MEMMUS.txt,144329,146914,2585,20,Y,N,-,-1,-1
MEMMUS.txt,144919,147609,2690,20,Y,N,-,-1,-1
MEMMUS.txt,145588,148110,2522,20,Y,N,-,-1,-1
MEMMUS.txt,146233,149038,2805,20,Y,N,-,-1,-1
MEMMUS.txt,146917,149702,2785,20,Y,N,-,-1,-1
MEMMUS.txt,147610,150556,2946,20,Y,N,-,-1,-1
MEMMUS.txt,148112,151313,3201,20,Y,N,-,-1,-1
MEMMUS.txt,149039,151886,2847,20,Y,N,-,-1,-1
MEMMUS.txt,149703,152650,2947,20,Y,N,-,-1,-1
MEMMUS.txt,150557,153273,2716,20,Y,N,-,-1,-1
MEMMUS.txt,151314,153928,2614,20,Y,N,-,-1,-1
MEMMUS.txt,151889,154730,2841,20,Y,Y,1436194630719,153960,154457
MEMMUS.txt,152651,155191,2540,20,Y,Y,1436194630719,153960,154457
MEMMUS.txt,153274,156157,2883,20,Y,Y,1436194630719,153960,154457
MEMMUS.txt,153929,156855,2926,20,Y,Y,1436194630719,153960,154457
MEMMUS.txt,154731,157615,2884,20,Y,N,-,-1,-1
MEMMUS.txt,155192,158297,3105,20,Y,N,-,-1,-1
MEMMUS.txt,156158,159087,2929,20,Y,N,-,-1,-1
MEMMUS.txt,156856,159937,3081,20,Y,N,-,-1,-1
MEMMUS.txt,157616,160584,2968,20,Y,N,-,-1,-1
MEMMUS.txt,158300,161779,3479,20,Y,N,-,-1,-1
MEMMUS.txt,159090,162430,3340,20,Y,N,-,-1,-1
MEMMUS.txt,159938,163431,3493,20,Y,N,-,-1,-1
MEMMUS.txt,160589,164398,3809,20,Y,N,-,-1,-1
MEMMUS.txt,161780,165191,3411,20,Y,N,-,-1,-1
MEMMUS.txt,162433,166038,3605,20,Y,N,-,-1,-1
MEMMUS.txt,163432,166676,3244,20,Y,Y,1436195369775,166223,166802
MEMMUS.txt,164401,167320,2919,20,Y,Y,1436195369775,166223,166802
MEMMUS.txt,165192,168451,3259,20,Y,Y,1436195369775,166223,166802
MEMMUS.txt,166039,168975,2936,20,Y,Y,1436195369775,166223,166802
MEMMUS.txt,166677,169684,3007,20,Y,Y,1436195369775,166223,166802
MEMMUS.txt,167323,170727,3404,20,Y,Y,1436195820165,167327,168540
MEMMUS.txt,168452,171421,2969,20,Y,Y,1436195820165,167327,168540
MEMMUS.txt,168978,172331,3353,20,Y,N,-,-1,-1
MEMMUS.txt,169685,173111,3426,20,Y,N,-,-1,-1
MEMMUS.txt,170730,173799,3069,20,Y,N,-,-1,-1
MEMMUS.txt,171422,174681,3259,20,Y,N,-,-1,-1
MEMMUS.txt,172332,175660,3328,20,Y,N,-,-1,-1
MEMMUS.txt,173112,176473,3361,20,Y,N,-,-1,-1
MEMMUS.txt,173800,177297,3497,20,Y,N,-,-1,-1
MEMMUS.txt,174682,178122,3440,20,Y,N,-,-1,-1
MEMMUS.txt,175661,179727,4066,20,Y,N,-,-1,-1
MEMMUS.txt,176474,180884,4410,20,Y,N,-,-1,-1
MEMMUS.txt,177303,181921,4618,20,Y,Y,1436200836078,181418,182145
MEMMUS.txt,178123,182550,4427,20,Y,Y,1436200836078,181418,182145
MEMMUS.txt,179730,183304,3574,20,Y,Y,1436200836078,181418,182145
MEMMUS.txt,180885,183911,3026,20,Y,Y,1436200836078,181418,182145
MEMMUS.txt,181922,184558,2636,20,Y,Y,1436200836078,181418,182145
MEMMUS.txt,182551,184977,2426,20,Y,Y,1436201256737,183322,184063
MEMMUS.txt,183307,185525,2218,20,Y,Y,1436201256737,183322,184063
MEMMUS.txt,183912,186171,2259,20,Y,Y,1436201256737,183322,184063
MEMMUS.txt,184561,186938,2377,20,Y,Y,1436202482351,186272,186982
MEMMUS.txt,184978,187533,2555,20,Y,Y,1436202482351,186272,186982
MEMMUS.txt,185526,188214,2688,20,Y,Y,1436202482351,186272,186982
MEMMUS.txt,186172,188827,2655,20,Y,Y,1436202482351,186272,186982
MEMMUS.txt,186939,189360,2421,20,Y,Y,1436202482351,186272,186982
MEMMUS.txt,187536,190241,2705,20,Y,N,-,-1,-1
MEMMUS.txt,188217,190577,2360,20,Y,N,-,-1,-1
MEMMUS.txt,188828,191183,2355,20,Y,Y,1436250750453,190583,190982
MEMMUS.txt,189361,191775,2414,20,Y,Y,1436250955725,191454,191936
MEMMUS.txt,190243,192427,2184,20,Y,Y,1436250955725,191454,191936
MEMMUS.txt,190580,193384,2804,20,Y,Y,1436250955725,191454,191936
MEMMUS.txt,191184,194007,2823,20,Y,Y,1436250955725,191454,191936
MEMMUS.txt,191776,194576,2800,20,Y,Y,1436250955725,191454,191936
MEMMUS.txt,192430,195486,3056,20,Y,Y,1436258886793,195179,195770
MEMMUS.txt,193385,196251,2866,20,Y,Y,1436258886793,195179,195770
MEMMUS.txt,194008,197102,3094,20,Y,Y,1436258886793,195179,195770
MEMMUS.txt,194577,197837,3260,20,Y,Y,1436258886793,195179,195770
MEMMUS.txt,195489,198664,3175,20,Y,Y,1436258886793,195179,195770
MEMMUS.txt,196252,199386,3134,20,Y,Y,1436260597356,198665,199131
MEMMUS.txt,197103,200220,3117,20,Y,Y,1436260597356,198665,199131
MEMMUS.txt,197838,201062,3224,20,Y,Y,1436260597356,198665,199131
MEMMUS.txt,198667,201678,3011,20,Y,Y,1436260597356,198665,199131
MEMMUS.txt,199389,202421,3032,20,Y,Y,1436261428542,200089,200824
MEMMUS.txt,200221,203182,2961,20,Y,Y,1436261428542,200089,200824
MEMMUS.txt,201064,204005,2941,20,Y,Y,1436262032838,201561,202518
MEMMUS.txt,201679,204677,2998,20,Y,Y,1436262032838,201561,202518
MEMMUS.txt,202422,205242,2820,20,Y,Y,1436262032838,201561,202518
MEMMUS.txt,203183,206031,2848,20,Y,Y,1436263043874,205904,206889
MEMMUS.txt,204007,206895,2888,20,Y,Y,1436263043874,205904,206889
MEMMUS.txt,204678,207160,2482,20,Y,Y,1436263043874,205904,206889
MEMMUS.txt,205243,207293,2050,20,Y,Y,1436263043874,205904,206889
MEMMUS.txt,206032,207429,1397,20,Y,Y,1436263043874,205904,206889
MEMMUS.txt,206896,207740,844,20,Y,Y,1436263335878,206962,209396
MEMMUS.txt,207161,207955,794,20,Y,Y,1436263335878,206962,209396
MEMMUS.txt,207294,208065,771,20,Y,Y,1436263335878,206962,209396
MEMMUS.txt,207430,208227,797,20,Y,Y,1436263335878,206962,209396
MEMMUS.txt,207741,208351,610,20,Y,Y,1436263335878,206962,209396
MEMMUS.txt,207957,208427,470,20,N,Y,1436263335878,206962,209396
MEMMUS.txt,208066,208579,513,20,N,Y,1436263335878,206962,209396
MEMMUS.txt,208228,208761,533,20,N,Y,1436263335878,206962,209396
MEMMUS.txt,208354,208929,575,20,N,Y,1436263335878,206962,209396
MEMMUS.txt,208428,209244,816,20,Y,Y,1436263335878,206962,209396
MEMMUS.txt,208581,209910,1329,20,Y,Y,1436263335878,206962,209396
MEMMUS.txt,208764,210854,2090,20,Y,Y,1436263335878,206962,209396
MEMMUS.txt,208930,211417,2487,20,Y,Y,1436263335878,206962,209396
MEMMUS.txt,209247,212025,2778,20,Y,Y,1436263335878,206962,209396
MEMMUS.txt,209911,212653,2742,20,Y,N,-,-1,-1
MEMMUS.txt,210855,213808,2953,20,Y,N,-,-1,-1
MEMMUS.txt,211418,214358,2940,20,Y,Y,1436264049561,214305,214870
MEMMUS.txt,212027,215179,3152,20,Y,Y,1436264049561,214305,214870
MEMMUS.txt,212654,215892,3238,20,Y,Y,1436264049561,214305,214870
MEMMUS.txt,213811,216618,2807,20,Y,Y,1436264049561,214305,214870
MEMMUS.txt,214359,217152,2793,20,Y,Y,1436264049561,214305,214870
MEMMUS.txt,215179,217807,2628,20,Y,N,-,-1,-1
MEMMUS.txt,215893,218681,2788,20,Y,N,-,-1,-1
MEMMUS.txt,216619,219451,2832,20,Y,N,-,-1,-1
MEMMUS.txt,217154,220077,2923,20,Y,N,-,-1,-1
MEMMUS.txt,217812,220982,3170,20,Y,N,-,-1,-1
MEMMUS.txt,218682,221697,3015,20,Y,N,-,-1,-1
MEMMUS.txt,219452,222539,3087,20,Y,N,-,-1,-1
MEMMUS.txt,220078,223033,2955,20,Y,N,-,-1,-1
MEMMUS.txt,220985,223533,2548,20,Y,N,-,-1,-1
MEMMUS.txt,221698,224142,2444,20,Y,Y,1436265325522,223973,225467
MEMMUS.txt,222540,224719,2179,20,Y,Y,1436265325522,223973,225467
MEMMUS.txt,223034,225268,2234,20,Y,Y,1436265325522,223973,225467
MEMMUS.txt,223534,225836,2302,20,Y,Y,1436265822598,225579,226125
MEMMUS.txt,224143,226368,2225,20,Y,Y,1436265822598,225579,226125
MEMMUS.txt,224720,226916,2196,20,Y,Y,1436265822598,225579,226125
MEMMUS.txt,225270,227782,2512,20,Y,Y,1436265822598,225579,226125
MEMMUS.txt,225839,228682,2843,20,Y,Y,1436265822598,225579,226125
MEMMUS.txt,226369,229404,3035,20,Y,Y,1436266262307,226191,228765
MEMMUS.txt,226917,230123,3206,20,Y,Y,1436266262307,226191,228765
MEMMUS.txt,227783,230610,2827,20,Y,Y,1436266262307,226191,228765
MEMMUS.txt,228685,231370,2685,20,Y,Y,1436266262307,226191,228765
MEMMUS.txt,229406,232255,2849,20,Y,N,-,-1,-1
MEMMUS.txt,230124,232987,2863,20,Y,N,-,-1,-1
MEMMUS.txt,230611,233765,3154,20,Y,N,-,-1,-1
MEMMUS.txt,231371,234274,2903,20,Y,N,-,-1,-1
MEMMUS.txt,232258,235153,2895,20,Y,N,-,-1,-1
MEMMUS.txt,232988,235735,2747,20,Y,N,-,-1,-1
MEMMUS.txt,233766,236707,2941,20,Y,N,-,-1,-1
MEMMUS.txt,234275,237666,3391,20,Y,N,-,-1,-1
MEMMUS.txt,235154,239035,3881,20,Y,N,-,-1,-1
MEMMUS.txt,235738,239978,4240,20,Y,N,-,-1,-1
MEMMUS.txt,236708,240648,3940,20,Y,Y,1436280456835,240521,241413
MEMMUS.txt,237667,241430,3763,20,Y,Y,1436280456835,240521,241413
MEMMUS.txt,239036,242163,3127,20,Y,Y,1436280456835,240521,241413
MEMMUS.txt,239979,242868,2889,20,Y,Y,1436280456835,240521,241413
MEMMUS.txt,240649,243630,2981,20,Y,Y,1436280789561,243407,244103
MEMMUS.txt,241432,244249,2817,20,Y,Y,1436281042239,244109,244443
MEMMUS.txt,242165,245065,2900,20,Y,Y,1436281042239,244109,244443
MEMMUS.txt,242870,245864,2994,20,Y,Y,1436281325939,245388,246385
MEMMUS.txt,243631,246456,2825,20,Y,Y,1436281325939,245388,246385
MEMMUS.txt,244250,247133,2883,20,Y,Y,1436281325939,245388,246385
MEMMUS.txt,245068,247969,2901,20,Y,Y,1436281325939,245388,246385
MEMMUS.txt,245865,249120,3255,20,Y,Y,1436281325939,245388,246385
MEMMUS.txt,246457,249955,3498,20,Y,Y,1436281535809,247698,249142
MEMMUS.txt,247134,250547,3413,20,Y,Y,1436281897258,250318,251929
MEMMUS.txt,247970,251306,3336,20,Y,Y,1436281897258,250318,251929
MEMMUS.txt,249123,252075,2952,20,Y,Y,1436281897258,250318,251929
MEMMUS.txt,249957,252947,2990,20,Y,Y,1436281897258,250318,251929
MEMMUS.txt,250548,253833,3285,20,Y,Y,1436282192995,253074,254294
MEMMUS.txt,251307,254184,2877,20,Y,Y,1436282192995,253074,254294
MEMMUS.txt,252076,254819,2743,20,Y,Y,1436282192995,253074,254294
MEMMUS.txt,252948,255510,2562,20,Y,Y,1436282192995,253074,254294
MEMMUS.txt,253834,256116,2282,20,Y,Y,1436282192995,253074,254294
MEMMUS.txt,254187,257022,2835,20,Y,Y,1436282192995,253074,254294
MEMMUS.txt,254820,257654,2834,20,Y,N,-,-1,-1
MEMMUS.txt,255511,258552,3041,20,Y,Y,1436282556335,257703,258387
MEMMUS.txt,256117,259594,3477,20,Y,Y,1436282832945,258754,259560
MEMMUS.txt,257025,260197,3172,20,Y,Y,1436282832945,258754,259560
MEMMUS.txt,257655,260839,3184,20,Y,Y,1436283306101,260256,261072
MEMMUS.txt,258553,261469,2916,20,Y,Y,1436283306101,260256,261072
MEMMUS.txt,259595,262130,2535,20,Y,Y,1436283306101,260256,261072
MEMMUS.txt,260200,262645,2445,20,Y,Y,1436283306101,260256,261072
MEMMUS.txt,260842,263598,2756,20,Y,Y,1436283306101,260256,261072
MEMMUS.txt,261470,264366,2896,20,Y,Y,1436283623047,261247,261769
MEMMUS.txt,262131,265065,2934,20,Y,Y,1436284721620,262676,264766
MEMMUS.txt,262648,265958,3310,20,Y,Y,1436284721620,262676,264766
MEMMUS.txt,263601,266740,3139,20,Y,Y,1436284721620,262676,264766
MEMMUS.txt,264367,267480,3113,20,Y,Y,1436284721620,262676,264766
MEMMUS.txt,265066,268080,3014,20,Y,Y,1436423346848,266385,267054
MEMMUS.txt,265959,268821,2862,20,Y,Y,1436423346848,266385,267054
MEMMUS.txt,266741,269679,2938,20,Y,Y,1436423346848,266385,267054
MEMMUS.txt,267481,270345,2864,20,Y,N,-,-1,-1
MEMMUS.txt,268081,270853,2772,20,Y,N,-,-1,-1
MEMMUS.txt,268822,271508,2686,20,Y,N,-,-1,-1
MEMMUS.txt,269680,272386,2706,20,Y,N,-,-1,-1
MEMMUS.txt,270346,273241,2895,20,Y,N,-,-1,-1
MEMMUS.txt,270856,273864,3008,20,Y,N,-,-1,-1
MEMMUS.txt,271509,274204,2695,20,Y,N,-,-1,-1
MEMMUS.txt,272387,275097,2710,20,Y,N,-,-1,-1
MEMMUS.txt,273242,275997,2755,20,Y,N,-,-1,-1
MEMMUS.txt,273865,276789,2924,20,Y,Y,1436423891936,276321,278167
MEMMUS.txt,274205,277541,3336,20,Y,Y,1436423891936,276321,278167
MEMMUS.txt,275099,278240,3141,20,Y,Y,1436423891936,276321,278167
MEMMUS.txt,275998,278942,2944,20,Y,Y,1436423891936,276321,278167
MEMMUS.txt,276790,279509,2719,20,Y,Y,1436423891936,276321,278167
MEMMUS.txt,277542,280105,2563,20,Y,Y,1436423891936,276321,278167
MEMMUS.txt,278243,281000,2757,20,Y,N,-,-1,-1
MEMMUS.txt,278943,281647,2704,20,Y,Y,1436424974663,281505,282511
MEMMUS.txt,279510,282414,2904,20,Y,Y,1436424974663,281505,282511
MEMMUS.txt,280107,283411,3304,20,Y,Y,1436424974663,281505,282511
MEMMUS.txt,281001,284387,3386,20,Y,Y,1436424974663,281505,282511
MEMMUS.txt,281648,285297,3649,20,Y,Y,1436424974663,281505,282511
MEMMUS.txt,282415,286136,3721,20,Y,Y,1436424974663,281505,282511
MEMMUS.txt,283412,287378,3966,20,Y,N,-,-1,-1
MEMMUS.txt,284388,288093,3705,20,Y,N,-,-1,-1
MEMMUS.txt,285298,288940,3642,20,Y,N,-,-1,-1
MEMMUS.txt,286137,289486,3349,20,Y,N,-,-1,-1
MEMMUS.txt,287379,290117,2738,20,Y,N,-,-1,-1
MEMMUS.txt,288094,290837,2743,20,Y,N,-,-1,-1
MEMMUS.txt,288943,291515,2572,20,Y,N,-,-1,-1
MEMMUS.txt,289488,292355,2867,20,Y,N,-,-1,-1
MEMMUS.txt,290118,293163,3045,20,Y,N,-,-1,-1
MEMMUS.txt,290838,293713,2875,20,Y,N,-,-1,-1
MEMMUS.txt,291516,294370,2854,20,Y,N,-,-1,-1
MEMMUS.txt,292358,295172,2814,20,Y,N,-,-1,-1
MEMMUS.txt,293164,295598,2434,20,Y,N,-,-1,-1
MEMMUS.txt,293716,296215,2499,20,Y,N,-,-1,-1
MEMMUS.txt,294373,296890,2517,20,Y,N,-,-1,-1
MEMMUS.txt,295173,297225,2052,20,Y,N,-,-1,-1
MEMMUS.txt,295604,297722,2118,20,Y,N,-,-1,-1
MEMMUS.txt,296218,298181,1963,20,Y,N,-,-1,-1
MEMMUS.txt,296892,298757,1865,20,Y,N,-,-1,-1
MEMMUS.txt,297228,299488,2260,20,Y,N,-,-1,-1
MEMMUS.txt,297723,300407,2684,20,Y,N,-,-1,-1
MEMMUS.txt,298182,301058,2876,20,Y,N,-,-1,-1
MEMMUS.txt,298758,301559,2801,20,Y,N,-,-1,-1
MEMMUS.txt,299489,302069,2580,20,Y,N,-,-1,-1
MEMMUS.txt,300410,302613,2203,20,Y,N,-,-1,-1
MEMMUS.txt,301059,303095,2036,20,Y,N,-,-1,-1
MEMMUS.txt,301561,303733,2172,20,Y,N,-,-1,-1
MEMMUS.txt,302070,304265,2195,20,N,Y,1436432727712,303953,304575
MEMMUS.txt,302614,304682,2068,20,Y,Y,1436432727712,303953,304575
MEMMUS.txt,303096,304987,1891,20,Y,Y,1436432727712,303953,304575
MEMMUS.txt,303734,305605,1871,20,Y,Y,1436432727712,303953,304575
MEMMUS.txt,304266,306192,1926,20,Y,Y,1436432727712,303953,304575
MEMMUS.txt,304683,306904,2221,20,Y,Y,1436433150618,304772,305829
MEMMUS.txt,304989,307932,2943,20,Y,Y,1436433150618,304772,305829
MEMMUS.txt,305606,308655,3049,20,Y,Y,1436433150618,304772,305829
MEMMUS.txt,306193,309375,3182,20,Y,N,-,-1,-1
MEMMUS.txt,306905,310267,3362,20,Y,N,-,-1,-1
MEMMUS.txt,307933,310926,2993,20,Y,N,-,-1,-1
MEMMUS.txt,308658,311723,3065,20,Y,N,-,-1,-1
MEMMUS.txt,309376,312703,3327,20,Y,N,-,-1,-1
MEMMUS.txt,310268,313879,3611,20,Y,N,-,-1,-1
MEMMUS.txt,310927,314644,3717,20,Y,N,-,-1,-1
MEMMUS.txt,311726,315312,3586,20,Y,N,-,-1,-1
MEMMUS.txt,312704,316189,3485,20,Y,N,-,-1,-1
MEMMUS.txt,313880,317172,3292,20,Y,N,-,-1,-1
MEMMUS.txt,314647,318009,3362,20,Y,N,-,-1,-1
MEMMUS.txt,315314,318740,3426,20,Y,N,-,-1,-1
MEMMUS.txt,316190,319544,3354,20,Y,N,-,-1,-1
MEMMUS.txt,317173,320307,3134,20,Y,N,-,-1,-1
MEMMUS.txt,318010,320913,2903,20,Y,N,-,-1,-1
MEMMUS.txt,318743,321335,2592,20,Y,N,-,-1,-1
MEMMUS.txt,319545,322206,2661,20,Y,N,-,-1,-1
MEMMUS.txt,320310,323069,2759,20,Y,N,-,-1,-1
MEMMUS.txt,320914,323830,2916,20,Y,N,-,-1,-1
MEMMUS.txt,321337,324370,3033,20,Y,N,-,-1,-1
MEMMUS.txt,322207,325661,3454,20,Y,N,-,-1,-1
MEMMUS.txt,323072,326486,3414,20,Y,N,-,-1,-1
MEMMUS.txt,323831,327369,3538,20,Y,N,-,-1,-1
MEMMUS.txt,324371,328439,4068,20,Y,N,-,-1,-1
MEMMUS.txt,325663,329204,3541,20,Y,N,-,-1,-1
MEMMUS.txt,326487,329772,3285,20,Y,N,-,-1,-1
MEMMUS.txt,327370,330443,3073,20,Y,N,-,-1,-1
MEMMUS.txt,328442,331544,3102,20,Y,Y,1436434376182,331404,332945
MEMMUS.txt,329205,332347,3142,20,Y,Y,1436434376182,331404,332945
MEMMUS.txt,329773,332958,3185,20,Y,Y,1436434376182,331404,332945
MEMMUS.txt,330446,333551,3105,20,Y,Y,1436434376182,331404,332945
MEMMUS.txt,331545,334004,2459,20,Y,Y,1436434595667,333552,333949
MEMMUS.txt,332349,334699,2350,20,Y,Y,1436434595667,333552,333949
MEMMUS.txt,332961,335225,2264,20,Y,Y,1436434595667,333552,333949
MEMMUS.txt,333554,335772,2218,20,Y,Y,1436434595667,333552,333949
MEMMUS.txt,334007,336879,2872,20,Y,Y,1436434882802,336475,336873
MEMMUS.txt,334700,337767,3067,20,Y,Y,1436435221703,336880,337454
MEMMUS.txt,335226,338372,3146,20,Y,Y,1436435221703,336880,337454
MEMMUS.txt,335773,339162,3389,20,Y,Y,1436435221703,336880,337454
MEMMUS.txt,336882,339678,2796,20,Y,Y,1436435221703,336880,337454
MEMMUS.txt,337768,339998,2230,20,Y,N,-,-1,-1
MEMMUS.txt,338375,340395,2020,20,Y,N,-,-1,-1
MEMMUS.txt,339163,341102,1939,20,Y,Y,1436435912176,340974,341737
MEMMUS.txt,339679,341998,2319,20,Y,Y,1436435912176,340974,341737
MEMMUS.txt,339999,342811,2812,20,Y,Y,1436435912176,340974,341737
MEMMUS.txt,340396,343556,3160,20,Y,Y,1436435912176,340974,341737
MEMMUS.txt,341103,344623,3520,20,Y,Y,1436435912176,340974,341737
MEMMUS.txt,342001,345615,3614,20,Y,N,-,-1,-1
MEMMUS.txt,342814,346314,3500,20,Y,Y,1436436770716,345847,347230
MEMMUS.txt,343559,346932,3373,20,Y,Y,1436436770716,345847,347230
MEMMUS.txt,344624,347192,2568,20,Y,Y,1436436770716,345847,347230
MEMMUS.txt,345616,347703,2087,20,Y,Y,1436436770716,345847,347230
MEMMUS.txt,346315,348412,2097,20,Y,Y,1436436770716,345847,347230
MEMMUS.txt,346933,348912,1979,20,Y,Y,1436436770716,345847,347230
MEMMUS.txt,347193,349632,2439,20,Y,Y,1436436770716,345847,347230
MEMMUS.txt,347704,350035,2331,20,Y,N,-,-1,-1
MEMMUS.txt,348413,350903,2490,20,Y,N,-,-1,-1
MEMMUS.txt,348913,351424,2511,20,Y,N,-,-1,-1
MEMMUS.txt,349633,352071,2438,20,Y,N,-,-1,-1
MEMMUS.txt,350038,352723,2685,20,Y,N,-,-1,-1
MEMMUS.txt,350904,353643,2739,20,Y,N,-,-1,-1
MEMMUS.txt,351425,354603,3178,20,Y,N,-,-1,-1
MEMMUS.txt,352072,355470,3398,20,Y,N,-,-1,-1
MEMMUS.txt,352726,356140,3414,20,Y,N,-,-1,-1
MEMMUS.txt,353644,356963,3319,20,Y,N,-,-1,-1
MEMMUS.txt,354605,357800,3195,20,Y,N,-,-1,-1
MEMMUS.txt,355471,358632,3161,20,Y,N,-,-1,-1
MEMMUS.txt,356141,359233,3092,20,Y,N,-,-1,-1
MEMMUS.txt,356964,359847,2883,20,Y,N,-,-1,-1
MEMMUS.txt,357801,360664,2863,20,Y,Y,1436438224836,360102,360820
MEMMUS.txt,358633,361450,2817,20,Y,Y,1436438224836,360102,360820
MEMMUS.txt,359234,362150,2916,20,Y,Y,1436438224836,360102,360820
MEMMUS.txt,359850,362972,3122,20,Y,Y,1436438560540,362307,362847
MEMMUS.txt,360665,363494,2829,20,Y,Y,1436438560540,362307,362847
MEMMUS.txt,361451,364258,2807,20,Y,Y,1436438560540,362307,362847
MEMMUS.txt,362151,364876,2725,20,Y,Y,1436438560540,362307,362847
MEMMUS.txt,362973,365663,2690,20,Y,N,-,-1,-1
MEMMUS.txt,363497,366168,2671,20,Y,N,-,-1,-1
MEMMUS.txt,364260,366603,2343,20,Y,N,-,-1,-1
MEMMUS.txt,364878,367193,2315,20,Y,Y,1436438967800,366801,367625
MEMMUS.txt,365664,367829,2165,20,Y,Y,1436438967800,366801,367625
MEMMUS.txt,366169,368641,2472,20,Y,Y,1436438967800,366801,367625
MEMMUS.txt,366604,369349,2745,20,Y,Y,1436438967800,366801,367625
MEMMUS.txt,367194,370216,3022,20,Y,Y,1436438967800,366801,367625
MEMMUS.txt,367830,370777,2947,20,Y,N,-,-1,-1
MEMMUS.txt,368642,371176,2534,20,Y,N,-,-1,-1
MEMMUS.txt,369350,371750,2400,20,Y,N,-,-1,-1
MEMMUS.txt,370219,372492,2273,20,Y,N,-,-1,-1
MEMMUS.txt,370779,373110,2331,20,Y,N,-,-1,-1
MEMMUS.txt,371177,373568,2391,20,Y,N,-,-1,-1
MEMMUS.txt,371751,374251,2500,20,Y,N,-,-1,-1
MEMMUS.txt,372494,374935,2441,20,Y,N,-,-1,-1
MEMMUS.txt,373111,375577,2466,20,Y,N,-,-1,-1
MEMMUS.txt,373571,376186,2615,20,Y,N,-,-1,-1
MEMMUS.txt,374253,376688,2435,20,Y,Y,1436444993373,376611,377536
MEMMUS.txt,374936,377403,2467,20,Y,Y,1436444993373,376611,377536
MEMMUS.txt,375578,378247,2669,20,Y,Y,1436445421219,377558,378460
MEMMUS.txt,376188,378818,2630,20,Y,Y,1436445421219,377558,378460
MEMMUS.txt,376689,379766,3077,20,Y,Y,1436445421219,377558,378460
MEMMUS.txt,377404,380651,3247,20,Y,Y,1436445421219,377558,378460
MEMMUS.txt,378248,381467,3219,20,Y,Y,1436445421219,377558,378460
MEMMUS.txt,378819,381913,3094,20,Y,Y,1436445738562,378567,378998
MEMMUS.txt,379769,382806,3037,20,Y,N,-,-1,-1
MEMMUS.txt,380652,383742,3090,20,Y,N,-,-1,-1
MEMMUS.txt,381470,384519,3049,20,Y,N,-,-1,-1
MEMMUS.txt,381916,385213,3297,20,Y,N,-,-1,-1
MEMMUS.txt,382809,385872,3063,20,Y,N,-,-1,-1
MEMMUS.txt,383743,386900,3157,20,Y,N,-,-1,-1
MEMMUS.txt,384520,387850,3330,20,Y,N,-,-1,-1
MEMMUS.txt,385216,388580,3364,20,Y,N,-,-1,-1
MEMMUS.txt,385874,389342,3468,20,Y,N,-,-1,-1
MEMMUS.txt,386903,389878,2975,20,Y,N,-,-1,-1
MEMMUS.txt,387851,390850,2999,20,Y,N,-,-1,-1
MEMMUS.txt,388581,391533,2952,20,Y,N,-,-1,-1
MEMMUS.txt,389343,392252,2909,20,Y,N,-,-1,-1
MEMMUS.txt,389879,393428,3549,20,Y,N,-,-1,-1
MEMMUS.txt,390851,394190,3339,20,Y,N,-,-1,-1
MEMMUS.txt,391534,394938,3404,20,Y,N,-,-1,-1
MEMMUS.txt,392253,395529,3276,20,Y,N,-,-1,-1
MEMMUS.txt,393429,396456,3027,20,Y,N,-,-1,-1
MEMMUS.txt,394191,397296,3105,20,Y,N,-,-1,-1
MEMMUS.txt,394940,398081,3141,20,Y,N,-,-1,-1
MEMMUS.txt,395530,398560,3030,20,Y,N,-,-1,-1
MEMMUS.txt,396457,399306,2849,20,Y,N,-,-1,-1
MEMMUS.txt,397297,400224,2927,20,Y,N,-,-1,-1
MEMMUS.txt,398082,401518,3436,20,Y,N,-,-1,-1
MEMMUS.txt,398561,402133,3572,20,Y,N,-,-1,-1
MEMMUS.txt,399307,402708,3401,20,Y,N,-,-1,-1
MEMMUS.txt,400226,402982,2756,20,Y,N,-,-1,-1
MEMMUS.txt,401521,403068,1547,20,N,N,-,-1,-1
MEMMUS.txt,402134,403132,998,20,N,N,-,-1,-1
MEMMUS.txt,402709,403743,1034,20,N,N,-,-1,-1
MEMMUS.txt,402983,404959,1976,20,N,N,-,-1,-1
MEMMUS.txt,403069,406088,3019,20,Y,N,-,-1,-1
MEMMUS.txt,403135,406973,3838,20,Y,N,-,-1,-1
MEMMUS.txt,403743,407790,4047,20,Y,Y,1436457314337,407582,409801
MEMMUS.txt,404961,408646,3685,20,Y,Y,1436457314337,407582,409801
MEMMUS.txt,406091,409438,3347,20,Y,Y,1436457314337,407582,409801
MEMMUS.txt,406974,410031,3057,20,Y,Y,1436457314337,407582,409801
MEMMUS.txt,407791,411014,3223,20,Y,Y,1436457314337,407582,409801
MEMMUS.txt,408649,411387,2738,20,Y,Y,1436457314337,407582,409801
MEMMUS.txt,409439,412588,3149,20,Y,Y,1436457314337,407582,409801
MEMMUS.txt,410034,413707,3673,20,Y,N,-,-1,-1
MEMMUS.txt,411015,414811,3796,20,Y,N,-,-1,-1
MEMMUS.txt,411388,415599,4211,20,Y,N,-,-1,-1
MEMMUS.txt,412589,416556,3967,20,Y,N,-,-1,-1
MEMMUS.txt,413710,417239,3529,20,Y,N,-,-1,-1
MEMMUS.txt,414812,417854,3042,20,Y,N,-,-1,-1
MEMMUS.txt,415600,418573,2973,20,Y,N,-,-1,-1
MEMMUS.txt,416557,419076,2519,20,Y,N,-,-1,-1
MEMMUS.txt,417242,419654,2412,20,Y,N,-,-1,-1
MEMMUS.txt,417856,420264,2408,20,Y,N,-,-1,-1
MEMMUS.txt,418574,420985,2411,20,Y,N,-,-1,-1
MEMMUS.txt,419077,421740,2663,20,Y,N,-,-1,-1
MEMMUS.txt,419655,422419,2764,20,Y,N,-,-1,-1
MEMMUS.txt,420267,423062,2795,20,Y,N,-,-1,-1
MEMMUS.txt,420986,423684,2698,20,Y,N,-,-1,-1
MEMMUS.txt,421743,424547,2804,20,Y,N,-,-1,-1
MEMMUS.txt,422420,425577,3157,20,Y,N,-,-1,-1
MEMMUS.txt,423065,426650,3585,20,Y,N,-,-1,-1
MEMMUS.txt,423685,427286,3601,20,Y,N,-,-1,-1
MEMMUS.txt,424550,428295,3745,20,Y,N,-,-1,-1
MEMMUS.txt,425580,428827,3247,20,Y,N,-,-1,-1
MEMMUS.txt,426651,429281,2630,20,Y,N,-,-1,-1
MEMMUS.txt,427289,429766,2477,20,Y,N,-,-1,-1
MEMMUS.txt,428296,430136,1840,20,Y,N,-,-1,-1
MEMMUS.txt,428828,432025,3197,20,Y,N,-,-1,-1
MEMMUS.txt,429282,432846,3564,20,Y,N,-,-1,-1
MEMMUS.txt,429767,433229,3462,20,Y,N,-,-1,-1
MEMMUS.txt,430139,433897,3758,20,Y,N,-,-1,-1
MEMMUS.txt,432026,434399,2373,20,Y,N,-,-1,-1
MEMMUS.txt,432847,435414,2567,20,Y,N,-,-1,-1
MEMMUS.txt,433230,435956,2726,20,Y,N,-,-1,-1
MEMMUS.txt,433900,437774,3874,20,Y,Y,1436458374558,436802,437453
MEMMUS.txt,434400,438297,3897,20,Y,Y,1436458807940,438002,438706
MEMMUS.txt,435417,438715,3298,20,Y,Y,1436458807940,438002,438706
MEMMUS.txt,435961,439742,3781,20,Y,Y,1436459343773,439368,440020
MEMMUS.txt,437775,440487,2712,20,Y,Y,1436459343773,439368,440020
MEMMUS.txt,438298,441105,2807,20,Y,Y,1436459343773,439368,440020
MEMMUS.txt,438721,441623,2902,20,Y,Y,1436459343773,439368,440020
MEMMUS.txt,439743,441921,2178,20,Y,Y,1436459343773,439368,440020
MEMMUS.txt,440488,442207,1719,20,Y,N,-,-1,-1
MEMMUS.txt,441107,443057,1950,20,Y,N,-,-1,-1
MEMMUS.txt,441624,443800,2176,20,Y,Y,1436518466769,443385,444821
MEMMUS.txt,441922,444513,2591,20,Y,Y,1436518466769,443385,444821
MEMMUS.txt,442210,445551,3341,20,Y,Y,1436518466769,443385,444821
MEMMUS.txt,443058,446287,3229,20,Y,Y,1436518466769,443385,444821
MEMMUS.txt,443803,447113,3310,20,Y,Y,1436518466769,443385,444821
MEMMUS.txt,444514,447978,3464,20,Y,Y,1436518466769,443385,444821
MEMMUS.txt,445554,448666,3112,20,Y,Y,1436518097111,445361,446096
MEMMUS.txt,446290,449338,3048,20,Y,Y,1436519578396,448667,449299
MEMMUS.txt,447116,450200,3084,20,Y,Y,1436519578396,448667,449299
MEMMUS.txt,447979,450843,2864,20,Y,Y,1436519578396,448667,449299
MEMMUS.txt,448668,451457,2789,20,Y,Y,1436519578396,448667,449299
MEMMUS.txt,449339,452523,3184,20,Y,N,-,-1,-1
MEMMUS.txt,450201,453008,2807,20,Y,Y,1436519953118,452615,453356
MEMMUS.txt,450844,453904,3060,20,Y,Y,1436519953118,452615,453356
MEMMUS.txt,451459,454759,3300,20,Y,Y,1436519953118,452615,453356
MEMMUS.txt,452524,455774,3250,20,Y,Y,1436519953118,452615,453356
MEMMUS.txt,453009,456205,3196,20,Y,Y,1436519953118,452615,453356
MEMMUS.txt,453905,456674,2769,20,Y,N,-,-1,-1
MEMMUS.txt,454760,457308,2548,20,Y,N,-,-1,-1
MEMMUS.txt,455775,457911,2136,20,Y,N,-,-1,-1
MEMMUS.txt,456206,458407,2201,20,Y,N,-,-1,-1
MEMMUS.txt,456675,459256,2581,20,Y,N,-,-1,-1
MEMMUS.txt,457309,459868,2559,20,Y,N,-,-1,-1
MEMMUS.txt,457914,461047,3133,20,Y,N,-,-1,-1
MEMMUS.txt,458408,462140,3732,20,Y,N,-,-1,-1
MEMMUS.txt,459257,462790,3533,20,Y,N,-,-1,-1
MEMMUS.txt,459869,463786,3917,20,Y,N,-,-1,-1
MEMMUS.txt,461048,464387,3339,20,Y,N,-,-1,-1
MEMMUS.txt,462145,465212,3067,20,Y,N,-,-1,-1
MEMMUS.txt,462791,466432,3641,20,Y,N,-,-1,-1
MEMMUS.txt,463787,467129,3342,20,Y,N,-,-1,-1
MEMMUS.txt,464388,467738,3350,20,Y,N,-,-1,-1
MEMMUS.txt,465213,468659,3446,20,Y,N,-,-1,-1
MEMMUS.txt,466435,469530,3095,20,Y,Y,1436521270492,469143,469869
MEMMUS.txt,467130,470285,3155,20,Y,Y,1436521270492,469143,469869
MEMMUS.txt,467739,471298,3559,20,Y,Y,1436521270492,469143,469869
MEMMUS.txt,468662,472216,3554,20,Y,Y,1436521270492,469143,469869
MEMMUS.txt,469531,472865,3334,20,Y,Y,1436521270492,469143,469869
MEMMUS.txt,470286,473554,3268,20,Y,Y,1436522398418,471475,474672
MEMMUS.txt,471300,474535,3235,20,Y,Y,1436522398418,471475,474672
MEMMUS.txt,472217,475505,3288,20,Y,Y,1436522398418,471475,474672
MEMMUS.txt,472866,476599,3733,20,Y,Y,1436522398418,471475,474672
MEMMUS.txt,473555,477173,3618,20,Y,Y,1436522398418,471475,474672
MEMMUS.txt,474538,477753,3215,20,Y,Y,1436522398418,471475,474672
MEMMUS.txt,475507,478422,2915,20,Y,N,-,-1,-1
MEMMUS.txt,476602,479240,2638,20,Y,N,-,-1,-1
MEMMUS.txt,477174,480019,2845,20,Y,N,-,-1,-1
MEMMUS.txt,477754,480087,2333,20,Y,N,-,-1,-1
MEMMUS.txt,478423,480154,1731,20,Y,N,-,-1,-1
MEMMUS.txt,479241,480224,983,20,Y,N,-,-1,-1
MEMMUS.txt,480022,480311,289,20,Y,N,-,-1,-1
MEMMUS.txt,480090,480389,299,20,Y,N,-,-1,-1
MEMMUS.txt,480155,480472,317,20,N,N,-,-1,-1
MEMMUS.txt,480225,480540,315,20,N,N,-,-1,-1
MEMMUS.txt,480312,480692,380,20,N,N,-,-1,-1
MEMMUS.txt,480390,480831,441,20,Y,N,-,-1,-1
MEMMUS.txt,480475,480936,461,20,Y,N,-,-1,-1
MEMMUS.txt,480543,481064,521,20,Y,N,-,-1,-1
MEMMUS.txt,480695,485950,5255,20,Y,N,-,-1,-1
MEMMUS.txt,480834,488061,7227,20,Y,N,-,-1,-1
MEMMUS.txt,480939,491153,10214,20,Y,N,-,-1,-1
MULIFE.txt,0,1604,1604,20,Y,N,-,-1,-1
MULIFE.txt,227,1711,1484,20,Y,N,-,-1,-1
MULIFE.txt,804,1839,1035,20,Y,N,-,-1,-1
MULIFE.txt,1522,1976,454,20,Y,N,-,-1,-1
MULIFE.txt,1605,2049,444,20,Y,N,-,-1,-1
MULIFE.txt,1712,2145,433,20,Y,N,-,-1,-1
MULIFE.txt,1840,2224,384,20,N,N,-,-1,-1
MULIFE.txt,1977,2329,352,20,N,N,-,-1,-1
MULIFE.txt,2050,2487,437,20,Y,N,-,-1,-1
MULIFE.txt,2146,2594,448,20,Y,N,-,-1,-1
MULIFE.txt,2225,2732,507,20,Y,N,-,-1,-1
MULIFE.txt,2330,2827,497,20,Y,N,-,-1,-1
MULIFE.txt,2488,2923,435,20,Y,N,-,-1,-1
MULIFE.txt,2595,3019,424,20,Y,N,-,-1,-1
MULIFE.txt,2733,3137,404,20,Y,N,-,-1,-1
MULIFE.txt,2828,3228,400,20,Y,N,-,-1,-1
MULIFE.txt,2924,3302,378,20,Y,N,-,-1,-1
MULIFE.txt,3020,3366,346,20,Y,N,-,-1,-1
MULIFE.txt,3142,3525,383,20,N,N,-,-1,-1
MULIFE.txt,3229,3652,423,20,Y,N,-,-1,-1
MULIFE.txt,3302,3681,379,20,Y,N,-,-1,-1
MULIFE.txt,3367,3752,385,20,Y,N,-,-1,-1
MULIFE.txt,3526,3901,375,20,Y,N,-,-1,-1
MULIFE.txt,3653,4043,390,20,Y,N,-,-1,-1
MULIFE.txt,3684,4205,521,20,Y,N,-,-1,-1
MULIFE.txt,3753,4347,594,20,Y,N,-,-1,-1
MULIFE.txt,3902,4461,559,20,Y,N,-,-1,-1
MULIFE.txt,4044,4565,521,20,Y,N,-,-1,-1
MULIFE.txt,4206,4734,528,20,Y,N,-,-1,-1
MULIFE.txt,4348,4819,471,20,Y,N,-,-1,-1
MULIFE.txt,4464,5014,550,20,Y,N,-,-1,-1
MULIFE.txt,4566,5227,661,20,Y,N,-,-1,-1
MULIFE.txt,4735,5352,617,20,Y,N,-,-1,-1
MULIFE.txt,4820,5505,685,20,Y,N,-,-1,-1
MULIFE.txt,5015,5582,567,20,Y,N,-,-1,-1
MULIFE.txt,5228,5673,445,20,Y,N,-,-1,-1
MULIFE.txt,5353,5756,403,20,Y,N,-,-1,-1
MULIFE.txt,5506,5875,369,20,Y,N,-,-1,-1
MULIFE.txt,5583,6007,424,20,Y,N,-,-1,-1
MULIFE.txt,5674,6169,495,20,Y,N,-,-1,-1
MULIFE.txt,5757,6308,551,20,Y,N,-,-1,-1
MULIFE.txt,5876,6470,594,20,Y,N,-,-1,-1
MULIFE.txt,6008,6639,631,20,Y,N,-,-1,-1
MULIFE.txt,6170,6778,608,20,Y,N,-,-1,-1
MULIFE.txt,6309,6910,601,20,Y,N,-,-1,-1
MULIFE.txt,6470,7076,606,20,Y,N,-,-1,-1
MULIFE.txt,6640,7131,491,20,Y,N,-,-1,-1
MULIFE.txt,6779,7286,507,20,Y,N,-,-1,-1
MULIFE.txt,6911,7420,509,20,Y,N,-,-1,-1
MULIFE.txt,7077,7571,494,20,Y,N,-,-1,-1
MULIFE.txt,7132,7690,558,20,N,N,-,-1,-1
MULIFE.txt,7287,7830,543,20,N,N,-,-1,-1
MULIFE.txt,7421,8004,583,20,Y,N,-,-1,-1
MULIFE.txt,7572,8060,488,20,Y,N,-,-1,-1
MULIFE.txt,7691,8156,465,20,Y,N,-,-1,-1
MULIFE.txt,7831,8250,419,20,Y,N,-,-1,-1
MULIFE.txt,8005,8361,356,20,N,N,-,-1,-1
MULIFE.txt,8061,8521,460,20,N,N,-,-1,-1
MULIFE.txt,8157,8658,501,20,N,N,-,-1,-1
MULIFE.txt,8251,8800,549,20,N,N,-,-1,-1
MULIFE.txt,8362,8920,558,20,N,N,-,-1,-1
MULIFE.txt,8522,9074,552,20,N,N,-,-1,-1
MULIFE.txt,8659,9235,576,20,N,N,-,-1,-1
MULIFE.txt,8801,9459,658,20,N,N,-,-1,-1
MULIFE.txt,8921,9628,707,20,N,N,-,-1,-1
MULIFE.txt,9075,9823,748,20,N,N,-,-1,-1
MULIFE.txt,9236,9999,763,20,N,N,-,-1,-1
MULIFE.txt,9460,10165,705,20,N,N,-,-1,-1
MULIFE.txt,9629,10370,741,20,N,N,-,-1,-1
MULIFE.txt,9824,10505,681,20,N,N,-,-1,-1
MULIFE.txt,10000,10595,595,20,N,N,-,-1,-1
MULIFE.txt,10166,10725,559,20,N,N,-,-1,-1
MULIFE.txt,10371,10821,450,20,N,N,-,-1,-1
MULIFE.txt,10506,10886,380,20,N,N,-,-1,-1
MULIFE.txt,10596,10996,400,20,N,N,-,-1,-1
MULIFE.txt,10726,11069,343,20,N,N,-,-1,-1
MULIFE.txt,10824,11131,307,20,N,N,-,-1,-1
MULIFE.txt,10887,11283,396,20,N,N,-,-1,-1
MULIFE.txt,10997,11427,430,20,N,N,-,-1,-1
MULIFE.txt,11069,11586,517,20,N,N,-,-1,-1
MULIFE.txt,11132,11713,581,20,N,N,-,-1,-1
MULIFE.txt,11283,11834,551,20,N,N,-,-1,-1
MULIFE.txt,11428,11945,517,20,N,N,-,-1,-1
MULIFE.txt,11587,12050,463,20,Y,N,-,-1,-1
MULIFE.txt,11714,12167,453,20,Y,N,-,-1,-1
MULIFE.txt,11835,12282,447,20,Y,N,-,-1,-1
MULIFE.txt,11946,12431,485,20,Y,N,-,-1,-1
MULIFE.txt,12051,12512,461,20,Y,N,-,-1,-1
MULIFE.txt,12168,12580,412,20,Y,N,-,-1,-1
MULIFE.txt,12283,12750,467,20,Y,N,-,-1,-1
MULIFE.txt,12434,12899,465,20,Y,N,-,-1,-1
MULIFE.txt,12513,13087,574,20,Y,N,-,-1,-1
MULIFE.txt,12581,13228,647,20,Y,N,-,-1,-1
MULIFE.txt,12751,13380,629,20,Y,N,-,-1,-1
MULIFE.txt,12900,13555,655,20,Y,N,-,-1,-1
MULIFE.txt,13088,13728,640,20,Y,N,-,-1,-1
MULIFE.txt,13229,13873,644,20,Y,N,-,-1,-1
MULIFE.txt,13381,13990,609,20,Y,N,-,-1,-1
MULIFE.txt,13556,14115,559,20,Y,N,-,-1,-1
MULIFE.txt,13729,14240,511,20,Y,N,-,-1,-1
MULIFE.txt,13876,14421,545,20,Y,N,-,-1,-1
MULIFE.txt,13991,14562,571,20,Y,N,-,-1,-1
MULIFE.txt,14116,14711,595,20,Y,N,-,-1,-1
MULIFE.txt,14241,14854,613,20,Y,N,-,-1,-1
MULIFE.txt,14422,14967,545,20,Y,N,-,-1,-1
MULIFE.txt,14563,15092,529,20,Y,N,-,-1,-1
MULIFE.txt,14712,15183,471,20,Y,N,-,-1,-1
MULIFE.txt,14855,15340,485,20,N,N,-,-1,-1
MULIFE.txt,14968,15501,533,20,Y,N,-,-1,-1
MULIFE.txt,15093,15632,539,20,N,N,-,-1,-1
MULIFE.txt,15184,15757,573,20,N,N,-,-1,-1
MULIFE.txt,15341,15900,559,20,N,N,-,-1,-1
MULIFE.txt,15502,16035,533,20,N,N,-,-1,-1
MULIFE.txt,15633,16203,570,20,N,N,-,-1,-1
MULIFE.txt,15758,16286,528,20,N,N,-,-1,-1
MULIFE.txt,15901,16429,528,20,N,N,-,-1,-1
MULIFE.txt,16036,16515,479,20,N,N,-,-1,-1
MULIFE.txt,16204,16677,473,20,Y,N,-,-1,-1
MULIFE.txt,16287,16763,476,20,Y,N,-,-1,-1
MULIFE.txt,16430,16921,491,20,Y,N,-,-1,-1
MULIFE.txt,16516,17075,559,20,Y,N,-,-1,-1
MULIFE.txt,16678,17174,496,20,Y,N,-,-1,-1
MULIFE.txt,16764,17335,571,20,N,N,-,-1,-1
MULIFE.txt,16922,17462,540,20,Y,N,-,-1,-1
MULIFE.txt,17076,17557,481,20,Y,N,-,-1,-1
MULIFE.txt,17175,17675,500,20,Y,N,-,-1,-1
MULIFE.txt,17336,17817,481,20,Y,N,-,-1,-1
MULIFE.txt,17463,17965,502,20,Y,N,-,-1,-1
MULIFE.txt,17558,18050,492,20,Y,N,-,-1,-1
MULIFE.txt,17676,18209,533,20,N,N,-,-1,-1
MULIFE.txt,17818,18347,529,20,N,N,-,-1,-1
MULIFE.txt,17968,18451,483,20,N,N,-,-1,-1
MULIFE.txt,18051,18616,565,20,N,N,-,-1,-1
MULIFE.txt,18210,18746,536,20,N,N,-,-1,-1
MULIFE.txt,18348,18833,485,20,N,N,-,-1,-1
MULIFE.txt,18452,18946,494,20,N,N,-,-1,-1
MULIFE.txt,18617,19050,433,20,N,N,-,-1,-1
MULIFE.txt,18749,19194,445,20,N,N,-,-1,-1
MULIFE.txt,18834,19313,479,20,N,N,-,-1,-1
MULIFE.txt,18947,19431,484,20,N,N,-,-1,-1
MULIFE.txt,19051,19540,489,20,N,N,-,-1,-1
MULIFE.txt,19195,19658,463,20,N,N,-,-1,-1
MULIFE.txt,19314,19771,457,20,N,N,-,-1,-1
MULIFE.txt,19432,19877,445,20,Y,N,-,-1,-1
MULIFE.txt,19541,19982,441,20,Y,N,-,-1,-1
MULIFE.txt,19659,20129,470,20,Y,N,-,-1,-1
MULIFE.txt,19772,20246,474,20,Y,N,-,-1,-1
MULIFE.txt,19878,20331,453,20,Y,N,-,-1,-1
MULIFE.txt,19985,20422,437,20,Y,N,-,-1,-1
MULIFE.txt,20130,20600,470,20,Y,N,-,-1,-1
MULIFE.txt,20247,20754,507,20,Y,N,-,-1,-1
MULIFE.txt,20332,20958,626,20,Y,N,-,-1,-1
MULIFE.txt,20423,21134,711,20,Y,N,-,-1,-1
MULIFE.txt,20601,21294,693,20,Y,N,-,-1,-1
MULIFE.txt,20755,21397,642,20,Y,N,-,-1,-1
MULIFE.txt,20959,21506,547,20,Y,N,-,-1,-1
MULIFE.txt,21135,21657,522,20,Y,N,-,-1,-1
MULIFE.txt,21295,21852,557,20,Y,N,-,-1,-1
MULIFE.txt,21398,21977,579,20,Y,N,-,-1,-1
MULIFE.txt,21507,22212,705,20,Y,N,-,-1,-1
MULIFE.txt,21658,22744,1086,20,Y,N,-,-1,-1
MULIFE.txt,21853,23027,1174,20,Y,N,-,-1,-1
MULIFE.txt,21978,23639,1661,20,Y,N,-,-1,-1
MULIFE.txt,22213,24323,2110,20,Y,N,-,-1,-1
MULIFE.txt,22745,24620,1875,20,Y,N,-,-1,-1
MULIFE.txt,23028,24952,1924,20,Y,N,-,-1,-1
MULIFE.txt,23642,25421,1779,20,N,N,-,-1,-1
MULIFE.txt,24324,25732,1408,20,N,N,-,-1,-1
MULIFE.txt,24623,26589,1966,20,N,N,-,-1,-1
MULIFE.txt,24955,27265,2310,20,N,N,-,-1,-1
MULIFE.txt,25421,27682,2261,20,N,N,-,-1,-1
MULIFE.txt,25735,28224,2489,20,Y,N,-,-1,-1
MULIFE.txt,26590,28518,1928,20,Y,N,-,-1,-1
MULIFE.txt,27268,29060,1792,20,Y,N,-,-1,-1
MULIFE.txt,27683,29755,2072,20,Y,N,-,-1,-1
MULIFE.txt,28226,30895,2669,20,Y,N,-,-1,-1
MULIFE.txt,28519,31623,3104,20,Y,N,-,-1,-1
MULIFE.txt,29061,31919,2858,20,Y,N,-,-1,-1
MULIFE.txt,29756,32737,2981,20,Y,N,-,-1,-1
MULIFE.txt,30896,33464,2568,20,Y,Y,1437637327937,33188,35197
MULIFE.txt,31624,34062,2438,20,Y,Y,1437637327937,33188,35197
MULIFE.txt,31921,34806,2885,20,Y,Y,1437637327937,33188,35197
MULIFE.txt,32738,35255,2517,20,Y,Y,1437637327937,33188,35197
MULIFE.txt,33465,35666,2201,20,Y,Y,1437642866570,35507,37282
MULIFE.txt,34063,36468,2405,20,Y,Y,1437642866570,35507,37282
MULIFE.txt,34807,37075,2268,20,Y,Y,1437642866570,35507,37282
MULIFE.txt,35256,37417,2161,20,Y,Y,1437642866570,35507,37282
MULIFE.txt,35667,38120,2453,20,Y,Y,1437642866570,35507,37282
MULIFE.txt,36469,38748,2279,20,Y,Y,1437642866570,35507,37282
MULIFE.txt,37076,39188,2112,20,Y,Y,1437642866570,35507,37282
MULIFE.txt,37418,39817,2399,20,Y,Y,1437643218811,39345,39813
MULIFE.txt,38121,40240,2119,20,Y,Y,1437643218811,39345,39813
MULIFE.txt,38749,40538,1789,20,Y,Y,1437643218811,39345,39813
MULIFE.txt,39189,40905,1716,20,Y,Y,1437643218811,39345,39813
MULIFE.txt,39819,41316,1497,20,Y,Y,1437643552468,40385,41243
MULIFE.txt,40241,41630,1389,20,Y,Y,1437643552468,40385,41243
MULIFE.txt,40539,42598,2059,20,Y,Y,1437643552468,40385,41243
MULIFE.txt,40906,43305,2399,20,Y,Y,1437643552468,40385,41243
MULIFE.txt,41317,43967,2650,20,Y,N,-,-1,-1
MULIFE.txt,41631,44720,3089,20,Y,N,-,-1,-1
MULIFE.txt,42601,45078,2477,20,Y,N,-,-1,-1
MULIFE.txt,43308,45667,2359,20,Y,N,-,-1,-1
MULIFE.txt,43968,46317,2349,20,Y,N,-,-1,-1
MULIFE.txt,44721,46994,2273,20,Y,N,-,-1,-1
MULIFE.txt,45079,47348,2269,20,Y,N,-,-1,-1
MULIFE.txt,45668,47968,2300,20,Y,N,-,-1,-1
MULIFE.txt,46319,48292,1973,20,Y,N,-,-1,-1
MULIFE.txt,46995,48788,1793,20,Y,N,-,-1,-1
MULIFE.txt,47349,49487,2138,20,Y,N,-,-1,-1
MULIFE.txt,47969,49845,1876,20,Y,N,-,-1,-1
MULIFE.txt,48293,50622,2329,20,Y,Y,1437644129613,50016,51209
MULIFE.txt,48789,51275,2486,20,Y,Y,1437644129613,50016,51209
MULIFE.txt,49488,51592,2104,20,Y,Y,1437644129613,50016,51209
MULIFE.txt,49846,51988,2142,20,Y,Y,1437644129613,50016,51209
MULIFE.txt,50624,52533,1909,20,Y,Y,1437644129613,50016,51209
MULIFE.txt,51276,53016,1740,20,Y,N,-,-1,-1
MULIFE.txt,51593,53632,2039,20,Y,N,-,-1,-1
MULIFE.txt,51991,53955,1964,20,Y,Y,1437644802503,53881,55535
MULIFE.txt,52534,54845,2311,20,Y,Y,1437644802503,53881,55535
MULIFE.txt,53017,55286,2269,20,Y,Y,1437644802503,53881,55535
MULIFE.txt,53633,55924,2291,20,Y,Y,1437670019221,55738,57876
MULIFE.txt,53956,56477,2521,20,Y,Y,1437670019221,55738,57876
MULIFE.txt,54846,56946,2100,20,Y,Y,1437670019221,55738,57876
MULIFE.txt,55288,57905,2617,20,Y,Y,1437670019221,55738,57876
MULIFE.txt,55925,58401,2476,20,Y,Y,1437670019221,55738,57876
MULIFE.txt,56478,58931,2453,20,Y,Y,1437670019221,55738,57876
MULIFE.txt,56948,59324,2376,20,Y,Y,1437670019221,55738,57876
MULIFE.txt,57906,60093,2187,20,Y,Y,1437670482083,58835,59579
MULIFE.txt,58402,60585,2183,20,Y,Y,1437670482083,58835,59579
MULIFE.txt,58934,61014,2080,20,Y,Y,1437670482083,58835,59579
MULIFE.txt,59325,61192,1867,20,Y,Y,1437670482083,58835,59579
MULIFE.txt,60094,61872,1778,20,Y,N,-,-1,-1
MULIFE.txt,60586,62743,2157,20,Y,N,-,-1,-1
MULIFE.txt,61017,63099,2082,20,Y,N,-,-1,-1
MULIFE.txt,61193,63571,2378,20,Y,N,-,-1,-1
MULIFE.txt,61873,64008,2135,20,Y,Y,1437671026479,63906,64392
MULIFE.txt,62746,64767,2021,20,Y,Y,1437671026479,63906,64392
MULIFE.txt,63100,65381,2281,20,Y,Y,1437671026479,63906,64392
MULIFE.txt,63572,65852,2280,20,Y,Y,1437671026479,63906,64392
MULIFE.txt,64009,66709,2700,20,Y,Y,1437671026479,63906,64392
MULIFE.txt,64770,67852,3082,20,Y,N,-,-1,-1
MULIFE.txt,65382,68237,2855,20,Y,N,-,-1,-1
MULIFE.txt,65855,68552,2697,20,Y,N,-,-1,-1
MULIFE.txt,66712,68877,2165,20,Y,N,-,-1,-1
MULIFE.txt,67855,68995,1140,20,Y,N,-,-1,-1
MULIFE.txt,68238,69308,1070,20,Y,N,-,-1,-1
MULIFE.txt,68557,69742,1185,20,Y,N,-,-1,-1
MULIFE.txt,68878,70325,1447,20,Y,N,-,-1,-1
MULIFE.txt,68996,70970,1974,20,Y,N,-,-1,-1
MULIFE.txt,69309,71497,2188,20,Y,N,-,-1,-1
MULIFE.txt,69743,71991,2248,20,Y,N,-,-1,-1
MULIFE.txt,70326,72631,2305,20,Y,N,-,-1,-1
MULIFE.txt,70973,73006,2033,20,Y,N,-,-1,-1
MULIFE.txt,71498,73336,1838,20,Y,N,-,-1,-1
MULIFE.txt,71992,73645,1653,20,Y,N,-,-1,-1
MULIFE.txt,72633,74507,1874,20,Y,Y,1437671604320,74249,75453
MULIFE.txt,73007,74878,1871,20,Y,Y,1437671604320,74249,75453
MULIFE.txt,73337,75474,2137,20,Y,Y,1437671604320,74249,75453
MULIFE.txt,73647,76371,2724,20,Y,Y,1437672056241,76209,76827
MULIFE.txt,74510,77045,2535,20,Y,Y,1437672056241,76209,76827
MULIFE.txt,74879,77666,2787,20,Y,Y,1437672056241,76209,76827
MULIFE.txt,75475,77929,2454,20,Y,Y,1437672056241,76209,76827
MULIFE.txt,76374,78386,2012,20,Y,Y,1437672056241,76209,76827
MULIFE.txt,77046,79287,2241,20,Y,N,-,-1,-1
MULIFE.txt,77667,79976,2309,20,Y,N,-,-1,-1
MULIFE.txt,77930,80313,2383,20,Y,N,-,-1,-1
MULIFE.txt,78387,80727,2340,20,Y,N,-,-1,-1
MULIFE.txt,79288,81456,2168,20,Y,N,-,-1,-1
MULIFE.txt,79979,81849,1870,20,Y,N,-,-1,-1
MULIFE.txt,80314,82363,2049,20,Y,N,-,-1,-1
MULIFE.txt,80728,83171,2443,20,Y,Y,1437672626512,82770,83334
MULIFE.txt,81458,83673,2215,20,Y,Y,1437672626512,82770,83334
MULIFE.txt,81850,84168,2318,20,Y,Y,1437672626512,82770,83334
MULIFE.txt,82366,84752,2386,20,Y,Y,1437672626512,82770,83334
MULIFE.txt,83172,85247,2075,20,Y,Y,1437672626512,82770,83334
MULIFE.txt,83674,85705,2031,20,Y,N,-,-1,-1
MULIFE.txt,84169,86472,2303,20,Y,N,-,-1,-1
MULIFE.txt,84753,87003,2250,20,Y,N,-,-1,-1
MULIFE.txt,85248,87413,2165,20,Y,N,-,-1,-1
MULIFE.txt,85706,87915,2209,20,Y,N,-,-1,-1
MULIFE.txt,86473,88792,2319,20,Y,N,-,-1,-1
MULIFE.txt,87004,89200,2196,20,Y,N,-,-1,-1
MULIFE.txt,87414,89577,2163,20,Y,N,-,-1,-1
MULIFE.txt,87918,89894,1976,20,Y,N,-,-1,-1
MULIFE.txt,88793,90438,1645,20,Y,N,-,-1,-1
MULIFE.txt,89202,91170,1968,20,Y,N,-,-1,-1
MULIFE.txt,89578,91715,2137,20,Y,N,-,-1,-1
MULIFE.txt,89895,92254,2359,20,Y,N,-,-1,-1
MULIFE.txt,90439,93044,2605,20,Y,N,-,-1,-1
MULIFE.txt,91173,93592,2419,20,Y,N,-,-1,-1
MULIFE.txt,91716,94202,2486,20,Y,N,-,-1,-1
MULIFE.txt,92255,94969,2714,20,Y,N,-,-1,-1
MULIFE.txt,93045,95707,2662,20,Y,N,-,-1,-1
MULIFE.txt,93593,96253,2660,20,Y,N,-,-1,-1
MULIFE.txt,94203,96707,2504,20,Y,N,-,-1,-1
MULIFE.txt,94970,97290,2320,20,Y,N,-,-1,-1
MULIFE.txt,95710,97957,2247,20,Y,N,-,-1,-1
MULIFE.txt,96254,98416,2162,20,Y,N,-,-1,-1
MULIFE.txt,96708,98664,1956,20,Y,N,-,-1,-1
MULIFE.txt,97291,99030,1739,20,Y,N,-,-1,-1
MULIFE.txt,97958,99776,1818,20,N,N,-,-1,-1
MULIFE.txt,98417,100329,1912,20,N,N,-,-1,-1
MULIFE.txt,98665,100805,2140,20,N,N,-,-1,-1
MULIFE.txt,99031,101076,2045,20,N,N,-,-1,-1
MULIFE.txt,99777,101316,1539,20,N,N,-,-1,-1
MULIFE.txt,100330,101900,1570,20,N,N,-,-1,-1
MULIFE.txt,100806,102127,1321,20,N,N,-,-1,-1
MULIFE.txt,101077,102377,1300,20,N,N,-,-1,-1
MULIFE.txt,101319,102963,1644,20,N,N,-,-1,-1
MULIFE.txt,101901,103338,1437,20,N,N,-,-1,-1
MULIFE.txt,102128,104107,1979,20,N,N,-,-1,-1
MULIFE.txt,102378,104287,1909,20,Y,N,-,-1,-1
MULIFE.txt,102966,104840,1874,20,Y,N,-,-1,-1
MULIFE.txt,103341,105054,1713,20,Y,N,-,-1,-1
MULIFE.txt,104108,105398,1290,20,Y,N,-,-1,-1
MULIFE.txt,104288,105728,1440,20,N,N,-,-1,-1
MULIFE.txt,104843,106108,1265,20,N,N,-,-1,-1
MULIFE.txt,105055,106524,1469,20,N,N,-,-1,-1
MULIFE.txt,105401,107055,1654,20,N,N,-,-1,-1
MULIFE.txt,105731,107597,1866,20,N,N,-,-1,-1
MULIFE.txt,106109,108191,2082,20,N,N,-,-1,-1
MULIFE.txt,106525,108645,2120,20,N,N,-,-1,-1
MULIFE.txt,107056,109018,1962,20,N,N,-,-1,-1
MULIFE.txt,107600,109757,2157,20,N,N,-,-1,-1
MULIFE.txt,108194,110241,2047,20,N,N,-,-1,-1
MULIFE.txt,108650,110714,2064,20,Y,N,-,-1,-1
MULIFE.txt,109020,111659,2639,20,Y,N,-,-1,-1
MULIFE.txt,109758,111975,2217,20,Y,N,-,-1,-1
MULIFE.txt,110242,112262,2020,20,Y,N,-,-1,-1
MULIFE.txt,110717,112515,1798,20,Y,N,-,-1,-1
MULIFE.txt,111662,112864,1202,20,Y,N,-,-1,-1
MULIFE.txt,111976,113286,1310,20,Y,N,-,-1,-1
MULIFE.txt,112263,113847,1584,20,Y,N,-,-1,-1
MULIFE.txt,112516,114226,1710,20,Y,N,-,-1,-1
MULIFE.txt,112866,115033,2167,20,Y,Y,1437727565787,114231,114741
MULIFE.txt,113287,115484,2197,20,Y,Y,1437727565787,114231,114741
MULIFE.txt,113849,116213,2364,20,Y,Y,1437727565787,114231,114741
MULIFE.txt,114229,116866,2637,20,Y,Y,1437727565787,114231,114741
MULIFE.txt,115035,117160,2125,20,Y,Y,1437728842716,115343,116376
MULIFE.txt,115485,117690,2205,20,Y,Y,1437728842716,115343,116376
MULIFE.txt,116214,118659,2445,20,Y,Y,1437728842716,115343,116376
MULIFE.txt,116867,119217,2350,20,Y,Y,1437729348025,117608,118272
MULIFE.txt,117161,119489,2328,20,Y,Y,1437729348025,117608,118272
MULIFE.txt,117691,120023,2332,20,Y,Y,1437729348025,117608,118272
MULIFE.txt,118660,120397,1737,20,Y,N,-,-1,-1
MULIFE.txt,119218,120774,1556,20,Y,N,-,-1,-1
MULIFE.txt,119490,121460,1970,20,Y,N,-,-1,-1
MULIFE.txt,120026,122042,2016,20,Y,N,-,-1,-1
MULIFE.txt,120398,122418,2020,20,Y,N,-,-1,-1
MULIFE.txt,120776,122902,2126,20,Y,N,-,-1,-1
MULIFE.txt,121463,123120,1657,20,Y,N,-,-1,-1
MULIFE.txt,122043,123338,1295,20,Y,N,-,-1,-1
MULIFE.txt,122419,123500,1081,20,Y,N,-,-1,-1
MULIFE.txt,122904,123958,1054,20,Y,N,-,-1,-1
MULIFE.txt,123121,124693,1572,20,Y,N,-,-1,-1
MULIFE.txt,123339,125398,2059,20,Y,N,-,-1,-1
MULIFE.txt,123501,126111,2610,20,Y,N,-,-1,-1
MULIFE.txt,123959,126635,2676,20,Y,N,-,-1,-1
MULIFE.txt,124694,127286,2592,20,Y,N,-,-1,-1
MULIFE.txt,125399,127883,2484,20,Y,Y,1437729941282,127304,128704
MULIFE.txt,126112,128768,2656,20,Y,Y,1437729941282,127304,128704
MULIFE.txt,126636,129396,2760,20,Y,Y,1437729941282,127304,128704
MULIFE.txt,127289,129913,2624,20,Y,Y,1437729941282,127304,128704
MULIFE.txt,127884,130697,2813,20,Y,Y,1437729941282,127304,128704
MULIFE.txt,128771,130805,2034,20,Y,Y,1437730322242,128854,129770
MULIFE.txt,129397,131016,1619,20,Y,Y,1437730322242,128854,129770
MULIFE.txt,129915,131279,1364,20,N,N,-,-1,-1
MULIFE.txt,130702,131732,1030,20,N,N,-,-1,-1
MULIFE.txt,130806,132305,1499,20,N,N,-,-1,-1
MULIFE.txt,131017,132660,1643,20,N,N,-,-1,-1
MULIFE.txt,131281,133259,1978,20,N,N,-,-1,-1
MULIFE.txt,131734,133476,1742,20,N,N,-,-1,-1
MULIFE.txt,132306,133958,1652,20,N,N,-,-1,-1
MULIFE.txt,132661,134491,1830,20,N,N,-,-1,-1
MULIFE.txt,133260,135036,1776,20,N,N,-,-1,-1
MULIFE.txt,133477,136084,2607,20,N,N,-,-1,-1
MULIFE.txt,133959,136595,2636,20,Y,N,-,-1,-1
MULIFE.txt,134492,137126,2634,20,Y,Y,1437731100795,137101,140058
MULIFE.txt,135037,137243,2206,20,Y,Y,1437731100795,137101,140058
MULIFE.txt,136085,138030,1945,20,Y,Y,1437731100795,137101,140058
MULIFE.txt,136596,138884,2288,20,Y,Y,1437731100795,137101,140058
MULIFE.txt,137127,139875,2748,20,Y,Y,1437731100795,137101,140058
MULIFE.txt,137244,140441,3197,20,Y,Y,1437731100795,137101,140058
MULIFE.txt,138033,140953,2920,20,Y,Y,1437731100795,137101,140058
MULIFE.txt,138885,141942,3057,20,Y,Y,1437731100795,137101,140058
MULIFE.txt,139876,142141,2265,20,Y,Y,1437731100795,137101,140058
MULIFE.txt,140442,142589,2147,20,Y,Y,1437732462096,142028,144946
MULIFE.txt,140956,143118,2162,20,Y,Y,1437732462096,142028,144946
MULIFE.txt,141943,143481,1538,20,Y,Y,1437732462096,142028,144946
MULIFE.txt,142142,143746,1604,20,Y,Y,1437732462096,142028,144946
MULIFE.txt,142590,144571,1981,20,Y,Y,1437732462096,142028,144946
MULIFE.txt,143119,145405,2286,20,Y,Y,1437732462096,142028,144946
MULIFE.txt,143483,146085,2602,20,Y,Y,1437732462096,142028,144946
MULIFE.txt,143747,146702,2955,20,Y,Y,1437732462096,142028,144946
MULIFE.txt,144572,147259,2687,20,Y,Y,1437732462096,142028,144946
MULIFE.txt,145406,147832,2426,20,Y,N,-,-1,-1
MULIFE.txt,146086,148412,2326,20,Y,N,-,-1,-1
MULIFE.txt,146703,149012,2309,20,Y,N,-,-1,-1
MULIFE.txt,147260,149541,2281,20,Y,N,-,-1,-1
MULIFE.txt,147833,150238,2405,20,Y,N,-,-1,-1
MULIFE.txt,148413,151142,2729,20,Y,N,-,-1,-1
MULIFE.txt,149014,151780,2766,20,Y,N,-,-1,-1
MULIFE.txt,149543,152489,2946,20,N,N,-,-1,-1
MULIFE.txt,150240,152920,2680,20,Y,N,-,-1,-1
MULIFE.txt,151145,153387,2242,20,Y,N,-,-1,-1
MULIFE.txt,151781,154003,2222,20,N,N,-,-1,-1
MULIFE.txt,152490,154287,1797,20,N,N,-,-1,-1
MULIFE.txt,152921,155028,2107,20,N,N,-,-1,-1
MULIFE.txt,153388,155155,1767,20,N,N,-,-1,-1
MULIFE.txt,154006,155369,1363,20,N,N,-,-1,-1
MULIFE.txt,154288,155638,1350,20,Y,N,-,-1,-1
MULIFE.txt,155029,156045,1016,20,Y,N,-,-1,-1
MULIFE.txt,155156,156515,1359,20,Y,N,-,-1,-1
MULIFE.txt,155371,156860,1489,20,Y,N,-,-1,-1
MULIFE.txt,155639,157123,1484,20,Y,N,-,-1,-1
MULIFE.txt,156046,157773,1727,20,Y,N,-,-1,-1
MULIFE.txt,156516,158647,2131,20,Y,N,-,-1,-1
MULIFE.txt,156861,158950,2089,20,Y,N,-,-1,-1
MULIFE.txt,157124,159896,2772,20,Y,N,-,-1,-1
MULIFE.txt,157774,160372,2598,20,Y,N,-,-1,-1
MULIFE.txt,158649,161114,2465,20,Y,N,-,-1,-1
MULIFE.txt,158951,161827,2876,20,Y,N,-,-1,-1
MULIFE.txt,159897,162457,2560,20,Y,N,-,-1,-1
MULIFE.txt,160373,162847,2474,20,Y,N,-,-1,-1
MULIFE.txt,161116,163232,2116,20,Y,N,-,-1,-1
MULIFE.txt,161828,163417,1589,20,Y,N,-,-1,-1
MULIFE.txt,162460,164129,1669,20,Y,N,-,-1,-1
MULIFE.txt,162848,164669,1821,20,Y,N,-,-1,-1
MULIFE.txt,163233,165539,2306,20,Y,N,-,-1,-1
MULIFE.txt,163418,165920,2502,20,Y,N,-,-1,-1
MULIFE.txt,164130,166700,2570,20,Y,N,-,-1,-1
MULIFE.txt,164670,167258,2588,20,Y,N,-,-1,-1
MULIFE.txt,165540,168048,2508,20,N,N,-,-1,-1
MULIFE.txt,165921,168744,2823,20,Y,N,-,-1,-1
MULIFE.txt,166701,169046,2345,20,N,N,-,-1,-1
MULIFE.txt,167260,170579,3319,20,Y,N,-,-1,-1
MULIFE.txt,168051,171319,3268,20,Y,Y,1437736266658,170580,171597
MULIFE.txt,168745,171937,3192,20,Y,Y,1437736266658,170580,171597
MULIFE.txt,169047,172392,3345,20,Y,Y,1437736266658,170580,171597
MULIFE.txt,170582,172774,2192,20,Y,Y,1437736266658,170580,171597
MULIFE.txt,171320,173359,2039,20,N,Y,1437736266658,170580,171597
MULIFE.txt,171938,174100,2162,20,N,N,-,-1,-1
MULIFE.txt,172395,175029,2634,20,N,N,-,-1,-1
MULIFE.txt,172775,175812,3037,20,Y,N,-,-1,-1
MULIFE.txt,173360,176794,3434,20,Y,N,-,-1,-1
MULIFE.txt,174101,177261,3160,20,Y,N,-,-1,-1
MULIFE.txt,175031,177849,2818,20,Y,N,-,-1,-1
MULIFE.txt,175815,178159,2344,20,Y,N,-,-1,-1
MULIFE.txt,176797,178384,1587,20,Y,N,-,-1,-1
MULIFE.txt,177262,178802,1540,20,N,N,-,-1,-1
MULIFE.txt,177850,179520,1670,20,Y,N,-,-1,-1
MULIFE.txt,178160,180182,2022,20,Y,N,-,-1,-1
MULIFE.txt,178385,180401,2016,20,Y,N,-,-1,-1
MULIFE.txt,178803,181114,2311,20,Y,N,-,-1,-1
MULIFE.txt,179521,181842,2321,20,N,N,-,-1,-1
MULIFE.txt,180183,182650,2467,20,N,N,-,-1,-1
MULIFE.txt,180404,182928,2524,20,Y,N,-,-1,-1
MULIFE.txt,181115,183189,2074,20,Y,N,-,-1,-1
MULIFE.txt,181844,183394,1550,20,Y,N,-,-1,-1
MULIFE.txt,182653,183971,1318,20,Y,N,-,-1,-1
MULIFE.txt,182930,184547,1617,20,Y,N,-,-1,-1
MULIFE.txt,183194,185285,2091,20,Y,N,-,-1,-1
MULIFE.txt,183395,185526,2131,20,Y,N,-,-1,-1
MULIFE.txt,183972,185915,1943,20,Y,N,-,-1,-1
MULIFE.txt,184548,186923,2375,20,Y,N,-,-1,-1
MULIFE.txt,185286,187214,1928,20,N,N,-,-1,-1
MULIFE.txt,185527,187670,2143,20,N,N,-,-1,-1
MULIFE.txt,185916,188428,2512,20,Y,Y,1437737385709,188168,190108
MULIFE.txt,186925,188777,1852,20,Y,Y,1437737385709,188168,190108
MULIFE.txt,187215,189408,2193,20,Y,Y,1437737385709,188168,190108
MULIFE.txt,187671,189880,2209,20,Y,Y,1437737385709,188168,190108
MULIFE.txt,188429,190714,2285,20,Y,Y,1437737385709,188168,190108
MULIFE.txt,188778,191563,2785,20,Y,Y,1437737385709,188168,190108
MULIFE.txt,189409,191890,2481,20,Y,Y,1437737385709,188168,190108
MULIFE.txt,189881,192504,2623,20,Y,Y,1437737964896,191891,192160
MULIFE.txt,190715,192807,2092,20,Y,Y,1437737964896,191891,192160
MULIFE.txt,191566,193358,1792,20,Y,Y,1437737964896,191891,192160
MULIFE.txt,191893,193899,2006,20,Y,Y,1437737964896,191891,192160
MULIFE.txt,192505,194578,2073,20,Y,N,-,-1,-1
MULIFE.txt,192808,195149,2341,20,Y,N,-,-1,-1
MULIFE.txt,193359,195969,2610,20,Y,N,-,-1,-1
MULIFE.txt,193900,196498,2598,20,Y,N,-,-1,-1
MULIFE.txt,194579,197003,2424,20,Y,N,-,-1,-1
MULIFE.txt,195150,197411,2261,20,Y,N,-,-1,-1
MULIFE.txt,195970,197968,1998,20,Y,N,-,-1,-1
MULIFE.txt,196499,198442,1943,20,Y,N,-,-1,-1
MULIFE.txt,197006,198902,1896,20,Y,N,-,-1,-1
MULIFE.txt,197412,199146,1734,20,Y,N,-,-1,-1
MULIFE.txt,197969,199912,1943,20,Y,N,-,-1,-1
MULIFE.txt,198444,200636,2192,20,Y,N,-,-1,-1
MULIFE.txt,198903,201085,2182,20,Y,N,-,-1,-1
MULIFE.txt,199147,201340,2193,20,Y,N,-,-1,-1
MULIFE.txt,199915,202184,2269,20,N,N,-,-1,-1
MULIFE.txt,200637,202480,1843,20,N,N,-,-1,-1
MULIFE.txt,201086,203213,2127,20,Y,N,-,-1,-1
MULIFE.txt,201341,203735,2394,20,Y,N,-,-1,-1
MULIFE.txt,202185,204398,2213,20,Y,N,-,-1,-1
MULIFE.txt,202481,205792,3311,20,Y,N,-,-1,-1
MULIFE.txt,203215,206490,3275,20,Y,N,-,-1,-1
MULIFE.txt,203738,206842,3104,20,Y,N,-,-1,-1
MULIFE.txt,204399,206950,2551,20,Y,N,-,-1,-1
MULIFE.txt,205793,207740,1947,20,Y,N,-,-1,-1
MULIFE.txt,206491,208407,1916,20,Y,N,-,-1,-1
MULIFE.txt,206844,209182,2338,20,Y,N,-,-1,-1
MULIFE.txt,206956,209674,2718,20,Y,N,-,-1,-1
MULIFE.txt,207741,210405,2664,20,Y,N,-,-1,-1
MULIFE.txt,208410,210723,2313,20,Y,N,-,-1,-1
MULIFE.txt,209183,211298,2115,20,Y,N,-,-1,-1
MULIFE.txt,209675,211595,1920,20,Y,N,-,-1,-1
MULIFE.txt,210408,211874,1466,20,Y,N,-,-1,-1
MULIFE.txt,210724,212572,1848,20,Y,N,-,-1,-1
MULIFE.txt,211299,213208,1909,20,Y,N,-,-1,-1
MULIFE.txt,211596,213569,1973,20,Y,N,-,-1,-1
MULIFE.txt,211875,214029,2154,20,Y,N,-,-1,-1
MULIFE.txt,212573,214742,2169,20,Y,N,-,-1,-1
MULIFE.txt,213213,215413,2200,20,Y,N,-,-1,-1
MULIFE.txt,213570,215597,2027,20,Y,N,-,-1,-1
MULIFE.txt,214029,216115,2086,20,Y,N,-,-1,-1
MULIFE.txt,214743,216591,1848,20,Y,N,-,-1,-1
MULIFE.txt,215414,217403,1989,20,Y,N,-,-1,-1
MULIFE.txt,215600,217951,2351,20,Y,N,-,-1,-1
MULIFE.txt,216116,218392,2276,20,Y,N,-,-1,-1
MULIFE.txt,216592,219075,2483,20,Y,N,-,-1,-1
MULIFE.txt,217404,219376,1972,20,Y,N,-,-1,-1
MULIFE.txt,217952,219680,1728,20,Y,N,-,-1,-1
MULIFE.txt,218395,220319,1924,20,Y,N,-,-1,-1
MULIFE.txt,219078,220663,1585,20,Y,N,-,-1,-1
MULIFE.txt,219377,221131,1754,20,Y,N,-,-1,-1
MULIFE.txt,219681,221719,2038,20,Y,N,-,-1,-1
MULIFE.txt,220320,222110,1790,20,Y,N,-,-1,-1
MULIFE.txt,220664,223154,2490,20,Y,N,-,-1,-1
MULIFE.txt,221132,223728,2596,20,Y,N,-,-1,-1
MULIFE.txt,221722,224831,3109,20,Y,N,-,-1,-1
MULIFE.txt,222111,225031,2920,20,Y,N,-,-1,-1
MULIFE.txt,223155,225291,2136,20,Y,N,-,-1,-1
MULIFE.txt,223729,225739,2010,20,Y,N,-,-1,-1
MULIFE.txt,224832,226456,1624,20,Y,N,-,-1,-1
MULIFE.txt,225032,227074,2042,20,Y,N,-,-1,-1
MULIFE.txt,225292,227475,2183,20,Y,N,-,-1,-1
MULIFE.txt,225740,227587,1847,20,Y,N,-,-1,-1
MULIFE.txt,226459,228148,1689,20,Y,N,-,-1,-1
MULIFE.txt,227076,228759,1683,20,Y,N,-,-1,-1
MULIFE.txt,227476,229804,2328,20,Y,N,-,-1,-1
MULIFE.txt,227587,231266,3679,20,Y,N,-,-1,-1
MULIFE.txt,228151,231973,3822,20,Y,N,-,-1,-1
MULIFE.txt,228760,232758,3998,20,Y,N,-,-1,-1
MULIFE.txt,229807,233724,3917,20,Y,N,-,-1,-1
MULIFE.txt,231267,234560,3293,20,Y,N,-,-1,-1
MULIFE.txt,231974,234853,2879,20,Y,N,-,-1,-1
MULIFE.txt,232759,235744,2985,20,Y,N,-,-1,-1
MULIFE.txt,233725,236287,2562,20,Y,N,-,-1,-1
MULIFE.txt,234563,236907,2344,20,Y,N,-,-1,-1
MULIFE.txt,234854,237416,2562,20,Y,N,-,-1,-1
MULIFE.txt,235745,238110,2365,20,Y,N,-,-1,-1
MULIFE.txt,236288,238606,2318,20,Y,N,-,-1,-1
MULIFE.txt,236910,238951,2041,20,Y,N,-,-1,-1
MULIFE.txt,237417,239896,2479,20,Y,N,-,-1,-1
MULIFE.txt,238111,240189,2078,20,Y,N,-,-1,-1
MULIFE.txt,238607,240857,2250,20,Y,N,-,-1,-1
MULIFE.txt,238952,241524,2572,20,Y,N,-,-1,-1
MULIFE.txt,239899,241756,1857,20,Y,N,-,-1,-1
MULIFE.txt,240190,242415,2225,20,Y,N,-,-1,-1
MULIFE.txt,240860,242860,2000,20,Y,N,-,-1,-1
MULIFE.txt,241525,243490,1965,20,Y,N,-,-1,-1
MULIFE.txt,241757,244050,2293,20,Y,N,-,-1,-1
MULIFE.txt,242418,244644,2226,20,Y,N,-,-1,-1
MULIFE.txt,242861,245170,2309,20,Y,N,-,-1,-1
MULIFE.txt,243493,245924,2431,20,Y,N,-,-1,-1
MULIFE.txt,244051,246648,2597,20,Y,N,-,-1,-1
MULIFE.txt,244645,247345,2700,20,Y,N,-,-1,-1
MULIFE.txt,245171,248156,2985,20,Y,N,-,-1,-1
MULIFE.txt,245925,248587,2662,20,Y,N,-,-1,-1
MULIFE.txt,246651,249428,2777,20,Y,N,-,-1,-1
MULIFE.txt,247346,250181,2835,20,Y,N,-,-1,-1
MULIFE.txt,248157,250771,2614,20,Y,N,-,-1,-1
MULIFE.txt,248588,251743,3155,20,Y,N,-,-1,-1
MULIFE.txt,249431,252192,2761,20,Y,N,-,-1,-1
MULIFE.txt,250182,252866,2684,20,Y,N,-,-1,-1
MULIFE.txt,250772,253752,2980,20,Y,N,-,-1,-1
MULIFE.txt,251748,254640,2892,20,Y,N,-,-1,-1
MULIFE.txt,252193,255957,3764,20,Y,N,-,-1,-1
MULIFE.txt,252867,256855,3988,20,Y,N,-,-1,-1
MULIFE.txt,253753,257742,3989,20,Y,N,-,-1,-1
MULIFE.txt,254643,258303,3660,20,Y,N,-,-1,-1
MULIFE.txt,255958,258978,3020,20,Y,N,-,-1,-1
MULIFE.txt,256855,259338,2483,20,Y,N,-,-1,-1
MULIFE.txt,257743,259710,1967,20,N,N,-,-1,-1
MULIFE.txt,258304,260087,1783,20,N,N,-,-1,-1
MULIFE.txt,258981,260620,1639,20,N,N,-,-1,-1
MULIFE.txt,259339,261255,1916,20,N,N,-,-1,-1
MULIFE.txt,259711,261791,2080,20,Y,N,-,-1,-1
MULIFE.txt,260088,262222,2134,20,Y,N,-,-1,-1
MULIFE.txt,260621,262827,2206,20,Y,N,-,-1,-1
MULIFE.txt,261256,263296,2040,20,Y,N,-,-1,-1
MULIFE.txt,261792,263685,1893,20,Y,N,-,-1,-1
MULIFE.txt,262223,264797,2574,20,Y,N,-,-1,-1
MULIFE.txt,262830,265110,2280,20,Y,N,-,-1,-1
MULIFE.txt,263299,266042,2743,20,Y,N,-,-1,-1
MULIFE.txt,263686,266625,2939,20,Y,N,-,-1,-1
MULIFE.txt,264798,267651,2853,20,Y,N,-,-1,-1
MULIFE.txt,265110,268383,3273,20,Y,N,-,-1,-1
MULIFE.txt,266043,269364,3321,20,Y,N,-,-1,-1
MULIFE.txt,266626,269801,3175,20,Y,N,-,-1,-1
MULIFE.txt,267652,270472,2820,20,Y,N,-,-1,-1
MULIFE.txt,268384,270725,2341,20,Y,N,-,-1,-1
MULIFE.txt,269367,271222,1855,20,Y,N,-,-1,-1
MULIFE.txt,269802,271839,2037,20,Y,N,-,-1,-1
MULIFE.txt,270473,272290,1817,20,Y,N,-,-1,-1
MULIFE.txt,270726,272869,2143,20,Y,N,-,-1,-1
MULIFE.txt,271225,273148,1923,20,Y,N,-,-1,-1
MULIFE.txt,271840,273429,1589,20,Y,N,-,-1,-1
MULIFE.txt,272295,273825,1530,20,Y,N,-,-1,-1
MULIFE.txt,272872,274622,1750,20,Y,N,-,-1,-1
MULIFE.txt,273149,275150,2001,20,Y,Y,1437748188744,274892,276661
MULIFE.txt,273430,275888,2458,20,Y,Y,1437748188744,274892,276661
MULIFE.txt,273826,276904,3078,20,Y,Y,1437748188744,274892,276661
MULIFE.txt,274624,277432,2808,20,Y,Y,1437748188744,274892,276661
MULIFE.txt,275153,278285,3132,20,Y,Y,1437748188744,274892,276661
MULIFE.txt,275889,278886,2997,20,Y,Y,1437748188744,274892,276661
MULIFE.txt,276905,279476,2571,20,Y,N,-,-1,-1
MULIFE.txt,277435,280303,2868,20,Y,N,-,-1,-1
MULIFE.txt,278288,280743,2455,20,Y,N,-,-1,-1
MULIFE.txt,278887,282217,3330,20,Y,N,-,-1,-1
MULIFE.txt,279477,282780,3303,20,Y,N,-,-1,-1
MULIFE.txt,280304,283208,2904,20,Y,N,-,-1,-1
MULIFE.txt,280744,283615,2871,20,Y,N,-,-1,-1
MULIFE.txt,282218,284414,2196,20,Y,N,-,-1,-1
MULIFE.txt,282781,284950,2169,20,Y,N,-,-1,-1
MULIFE.txt,283209,286305,3096,20,Y,N,-,-1,-1
MULIFE.txt,283616,286978,3362,20,Y,N,-,-1,-1
MULIFE.txt,284415,287792,3377,20,Y,N,-,-1,-1
MULIFE.txt,284952,288171,3219,20,Y,N,-,-1,-1
MULIFE.txt,286305,288589,2284,20,Y,N,-,-1,-1
MULIFE.txt,286979,288925,1946,20,Y,N,-,-1,-1
MULIFE.txt,287793,289220,1427,20,Y,N,-,-1,-1
MULIFE.txt,288172,289929,1757,20,Y,N,-,-1,-1
MULIFE.txt,288590,291047,2457,20,Y,N,-,-1,-1
MULIFE.txt,288926,291961,3035,20,Y,N,-,-1,-1
MULIFE.txt,289221,292983,3762,20,Y,N,-,-1,-1
MULIFE.txt,289932,294003,4071,20,Y,N,-,-1,-1
MULIFE.txt,291050,294865,3815,20,Y,N,-,-1,-1
MULIFE.txt,291962,295679,3717,20,Y,N,-,-1,-1
MULIFE.txt,292986,296389,3403,20,Y,N,-,-1,-1
MULIFE.txt,294004,297218,3214,20,Y,N,-,-1,-1
MULIFE.txt,294867,297621,2754,20,Y,N,-,-1,-1
MULIFE.txt,295682,298513,2831,20,Y,N,-,-1,-1
MULIFE.txt,296390,299642,3252,20,Y,N,-,-1,-1
MULIFE.txt,297219,300304,3085,20,Y,N,-,-1,-1
MULIFE.txt,297622,300789,3167,20,Y,N,-,-1,-1
MULIFE.txt,298514,301305,2791,20,Y,N,-,-1,-1
MULIFE.txt,299645,301633,1988,20,Y,N,-,-1,-1
MULIFE.txt,300305,302048,1743,20,Y,N,-,-1,-1
MULIFE.txt,300790,302574,1784,20,Y,N,-,-1,-1
MULIFE.txt,301308,303473,2165,20,Y,N,-,-1,-1
MULIFE.txt,301634,304136,2502,20,Y,N,-,-1,-1
MULIFE.txt,302048,304786,2738,20,Y,N,-,-1,-1
MULIFE.txt,302575,305414,2839,20,Y,N,-,-1,-1
MULIFE.txt,303474,305638,2164,20,Y,N,-,-1,-1
MULIFE.txt,304137,306268,2131,20,Y,N,-,-1,-1
MULIFE.txt,304788,307413,2625,20,Y,N,-,-1,-1
MULIFE.txt,305417,307860,2443,20,Y,N,-,-1,-1
MULIFE.txt,305639,308033,2394,20,Y,N,-,-1,-1
MULIFE.txt,306270,308164,1894,20,Y,N,-,-1,-1
MULIFE.txt,307414,308455,1041,20,Y,N,-,-1,-1
MULIFE.txt,307861,308984,1123,20,Y,N,-,-1,-1
MULIFE.txt,308034,310423,2389,20,Y,N,-,-1,-1
MULIFE.txt,308165,311250,3085,20,Y,N,-,-1,-1
MULIFE.txt,308456,311928,3472,20,Y,N,-,-1,-1
MULIFE.txt,308985,312528,3543,20,Y,N,-,-1,-1
MULIFE.txt,310426,313617,3191,20,Y,N,-,-1,-1
MULIFE.txt,311253,314240,2987,20,Y,N,-,-1,-1
MULIFE.txt,311929,314433,2504,20,Y,N,-,-1,-1
MULIFE.txt,312529,314514,1985,20,Y,N,-,-1,-1
MULIFE.txt,313618,315024,1406,20,Y,N,-,-1,-1
MULIFE.txt,314241,315710,1469,20,N,N,-,-1,-1
MULIFE.txt,314434,318142,3708,20,N,N,-,-1,-1
MULIFE.txt,314515,318728,4213,20,N,N,-,-1,-1
MULIFE.txt,315025,319968,4943,20,Y,N,-,-1,-1
MULIFE.txt,315711,320607,4896,20,Y,N,-,-1,-1
MULIFE.txt,318143,321488,3345,20,Y,N,-,-1,-1
MULIFE.txt,318729,322513,3784,20,Y,N,-,-1,-1
MULIFE.txt,319969,323194,3225,20,Y,N,-,-1,-1
MULIFE.txt,320610,323844,3234,20,Y,N,-,-1,-1
MULIFE.txt,321489,324362,2873,20,Y,N,-,-1,-1
MULIFE.txt,322514,325035,2521,20,Y,N,-,-1,-1
MULIFE.txt,323195,325843,2648,20,Y,N,-,-1,-1
MULIFE.txt,323846,326169,2323,20,Y,N,-,-1,-1
MULIFE.txt,324364,327259,2895,20,Y,N,-,-1,-1
MULIFE.txt,325036,327624,2588,20,Y,N,-,-1,-1
MULIFE.txt,325844,328373,2529,20,Y,N,-,-1,-1
MULIFE.txt,326172,329166,2994,20,Y,N,-,-1,-1
MULIFE.txt,327265,329462,2197,20,Y,N,-,-1,-1
MULIFE.txt,327627,330341,2714,20,Y,N,-,-1,-1
MULIFE.txt,328376,330870,2494,20,Y,N,-,-1,-1
MULIFE.txt,329168,331814,2646,20,Y,N,-,-1,-1
MULIFE.txt,329463,332191,2728,20,Y,N,-,-1,-1
MULIFE.txt,330342,332731,2389,20,Y,N,-,-1,-1
MULIFE.txt,330873,333323,2450,20,Y,N,-,-1,-1
MULIFE.txt,331815,333708,1893,20,Y,N,-,-1,-1
MULIFE.txt,332194,334222,2028,20,Y,N,-,-1,-1
MULIFE.txt,332736,334744,2008,20,Y,N,-,-1,-1
MULIFE.txt,333324,334949,1625,20,Y,N,-,-1,-1
MULIFE.txt,333709,335647,1938,20,N,N,-,-1,-1
MULIFE.txt,334223,336270,2047,20,N,N,-,-1,-1
MULIFE.txt,334749,336737,1988,20,Y,N,-,-1,-1
MULIFE.txt,334952,337372,2420,20,Y,N,-,-1,-1
MULIFE.txt,335648,338235,2587,20,Y,N,-,-1,-1
MULIFE.txt,336273,339193,2920,20,Y,N,-,-1,-1
MULIFE.txt,336739,339842,3103,20,Y,N,-,-1,-1
MULIFE.txt,337374,340415,3041,20,Y,N,-,-1,-1
MULIFE.txt,338236,340795,2559,20,Y,N,-,-1,-1
MULIFE.txt,339198,341656,2458,20,Y,N,-,-1,-1
MULIFE.txt,339843,342424,2581,20,Y,N,-,-1,-1
MULIFE.txt,340416,343076,2660,20,Y,N,-,-1,-1
MULIFE.txt,340797,343629,2832,20,Y,N,-,-1,-1
MULIFE.txt,341659,344237,2578,20,Y,N,-,-1,-1
MULIFE.txt,342427,344813,2386,20,Y,N,-,-1,-1
MULIFE.txt,343077,345433,2356,20,Y,N,-,-1,-1
MULIFE.txt,343630,346196,2566,20,Y,N,-,-1,-1
MULIFE.txt,344240,346845,2605,20,Y,N,-,-1,-1
MULIFE.txt,344814,347069,2255,20,Y,N,-,-1,-1
MULIFE.txt,345434,347400,1966,20,Y,N,-,-1,-1
MULIFE.txt,346197,347986,1789,20,Y,N,-,-1,-1
MULIFE.txt,346848,349199,2351,20,N,N,-,-1,-1
MULIFE.txt,347072,349905,2833,20,Y,N,-,-1,-1
MULIFE.txt,347402,350643,3241,20,Y,N,-,-1,-1
MULIFE.txt,347989,351337,3348,20,Y,N,-,-1,-1
MULIFE.txt,349200,351981,2781,20,Y,N,-,-1,-1
MULIFE.txt,349906,352520,2614,20,Y,N,-,-1,-1
MULIFE.txt,350644,353020,2376,20,Y,N,-,-1,-1
MULIFE.txt,351338,353784,2446,20,Y,N,-,-1,-1
MULIFE.txt,351982,354250,2268,20,Y,N,-,-1,-1
MULIFE.txt,352522,354990,2468,20,Y,N,-,-1,-1
MULIFE.txt,353023,355448,2425,20,Y,N,-,-1,-1
MULIFE.txt,353785,356023,2238,20,Y,N,-,-1,-1
MULIFE.txt,354253,356472,2219,20,Y,N,-,-1,-1
MULIFE.txt,354991,357346,2355,20,Y,N,-,-1,-1
MULIFE.txt,355451,358553,3102,20,Y,N,-,-1,-1
MULIFE.txt,356026,359638,3612,20,Y,N,-,-1,-1
MULIFE.txt,356475,360145,3670,20,Y,N,-,-1,-1
MULIFE.txt,357349,361057,3708,20,Y,N,-,-1,-1
MULIFE.txt,358554,361683,3129,20,Y,N,-,-1,-1
MULIFE.txt,359639,362150,2511,20,Y,N,-,-1,-1
MULIFE.txt,360148,362972,2824,20,Y,N,-,-1,-1
MULIFE.txt,361060,363616,2556,20,Y,N,-,-1,-1
MULIFE.txt,361684,364244,2560,20,Y,N,-,-1,-1
MULIFE.txt,362153,364606,2453,20,Y,N,-,-1,-1
MULIFE.txt,362973,365339,2366,20,Y,N,-,-1,-1
MULIFE.txt,363619,366113,2494,20,Y,N,-,-1,-1
MULIFE.txt,364245,366708,2463,20,Y,N,-,-1,-1
MULIFE.txt,364607,367593,2986,20,Y,N,-,-1,-1
MULIFE.txt,365340,367982,2642,20,Y,N,-,-1,-1
MULIFE.txt,366116,368677,2561,20,Y,N,-,-1,-1
MULIFE.txt,366709,369170,2461,20,Y,N,-,-1,-1
MULIFE.txt,367594,369415,1821,20,Y,N,-,-1,-1
MULIFE.txt,367985,369881,1896,20,Y,N,-,-1,-1
MULIFE.txt,368678,370358,1680,20,Y,N,-,-1,-1
MULIFE.txt,369173,371515,2342,20,Y,N,-,-1,-1
MULIFE.txt,369416,372455,3039,20,Y,N,-,-1,-1
MULIFE.txt,369884,373151,3267,20,Y,N,-,-1,-1
MULIFE.txt,370359,374081,3722,20,Y,N,-,-1,-1
MULIFE.txt,371518,374883,3365,20,Y,N,-,-1,-1
MULIFE.txt,372456,375522,3066,20,Y,N,-,-1,-1
MULIFE.txt,373152,376441,3289,20,Y,N,-,-1,-1
MULIFE.txt,374084,377008,2924,20,Y,N,-,-1,-1
MULIFE.txt,374884,378010,3126,20,Y,N,-,-1,-1
MULIFE.txt,375525,378821,3296,20,Y,N,-,-1,-1
MULIFE.txt,376442,379320,2878,20,Y,N,-,-1,-1
MULIFE.txt,377011,379748,2737,20,Y,N,-,-1,-1
MULIFE.txt,378013,380525,2512,20,Y,N,-,-1,-1
MULIFE.txt,378822,380886,2064,20,Y,N,-,-1,-1
MULIFE.txt,379321,381442,2121,20,Y,N,-,-1,-1
MULIFE.txt,379749,381989,2240,20,Y,N,-,-1,-1
MULIFE.txt,380527,382780,2253,20,Y,N,-,-1,-1
MULIFE.txt,380889,383512,2623,20,Y,N,-,-1,-1
MULIFE.txt,381445,384054,2609,20,Y,N,-,-1,-1
MULIFE.txt,381990,384908,2918,20,Y,N,-,-1,-1
MULIFE.txt,382781,385282,2501,20,Y,N,-,-1,-1
MULIFE.txt,383513,385918,2405,20,Y,N,-,-1,-1
MULIFE.txt,384055,386484,2429,20,Y,N,-,-1,-1
MULIFE.txt,384909,386946,2037,20,Y,N,-,-1,-1
MULIFE.txt,385284,387476,2192,20,Y,N,-,-1,-1
MULIFE.txt,385920,388068,2148,20,Y,N,-,-1,-1
MULIFE.txt,386485,388672,2187,20,Y,N,-,-1,-1
MULIFE.txt,386947,389342,2395,20,Y,N,-,-1,-1
MULIFE.txt,387479,389737,2258,20,Y,N,-,-1,-1
MULIFE.txt,388071,390438,2367,20,Y,N,-,-1,-1
MULIFE.txt,388673,390792,2119,20,Y,N,-,-1,-1
MULIFE.txt,389344,392233,2889,20,Y,N,-,-1,-1
MULIFE.txt,389738,392788,3050,20,Y,N,-,-1,-1
MULIFE.txt,390441,393155,2714,20,Y,N,-,-1,-1
MULIFE.txt,390793,393479,2686,20,Y,N,-,-1,-1
MULIFE.txt,392236,394161,1925,20,Y,N,-,-1,-1
MULIFE.txt,392789,394573,1784,20,Y,N,-,-1,-1
MULIFE.txt,393156,394716,1560,20,Y,N,-,-1,-1
MULIFE.txt,393482,394873,1391,20,Y,N,-,-1,-1
MULIFE.txt,394162,395048,886,20,Y,N,-,-1,-1
MULIFE.txt,394576,395153,577,20,N,N,-,-1,-1
MULIFE.txt,394719,395272,553,20,N,N,-,-1,-1
MULIFE.txt,394876,395363,487,20,N,N,-,-1,-1
MULIFE.txt,395049,395496,447,20,N,N,-,-1,-1
MULIFE.txt,395156,395620,464,20,N,N,-,-1,-1
MULIFE.txt,395275,396490,1215,20,Y,N,-,-1,-1
MULIFE.txt,395364,396880,1516,20,Y,N,-,-1,-1
MULIFE.txt,395499,397922,2423,20,Y,N,-,-1,-1
MULIFE.txt,395623,398984,3361,20,Y,N,-,-1,-1
MULIFE.txt,396491,399845,3354,20,Y,N,-,-1,-1
MULIFE.txt,396883,400215,3332,20,Y,N,-,-1,-1
MULIFE.txt,397923,400891,2968,20,Y,N,-,-1,-1
MULIFE.txt,398987,401734,2747,20,Y,N,-,-1,-1
MULIFE.txt,399848,402829,2981,20,Y,N,-,-1,-1
MULIFE.txt,400217,403648,3431,20,Y,N,-,-1,-1
MULIFE.txt,400892,404629,3737,20,Y,N,-,-1,-1
MULIFE.txt,401735,405217,3482,20,Y,N,-,-1,-1
MULIFE.txt,402830,405570,2740,20,Y,N,-,-1,-1
MULIFE.txt,403651,406715,3064,20,Y,N,-,-1,-1
MULIFE.txt,404631,407052,2421,20,Y,N,-,-1,-1
MULIFE.txt,405218,407670,2452,20,Y,N,-,-1,-1
MULIFE.txt,405571,408706,3135,20,Y,N,-,-1,-1
MULIFE.txt,406716,409246,2530,20,Y,N,-,-1,-1
MULIFE.txt,407055,410210,3155,20,Y,N,-,-1,-1
MULIFE.txt,407671,410723,3052,20,Y,N,-,-1,-1
MULIFE.txt,408707,411868,3161,20,Y,N,-,-1,-1
MULIFE.txt,409247,412564,3317,20,Y,N,-,-1,-1
MULIFE.txt,410211,413886,3675,20,Y,N,-,-1,-1
MULIFE.txt,410724,414758,4034,20,Y,N,-,-1,-1
MULIFE.txt,411869,415156,3287,20,Y,N,-,-1,-1
MULIFE.txt,412565,415738,3173,20,Y,N,-,-1,-1
MULIFE.txt,413888,416427,2539,20,Y,N,-,-1,-1
MULIFE.txt,414759,417195,2436,20,Y,N,-,-1,-1
MULIFE.txt,415158,417738,2580,20,Y,N,-,-1,-1
MULIFE.txt,415739,418208,2469,20,Y,N,-,-1,-1
MULIFE.txt,416430,418726,2296,20,Y,N,-,-1,-1
MULIFE.txt,417197,419734,2537,20,Y,N,-,-1,-1
MULIFE.txt,417740,420530,2790,20,Y,N,-,-1,-1
MULIFE.txt,418210,421557,3347,20,Y,N,-,-1,-1
MULIFE.txt,418728,422685,3957,20,Y,N,-,-1,-1
MULIFE.txt,419735,424028,4293,20,Y,N,-,-1,-1
MULIFE.txt,420531,425315,4784,20,Y,N,-,-1,-1
MULIFE.txt,421558,425839,4281,20,Y,N,-,-1,-1
MULIFE.txt,422688,426509,3821,20,Y,N,-,-1,-1
MULIFE.txt,424029,427438,3409,20,Y,N,-,-1,-1
MULIFE.txt,425316,428788,3472,20,Y,N,-,-1,-1
MULIFE.txt,425842,429465,3623,20,Y,N,-,-1,-1
MULIFE.txt,426510,429819,3309,20,Y,N,-,-1,-1
MULIFE.txt,427439,430642,3203,20,Y,N,-,-1,-1
MULIFE.txt,428789,431158,2369,20,Y,N,-,-1,-1
MULIFE.txt,429466,431997,2531,20,Y,N,-,-1,-1
MULIFE.txt,429820,432532,2712,20,Y,N,-,-1,-1
MULIFE.txt,430643,433162,2519,20,Y,N,-,-1,-1
MULIFE.txt,431159,433363,2204,20,Y,N,-,-1,-1
MULIFE.txt,432000,433992,1992,20,Y,N,-,-1,-1
MULIFE.txt,432534,434478,1944,20,Y,N,-,-1,-1
MULIFE.txt,433164,435097,1933,20,Y,N,-,-1,-1
MULIFE.txt,433364,435745,2381,20,Y,N,-,-1,-1
MULIFE.txt,433993,436566,2573,20,Y,N,-,-1,-1
MULIFE.txt,434479,437380,2901,20,Y,N,-,-1,-1
MULIFE.txt,435100,437981,2881,20,Y,N,-,-1,-1
MULIFE.txt,435746,438630,2884,20,Y,N,-,-1,-1
MULIFE.txt,436567,439464,2897,20,Y,N,-,-1,-1
MULIFE.txt,437383,439681,2298,20,Y,N,-,-1,-1
MULIFE.txt,437982,440310,2328,20,Y,N,-,-1,-1
MULIFE.txt,438631,441053,2422,20,Y,N,-,-1,-1
MULIFE.txt,439467,441597,2130,20,Y,N,-,-1,-1
MULIFE.txt,439682,442213,2531,20,Y,N,-,-1,-1
MULIFE.txt,440311,442740,2429,20,Y,N,-,-1,-1
MULIFE.txt,441054,443415,2361,20,Y,N,-,-1,-1
MULIFE.txt,441600,443762,2162,20,Y,N,-,-1,-1
MULIFE.txt,442213,444258,2045,20,Y,N,-,-1,-1
MULIFE.txt,442741,445083,2342,20,Y,N,-,-1,-1
MULIFE.txt,443417,445580,2163,20,Y,N,-,-1,-1
MULIFE.txt,443763,446114,2351,20,Y,N,-,-1,-1
MULIFE.txt,444259,446692,2433,20,Y,N,-,-1,-1
MULIFE.txt,445084,447249,2165,20,Y,N,-,-1,-1
MULIFE.txt,445581,448045,2464,20,Y,N,-,-1,-1
MULIFE.txt,446115,448681,2566,20,Y,N,-,-1,-1
MULIFE.txt,446694,449383,2689,20,Y,N,-,-1,-1
MULIFE.txt,447252,449738,2486,20,Y,N,-,-1,-1
MULIFE.txt,448046,450343,2297,20,Y,N,-,-1,-1
MULIFE.txt,448682,450984,2302,20,Y,N,-,-1,-1
MULIFE.txt,449384,451543,2159,20,Y,N,-,-1,-1
MULIFE.txt,449739,452389,2650,20,Y,N,-,-1,-1
MULIFE.txt,450346,452741,2395,20,Y,N,-,-1,-1
MULIFE.txt,450985,453685,2700,20,Y,N,-,-1,-1
MULIFE.txt,451544,454308,2764,20,Y,N,-,-1,-1
MULIFE.txt,452392,455030,2638,20,Y,N,-,-1,-1
MULIFE.txt,452742,456463,3721,20,Y,N,-,-1,-1
MULIFE.txt,453686,457058,3372,20,Y,N,-,-1,-1
MULIFE.txt,454309,457727,3418,20,Y,N,-,-1,-1
MULIFE.txt,455031,458131,3100,20,Y,N,-,-1,-1
MULIFE.txt,456466,458802,2336,20,Y,N,-,-1,-1
MULIFE.txt,457059,459865,2806,20,N,N,-,-1,-1
MULIFE.txt,457728,460247,2519,20,N,N,-,-1,-1
MULIFE.txt,458132,461125,2993,20,N,N,-,-1,-1
MULIFE.txt,458803,461893,3090,20,Y,N,-,-1,-1
MULIFE.txt,459866,462348,2482,20,Y,N,-,-1,-1
MULIFE.txt,460250,463250,3000,20,N,N,-,-1,-1
MULIFE.txt,461126,464155,3029,20,Y,N,-,-1,-1
MULIFE.txt,461894,464465,2571,20,Y,N,-,-1,-1
MULIFE.txt,462349,465595,3246,20,Y,N,-,-1,-1
MULIFE.txt,463251,465936,2685,20,Y,N,-,-1,-1
MULIFE.txt,464156,466233,2077,20,Y,N,-,-1,-1
MULIFE.txt,464466,466688,2222,20,Y,N,-,-1,-1
MULIFE.txt,465598,467207,1609,20,Y,N,-,-1,-1
MULIFE.txt,465937,467450,1513,20,N,N,-,-1,-1
MULIFE.txt,466234,468160,1926,20,Y,N,-,-1,-1
MULIFE.txt,466689,468784,2095,20,Y,N,-,-1,-1
MULIFE.txt,467208,469566,2358,20,Y,N,-,-1,-1
MULIFE.txt,467451,470006,2555,20,Y,N,-,-1,-1
MULIFE.txt,468161,470894,2733,20,N,N,-,-1,-1
MULIFE.txt,468785,471098,2313,20,Y,N,-,-1,-1
MULIFE.txt,469567,471597,2030,20,Y,N,-,-1,-1
MULIFE.txt,470009,472066,2057,20,Y,N,-,-1,-1
MULIFE.txt,470899,472427,1528,20,Y,N,-,-1,-1
MULIFE.txt,471099,472985,1886,20,Y,N,-,-1,-1
MULIFE.txt,471598,474053,2455,20,Y,N,-,-1,-1
MULIFE.txt,472067,475331,3264,20,Y,N,-,-1,-1
MULIFE.txt,472428,475649,3221,20,Y,N,-,-1,-1
MULIFE.txt,472986,475961,2975,20,Y,N,-,-1,-1
MULIFE.txt,474054,476635,2581,20,N,N,-,-1,-1
MULIFE.txt,475334,476962,1628,20,N,N,-,-1,-1
MULIFE.txt,475651,477345,1694,20,N,N,-,-1,-1
MULIFE.txt,475962,477563,1601,20,N,N,-,-1,-1
MULIFE.txt,476636,477759,1123,20,N,N,-,-1,-1
MULIFE.txt,476963,478107,1144,20,N,N,-,-1,-1
MULIFE.txt,477348,478630,1282,20,N,N,-,-1,-1
MULIFE.txt,477566,479228,1662,20,N,N,-,-1,-1
MULIFE.txt,477760,479454,1694,20,N,N,-,-1,-1
MULIFE.txt,478108,479889,1781,20,N,N,-,-1,-1
MULIFE.txt,478633,480443,1810,20,N,N,-,-1,-1
MULIFE.txt,479229,480956,1727,20,N,N,-,-1,-1
MULIFE.txt,479455,481220,1765,20,N,N,-,-1,-1
MULIFE.txt,479890,481531,1641,20,N,N,-,-1,-1
MULIFE.txt,480446,482197,1751,20,N,N,-,-1,-1
MULIFE.txt,480957,482454,1497,20,N,N,-,-1,-1
MULIFE.txt,481221,482807,1586,20,N,N,-,-1,-1
MULIFE.txt,481532,483429,1897,20,N,N,-,-1,-1
MULIFE.txt,482198,484008,1810,20,N,N,-,-1,-1
MULIFE.txt,482457,484511,2054,20,N,N,-,-1,-1
MULIFE.txt,482808,484975,2167,20,N,N,-,-1,-1
MULIFE.txt,483432,485632,2200,20,Y,N,-,-1,-1
MULIFE.txt,484009,487120,3111,20,N,N,-,-1,-1
MULIFE.txt,484512,488024,3512,20,N,N,-,-1,-1
MULIFE.txt,484976,488533,3557,20,N,N,-,-1,-1
MULIFE.txt,485633,488760,3127,20,N,N,-,-1,-1
MULIFE.txt,487121,488885,1764,20,N,N,-,-1,-1
MULIFE.txt,488027,489152,1125,20,N,N,-,-1,-1
MULIFE.txt,488536,489404,868,20,N,N,-,-1,-1
MULIFE.txt,488761,489831,1070,20,N,N,-,-1,-1
MULIFE.txt,488886,490404,1518,20,N,N,-,-1,-1
MULIFE.txt,489155,490584,1429,20,Y,N,-,-1,-1
MULIFE.txt,489407,491513,2106,20,Y,N,-,-1,-1
MULIFE.txt,489834,492181,2347,20,Y,Y,1437819193404,491891,492364
MULIFE.txt,490407,492786,2379,20,Y,Y,1437819193404,491891,492364
MULIFE.txt,490585,493246,2661,20,Y,Y,1437819193404,491891,492364
MULIFE.txt,491516,493697,2181,20,Y,Y,1437819193404,491891,492364
MULIFE.txt,492182,494229,2047,20,Y,Y,1437819940135,493797,494222
MULIFE.txt,492787,494537,1750,20,Y,Y,1437819940135,493797,494222
MULIFE.txt,493249,494702,1453,20,Y,Y,1437819940135,493797,494222
MULIFE.txt,493698,494948,1250,20,Y,Y,1437819940135,493797,494222
MULIFE.txt,494231,495452,1221,20,Y,N,-,-1,-1
MULIFE.txt,494538,496002,1464,20,Y,N,-,-1,-1
MULIFE.txt,494703,496706,2003,20,Y,N,-,-1,-1
MULIFE.txt,494949,497214,2265,20,Y,N,-,-1,-1
MULIFE.txt,495453,497602,2149,20,Y,N,-,-1,-1
MULIFE.txt,496003,498056,2053,20,Y,N,-,-1,-1
MULIFE.txt,496707,498620,1913,20,Y,N,-,-1,-1
MULIFE.txt,497215,499136,1921,20,Y,N,-,-1,-1
MULIFE.txt,497603,499671,2068,20,Y,N,-,-1,-1
MULIFE.txt,498057,500090,2033,20,Y,N,-,-1,-1
MULIFE.txt,498621,500190,1569,20,Y,N,-,-1,-1
MULIFE.txt,499139,500875,1736,20,Y,N,-,-1,-1
MULIFE.txt,499672,501396,1724,20,Y,N,-,-1,-1
MULIFE.txt,500091,502043,1952,20,Y,N,-,-1,-1
MULIFE.txt,500191,503333,3142,20,Y,N,-,-1,-1
MULIFE.txt,500878,504066,3188,20,Y,N,-,-1,-1
MULIFE.txt,501397,504443,3046,20,Y,N,-,-1,-1
MULIFE.txt,502046,506033,3987,20,Y,N,-,-1,-1
MULIFE.txt,503334,506674,3340,20,Y,N,-,-1,-1
MULIFE.txt,504068,507549,3481,20,Y,N,-,-1,-1
MULIFE.txt,504446,508596,4150,20,Y,N,-,-1,-1
MULIFE.txt,506034,509155,3121,20,Y,N,-,-1,-1
MULIFE.txt,506676,510008,3332,20,Y,N,-,-1,-1
MULIFE.txt,507550,510428,2878,20,Y,Y,1437821785598,510009,510542
MULIFE.txt,508597,510883,2286,20,Y,Y,1437821785598,510009,510542
MULIFE.txt,509156,511540,2384,20,Y,Y,1437821785598,510009,510542
MULIFE.txt,510011,511995,1984,20,Y,Y,1437822193958,511750,512403
MULIFE.txt,510429,512869,2440,20,Y,Y,1437822193958,511750,512403
MULIFE.txt,510884,513280,2396,20,Y,Y,1437822193958,511750,512403
MULIFE.txt,511541,513778,2237,20,Y,Y,1437822193958,511750,512403
MULIFE.txt,511997,514559,2562,20,Y,Y,1437822193958,511750,512403
MULIFE.txt,512870,515087,2217,20,Y,N,-,-1,-1
MULIFE.txt,513281,515859,2578,20,Y,N,-,-1,-1
MULIFE.txt,513779,516908,3129,20,Y,N,-,-1,-1
MULIFE.txt,514562,517940,3378,20,Y,Y,1437822538234,517368,517636
MULIFE.txt,515088,518854,3766,20,Y,Y,1437822538234,517368,517636
MULIFE.txt,515860,520121,4261,20,Y,Y,1437822538234,517368,517636
MULIFE.txt,516909,520876,3967,20,Y,Y,1437822538234,517368,517636
MULIFE.txt,517943,521252,3309,20,Y,Y,1437823433827,520914,521651
MULIFE.txt,518856,521726,2870,20,Y,Y,1437823433827,520914,521651
MULIFE.txt,520122,522305,2183,20,Y,Y,1437823700026,522255,523121
MULIFE.txt,520879,523137,2258,20,Y,Y,1437823700026,522255,523121
MULIFE.txt,521253,524218,2965,20,Y,Y,1437823700026,522255,523121
MULIFE.txt,521728,525033,3305,20,Y,Y,1437823700026,522255,523121
MULIFE.txt,522306,525706,3400,20,Y,Y,1437823700026,522255,523121
MULIFE.txt,523140,526719,3579,20,N,N,-,-1,-1
MULIFE.txt,524219,527349,3130,20,N,N,-,-1,-1
MULIFE.txt,525034,527982,2948,20,N,N,-,-1,-1
MULIFE.txt,525708,528318,2610,20,N,N,-,-1,-1
MULIFE.txt,526720,529180,2460,20,N,N,-,-1,-1
MULIFE.txt,527352,529889,2537,20,N,N,-,-1,-1
MULIFE.txt,527983,530603,2620,20,Y,N,-,-1,-1
MULIFE.txt,528319,531717,3398,20,Y,Y,1437842085814,530652,531925
MULIFE.txt,529181,532382,3201,20,Y,Y,1437842085814,530652,531925
MULIFE.txt,529890,532982,3092,20,Y,Y,1437842085814,530652,531925
MULIFE.txt,530604,533516,2912,20,Y,Y,1437842085814,530652,531925
MULIFE.txt,531718,533991,2273,20,Y,Y,1437842085814,530652,531925
MULIFE.txt,532383,534737,2354,20,Y,N,-,-1,-1
MULIFE.txt,532984,535433,2449,20,Y,N,-,-1,-1
MULIFE.txt,533521,536005,2484,20,Y,N,-,-1,-1
MULIFE.txt,533992,536720,2728,20,Y,N,-,-1,-1
MULIFE.txt,534738,537097,2359,20,Y,N,-,-1,-1
MULIFE.txt,535434,537685,2251,20,Y,N,-,-1,-1
MULIFE.txt,536006,538462,2456,20,Y,N,-,-1,-1
MULIFE.txt,536721,539004,2283,20,Y,N,-,-1,-1
MULIFE.txt,537098,539678,2580,20,Y,N,-,-1,-1
MULIFE.txt,537686,540701,3015,20,Y,N,-,-1,-1
MULIFE.txt,538463,541312,2849,20,Y,N,-,-1,-1
MULIFE.txt,539005,541813,2808,20,Y,N,-,-1,-1
MULIFE.txt,539681,543081,3400,20,Y,N,-,-1,-1
MULIFE.txt,540704,543791,3087,20,Y,N,-,-1,-1
MULIFE.txt,541313,544276,2963,20,Y,N,-,-1,-1
MULIFE.txt,541814,544999,3185,20,Y,N,-,-1,-1
MULIFE.txt,543084,545637,2553,20,Y,Y,1437842663182,545558,546298
MULIFE.txt,543794,546068,2274,20,Y,Y,1437842663182,545558,546298
MULIFE.txt,544277,546883,2606,20,Y,Y,1437842663182,545558,546298
MULIFE.txt,545002,547318,2316,20,Y,Y,1437842663182,545558,546298
MULIFE.txt,545638,547612,1974,20,Y,Y,1437842663182,545558,546298
MULIFE.txt,546070,548235,2165,20,Y,Y,1437842663182,545558,546298
MULIFE.txt,546886,548560,1674,20,Y,N,-,-1,-1
MULIFE.txt,547319,549013,1694,20,Y,N,-,-1,-1
MULIFE.txt,547615,549563,1948,20,Y,Y,1437842936274,549355,550003
MULIFE.txt,548236,550126,1890,20,Y,Y,1437842936274,549355,550003
MULIFE.txt,548563,550396,1833,20,Y,Y,1437842936274,549355,550003
MULIFE.txt,549014,551354,2340,20,Y,Y,1437842936274,549355,550003
MULIFE.txt,549564,552040,2476,20,Y,Y,1437842936274,549355,550003
MULIFE.txt,550127,552524,2397,20,Y,N,-,-1,-1
MULIFE.txt,550397,553200,2803,20,Y,Y,1437843377951,552763,553884
MULIFE.txt,551355,553607,2252,20,Y,Y,1437843377951,552763,553884
MULIFE.txt,552041,554310,2269,20,Y,Y,1437843377951,552763,553884
MULIFE.txt,552525,555249,2724,20,Y,Y,1437843377951,552763,553884
MULIFE.txt,553201,556362,3161,20,Y,Y,1437843377951,552763,553884
MULIFE.txt,553608,556861,3253,20,Y,Y,1437843377951,552763,553884
MULIFE.txt,554311,557649,3338,20,Y,N,-,-1,-1
MULIFE.txt,555250,558563,3313,20,N,N,-,-1,-1
MULIFE.txt,556363,559148,2785,20,N,N,-,-1,-1
MULIFE.txt,556862,559654,2792,20,N,N,-,-1,-1
MULIFE.txt,557650,560633,2983,20,Y,N,-,-1,-1
MULIFE.txt,558566,561093,2527,20,Y,N,-,-1,-1
MULIFE.txt,559150,561511,2361,20,Y,N,-,-1,-1
MULIFE.txt,559656,562252,2596,20,Y,N,-,-1,-1
MULIFE.txt,560635,562916,2281,20,Y,N,-,-1,-1
MULIFE.txt,561096,563752,2656,20,Y,N,-,-1,-1
MULIFE.txt,561512,564110,2598,20,Y,N,-,-1,-1
MULIFE.txt,562255,565038,2783,20,Y,Y,1437843751491,564174,565427
MULIFE.txt,562917,565771,2854,20,Y,Y,1437843751491,564174,565427
MULIFE.txt,563753,566860,3107,20,Y,Y,1437843751491,564174,565427
MULIFE.txt,564113,567529,3416,20,Y,Y,1437843751491,564174,565427
MULIFE.txt,565039,568503,3464,20,Y,Y,1437843751491,564174,565427
MULIFE.txt,565772,569373,3601,20,Y,Y,1437844476348,567281,568945
MULIFE.txt,566861,570187,3326,20,Y,Y,1437844476348,567281,568945
MULIFE.txt,567530,571347,3817,20,Y,Y,1437844476348,567281,568945
MULIFE.txt,568504,572096,3592,20,Y,Y,1437844476348,567281,568945
MULIFE.txt,569374,572482,3108,20,Y,N,-,-1,-1
MULIFE.txt,570190,572940,2750,20,Y,N,-,-1,-1
MULIFE.txt,571348,573454,2106,20,Y,N,-,-1,-1
MULIFE.txt,572099,574125,2026,20,Y,N,-,-1,-1
MULIFE.txt,572485,574669,2184,20,N,N,-,-1,-1
MULIFE.txt,572941,575045,2104,20,N,N,-,-1,-1
MULIFE.txt,573455,576253,2798,20,N,N,-,-1,-1
MULIFE.txt,574126,576711,2585,20,N,N,-,-1,-1
MULIFE.txt,574670,577347,2677,20,Y,N,-,-1,-1
MULIFE.txt,575046,577621,2575,20,Y,N,-,-1,-1
MULIFE.txt,576256,578430,2174,20,Y,N,-,-1,-1
MULIFE.txt,576714,579074,2360,20,Y,N,-,-1,-1
MULIFE.txt,577352,579371,2019,20,Y,N,-,-1,-1
MULIFE.txt,577623,579431,1808,20,Y,N,-,-1,-1
MULIFE.txt,578433,579915,1482,20,Y,N,-,-1,-1
MULIFE.txt,579079,580384,1305,20,Y,N,-,-1,-1
MULIFE.txt,579372,581700,2328,20,Y,N,-,-1,-1
MULIFE.txt,579432,582386,2954,20,Y,Y,1437845266061,581723,582485
MULIFE.txt,579916,583003,3087,20,Y,Y,1437845266061,581723,582485
MULIFE.txt,580385,583394,3009,20,Y,Y,1437845266061,581723,582485
MULIFE.txt,581701,584211,2510,20,Y,Y,1437845266061,581723,582485
MULIFE.txt,582387,584734,2347,20,Y,Y,1437845266061,581723,582485
MULIFE.txt,583004,585460,2456,20,Y,N,-,-1,-1
MULIFE.txt,583396,586202,2806,20,Y,N,-,-1,-1
MULIFE.txt,584211,586959,2748,20,Y,N,-,-1,-1
MULIFE.txt,584735,587661,2926,20,Y,N,-,-1,-1
MULIFE.txt,585462,588092,2630,20,Y,N,-,-1,-1
MULIFE.txt,586205,588753,2548,20,Y,N,-,-1,-1
MULIFE.txt,586960,589196,2236,20,Y,N,-,-1,-1
MULIFE.txt,587662,590082,2420,20,N,N,-,-1,-1
MULIFE.txt,588093,590731,2638,20,Y,N,-,-1,-1
MULIFE.txt,588754,591423,2669,20,Y,N,-,-1,-1
MULIFE.txt,589199,592433,3234,20,Y,N,-,-1,-1
MULIFE.txt,590085,593149,3064,20,Y,N,-,-1,-1
MULIFE.txt,590733,593846,3113,20,Y,N,-,-1,-1
MULIFE.txt,591424,594603,3179,20,Y,N,-,-1,-1
MULIFE.txt,592434,595953,3519,20,Y,N,-,-1,-1
MULIFE.txt,593150,596549,3399,20,Y,N,-,-1,-1
MULIFE.txt,593847,597376,3529,20,Y,N,-,-1,-1
MULIFE.txt,594604,598364,3760,20,Y,N,-,-1,-1
MULIFE.txt,595956,599198,3242,20,Y,N,-,-1,-1
MULIFE.txt,596550,599809,3259,20,Y,N,-,-1,-1
MULIFE.txt,597378,600290,2912,20,Y,N,-,-1,-1
MULIFE.txt,598365,600996,2631,20,Y,N,-,-1,-1
MULIFE.txt,599201,601533,2332,20,Y,N,-,-1,-1
MULIFE.txt,599810,602583,2773,20,Y,N,-,-1,-1
MULIFE.txt,600291,603388,3097,20,Y,N,-,-1,-1
MULIFE.txt,600997,604161,3164,20,Y,N,-,-1,-1
MULIFE.txt,601534,604449,2915,20,Y,N,-,-1,-1
MULIFE.txt,602583,605149,2566,20,Y,N,-,-1,-1
MULIFE.txt,603389,605772,2383,20,Y,N,-,-1,-1
MULIFE.txt,604162,606828,2666,20,Y,N,-,-1,-1
MULIFE.txt,604450,607228,2778,20,Y,N,-,-1,-1
MULIFE.txt,605152,608504,3352,20,Y,N,-,-1,-1
MULIFE.txt,605775,609130,3355,20,Y,N,-,-1,-1
MULIFE.txt,606831,609915,3084,20,Y,N,-,-1,-1
MULIFE.txt,607229,611350,4121,20,Y,N,-,-1,-1
MULIFE.txt,608507,612078,3571,20,Y,N,-,-1,-1
MULIFE.txt,609131,612991,3860,20,Y,N,-,-1,-1
MULIFE.txt,609918,613594,3676,20,Y,N,-,-1,-1
MULIFE.txt,611351,614488,3137,20,Y,N,-,-1,-1
MULIFE.txt,612079,615190,3111,20,Y,N,-,-1,-1
MULIFE.txt,612992,616490,3498,20,Y,N,-,-1,-1
MULIFE.txt,613595,617308,3713,20,Y,N,-,-1,-1
MULIFE.txt,614491,617785,3294,20,Y,N,-,-1,-1
MULIFE.txt,615191,618985,3794,20,Y,N,-,-1,-1
MULIFE.txt,616491,619928,3437,20,Y,N,-,-1,-1
MULIFE.txt,617309,620681,3372,20,Y,Y,1437986157098,620366,620948
MULIFE.txt,617786,621087,3301,20,Y,Y,1437986157098,620366,620948
MULIFE.txt,618988,621890,2902,20,Y,Y,1437986157098,620366,620948
MULIFE.txt,619929,622550,2621,20,Y,Y,1437986157098,620366,620948
MULIFE.txt,620682,623488,2806,20,Y,Y,1437986157098,620366,620948
MULIFE.txt,621088,624121,3033,20,Y,N,-,-1,-1
MULIFE.txt,621891,625240,3349,20,Y,N,-,-1,-1
MULIFE.txt,622551,625944,3393,20,Y,N,-,-1,-1
MULIFE.txt,623489,626414,2925,20,Y,Y,1437986573396,626278,626853
MULIFE.txt,624122,626901,2779,20,Y,Y,1437986573396,626278,626853
MULIFE.txt,625241,627678,2437,20,Y,Y,1437986573396,626278,626853
MULIFE.txt,625947,628447,2500,20,Y,Y,1437986573396,626278,626853
MULIFE.txt,626415,629955,3540,20,Y,Y,1437986573396,626278,626853
MULIFE.txt,626902,630443,3541,20,Y,N,-,-1,-1
MULIFE.txt,627679,631082,3403,20,Y,N,-,-1,-1
MULIFE.txt,628450,632311,3861,20,Y,N,-,-1,-1
MULIFE.txt,629956,632868,2912,20,Y,N,-,-1,-1
MULIFE.txt,630446,633582,3136,20,Y,Y,1437987243903,633307,634055
MULIFE.txt,631083,634126,3043,20,Y,Y,1437987243903,633307,634055
MULIFE.txt,632312,635162,2850,20,Y,Y,1437987243903,633307,634055
MULIFE.txt,632869,636115,3246,20,Y,Y,1437987243903,633307,634055
MULIFE.txt,633583,636904,3321,20,Y,Y,1437987243903,633307,634055
MULIFE.txt,634129,637598,3469,20,Y,Y,1437987949897,635438,636165
MULIFE.txt,635165,638211,3046,20,Y,Y,1437987949897,635438,636165
MULIFE.txt,636117,638861,2744,20,Y,Y,1437987949897,635438,636165
MULIFE.txt,636905,639976,3071,20,Y,N,-,-1,-1
MULIFE.txt,637599,640816,3217,20,Y,N,-,-1,-1
MULIFE.txt,638212,642047,3835,20,Y,N,-,-1,-1
MULIFE.txt,638862,642587,3725,20,Y,N,-,-1,-1
MULIFE.txt,639979,642878,2899,20,N,N,-,-1,-1
MULIFE.txt,640817,643385,2568,20,N,N,-,-1,-1
MULIFE.txt,642048,644289,2241,20,N,N,-,-1,-1
MULIFE.txt,642588,644862,2274,20,Y,N,-,-1,-1
MULIFE.txt,642879,645401,2522,20,Y,N,-,-1,-1
MULIFE.txt,643387,645914,2527,20,Y,N,-,-1,-1
MULIFE.txt,644291,646434,2143,20,Y,N,-,-1,-1
MULIFE.txt,644863,647094,2231,20,Y,N,-,-1,-1
MULIFE.txt,645404,647296,1892,20,N,N,-,-1,-1
MULIFE.txt,645916,647579,1663,20,Y,N,-,-1,-1
MULIFE.txt,646435,647982,1547,20,Y,N,-,-1,-1
MULIFE.txt,647096,648659,1563,20,Y,N,-,-1,-1
MULIFE.txt,647299,649269,1970,20,Y,N,-,-1,-1
MULIFE.txt,647579,649899,2320,20,N,N,-,-1,-1
MULIFE.txt,647985,650253,2268,20,N,N,-,-1,-1
MULIFE.txt,648662,650802,2140,20,N,N,-,-1,-1
MULIFE.txt,649270,651190,1920,20,Y,N,-,-1,-1
MULIFE.txt,649900,652026,2126,20,Y,N,-,-1,-1
MULIFE.txt,650255,652673,2418,20,Y,N,-,-1,-1
MULIFE.txt,650805,653301,2496,20,Y,N,-,-1,-1
MULIFE.txt,651191,654008,2817,20,Y,N,-,-1,-1
MULIFE.txt,652027,654742,2715,20,Y,N,-,-1,-1
MULIFE.txt,652676,655421,2745,20,Y,N,-,-1,-1
MULIFE.txt,653304,655976,2672,20,N,N,-,-1,-1
MULIFE.txt,654011,656519,2508,20,Y,N,-,-1,-1
MULIFE.txt,654743,656897,2154,20,Y,N,-,-1,-1
MULIFE.txt,655422,657935,2513,20,Y,N,-,-1,-1
MULIFE.txt,655979,658786,2807,20,Y,N,-,-1,-1
MULIFE.txt,656522,659203,2681,20,Y,N,-,-1,-1
MULIFE.txt,656898,659673,2775,20,Y,Y,1437988651932,659204,659887
MULIFE.txt,657936,660291,2355,20,Y,Y,1437988651932,659204,659887
MULIFE.txt,658787,661013,2226,20,Y,Y,1437988651932,659204,659887
MULIFE.txt,659204,661531,2327,20,Y,Y,1437988651932,659204,659887
MULIFE.txt,659675,662043,2368,20,Y,Y,1437989149214,661990,662272
MULIFE.txt,660292,662746,2454,20,N,Y,1437989149214,661990,662272
MULIFE.txt,661014,663158,2144,20,Y,Y,1437989149214,661990,662272
MULIFE.txt,661532,664027,2495,20,Y,Y,1437989149214,661990,662272
MULIFE.txt,662045,664564,2519,20,Y,Y,1437989518903,664383,664855
MULIFE.txt,662747,665248,2501,20,Y,Y,1437989518903,664383,664855
MULIFE.txt,663161,665996,2835,20,Y,Y,1437989518903,664383,664855
MULIFE.txt,664028,666289,2261,20,Y,Y,1437989518903,664383,664855
MULIFE.txt,664565,666677,2112,20,Y,Y,1437989518903,664383,664855
MULIFE.txt,665249,666952,1703,20,N,Y,1437989874676,664875,665551
MULIFE.txt,665999,667419,1420,20,N,N,-,-1,-1
MULIFE.txt,666291,667619,1328,20,N,N,-,-1,-1
MULIFE.txt,666678,668135,1457,20,N,N,-,-1,-1
MULIFE.txt,666953,668511,1558,20,Y,N,-,-1,-1
MULIFE.txt,667421,668921,1500,20,N,N,-,-1,-1
MULIFE.txt,667620,669221,1601,20,N,Y,1437990390319,668943,669389
MULIFE.txt,668136,669611,1475,20,N,Y,1437990390319,668943,669389
MULIFE.txt,668512,670308,1796,20,N,Y,1437990390319,668943,669389
MULIFE.txt,668926,670518,1592,20,N,Y,1437990390319,668943,669389
MULIFE.txt,669222,670837,1615,20,N,Y,1437990390319,668943,669389
MULIFE.txt,669612,671408,1796,20,N,N,-,-1,-1
MULIFE.txt,670313,671798,1485,20,N,N,-,-1,-1
MULIFE.txt,670521,672243,1722,20,N,N,-,-1,-1
MULIFE.txt,670838,672491,1653,20,Y,N,-,-1,-1
MULIFE.txt,671411,672742,1331,20,Y,N,-,-1,-1
MULIFE.txt,671799,673131,1332,20,N,N,-,-1,-1
MULIFE.txt,672244,673644,1400,20,N,N,-,-1,-1
MULIFE.txt,672492,674057,1565,20,N,N,-,-1,-1
MULIFE.txt,672743,674638,1895,20,N,N,-,-1,-1
MULIFE.txt,673134,674994,1860,20,N,N,-,-1,-1
MULIFE.txt,673645,675393,1748,20,N,N,-,-1,-1
MULIFE.txt,674060,675923,1863,20,N,N,-,-1,-1
MULIFE.txt,674641,676201,1560,20,N,N,-,-1,-1
MULIFE.txt,674995,676726,1731,20,N,N,-,-1,-1
MULIFE.txt,675394,677196,1802,20,N,N,-,-1,-1
MULIFE.txt,675926,677848,1922,20,Y,N,-,-1,-1
MULIFE.txt,676202,678432,2230,20,Y,N,-,-1,-1
MULIFE.txt,676727,678966,2239,20,Y,N,-,-1,-1
MULIFE.txt,677199,679571,2372,20,Y,N,-,-1,-1
MULIFE.txt,677849,680188,2339,20,N,N,-,-1,-1
MULIFE.txt,678435,680798,2363,20,N,N,-,-1,-1
MULIFE.txt,678967,681399,2432,20,N,N,-,-1,-1
MULIFE.txt,679574,681857,2283,20,Y,N,-,-1,-1
MULIFE.txt,680191,682399,2208,20,Y,N,-,-1,-1
MULIFE.txt,680799,682606,1807,20,Y,N,-,-1,-1
MULIFE.txt,681400,682904,1504,20,Y,N,-,-1,-1
MULIFE.txt,681858,683289,1431,20,Y,N,-,-1,-1
MULIFE.txt,682400,684117,1717,20,N,N,-,-1,-1
MULIFE.txt,682607,684342,1735,20,N,N,-,-1,-1
MULIFE.txt,682907,684942,2035,20,N,N,-,-1,-1
MULIFE.txt,683292,685568,2276,20,N,N,-,-1,-1
MULIFE.txt,684120,685900,1780,20,N,N,-,-1,-1
MULIFE.txt,684343,687334,2991,20,Y,N,-,-1,-1
MULIFE.txt,684944,687819,2875,20,Y,N,-,-1,-1
MULIFE.txt,685571,688104,2533,20,Y,N,-,-1,-1
MULIFE.txt,685902,688848,2946,20,Y,N,-,-1,-1
MULIFE.txt,687335,689857,2522,20,N,N,-,-1,-1
MULIFE.txt,687822,690363,2541,20,N,N,-,-1,-1
MULIFE.txt,688105,691004,2899,20,N,N,-,-1,-1
MULIFE.txt,688849,691635,2786,20,N,N,-,-1,-1
MULIFE.txt,689858,692594,2736,20,N,N,-,-1,-1
MULIFE.txt,690364,693119,2755,20,N,N,-,-1,-1
MULIFE.txt,691007,693435,2428,20,N,Y,1437991397891,693219,694006
MULIFE.txt,691636,693570,1934,20,N,Y,1437991397891,693219,694006
MULIFE.txt,692597,694058,1461,20,N,Y,1437991397891,693219,694006
MULIFE.txt,693122,694415,1293,20,Y,Y,1437991397891,693219,694006
MULIFE.txt,693436,695143,1707,20,Y,Y,1437991397891,693219,694006
MULIFE.txt,693571,695399,1828,20,Y,Y,1437991397891,693219,694006
MULIFE.txt,694061,695849,1788,20,Y,Y,1437991665521,694564,695190
MULIFE.txt,694416,696153,1737,20,Y,Y,1437991665521,694564,695190
MULIFE.txt,695144,696815,1671,20,N,Y,1437991665521,694564,695190
MULIFE.txt,695400,697549,2149,20,N,N,-,-1,-1
MULIFE.txt,695854,698218,2364,20,Y,N,-,-1,-1
MULIFE.txt,696154,698823,2669,20,Y,N,-,-1,-1
MULIFE.txt,696816,699558,2742,20,Y,N,-,-1,-1
MULIFE.txt,697550,700415,2865,20,Y,N,-,-1,-1
MULIFE.txt,698219,700848,2629,20,N,N,-,-1,-1
MULIFE.txt,698824,701117,2293,20,N,N,-,-1,-1
MULIFE.txt,699561,701285,1724,20,N,N,-,-1,-1
MULIFE.txt,700416,701738,1322,20,N,N,-,-1,-1
MULIFE.txt,700849,702082,1233,20,N,Y,1437991986836,701932,703111
MULIFE.txt,701118,702425,1307,20,Y,Y,1437991986836,701932,703111
MULIFE.txt,701286,703040,1754,20,Y,Y,1437991986836,701932,703111
MULIFE.txt,701743,703555,1812,20,Y,Y,1437991986836,701932,703111
MULIFE.txt,702083,704209,2126,20,N,Y,1437991986836,701932,703111
MULIFE.txt,702426,704904,2478,20,N,Y,1437991986836,701932,703111
MULIFE.txt,703041,705596,2555,20,Y,Y,1437991986836,701932,703111
MULIFE.txt,703558,706019,2461,20,Y,N,-,-1,-1
MULIFE.txt,704211,706782,2571,20,Y,N,-,-1,-1
MULIFE.txt,704907,707181,2274,20,N,N,-,-1,-1
MULIFE.txt,705601,707936,2335,20,N,Y,1437992265363,707653,708287
MULIFE.txt,706020,708373,2353,20,N,Y,1437992265363,707653,708287
MULIFE.txt,706783,708728,1945,20,N,Y,1437992265363,707653,708287
MULIFE.txt,707182,709066,1884,20,N,Y,1437992265363,707653,708287
MULIFE.txt,707937,709571,1634,20,Y,Y,1437992265363,707653,708287
MULIFE.txt,708374,710154,1780,20,N,N,-,-1,-1
MULIFE.txt,708729,710689,1960,20,Y,N,-,-1,-1
MULIFE.txt,709067,710989,1922,20,N,N,-,-1,-1
MULIFE.txt,709574,711488,1914,20,Y,N,-,-1,-1
MULIFE.txt,710157,712006,1849,20,N,N,-,-1,-1
MULIFE.txt,710690,712617,1927,20,N,N,-,-1,-1
MULIFE.txt,710990,713635,2645,20,Y,N,-,-1,-1
MULIFE.txt,711491,714388,2897,20,Y,N,-,-1,-1
MULIFE.txt,712008,714971,2963,20,Y,N,-,-1,-1
MULIFE.txt,712618,715356,2738,20,Y,N,-,-1,-1
MULIFE.txt,713638,715730,2092,20,Y,N,-,-1,-1
MULIFE.txt,714389,716370,1981,20,Y,N,-,-1,-1
MULIFE.txt,714973,717093,2120,20,Y,N,-,-1,-1
MULIFE.txt,715357,717958,2601,20,N,N,-,-1,-1
MULIFE.txt,715732,718317,2585,20,N,N,-,-1,-1
MULIFE.txt,716371,718964,2593,20,N,Y,1437992560557,718760,719849
MULIFE.txt,717094,719664,2570,20,N,Y,1437992560557,718760,719849
MULIFE.txt,717959,720493,2534,20,Y,Y,1437992801449,719924,720764
MULIFE.txt,718320,720870,2550,20,Y,Y,1437992801449,719924,720764
MULIFE.txt,718965,721148,2183,20,Y,Y,1437992801449,719924,720764
MULIFE.txt,719665,721642,1977,20,Y,Y,1437992801449,719924,720764
MULIFE.txt,720494,722233,1739,20,Y,Y,1437992801449,719924,720764
MULIFE.txt,720871,722479,1608,20,N,N,-,-1,-1
MULIFE.txt,721149,722916,1767,20,Y,N,-,-1,-1
MULIFE.txt,721643,723529,1886,20,Y,N,-,-1,-1
MULIFE.txt,722234,724005,1771,20,Y,N,-,-1,-1
MULIFE.txt,722480,724706,2226,20,Y,N,-,-1,-1
MULIFE.txt,722917,725386,2469,20,Y,N,-,-1,-1
MULIFE.txt,723530,726144,2614,20,Y,N,-,-1,-1
MULIFE.txt,724008,726922,2914,20,Y,N,-,-1,-1
MULIFE.txt,724708,727422,2714,20,Y,N,-,-1,-1
MULIFE.txt,725387,728135,2748,20,Y,N,-,-1,-1
MULIFE.txt,726147,729216,3069,20,Y,N,-,-1,-1
MULIFE.txt,726923,729677,2754,20,Y,N,-,-1,-1
MULIFE.txt,727423,730258,2835,20,Y,N,-,-1,-1
MULIFE.txt,728136,731172,3036,20,Y,N,-,-1,-1
MULIFE.txt,729218,731655,2437,20,Y,N,-,-1,-1
MULIFE.txt,729680,732165,2485,20,N,N,-,-1,-1
MULIFE.txt,730259,732744,2485,20,N,N,-,-1,-1
MULIFE.txt,731173,733607,2434,20,Y,N,-,-1,-1
MULIFE.txt,731658,734180,2522,20,Y,N,-,-1,-1
MULIFE.txt,732166,734722,2556,20,Y,N,-,-1,-1
MULIFE.txt,732745,735503,2758,20,Y,N,-,-1,-1
MULIFE.txt,733607,736017,2410,20,Y,N,-,-1,-1
MULIFE.txt,734181,736435,2254,20,Y,N,-,-1,-1
MULIFE.txt,734723,737071,2348,20,N,N,-,-1,-1
MULIFE.txt,735504,737421,1917,20,N,N,-,-1,-1
MULIFE.txt,736018,738016,1998,20,N,N,-,-1,-1
MULIFE.txt,736437,738561,2124,20,N,N,-,-1,-1
MULIFE.txt,737074,739184,2110,20,Y,N,-,-1,-1
MULIFE.txt,737422,739281,1859,20,Y,N,-,-1,-1
MULIFE.txt,738019,739921,1902,20,Y,N,-,-1,-1
MULIFE.txt,738564,740282,1718,20,Y,N,-,-1,-1
MULIFE.txt,739189,740851,1662,20,Y,Y,1437993458963,740703,741759
MULIFE.txt,739282,741394,2112,20,Y,Y,1437993458963,740703,741759
MULIFE.txt,739922,741839,1917,20,Y,Y,1437993458963,740703,741759
MULIFE.txt,740283,742341,2058,20,Y,Y,1437993458963,740703,741759
MULIFE.txt,740852,742694,1842,20,Y,Y,1437993458963,740703,741759
MULIFE.txt,741395,742954,1559,20,Y,Y,1437993458963,740703,741759
MULIFE.txt,741842,743250,1408,20,Y,N,-,-1,-1
MULIFE.txt,742342,743489,1147,20,N,N,-,-1,-1
MULIFE.txt,742695,743854,1159,20,N,N,-,-1,-1
MULIFE.txt,742955,744359,1404,20,Y,N,-,-1,-1
MULIFE.txt,743251,745183,1932,20,Y,N,-,-1,-1
MULIFE.txt,743490,745791,2301,20,Y,N,-,-1,-1
MULIFE.txt,743855,746619,2764,20,Y,N,-,-1,-1
MULIFE.txt,744362,747100,2738,20,Y,Y,1437993739565,746751,748086
MULIFE.txt,745184,748138,2954,20,Y,Y,1437993739565,746751,748086
MULIFE.txt,745792,748509,2717,20,Y,Y,1437993739565,746751,748086
MULIFE.txt,746620,749107,2487,20,Y,Y,1437993739565,746751,748086
MULIFE.txt,747101,749364,2263,20,Y,Y,1437993739565,746751,748086
MULIFE.txt,748143,750514,2371,20,N,N,-,-1,-1
MULIFE.txt,748510,751117,2607,20,Y,N,-,-1,-1
MULIFE.txt,749110,751791,2681,20,Y,N,-,-1,-1
MULIFE.txt,749365,752566,3201,20,Y,N,-,-1,-1
MULIFE.txt,750515,753088,2573,20,Y,N,-,-1,-1
MULIFE.txt,751118,753911,2793,20,Y,N,-,-1,-1
MULIFE.txt,751794,754306,2512,20,Y,N,-,-1,-1
MULIFE.txt,752567,754609,2042,20,Y,N,-,-1,-1
MULIFE.txt,753089,755263,2174,20,Y,N,-,-1,-1
MULIFE.txt,753912,755628,1716,20,Y,N,-,-1,-1
MULIFE.txt,754307,756089,1782,20,Y,N,-,-1,-1
MULIFE.txt,754610,757300,2690,20,Y,N,-,-1,-1
MULIFE.txt,755264,758041,2777,20,Y,N,-,-1,-1
MULIFE.txt,755629,758941,3312,20,Y,N,-,-1,-1
MULIFE.txt,756091,759819,3728,20,Y,N,-,-1,-1
MULIFE.txt,757303,760334,3031,20,Y,Y,1437994269353,759820,760565
MULIFE.txt,758044,760992,2948,20,Y,Y,1437994269353,759820,760565
MULIFE.txt,758942,761760,2818,20,Y,Y,1437994269353,759820,760565
MULIFE.txt,759822,762353,2531,20,Y,Y,1437994269353,759820,760565
MULIFE.txt,760335,763075,2740,20,N,Y,1437994269353,759820,760565
MULIFE.txt,760993,764037,3044,20,Y,N,-,-1,-1
MULIFE.txt,761763,764500,2737,20,Y,N,-,-1,-1
MULIFE.txt,762354,765015,2661,20,N,N,-,-1,-1
MULIFE.txt,763078,765880,2802,20,N,N,-,-1,-1
MULIFE.txt,764040,766417,2377,20,N,N,-,-1,-1
MULIFE.txt,764501,767351,2850,20,N,N,-,-1,-1
MULIFE.txt,765016,768498,3482,20,Y,N,-,-1,-1
MULIFE.txt,765883,769318,3435,20,Y,N,-,-1,-1
MULIFE.txt,766420,770140,3720,20,Y,N,-,-1,-1
MULIFE.txt,767352,770340,2988,20,Y,N,-,-1,-1
MULIFE.txt,768499,771029,2530,20,Y,N,-,-1,-1
MULIFE.txt,769321,771316,1995,20,Y,Y,1438000608332,771119,771952
MULIFE.txt,770141,771956,1815,20,Y,Y,1438000608332,771119,771952
MULIFE.txt,770342,772943,2601,20,N,Y,1438000608332,771119,771952
MULIFE.txt,771034,773375,2341,20,N,Y,1438000608332,771119,771952
MULIFE.txt,771317,773978,2661,20,Y,Y,1438000608332,771119,771952
MULIFE.txt,771959,774318,2359,20,Y,N,-,-1,-1
MULIFE.txt,772946,775412,2466,20,Y,N,-,-1,-1
MULIFE.txt,773376,775994,2618,20,Y,N,-,-1,-1
MULIFE.txt,773979,776431,2452,20,Y,N,-,-1,-1
MULIFE.txt,774319,777034,2715,20,N,N,-,-1,-1
MULIFE.txt,775413,777994,2581,20,N,N,-,-1,-1
MULIFE.txt,775995,778536,2541,20,N,N,-,-1,-1
MULIFE.txt,776434,778914,2480,20,Y,Y,1438001606981,778715,780387
MULIFE.txt,777035,779369,2334,20,Y,Y,1438001606981,778715,780387
MULIFE.txt,777995,780326,2331,20,Y,Y,1438001606981,778715,780387
MULIFE.txt,778537,780777,2240,20,Y,Y,1438001606981,778715,780387
MULIFE.txt,778915,781225,2310,20,N,Y,1438001606981,778715,780387
MULIFE.txt,779370,781661,2291,20,Y,Y,1438001606981,778715,780387
MULIFE.txt,780329,782050,1721,20,Y,Y,1438001606981,778715,780387
MULIFE.txt,780778,782326,1548,20,N,N,-,-1,-1
MULIFE.txt,781226,782828,1602,20,N,N,-,-1,-1
MULIFE.txt,781664,783268,1604,20,N,N,-,-1,-1
MULIFE.txt,782053,784060,2007,20,N,N,-,-1,-1
MULIFE.txt,782329,785000,2671,20,N,N,-,-1,-1
MULIFE.txt,782829,785434,2605,20,N,N,-,-1,-1
MULIFE.txt,783269,785839,2570,20,N,N,-,-1,-1
MULIFE.txt,784061,786199,2138,20,N,N,-,-1,-1
MULIFE.txt,785003,786534,1531,20,N,N,-,-1,-1
MULIFE.txt,785435,787000,1565,20,N,N,-,-1,-1
MULIFE.txt,785840,787511,1671,20,N,N,-,-1,-1
MULIFE.txt,786202,787881,1679,20,N,N,-,-1,-1
MULIFE.txt,786535,788660,2125,20,Y,N,-,-1,-1
MULIFE.txt,787001,789650,2649,20,Y,N,-,-1,-1
MULIFE.txt,787512,790692,3180,20,Y,N,-,-1,-1
MULIFE.txt,787884,791247,3363,20,Y,N,-,-1,-1
MULIFE.txt,788661,791832,3171,20,Y,N,-,-1,-1
MULIFE.txt,789653,792402,2749,20,Y,N,-,-1,-1
MULIFE.txt,790693,793376,2683,20,Y,N,-,-1,-1
MULIFE.txt,791250,794040,2790,20,N,N,-,-1,-1
MULIFE.txt,791834,794894,3060,20,N,N,-,-1,-1
MULIFE.txt,792403,795332,2929,20,N,N,-,-1,-1
MULIFE.txt,793377,796114,2737,20,N,N,-,-1,-1
MULIFE.txt,794041,796380,2339,20,N,N,-,-1,-1
MULIFE.txt,794895,796755,1860,20,N,N,-,-1,-1
MULIFE.txt,795333,797132,1799,20,N,N,-,-1,-1
MULIFE.txt,796117,799176,3059,20,N,N,-,-1,-1
MULIFE.txt,796381,800329,3948,20,Y,N,-,-1,-1
MULIFE.txt,796758,801196,4438,20,Y,N,-,-1,-1
MULIFE.txt,797133,801947,4814,20,Y,N,-,-1,-1
MULIFE.txt,799179,802810,3631,20,Y,N,-,-1,-1
MULIFE.txt,800330,803517,3187,20,Y,N,-,-1,-1
MULIFE.txt,801197,804086,2889,20,N,N,-,-1,-1
MULIFE.txt,801949,804878,2929,20,Y,N,-,-1,-1
MULIFE.txt,802812,805675,2863,20,Y,N,-,-1,-1
MULIFE.txt,803518,806074,2556,20,N,N,-,-1,-1
MULIFE.txt,804087,806361,2274,20,N,N,-,-1,-1
MULIFE.txt,804879,806941,2062,20,N,N,-,-1,-1
MULIFE.txt,805676,807617,1941,20,N,N,-,-1,-1
MULIFE.txt,806075,808674,2599,20,N,N,-,-1,-1
MULIFE.txt,806362,809220,2858,20,Y,N,-,-1,-1
MULIFE.txt,806942,809978,3036,20,Y,N,-,-1,-1
MULIFE.txt,807618,810693,3075,20,Y,N,-,-1,-1
MULIFE.txt,808676,811610,2934,20,N,N,-,-1,-1
MULIFE.txt,809221,812028,2807,20,N,N,-,-1,-1
MULIFE.txt,809979,812914,2935,20,N,N,-,-1,-1
MULIFE.txt,810694,813601,2907,20,Y,N,-,-1,-1
MULIFE.txt,811613,814719,3106,20,Y,N,-,-1,-1
MULIFE.txt,812031,815281,3250,20,Y,N,-,-1,-1
MULIFE.txt,812915,815967,3052,20,Y,N,-,-1,-1
MULIFE.txt,813602,816774,3172,20,Y,N,-,-1,-1
MULIFE.txt,814720,817327,2607,20,Y,N,-,-1,-1
MULIFE.txt,815282,817876,2594,20,Y,N,-,-1,-1
MULIFE.txt,815968,818478,2510,20,Y,N,-,-1,-1
MULIFE.txt,816775,819314,2539,20,Y,N,-,-1,-1
MULIFE.txt,817328,820071,2743,20,Y,N,-,-1,-1
MULIFE.txt,817877,821087,3210,20,Y,N,-,-1,-1
MULIFE.txt,818479,821907,3428,20,Y,N,-,-1,-1
MULIFE.txt,819317,822641,3324,20,Y,N,-,-1,-1
MULIFE.txt,820072,823177,3105,20,N,N,-,-1,-1
MULIFE.txt,821092,823646,2554,20,Y,N,-,-1,-1
MULIFE.txt,821908,824295,2387,20,Y,N,-,-1,-1
MULIFE.txt,822642,824817,2175,20,Y,N,-,-1,-1
MULIFE.txt,823178,825271,2093,20,Y,N,-,-1,-1
MULIFE.txt,823647,825974,2327,20,N,N,-,-1,-1
MULIFE.txt,824298,827161,2863,20,N,N,-,-1,-1
MULIFE.txt,824818,827429,2611,20,N,N,-,-1,-1
MULIFE.txt,825272,827664,2392,20,N,N,-,-1,-1
MULIFE.txt,825977,828061,2084,20,N,N,-,-1,-1
MULIFE.txt,827166,828623,1457,20,N,N,-,-1,-1
MULIFE.txt,827430,829126,1696,20,N,N,-,-1,-1
MULIFE.txt,827665,829557,1892,20,N,N,-,-1,-1
MULIFE.txt,828064,829910,1846,20,N,N,-,-1,-1
MULIFE.txt,828624,830444,1820,20,N,N,-,-1,-1
MULIFE.txt,829127,831041,1914,20,N,N,-,-1,-1
MULIFE.txt,829558,831647,2089,20,N,N,-,-1,-1
MULIFE.txt,829911,832074,2163,20,N,N,-,-1,-1
MULIFE.txt,830445,832341,1896,20,Y,N,-,-1,-1
MULIFE.txt,831042,832804,1762,20,Y,N,-,-1,-1
MULIFE.txt,831648,833187,1539,20,Y,N,-,-1,-1
MULIFE.txt,832075,833823,1748,20,Y,N,-,-1,-1
MULIFE.txt,832342,834243,1901,20,Y,N,-,-1,-1
MULIFE.txt,832805,834922,2117,20,N,N,-,-1,-1
MULIFE.txt,833188,835591,2403,20,N,N,-,-1,-1
MULIFE.txt,833824,836329,2505,20,N,N,-,-1,-1
MULIFE.txt,834244,836752,2508,20,N,N,-,-1,-1
MULIFE.txt,834923,837308,2385,20,N,N,-,-1,-1
MULIFE.txt,835592,837954,2362,20,Y,N,-,-1,-1
MULIFE.txt,836332,838428,2096,20,N,N,-,-1,-1
MULIFE.txt,836753,839283,2530,20,N,N,-,-1,-1
MULIFE.txt,837309,839756,2447,20,N,N,-,-1,-1
MULIFE.txt,837955,840282,2327,20,N,N,-,-1,-1
MULIFE.txt,838429,840681,2252,20,N,N,-,-1,-1
MULIFE.txt,839285,841049,1764,20,N,N,-,-1,-1
MULIFE.txt,839757,841535,1778,20,N,N,-,-1,-1
MULIFE.txt,840283,841820,1537,20,N,N,-,-1,-1
MULIFE.txt,840682,842299,1617,20,N,N,-,-1,-1
MULIFE.txt,841052,843311,2259,20,Y,N,-,-1,-1
MULIFE.txt,841536,843993,2457,20,Y,N,-,-1,-1
MULIFE.txt,841821,844475,2654,20,Y,N,-,-1,-1
MULIFE.txt,842302,844982,2680,20,Y,N,-,-1,-1
MULIFE.txt,843312,845380,2068,20,Y,N,-,-1,-1
MULIFE.txt,843994,846449,2455,20,Y,N,-,-1,-1
MULIFE.txt,844476,846923,2447,20,Y,N,-,-1,-1
MULIFE.txt,844983,847668,2685,20,Y,N,-,-1,-1
MULIFE.txt,845383,848855,3472,20,Y,N,-,-1,-1
MULIFE.txt,846452,849351,2899,20,Y,N,-,-1,-1
MULIFE.txt,846924,850662,3738,20,Y,N,-,-1,-1
MULIFE.txt,847669,851210,3541,20,Y,N,-,-1,-1
MULIFE.txt,848858,851765,2907,20,Y,N,-,-1,-1
MULIFE.txt,849354,852196,2842,20,Y,N,-,-1,-1
MULIFE.txt,850665,852532,1867,20,Y,N,-,-1,-1
MULIFE.txt,851211,852973,1762,20,Y,N,-,-1,-1
MULIFE.txt,851766,853505,1739,20,Y,N,-,-1,-1
MULIFE.txt,852197,853849,1652,20,Y,N,-,-1,-1
MULIFE.txt,852533,854069,1536,20,Y,N,-,-1,-1
MULIFE.txt,852974,854486,1512,20,N,N,-,-1,-1
MULIFE.txt,853506,855033,1527,20,N,N,-,-1,-1
MULIFE.txt,853850,855326,1476,20,N,N,-,-1,-1
MULIFE.txt,854072,855531,1459,20,N,N,-,-1,-1
MULIFE.txt,854487,855756,1269,20,N,N,-,-1,-1
MULIFE.txt,855035,856173,1138,20,N,N,-,-1,-1
MULIFE.txt,855327,856607,1280,20,N,N,-,-1,-1
MULIFE.txt,855532,857444,1912,20,N,N,-,-1,-1
MULIFE.txt,855757,858096,2339,20,Y,N,-,-1,-1
MULIFE.txt,856176,858679,2503,20,Y,N,-,-1,-1
MULIFE.txt,856608,859674,3066,20,Y,N,-,-1,-1
MULIFE.txt,857445,860238,2793,20,Y,N,-,-1,-1
MULIFE.txt,858099,860759,2660,20,Y,N,-,-1,-1
MULIFE.txt,858680,861218,2538,20,Y,N,-,-1,-1
MULIFE.txt,859677,861481,1804,20,Y,N,-,-1,-1
MULIFE.txt,860241,861901,1660,20,Y,N,-,-1,-1
MULIFE.txt,860760,862701,1941,20,Y,N,-,-1,-1
MULIFE.txt,861219,863574,2355,20,Y,N,-,-1,-1
MULIFE.txt,861482,864235,2753,20,N,N,-,-1,-1
MULIFE.txt,861902,865151,3249,20,N,N,-,-1,-1
MULIFE.txt,862703,865847,3144,20,N,N,-,-1,-1
MULIFE.txt,863575,866477,2902,20,N,N,-,-1,-1
MULIFE.txt,864236,867077,2841,20,Y,N,-,-1,-1
MULIFE.txt,865152,867246,2094,20,Y,N,-,-1,-1
MULIFE.txt,865850,867596,1746,20,Y,N,-,-1,-1
MULIFE.txt,866478,868271,1793,20,Y,N,-,-1,-1
MULIFE.txt,867078,869040,1962,20,Y,N,-,-1,-1
MULIFE.txt,867247,869916,2669,20,Y,N,-,-1,-1
MULIFE.txt,867599,870597,2998,20,Y,N,-,-1,-1
MULIFE.txt,868272,871140,2868,20,N,N,-,-1,-1
MULIFE.txt,869043,871468,2425,20,N,N,-,-1,-1
MULIFE.txt,869917,871694,1777,20,N,N,-,-1,-1
MULIFE.txt,870598,871992,1394,20,N,N,-,-1,-1
MULIFE.txt,871141,872585,1444,20,N,N,-,-1,-1
MULIFE.txt,871469,873587,2118,20,Y,N,-,-1,-1
MULIFE.txt,871695,873828,2133,20,Y,N,-,-1,-1
MULIFE.txt,871993,874163,2170,20,Y,N,-,-1,-1
MULIFE.txt,872588,874990,2402,20,Y,N,-,-1,-1
MULIFE.txt,873590,875482,1892,20,Y,N,-,-1,-1
MULIFE.txt,873829,875777,1948,20,Y,N,-,-1,-1
MULIFE.txt,874164,875994,1830,20,Y,N,-,-1,-1
MULIFE.txt,874993,876359,1366,20,Y,N,-,-1,-1
MULIFE.txt,875483,876556,1073,20,Y,N,-,-1,-1
MULIFE.txt,875778,876851,1073,20,Y,N,-,-1,-1
MULIFE.txt,875995,877007,1012,20,Y,N,-,-1,-1
MULIFE.txt,876360,877402,1042,20,Y,N,-,-1,-1
MULIFE.txt,876557,877670,1113,20,Y,N,-,-1,-1
MULIFE.txt,876852,877900,1048,20,Y,N,-,-1,-1
MULIFE.txt,877008,878261,1253,20,Y,N,-,-1,-1
MULIFE.txt,877403,878503,1100,20,Y,N,-,-1,-1
MULIFE.txt,877673,878889,1216,20,N,N,-,-1,-1
MULIFE.txt,877901,879494,1593,20,N,N,-,-1,-1
MULIFE.txt,878263,879661,1398,20,N,N,-,-1,-1
MULIFE.txt,878504,880018,1514,20,Y,N,-,-1,-1
MULIFE.txt,878890,880179,1289,20,N,N,-,-1,-1
MULIFE.txt,879497,880420,923,20,N,N,-,-1,-1
MULIFE.txt,879662,880873,1211,20,N,N,-,-1,-1
MULIFE.txt,880019,881474,1455,20,N,N,-,-1,-1
MULIFE.txt,880180,882232,2052,20,Y,N,-,-1,-1
MULIFE.txt,880421,882960,2539,20,Y,N,-,-1,-1
MULIFE.txt,880876,883531,2655,20,Y,N,-,-1,-1
MULIFE.txt,881477,884503,3026,20,Y,N,-,-1,-1
MULIFE.txt,882233,885253,3020,20,Y,N,-,-1,-1
MULIFE.txt,882961,885646,2685,20,N,N,-,-1,-1
MULIFE.txt,883532,885881,2349,20,Y,N,-,-1,-1
MULIFE.txt,884504,886040,1536,20,N,N,-,-1,-1
MULIFE.txt,885256,886491,1235,20,N,N,-,-1,-1
MULIFE.txt,885647,886896,1249,20,N,N,-,-1,-1
MULIFE.txt,885883,887458,1575,20,N,N,-,-1,-1
MULIFE.txt,886041,887771,1730,20,N,N,-,-1,-1
MULIFE.txt,886494,888375,1881,20,N,N,-,-1,-1
MULIFE.txt,886897,890438,3541,20,N,N,-,-1,-1
MULIFE.txt,887459,891033,3574,20,N,N,-,-1,-1
MULIFE.txt,887772,891551,3779,20,Y,N,-,-1,-1
MULIFE.txt,888378,892556,4178,20,Y,N,-,-1,-1
MULIFE.txt,890441,892659,2218,20,Y,N,-,-1,-1
MULIFE.txt,891035,893085,2050,20,Y,Y,1438002747854,892999,894161
MULIFE.txt,891552,894237,2685,20,Y,Y,1438002747854,892999,894161
MULIFE.txt,892564,894745,2181,20,Y,Y,1438002747854,892999,894161
MULIFE.txt,892660,895871,3211,20,Y,Y,1438002747854,892999,894161
MULIFE.txt,893088,896477,3389,20,Y,Y,1438002747854,892999,894161
MULIFE.txt,894240,896978,2738,20,Y,N,-,-1,-1
MULIFE.txt,894748,897502,2754,20,Y,N,-,-1,-1
MULIFE.txt,895874,897957,2083,20,Y,N,-,-1,-1
MULIFE.txt,896478,898689,2211,20,Y,N,-,-1,-1
MULIFE.txt,896979,899153,2174,20,Y,N,-,-1,-1
MULIFE.txt,897505,899646,2141,20,Y,N,-,-1,-1
MULIFE.txt,897958,900227,2269,20,Y,N,-,-1,-1
MULIFE.txt,898690,900801,2111,20,Y,N,-,-1,-1
MULIFE.txt,899156,901612,2456,20,Y,N,-,-1,-1
MULIFE.txt,899647,902185,2538,20,Y,Y,1438003564102,901839,902422
MULIFE.txt,900230,902938,2708,20,Y,Y,1438003564102,901839,902422
MULIFE.txt,900802,903246,2444,20,Y,Y,1438003564102,901839,902422
MULIFE.txt,901614,903761,2147,20,Y,Y,1438003564102,901839,902422
MULIFE.txt,902188,904284,2096,20,Y,Y,1438003564102,901839,902422
MULIFE.txt,902941,904900,1959,20,Y,Y,1438003925285,903100,903985
MULIFE.txt,903247,905248,2001,20,Y,Y,1438003925285,903100,903985
MULIFE.txt,903762,905936,2174,20,Y,Y,1438004319285,905549,905936
MULIFE.txt,904285,906415,2130,20,Y,Y,1438004319285,905549,905936
MULIFE.txt,904901,907150,2249,20,Y,Y,1438004319285,905549,905936
MULIFE.txt,905249,907543,2294,20,Y,Y,1438004319285,905549,905936
MULIFE.txt,905939,907945,2006,20,Y,N,-,-1,-1
MULIFE.txt,906416,908660,2244,20,Y,N,-,-1,-1
MULIFE.txt,907151,909193,2042,20,Y,N,-,-1,-1
MULIFE.txt,907546,909806,2260,20,Y,N,-,-1,-1
MULIFE.txt,907946,910590,2644,20,Y,N,-,-1,-1
MULIFE.txt,908661,911008,2347,20,Y,N,-,-1,-1
MULIFE.txt,909195,911624,2429,20,Y,N,-,-1,-1
MULIFE.txt,909807,912043,2236,20,Y,N,-,-1,-1
MULIFE.txt,910591,912509,1918,20,Y,N,-,-1,-1
MULIFE.txt,911009,912881,1872,20,Y,N,-,-1,-1
MULIFE.txt,911627,913067,1440,20,Y,N,-,-1,-1
MULIFE.txt,912044,913527,1483,20,Y,N,-,-1,-1
MULIFE.txt,912510,913927,1417,20,Y,N,-,-1,-1
MULIFE.txt,912882,914137,1255,20,Y,N,-,-1,-1
MULIFE.txt,913068,914489,1421,20,Y,N,-,-1,-1
MULIFE.txt,913528,914979,1451,20,Y,N,-,-1,-1
MULIFE.txt,913930,915213,1283,20,Y,N,-,-1,-1
MULIFE.txt,914139,916139,2000,20,Y,N,-,-1,-1
MULIFE.txt,914490,916814,2324,20,N,N,-,-1,-1
MULIFE.txt,914980,917367,2387,20,Y,N,-,-1,-1
MULIFE.txt,915214,918194,2980,20,Y,N,-,-1,-1
MULIFE.txt,916140,918503,2363,20,Y,N,-,-1,-1
MULIFE.txt,916815,919465,2650,20,Y,N,-,-1,-1
MULIFE.txt,917370,919831,2461,20,Y,N,-,-1,-1
MULIFE.txt,918197,920471,2274,20,Y,N,-,-1,-1
MULIFE.txt,918504,920973,2469,20,Y,N,-,-1,-1
MULIFE.txt,919468,921695,2227,20,Y,N,-,-1,-1
MULIFE.txt,919834,922279,2445,20,Y,N,-,-1,-1
MULIFE.txt,920474,922679,2205,20,Y,N,-,-1,-1
MULIFE.txt,920974,923513,2539,20,Y,N,-,-1,-1
MULIFE.txt,921696,923748,2052,20,Y,N,-,-1,-1
MULIFE.txt,922281,925514,3233,20,Y,N,-,-1,-1
MULIFE.txt,922681,926206,3525,20,Y,N,-,-1,-1
MULIFE.txt,923514,927006,3492,20,Y,N,-,-1,-1
MULIFE.txt,923749,928372,4623,20,Y,N,-,-1,-1
MULIFE.txt,925517,929088,3571,20,Y,N,-,-1,-1
MULIFE.txt,926209,929713,3504,20,Y,N,-,-1,-1
MULIFE.txt,927007,930326,3319,20,Y,N,-,-1,-1
MULIFE.txt,928373,930925,2552,20,Y,N,-,-1,-1
MULIFE.txt,929091,931324,2233,20,Y,N,-,-1,-1
MULIFE.txt,929714,932268,2554,20,Y,N,-,-1,-1
MULIFE.txt,930327,932697,2370,20,Y,N,-,-1,-1
MULIFE.txt,930926,933088,2162,20,Y,N,-,-1,-1
MULIFE.txt,931325,933568,2243,20,Y,N,-,-1,-1
MULIFE.txt,932269,934099,1830,20,Y,N,-,-1,-1
MULIFE.txt,932700,934919,2219,20,Y,N,-,-1,-1
MULIFE.txt,933091,935899,2808,20,Y,N,-,-1,-1
MULIFE.txt,933569,936491,2922,20,Y,N,-,-1,-1
MULIFE.txt,934100,937250,3150,20,Y,N,-,-1,-1
MULIFE.txt,934922,937495,2573,20,Y,N,-,-1,-1
MULIFE.txt,935902,938336,2434,20,Y,N,-,-1,-1
MULIFE.txt,936492,938778,2286,20,Y,N,-,-1,-1
MULIFE.txt,937251,939194,1943,20,Y,N,-,-1,-1
MULIFE.txt,937497,939804,2307,20,Y,N,-,-1,-1
MULIFE.txt,938337,940190,1853,20,Y,N,-,-1,-1
MULIFE.txt,938779,940568,1789,20,Y,N,-,-1,-1
MULIFE.txt,939195,941050,1855,20,Y,N,-,-1,-1
MULIFE.txt,939805,941319,1514,20,Y,N,-,-1,-1
MULIFE.txt,940191,941781,1590,20,Y,N,-,-1,-1
MULIFE.txt,940570,942086,1516,20,Y,N,-,-1,-1
MULIFE.txt,941053,942795,1742,20,Y,N,-,-1,-1
MULIFE.txt,941320,943061,1741,20,Y,N,-,-1,-1
MULIFE.txt,941786,943592,1806,20,N,N,-,-1,-1
MULIFE.txt,942089,944251,2162,20,Y,N,-,-1,-1
MULIFE.txt,942798,944538,1740,20,Y,N,-,-1,-1
MULIFE.txt,943062,945813,2751,20,Y,N,-,-1,-1
MULIFE.txt,943593,946430,2837,20,Y,N,-,-1,-1
MULIFE.txt,944252,947066,2814,20,Y,N,-,-1,-1
MULIFE.txt,944539,947871,3332,20,Y,N,-,-1,-1
MULIFE.txt,945814,948312,2498,20,Y,N,-,-1,-1
MULIFE.txt,946431,948934,2503,20,Y,N,-,-1,-1
MULIFE.txt,947069,949491,2422,20,N,N,-,-1,-1
MULIFE.txt,947872,949866,1994,20,N,N,-,-1,-1
MULIFE.txt,948313,950448,2135,20,N,N,-,-1,-1
MULIFE.txt,948935,951292,2357,20,N,N,-,-1,-1
MULIFE.txt,949492,952241,2749,20,N,N,-,-1,-1
MULIFE.txt,949867,953087,3220,20,N,N,-,-1,-1
MULIFE.txt,950449,953760,3311,20,N,Y,1438005303228,953665,955052
MULIFE.txt,951293,954042,2749,20,N,Y,1438005303228,953665,955052
MULIFE.txt,952242,954953,2711,20,Y,Y,1438005303228,953665,955052
MULIFE.txt,953088,955481,2393,20,N,Y,1438005724733,955431,957516
MULIFE.txt,953761,956064,2303,20,Y,Y,1438005724733,955431,957516
MULIFE.txt,954043,957060,3017,20,Y,Y,1438005724733,955431,957516
MULIFE.txt,954954,957909,2955,20,Y,Y,1438005724733,955431,957516
MULIFE.txt,955482,959117,3635,20,Y,Y,1438005724733,955431,957516
MULIFE.txt,956065,959644,3579,20,Y,Y,1438005724733,955431,957516
MULIFE.txt,957061,960439,3378,20,Y,Y,1438005724733,955431,957516
MULIFE.txt,957912,961316,3404,20,Y,N,-,-1,-1
MULIFE.txt,959120,961980,2860,20,Y,N,-,-1,-1
MULIFE.txt,959645,962900,3255,20,Y,N,-,-1,-1
MULIFE.txt,960440,963722,3282,20,Y,N,-,-1,-1
MULIFE.txt,961319,964594,3275,20,Y,N,-,-1,-1
MULIFE.txt,961983,965563,3580,20,Y,N,-,-1,-1
MULIFE.txt,962903,966235,3332,20,Y,N,-,-1,-1
MULIFE.txt,963723,966705,2982,20,Y,N,-,-1,-1
MULIFE.txt,964595,967112,2517,20,Y,N,-,-1,-1
MULIFE.txt,965564,967700,2136,20,Y,N,-,-1,-1
MULIFE.txt,966236,968059,1823,20,Y,N,-,-1,-1
MULIFE.txt,966706,968752,2046,20,Y,N,-,-1,-1
MULIFE.txt,967115,969092,1977,20,Y,N,-,-1,-1
MULIFE.txt,967703,970129,2426,20,Y,N,-,-1,-1
MULIFE.txt,968061,970658,2597,20,Y,N,-,-1,-1
MULIFE.txt,968757,971284,2527,20,Y,Y,1438006506960,970689,974719
MULIFE.txt,969094,972405,3311,20,Y,Y,1438006506960,970689,974719
MULIFE.txt,970130,973830,3700,20,Y,Y,1438006506960,970689,974719
MULIFE.txt,970659,974826,4167,20,Y,Y,1438006506960,970689,974719
MULIFE.txt,971285,975481,4196,20,Y,Y,1438006506960,970689,974719
MULIFE.txt,972406,976041,3635,20,Y,Y,1438006506960,970689,974719
MULIFE.txt,973831,976295,2464,20,Y,Y,1438006506960,970689,974719
MULIFE.txt,974827,976746,1919,20,N,N,-,-1,-1
MULIFE.txt,975482,977369,1887,20,N,N,-,-1,-1
MULIFE.txt,976042,977715,1673,20,N,N,-,-1,-1
MULIFE.txt,976298,978001,1703,20,N,N,-,-1,-1
MULIFE.txt,976747,978350,1603,20,N,N,-,-1,-1
MULIFE.txt,977370,979021,1651,20,Y,N,-,-1,-1
MULIFE.txt,977716,979676,1960,20,Y,N,-,-1,-1
MULIFE.txt,978002,980348,2346,20,Y,N,-,-1,-1
MULIFE.txt,978353,980866,2513,20,Y,N,-,-1,-1
MULIFE.txt,979022,981282,2260,20,Y,N,-,-1,-1
MULIFE.txt,979679,981931,2252,20,Y,N,-,-1,-1
MULIFE.txt,980349,982327,1978,20,Y,N,-,-1,-1
MULIFE.txt,980867,982607,1740,20,Y,N,-,-1,-1
MULIFE.txt,981285,983393,2108,20,N,N,-,-1,-1
MULIFE.txt,981934,984133,2199,20,N,N,-,-1,-1
MULIFE.txt,982328,984240,1912,20,N,N,-,-1,-1
MULIFE.txt,982608,984369,1761,20,N,N,-,-1,-1
MULIFE.txt,983396,984462,1066,20,N,N,-,-1,-1
MULIFE.txt,984135,984591,456,20,N,N,-,-1,-1
MULIFE.txt,984241,984725,484,20,N,N,-,-1,-1
MULIFE.txt,984370,984865,495,20,N,N,-,-1,-1
MULIFE.txt,984463,985075,612,20,N,N,-,-1,-1
MULIFE.txt,984592,985217,625,20,N,N,-,-1,-1
MULIFE.txt,984726,985356,630,20,N,N,-,-1,-1
MULIFE.txt,984866,985492,626,20,N,N,-,-1,-1
MULIFE.txt,985076,985617,541,20,N,N,-,-1,-1
MULIFE.txt,985219,985795,576,20,N,N,-,-1,-1
MULIFE.txt,985357,986083,726,20,N,N,-,-1,-1
MULIFE.txt,985493,986200,707,20,N,N,-,-1,-1
MULIFE.txt,985618,986334,716,20,N,N,-,-1,-1
MULIFE.txt,985798,986382,584,20,N,N,-,-1,-1
MULIFE.txt,986088,986502,414,20,N,N,-,-1,-1
MULIFE.txt,986201,986603,402,20,N,N,-,-1,-1
MULIFE.txt,986335,986673,338,20,N,N,-,-1,-1
MULIFE.txt,986383,986799,416,20,N,N,-,-1,-1
MULIFE.txt,986503,986990,487,20,N,N,-,-1,-1
MULIFE.txt,986604,987090,486,20,N,N,-,-1,-1
MULIFE.txt,986674,987363,689,20,N,N,-,-1,-1
MULIFE.txt,986800,987558,758,20,N,N,-,-1,-1
MULIFE.txt,986991,987650,659,20,N,N,-,-1,-1
MULIFE.txt,987092,987777,685,20,N,N,-,-1,-1
MULIFE.txt,987366,987952,586,20,N,N,-,-1,-1
MULIFE.txt,987558,988103,545,20,N,N,-,-1,-1
MULIFE.txt,987652,988169,517,20,N,N,-,-1,-1
MULIFE.txt,987778,988323,545,20,N,N,-,-1,-1
MULIFE.txt,987953,988342,389,20,N,N,-,-1,-1
MULIFE.txt,988104,988464,360,20,N,N,-,-1,-1
MULIFE.txt,988170,988595,425,20,N,N,-,-1,-1
MULIFE.txt,988324,988738,414,20,N,N,-,-1,-1
MULIFE.txt,988344,988854,510,20,N,N,-,-1,-1
MULIFE.txt,988465,988943,478,20,N,N,-,-1,-1
MULIFE.txt,988597,989037,440,20,N,N,-,-1,-1
MULIFE.txt,988740,989100,360,20,N,N,-,-1,-1
MULIFE.txt,988855,989155,300,20,N,N,-,-1,-1
MULIFE.txt,988944,989324,380,20,N,N,-,-1,-1
MULIFE.txt,989038,989396,358,20,N,N,-,-1,-1
MULIFE.txt,989101,989499,398,20,N,N,-,-1,-1
MULIFE.txt,989160,989546,386,20,N,N,-,-1,-1
MULIFE.txt,989325,989627,302,20,N,N,-,-1,-1
MULIFE.txt,989397,989794,397,20,N,N,-,-1,-1
MULIFE.txt,989500,989870,370,20,N,N,-,-1,-1
MULIFE.txt,989547,989927,380,20,N,N,-,-1,-1
MULIFE.txt,989628,989979,351,20,N,N,-,-1,-1
MULIFE.txt,989796,990165,369,20,N,N,-,-1,-1
MULIFE.txt,989871,990352,481,20,N,N,-,-1,-1
MULIFE.txt,989930,990539,609,20,N,N,-,-1,-1
MULIFE.txt,989980,990681,701,20,N,N,-,-1,-1
MULIFE.txt,990166,990920,754,20,N,N,-,-1,-1
MULIFE.txt,990353,991090,737,20,N,N,-,-1,-1
MULIFE.txt,990540,991258,718,20,N,N,-,-1,-1
MULIFE.txt,990684,991426,742,20,N,N,-,-1,-1
MULIFE.txt,990928,991514,586,20,N,N,-,-1,-1
MULIFE.txt,991091,991640,549,20,N,N,-,-1,-1
MULIFE.txt,991259,991705,446,20,N,N,-,-1,-1
MULIFE.txt,991428,991832,404,20,N,N,-,-1,-1
MULIFE.txt,991515,991919,404,20,N,N,-,-1,-1
MULIFE.txt,991641,992014,373,20,N,N,-,-1,-1
MULIFE.txt,991708,992180,472,20,N,N,-,-1,-1
MULIFE.txt,991833,992285,452,20,N,N,-,-1,-1
MULIFE.txt,991920,992553,633,20,N,N,-,-1,-1
MULIFE.txt,992015,992713,698,20,N,N,-,-1,-1
MULIFE.txt,992182,992756,574,20,N,N,-,-1,-1
MULIFE.txt,992286,992848,562,20,N,N,-,-1,-1
MULIFE.txt,992554,992962,408,20,N,N,-,-1,-1
MULIFE.txt,992714,993047,333,20,N,N,-,-1,-1
MULIFE.txt,992757,993119,362,20,N,N,-,-1,-1
MULIFE.txt,992850,993162,312,20,N,N,-,-1,-1
MULIFE.txt,992967,993212,245,20,N,N,-,-1,-1
MULIFE.txt,993048,993258,210,20,N,N,-,-1,-1
MULIFE.txt,993119,993428,309,20,N,N,-,-1,-1
MULIFE.txt,993164,993507,343,20,N,N,-,-1,-1
MULIFE.txt,993213,993550,337,20,N,N,-,-1,-1
MULIFE.txt,993260,993664,404,20,N,N,-,-1,-1
MULIFE.txt,993429,993852,423,20,N,N,-,-1,-1
MULIFE.txt,993510,993938,428,20,N,N,-,-1,-1
MULIFE.txt,993553,994007,454,20,N,N,-,-1,-1
MULIFE.txt,993665,994058,393,20,N,N,-,-1,-1
MULIFE.txt,993855,994163,308,20,N,N,-,-1,-1
MULIFE.txt,993939,994203,264,20,N,N,-,-1,-1
MULIFE.txt,994008,994246,238,20,N,N,-,-1,-1
MULIFE.txt,994059,994305,246,20,N,N,-,-1,-1
MULIFE.txt,994164,994359,195,20,N,N,-,-1,-1
MULIFE.txt,994204,994423,219,20,N,N,-,-1,-1
MULIFE.txt,994247,994560,313,20,N,N,-,-1,-1
MULIFE.txt,994306,994620,314,20,N,N,-,-1,-1
MULIFE.txt,994360,994731,371,20,N,N,-,-1,-1
MULIFE.txt,994426,994886,460,20,N,N,-,-1,-1
MULIFE.txt,994561,994968,407,20,N,N,-,-1,-1
MULIFE.txt,994621,995041,420,20,N,N,-,-1,-1
MULIFE.txt,994732,995131,399,20,N,N,-,-1,-1
MULIFE.txt,994887,995177,290,20,N,N,-,-1,-1
MULIFE.txt,994969,995311,342,20,N,N,-,-1,-1
MULIFE.txt,995042,995418,376,20,N,N,-,-1,-1
MULIFE.txt,995132,995574,442,20,N,N,-,-1,-1
MULIFE.txt,995178,995649,471,20,N,N,-,-1,-1
MULIFE.txt,995313,995726,413,20,N,N,-,-1,-1
MULIFE.txt,995421,995790,369,20,N,N,-,-1,-1
MULIFE.txt,995577,995934,357,20,N,N,-,-1,-1
MULIFE.txt,995650,996062,412,20,N,N,-,-1,-1
MULIFE.txt,995727,996164,437,20,N,N,-,-1,-1
MULIFE.txt,995793,996247,454,20,N,N,-,-1,-1
MULIFE.txt,995937,996462,525,20,N,N,-,-1,-1
MULIFE.txt,996063,996693,630,20,N,N,-,-1,-1
MULIFE.txt,996165,996996,831,20,N,N,-,-1,-1
MULIFE.txt,996248,997028,780,20,N,N,-,-1,-1
MULIFE.txt,996463,997178,715,20,N,N,-,-1,-1
MULIFE.txt,996695,997293,598,20,N,N,-,-1,-1
MULIFE.txt,996997,997349,352,20,N,N,-,-1,-1
MULIFE.txt,997031,997577,546,20,N,N,-,-1,-1
MULIFE.txt,997179,997653,474,20,N,N,-,-1,-1
MULIFE.txt,997295,997727,432,20,N,N,-,-1,-1
MULIFE.txt,997350,997827,477,20,N,N,-,-1,-1
MULIFE.txt,997579,997955,376,20,N,N,-,-1,-1
MULIFE.txt,997654,998113,459,20,N,N,-,-1,-1
MULIFE.txt,997728,998166,438,20,N,N,-,-1,-1
MULIFE.txt,997828,998258,430,20,N,N,-,-1,-1
MULIFE.txt,997956,998416,460,20,N,N,-,-1,-1
MULIFE.txt,998114,998605,491,20,N,N,-,-1,-1
MULIFE.txt,998167,998684,517,20,N,N,-,-1,-1
MULIFE.txt,998263,998837,574,20,N,N,-,-1,-1
MULIFE.txt,998421,998988,567,20,N,N,-,-1,-1
MULIFE.txt,998607,999099,492,20,N,N,-,-1,-1
MULIFE.txt,998684,999163,479,20,N,N,-,-1,-1
MULIFE.txt,998838,999204,366,20,N,N,-,-1,-1
MULIFE.txt,998991,999314,323,20,N,N,-,-1,-1
MULIFE.txt,999099,999463,364,20,N,N,-,-1,-1
MULIFE.txt,999164,999653,489,20,N,N,-,-1,-1
MULIFE.txt,999206,999715,509,20,N,N,-,-1,-1
MULIFE.txt,999314,999768,454,20,N,N,-,-1,-1
MULIFE.txt,999464,999817,353,20,N,N,-,-1,-1
MULIFE.txt,999654,1000004,350,20,N,N,-,-1,-1
MULIFE.txt,999716,1000153,437,20,N,N,-,-1,-1
MULIFE.txt,999768,1000278,510,20,N,N,-,-1,-1
MULIFE.txt,999818,1000346,528,20,N,N,-,-1,-1
MULIFE.txt,1000009,1000435,426,20,N,N,-,-1,-1
MULIFE.txt,1000154,1000484,330,20,N,N,-,-1,-1
MULIFE.txt,1000279,1000608,329,20,N,N,-,-1,-1
MULIFE.txt,1000347,1000815,468,20,N,N,-,-1,-1
MULIFE.txt,1000437,1001108,671,20,N,N,-,-1,-1
MULIFE.txt,1000485,1001152,667,20,N,N,-,-1,-1
MULIFE.txt,1000609,1001297,688,20,N,N,-,-1,-1
MULIFE.txt,1000816,1001374,558,20,N,N,-,-1,-1
MULIFE.txt,1001109,1001461,352,20,N,N,-,-1,-1
MULIFE.txt,1001153,1001527,374,20,N,N,-,-1,-1
MULIFE.txt,1001298,1001575,277,20,N,N,-,-1,-1
MULIFE.txt,1001377,1001714,337,20,N,N,-,-1,-1
MULIFE.txt,1001464,1001760,296,20,N,N,-,-1,-1
MULIFE.txt,1001528,1001884,356,20,N,N,-,-1,-1
MULIFE.txt,1001576,1001956,380,20,N,N,-,-1,-1
MULIFE.txt,1001715,1001995,280,20,N,N,-,-1,-1
MULIFE.txt,1001761,1002127,366,20,N,N,-,-1,-1
MULIFE.txt,1001885,1002256,371,20,N,N,-,-1,-1
MULIFE.txt,1001957,1002376,419,20,N,N,-,-1,-1
MULIFE.txt,1001996,1002504,508,20,N,N,-,-1,-1
MULIFE.txt,1002128,1002650,522,20,N,N,-,-1,-1
MULIFE.txt,1002257,1002796,539,20,N,N,-,-1,-1
MULIFE.txt,1002379,1002897,518,20,N,N,-,-1,-1
MULIFE.txt,1002507,1003041,534,20,N,N,-,-1,-1
MULIFE.txt,1002651,1003088,437,20,N,N,-,-1,-1
MULIFE.txt,1002797,1003129,332,20,N,N,-,-1,-1
MULIFE.txt,1002898,1003189,291,20,N,N,-,-1,-1
MULIFE.txt,1003042,1003233,191,20,N,N,-,-1,-1
MULIFE.txt,1003089,1003327,238,20,N,N,-,-1,-1
MULIFE.txt,1003130,1003414,284,20,N,N,-,-1,-1
MULIFE.txt,1003190,1003456,266,20,N,N,-,-1,-1
MULIFE.txt,1003236,1003590,354,20,N,N,-,-1,-1
MULIFE.txt,1003328,1003705,377,20,N,N,-,-1,-1
MULIFE.txt,1003415,1003835,420,20,N,N,-,-1,-1
MULIFE.txt,1003457,1004042,585,20,N,N,-,-1,-1
MULIFE.txt,1003591,1004104,513,20,N,N,-,-1,-1
MULIFE.txt,1003706,1004269,563,20,N,N,-,-1,-1
MULIFE.txt,1003836,1004436,600,20,N,N,-,-1,-1
MULIFE.txt,1004043,1004559,516,20,N,N,-,-1,-1
MULIFE.txt,1004105,1004659,554,20,N,N,-,-1,-1
MULIFE.txt,1004270,1004825,555,20,N,N,-,-1,-1
MULIFE.txt,1004437,1004959,522,20,N,N,-,-1,-1
MULIFE.txt,1004560,1005055,495,20,N,N,-,-1,-1
MULIFE.txt,1004660,1005217,557,20,N,N,-,-1,-1
MULIFE.txt,1004826,1005366,540,20,N,N,-,-1,-1
MULIFE.txt,1004962,1005531,569,20,N,N,-,-1,-1
MULIFE.txt,1005056,1005682,626,20,N,N,-,-1,-1
MULIFE.txt,1005218,1005766,548,20,N,N,-,-1,-1
MULIFE.txt,1005368,1005874,506,20,N,N,-,-1,-1
MULIFE.txt,1005532,1005982,450,20,N,N,-,-1,-1
MULIFE.txt,1005683,1006118,435,20,N,N,-,-1,-1
MULIFE.txt,1005767,1006220,453,20,N,N,-,-1,-1
MULIFE.txt,1005875,1006343,468,20,N,N,-,-1,-1
MULIFE.txt,1005983,1006472,489,20,N,N,-,-1,-1
MULIFE.txt,1006120,1006562,442,20,N,N,-,-1,-1
MULIFE.txt,1006225,1006641,416,20,N,N,-,-1,-1
MULIFE.txt,1006348,1006776,428,20,N,N,-,-1,-1
MULIFE.txt,1006473,1006942,469,20,N,N,-,-1,-1
MULIFE.txt,1006563,1007114,551,20,N,N,-,-1,-1
MULIFE.txt,1006642,1007245,603,20,N,N,-,-1,-1
MULIFE.txt,1006777,1007350,573,20,N,N,-,-1,-1
MULIFE.txt,1006943,1007566,623,20,N,N,-,-1,-1
MULIFE.txt,1007114,1007621,507,20,N,N,-,-1,-1
MULIFE.txt,1007246,1007766,520,20,N,N,-,-1,-1
MULIFE.txt,1007351,1007858,507,20,N,N,-,-1,-1
MULIFE.txt,1007567,1007930,363,20,N,N,-,-1,-1
MULIFE.txt,1007623,1008028,405,20,N,N,-,-1,-1
MULIFE.txt,1007769,1008099,330,20,N,N,-,-1,-1
MULIFE.txt,1007859,1008157,298,20,N,N,-,-1,-1
MULIFE.txt,1007931,1008259,328,20,N,N,-,-1,-1
MULIFE.txt,1008031,1008325,294,20,N,N,-,-1,-1
MULIFE.txt,1008099,1008431,332,20,N,N,-,-1,-1
MULIFE.txt,1008158,1008498,340,20,N,N,-,-1,-1
MULIFE.txt,1008260,1008631,371,20,N,N,-,-1,-1
MULIFE.txt,1008326,1008657,331,20,N,N,-,-1,-1
MULIFE.txt,1008431,1008847,416,20,N,N,-,-1,-1
MULIFE.txt,1008500,1008996,496,20,N,N,-,-1,-1
MULIFE.txt,1008632,1009306,674,20,N,N,-,-1,-1
MULIFE.txt,1008658,1009478,820,20,N,N,-,-1,-1
MULIFE.txt,1008848,1009546,698,20,N,N,-,-1,-1
MULIFE.txt,1008999,1009656,657,20,N,N,-,-1,-1
MULIFE.txt,1009308,1009719,411,20,N,N,-,-1,-1
MULIFE.txt,1009479,1009849,370,20,N,N,-,-1,-1
MULIFE.txt,1009547,1009900,353,20,N,N,-,-1,-1
MULIFE.txt,1009658,1010000,342,20,N,N,-,-1,-1
MULIFE.txt,1009720,1010093,373,20,N,N,-,-1,-1
MULIFE.txt,1009850,1010124,274,20,N,N,-,-1,-1
MULIFE.txt,1009901,1010222,321,20,N,N,-,-1,-1
MULIFE.txt,1010001,1010354,353,20,N,N,-,-1,-1
MULIFE.txt,1010094,1010555,461,20,N,N,-,-1,-1
MULIFE.txt,1010125,1010779,654,20,N,N,-,-1,-1
MULIFE.txt,1010223,1010831,608,20,N,N,-,-1,-1
MULIFE.txt,1010357,1010901,544,20,N,N,-,-1,-1
MULIFE.txt,1010556,1010921,365,20,N,N,-,-1,-1
MULIFE.txt,1010780,1011079,299,20,N,N,-,-1,-1
MULIFE.txt,1010833,1011347,514,20,N,N,-,-1,-1
MULIFE.txt,1010901,1011548,647,20,N,N,-,-1,-1
MULIFE.txt,1010922,1011771,849,20,N,N,-,-1,-1
MULIFE.txt,1011084,1011921,837,20,N,N,-,-1,-1
MULIFE.txt,1011348,1012137,789,20,N,N,-,-1,-1
MULIFE.txt,1011549,1012209,660,20,N,N,-,-1,-1
MULIFE.txt,1011772,1012282,510,20,N,N,-,-1,-1
MULIFE.txt,1011923,1012384,461,20,N,N,-,-1,-1
MULIFE.txt,1012138,1012502,364,20,N,N,-,-1,-1
MULIFE.txt,1012214,1012571,357,20,N,N,-,-1,-1
MULIFE.txt,1012283,1012675,392,20,N,N,-,-1,-1
MULIFE.txt,1012389,1012801,412,20,N,N,-,-1,-1
MULIFE.txt,1012503,1012988,485,20,N,N,-,-1,-1
MULIFE.txt,1012572,1013312,740,20,N,N,-,-1,-1
MULIFE.txt,1012678,1013467,789,20,N,N,-,-1,-1
MULIFE.txt,1012802,1013667,865,20,N,N,-,-1,-1
MULIFE.txt,1012989,1013728,739,20,N,N,-,-1,-1
MULIFE.txt,1013313,1013907,594,20,N,N,-,-1,-1
MULIFE.txt,1013468,1014123,655,20,N,N,-,-1,-1
MULIFE.txt,1013668,1014268,600,20,N,N,-,-1,-1
MULIFE.txt,1013729,1014399,670,20,N,N,-,-1,-1
MULIFE.txt,1013908,1014602,694,20,N,N,-,-1,-1
MULIFE.txt,1014124,1014796,672,20,N,N,-,-1,-1
MULIFE.txt,1014273,1014943,670,20,N,N,-,-1,-1
MULIFE.txt,1014399,1015027,628,20,N,N,-,-1,-1
MULIFE.txt,1014603,1015233,630,20,N,N,-,-1,-1
MULIFE.txt,1014797,1015370,573,20,N,N,-,-1,-1
MULIFE.txt,1014945,1015585,640,20,N,N,-,-1,-1
MULIFE.txt,1015028,1015648,620,20,N,N,-,-1,-1
MULIFE.txt,1015234,1015964,730,20,N,N,-,-1,-1
MULIFE.txt,1015371,1015994,623,20,N,N,-,-1,-1
MULIFE.txt,1015586,1016126,540,20,N,N,-,-1,-1
MULIFE.txt,1015649,1016374,725,20,N,N,-,-1,-1
MULIFE.txt,1015965,1016584,619,20,N,N,-,-1,-1
MULIFE.txt,1015995,1016657,662,20,N,N,-,-1,-1
MULIFE.txt,1016131,1016869,738,20,N,N,-,-1,-1
MULIFE.txt,1016375,1017084,709,20,N,N,-,-1,-1
MULIFE.txt,1016585,1017301,716,20,N,N,-,-1,-1
MULIFE.txt,1016658,1017503,845,20,N,N,-,-1,-1
MULIFE.txt,1016870,1017644,774,20,N,N,-,-1,-1
MULIFE.txt,1017085,1017747,662,20,N,N,-,-1,-1
MULIFE.txt,1017302,1017961,659,20,N,N,-,-1,-1
MULIFE.txt,1017504,1017993,489,20,N,N,-,-1,-1
MULIFE.txt,1017645,1018180,535,20,N,N,-,-1,-1
MULIFE.txt,1017750,1018396,646,20,N,N,-,-1,-1
MULIFE.txt,1017962,1018430,468,20,N,N,-,-1,-1
MULIFE.txt,1017993,1018580,587,20,N,N,-,-1,-1
MULIFE.txt,1018181,1018854,673,20,N,N,-,-1,-1
MULIFE.txt,1018397,1018991,594,20,N,N,-,-1,-1
MULIFE.txt,1018431,1019186,755,20,N,N,-,-1,-1
MULIFE.txt,1018581,1019444,863,20,N,N,-,-1,-1
MULIFE.txt,1018855,1019614,759,20,N,N,-,-1,-1
MULIFE.txt,1018991,1019796,805,20,N,N,-,-1,-1
MULIFE.txt,1019189,1020019,830,20,N,N,-,-1,-1
MULIFE.txt,1019449,1020232,783,20,N,N,-,-1,-1
MULIFE.txt,1019615,1020427,812,20,N,N,-,-1,-1
MULIFE.txt,1019797,1020675,878,20,N,N,-,-1,-1
MULIFE.txt,1020020,1020840,820,20,N,N,-,-1,-1
MULIFE.txt,1020233,1021042,809,20,N,N,-,-1,-1
MULIFE.txt,1020428,1021130,702,20,N,N,-,-1,-1
MULIFE.txt,1020676,1021250,574,20,N,N,-,-1,-1
MULIFE.txt,1020843,1021437,594,20,N,N,-,-1,-1
MULIFE.txt,1021043,1021572,529,20,N,N,-,-1,-1
MULIFE.txt,1021132,1021759,627,20,N,N,-,-1,-1
MULIFE.txt,1021250,1021878,628,20,N,N,-,-1,-1
MULIFE.txt,1021438,1022053,615,20,N,N,-,-1,-1
MULIFE.txt,1021573,1022134,561,20,N,N,-,-1,-1
MULIFE.txt,1021759,1022351,592,20,N,N,-,-1,-1
MULIFE.txt,1021879,1022489,610,20,N,N,-,-1,-1
MULIFE.txt,1022054,1022828,774,20,N,N,-,-1,-1
MULIFE.txt,1022135,1023008,873,20,N,N,-,-1,-1
MULIFE.txt,1022352,1023152,800,20,N,N,-,-1,-1
MULIFE.txt,1022492,1023196,704,20,N,N,-,-1,-1
MULIFE.txt,1022829,1023303,474,20,N,N,-,-1,-1
MULIFE.txt,1023009,1023543,534,20,N,N,-,-1,-1
MULIFE.txt,1023153,1023681,528,20,N,N,-,-1,-1
MULIFE.txt,1023196,1023817,621,20,N,N,-,-1,-1
MULIFE.txt,1023304,1024048,744,20,N,N,-,-1,-1
MULIFE.txt,1023544,1024104,560,20,N,N,-,-1,-1
MULIFE.txt,1023684,1024169,485,20,N,N,-,-1,-1
MULIFE.txt,1023820,1024330,510,20,N,N,-,-1,-1
MULIFE.txt,1024049,1024504,455,20,N,N,-,-1,-1
MULIFE.txt,1024105,1024579,474,20,N,N,-,-1,-1
MULIFE.txt,1024172,1024779,607,20,N,N,-,-1,-1
MULIFE.txt,1024333,1024943,610,20,N,N,-,-1,-1
MULIFE.txt,1024505,1025125,620,20,N,N,-,-1,-1
MULIFE.txt,1024580,1025196,616,20,N,N,-,-1,-1
MULIFE.txt,1024781,1025278,497,20,N,N,-,-1,-1
MULIFE.txt,1024943,1025290,347,20,N,N,-,-1,-1
MULIFE.txt,1025126,1025411,285,20,N,N,-,-1,-1
MULIFE.txt,1025196,1025455,259,20,N,N,-,-1,-1
MULIFE.txt,1025279,1025623,344,20,N,N,-,-1,-1
MULIFE.txt,1025291,1025909,618,20,N,N,-,-1,-1
MULIFE.txt,1025412,1025985,573,20,N,N,-,-1,-1
MULIFE.txt,1025458,1026044,586,20,N,N,-,-1,-1
MULIFE.txt,1025624,1026165,541,20,N,N,-,-1,-1
MULIFE.txt,1025910,1026384,474,20,N,N,-,-1,-1
MULIFE.txt,1025986,1026457,471,20,N,N,-,-1,-1
MULIFE.txt,1026045,1026658,613,20,N,N,-,-1,-1
MULIFE.txt,1026166,1026753,587,20,N,N,-,-1,-1
MULIFE.txt,1026385,1026878,493,20,N,N,-,-1,-1
MULIFE.txt,1026458,1027031,573,20,N,N,-,-1,-1
MULIFE.txt,1026659,1027156,497,20,N,N,-,-1,-1
MULIFE.txt,1026754,1027209,455,20,N,N,-,-1,-1
MULIFE.txt,1026881,1027297,416,20,N,N,-,-1,-1
MULIFE.txt,1027032,1027435,403,20,N,N,-,-1,-1
MULIFE.txt,1027157,1027540,383,20,N,N,-,-1,-1
MULIFE.txt,1027210,1027609,399,20,N,N,-,-1,-1
MULIFE.txt,1027299,1027733,434,20,N,N,-,-1,-1
MULIFE.txt,1027436,1027757,321,20,N,N,-,-1,-1
MULIFE.txt,1027543,1027868,325,20,N,N,-,-1,-1
MULIFE.txt,1027610,1027958,348,20,N,N,-,-1,-1
MULIFE.txt,1027734,1028059,325,20,N,N,-,-1,-1
MULIFE.txt,1027760,1028133,373,20,N,N,-,-1,-1
MULIFE.txt,1027871,1028193,322,20,N,N,-,-1,-1
MULIFE.txt,1027961,1028299,338,20,N,N,-,-1,-1
MULIFE.txt,1028060,1028523,463,20,N,N,-,-1,-1
MULIFE.txt,1028134,1028783,649,20,N,N,-,-1,-1
MULIFE.txt,1028195,1028917,722,20,N,N,-,-1,-1
MULIFE.txt,1028301,1029005,704,20,N,N,-,-1,-1
MULIFE.txt,1028524,1029043,519,20,N,N,-,-1,-1
MULIFE.txt,1028786,1029201,415,20,N,N,-,-1,-1
MULIFE.txt,1028918,1029317,399,20,N,N,-,-1,-1
MULIFE.txt,1029006,1029427,421,20,N,N,-,-1,-1
MULIFE.txt,1029044,1029480,436,20,N,N,-,-1,-1
MULIFE.txt,1029202,1029596,394,20,N,N,-,-1,-1
MULIFE.txt,1029319,1029676,357,20,N,N,-,-1,-1
MULIFE.txt,1029428,1029703,275,20,N,N,-,-1,-1
MULIFE.txt,1029481,1029826,345,20,N,N,-,-1,-1
MULIFE.txt,1029597,1029880,283,20,N,N,-,-1,-1
MULIFE.txt,1029679,1030009,330,20,N,N,-,-1,-1
MULIFE.txt,1029704,1030305,601,20,N,N,-,-1,-1
MULIFE.txt,1029827,1030463,636,20,N,N,-,-1,-1
MULIFE.txt,1029883,1030692,809,20,N,N,-,-1,-1
MULIFE.txt,1030014,1030799,785,20,N,N,-,-1,-1
MULIFE.txt,1030308,1030900,592,20,N,N,-,-1,-1
MULIFE.txt,1030466,1031052,586,20,N,N,-,-1,-1
MULIFE.txt,1030693,1031226,533,20,N,N,-,-1,-1
MULIFE.txt,1030800,1031316,516,20,N,N,-,-1,-1
MULIFE.txt,1030901,1031412,511,20,N,N,-,-1,-1
MULIFE.txt,1031055,1031484,429,20,N,N,-,-1,-1
MULIFE.txt,1031229,1031619,390,20,N,N,-,-1,-1
MULIFE.txt,1031317,1031722,405,20,N,N,-,-1,-1
MULIFE.txt,1031413,1031802,389,20,N,N,-,-1,-1
MULIFE.txt,1031485,1031855,370,20,N,N,-,-1,-1
MULIFE.txt,1031621,1031949,328,20,N,N,-,-1,-1
MULIFE.txt,1031723,1031998,275,20,N,N,-,-1,-1
MULIFE.txt,1031805,1032126,321,20,N,N,-,-1,-1
MULIFE.txt,1031856,1032232,376,20,N,N,-,-1,-1
MULIFE.txt,1031950,1032399,449,20,N,N,-,-1,-1
MULIFE.txt,1032001,1032468,467,20,N,N,-,-1,-1
MULIFE.txt,1032127,1032561,434,20,N,N,-,-1,-1
MULIFE.txt,1032233,1032639,406,20,N,N,-,-1,-1
MULIFE.txt,1032401,1032767,366,20,N,N,-,-1,-1
MULIFE.txt,1032471,1032826,355,20,N,N,-,-1,-1
MULIFE.txt,1032562,1032937,375,20,N,N,-,-1,-1
MULIFE.txt,1032640,1033081,441,20,N,N,-,-1,-1
MULIFE.txt,1032768,1033198,430,20,N,N,-,-1,-1
MULIFE.txt,1032827,1033464,637,20,N,N,-,-1,-1
MULIFE.txt,1032938,1033517,579,20,N,N,-,-1,-1
MULIFE.txt,1033084,1033557,473,20,N,N,-,-1,-1
MULIFE.txt,1033199,1033624,425,20,N,N,-,-1,-1
MULIFE.txt,1033466,1033841,375,20,N,N,-,-1,-1
MULIFE.txt,1033520,1033929,409,20,N,N,-,-1,-1
MULIFE.txt,1033559,1034109,550,20,N,N,-,-1,-1
MULIFE.txt,1033627,1034244,617,20,N,N,-,-1,-1
MULIFE.txt,1033842,1034368,526,20,N,N,-,-1,-1
MULIFE.txt,1033931,1034416,485,20,N,N,-,-1,-1
MULIFE.txt,1034112,1034520,408,20,N,N,-,-1,-1
MULIFE.txt,1034244,1034625,381,20,N,N,-,-1,-1
MULIFE.txt,1034369,1034735,366,20,N,N,-,-1,-1
MULIFE.txt,1034417,1034849,432,20,N,N,-,-1,-1
MULIFE.txt,1034520,1034966,446,20,N,N,-,-1,-1
MULIFE.txt,1034626,1035067,441,20,N,N,-,-1,-1
MULIFE.txt,1034738,1035188,450,20,N,N,-,-1,-1
MULIFE.txt,1034850,1035338,488,20,N,N,-,-1,-1
MULIFE.txt,1034967,1035618,651,20,N,N,-,-1,-1
MULIFE.txt,1035072,1035672,600,20,N,N,-,-1,-1
MULIFE.txt,1035193,1035801,608,20,N,N,-,-1,-1
MULIFE.txt,1035341,1035912,571,20,N,N,-,-1,-1
MULIFE.txt,1035619,1035969,350,20,N,N,-,-1,-1
MULIFE.txt,1035673,1036052,379,20,N,N,-,-1,-1
MULIFE.txt,1035806,1036252,446,20,N,N,-,-1,-1
MULIFE.txt,1035913,1036407,494,20,N,N,-,-1,-1
MULIFE.txt,1035970,1036487,517,20,N,N,-,-1,-1
MULIFE.txt,1036054,1036576,522,20,N,N,-,-1,-1
MULIFE.txt,1036253,1036660,407,20,N,N,-,-1,-1
MULIFE.txt,1036408,1036754,346,20,N,N,-,-1,-1
MULIFE.txt,1036489,1036825,336,20,N,N,-,-1,-1
MULIFE.txt,1036577,1036894,317,20,N,N,-,-1,-1
MULIFE.txt,1036662,1036956,294,20,N,N,-,-1,-1
MULIFE.txt,1036755,1037035,280,20,N,N,-,-1,-1
MULIFE.txt,1036826,1037075,249,20,N,N,-,-1,-1
MULIFE.txt,1036895,1037125,230,20,N,N,-,-1,-1
MULIFE.txt,1036958,1037202,244,20,N,N,-,-1,-1
MULIFE.txt,1037036,1037267,231,20,N,N,-,-1,-1
MULIFE.txt,1037076,1037349,273,20,N,N,-,-1,-1
MULIFE.txt,1037126,1037541,415,20,N,N,-,-1,-1
MULIFE.txt,1037203,1037623,420,20,N,N,-,-1,-1
MULIFE.txt,1037268,1037676,408,20,N,N,-,-1,-1
MULIFE.txt,1037350,1037841,491,20,N,N,-,-1,-1
MULIFE.txt,1037542,1037965,423,20,N,N,-,-1,-1
MULIFE.txt,1037625,1038037,412,20,N,N,-,-1,-1
MULIFE.txt,1037677,1038095,418,20,N,N,-,-1,-1
MULIFE.txt,1037844,1038204,360,20,N,N,-,-1,-1
MULIFE.txt,1037967,1038315,348,20,N,N,-,-1,-1
MULIFE.txt,1038037,1038434,397,20,N,N,-,-1,-1
MULIFE.txt,1038096,1038568,472,20,N,N,-,-1,-1
MULIFE.txt,1038206,1038676,470,20,N,N,-,-1,-1
MULIFE.txt,1038316,1038799,483,20,N,N,-,-1,-1
MULIFE.txt,1038435,1039062,627,20,N,N,-,-1,-1
MULIFE.txt,1038569,1039255,686,20,N,N,-,-1,-1
MULIFE.txt,1038679,1039354,675,20,N,N,-,-1,-1
MULIFE.txt,1038804,1039481,677,20,N,N,-,-1,-1
MULIFE.txt,1039063,1039579,516,20,N,N,-,-1,-1
MULIFE.txt,1039258,1039647,389,20,N,N,-,-1,-1
MULIFE.txt,1039355,1039745,390,20,N,N,-,-1,-1
MULIFE.txt,1039482,1039959,477,20,N,N,-,-1,-1
MULIFE.txt,1039580,1040094,514,20,N,N,-,-1,-1
MULIFE.txt,1039650,1040122,472,20,N,N,-,-1,-1
MULIFE.txt,1039750,1040192,442,20,N,N,-,-1,-1
MULIFE.txt,1039960,1040234,274,20,N,N,-,-1,-1
MULIFE.txt,1040095,1040258,163,20,N,N,-,-1,-1
MULIFE.txt,1040123,1040366,243,20,N,N,-,-1,-1
MULIFE.txt,1040193,1040500,307,20,N,N,-,-1,-1
MULIFE.txt,1040235,1040671,436,20,N,N,-,-1,-1
MULIFE.txt,1040259,1040788,529,20,N,N,-,-1,-1
MULIFE.txt,1040369,1040837,468,20,N,N,-,-1,-1
MULIFE.txt,1040501,1040988,487,20,N,N,-,-1,-1
MULIFE.txt,1040673,1041086,413,20,N,N,-,-1,-1
MULIFE.txt,1040789,1041248,459,20,N,N,-,-1,-1
MULIFE.txt,1040838,1041445,607,20,N,N,-,-1,-1
MULIFE.txt,1040989,1041517,528,20,N,N,-,-1,-1
MULIFE.txt,1041087,1041664,577,20,N,N,-,-1,-1
MULIFE.txt,1041250,1041903,653,20,N,N,-,-1,-1
MULIFE.txt,1041446,1042028,582,20,N,N,-,-1,-1
MULIFE.txt,1041520,1042092,572,20,N,N,-,-1,-1
MULIFE.txt,1041665,1042174,509,20,N,N,-,-1,-1
MULIFE.txt,1041905,1042263,358,20,N,N,-,-1,-1
MULIFE.txt,1042031,1042372,341,20,N,N,-,-1,-1
MULIFE.txt,1042093,1042523,430,20,N,N,-,-1,-1
MULIFE.txt,1042175,1042674,499,20,N,N,-,-1,-1
MULIFE.txt,1042264,1042715,451,20,N,N,-,-1,-1
MULIFE.txt,1042373,1042836,463,20,N,N,-,-1,-1
MULIFE.txt,1042524,1042963,439,20,N,N,-,-1,-1
MULIFE.txt,1042675,1043061,386,20,N,N,-,-1,-1
MULIFE.txt,1042716,1043166,450,20,N,N,-,-1,-1
MULIFE.txt,1042837,1043351,514,20,N,N,-,-1,-1
MULIFE.txt,1042964,1043427,463,20,N,N,-,-1,-1
MULIFE.txt,1043064,1043532,468,20,N,N,-,-1,-1
MULIFE.txt,1043167,1043647,480,20,N,N,-,-1,-1
MULIFE.txt,1043352,1043724,372,20,N,N,-,-1,-1
MULIFE.txt,1043432,1043790,358,20,N,N,-,-1,-1
MULIFE.txt,1043534,1043846,312,20,N,N,-,-1,-1
MULIFE.txt,1043648,1043920,272,20,N,N,-,-1,-1
MULIFE.txt,1043726,1043984,258,20,N,N,-,-1,-1
MULIFE.txt,1043793,1044110,317,20,N,N,-,-1,-1
MULIFE.txt,1043849,1044230,381,20,N,N,-,-1,-1
MULIFE.txt,1043922,1044443,521,20,N,N,-,-1,-1
MULIFE.txt,1043985,1044557,572,20,N,N,-,-1,-1
MULIFE.txt,1044111,1044630,519,20,N,N,-,-1,-1
MULIFE.txt,1044232,1044782,550,20,N,N,-,-1,-1
MULIFE.txt,1044444,1045049,605,20,N,N,-,-1,-1
MULIFE.txt,1044557,1045108,551,20,N,N,-,-1,-1
MULIFE.txt,1044631,1045184,553,20,N,N,-,-1,-1
MULIFE.txt,1044787,1045283,496,20,N,N,-,-1,-1
MULIFE.txt,1045050,1045345,295,20,N,N,-,-1,-1
MULIFE.txt,1045109,1045392,283,20,N,N,-,-1,-1
MULIFE.txt,1045185,1045483,298,20,N,N,-,-1,-1
MULIFE.txt,1045284,1045623,339,20,N,N,-,-1,-1
MULIFE.txt,1045348,1045683,335,20,N,N,-,-1,-1
MULIFE.txt,1045395,1045759,364,20,N,N,-,-1,-1
MULIFE.txt,1045483,1045800,317,20,N,N,-,-1,-1
MULIFE.txt,1045624,1045848,224,20,N,N,-,-1,-1
MULIFE.txt,1045684,1045971,287,20,N,N,-,-1,-1
MULIFE.txt,1045760,1046020,260,20,N,N,-,-1,-1
MULIFE.txt,1045802,1046068,266,20,N,N,-,-1,-1
MULIFE.txt,1045849,1046132,283,20,N,N,-,-1,-1
MULIFE.txt,1045972,1046184,212,20,N,N,-,-1,-1
MULIFE.txt,1046023,1046298,275,20,N,N,-,-1,-1
MULIFE.txt,1046069,1046507,438,20,N,N,-,-1,-1
MULIFE.txt,1046134,1046673,539,20,N,N,-,-1,-1
MULIFE.txt,1046185,1046791,606,20,N,N,-,-1,-1
MULIFE.txt,1046299,1046877,578,20,N,N,-,-1,-1
MULIFE.txt,1046508,1046957,449,20,N,N,-,-1,-1
MULIFE.txt,1046674,1047030,356,20,N,N,-,-1,-1
MULIFE.txt,1046792,1047116,324,20,N,N,-,-1,-1
MULIFE.txt,1046878,1047190,312,20,N,N,-,-1,-1
MULIFE.txt,1046958,1047257,299,20,N,N,-,-1,-1
MULIFE.txt,1047030,1047410,380,20,N,N,-,-1,-1
MULIFE.txt,1047117,1047482,365,20,N,N,-,-1,-1
MULIFE.txt,1047192,1047625,433,20,N,N,-,-1,-1
MULIFE.txt,1047258,1047696,438,20,N,N,-,-1,-1
MULIFE.txt,1047411,1047760,349,20,N,N,-,-1,-1
MULIFE.txt,1047485,1047817,332,20,N,N,-,-1,-1
MULIFE.txt,1047626,1047998,372,20,N,N,-,-1,-1
MULIFE.txt,1047697,1048093,396,20,N,N,-,-1,-1
MULIFE.txt,1047761,1048218,457,20,N,N,-,-1,-1
MULIFE.txt,1047820,1048333,513,20,N,N,-,-1,-1
MULIFE.txt,1047999,1048564,565,20,N,N,-,-1,-1
MULIFE.txt,1048094,1048692,598,20,N,N,-,-1,-1
MULIFE.txt,1048221,1048801,580,20,N,N,-,-1,-1
MULIFE.txt,1048334,1048849,515,20,N,N,-,-1,-1
MULIFE.txt,1048565,1049045,480,20,N,N,-,-1,-1
MULIFE.txt,1048693,1049122,429,20,N,N,-,-1,-1
MULIFE.txt,1048802,1049255,453,20,Y,N,-,-1,-1
MULIFE.txt,1048850,1049303,453,20,Y,N,-,-1,-1
MULIFE.txt,1049046,1049456,410,20,Y,N,-,-1,-1
MULIFE.txt,1049123,1049647,524,20,Y,N,-,-1,-1
MULIFE.txt,1049256,1049738,482,20,N,N,-,-1,-1
MULIFE.txt,1049306,1049921,615,20,N,N,-,-1,-1
MULIFE.txt,1049457,1050043,586,20,N,N,-,-1,-1
MULIFE.txt,1049648,1050112,464,20,N,N,-,-1,-1
MULIFE.txt,1049743,1050236,493,20,N,N,-,-1,-1
MULIFE.txt,1049922,1050406,484,20,N,N,-,-1,-1
MULIFE.txt,1050044,1050516,472,20,N,N,-,-1,-1
MULIFE.txt,1050115,1050609,494,20,N,N,-,-1,-1
MULIFE.txt,1050237,1050717,480,20,N,N,-,-1,-1
MULIFE.txt,1050407,1050797,390,20,N,N,-,-1,-1
MULIFE.txt,1050517,1050938,421,20,N,N,-,-1,-1
MULIFE.txt,1050612,1051002,390,20,N,N,-,-1,-1
MULIFE.txt,1050720,1051078,358,20,N,N,-,-1,-1
MULIFE.txt,1050800,1051108,308,20,N,N,-,-1,-1
MULIFE.txt,1050939,1051288,349,20,N,N,-,-1,-1
MULIFE.txt,1051003,1051389,386,20,N,N,-,-1,-1
MULIFE.txt,1051080,1051459,379,20,N,N,-,-1,-1
MULIFE.txt,1051108,1051583,475,20,N,N,-,-1,-1
MULIFE.txt,1051289,1051677,388,20,N,N,-,-1,-1
MULIFE.txt,1051390,1051769,379,20,N,N,-,-1,-1
MULIFE.txt,1051460,1051873,413,20,N,N,-,-1,-1
MULIFE.txt,1051584,1052075,491,20,N,N,-,-1,-1
MULIFE.txt,1051678,1052182,504,20,N,N,-,-1,-1
MULIFE.txt,1051770,1052264,494,20,N,N,-,-1,-1
MULIFE.txt,1051874,1052304,430,20,N,N,-,-1,-1
MULIFE.txt,1052076,1052371,295,20,N,N,-,-1,-1
MULIFE.txt,1052183,1052423,240,20,N,N,-,-1,-1
MULIFE.txt,1052265,1052502,237,20,N,N,-,-1,-1
MULIFE.txt,1052304,1052600,296,20,N,N,-,-1,-1
MULIFE.txt,1052372,1052680,308,20,N,N,-,-1,-1
MULIFE.txt,1052424,1052724,300,20,N,N,-,-1,-1
MULIFE.txt,1052505,1052840,335,20,N,N,-,-1,-1
MULIFE.txt,1052601,1052910,309,20,N,N,-,-1,-1
MULIFE.txt,1052680,1052983,303,20,N,N,-,-1,-1
MULIFE.txt,1052729,1053069,340,20,N,N,-,-1,-1
MULIFE.txt,1052843,1053126,283,20,N,N,-,-1,-1
MULIFE.txt,1052911,1053210,299,20,N,N,-,-1,-1
MULIFE.txt,1052984,1053282,298,20,N,N,-,-1,-1
MULIFE.txt,1053070,1053352,282,20,N,N,-,-1,-1
MULIFE.txt,1053128,1053457,329,20,N,N,-,-1,-1
MULIFE.txt,1053211,1053530,319,20,N,N,-,-1,-1
MULIFE.txt,1053285,1053628,343,20,N,N,-,-1,-1
MULIFE.txt,1053353,1053719,366,20,N,N,-,-1,-1
MULIFE.txt,1053460,1053874,414,20,N,N,-,-1,-1
MULIFE.txt,1053531,1054002,471,20,N,N,-,-1,-1
MULIFE.txt,1053629,1054090,461,20,N,N,-,-1,-1
MULIFE.txt,1053720,1054238,518,20,N,N,-,-1,-1
MULIFE.txt,1053875,1054423,548,20,N,N,-,-1,-1
MULIFE.txt,1054003,1054496,493,20,N,N,-,-1,-1
MULIFE.txt,1054092,1054587,495,20,N,N,-,-1,-1
MULIFE.txt,1054241,1054612,371,20,N,N,-,-1,-1
MULIFE.txt,1054424,1054676,252,20,N,N,-,-1,-1
MULIFE.txt,1054498,1054726,228,20,N,N,-,-1,-1
MULIFE.txt,1054588,1054811,223,20,N,N,-,-1,-1
MULIFE.txt,1054615,1054897,282,20,N,N,-,-1,-1
MULIFE.txt,1054677,1055036,359,20,N,N,-,-1,-1
MULIFE.txt,1054726,1055181,455,20,N,N,-,-1,-1
MULIFE.txt,1054812,1055328,516,20,N,N,-,-1,-1
MULIFE.txt,1054898,1055425,527,20,N,N,-,-1,-1
MULIFE.txt,1055037,1055571,534,20,N,N,-,-1,-1
MULIFE.txt,1055182,1055661,479,20,N,N,-,-1,-1
MULIFE.txt,1055328,1055695,367,20,N,N,-,-1,-1
MULIFE.txt,1055426,1055786,360,20,N,N,-,-1,-1
MULIFE.txt,1055574,1055871,297,20,N,N,-,-1,-1
MULIFE.txt,1055662,1055968,306,20,N,N,-,-1,-1
MULIFE.txt,1055696,1056123,427,20,N,N,-,-1,-1
MULIFE.txt,1055787,1056365,578,20,N,N,-,-1,-1
MULIFE.txt,1055873,1056525,652,20,N,N,-,-1,-1
MULIFE.txt,1055969,1056664,695,20,N,N,-,-1,-1
MULIFE.txt,1056124,1056722,598,20,N,N,-,-1,-1
MULIFE.txt,1056368,1056896,528,20,N,N,-,-1,-1
MULIFE.txt,1056526,1056992,466,20,N,N,-,-1,-1
MULIFE.txt,1056665,1057090,425,20,N,N,-,-1,-1
MULIFE.txt,1056724,1057156,432,20,N,N,-,-1,-1
MULIFE.txt,1056897,1057286,389,20,N,N,-,-1,-1
MULIFE.txt,1056994,1057394,400,20,N,N,-,-1,-1
MULIFE.txt,1057092,1057446,354,20,N,N,-,-1,-1
MULIFE.txt,1057157,1057538,381,20,N,N,-,-1,-1
MULIFE.txt,1057287,1057670,383,20,N,N,-,-1,-1
MULIFE.txt,1057396,1057774,378,20,N,N,-,-1,-1
MULIFE.txt,1057451,1057909,458,20,N,N,-,-1,-1
MULIFE.txt,1057539,1057999,460,20,N,N,-,-1,-1
MULIFE.txt,1057673,1058168,495,20,N,N,-,-1,-1
MULIFE.txt,1057775,1058296,521,20,N,N,-,-1,-1
MULIFE.txt,1057910,1058357,447,20,N,N,-,-1,-1
MULIFE.txt,1058002,1058402,400,20,N,N,-,-1,-1
MULIFE.txt,1058169,1058463,294,20,N,N,-,-1,-1
MULIFE.txt,1058297,1058539,242,20,N,N,-,-1,-1
MULIFE.txt,1058358,1058610,252,20,N,N,-,-1,-1
MULIFE.txt,1058403,1058679,276,20,N,N,-,-1,-1
MULIFE.txt,1058464,1058743,279,20,N,N,-,-1,-1
MULIFE.txt,1058542,1058793,251,20,N,N,-,-1,-1
MULIFE.txt,1058611,1058852,241,20,N,N,-,-1,-1
MULIFE.txt,1058680,1058921,241,20,N,N,-,-1,-1
MULIFE.txt,1058744,1058983,239,20,N,N,-,-1,-1
MULIFE.txt,1058796,1059035,239,20,N,N,-,-1,-1
MULIFE.txt,1058854,1059080,226,20,N,N,-,-1,-1
MULIFE.txt,1058922,1059153,231,20,N,N,-,-1,-1
MULIFE.txt,1058984,1059216,232,20,N,N,-,-1,-1
MULIFE.txt,1059038,1059293,255,20,N,N,-,-1,-1
MULIFE.txt,1059081,1059366,285,20,N,N,-,-1,-1
MULIFE.txt,1059154,1059439,285,20,N,N,-,-1,-1
MULIFE.txt,1059217,1059511,294,20,N,N,-,-1,-1
MULIFE.txt,1059294,1059640,346,20,N,N,-,-1,-1
MULIFE.txt,1059367,1059845,478,20,N,N,-,-1,-1
MULIFE.txt,1059440,1059956,516,20,N,N,-,-1,-1
MULIFE.txt,1059512,1060035,523,20,N,N,-,-1,-1
MULIFE.txt,1059643,1060197,554,20,N,N,-,-1,-1
MULIFE.txt,1059846,1060321,475,20,N,N,-,-1,-1
MULIFE.txt,1059957,1060431,474,20,N,N,-,-1,-1
MULIFE.txt,1060036,1060606,570,20,N,N,-,-1,-1
MULIFE.txt,1060198,1060715,517,20,N,N,-,-1,-1
MULIFE.txt,1060322,1060824,502,20,N,N,-,-1,-1
MULIFE.txt,1060432,1060896,464,20,N,N,-,-1,-1
MULIFE.txt,1060611,1060965,354,20,N,N,-,-1,-1
MULIFE.txt,1060716,1061057,341,20,N,N,-,-1,-1
MULIFE.txt,1060825,1061175,350,20,N,N,-,-1,-1
MULIFE.txt,1060897,1061257,360,20,N,N,-,-1,-1
MULIFE.txt,1060966,1061327,361,20,N,N,-,-1,-1
MULIFE.txt,1061059,1061406,347,20,N,N,-,-1,-1
MULIFE.txt,1061176,1061486,310,20,N,N,-,-1,-1
MULIFE.txt,1061258,1061595,337,20,N,N,-,-1,-1
MULIFE.txt,1061328,1061661,333,20,N,N,-,-1,-1
MULIFE.txt,1061407,1061753,346,20,N,N,-,-1,-1
MULIFE.txt,1061489,1061972,483,20,N,N,-,-1,-1
MULIFE.txt,1061596,1062217,621,20,N,N,-,-1,-1
MULIFE.txt,1061662,1062317,655,20,N,N,-,-1,-1
MULIFE.txt,1061756,1062384,628,20,N,N,-,-1,-1
MULIFE.txt,1061973,1062485,512,20,N,N,-,-1,-1
MULIFE.txt,1062219,1062517,298,20,N,N,-,-1,-1
MULIFE.txt,1062319,1062735,416,20,N,N,-,-1,-1
MULIFE.txt,1062385,1062864,479,20,N,N,-,-1,-1
MULIFE.txt,1062486,1063049,563,20,N,N,-,-1,-1
MULIFE.txt,1062518,1063199,681,20,N,N,-,-1,-1
MULIFE.txt,1062736,1063324,588,20,N,N,-,-1,-1
MULIFE.txt,1062867,1063474,607,20,N,N,-,-1,-1
MULIFE.txt,1063050,1063564,514,20,N,N,-,-1,-1
MULIFE.txt,1063202,1063628,426,20,N,N,-,-1,-1
MULIFE.txt,1063327,1063725,398,20,N,N,-,-1,-1
MULIFE.txt,1063477,1063810,333,20,N,N,-,-1,-1
MULIFE.txt,1063565,1063882,317,20,N,N,-,-1,-1
MULIFE.txt,1063629,1063961,332,20,N,N,-,-1,-1
MULIFE.txt,1063726,1064038,312,20,N,N,-,-1,-1
MULIFE.txt,1063811,1064167,356,20,N,N,-,-1,-1
MULIFE.txt,1063883,1064314,431,20,N,N,-,-1,-1
MULIFE.txt,1063962,1064426,464,20,N,N,-,-1,-1
MULIFE.txt,1064043,1064541,498,20,N,N,-,-1,-1
MULIFE.txt,1064168,1064679,511,20,N,N,-,-1,-1
MULIFE.txt,1064317,1064750,433,20,N,N,-,-1,-1
MULIFE.txt,1064427,1064857,430,20,N,N,-,-1,-1
MULIFE.txt,1064542,1065003,461,20,N,N,-,-1,-1
MULIFE.txt,1064679,1065074,395,20,N,N,-,-1,-1
MULIFE.txt,1064752,1065391,639,20,N,N,-,-1,-1
MULIFE.txt,1064859,1065611,752,20,N,N,-,-1,-1
MULIFE.txt,1065006,1065742,736,20,N,N,-,-1,-1
MULIFE.txt,1065075,1065840,765,20,N,N,-,-1,-1
MULIFE.txt,1065394,1065981,587,20,N,N,-,-1,-1
MULIFE.txt,1065616,1066087,471,20,N,N,-,-1,-1
MULIFE.txt,1065743,1066207,464,20,N,N,-,-1,-1
MULIFE.txt,1065843,1066321,478,20,N,N,-,-1,-1
MULIFE.txt,1065982,1066432,450,20,N,N,-,-1,-1
MULIFE.txt,1066090,1066539,449,20,N,N,-,-1,-1
MULIFE.txt,1066210,1066628,418,20,N,N,-,-1,-1
MULIFE.txt,1066322,1066719,397,20,N,N,-,-1,-1
MULIFE.txt,1066435,1066849,414,20,N,N,-,-1,-1
MULIFE.txt,1066544,1066931,387,20,N,N,-,-1,-1
MULIFE.txt,1066629,1067013,384,20,N,N,-,-1,-1
MULIFE.txt,1066720,1067107,387,20,N,N,-,-1,-1
MULIFE.txt,1066850,1067215,365,20,N,N,-,-1,-1
MULIFE.txt,1066933,1067326,393,20,N,N,-,-1,-1
MULIFE.txt,1067014,1067424,410,20,N,N,-,-1,-1
MULIFE.txt,1067108,1067524,416,20,N,N,-,-1,-1
MULIFE.txt,1067217,1067623,406,20,N,N,-,-1,-1
MULIFE.txt,1067327,1067695,368,20,N,N,-,-1,-1
MULIFE.txt,1067429,1067856,427,20,N,N,-,-1,-1
MULIFE.txt,1067525,1068042,517,20,N,N,-,-1,-1
MULIFE.txt,1067624,1068128,504,20,N,N,-,-1,-1
MULIFE.txt,1067696,1068298,602,20,N,N,-,-1,-1
MULIFE.txt,1067857,1068433,576,20,N,N,-,-1,-1
MULIFE.txt,1068043,1068551,508,20,N,N,-,-1,-1
MULIFE.txt,1068129,1068645,516,20,N,N,-,-1,-1
MULIFE.txt,1068299,1068766,467,20,N,N,-,-1,-1
MULIFE.txt,1068436,1068884,448,20,N,N,-,-1,-1
MULIFE.txt,1068554,1068991,437,20,N,N,-,-1,-1
MULIFE.txt,1068646,1069073,427,20,N,N,-,-1,-1
MULIFE.txt,1068769,1069222,453,20,N,N,-,-1,-1
MULIFE.txt,1068887,1069387,500,20,N,N,-,-1,-1
MULIFE.txt,1068992,1069546,554,20,N,N,-,-1,-1
MULIFE.txt,1069076,1069703,627,20,N,N,-,-1,-1
MULIFE.txt,1069225,1069833,608,20,N,N,-,-1,-1
MULIFE.txt,1069388,1070048,660,20,N,N,-,-1,-1
MULIFE.txt,1069549,1070166,617,20,N,N,-,-1,-1
MULIFE.txt,1069704,1070335,631,20,N,N,-,-1,-1
MULIFE.txt,1069836,1070535,699,20,N,N,-,-1,-1
MULIFE.txt,1070049,1070670,621,20,N,N,-,-1,-1
MULIFE.txt,1070167,1070748,581,20,N,N,-,-1,-1
MULIFE.txt,1070336,1070834,498,20,N,N,-,-1,-1
MULIFE.txt,1070537,1070965,428,20,N,N,-,-1,-1
MULIFE.txt,1070673,1071000,327,20,N,N,-,-1,-1
MULIFE.txt,1070748,1071183,435,20,N,N,-,-1,-1
MULIFE.txt,1070836,1071220,384,20,N,N,-,-1,-1
MULIFE.txt,1070966,1071363,397,20,N,N,-,-1,-1
MULIFE.txt,1071002,1071567,565,20,N,N,-,-1,-1
MULIFE.txt,1071184,1071658,474,20,N,N,-,-1,-1
MULIFE.txt,1071222,1071838,616,20,N,N,-,-1,-1
MULIFE.txt,1071365,1071969,604,20,N,N,-,-1,-1
MULIFE.txt,1071568,1072074,506,20,N,N,-,-1,-1
MULIFE.txt,1071660,1072245,585,20,N,N,-,-1,-1
MULIFE.txt,1071840,1072323,483,20,N,N,-,-1,-1
MULIFE.txt,1071971,1072484,513,20,N,N,-,-1,-1
MULIFE.txt,1072075,1072577,502,20,N,N,-,-1,-1
MULIFE.txt,1072246,1072674,428,20,N,N,-,-1,-1
MULIFE.txt,1072325,1072892,567,20,N,N,-,-1,-1
MULIFE.txt,1072485,1072940,455,20,N,N,-,-1,-1
MULIFE.txt,1072579,1073065,486,20,N,N,-,-1,-1
MULIFE.txt,1072677,1073220,543,20,N,N,-,-1,-1
MULIFE.txt,1072893,1073382,489,20,N,N,-,-1,-1
MULIFE.txt,1072943,1073542,599,20,N,N,-,-1,-1
MULIFE.txt,1073068,1073769,701,20,N,N,-,-1,-1
MULIFE.txt,1073223,1074101,878,20,N,N,-,-1,-1
MULIFE.txt,1073384,1074285,901,20,N,N,-,-1,-1
MULIFE.txt,1073545,1074471,926,20,N,N,-,-1,-1
MULIFE.txt,1073771,1074714,943,20,N,N,-,-1,-1
MULIFE.txt,1074102,1074891,789,20,N,N,-,-1,-1
MULIFE.txt,1074286,1074985,699,20,N,N,-,-1,-1
MULIFE.txt,1074476,1075156,680,20,N,N,-,-1,-1
MULIFE.txt,1074715,1075218,503,20,N,N,-,-1,-1
MULIFE.txt,1074894,1075344,450,20,N,N,-,-1,-1
MULIFE.txt,1074986,1075472,486,20,N,N,-,-1,-1
MULIFE.txt,1075157,1075692,535,20,N,N,-,-1,-1
MULIFE.txt,1075221,1075766,545,20,N,N,-,-1,-1
MULIFE.txt,1075345,1075971,626,20,N,N,-,-1,-1
MULIFE.txt,1075474,1076009,535,20,N,N,-,-1,-1
MULIFE.txt,1075693,1076222,529,20,N,N,-,-1,-1
MULIFE.txt,1075767,1076379,612,20,N,N,-,-1,-1
MULIFE.txt,1075973,1076523,550,20,N,N,-,-1,-1
MULIFE.txt,1076011,1076746,735,20,N,N,-,-1,-1
MULIFE.txt,1076225,1076910,685,20,N,N,-,-1,-1
MULIFE.txt,1076382,1077101,719,20,N,N,-,-1,-1
MULIFE.txt,1076524,1077282,758,20,N,N,-,-1,-1
MULIFE.txt,1076747,1077427,680,20,N,N,-,-1,-1
MULIFE.txt,1076911,1077615,704,20,N,N,-,-1,-1
MULIFE.txt,1077104,1077678,574,20,N,N,-,-1,-1
MULIFE.txt,1077283,1077722,439,20,N,N,-,-1,-1
MULIFE.txt,1077430,1077845,415,20,N,N,-,-1,-1
MULIFE.txt,1077616,1077982,366,20,N,N,-,-1,-1
MULIFE.txt,1077679,1078128,449,20,N,N,-,-1,-1
MULIFE.txt,1077724,1078300,576,20,N,N,-,-1,-1
MULIFE.txt,1077846,1078443,597,20,N,N,-,-1,-1
MULIFE.txt,1077984,1078513,529,20,N,N,-,-1,-1
MULIFE.txt,1078129,1078575,446,20,N,N,-,-1,-1
MULIFE.txt,1078303,1078649,346,20,N,N,-,-1,-1
MULIFE.txt,1078446,1078689,243,20,N,N,-,-1,-1
MULIFE.txt,1078514,1078730,216,20,N,N,-,-1,-1
MULIFE.txt,1078577,1078772,195,20,N,N,-,-1,-1
MULIFE.txt,1078650,1078823,173,20,N,N,-,-1,-1
MULIFE.txt,1078690,1078879,189,20,N,N,-,-1,-1
MULIFE.txt,1078731,1078929,198,20,N,N,-,-1,-1
MULIFE.txt,1078773,1078964,191,20,N,N,-,-1,-1
MULIFE.txt,1078824,1079022,198,20,N,N,-,-1,-1
MULIFE.txt,1078880,1079109,229,20,N,N,-,-1,-1
MULIFE.txt,1078931,1079172,241,20,N,N,-,-1,-1
MULIFE.txt,1078965,1079236,271,20,N,N,-,-1,-1
MULIFE.txt,1079023,1079311,288,20,N,N,-,-1,-1
MULIFE.txt,1079110,1079417,307,20,N,N,-,-1,-1
MULIFE.txt,1079173,1079484,311,20,N,N,-,-1,-1
MULIFE.txt,1079237,1079553,316,20,N,N,-,-1,-1
MULIFE.txt,1079312,1079620,308,20,N,N,-,-1,-1
MULIFE.txt,1079418,1079697,279,20,N,N,-,-1,-1
MULIFE.txt,1079486,1079801,315,20,N,N,-,-1,-1
MULIFE.txt,1079554,1079898,344,20,N,N,-,-1,-1
MULIFE.txt,1079621,1079972,351,20,N,N,-,-1,-1
MULIFE.txt,1079700,1080064,364,20,N,N,-,-1,-1
MULIFE.txt,1079804,1080098,294,20,N,N,-,-1,-1
MULIFE.txt,1079899,1080256,357,20,N,N,-,-1,-1
MULIFE.txt,1079973,1080394,421,20,N,N,-,-1,-1
MULIFE.txt,1080065,1080465,400,20,N,N,-,-1,-1
MULIFE.txt,1080099,1080528,429,20,N,N,-,-1,-1
MULIFE.txt,1080257,1080624,367,20,N,N,-,-1,-1
MULIFE.txt,1080395,1080646,251,20,N,N,-,-1,-1
MULIFE.txt,1080468,1080725,257,20,N,N,-,-1,-1
MULIFE.txt,1080531,1080791,260,20,N,N,-,-1,-1
MULIFE.txt,1080625,1080848,223,20,N,N,-,-1,-1
MULIFE.txt,1080649,1080925,276,20,N,N,-,-1,-1
MULIFE.txt,1080725,1080976,251,20,N,N,-,-1,-1
MULIFE.txt,1080792,1081076,284,20,N,N,-,-1,-1
MULIFE.txt,1080851,1081112,261,20,N,N,-,-1,-1
MULIFE.txt,1080926,1081177,251,20,N,N,-,-1,-1
MULIFE.txt,1080977,1081228,251,20,N,N,-,-1,-1
MULIFE.txt,1081077,1081396,319,20,N,N,-,-1,-1
MULIFE.txt,1081113,1081500,387,20,N,N,-,-1,-1
MULIFE.txt,1081178,1081746,568,20,N,N,-,-1,-1
MULIFE.txt,1081231,1081964,733,20,N,N,-,-1,-1
MULIFE.txt,1081397,1082093,696,20,N,N,-,-1,-1
MULIFE.txt,1081503,1082331,828,20,N,N,-,-1,-1
MULIFE.txt,1081751,1082539,788,20,N,N,-,-1,-1
MULIFE.txt,1081965,1082794,829,20,N,N,-,-1,-1
MULIFE.txt,1082096,1082908,812,20,N,N,-,-1,-1
MULIFE.txt,1082332,1083047,715,20,N,N,-,-1,-1
MULIFE.txt,1082540,1083153,613,20,N,N,-,-1,-1
MULIFE.txt,1082794,1083265,471,20,N,N,-,-1,-1
MULIFE.txt,1082909,1083405,496,20,N,N,-,-1,-1
MULIFE.txt,1083048,1083521,473,20,N,N,-,-1,-1
MULIFE.txt,1083154,1083597,443,20,Y,N,-,-1,-1
MULIFE.txt,1083266,1083747,481,20,Y,N,-,-1,-1
MULIFE.txt,1083406,1083863,457,20,Y,N,-,-1,-1
MULIFE.txt,1083523,1084015,492,20,Y,N,-,-1,-1
MULIFE.txt,1083598,1084086,488,20,Y,N,-,-1,-1
MULIFE.txt,1083748,1084162,414,20,Y,N,-,-1,-1
MULIFE.txt,1083864,1084279,415,20,Y,N,-,-1,-1
MULIFE.txt,1084016,1084341,325,20,Y,N,-,-1,-1
MULIFE.txt,1084087,1084444,357,20,N,N,-,-1,-1
MULIFE.txt,1084163,1084555,392,20,N,N,-,-1,-1
MULIFE.txt,1084280,1084717,437,20,N,N,-,-1,-1
MULIFE.txt,1084342,1084881,539,20,N,N,-,-1,-1
MULIFE.txt,1084445,1085032,587,20,N,N,-,-1,-1
MULIFE.txt,1084557,1085127,570,20,N,N,-,-1,-1
MULIFE.txt,1084718,1085159,441,20,N,N,-,-1,-1
MULIFE.txt,1084882,1085242,360,20,N,N,-,-1,-1
MULIFE.txt,1085033,1085302,269,20,N,N,-,-1,-1
MULIFE.txt,1085128,1085384,256,20,N,N,-,-1,-1
MULIFE.txt,1085160,1085418,258,20,N,N,-,-1,-1
MULIFE.txt,1085244,1085466,222,20,N,N,-,-1,-1
MULIFE.txt,1085303,1085511,208,20,N,N,-,-1,-1
MULIFE.txt,1085385,1085592,207,20,N,N,-,-1,-1
MULIFE.txt,1085419,1085660,241,20,N,N,-,-1,-1
MULIFE.txt,1085467,1085734,267,20,N,N,-,-1,-1
MULIFE.txt,1085512,1085922,410,20,N,N,-,-1,-1
MULIFE.txt,1085595,1086067,472,20,N,N,-,-1,-1
MULIFE.txt,1085661,1086154,493,20,N,N,-,-1,-1
MULIFE.txt,1085735,1086212,477,20,N,N,-,-1,-1
MULIFE.txt,1085923,1086260,337,20,N,N,-,-1,-1
MULIFE.txt,1086069,1086311,242,20,N,N,-,-1,-1
MULIFE.txt,1086155,1086360,205,20,N,N,-,-1,-1
MULIFE.txt,1086213,1086452,239,20,N,N,-,-1,-1
MULIFE.txt,1086261,1086556,295,20,N,N,-,-1,-1
MULIFE.txt,1086311,1086660,349,20,N,N,-,-1,-1
MULIFE.txt,1086361,1086785,424,20,N,N,-,-1,-1
MULIFE.txt,1086453,1087053,600,20,N,N,-,-1,-1
MULIFE.txt,1086559,1087201,642,20,N,N,-,-1,-1
MULIFE.txt,1086661,1087336,675,20,N,N,-,-1,-1
MULIFE.txt,1086788,1087411,623,20,N,N,-,-1,-1
MULIFE.txt,1087054,1087486,432,20,N,N,-,-1,-1
MULIFE.txt,1087202,1087595,393,20,N,N,-,-1,-1
MULIFE.txt,1087337,1087680,343,20,N,N,-,-1,-1
MULIFE.txt,1087412,1087813,401,20,N,N,-,-1,-1
MULIFE.txt,1087487,1088027,540,20,N,N,-,-1,-1
MULIFE.txt,1087595,1088083,488,20,N,N,-,-1,-1
MULIFE.txt,1087681,1088138,457,20,N,N,-,-1,-1
MULIFE.txt,1087814,1088206,392,20,N,N,-,-1,-1
MULIFE.txt,1088028,1088265,237,20,N,N,-,-1,-1
MULIFE.txt,1088084,1088446,362,20,N,N,-,-1,-1
MULIFE.txt,1088140,1088757,617,20,N,N,-,-1,-1
MULIFE.txt,1088208,1088825,617,20,N,N,-,-1,-1
MULIFE.txt,1088266,1088900,634,20,N,N,-,-1,-1
MULIFE.txt,1088447,1089145,698,20,N,N,-,-1,-1
MULIFE.txt,1088758,1089365,607,20,N,N,-,-1,-1
MULIFE.txt,1088826,1089508,682,20,N,N,-,-1,-1
MULIFE.txt,1088901,1089714,813,20,N,N,-,-1,-1
MULIFE.txt,1089146,1089865,719,20,N,N,-,-1,-1
MULIFE.txt,1089368,1089959,591,20,N,N,-,-1,-1
MULIFE.txt,1089509,1090108,599,20,N,N,-,-1,-1
MULIFE.txt,1089717,1090198,481,20,N,N,-,-1,-1
MULIFE.txt,1089868,1090263,395,20,N,N,-,-1,-1
MULIFE.txt,1089960,1090440,480,20,N,N,-,-1,-1
MULIFE.txt,1090109,1090604,495,20,N,N,-,-1,-1
MULIFE.txt,1090200,1090706,506,20,N,N,-,-1,-1
MULIFE.txt,1090264,1090901,637,20,N,N,-,-1,-1
MULIFE.txt,1090441,1090966,525,20,N,N,-,-1,-1
MULIFE.txt,1090605,1091078,473,20,N,N,-,-1,-1
MULIFE.txt,1090707,1091158,451,20,N,N,-,-1,-1
MULIFE.txt,1090902,1091251,349,20,N,N,-,-1,-1
MULIFE.txt,1090967,1091316,349,20,N,N,-,-1,-1
MULIFE.txt,1091079,1091396,317,20,N,N,-,-1,-1
MULIFE.txt,1091159,1091522,363,20,N,N,-,-1,-1
MULIFE.txt,1091254,1091618,364,20,N,N,-,-1,-1
MULIFE.txt,1091317,1091824,507,20,N,N,-,-1,-1
MULIFE.txt,1091398,1092042,644,20,N,N,-,-1,-1
MULIFE.txt,1091523,1092143,620,20,N,N,-,-1,-1
MULIFE.txt,1091619,1092212,593,20,N,N,-,-1,-1
MULIFE.txt,1091825,1092269,444,20,N,N,-,-1,-1
MULIFE.txt,1092043,1092437,394,20,N,N,-,-1,-1
MULIFE.txt,1092144,1092627,483,20,N,N,-,-1,-1
MULIFE.txt,1092213,1092682,469,20,N,N,-,-1,-1
MULIFE.txt,1092274,1092716,442,20,N,N,-,-1,-1
MULIFE.txt,1092438,1093015,577,20,N,N,-,-1,-1
MULIFE.txt,1092628,1093166,538,20,N,N,-,-1,-1
MUSING.txt,0,5332,5332,20,Y,N,-,-1,-1
MUSING.txt,1011,6114,5103,20,Y,N,-,-1,-1
MUSING.txt,2032,6953,4921,20,Y,N,-,-1,-1
MUSING.txt,3606,8219,4613,20,Y,N,-,-1,-1
MUSING.txt,5334,9101,3767,20,N,N,-,-1,-1
MUSING.txt,6115,9828,3713,20,N,N,-,-1,-1
MUSING.txt,6955,10190,3235,20,N,N,-,-1,-1
MUSING.txt,8220,12155,3935,20,Y,Y,1452196853462,11789,12151
MUSING.txt,9102,13362,4260,20,Y,Y,1452197105481,12624,12995
MUSING.txt,9829,15556,5727,20,Y,Y,1452197105481,12624,12995
MUSING.txt,10191,16595,6404,20,Y,Y,1452197105481,12624,12995
MUSING.txt,12156,18996,6840,20,Y,Y,1452197105481,12624,12995
MUSING.txt,13363,20142,6779,20,Y,Y,1452552834876,19293,19784
MUSING.txt,15558,21452,5894,20,Y,Y,1452552963937,20183,20500
MUSING.txt,16598,22263,5665,20,Y,Y,1452552963937,20183,20500
MUSING.txt,18997,23244,4247,20,Y,Y,1452552963937,20183,20500
MUSING.txt,20143,25106,4963,20,Y,Y,1452552963937,20183,20500
MUSING.txt,21453,26386,4933,20,Y,Y,1452633313155,24231,24696
MUSING.txt,22264,27628,5364,20,Y,Y,1452633313155,24231,24696
MUSING.txt,23245,28753,5508,20,Y,Y,1452633313155,24231,24696
MUSING.txt,25107,30171,5064,20,Y,Y,1452633925920,28052,28470
MUSING.txt,26387,31594,5207,20,Y,Y,1452635059028,30305,30726
MUSING.txt,27631,32621,4990,20,Y,Y,1452636055684,32302,33666
MUSING.txt,28754,33910,5156,20,Y,Y,1452636055684,32302,33666
MUSING.txt,30172,35333,5161,20,Y,Y,1452636055684,32302,33666
MUSING.txt,31597,36231,4634,20,Y,Y,1452636055684,32302,33666
MUSING.txt,32622,36925,4303,20,Y,Y,1452636055684,32302,33666
MUSING.txt,33911,38179,4268,20,Y,N,-,-1,-1
MUSING.txt,35334,40078,4744,20,Y,Y,1452636825724,38193,39614
MUSING.txt,36232,41602,5370,20,Y,Y,1452636825724,38193,39614
MUSING.txt,36926,42424,5498,20,Y,Y,1452636825724,38193,39614
MUSING.txt,38180,43113,4933,20,Y,Y,1452636825724,38193,39614
MUSING.txt,40079,44381,4302,20,Y,Y,1452637642930,39672,40424
MUSING.txt,41605,45256,3651,20,Y,Y,1452638022184,43114,43497
MUSING.txt,42425,46355,3930,20,Y,Y,1452638022184,43114,43497
MUSING.txt,43116,46914,3798,20,Y,Y,1452638022184,43114,43497
MUSING.txt,44384,47640,3256,20,N,N,-,-1,-1
MUSING.txt,45257,48504,3247,20,N,N,-,-1,-1
MUSING.txt,46357,49001,2644,20,N,N,-,-1,-1
MUSING.txt,46915,50303,3388,20,Y,Y,1452808243495,49009,49545
MUSING.txt,47642,51834,4192,20,Y,Y,1452808243495,49009,49545
MUSING.txt,48505,53071,4566,20,Y,Y,1452809876210,52219,52571
MUSING.txt,49002,54299,5297,20,Y,Y,1452810063851,53076,53440
MUSING.txt,50304,55513,5209,20,Y,Y,1452810063851,53076,53440
MUSING.txt,51835,56634,4799,20,Y,Y,1452810063851,53076,53440
MUSING.txt,53074,57363,4289,20,Y,Y,1452810063851,53076,53440
MUSING.txt,54300,57931,3631,20,Y,Y,1452811308084,57736,58274
MUSING.txt,55514,59012,3498,20,Y,Y,1452811308084,57736,58274
MUSING.txt,56636,59990,3354,20,Y,Y,1452811308084,57736,58274
MUSING.txt,57364,61815,4451,20,Y,Y,1453045736851,60609,61623
MUSING.txt,57932,63053,5121,20,Y,Y,1453045736851,60609,61623
MUSING.txt,59014,64015,5001,20,Y,Y,1453049225205,63792,64405
MUSING.txt,59993,64633,4640,20,Y,Y,1453049225205,63792,64405
MUSING.txt,61817,66249,4432,20,Y,Y,1453049225205,63792,64405
MUSING.txt,63054,67707,4653,20,Y,Y,1453049225205,63792,64405
MUSING.txt,64016,68600,4584,20,Y,Y,1453049225205,63792,64405
MUSING.txt,64635,69846,5211,20,Y,Y,1453051275841,69685,69839
MUSING.txt,66250,71010,4760,20,Y,Y,1453051275841,69685,69839
MUSING.txt,67708,72340,4632,20,Y,Y,1453051275841,69685,69839
MUSING.txt,68601,73594,4993,20,Y,Y,1453051275841,69685,69839
MUSING.txt,69849,74686,4837,20,Y,Y,1453053339147,74161,74769
MUSING.txt,71011,75920,4909,20,Y,Y,1453053339147,74161,74769
MUSING.txt,72343,76920,4577,20,Y,Y,1453054180764,75925,76428
MUSING.txt,73597,78026,4429,20,Y,Y,1453054180764,75925,76428
MUSING.txt,74687,79269,4582,20,Y,Y,1453054180764,75925,76428
MUSING.txt,75921,80292,4371,20,Y,Y,1453054180764,75925,76428
MUSING.txt,76921,81323,4402,20,Y,Y,1453054446277,77703,78851
MUSING.txt,78027,83042,5015,20,Y,Y,1453054446277,77703,78851
MUSING.txt,79270,84243,4973,20,N,N,-,-1,-1
MUSING.txt,80293,85754,5461,20,N,N,-,-1,-1
MUSING.txt,81324,87168,5844,20,N,N,-,-1,-1
MUSING.txt,83044,88535,5491,20,N,N,-,-1,-1
MUSING.txt,84244,89578,5334,20,N,N,-,-1,-1
MUSING.txt,85755,90531,4776,20,N,N,-,-1,-1
MUSING.txt,87169,91641,4472,20,N,N,-,-1,-1
MUSING.txt,88538,92581,4043,20,N,N,-,-1,-1
MUSING.txt,89579,93242,3663,20,N,N,-,-1,-1
MUSING.txt,90532,94353,3821,20,Y,N,-,-1,-1
MUSING.txt,91642,95661,4019,20,Y,N,-,-1,-1
MUSING.txt,92582,97202,4620,20,Y,N,-,-1,-1
MUSING.txt,93243,98360,5117,20,Y,N,-,-1,-1
MUSING.txt,94356,99747,5391,20,Y,N,-,-1,-1
MUSING.txt,95662,100553,4891,20,Y,N,-,-1,-1
MUSING.txt,97205,101286,4081,20,N,N,-,-1,-1
MUSING.txt,98361,102131,3770,20,N,N,-,-1,-1
MUSING.txt,99750,103361,3611,20,N,N,-,-1,-1
MUSING.txt,100554,104761,4207,20,Y,N,-,-1,-1
MUSING.txt,101287,106130,4843,20,Y,N,-,-1,-1
MUSING.txt,102132,107009,4877,20,Y,Y,1461619406602,106559,106998
MUSING.txt,103362,108459,5097,20,Y,Y,1461619406602,106559,106998
MUSING.txt,104763,109171,4408,20,Y,Y,1461619406602,106559,106998
MUSING.txt,106131,109976,3845,20,Y,Y,1461619406602,106559,106998
MUSING.txt,107010,110711,3701,20,Y,Y,1461619728886,107422,107922
MUSING.txt,108460,111305,2845,20,Y,Y,1473711868958,108578,109622
MUSING.txt,109172,111821,2649,20,Y,Y,1473711868958,108578,109622
MUSING.txt,109977,112208,2231,20,Y,N,-,-1,-1
MUSING.txt,110712,112840,2128,20,Y,N,-,-1,-1
MUSING.txt,111306,113711,2405,20,Y,Y,1473713496783,113607,114030
MUSING.txt,111822,114566,2744,20,Y,Y,1473713496783,113607,114030
MUSING.txt,112209,115555,3346,20,Y,Y,1473713496783,113607,114030
MUSING.txt,112845,116195,3350,20,Y,Y,1473713496783,113607,114030
MUSING.txt,113712,117245,3533,20,Y,Y,1473713496783,113607,114030
MUSING.txt,114568,118785,4217,20,Y,N,-,-1,-1
MUSING.txt,115556,119218,3662,20,Y,N,-,-1,-1
MUSING.txt,116196,119771,3575,20,Y,N,-,-1,-1
MUSING.txt,117246,120793,3547,20,Y,N,-,-1,-1
MUSING.txt,118786,121414,2628,20,Y,N,-,-1,-1
MUSING.txt,119219,122778,3559,20,Y,Y,1473715568245,121644,121983
MUSING.txt,119774,123455,3681,20,Y,Y,1473715568245,121644,121983
MUSING.txt,120794,124535,3741,20,Y,Y,1473715568245,121644,121983
MUSING.txt,121415,125145,3730,20,Y,Y,1473715568245,121644,121983
MUSING.txt,122780,125616,2836,20,Y,N,-,-1,-1
MUSING.txt,123456,126366,2910,20,Y,N,-,-1,-1
MUSING.txt,124536,126869,2333,20,Y,N,-,-1,-1
MUSING.txt,125148,127838,2690,20,Y,Y,1483014061568,126874,127277
MUSING.txt,125619,128743,3124,20,Y,Y,1483014061568,126874,127277
MUSING.txt,126371,129587,3216,20,Y,Y,1483014061568,126874,127277
MUSING.txt,126870,130174,3304,20,Y,Y,1483014061568,126874,127277
MUSING.txt,127839,130518,2679,20,Y,N,-,-1,-1
MUSING.txt,128746,131206,2460,20,Y,N,-,-1,-1
MUSING.txt,129588,132124,2536,20,Y,N,-,-1,-1
MUSING.txt,130176,132719,2543,20,Y,N,-,-1,-1
MUSING.txt,130521,133428,2907,20,Y,N,-,-1,-1
MUSING.txt,131207,134103,2896,20,Y,N,-,-1,-1
MUSING.txt,132125,134840,2715,20,Y,N,-,-1,-1
MUSING.txt,132722,135588,2866,20,Y,N,-,-1,-1
MUSING.txt,133429,136560,3131,20,Y,N,-,-1,-1
MUSING.txt,134104,136886,2782,20,Y,N,-,-1,-1
MUSING.txt,134841,137318,2477,20,Y,N,-,-1,-1
MUSING.txt,135589,137614,2025,20,Y,N,-,-1,-1
MUSING.txt,136562,138082,1520,20,Y,N,-,-1,-1
MUSING.txt,136888,138739,1851,20,Y,N,-,-1,-1
MUSING.txt,137319,139306,1987,20,Y,N,-,-1,-1
MUSING.txt,137617,139825,2208,20,Y,N,-,-1,-1
MUSING.txt,138083,140608,2525,20,Y,N,-,-1,-1
MUSING.txt,138742,141178,2436,20,Y,Y,1483023499163,140609,141162
MUSING.txt,139307,141518,2211,20,Y,Y,1483023499163,140609,141162
MUSING.txt,139826,141809,1983,20,Y,Y,1483023499163,140609,141162
MUSING.txt,140611,142555,1944,20,Y,Y,1483023499163,140609,141162
MUSING.txt,141181,143420,2239,20,Y,N,-,-1,-1
MUSING.txt,141519,143757,2238,20,Y,N,-,-1,-1
MUSING.txt,141812,144457,2645,20,Y,N,-,-1,-1
MUSING.txt,142556,145244,2688,20,Y,N,-,-1,-1
MUSING.txt,143421,145856,2435,20,Y,N,-,-1,-1
MUSING.txt,143759,147165,3406,20,Y,N,-,-1,-1
MUSING.txt,144459,148888,4429,20,Y,N,-,-1,-1
MUSING.txt,145245,149185,3940,20,Y,N,-,-1,-1
MUSING.txt,145857,149636,3779,20,Y,N,-,-1,-1
MUSING.txt,147166,150428,3262,20,Y,N,-,-1,-1
MUSING.txt,148892,151328,2436,20,Y,N,-,-1,-1
MUSING.txt,149186,151732,2546,20,Y,N,-,-1,-1
MUSING.txt,149637,152403,2766,20,Y,Y,1483028149168,151984,152882
MUSING.txt,150429,153020,2591,20,Y,Y,1483028149168,151984,152882
MUSING.txt,151329,153500,2171,20,Y,Y,1483028149168,151984,152882
MUSING.txt,151733,153879,2146,20,Y,Y,1483028149168,151984,152882
MUSING.txt,152404,154589,2185,20,Y,Y,1483028149168,151984,152882
MUSING.txt,153023,155091,2068,20,Y,Y,1483028673856,154833,155406
MUSING.txt,153501,155507,2006,20,Y,Y,1483028673856,154833,155406
MUSING.txt,153882,155936,2054,20,Y,Y,1483028673856,154833,155406
MUSING.txt,154590,156638,2048,20,Y,Y,1483028673856,154833,155406
MUSING.txt,155092,157273,2181,20,Y,Y,1483028673856,154833,155406
MUSING.txt,155509,158174,2665,20,Y,N,-,-1,-1
MUSING.txt,155937,158805,2868,20,Y,N,-,-1,-1
MUSING.txt,156639,159880,3241,20,Y,N,-,-1,-1
MUSING.txt,157274,160919,3645,20,Y,N,-,-1,-1
MUSING.txt,158175,161758,3583,20,Y,N,-,-1,-1
MUSING.txt,158810,163099,4289,20,Y,N,-,-1,-1
MUSING.txt,159883,163857,3974,20,Y,N,-,-1,-1
MUSING.txt,160922,164486,3564,20,Y,N,-,-1,-1
MUSING.txt,161761,165427,3666,20,Y,N,-,-1,-1
MUSING.txt,163100,166301,3201,20,Y,N,-,-1,-1
MUSING.txt,163858,166831,2973,20,Y,N,-,-1,-1
MUSING.txt,164489,167710,3221,20,Y,N,-,-1,-1
MUSING.txt,165428,169516,4088,20,Y,N,-,-1,-1
MUSING.txt,166302,171419,5117,20,Y,N,-,-1,-1
MUSING.txt,166833,171997,5164,20,Y,N,-,-1,-1
MUSING.txt,167711,173067,5356,20,Y,N,-,-1,-1
MUSING.txt,169519,174787,5268,20,Y,N,-,-1,-1
MUSING.txt,171420,175814,4394,20,Y,N,-,-1,-1
MUSING.txt,172000,176991,4991,20,Y,N,-,-1,-1
MUSING.txt,173068,177854,4786,20,Y,N,-,-1,-1
MUSING.txt,174788,178939,4151,20,Y,N,-,-1,-1
MUSING.txt,175815,179955,4140,20,Y,N,-,-1,-1
MUSING.txt,176992,182335,5343,20,Y,N,-,-1,-1
MUSING.txt,177857,184121,6264,20,Y,N,-,-1,-1
MUSING.txt,178941,185013,6072,20,Y,N,-,-1,-1
MUSING.txt,179958,186990,7032,20,Y,N,-,-1,-1
MUSING.txt,182336,189163,6827,20,Y,N,-,-1,-1
MUSING.txt,184123,189894,5771,20,Y,N,-,-1,-1
MUSING.txt,185014,190657,5643,20,Y,N,-,-1,-1
MUSING.txt,186993,191129,4136,20,N,N,-,-1,-1
MUSING.txt,189164,191789,2625,20,N,N,-,-1,-1
MUSING.txt,189895,193046,3151,20,N,N,-,-1,-1
MUSING.txt,190658,194305,3647,20,N,N,-,-1,-1
MUSING.txt,191130,195645,4515,20,Y,N,-,-1,-1
MUSING.txt,191792,197021,5229,20,Y,N,-,-1,-1
MUSING.txt,193049,198215,5166,20,Y,N,-,-1,-1
MUSING.txt,194307,199183,4876,20,Y,N,-,-1,-1
MUSING.txt,195646,201553,5907,20,Y,N,-,-1,-1
MUSING.txt,197022,202282,5260,20,Y,N,-,-1,-1
MUSING.txt,198216,203384,5168,20,Y,N,-,-1,-1
MUSING.txt,199186,204903,5717,20,Y,N,-,-1,-1
MUSING.txt,201555,206537,4982,20,Y,N,-,-1,-1
MUSING.txt,202283,207654,5371,20,Y,N,-,-1,-1
MUSING.txt,203385,208906,5521,20,Y,N,-,-1,-1
MUSING.txt,204906,210542,5636,20,Y,N,-,-1,-1
MUSING.txt,206538,211402,4864,20,Y,N,-,-1,-1
MUSING.txt,207656,212086,4430,20,Y,N,-,-1,-1
MUSING.txt,208907,213516,4609,20,Y,N,-,-1,-1
MUSING.txt,210543,214468,3925,20,Y,N,-,-1,-1
MUSING.txt,211403,215539,4136,20,Y,N,-,-1,-1
MUSING.txt,212088,216226,4138,20,Y,N,-,-1,-1
MUSING.txt,213517,216769,3252,20,Y,N,-,-1,-1
MUSING.txt,214469,218282,3813,20,Y,N,-,-1,-1
MUSING.txt,215540,219481,3941,20,Y,N,-,-1,-1
MUSING.txt,216228,220274,4046,20,Y,N,-,-1,-1
MUSING.txt,216770,221131,4361,20,Y,N,-,-1,-1
MUSING.txt,218285,221889,3604,20,Y,N,-,-1,-1
MUSING.txt,219482,223044,3562,20,Y,N,-,-1,-1
MUSING.txt,220275,225074,4799,20,Y,N,-,-1,-1
MUSING.txt,221132,225905,4773,20,Y,N,-,-1,-1
MUSING.txt,221890,226728,4838,20,Y,N,-,-1,-1
MUSING.txt,223046,227482,4436,20,Y,N,-,-1,-1
MUSING.txt,225075,228383,3308,20,Y,N,-,-1,-1
MUSING.txt,225906,229246,3340,20,Y,N,-,-1,-1
MUSING.txt,226731,230848,4117,20,Y,N,-,-1,-1
MUSING.txt,227483,231627,4144,20,Y,N,-,-1,-1
MUSING.txt,228384,232387,4003,20,Y,N,-,-1,-1
MUSING.txt,229247,233646,4399,20,Y,N,-,-1,-1
MUSING.txt,230849,234932,4083,20,Y,N,-,-1,-1
MUSING.txt,231628,235828,4200,20,Y,N,-,-1,-1
MUSING.txt,232388,236077,3689,20,Y,N,-,-1,-1
MUSING.txt,233647,236876,3229,20,N,N,-,-1,-1
MUSING.txt,234933,238114,3181,20,N,N,-,-1,-1
MUSING.txt,235829,239539,3710,20,Y,N,-,-1,-1
MUSING.txt,236078,240718,4640,20,Y,N,-,-1,-1
MUSING.txt,236877,241555,4678,20,Y,N,-,-1,-1
MUSING.txt,238116,242247,4131,20,Y,N,-,-1,-1
MUSING.txt,239540,244048,4508,20,Y,N,-,-1,-1
MUSING.txt,240721,245076,4355,20,Y,N,-,-1,-1
MUSING.txt,241558,245523,3965,20,Y,N,-,-1,-1
MUSING.txt,242248,246587,4339,20,Y,N,-,-1,-1
MUSING.txt,244049,247855,3806,20,N,N,-,-1,-1
MUSING.txt,245077,248977,3900,20,N,N,-,-1,-1
MUSING.txt,245525,250260,4735,20,N,N,-,-1,-1
MUSING.txt,246588,252286,5698,20,N,N,-,-1,-1
MUSING.txt,247856,253282,5426,20,N,N,-,-1,-1
MUSING.txt,248978,254476,5498,20,N,N,-,-1,-1
MUSING.txt,250262,256209,5947,20,N,N,-,-1,-1
MUSING.txt,252287,257434,5147,20,N,N,-,-1,-1
MUSING.txt,253283,259012,5729,20,Y,N,-,-1,-1
MUSING.txt,254477,260936,6459,20,N,N,-,-1,-1
MUSING.txt,256210,262395,6185,20,N,N,-,-1,-1
MUSING.txt,257435,265273,7838,20,N,N,-,-1,-1
MUSING.txt,259013,266006,6993,20,N,N,-,-1,-1
MUSING.txt,260938,266722,5784,20,N,N,-,-1,-1
MUSING.txt,262396,267379,4983,20,N,N,-,-1,-1
MUSING.txt,265274,268347,3073,20,N,N,-,-1,-1
MUSING.txt,266007,268912,2905,20,N,N,-,-1,-1
MUSING.txt,266723,269334,2611,20,Y,N,-,-1,-1
MUSING.txt,267380,269674,2294,20,N,N,-,-1,-1
MUSING.txt,268348,270070,1722,20,Y,N,-,-1,-1
MUSING.txt,268913,270404,1491,20,Y,N,-,-1,-1
MUSING.txt,269335,270923,1588,20,Y,N,-,-1,-1
MUSING.txt,269675,271743,2068,20,Y,N,-,-1,-1
MUSING.txt,270071,272792,2721,20,Y,N,-,-1,-1
MUSING.txt,270405,274058,3653,20,Y,N,-,-1,-1
MUSING.txt,270925,275274,4349,20,Y,N,-,-1,-1
MUSING.txt,271744,276537,4793,20,Y,N,-,-1,-1
MUSING.txt,272793,276969,4176,20,Y,N,-,-1,-1
MUSING.txt,274059,277914,3855,20,Y,N,-,-1,-1
MUSING.txt,275275,279136,3861,20,Y,N,-,-1,-1
MUSING.txt,276538,279789,3251,20,Y,N,-,-1,-1
MUSING.txt,276971,280308,3337,20,Y,N,-,-1,-1
MUSING.txt,277915,280978,3063,20,Y,N,-,-1,-1
MUSING.txt,279137,281983,2846,20,Y,N,-,-1,-1
MUSING.txt,279792,283295,3503,20,Y,N,-,-1,-1
MUSING.txt,280309,284423,4114,20,Y,N,-,-1,-1
MUSING.txt,280979,285420,4441,20,Y,N,-,-1,-1
MUSING.txt,281984,287130,5146,20,Y,N,-,-1,-1
MUSING.txt,283298,288388,5090,20,Y,N,-,-1,-1
MUSING.txt,284426,289509,5083,20,Y,N,-,-1,-1
MUSING.txt,285421,290995,5574,20,Y,N,-,-1,-1
MUSING.txt,287133,291625,4492,20,N,N,-,-1,-1
MUSING.txt,288389,291991,3602,20,Y,N,-,-1,-1
MUSING.txt,289510,292426,2916,20,Y,N,-,-1,-1
MUSING.txt,290998,293368,2370,20,Y,N,-,-1,-1
MUSING.txt,291628,294317,2689,20,Y,N,-,-1,-1
MUSING.txt,291992,294787,2795,20,Y,N,-,-1,-1
MUSING.txt,292429,296134,3705,20,Y,N,-,-1,-1
MUSING.txt,293369,297078,3709,20,Y,N,-,-1,-1
MUSING.txt,294318,298618,4300,20,Y,N,-,-1,-1
MUSING.txt,294792,299170,4378,20,Y,N,-,-1,-1
MUSING.txt,296135,300033,3898,20,Y,N,-,-1,-1
MUSING.txt,297081,301829,4748,20,Y,N,-,-1,-1
MUSING.txt,298619,303441,4822,20,Y,N,-,-1,-1
MUSING.txt,299173,304975,5802,20,Y,N,-,-1,-1
MUSING.txt,300034,306158,6124,20,Y,N,-,-1,-1
MUSING.txt,301832,307421,5589,20,Y,N,-,-1,-1
MUSING.txt,303442,308427,4985,20,N,N,-,-1,-1
MUSING.txt,304976,308858,3882,20,N,N,-,-1,-1
MUSING.txt,306160,309797,3637,20,N,N,-,-1,-1
MUSING.txt,307422,310095,2673,20,N,N,-,-1,-1
MUSING.txt,308428,310650,2222,20,N,N,-,-1,-1
MUSING.txt,308859,312100,3241,20,N,N,-,-1,-1
MUSING.txt,309798,313159,3361,20,Y,N,-,-1,-1
MUSING.txt,310096,314427,4331,20,Y,N,-,-1,-1
MUSING.txt,310651,315221,4570,20,Y,N,-,-1,-1
MUSING.txt,312101,315467,3366,20,Y,N,-,-1,-1
MUSING.txt,313160,315907,2747,20,Y,N,-,-1,-1
MUSING.txt,314429,316615,2186,20,Y,N,-,-1,-1
MUSING.txt,315223,317542,2319,20,Y,N,-,-1,-1
MUSING.txt,315468,318685,3217,20,Y,N,-,-1,-1
MUSING.txt,315908,319415,3507,20,Y,N,-,-1,-1
MUSING.txt,316616,320250,3634,20,Y,N,-,-1,-1
MUSING.txt,317544,321806,4262,20,Y,N,-,-1,-1
MUSING.txt,318686,323050,4364,20,Y,N,-,-1,-1
MUSING.txt,319416,324923,5507,20,Y,N,-,-1,-1
MUSING.txt,320255,326059,5804,20,Y,N,-,-1,-1
MUSING.txt,321808,327369,5561,20,Y,N,-,-1,-1
MUSING.txt,323053,328225,5172,20,Y,N,-,-1,-1
MUSING.txt,324924,329119,4195,20,Y,N,-,-1,-1
MUSING.txt,326061,330248,4187,20,Y,N,-,-1,-1
MUSING.txt,327370,331208,3838,20,Y,N,-,-1,-1
MUSING.txt,328226,332165,3939,20,Y,N,-,-1,-1
MUSING.txt,329120,333155,4035,20,Y,N,-,-1,-1
MUSING.txt,330251,334237,3986,20,Y,N,-,-1,-1
MUSING.txt,331209,335432,4223,20,N,N,-,-1,-1
MUSING.txt,332167,336994,4827,20,N,N,-,-1,-1
MUSING.txt,333158,337490,4332,20,N,N,-,-1,-1
MUSING.txt,334240,337932,3692,20,N,N,-,-1,-1
MUSING.txt,335433,339419,3986,20,N,N,-,-1,-1
MUSING.txt,336995,340692,3697,20,N,N,-,-1,-1
MUSING.txt,337491,341795,4304,20,Y,N,-,-1,-1
MUSING.txt,337937,343136,5199,20,Y,N,-,-1,-1
MUSING.txt,339420,344512,5092,20,Y,N,-,-1,-1
MUSING.txt,340697,345365,4668,20,Y,N,-,-1,-1
MUSING.txt,341797,346509,4712,20,Y,N,-,-1,-1
MUSING.txt,343137,347041,3904,20,Y,N,-,-1,-1
MUSING.txt,344515,348013,3498,20,Y,N,-,-1,-1
MUSING.txt,345366,348985,3619,20,Y,N,-,-1,-1
MUSING.txt,346510,349904,3394,20,Y,N,-,-1,-1
MUSING.txt,347044,350907,3863,20,Y,N,-,-1,-1
MUSING.txt,348015,351464,3449,20,Y,N,-,-1,-1
MUSING.txt,348986,352359,3373,20,Y,N,-,-1,-1
MUSING.txt,349905,353022,3117,20,Y,N,-,-1,-1
MUSING.txt,350908,353963,3055,20,Y,N,-,-1,-1
MUSING.txt,351465,355735,4270,20,Y,N,-,-1,-1
MUSING.txt,352360,356409,4049,20,Y,N,-,-1,-1
MUSING.txt,353023,357006,3983,20,Y,N,-,-1,-1
MUSING.txt,353964,358775,4811,20,Y,N,-,-1,-1
MUSING.txt,355738,359443,3705,20,Y,N,-,-1,-1
MUSING.txt,356410,360193,3783,20,Y,N,-,-1,-1
MUSING.txt,357007,360946,3939,20,Y,N,-,-1,-1
MUSING.txt,358776,361530,2754,20,Y,N,-,-1,-1
MUSING.txt,359444,362227,2783,20,Y,N,-,-1,-1
MUSING.txt,360194,363329,3135,20,Y,N,-,-1,-1
MUSING.txt,360949,364291,3342,20,Y,N,-,-1,-1
MUSING.txt,361531,364924,3393,20,Y,N,-,-1,-1
MUSING.txt,362228,365799,3571,20,Y,N,-,-1,-1
MUSING.txt,363330,366458,3128,20,Y,N,-,-1,-1
MUSING.txt,364292,366962,2670,20,Y,N,-,-1,-1
MUSING.txt,364927,367904,2977,20,Y,N,-,-1,-1
MUSING.txt,365800,368421,2621,20,Y,N,-,-1,-1
MUSING.txt,366459,368834,2375,20,Y,N,-,-1,-1
MUSING.txt,366963,369525,2562,20,Y,N,-,-1,-1
MUSING.txt,367907,370564,2657,20,Y,N,-,-1,-1
MUSING.txt,368422,371869,3447,20,Y,N,-,-1,-1
MUSING.txt,368835,372031,3196,20,Y,N,-,-1,-1
MUSING.txt,369528,372167,2639,20,Y,N,-,-1,-1
MUSING.txt,370567,372947,2380,20,Y,N,-,-1,-1
MUSING.txt,371870,374076,2206,20,Y,N,-,-1,-1
MUSING.txt,372036,374832,2796,20,Y,N,-,-1,-1
MUSING.txt,372170,375727,3557,20,Y,N,-,-1,-1
MUSING.txt,372949,377018,4069,20,Y,N,-,-1,-1
MUSING.txt,374077,377394,3317,20,Y,N,-,-1,-1
MUSING.txt,374833,378231,3398,20,Y,N,-,-1,-1
MUSING.txt,375728,379259,3531,20,Y,N,-,-1,-1
MUSING.txt,377019,380408,3389,20,Y,N,-,-1,-1
MUSING.txt,377397,381186,3789,20,Y,N,-,-1,-1
MUSING.txt,378232,383545,5313,20,Y,N,-,-1,-1
MUSING.txt,379261,384546,5285,20,Y,N,-,-1,-1
MUSING.txt,380409,385632,5223,20,Y,N,-,-1,-1
MUSING.txt,381187,386517,5330,20,N,N,-,-1,-1
MUSING.txt,383546,387714,4168,20,N,N,-,-1,-1
MUSING.txt,384547,389543,4996,20,N,N,-,-1,-1
MUSING.txt,385633,391334,5701,20,N,N,-,-1,-1
MUSING.txt,386518,392212,5694,20,N,N,-,-1,-1
MUSING.txt,387715,392983,5268,20,N,N,-,-1,-1
MUSING.txt,389544,394076,4532,20,N,N,-,-1,-1
MUSING.txt,391335,394900,3565,20,Y,N,-,-1,-1
MUSING.txt,392214,397377,5163,20,Y,N,-,-1,-1
MUSING.txt,392984,398899,5915,20,Y,N,-,-1,-1
MUSING.txt,394079,400036,5957,20,Y,N,-,-1,-1
MUSING.txt,394901,400665,5764,20,Y,N,-,-1,-1
MUSING.txt,397378,401116,3738,20,Y,N,-,-1,-1
MUSING.txt,398900,402003,3103,20,Y,N,-,-1,-1
MUSING.txt,400039,403261,3222,20,Y,N,-,-1,-1
MUSING.txt,400666,404348,3682,20,Y,N,-,-1,-1
MUSING.txt,401117,405432,4315,20,Y,N,-,-1,-1
MUSING.txt,402008,406295,4287,20,Y,N,-,-1,-1
MUSING.txt,403262,407264,4002,20,Y,N,-,-1,-1
MUSING.txt,404349,408294,3945,20,Y,N,-,-1,-1
MUSING.txt,405433,410104,4671,20,Y,N,-,-1,-1
MUSING.txt,406296,410350,4054,20,Y,N,-,-1,-1
MUSING.txt,407267,410542,3275,20,Y,N,-,-1,-1
MUSING.txt,408295,410654,2359,20,N,N,-,-1,-1
MUSING.txt,410106,410801,695,20,N,N,-,-1,-1
MUSING.txt,410352,410939,587,20,N,N,-,-1,-1
MUSING.txt,410544,411025,481,20,N,N,-,-1,-1
MUSING.txt,410656,411152,496,20,N,N,-,-1,-1
MUSING.txt,410803,411229,426,20,N,N,-,-1,-1
MUSING.txt,410941,411359,418,20,N,N,-,-1,-1
MUSING.txt,411027,411515,488,20,N,N,-,-1,-1
MUSING.txt,411154,411620,466,20,N,N,-,-1,-1
MUSING.txt,411231,411779,548,20,N,N,-,-1,-1
MUSING.txt,411362,411900,538,20,N,N,-,-1,-1
MUSING.txt,411517,412044,527,20,N,N,-,-1,-1
MUSING.txt,411622,412137,515,20,N,N,-,-1,-1
MUSING.txt,411781,412235,454,20,N,N,-,-1,-1
MUSING.txt,411902,413511,1609,20,N,N,-,-1,-1
MUSING.txt,412046,414358,2312,20,Y,N,-,-1,-1
MUSING.txt,412138,415226,3088,20,Y,N,-,-1,-1
MUSING.txt,412237,415697,3460,20,Y,N,-,-1,-1
MUSING.txt,413514,416444,2930,20,Y,N,-,-1,-1
MUSING.txt,414359,416841,2482,20,Y,N,-,-1,-1
MUSING.txt,415227,417564,2337,20,Y,N,-,-1,-1
MUSING.txt,415698,418427,2729,20,Y,N,-,-1,-1
MUSING.txt,416447,418925,2478,20,Y,N,-,-1,-1
MUSING.txt,416844,419672,2828,20,Y,N,-,-1,-1
MUSING.txt,417565,420558,2993,20,Y,N,-,-1,-1
MUSING.txt,418428,421670,3242,20,Y,N,-,-1,-1
MUSING.txt,418926,423456,4530,20,Y,N,-,-1,-1
MUSING.txt,419673,424197,4524,20,Y,N,-,-1,-1
MUSING.txt,420559,424704,4145,20,Y,N,-,-1,-1
MUSING.txt,421670,425442,3772,20,Y,N,-,-1,-1
MUSING.txt,423457,426540,3083,20,Y,N,-,-1,-1
MUSING.txt,424198,427603,3405,20,Y,N,-,-1,-1
MUSING.txt,424706,428681,3975,20,Y,N,-,-1,-1
MUSING.txt,425442,430283,4841,20,Y,N,-,-1,-1
MUSING.txt,426541,431067,4526,20,Y,N,-,-1,-1
MUSING.txt,427604,431348,3744,20,Y,N,-,-1,-1
MUSING.txt,428683,432005,3322,20,Y,N,-,-1,-1
MUSING.txt,430284,433018,2734,20,Y,N,-,-1,-1
MUSING.txt,431068,433859,2791,20,Y,N,-,-1,-1
MUSING.txt,431349,434949,3600,20,Y,N,-,-1,-1
MUSING.txt,432006,435658,3652,20,Y,N,-,-1,-1
MUSING.txt,433019,436472,3453,20,Y,N,-,-1,-1
MUSING.txt,433860,437472,3612,20,Y,N,-,-1,-1
MUSING.txt,434950,438088,3138,20,Y,N,-,-1,-1
MUSING.txt,435659,439134,3475,20,Y,N,-,-1,-1
MUSING.txt,436474,439986,3512,20,Y,N,-,-1,-1
MUSING.txt,437473,440722,3249,20,Y,N,-,-1,-1
MUSING.txt,438089,441554,3465,20,Y,N,-,-1,-1
MUSING.txt,439135,442336,3201,20,Y,N,-,-1,-1
MUSING.txt,439987,443284,3297,20,Y,N,-,-1,-1
MUSING.txt,440725,444790,4065,20,Y,N,-,-1,-1
MUSING.txt,441555,445486,3931,20,Y,N,-,-1,-1
MUSING.txt,442341,446998,4657,20,Y,N,-,-1,-1
MUSING.txt,443287,447762,4475,20,N,N,-,-1,-1
MUSING.txt,444792,448440,3648,20,N,N,-,-1,-1
MUSING.txt,445487,448552,3065,20,N,N,-,-1,-1
MUSING.txt,446999,449538,2539,20,N,N,-,-1,-1
MUSING.txt,447763,451130,3367,20,Y,N,-,-1,-1
MUSING.txt,448441,452185,3744,20,Y,N,-,-1,-1
MUSING.txt,448553,453304,4751,20,Y,N,-,-1,-1
MUSING.txt,449543,454546,5003,20,Y,N,-,-1,-1
MUSING.txt,451132,455801,4669,20,Y,N,-,-1,-1
MUSING.txt,452187,457052,4865,20,Y,N,-,-1,-1
MUSING.txt,453305,458711,5406,20,Y,N,-,-1,-1
MUSING.txt,454547,460561,6014,20,Y,N,-,-1,-1
MUSING.txt,455802,462067,6265,20,Y,N,-,-1,-1
MUSING.txt,457053,463362,6309,20,Y,N,-,-1,-1
MUSING.txt,458716,464729,6013,20,Y,N,-,-1,-1
MUSING.txt,460564,465458,4894,20,Y,N,-,-1,-1
MUSING.txt,462068,465893,3825,20,Y,N,-,-1,-1
MUSING.txt,463363,467032,3669,20,Y,N,-,-1,-1
MUSING.txt,464730,467981,3251,20,Y,N,-,-1,-1
MUSING.txt,465461,468870,3409,20,Y,N,-,-1,-1
MUSING.txt,465894,470037,4143,20,Y,N,-,-1,-1
MUSING.txt,467035,471117,4082,20,Y,N,-,-1,-1
MUSING.txt,467983,472485,4502,20,Y,N,-,-1,-1
MUSING.txt,468872,474242,5370,20,Y,N,-,-1,-1
MUSING.txt,470039,474946,4907,20,Y,N,-,-1,-1
MUSING.txt,471118,475878,4760,20,Y,N,-,-1,-1
MUSING.txt,472488,477132,4644,20,Y,N,-,-1,-1
MUSING.txt,474243,477823,3580,20,Y,N,-,-1,-1
MUSING.txt,474947,478677,3730,20,Y,N,-,-1,-1
MUSING.txt,475879,479605,3726,20,Y,N,-,-1,-1
MUSING.txt,477133,480070,2937,20,Y,N,-,-1,-1
MUSING.txt,477828,480678,2850,20,Y,N,-,-1,-1
MUSING.txt,478678,481898,3220,20,Y,N,-,-1,-1
MUSING.txt,479606,482628,3022,20,Y,N,-,-1,-1
MUSING.txt,480072,483447,3375,20,Y,N,-,-1,-1
MUSING.txt,480679,485223,4544,20,Y,N,-,-1,-1
MUSING.txt,481899,486593,4694,20,Y,N,-,-1,-1
MUSING.txt,482629,487798,5169,20,Y,N,-,-1,-1
MUSING.txt,483448,489183,5735,20,Y,N,-,-1,-1
MUSING.txt,485224,490303,5079,20,Y,N,-,-1,-1
MUSING.txt,486594,490886,4292,20,Y,N,-,-1,-1
MUSING.txt,487799,491630,3831,20,N,N,-,-1,-1
MUSING.txt,489186,492055,2869,20,N,N,-,-1,-1
MUSING.txt,490304,493944,3640,20,N,N,-,-1,-1
MUSING.txt,490888,495032,4144,20,N,N,-,-1,-1
MUSING.txt,491631,495994,4363,20,N,N,-,-1,-1
MUSING.txt,492056,496931,4875,20,N,N,-,-1,-1
MUSING.txt,493947,497827,3880,20,N,N,-,-1,-1
MUSING.txt,495033,499338,4305,20,Y,N,-,-1,-1
MUSING.txt,495995,500093,4098,20,Y,N,-,-1,-1
MUSING.txt,496934,500910,3976,20,Y,N,-,-1,-1
MUSING.txt,497828,501482,3654,20,N,N,-,-1,-1
MUSING.txt,499339,502457,3118,20,N,N,-,-1,-1
MUSING.txt,500094,503637,3543,20,N,N,-,-1,-1
MUSING.txt,500911,504330,3419,20,N,N,-,-1,-1
MUSING.txt,501483,505180,3697,20,N,N,-,-1,-1
MUSING.txt,502458,506453,3995,20,Y,N,-,-1,-1
MUSING.txt,503638,508225,4587,20,Y,N,-,-1,-1
MUSING.txt,504332,509084,4752,20,Y,N,-,-1,-1
MUSING.txt,505181,509902,4721,20,Y,N,-,-1,-1
MUSING.txt,506454,510635,4181,20,Y,N,-,-1,-1
MUSREM.txt,8,1107,1099,20,Y,N,-,-1,-1
MUSREM.txt,321,1648,1327,20,N,N,-,-1,-1
MUSREM.txt,506,2089,1583,20,Y,N,-,-1,-1
MUSREM.txt,871,2361,1490,20,Y,N,-,-1,-1
MUSREM.txt,1110,3533,2423,20,Y,N,-,-1,-1
MUSREM.txt,1649,5022,3373,20,Y,N,-,-1,-1
MUSREM.txt,2092,6163,4071,20,Y,N,-,-1,-1
MUSREM.txt,2364,7149,4785,20,Y,N,-,-1,-1
MUSREM.txt,3534,8068,4534,20,Y,N,-,-1,-1
MUSREM.txt,5023,9028,4005,20,Y,N,-,-1,-1
MUSREM.txt,6164,9736,3572,20,Y,N,-,-1,-1
MUSREM.txt,7152,10488,3336,20,Y,Y,1445944603888,10479,11042
MUSREM.txt,8073,11056,2983,20,Y,Y,1445944603888,10479,11042
MUSREM.txt,9031,11638,2607,20,Y,Y,1445944603888,10479,11042
MUSREM.txt,9739,12228,2489,20,Y,Y,1445944603888,10479,11042
MUSREM.txt,10489,13107,2618,20,Y,Y,1445944603888,10479,11042
MUSREM.txt,11057,14146,3089,20,Y,Y,1445946913032,11418,11636
MUSREM.txt,11640,14801,3161,20,Y,N,-,-1,-1
MUSREM.txt,12231,15790,3559,20,Y,Y,1445947674116,15382,15779
MUSREM.txt,13109,16386,3277,20,Y,Y,1445947674116,15382,15779
MUSREM.txt,14147,17145,2998,20,Y,Y,1445947674116,15382,15779
MUSREM.txt,14803,17634,2831,20,Y,Y,1445947674116,15382,15779
MUSREM.txt,15793,18365,2572,20,Y,Y,1445955109644,17888,18866
MUSREM.txt,16389,19206,2817,20,Y,Y,1445955109644,17888,18866
MUSREM.txt,17146,19915,2769,20,Y,Y,1445955109644,17888,18866
MUSREM.txt,17635,20450,2815,20,Y,Y,1445955109644,17888,18866
MUSREM.txt,18366,21455,3089,20,Y,Y,1445955109644,17888,18866
MUSREM.txt,19207,22545,3338,20,Y,Y,1445955591123,20528,20953
MUSREM.txt,19920,23214,3294,20,Y,Y,1445955912022,23018,23382
MUSREM.txt,20452,24101,3649,20,Y,Y,1445955912022,23018,23382
MUSREM.txt,21456,24958,3502,20,Y,Y,1445955912022,23018,23382
MUSREM.txt,22546,26010,3464,20,Y,Y,1445955912022,23018,23382
MUSREM.txt,23215,26583,3368,20,Y,Y,1445955912022,23018,23382
MUSREM.txt,24102,27256,3154,20,Y,Y,1445956412843,24469,24832
MUSREM.txt,24959,27907,2948,20,Y,Y,1445956802191,26011,26302
MUSREM.txt,26013,28823,2810,20,Y,Y,1445957251664,27927,28212
MUSREM.txt,26584,29590,3006,20,Y,Y,1445957251664,27927,28212
MUSREM.txt,27259,30062,2803,20,Y,Y,1445957251664,27927,28212
MUSREM.txt,27908,30673,2765,20,Y,Y,1445957251664,27927,28212
MUSREM.txt,28825,31484,2659,20,Y,Y,1445957972281,31471,31861
MUSREM.txt,29591,32267,2676,20,Y,Y,1445957972281,31471,31861
MUSREM.txt,30063,33310,3247,20,Y,Y,1445957972281,31471,31861
MUSREM.txt,30674,34012,3338,20,Y,Y,1445957972281,31471,31861
MUSREM.txt,31484,34630,3146,20,Y,Y,1445957972281,31471,31861
MUSREM.txt,32268,35318,3050,20,Y,Y,1445963721474,35258,35532
MUSREM.txt,33311,36248,2937,20,Y,Y,1445963721474,35258,35532
MUSREM.txt,34014,36598,2584,20,Y,Y,1445963721474,35258,35532
MUSREM.txt,34633,37398,2765,20,Y,Y,1445963721474,35258,35532
MUSREM.txt,35319,38154,2835,20,Y,Y,1445964475278,37399,37589
MUSREM.txt,36249,39060,2811,20,Y,Y,1445964475278,37399,37589
MUSREM.txt,36601,39850,3249,20,Y,Y,1445964475278,37399,37589
MUSREM.txt,37401,40604,3203,20,Y,Y,1445964475278,37399,37589
MUSREM.txt,38155,41297,3142,20,Y,Y,1445965566465,40802,41605
MUSREM.txt,39063,42232,3169,20,Y,Y,1445965566465,40802,41605
MUSREM.txt,39851,43021,3170,20,Y,Y,1445965566465,40802,41605
MUSREM.txt,40605,43747,3142,20,Y,Y,1445965566465,40802,41605
MUSREM.txt,41298,44281,2983,20,Y,Y,1445965566465,40802,41605
MUSREM.txt,42235,44709,2474,20,Y,Y,1445966436521,43605,43853
MUSREM.txt,43022,45491,2469,20,Y,Y,1446052439741,45238,45486
MUSREM.txt,43748,46122,2374,20,Y,Y,1446052439741,45238,45486
MUSREM.txt,44282,47146,2864,20,Y,Y,1446052439741,45238,45486
MUSREM.txt,44712,47779,3067,20,Y,Y,1446052439741,45238,45486
MUSREM.txt,45494,48584,3090,20,Y,Y,1446053757053,48262,48584
MUSREM.txt,46123,49370,3247,20,Y,Y,1446053757053,48262,48584
MUSREM.txt,47147,50111,2964,20,Y,Y,1446053757053,48262,48584
MUSREM.txt,47780,50901,3121,20,Y,Y,1446053757053,48262,48584
MUSREM.txt,48585,51673,3088,20,Y,Y,1446635157507,51003,51207
MUSREM.txt,49371,52421,3050,20,Y,Y,1446635157507,51003,51207
MUSREM.txt,50114,53341,3227,20,Y,Y,1446635157507,51003,51207
MUSREM.txt,50904,54132,3228,20,Y,Y,1446635157507,51003,51207
MUSREM.txt,51674,54948,3274,20,Y,N,-,-1,-1
MUSREM.txt,52421,55634,3213,20,Y,N,-,-1,-1
MUSREM.txt,53342,56861,3519,20,Y,Y,1446636156055,56380,57523
MUSREM.txt,54135,57665,3530,20,Y,Y,1446636156055,56380,57523
MUSREM.txt,54949,58685,3736,20,Y,Y,1446636156055,56380,57523
MUSREM.txt,55636,59162,3526,20,Y,Y,1446636156055,56380,57523
MUSREM.txt,56862,59904,3042,20,Y,Y,1446636156055,56380,57523
MUSREM.txt,57666,61039,3373,20,Y,Y,1446637443845,60250,60839
MUSREM.txt,58686,61696,3010,20,Y,Y,1446637443845,60250,60839
MUSREM.txt,59165,62373,3208,20,Y,Y,1446637443845,60250,60839
MUSREM.txt,59905,63318,3413,20,Y,Y,1446637443845,60250,60839
MUSREM.txt,61040,64012,2972,20,Y,Y,1446637734026,60862,61393
MUSREM.txt,61699,64868,3169,20,Y,Y,1446638321422,63089,63407
MUSREM.txt,62374,65747,3373,20,Y,Y,1446638321422,63089,63407
MUSREM.txt,63319,66473,3154,20,Y,Y,1446638321422,63089,63407
MUSREM.txt,64013,67756,3743,20,Y,Y,1446639780182,64006,64258
MUSREM.txt,64869,68492,3623,20,Y,Y,1446640118196,66272,66825
MUSREM.txt,65749,68992,3243,20,Y,Y,1446640118196,66272,66825
MUSREM.txt,66475,70046,3571,20,Y,Y,1446640889918,69534,70949
MUSREM.txt,67758,70826,3068,20,Y,Y,1446640889918,69534,70949
MUSREM.txt,68493,71343,2850,20,Y,Y,1446640889918,69534,70949
MUSREM.txt,68993,72182,3189,20,Y,Y,1446640889918,69534,70949
MUSREM.txt,70049,73077,3028,20,Y,Y,1446640889918,69534,70949
MUSREM.txt,70827,74242,3415,20,Y,Y,1446640889918,69534,70949
MUSREM.txt,71344,74767,3423,20,Y,N,-,-1,-1
MUSREM.txt,72185,75644,3459,20,Y,N,-,-1,-1
MUSREM.txt,73078,76396,3318,20,Y,N,-,-1,-1
MUSREM.txt,74247,77237,2990,20,Y,N,-,-1,-1
MUSREM.txt,74768,78200,3432,20,Y,N,-,-1,-1
MUSREM.txt,75646,79192,3546,20,Y,N,-,-1,-1
MUSREM.txt,76397,79862,3465,20,Y,N,-,-1,-1
MUSREM.txt,77238,80615,3377,20,Y,N,-,-1,-1
MUSREM.txt,78202,81193,2991,20,Y,N,-,-1,-1
MUSREM.txt,79193,81822,2629,20,Y,Y,1446647463097,81750,82066
MUSREM.txt,79863,82531,2668,20,Y,Y,1446647463097,81750,82066
MUSREM.txt,80616,83121,2505,20,Y,Y,1446647463097,81750,82066
MUSREM.txt,81196,83825,2629,20,Y,Y,1446647463097,81750,82066
MUSREM.txt,81825,84858,3033,20,Y,Y,1446647463097,81750,82066
MUSREM.txt,82532,85572,3040,20,Y,N,-,-1,-1
MUSREM.txt,83122,86116,2994,20,Y,N,-,-1,-1
MUSREM.txt,83828,86942,3114,20,Y,Y,1446648222034,86772,88203
MUSREM.txt,84863,87946,3083,20,Y,Y,1446648222034,86772,88203
MUSREM.txt,85574,88729,3155,20,Y,Y,1446648222034,86772,88203
MUSREM.txt,86119,89340,3221,20,Y,Y,1446648222034,86772,88203
MUSREM.txt,86943,90134,3191,20,Y,Y,1446648222034,86772,88203
MUSREM.txt,87949,90908,2959,20,Y,Y,1446720066011,90716,91222
MUSREM.txt,88730,91801,3071,20,Y,Y,1446720066011,90716,91222
MUSREM.txt,89341,92792,3451,20,Y,Y,1446720066011,90716,91222
MUSREM.txt,90135,93468,3333,20,Y,Y,1446720066011,90716,91222
MUSREM.txt,90910,94106,3196,20,Y,Y,1446720066011,90716,91222
MUSREM.txt,91802,94597,2795,20,Y,Y,1446720539477,92682,93428
MUSREM.txt,92793,95087,2294,20,Y,Y,1446720539477,92682,93428
MUSREM.txt,93471,95713,2242,20,Y,Y,1446721440313,95396,95514
MUSREM.txt,94107,96297,2190,20,Y,Y,1446721440313,95396,95514
MUSREM.txt,94598,96855,2257,20,Y,Y,1446721440313,95396,95514
MUSREM.txt,95088,97414,2326,20,Y,Y,1446721440313,95396,95514
MUSREM.txt,95714,98093,2379,20,Y,Y,1446722309879,97182,97409
MUSREM.txt,96298,99019,2721,20,Y,Y,1446722309879,97182,97409
MUSREM.txt,96856,99924,3068,20,Y,Y,1446722309879,97182,97409
MUSREM.txt,97415,100849,3434,20,Y,Y,1446743095300,100170,100734
MUSREM.txt,98096,101494,3398,20,Y,Y,1446743095300,100170,100734
MUSREM.txt,99021,102286,3265,20,Y,Y,1446743095300,100170,100734
MUSREM.txt,99925,103287,3362,20,Y,Y,1446743095300,100170,100734
MUSREM.txt,100850,104116,3266,20,Y,Y,1446743750418,103215,103356
MUSREM.txt,101495,104715,3220,20,Y,Y,1446743750418,103215,103356
MUSREM.txt,102287,105623,3336,20,Y,Y,1446744408545,105127,106612
MUSREM.txt,103290,107260,3970,20,Y,Y,1446744408545,105127,106612
MUSREM.txt,104117,107921,3804,20,Y,Y,1446744408545,105127,106612
MUSREM.txt,104715,108854,4139,20,Y,Y,1446744408545,105127,106612
MUSREM.txt,105625,109630,4005,20,Y,Y,1446744408545,105127,106612
MUSREM.txt,107261,110440,3179,20,Y,N,-,-1,-1
MUSREM.txt,107922,111265,3343,20,Y,Y,1446744877240,111104,111542
MUSREM.txt,108855,111881,3026,20,Y,Y,1446744877240,111104,111542
MUSREM.txt,109633,112784,3151,20,Y,Y,1446744877240,111104,111542
MUSREM.txt,110441,113693,3252,20,Y,Y,1446744877240,111104,111542
MUSREM.txt,111267,114615,3348,20,Y,Y,1446744877240,111104,111542
MUSREM.txt,111884,115792,3908,20,Y,N,-,-1,-1
MUSREM.txt,112787,116649,3862,20,Y,N,-,-1,-1
MUSREM.txt,113694,117363,3669,20,Y,N,-,-1,-1
MUSREM.txt,114615,118214,3599,20,Y,Y,1446808893671,117606,117864
MUSREM.txt,115797,119735,3938,20,Y,Y,1446808893671,117606,117864
MUSREM.txt,116652,120697,4045,20,Y,Y,1446809343172,120380,120695
MUSREM.txt,117366,121536,4170,20,Y,Y,1446809343172,120380,120695
MUSREM.txt,118217,122049,3832,20,Y,Y,1446809343172,120380,120695
MUSREM.txt,119736,122993,3257,20,Y,Y,1446809343172,120380,120695
MUSREM.txt,120698,123523,2825,20,Y,N,-,-1,-1
MUSREM.txt,121538,124473,2935,20,Y,Y,1446809771688,123931,124283
MUSREM.txt,122050,125337,3287,20,Y,Y,1446809771688,123931,124283
MUSREM.txt,122998,126034,3036,20,Y,Y,1446809771688,123931,124283
MUSREM.txt,123526,127157,3631,20,Y,Y,1446809771688,123931,124283
MUSREM.txt,124476,128217,3741,20,Y,N,-,-1,-1
MUSREM.txt,125342,128924,3582,20,Y,N,-,-1,-1
MUSREM.txt,126037,129501,3464,20,Y,N,-,-1,-1
MUSREM.txt,127160,130383,3223,20,Y,N,-,-1,-1
MUSREM.txt,128218,131638,3420,20,Y,N,-,-1,-1
MUSREM.txt,128925,132629,3704,20,Y,N,-,-1,-1
MUSREM.txt,129504,133207,3703,20,Y,N,-,-1,-1
MUSREM.txt,130384,133952,3568,20,Y,N,-,-1,-1
MUSREM.txt,131643,134746,3103,20,Y,N,-,-1,-1
MUSREM.txt,132630,135706,3076,20,Y,N,-,-1,-1
MUSREM.txt,133208,136464,3256,20,Y,N,-,-1,-1
MUSREM.txt,133952,137474,3522,20,Y,Y,1446810408665,136481,136987
MUSREM.txt,134747,138391,3644,20,Y,Y,1446810408665,136481,136987
MUSREM.txt,135708,139097,3389,20,Y,Y,1446810408665,136481,136987
MUSREM.txt,136467,140011,3544,20,Y,Y,1446810408665,136481,136987
MUSREM.txt,137475,140868,3393,20,Y,N,-,-1,-1
MUSREM.txt,138394,141604,3210,20,Y,N,-,-1,-1
MUSREM.txt,139098,142048,2950,20,Y,N,-,-1,-1
MUSREM.txt,140012,143434,3422,20,Y,N,-,-1,-1
MUSREM.txt,140869,144045,3176,20,Y,Y,1446810866600,143464,144041
MUSREM.txt,141605,144488,2883,20,Y,Y,1446810866600,143464,144041
MUSREM.txt,142049,144916,2867,20,Y,Y,1446811109129,144788,145068
MUSREM.txt,143437,145974,2537,20,Y,Y,1446811109129,144788,145068
MUSREM.txt,144046,146826,2780,20,Y,Y,1446811471283,146801,147362
MUSREM.txt,144491,147518,3027,20,Y,Y,1446811837346,147380,148123
MUSREM.txt,144917,148159,3242,20,Y,Y,1446811837346,147380,148123
MUSREM.txt,145976,148584,2608,20,Y,Y,1446811837346,147380,148123
MUSREM.txt,146831,149489,2658,20,Y,Y,1446811837346,147380,148123
MUSREM.txt,147519,150281,2762,20,Y,Y,1446811837346,147380,148123
MUSREM.txt,148160,150969,2809,20,Y,N,-,-1,-1
MUSREM.txt,148585,152026,3441,20,Y,Y,1446813333984,151500,152176
MUSREM.txt,149490,152740,3250,20,Y,Y,1446813333984,151500,152176
MUSREM.txt,150282,153148,2866,20,Y,Y,1446813333984,151500,152176
MUSREM.txt,150972,153832,2860,20,Y,Y,1446813333984,151500,152176
MUSREM.txt,152027,154756,2729,20,Y,Y,1446813333984,151500,152176
MUSREM.txt,152741,155690,2949,20,Y,Y,1446813762750,154311,154910
MUSREM.txt,153151,156629,3478,20,Y,Y,1446813762750,154311,154910
MUSREM.txt,153833,157643,3810,20,Y,Y,1446813762750,154311,154910
MUSREM.txt,154757,158270,3513,20,Y,Y,1446813762750,154311,154910
MUSREM.txt,155692,158964,3272,20,Y,Y,1446818906646,158638,159239
MUSREM.txt,156630,159915,3285,20,Y,Y,1446818906646,158638,159239
MUSREM.txt,157648,160641,2993,20,Y,Y,1446818906646,158638,159239
MUSREM.txt,158271,160788,2517,20,Y,Y,1446818906646,158638,159239
MUSREM.txt,158965,161425,2460,20,Y,Y,1446818906646,158638,159239
MUSREM.txt,159916,162272,2356,20,Y,Y,1446819402984,161235,162017
MUSREM.txt,160646,162947,2301,20,Y,Y,1446819402984,161235,162017
MUSREM.txt,160791,163512,2721,20,Y,Y,1446819402984,161235,162017
MUSREM.txt,161426,164251,2825,20,Y,Y,1446819402984,161235,162017
MUSREM.txt,162273,164910,2637,20,Y,N,-,-1,-1
MUSREM.txt,162950,165794,2844,20,Y,N,-,-1,-1
MUSREM.txt,163515,166508,2993,20,Y,N,-,-1,-1
MUSREM.txt,164252,167456,3204,20,Y,Y,1446820062767,167097,167662
MUSREM.txt,164911,168423,3512,20,Y,Y,1446820062767,167097,167662
MUSREM.txt,165795,169472,3677,20,Y,Y,1446820062767,167097,167662
MUSREM.txt,166511,170594,4083,20,Y,Y,1446820734391,170585,172593
MUSREM.txt,167457,171536,4079,20,Y,Y,1446820734391,170585,172593
MUSREM.txt,168426,172385,3959,20,Y,Y,1446820734391,170585,172593
MUSREM.txt,169473,172716,3243,20,Y,Y,1446820734391,170585,172593
MUSREM.txt,170595,173397,2802,20,Y,Y,1446821453239,172722,173763
MUSREM.txt,171537,174093,2556,20,Y,Y,1446821453239,172722,173763
MUSREM.txt,172386,174812,2426,20,Y,Y,1446821453239,172722,173763
MUSREM.txt,172717,175562,2845,20,Y,Y,1446821453239,172722,173763
MUSREM.txt,173398,176327,2929,20,Y,Y,1446821453239,172722,173763
MUSREM.txt,174094,176980,2886,20,Y,Y,1446821880661,175939,176466
MUSREM.txt,174815,177920,3105,20,Y,Y,1446823433860,177434,177715
MUSREM.txt,175563,178747,3184,20,Y,Y,1446823433860,177434,177715
MUSREM.txt,176328,179790,3462,20,Y,Y,1446823931858,179105,180424
MUSREM.txt,176981,180240,3259,20,Y,Y,1446823931858,179105,180424
MUSREM.txt,177921,180824,2903,20,Y,Y,1446823931858,179105,180424
MUSREM.txt,178750,181799,3049,20,Y,Y,1446823931858,179105,180424
MUSREM.txt,179795,182543,2748,20,Y,Y,1446823931858,179105,180424
MUSREM.txt,180241,183110,2869,20,Y,Y,1446823931858,179105,180424
MUSREM.txt,180824,183661,2837,20,Y,N,-,-1,-1
MUSREM.txt,181804,184836,3032,20,Y,N,-,-1,-1
MUSREM.txt,182543,185664,3121,20,Y,N,-,-1,-1
MUSREM.txt,183112,186538,3426,20,Y,N,-,-1,-1
MUSREM.txt,183662,188077,4415,20,Y,N,-,-1,-1
MUSREM.txt,184841,188973,4132,20,Y,N,-,-1,-1
MUSREM.txt,185665,190008,4343,20,Y,N,-,-1,-1
MUSREM.txt,186539,190502,3963,20,Y,N,-,-1,-1
MUSREM.txt,188078,191620,3542,20,Y,N,-,-1,-1
MUSREM.txt,188974,192133,3159,20,Y,N,-,-1,-1
MUSREM.txt,190009,193212,3203,20,N,N,-,-1,-1
MUSREM.txt,190503,194476,3973,20,Y,N,-,-1,-1
MUSREM.txt,191621,195487,3866,20,Y,N,-,-1,-1
MUSREM.txt,192134,196325,4191,20,N,N,-,-1,-1
MUSREM.txt,193215,197463,4248,20,Y,N,-,-1,-1
MUSREM.txt,194481,198376,3895,20,Y,Y,1446824933321,197918,199597
MUSREM.txt,195489,198983,3494,20,Y,Y,1446824933321,197918,199597
MUSREM.txt,196326,199657,3331,20,Y,Y,1446824933321,197918,199597
MUSREM.txt,197464,200574,3110,20,Y,Y,1447063241953,200523,201321
MUSREM.txt,198377,201550,3173,20,Y,Y,1447063241953,200523,201321
MUSREM.txt,198985,202011,3026,20,Y,Y,1447063241953,200523,201321
MUSREM.txt,199658,202600,2942,20,Y,Y,1447063241953,200523,201321
MUSREM.txt,200575,203104,2529,20,Y,Y,1447063241953,200523,201321
MUSREM.txt,201551,203885,2334,20,Y,N,-,-1,-1
MUSREM.txt,202012,204462,2450,20,Y,N,-,-1,-1
MUSREM.txt,202603,205052,2449,20,Y,N,-,-1,-1
MUSREM.txt,203105,205840,2735,20,Y,N,-,-1,-1
MUSREM.txt,203888,206598,2710,20,Y,N,-,-1,-1
MUSREM.txt,204467,207226,2759,20,Y,N,-,-1,-1
MUSREM.txt,205053,207781,2728,20,Y,Y,1447063940500,207257,208280
MUSREM.txt,205841,208300,2459,20,Y,Y,1447063940500,207257,208280
MUSREM.txt,206599,208884,2285,20,Y,Y,1447063940500,207257,208280
MUSREM.txt,207227,209394,2167,20,Y,Y,1447063940500,207257,208280
MUSREM.txt,207782,210181,2399,20,Y,Y,1447063940500,207257,208280
MUSREM.txt,208302,210660,2358,20,Y,Y,1447064379607,210331,210573
MUSREM.txt,208885,211657,2772,20,Y,Y,1447064379607,210331,210573
MUSREM.txt,209397,212365,2968,20,Y,Y,1447064379607,210331,210573
MUSREM.txt,210182,213066,2884,20,Y,Y,1447064379607,210331,210573
MUSREM.txt,210661,213659,2998,20,Y,Y,1447065659153,213218,213654
MUSREM.txt,211658,214273,2615,20,Y,Y,1447065659153,213218,213654
MUSREM.txt,212366,215058,2692,20,Y,Y,1447065659153,213218,213654
MUSREM.txt,213066,215768,2702,20,Y,Y,1448538803111,215417,216014
MUSREM.txt,213660,216430,2770,20,Y,Y,1448538803111,215417,216014
MUSREM.txt,214274,217023,2749,20,Y,Y,1448538803111,215417,216014
MUSREM.txt,215059,217595,2536,20,Y,Y,1448538803111,215417,216014
MUSREM.txt,215770,218106,2336,20,Y,Y,1448538803111,215417,216014
MUSREM.txt,216433,218761,2328,20,Y,Y,1448539695891,217596,217897
MUSREM.txt,217024,219385,2361,20,Y,Y,1448539695891,217596,217897
MUSREM.txt,217596,220119,2523,20,Y,Y,1448539695891,217596,217897
MUSREM.txt,218107,220755,2648,20,Y,Y,1448539816075,217930,218206
MUSREM.txt,218762,221435,2673,20,Y,Y,1448540487155,218969,220902
MUSREM.txt,219386,221988,2602,20,Y,Y,1448540487155,218969,220902
MUSREM.txt,220120,222839,2719,20,Y,Y,1448540487155,218969,220902
MUSREM.txt,220756,223920,3164,20,Y,Y,1448540487155,218969,220902
MUSREM.txt,221436,224823,3387,20,Y,N,-,-1,-1
MUSREM.txt,221990,225280,3290,20,Y,N,-,-1,-1
MUSREM.txt,222840,225981,3141,20,Y,N,-,-1,-1
MUSREM.txt,223923,226999,3076,20,Y,N,-,-1,-1
MUSREM.txt,224826,227935,3109,20,Y,N,-,-1,-1
MUSREM.txt,225283,228631,3348,20,Y,N,-,-1,-1
MUSREM.txt,225982,229444,3462,20,Y,N,-,-1,-1
MUSREM.txt,227000,230211,3211,20,Y,N,-,-1,-1
MUSREM.txt,227938,230781,2843,20,Y,N,-,-1,-1
MUSREM.txt,228632,231363,2731,20,Y,N,-,-1,-1
MUSREM.txt,229447,232252,2805,20,Y,N,-,-1,-1
MUSREM.txt,230216,233065,2849,20,Y,N,-,-1,-1
MUSREM.txt,230782,233888,3106,20,Y,N,-,-1,-1
MUSREM.txt,231364,234966,3602,20,Y,N,-,-1,-1
MUSREM.txt,232253,235862,3609,20,Y,N,-,-1,-1
MUSREM.txt,233066,236593,3527,20,Y,N,-,-1,-1
MUSREM.txt,233889,237224,3335,20,Y,N,-,-1,-1
MUSREM.txt,234968,238036,3068,20,Y,N,-,-1,-1
MUSREM.txt,235863,238850,2987,20,Y,N,-,-1,-1
MUSREM.txt,236594,239679,3085,20,Y,Y,1448634950635,239410,239860
MUSREM.txt,237226,240283,3057,20,Y,Y,1448634950635,239410,239860
MUSREM.txt,238039,240348,2309,20,Y,Y,1448634950635,239410,239860
MUSREM.txt,238851,240484,1633,20,Y,Y,1448634950635,239410,239860
MUSREM.txt,239680,241366,1686,20,Y,Y,1448634950635,239410,239860
MUSREM.txt,240283,242193,1910,20,Y,N,-,-1,-1
MUSREM.txt,240349,243017,2668,20,Y,N,-,-1,-1
MUSREM.txt,240489,243701,3212,20,Y,N,-,-1,-1
MUSREM.txt,241367,244952,3585,20,Y,N,-,-1,-1
MUSREM.txt,242195,245871,3676,20,Y,N,-,-1,-1
MUSREM.txt,243018,246910,3892,20,Y,N,-,-1,-1
MUSREM.txt,243702,247780,4078,20,Y,N,-,-1,-1
MUSREM.txt,244953,248403,3450,20,Y,N,-,-1,-1
MUSREM.txt,245872,249238,3366,20,Y,Y,1448635413557,249132,249521
MUSREM.txt,246911,250390,3479,20,Y,Y,1448635413557,249132,249521
MUSREM.txt,247781,251013,3232,20,Y,Y,1448635980588,250398,250825
MUSREM.txt,248406,251480,3074,20,Y,Y,1448635980588,250398,250825
MUSREM.txt,249239,252004,2765,20,Y,Y,1448635980588,250398,250825
MUSREM.txt,250391,253010,2619,20,Y,Y,1448635980588,250398,250825
MUSREM.txt,251014,253813,2799,20,Y,N,-,-1,-1
MUSREM.txt,251481,254417,2936,20,Y,N,-,-1,-1
MUSREM.txt,252006,255353,3347,20,Y,N,-,-1,-1
MUSREM.txt,253011,256258,3247,20,Y,Y,1448636605363,256225,257318
MUSREM.txt,253814,256862,3048,20,Y,Y,1448636605363,256225,257318
MUSREM.txt,254420,257373,2953,20,Y,Y,1448636605363,256225,257318
MUSREM.txt,255354,258159,2805,20,Y,Y,1448636605363,256225,257318
MUSREM.txt,256259,258797,2538,20,Y,Y,1448636605363,256225,257318
MUSREM.txt,256863,259738,2875,20,Y,Y,1448636605363,256225,257318
MUSREM.txt,257376,260456,3080,20,Y,Y,1448637072058,259739,260989
MUSREM.txt,258160,261235,3075,20,Y,Y,1448637072058,259739,260989
MUSREM.txt,258798,261832,3034,20,Y,Y,1448637072058,259739,260989
MUSREM.txt,259739,262472,2733,20,Y,Y,1448637339862,262368,262868
MUSREM.txt,260457,263568,3111,20,Y,Y,1448637339862,262368,262868
MUSREM.txt,261238,264449,3211,20,Y,Y,1448637339862,262368,262868
MUSREM.txt,261833,264946,3113,20,Y,Y,1448637339862,262368,262868
MUSREM.txt,262473,266073,3600,20,Y,Y,1448637339862,262368,262868
MUSREM.txt,263569,266660,3091,20,Y,Y,1448640538484,265221,266337
MUSREM.txt,264450,267312,2862,20,Y,Y,1448640538484,265221,266337
MUSREM.txt,264947,267724,2777,20,Y,Y,1448640538484,265221,266337
MUSREM.txt,266074,268535,2461,20,Y,Y,1448640538484,265221,266337
MUSREM.txt,266661,268903,2242,20,Y,Y,1448971601346,266958,268184
MUSREM.txt,267313,269752,2439,20,Y,Y,1448971601346,266958,268184
MUSREM.txt,267725,270315,2590,20,Y,Y,1448971601346,266958,268184
MUSREM.txt,268536,270863,2327,20,Y,Y,1448972027684,268678,270113
MUSREM.txt,268904,271637,2733,20,Y,Y,1448972027684,268678,270113
MUSREM.txt,269753,272433,2680,20,Y,Y,1448972027684,268678,270113
MUSREM.txt,270316,272883,2567,20,Y,Y,1448972712694,271727,272544
MUSREM.txt,270866,273612,2746,20,Y,Y,1448972712694,271727,272544
MUSREM.txt,271638,274384,2746,20,Y,Y,1448972712694,271727,272544
MUSREM.txt,272434,275057,2623,20,Y,Y,1448973059320,274486,274617
MUSREM.txt,272884,275762,2878,20,Y,Y,1448973059320,274486,274617
MUSREM.txt,273613,276287,2674,20,Y,Y,1448973059320,274486,274617
MUSREM.txt,274385,276906,2521,20,Y,Y,1448973059320,274486,274617
MUSREM.txt,275060,277299,2239,20,Y,Y,1448973292285,274886,275121
MUSREM.txt,275763,278109,2346,20,Y,Y,1448980124717,276863,277295
MUSREM.txt,276288,278978,2690,20,Y,Y,1448980124717,276863,277295
MUSREM.txt,276908,279936,3028,20,Y,Y,1448980436772,279074,279287
MUSREM.txt,277302,280567,3265,20,Y,Y,1448980436772,279074,279287
MUSREM.txt,278114,281246,3132,20,Y,Y,1448980436772,279074,279287
MUSREM.txt,278979,281723,2744,20,Y,Y,1448980436772,279074,279287
MUSREM.txt,279937,282279,2342,20,Y,Y,1448981024747,279424,280031
MUSREM.txt,280568,283105,2537,20,Y,Y,1448981398336,280787,280977
MUSREM.txt,281247,283637,2390,20,Y,Y,1448981870937,282204,283086
MUSREM.txt,281724,284368,2644,20,Y,Y,1448982281247,283638,283867
MUSREM.txt,282280,285392,3112,20,Y,Y,1448982281247,283638,283867
MUSREM.txt,283106,286196,3090,20,Y,Y,1448982281247,283638,283867
MUSREM.txt,283639,286852,3213,20,Y,Y,1448982281247,283638,283867
MUSREM.txt,284369,287349,2980,20,Y,Y,1448988789823,287061,287381
MUSREM.txt,285393,287778,2385,20,Y,Y,1448988789823,287061,287381
MUSREM.txt,286197,288208,2011,20,Y,Y,1448988789823,287061,287381
MUSREM.txt,286854,288586,1732,20,Y,Y,1448988789823,287061,287381
MUSREM.txt,287350,289355,2005,20,Y,Y,1448988789823,287061,287381
MUSREM.txt,287779,290239,2460,20,Y,Y,1448989871144,289506,290112
MUSREM.txt,288209,291207,2998,20,Y,Y,1448989871144,289506,290112
MUSREM.txt,288588,292038,3450,20,Y,Y,1448989871144,289506,290112
MUSREM.txt,289356,293246,3890,20,Y,Y,1448989871144,289506,290112
MUSREM.txt,290240,294084,3844,20,Y,Y,1448990639546,291228,292408
MUSREM.txt,291208,294852,3644,20,Y,Y,1448991259482,294449,294734
MUSREM.txt,292040,296027,3987,20,Y,Y,1448991259482,294449,294734
MUSREM.txt,293247,296701,3454,20,Y,Y,1448991259482,294449,294734
MUSREM.txt,294085,297736,3651,20,Y,Y,1448991259482,294449,294734
MUSREM.txt,294853,298318,3465,20,Y,N,-,-1,-1
MUSREM.txt,296028,298835,2807,20,Y,N,-,-1,-1
MUSREM.txt,296702,300008,3306,20,Y,N,-,-1,-1
MUSREM.txt,297737,300643,2906,20,Y,N,-,-1,-1
MUSREM.txt,298319,301515,3196,20,Y,N,-,-1,-1
MUSREM.txt,298836,302591,3755,20,Y,N,-,-1,-1
MUSREM.txt,300009,303359,3350,20,Y,N,-,-1,-1
MUSREM.txt,300644,304231,3587,20,Y,N,-,-1,-1
MUSREM.txt,301520,304815,3295,20,Y,N,-,-1,-1
MUSREM.txt,302592,305325,2733,20,Y,N,-,-1,-1
MUSREM.txt,303359,305988,2629,20,Y,N,-,-1,-1
MUSREM.txt,304232,306216,1984,20,Y,N,-,-1,-1
OUSELEY.txt,0,7977,7977,20,N,N,-,-1,-1
OUSELEY.txt,910,11297,10387,20,N,N,-,-1,-1
OUSELEY.txt,2718,11499,8781,20,Y,N,-,-1,-1
OUSELEY.txt,5215,11538,6323,20,Y,N,-,-1,-1
OUSELEY.txt,7978,11884,3906,20,N,N,-,-1,-1
OUSELEY.txt,11298,12747,1449,20,N,N,-,-1,-1
OUSELEY.txt,11499,13030,1531,20,N,N,-,-1,-1
OUSELEY.txt,11538,13772,2234,20,N,N,-,-1,-1
OUSELEY.txt,11885,14592,2707,20,N,N,-,-1,-1
OUSELEY.txt,12749,15052,2303,20,N,N,-,-1,-1
OUSELEY.txt,13031,15276,2245,20,N,N,-,-1,-1
OUSELEY.txt,13773,15923,2150,20,N,N,-,-1,-1
OUSELEY.txt,14593,16358,1765,20,N,N,-,-1,-1
OUSELEY.txt,15053,17115,2062,20,N,N,-,-1,-1
OUSELEY.txt,15278,17625,2347,20,N,N,-,-1,-1
OUSELEY.txt,15924,19249,3325,20,Y,N,-,-1,-1
OUSELEY.txt,16360,20284,3924,20,Y,N,-,-1,-1
OUSELEY.txt,17116,20605,3489,20,Y,N,-,-1,-1
OUSELEY.txt,17626,21780,4154,20,Y,N,-,-1,-1
OUSELEY.txt,19250,22903,3653,20,Y,N,-,-1,-1
OUSELEY.txt,20289,23987,3698,20,Y,N,-,-1,-1
OUSELEY.txt,20606,25342,4736,20,Y,N,-,-1,-1
OUSELEY.txt,21783,25971,4188,20,Y,N,-,-1,-1
OUSELEY.txt,22906,26327,3421,20,Y,N,-,-1,-1
OUSELEY.txt,23988,26594,2606,20,Y,N,-,-1,-1
OUSELEY.txt,25343,26929,1586,20,Y,N,-,-1,-1
OUSELEY.txt,25972,27361,1389,20,Y,N,-,-1,-1
OUSELEY.txt,26328,28456,2128,20,Y,N,-,-1,-1
OUSELEY.txt,26595,29377,2782,20,Y,N,-,-1,-1
OUSELEY.txt,26930,29533,2603,20,Y,N,-,-1,-1
OUSELEY.txt,27362,30036,2674,20,Y,N,-,-1,-1
OUSELEY.txt,28457,31699,3242,20,Y,N,-,-1,-1
OUSELEY.txt,29380,32106,2726,20,Y,N,-,-1,-1
OUSELEY.txt,29535,32656,3121,20,Y,N,-,-1,-1
OUSELEY.txt,30037,33459,3422,20,Y,N,-,-1,-1
OUSELEY.txt,31702,34283,2581,20,Y,N,-,-1,-1
OUSELEY.txt,32107,34856,2749,20,Y,N,-,-1,-1
OUSELEY.txt,32658,36135,3477,20,Y,N,-,-1,-1
OUSELEY.txt,33462,36988,3526,20,Y,N,-,-1,-1
OUSELEY.txt,34284,38180,3896,20,Y,N,-,-1,-1
OUSELEY.txt,34859,39113,4254,20,Y,N,-,-1,-1
OUSELEY.txt,36136,39483,3347,20,Y,N,-,-1,-1
OUSELEY.txt,36993,39892,2899,20,Y,N,-,-1,-1
OUSELEY.txt,38183,40775,2592,20,Y,N,-,-1,-1
OUSELEY.txt,39116,41391,2275,20,Y,N,-,-1,-1
OUSELEY.txt,39484,41981,2497,20,Y,Y,1436610229204,41646,43959
OUSELEY.txt,39895,42946,3051,20,Y,Y,1436610229204,41646,43959
OUSELEY.txt,40780,43849,3069,20,Y,Y,1436610229204,41646,43959
OUSELEY.txt,41392,44464,3072,20,Y,Y,1436610229204,41646,43959
OUSELEY.txt,41982,45035,3053,20,Y,Y,1436610229204,41646,43959
OUSELEY.txt,42949,45472,2523,20,Y,Y,1436610229204,41646,43959
OUSELEY.txt,43852,45622,1770,20,Y,Y,1436610229204,41646,43959
OUSELEY.txt,44465,45711,1246,20,Y,N,-,-1,-1
OUSELEY.txt,45036,46343,1307,20,Y,N,-,-1,-1
OUSELEY.txt,45473,47109,1636,20,Y,N,-,-1,-1
OUSELEY.txt,45627,47371,1744,20,Y,N,-,-1,-1
OUSELEY.txt,45714,48116,2402,20,Y,N,-,-1,-1
OUSELEY.txt,46344,48787,2443,20,N,N,-,-1,-1
OUSELEY.txt,47110,49306,2196,20,N,N,-,-1,-1
OUSELEY.txt,47372,50240,2868,20,N,N,-,-1,-1
OUSELEY.txt,48117,50911,2794,20,N,N,-,-1,-1
OUSELEY.txt,48788,51556,2768,20,N,N,-,-1,-1
OUSELEY.txt,49307,52472,3165,20,N,N,-,-1,-1
OUSELEY.txt,50242,53116,2874,20,Y,N,-,-1,-1
OUSELEY.txt,50912,54066,3154,20,Y,N,-,-1,-1
OUSELEY.txt,51557,54599,3042,20,Y,N,-,-1,-1
OUSELEY.txt,52473,55522,3049,20,Y,N,-,-1,-1
OUSELEY.txt,53118,56644,3526,20,Y,N,-,-1,-1
OUSELEY.txt,54068,57459,3391,20,Y,N,-,-1,-1
OUSELEY.txt,54600,58223,3623,20,Y,N,-,-1,-1
OUSELEY.txt,55523,58604,3081,20,Y,N,-,-1,-1
OUSELEY.txt,56645,58984,2339,20,Y,N,-,-1,-1
OUSELEY.txt,57460,59714,2254,20,Y,N,-,-1,-1
OUSELEY.txt,58226,60383,2157,20,Y,N,-,-1,-1
OUSELEY.txt,58605,61223,2618,20,Y,N,-,-1,-1
OUSELEY.txt,58985,61867,2882,20,Y,N,-,-1,-1
OUSELEY.txt,59715,62613,2898,20,Y,N,-,-1,-1
OUSELEY.txt,60384,63416,3032,20,Y,N,-,-1,-1
OUSELEY.txt,61225,64202,2977,20,Y,N,-,-1,-1
OUSELEY.txt,61868,65070,3202,20,Y,N,-,-1,-1
OUSELEY.txt,62616,65739,3123,20,Y,N,-,-1,-1
OUSELEY.txt,63418,66748,3330,20,Y,N,-,-1,-1
OUSELEY.txt,64203,67887,3684,20,Y,N,-,-1,-1
OUSELEY.txt,65071,68557,3486,20,Y,N,-,-1,-1
OUSELEY.txt,65740,69565,3825,20,Y,N,-,-1,-1
OUSELEY.txt,66749,70598,3849,20,N,N,-,-1,-1
OUSELEY.txt,67888,71384,3496,20,Y,N,-,-1,-1
OUSELEY.txt,68562,71804,3242,20,Y,N,-,-1,-1
OUSELEY.txt,69566,72595,3029,20,Y,N,-,-1,-1
OUSELEY.txt,70600,73718,3118,20,Y,N,-,-1,-1
OUSELEY.txt,71385,74090,2705,20,Y,N,-,-1,-1
OUSELEY.txt,71809,74729,2920,20,Y,N,-,-1,-1
OUSELEY.txt,72596,75370,2774,20,Y,N,-,-1,-1
OUSELEY.txt,73719,76170,2451,20,Y,N,-,-1,-1
OUSELEY.txt,74091,76974,2883,20,Y,N,-,-1,-1
OUSELEY.txt,74732,78037,3305,20,Y,N,-,-1,-1
OUSELEY.txt,75372,78862,3490,20,Y,N,-,-1,-1
OUSELEY.txt,76171,79556,3385,20,Y,N,-,-1,-1
OUSELEY.txt,76975,79704,2729,20,Y,N,-,-1,-1
OUSELEY.txt,78038,80849,2811,20,Y,N,-,-1,-1
OUSELEY.txt,78865,81984,3119,20,Y,N,-,-1,-1
OUSELEY.txt,79557,82475,2918,20,Y,N,-,-1,-1
OUSELEY.txt,79705,83298,3593,20,Y,N,-,-1,-1
OUSELEY.txt,80850,83984,3134,20,Y,N,-,-1,-1
OUSELEY.txt,81989,84628,2639,20,Y,N,-,-1,-1
OUSELEY.txt,82476,85184,2708,20,Y,N,-,-1,-1
OUSELEY.txt,83299,85962,2663,20,Y,N,-,-1,-1
OUSELEY.txt,83987,87042,3055,20,Y,N,-,-1,-1
OUSELEY.txt,84629,87693,3064,20,Y,N,-,-1,-1
OUSELEY.txt,85185,88622,3437,20,Y,N,-,-1,-1
OUSELEY.txt,85963,88959,2996,20,Y,N,-,-1,-1
OUSELEY.txt,87045,90232,3187,20,Y,N,-,-1,-1
OUSELEY.txt,87694,91112,3418,20,Y,N,-,-1,-1
OUSELEY.txt,88623,92146,3523,20,Y,N,-,-1,-1
OUSELEY.txt,88960,92964,4004,20,Y,N,-,-1,-1
OUSELEY.txt,90233,94186,3953,20,Y,N,-,-1,-1
OUSELEY.txt,91117,94873,3756,20,Y,N,-,-1,-1
OUSELEY.txt,92147,95751,3604,20,Y,N,-,-1,-1
OUSELEY.txt,92965,96532,3567,20,Y,N,-,-1,-1
OUSELEY.txt,94187,97409,3222,20,Y,N,-,-1,-1
OUSELEY.txt,94874,98099,3225,20,Y,N,-,-1,-1
OUSELEY.txt,95752,99262,3510,20,Y,N,-,-1,-1
OUSELEY.txt,96535,101036,4501,20,Y,N,-,-1,-1
OUSELEY.txt,97410,103197,5787,20,Y,N,-,-1,-1
OUSELEY.txt,98100,104592,6492,20,Y,N,-,-1,-1
OUSELEY.txt,99263,106101,6838,20,Y,N,-,-1,-1
OUSELEY.txt,101037,106929,5892,20,Y,N,-,-1,-1
OUSELEY.txt,103200,107778,4578,20,Y,N,-,-1,-1
OUSELEY.txt,104593,108082,3489,20,Y,N,-,-1,-1
OUSELEY.txt,106102,108314,2212,20,Y,N,-,-1,-1
OUSELEY.txt,106930,108710,1780,20,Y,N,-,-1,-1
OUSELEY.txt,107779,109233,1454,20,Y,N,-,-1,-1
OUSELEY.txt,108085,109749,1664,20,Y,N,-,-1,-1
OUSELEY.txt,108315,110248,1933,20,Y,N,-,-1,-1
OUSELEY.txt,108711,110800,2089,20,Y,N,-,-1,-1
OUSELEY.txt,109234,111688,2454,20,Y,N,-,-1,-1
OUSELEY.txt,109750,112272,2522,20,Y,N,-,-1,-1
OUSELEY.txt,110249,113233,2984,20,Y,N,-,-1,-1
OUSELEY.txt,110801,113993,3192,20,Y,N,-,-1,-1
OUSELEY.txt,111689,114901,3212,20,Y,N,-,-1,-1
OUSELEY.txt,112273,115738,3465,20,Y,N,-,-1,-1
OUSELEY.txt,113235,116180,2945,20,Y,N,-,-1,-1
OUSELEY.txt,113994,116523,2529,20,Y,N,-,-1,-1
OUSELEY.txt,114902,116832,1930,20,Y,N,-,-1,-1
OUSELEY.txt,115739,117182,1443,20,N,N,-,-1,-1
OUSELEY.txt,116181,117422,1241,20,N,N,-,-1,-1
OUSELEY.txt,116524,117709,1185,20,Y,N,-,-1,-1
OUSELEY.txt,116833,118054,1221,20,Y,N,-,-1,-1
OUSELEY.txt,117183,118332,1149,20,Y,N,-,-1,-1
OUSELEY.txt,117424,118858,1434,20,Y,N,-,-1,-1
OUSELEY.txt,117710,119609,1899,20,Y,N,-,-1,-1
OUSELEY.txt,118055,120106,2051,20,Y,N,-,-1,-1
OUSELEY.txt,118334,120692,2358,20,Y,N,-,-1,-1
OUSELEY.txt,118859,121633,2774,20,Y,N,-,-1,-1
OUSELEY.txt,119610,122869,3259,20,Y,N,-,-1,-1
OUSELEY.txt,120107,123840,3733,20,Y,N,-,-1,-1
OUSELEY.txt,120693,124695,4002,20,Y,N,-,-1,-1
OUSELEY.txt,121634,125318,3684,20,Y,N,-,-1,-1
OUSELEY.txt,122874,125949,3075,20,Y,N,-,-1,-1
OUSELEY.txt,123842,126641,2799,20,Y,N,-,-1,-1
OUSELEY.txt,124698,127694,2996,20,Y,N,-,-1,-1
OUSELEY.txt,125321,129399,4078,20,Y,N,-,-1,-1
OUSELEY.txt,125954,130424,4470,20,Y,N,-,-1,-1
OUSELEY.txt,126642,132019,5377,20,Y,N,-,-1,-1
OUSELEY.txt,127695,133012,5317,20,Y,N,-,-1,-1
OUSELEY.txt,129400,134067,4667,20,Y,N,-,-1,-1
OUSELEY.txt,130425,134821,4396,20,Y,N,-,-1,-1
OUSELEY.txt,132020,136451,4431,20,Y,N,-,-1,-1
OUSELEY.txt,133013,137303,4290,20,Y,N,-,-1,-1
OUSELEY.txt,134068,138099,4031,20,Y,N,-,-1,-1
OUSELEY.txt,134826,139093,4267,20,Y,N,-,-1,-1
OUSELEY.txt,136454,139756,3302,20,Y,N,-,-1,-1
OUSELEY.txt,137304,140135,2831,20,Y,N,-,-1,-1
OUSELEY.txt,138100,140638,2538,20,Y,N,-,-1,-1
OUSELEY.txt,139095,141576,2481,20,Y,N,-,-1,-1
OUSELEY.txt,139757,142684,2927,20,Y,N,-,-1,-1
OUSELEY.txt,140136,143442,3306,20,Y,N,-,-1,-1
OUSELEY.txt,140639,144294,3655,20,Y,N,-,-1,-1
OUSELEY.txt,141577,145220,3643,20,Y,N,-,-1,-1
OUSELEY.txt,142685,145683,2998,20,Y,N,-,-1,-1
OUSELEY.txt,143443,146392,2949,20,Y,N,-,-1,-1
OUSELEY.txt,144295,146857,2562,20,Y,N,-,-1,-1
OUSELEY.txt,145221,147938,2717,20,Y,N,-,-1,-1
OUSELEY.txt,145684,148831,3147,20,Y,N,-,-1,-1
OUSELEY.txt,146392,149910,3518,20,Y,N,-,-1,-1
OUSELEY.txt,146858,150691,3833,20,Y,N,-,-1,-1
OUSELEY.txt,147941,151443,3502,20,Y,N,-,-1,-1
OUSELEY.txt,148832,152623,3791,20,Y,N,-,-1,-1
OUSELEY.txt,149911,153069,3158,20,Y,N,-,-1,-1
OUSELEY.txt,150692,153842,3150,20,Y,N,-,-1,-1
OUSELEY.txt,151444,154635,3191,20,Y,N,-,-1,-1
OUSELEY.txt,152624,155438,2814,20,Y,N,-,-1,-1
OUSELEY.txt,153074,156501,3427,20,Y,N,-,-1,-1
OUSELEY.txt,153843,157899,4056,20,Y,N,-,-1,-1
OUSELEY.txt,154636,159047,4411,20,Y,N,-,-1,-1
OUSELEY.txt,155439,159723,4284,20,Y,N,-,-1,-1
OUSELEY.txt,156504,160588,4084,20,Y,N,-,-1,-1
OUSELEY.txt,157902,161830,3928,20,Y,N,-,-1,-1
OUSELEY.txt,159052,162313,3261,20,Y,N,-,-1,-1
OUSELEY.txt,159726,163071,3345,20,Y,N,-,-1,-1
OUSELEY.txt,160589,163684,3095,20,Y,N,-,-1,-1
OUSELEY.txt,161831,163849,2018,20,Y,N,-,-1,-1
OUSELEY.txt,162316,164969,2653,20,Y,N,-,-1,-1
OUSELEY.txt,163073,165784,2711,20,Y,N,-,-1,-1
OUSELEY.txt,163685,166549,2864,20,Y,N,-,-1,-1
OUSELEY.txt,163851,167057,3206,20,Y,N,-,-1,-1
OUSELEY.txt,164971,167474,2503,20,Y,N,-,-1,-1
OUSELEY.txt,165785,168119,2334,20,Y,N,-,-1,-1
OUSELEY.txt,166554,169098,2544,20,Y,N,-,-1,-1
OUSELEY.txt,167058,169983,2925,20,Y,N,-,-1,-1
OUSELEY.txt,167475,170816,3341,20,Y,N,-,-1,-1
OUSELEY.txt,168120,171396,3276,20,Y,N,-,-1,-1
OUSELEY.txt,169103,171843,2740,20,Y,N,-,-1,-1
OUSELEY.txt,169984,172880,2896,20,Y,N,-,-1,-1
OUSELEY.txt,170818,173491,2673,20,Y,N,-,-1,-1
OUSELEY.txt,171397,174583,3186,20,Y,N,-,-1,-1
OUSELEY.txt,171844,175237,3393,20,Y,N,-,-1,-1
OUSELEY.txt,172881,176109,3228,20,Y,N,-,-1,-1
OUSELEY.txt,173496,176674,3178,20,Y,N,-,-1,-1
OUSELEY.txt,174584,177559,2975,20,Y,N,-,-1,-1
OUSELEY.txt,175238,178383,3145,20,Y,N,-,-1,-1
OUSELEY.txt,176110,178842,2732,20,Y,N,-,-1,-1
OUSELEY.txt,176675,179910,3235,20,Y,N,-,-1,-1
OUSELEY.txt,177562,180937,3375,20,Y,N,-,-1,-1
OUSELEY.txt,178384,181871,3487,20,Y,N,-,-1,-1
OUSELEY.txt,178844,182848,4004,20,Y,N,-,-1,-1
OUSELEY.txt,179912,183417,3505,20,Y,N,-,-1,-1
OUSELEY.txt,180939,183880,2941,20,Y,N,-,-1,-1
OUSELEY.txt,181874,184728,2854,20,Y,N,-,-1,-1
OUSELEY.txt,182850,185674,2824,20,Y,N,-,-1,-1
OUSELEY.txt,183418,187029,3611,20,Y,N,-,-1,-1
OUSELEY.txt,183883,187815,3932,20,Y,N,-,-1,-1
OUSELEY.txt,184729,188607,3878,20,Y,N,-,-1,-1
OUSELEY.txt,185675,188698,3023,20,Y,N,-,-1,-1
OUSELEY.txt,187030,188776,1746,20,N,N,-,-1,-1
OUSELEY.txt,187816,189542,1726,20,Y,N,-,-1,-1
OUSELEY.txt,188610,190159,1549,20,Y,N,-,-1,-1
OUSELEY.txt,188699,191263,2564,20,Y,N,-,-1,-1
OUSELEY.txt,188781,192742,3961,20,Y,N,-,-1,-1
OUSELEY.txt,189543,193753,4210,20,Y,N,-,-1,-1
OUSELEY.txt,190162,194610,4448,20,N,N,-,-1,-1
OUSELEY.txt,191266,195908,4642,20,N,N,-,-1,-1
OUSELEY.txt,192745,196878,4133,20,N,N,-,-1,-1
OUSELEY.txt,193753,197316,3563,20,N,N,-,-1,-1
OUSELEY.txt,194611,198079,3468,20,N,N,-,-1,-1
OUSELEY.txt,195911,198495,2584,20,N,N,-,-1,-1
OUSELEY.txt,196879,199165,2286,20,N,N,-,-1,-1
OUSELEY.txt,197319,199377,2058,20,N,N,-,-1,-1
OUSELEY.txt,198080,199790,1710,20,N,N,-,-1,-1
OUSELEY.txt,198498,200185,1687,20,N,N,-,-1,-1
OUSELEY.txt,199168,201607,2439,20,N,N,-,-1,-1
OUSELEY.txt,199380,202581,3201,20,N,N,-,-1,-1
OUSELEY.txt,199793,204639,4846,20,N,N,-,-1,-1
OUSELEY.txt,200186,206046,5860,20,Y,N,-,-1,-1
OUSELEY.txt,201608,206723,5115,20,Y,N,-,-1,-1
OUSELEY.txt,202582,206925,4343,20,Y,N,-,-1,-1
OUSELEY.txt,204640,207400,2760,20,Y,N,-,-1,-1
OUSELEY.txt,206048,207978,1930,20,Y,N,-,-1,-1
OUSELEY.txt,206728,208830,2102,20,N,N,-,-1,-1
OUSELEY.txt,206926,209436,2510,20,Y,N,-,-1,-1
OUSELEY.txt,207401,210227,2826,20,Y,N,-,-1,-1
OUSELEY.txt,207979,211091,3112,20,Y,N,-,-1,-1
OUSELEY.txt,208831,211888,3057,20,Y,N,-,-1,-1
OUSELEY.txt,209437,212486,3049,20,Y,N,-,-1,-1
OUSELEY.txt,210228,213120,2892,20,Y,N,-,-1,-1
OUSELEY.txt,211092,213619,2527,20,Y,N,-,-1,-1
OUSELEY.txt,211889,215034,3145,20,Y,N,-,-1,-1
OUSELEY.txt,212487,215993,3506,20,Y,N,-,-1,-1
OUSELEY.txt,213121,216688,3567,20,Y,N,-,-1,-1
OUSELEY.txt,213622,217847,4225,20,Y,N,-,-1,-1
OUSELEY.txt,215035,218741,3706,20,Y,N,-,-1,-1
OUSELEY.txt,215995,219991,3996,20,Y,N,-,-1,-1
OUSELEY.txt,216689,220669,3980,20,Y,N,-,-1,-1
OUSELEY.txt,217848,221550,3702,20,N,N,-,-1,-1
OUSELEY.txt,218742,222632,3890,20,N,N,-,-1,-1
OUSELEY.txt,219992,224328,4336,20,Y,N,-,-1,-1
OUSELEY.txt,220670,225768,5098,20,Y,N,-,-1,-1
OUSELEY.txt,221551,227435,5884,20,Y,N,-,-1,-1
OUSELEY.txt,222634,228460,5826,20,Y,N,-,-1,-1
OUSELEY.txt,224329,229418,5089,20,Y,N,-,-1,-1
OUSELEY.txt,225769,230308,4539,20,Y,N,-,-1,-1
OUSELEY.txt,227436,231094,3658,20,Y,N,-,-1,-1
OUSELEY.txt,228461,232064,3603,20,Y,N,-,-1,-1
OUSELEY.txt,229419,233064,3645,20,Y,N,-,-1,-1
OUSELEY.txt,230309,233938,3629,20,Y,N,-,-1,-1
OUSELEY.txt,231096,235049,3953,20,Y,N,-,-1,-1
OUSELEY.txt,232065,236606,4541,20,Y,N,-,-1,-1
OUSELEY.txt,233066,237747,4681,20,Y,N,-,-1,-1
OUSELEY.txt,233940,239140,5200,20,Y,N,-,-1,-1
OUSELEY.txt,235050,240049,4999,20,Y,N,-,-1,-1
OUSELEY.txt,236608,241587,4979,20,Y,N,-,-1,-1
OUSELEY.txt,237748,242437,4689,20,Y,N,-,-1,-1
OUSELEY.txt,239141,243379,4238,20,Y,N,-,-1,-1
OUSELEY.txt,240051,244751,4700,20,Y,N,-,-1,-1
OUSELEY.txt,241588,246112,4524,20,Y,N,-,-1,-1
OUSELEY.txt,242438,246991,4553,20,Y,N,-,-1,-1
OUSELEY.txt,243380,248069,4689,20,Y,N,-,-1,-1
OUSELEY.txt,244752,248994,4242,20,Y,N,-,-1,-1
OUSELEY.txt,246115,249824,3709,20,Y,N,-,-1,-1
OUSELEY.txt,246992,250965,3973,20,Y,N,-,-1,-1
OUSELEY.txt,248070,252161,4091,20,Y,N,-,-1,-1
OUSELEY.txt,248995,253386,4391,20,Y,N,-,-1,-1
OUSELEY.txt,249825,253663,3838,20,Y,N,-,-1,-1
OUSELEY.txt,250966,254286,3320,20,Y,N,-,-1,-1
OUSELEY.txt,252162,254712,2550,20,Y,N,-,-1,-1
OUSELEY.txt,253387,255202,1815,20,Y,N,-,-1,-1
OUSELEY.txt,253666,256121,2455,20,Y,N,-,-1,-1
OUSELEY.txt,254287,257258,2971,20,Y,N,-,-1,-1
OUSELEY.txt,254713,258429,3716,20,Y,N,-,-1,-1
OUSELEY.txt,255203,258998,3795,20,Y,N,-,-1,-1
OUSELEY.txt,256122,259785,3663,20,Y,N,-,-1,-1
OUSELEY.txt,257260,260581,3321,20,Y,N,-,-1,-1
OUSELEY.txt,258434,261936,3502,20,Y,N,-,-1,-1
OUSELEY.txt,258999,262598,3599,20,Y,N,-,-1,-1
OUSELEY.txt,259786,263289,3503,20,Y,N,-,-1,-1
OUSELEY.txt,260586,264096,3510,20,Y,N,-,-1,-1
OUSELEY.txt,261941,264623,2682,20,Y,N,-,-1,-1
OUSELEY.txt,262600,265883,3283,20,Y,N,-,-1,-1
OUSELEY.txt,263290,266240,2950,20,Y,N,-,-1,-1
OUSELEY.txt,264097,267039,2942,20,Y,N,-,-1,-1
OUSELEY.txt,264628,267618,2990,20,Y,N,-,-1,-1
OUSELEY.txt,265886,268829,2943,20,Y,N,-,-1,-1
OUSELEY.txt,266241,269357,3116,20,Y,N,-,-1,-1
OUSELEY.txt,267040,269943,2903,20,Y,N,-,-1,-1
OUSELEY.txt,267619,270678,3059,20,Y,N,-,-1,-1
OUSELEY.txt,268830,271427,2597,20,Y,N,-,-1,-1
OUSELEY.txt,269358,272055,2697,20,Y,N,-,-1,-1
OUSELEY.txt,269944,272550,2606,20,Y,N,-,-1,-1
OUSELEY.txt,270679,273300,2621,20,Y,N,-,-1,-1
OUSELEY.txt,271428,274037,2609,20,N,N,-,-1,-1
OUSELEY.txt,272056,274840,2784,20,N,N,-,-1,-1
OUSELEY.txt,272551,275493,2942,20,Y,N,-,-1,-1
OUSELEY.txt,273301,276194,2893,20,Y,N,-,-1,-1
OUSELEY.txt,274038,276809,2771,20,Y,N,-,-1,-1
OUSELEY.txt,274842,277418,2576,20,Y,N,-,-1,-1
OUSELEY.txt,275496,278045,2549,20,Y,N,-,-1,-1
OUSELEY.txt,276194,278746,2552,20,Y,N,-,-1,-1
OUSELEY.txt,276810,279789,2979,20,Y,N,-,-1,-1
OUSELEY.txt,277419,280408,2989,20,Y,N,-,-1,-1
OUSELEY.txt,278046,281122,3076,20,Y,N,-,-1,-1
OUSELEY.txt,278747,281819,3072,20,Y,N,-,-1,-1
OUSELEY.txt,279794,282851,3057,20,Y,N,-,-1,-1
OUSELEY.txt,280409,283834,3425,20,Y,N,-,-1,-1
OUSELEY.txt,281123,284563,3440,20,Y,N,-,-1,-1
OUSELEY.txt,281820,284797,2977,20,Y,N,-,-1,-1
OUSELEY.txt,282852,284983,2131,20,N,N,-,-1,-1
OUSELEY.txt,283835,285086,1251,20,N,N,-,-1,-1
OUSELEY.txt,284566,285207,641,20,Y,N,-,-1,-1
OUSELEY.txt,284799,285646,847,20,Y,N,-,-1,-1
OUSELEY.txt,284985,286145,1160,20,Y,N,-,-1,-1
OUSELEY.txt,285088,286387,1299,20,Y,N,-,-1,-1
OUSELEY.txt,285208,286585,1377,20,N,N,-,-1,-1
OUSELEY.txt,285651,286769,1118,20,N,N,-,-1,-1
OUSELEY.txt,286147,286999,852,20,N,N,-,-1,-1
OUSELEY.txt,286388,287132,744,20,N,N,-,-1,-1
OUSELEY.txt,286587,287281,694,20,N,N,-,-1,-1
OUSELEY.txt,286772,287518,746,20,N,N,-,-1,-1
OUSELEY.txt,287001,287667,666,20,N,N,-,-1,-1
OUSELEY.txt,287135,287845,710,20,N,N,-,-1,-1
OUSELEY.txt,287282,288000,718,20,N,N,-,-1,-1
OUSELEY.txt,287520,288159,639,20,N,N,-,-1,-1
OUSELEY.txt,287669,288279,610,20,N,N,-,-1,-1
OUSELEY.txt,287848,288416,568,20,N,N,-,-1,-1
OUSELEY.txt,288003,288586,583,20,N,N,-,-1,-1
OUSELEY.txt,288160,289786,1626,20,Y,N,-,-1,-1
OUSELEY.txt,288280,290784,2504,20,Y,N,-,-1,-1
OUSELEY.txt,288417,291602,3185,20,Y,N,-,-1,-1
OUSELEY.txt,288589,292024,3435,20,Y,N,-,-1,-1
OUSELEY.txt,289786,292582,2796,20,Y,N,-,-1,-1
OUSELEY.txt,290784,293233,2449,20,Y,N,-,-1,-1
OUSELEY.txt,291603,293288,1685,20,Y,N,-,-1,-1
OUSELEY.txt,292027,293422,1395,20,Y,N,-,-1,-1
OUSELEY.txt,292585,293487,902,20,Y,N,-,-1,-1
OUSELEY.txt,293236,293591,355,20,Y,N,-,-1,-1
OUSELEY.txt,293289,293654,365,20,Y,N,-,-1,-1
OUSELEY.txt,293423,293718,295,20,Y,N,-,-1,-1
OUSELEY.txt,293488,294276,788,20,Y,N,-,-1,-1
OUSELEY.txt,293594,295102,1508,20,Y,N,-,-1,-1
OUSELEY.txt,293657,295186,1529,20,Y,N,-,-1,-1
OUSELEY.txt,293719,295256,1537,20,N,N,-,-1,-1
OUSELEY.txt,294277,295369,1092,20,N,N,-,-1,-1
OUSELEY.txt,295103,295457,354,20,Y,N,-,-1,-1
OUSELEY.txt,295187,295622,435,20,Y,N,-,-1,-1
OUSELEY.txt,295257,295722,465,20,Y,N,-,-1,-1
OUSELEY.txt,295371,295904,533,20,Y,N,-,-1,-1
OUSELEY.txt,295459,296050,591,20,Y,N,-,-1,-1
OUSELEY.txt,295623,296098,475,20,Y,N,-,-1,-1
OUSELEY.txt,295723,296230,507,20,Y,N,-,-1,-1
OUSELEY.txt,295905,296329,424,20,Y,N,-,-1,-1
OUSELEY.txt,296051,296429,378,20,Y,N,-,-1,-1
OUSELEY.txt,296101,296501,400,20,Y,N,-,-1,-1
OUSELEY.txt,296231,296719,488,20,Y,N,-,-1,-1
OUSELEY.txt,296330,296792,462,20,Y,N,-,-1,-1
OUSELEY.txt,296430,297365,935,20,Y,N,-,-1,-1
OUSELEY.txt,296506,297939,1433,20,Y,N,-,-1,-1
OUSELEY.txt,296720,298061,1341,20,Y,N,-,-1,-1
OUSELEY.txt,296793,298446,1653,20,Y,N,-,-1,-1
OUSELEY.txt,297366,299235,1869,20,Y,N,-,-1,-1
OUSELEY.txt,297941,299979,2038,20,Y,N,-,-1,-1
OUSELEY.txt,298062,300118,2056,20,Y,N,-,-1,-1
OUSELEY.txt,298449,300593,2144,20,Y,N,-,-1,-1
OUSELEY.txt,299236,301743,2507,20,Y,N,-,-1,-1
OUSELEY.txt,299980,302282,2302,20,Y,N,-,-1,-1
OUSELEY.txt,300119,303035,2916,20,N,N,-,-1,-1
OUSELEY.txt,300594,303542,2948,20,N,N,-,-1,-1
OUSELEY.txt,301745,303975,2230,20,Y,N,-,-1,-1
OUSELEY.txt,302284,304394,2110,20,Y,N,-,-1,-1
OUSELEY.txt,303036,304750,1714,20,N,N,-,-1,-1
OUSELEY.txt,303548,305204,1656,20,Y,N,-,-1,-1
OUSELEY.txt,303976,305820,1844,20,N,N,-,-1,-1
OUSELEY.txt,304396,306599,2203,20,N,N,-,-1,-1
OUSELEY.txt,304753,307416,2663,20,Y,N,-,-1,-1
OUSELEY.txt,305205,307759,2554,20,N,N,-,-1,-1
OUSELEY.txt,305821,308063,2242,20,Y,N,-,-1,-1
OUSELEY.txt,306600,308684,2084,20,Y,N,-,-1,-1
OUSELEY.txt,307421,309723,2302,20,Y,N,-,-1,-1
OUSELEY.txt,307765,310097,2332,20,Y,N,-,-1,-1
OUSELEY.txt,308066,311496,3430,20,Y,N,-,-1,-1
OUSELEY.txt,308685,311789,3104,20,Y,N,-,-1,-1
OUSELEY.txt,309724,312068,2344,20,Y,N,-,-1,-1
OUSELEY.txt,310100,312360,2260,20,N,N,-,-1,-1
OUSELEY.txt,311502,312665,1163,20,N,N,-,-1,-1
OUSELEY.txt,311790,312943,1153,20,N,N,-,-1,-1
PILGRIM.txt,0,1873,1873,20,Y,N,-,-1,-1
PILGRIM.txt,86,2170,2084,20,Y,N,-,-1,-1
PILGRIM.txt,901,2348,1447,20,Y,N,-,-1,-1
PILGRIM.txt,1369,3316,1947,20,Y,N,-,-1,-1
PILGRIM.txt,1874,3998,2124,20,Y,N,-,-1,-1
PILGRIM.txt,2172,5011,2839,20,Y,N,-,-1,-1
PILGRIM.txt,2348,5712,3364,20,Y,N,-,-1,-1
PILGRIM.txt,3317,6350,3033,20,Y,N,-,-1,-1
PILGRIM.txt,3999,7179,3180,20,Y,N,-,-1,-1
PILGRIM.txt,5012,8024,3012,20,Y,N,-,-1,-1
PILGRIM.txt,5713,8981,3268,20,Y,N,-,-1,-1
PILGRIM.txt,6353,9807,3454,20,Y,N,-,-1,-1
PILGRIM.txt,7180,10734,3554,20,Y,N,-,-1,-1
PILGRIM.txt,8025,11714,3689,20,Y,N,-,-1,-1
PILGRIM.txt,8982,12925,3943,20,Y,N,-,-1,-1
PILGRIM.txt,9810,14295,4485,20,Y,N,-,-1,-1
PILGRIM.txt,10737,15542,4805,20,Y,N,-,-1,-1
PILGRIM.txt,11717,16741,5024,20,Y,N,-,-1,-1
PILGRIM.txt,12928,18630,5702,20,Y,N,-,-1,-1
PILGRIM.txt,14298,19274,4976,20,Y,N,-,-1,-1
PILGRIM.txt,15545,20292,4747,20,N,N,-,-1,-1
PILGRIM.txt,16744,21481,4737,20,Y,N,-,-1,-1
PILGRIM.txt,18633,22074,3441,20,Y,N,-,-1,-1
PILGRIM.txt,19275,22764,3489,20,Y,N,-,-1,-1
PILGRIM.txt,20295,23276,2981,20,Y,N,-,-1,-1
PILGRIM.txt,21482,23903,2421,20,Y,N,-,-1,-1
PILGRIM.txt,22075,24751,2676,20,N,N,-,-1,-1
PILGRIM.txt,22765,25471,2706,20,N,N,-,-1,-1
PILGRIM.txt,23279,26233,2954,20,Y,N,-,-1,-1
PILGRIM.txt,23904,26968,3064,20,Y,N,-,-1,-1
PILGRIM.txt,24752,28187,3435,20,Y,N,-,-1,-1
PILGRIM.txt,25473,29116,3643,20,Y,N,-,-1,-1
PILGRIM.txt,26234,29828,3594,20,Y,N,-,-1,-1
PILGRIM.txt,26971,30500,3529,20,Y,N,-,-1,-1
PILGRIM.txt,28190,31161,2971,20,Y,N,-,-1,-1
PILGRIM.txt,29117,31684,2567,20,N,N,-,-1,-1
PILGRIM.txt,29829,32271,2442,20,N,N,-,-1,-1
PILGRIM.txt,30502,33067,2565,20,N,N,-,-1,-1
PILGRIM.txt,31162,33952,2790,20,N,N,-,-1,-1
PILGRIM.txt,31685,34737,3052,20,Y,N,-,-1,-1
PILGRIM.txt,32272,35681,3409,20,Y,N,-,-1,-1
PILGRIM.txt,33068,36148,3080,20,Y,N,-,-1,-1
PILGRIM.txt,33954,36689,2735,20,Y,N,-,-1,-1
PILGRIM.txt,34739,37462,2723,20,Y,N,-,-1,-1
PILGRIM.txt,35683,37937,2254,20,Y,N,-,-1,-1
PILGRIM.txt,36151,38456,2305,20,Y,N,-,-1,-1
PILGRIM.txt,36690,39056,2366,20,Y,N,-,-1,-1
PILGRIM.txt,37463,39837,2374,20,Y,N,-,-1,-1
PILGRIM.txt,37940,40501,2561,20,Y,N,-,-1,-1
PILGRIM.txt,38459,41311,2852,20,Y,N,-,-1,-1
PILGRIM.txt,39057,41956,2899,20,Y,N,-,-1,-1
PILGRIM.txt,39839,42530,2691,20,Y,N,-,-1,-1
PILGRIM.txt,40502,42966,2464,20,Y,N,-,-1,-1
PILGRIM.txt,41312,43685,2373,20,Y,N,-,-1,-1
PILGRIM.txt,41957,44278,2321,20,Y,N,-,-1,-1
PILGRIM.txt,42531,44903,2372,20,Y,N,-,-1,-1
PILGRIM.txt,42967,45811,2844,20,Y,N,-,-1,-1
PILGRIM.txt,43686,46317,2631,20,Y,N,-,-1,-1
PILGRIM.txt,44279,46908,2629,20,Y,N,-,-1,-1
PILGRIM.txt,44908,47588,2680,20,Y,N,-,-1,-1
PILGRIM.txt,45812,48633,2821,20,Y,N,-,-1,-1
PILGRIM.txt,46318,49016,2698,20,Y,N,-,-1,-1
PILGRIM.txt,46909,49449,2540,20,Y,N,-,-1,-1
PILGRIM.txt,47589,49980,2391,20,Y,N,-,-1,-1
PILGRIM.txt,48635,50805,2170,20,Y,Y,1430808947621,50425,50979
PILGRIM.txt,49021,51605,2584,20,Y,Y,1430808947621,50425,50979
PILGRIM.txt,49450,52022,2572,20,Y,Y,1430808947621,50425,50979
PILGRIM.txt,49983,52606,2623,20,Y,Y,1430808947621,50425,50979
PILGRIM.txt,50806,53225,2419,20,Y,Y,1430808947621,50425,50979
PILGRIM.txt,51606,53858,2252,20,Y,N,-,-1,-1
PILGRIM.txt,52025,54478,2453,20,Y,N,-,-1,-1
PILGRIM.txt,52607,55042,2435,20,Y,N,-,-1,-1
PILGRIM.txt,53226,55873,2647,20,Y,N,-,-1,-1
PILGRIM.txt,53859,56749,2890,20,Y,N,-,-1,-1
PILGRIM.txt,54479,57583,3104,20,Y,N,-,-1,-1
PILGRIM.txt,55043,58112,3069,20,Y,N,-,-1,-1
PILGRIM.txt,55875,58947,3072,20,N,N,-,-1,-1
PILGRIM.txt,56751,59507,2756,20,N,N,-,-1,-1
PILGRIM.txt,57584,60062,2478,20,N,N,-,-1,-1
PILGRIM.txt,58113,60579,2466,20,Y,N,-,-1,-1
PILGRIM.txt,58948,61328,2380,20,Y,N,-,-1,-1
PILGRIM.txt,59508,61786,2278,20,Y,N,-,-1,-1
PILGRIM.txt,60063,62329,2266,20,Y,N,-,-1,-1
PILGRIM.txt,60580,63228,2648,20,N,N,-,-1,-1
PILGRIM.txt,61331,64265,2934,20,Y,N,-,-1,-1
PILGRIM.txt,61787,64930,3143,20,Y,N,-,-1,-1
PILGRIM.txt,62332,65494,3162,20,Y,N,-,-1,-1
PILGRIM.txt,63231,66105,2874,20,Y,N,-,-1,-1
PILGRIM.txt,64268,66599,2331,20,Y,N,-,-1,-1
PILGRIM.txt,64931,67292,2361,20,Y,N,-,-1,-1
PILGRIM.txt,65499,67901,2402,20,N,N,-,-1,-1
PILGRIM.txt,66106,68288,2182,20,N,N,-,-1,-1
PILGRIM.txt,66600,68936,2336,20,N,N,-,-1,-1
PILGRIM.txt,67295,69603,2308,20,N,N,-,-1,-1
PILGRIM.txt,67902,70153,2251,20,N,N,-,-1,-1
PILGRIM.txt,68289,70788,2499,20,Y,N,-,-1,-1
PILGRIM.txt,68938,71294,2356,20,Y,N,-,-1,-1
PILGRIM.txt,69604,72259,2655,20,Y,N,-,-1,-1
PILGRIM.txt,70154,72810,2656,20,Y,N,-,-1,-1
PILGRIM.txt,70791,73444,2653,20,Y,N,-,-1,-1
PILGRIM.txt,71295,73965,2670,20,Y,N,-,-1,-1
PILGRIM.txt,72260,74533,2273,20,Y,N,-,-1,-1
PILGRIM.txt,72812,75067,2255,20,Y,N,-,-1,-1
PILGRIM.txt,73445,75624,2179,20,Y,N,-,-1,-1
PILGRIM.txt,73971,76317,2346,20,Y,N,-,-1,-1
PILGRIM.txt,74536,77254,2718,20,Y,Y,1432737524261,76323,77903
PILGRIM.txt,75068,77904,2836,20,Y,Y,1432737524261,76323,77903
PILGRIM.txt,75625,78599,2974,20,Y,Y,1432737524261,76323,77903
PILGRIM.txt,76320,79284,2964,20,Y,Y,1432737524261,76323,77903
PILGRIM.txt,77257,80069,2812,20,Y,Y,1432737524261,76323,77903
PILGRIM.txt,77905,80536,2631,20,Y,N,-,-1,-1
PILGRIM.txt,78600,81116,2516,20,Y,N,-,-1,-1
PILGRIM.txt,79285,82083,2798,20,Y,N,-,-1,-1
PILGRIM.txt,80072,82730,2658,20,Y,N,-,-1,-1
PILGRIM.txt,80539,83563,3024,20,N,N,-,-1,-1
PILGRIM.txt,81117,84372,3255,20,N,N,-,-1,-1
PILGRIM.txt,82084,85002,2918,20,Y,N,-,-1,-1
PILGRIM.txt,82731,85683,2952,20,Y,N,-,-1,-1
PILGRIM.txt,83568,86567,2999,20,Y,N,-,-1,-1
PILGRIM.txt,84375,87401,3026,20,Y,N,-,-1,-1
PILGRIM.txt,85004,87989,2985,20,Y,N,-,-1,-1
PILGRIM.txt,85684,88712,3028,20,Y,N,-,-1,-1
PILGRIM.txt,86568,89407,2839,20,Y,N,-,-1,-1
PILGRIM.txt,87402,89856,2454,20,Y,N,-,-1,-1
PILGRIM.txt,87990,90254,2264,20,Y,N,-,-1,-1
PILGRIM.txt,88713,90994,2281,20,Y,N,-,-1,-1
PILGRIM.txt,89408,91796,2388,20,Y,N,-,-1,-1
PILGRIM.txt,89857,92515,2658,20,Y,N,-,-1,-1
PILGRIM.txt,90255,93451,3196,20,Y,N,-,-1,-1
PILGRIM.txt,90995,94131,3136,20,Y,N,-,-1,-1
PILGRIM.txt,91797,94832,3035,20,Y,N,-,-1,-1
PILGRIM.txt,92518,95617,3099,20,Y,N,-,-1,-1
PILGRIM.txt,93452,96232,2780,20,Y,N,-,-1,-1
PILGRIM.txt,94136,96957,2821,20,Y,N,-,-1,-1
PILGRIM.txt,94833,97541,2708,20,Y,N,-,-1,-1
PILGRIM.txt,95618,98658,3040,20,Y,N,-,-1,-1
PILGRIM.txt,96233,99319,3086,20,Y,N,-,-1,-1
PILGRIM.txt,96958,100191,3233,20,Y,N,-,-1,-1
PILGRIM.txt,97543,100625,3082,20,Y,N,-,-1,-1
PILGRIM.txt,98659,101292,2633,20,Y,N,-,-1,-1
PILGRIM.txt,99320,102085,2765,20,Y,N,-,-1,-1
PILGRIM.txt,100192,102613,2421,20,Y,N,-,-1,-1
PILGRIM.txt,100626,103100,2474,20,N,N,-,-1,-1
PILGRIM.txt,101293,103783,2490,20,N,N,-,-1,-1
PILGRIM.txt,102086,104318,2232,20,Y,N,-,-1,-1
PILGRIM.txt,102614,105015,2401,20,Y,N,-,-1,-1
PILGRIM.txt,103101,105626,2525,20,Y,N,-,-1,-1
PILGRIM.txt,103784,106270,2486,20,Y,N,-,-1,-1
PILGRIM.txt,104321,106758,2437,20,Y,N,-,-1,-1
PILGRIM.txt,105016,107329,2313,20,Y,N,-,-1,-1
PILGRIM.txt,105627,107936,2309,20,Y,N,-,-1,-1
PILGRIM.txt,106271,108698,2427,20,Y,N,-,-1,-1
PILGRIM.txt,106759,109274,2515,20,Y,N,-,-1,-1
PILGRIM.txt,107330,109936,2606,20,Y,N,-,-1,-1
PILGRIM.txt,107937,110504,2567,20,Y,N,-,-1,-1
PILGRIM.txt,108699,111390,2691,20,Y,N,-,-1,-1
PILGRIM.txt,109275,111824,2549,20,N,N,-,-1,-1
PILGRIM.txt,109939,112746,2807,20,N,N,-,-1,-1
PILGRIM.txt,110505,113255,2750,20,Y,N,-,-1,-1
PILGRIM.txt,111391,114105,2714,20,Y,N,-,-1,-1
PILGRIM.txt,111825,114898,3073,20,Y,N,-,-1,-1
PILGRIM.txt,112749,115339,2590,20,Y,N,-,-1,-1
PILGRIM.txt,113256,116026,2770,20,Y,N,-,-1,-1
PILGRIM.txt,114106,116757,2651,20,Y,N,-,-1,-1
PILGRIM.txt,114901,117230,2329,20,Y,N,-,-1,-1
PILGRIM.txt,115340,118183,2843,20,Y,N,-,-1,-1
PILGRIM.txt,116027,119184,3157,20,Y,N,-,-1,-1
PILGRIM.txt,116758,119846,3088,20,Y,N,-,-1,-1
PILGRIM.txt,117231,120452,3221,20,Y,N,-,-1,-1
PILGRIM.txt,118184,121225,3041,20,Y,N,-,-1,-1
PILGRIM.txt,119185,121842,2657,20,Y,N,-,-1,-1
PILGRIM.txt,119848,122427,2579,20,Y,N,-,-1,-1
PILGRIM.txt,120457,123048,2591,20,Y,N,-,-1,-1
PILGRIM.txt,121227,123477,2250,20,Y,N,-,-1,-1
PILGRIM.txt,121843,124007,2164,20,Y,N,-,-1,-1
PILGRIM.txt,122428,124839,2411,20,Y,N,-,-1,-1
PILGRIM.txt,123049,125148,2099,20,Y,N,-,-1,-1
PILGRIM.txt,123479,125855,2376,20,Y,N,-,-1,-1
PILGRIM.txt,124010,126315,2305,20,Y,N,-,-1,-1
PILGRIM.txt,124840,126817,1977,20,Y,N,-,-1,-1
PILGRIM.txt,125149,127308,2159,20,Y,N,-,-1,-1
PILGRIM.txt,125856,128323,2467,20,Y,N,-,-1,-1
PILGRIM.txt,126316,128755,2439,20,Y,N,-,-1,-1
PILGRIM.txt,126818,129582,2764,20,Y,N,-,-1,-1
PILGRIM.txt,127309,130212,2903,20,Y,Y,1432747851515,129932,131402
PILGRIM.txt,128324,130726,2402,20,Y,Y,1432747851515,129932,131402
PILGRIM.txt,128756,131368,2612,20,Y,Y,1432747851515,129932,131402
PILGRIM.txt,129583,131766,2183,20,Y,Y,1432747851515,129932,131402
PILGRIM.txt,130213,132205,1992,20,Y,Y,1432747851515,129932,131402
PILGRIM.txt,130727,132621,1894,20,Y,Y,1432747851515,129932,131402
PILGRIM.txt,131369,133083,1714,20,Y,Y,1432747851515,129932,131402
PILGRIM.txt,131767,133797,2030,20,Y,N,-,-1,-1
PILGRIM.txt,132206,134587,2381,20,Y,N,-,-1,-1
PILGRIM.txt,132622,135107,2485,20,Y,Y,1432792603693,134919,135643
PILGRIM.txt,133084,135651,2567,20,Y,Y,1432792603693,134919,135643
PILGRIM.txt,133800,136395,2595,20,Y,Y,1432792603693,134919,135643
PILGRIM.txt,134588,136847,2259,20,Y,Y,1432792603693,134919,135643
PILGRIM.txt,135108,137532,2424,20,Y,Y,1432792603693,134919,135643
PILGRIM.txt,135652,137702,2050,20,Y,N,-,-1,-1
PILGRIM.txt,136396,138488,2092,20,Y,N,-,-1,-1
PILGRIM.txt,136849,139324,2475,20,Y,N,-,-1,-1
PILGRIM.txt,137533,140293,2760,20,Y,N,-,-1,-1
PILGRIM.txt,137704,141239,3535,20,Y,N,-,-1,-1
PILGRIM.txt,138491,141897,3406,20,Y,N,-,-1,-1
PILGRIM.txt,139329,142291,2962,20,Y,N,-,-1,-1
PILGRIM.txt,140296,142851,2555,20,N,N,-,-1,-1
PILGRIM.txt,141244,143228,1984,20,N,N,-,-1,-1
PILGRIM.txt,141898,143698,1800,20,Y,N,-,-1,-1
PILGRIM.txt,142292,144020,1728,20,Y,N,-,-1,-1
PILGRIM.txt,142852,145131,2279,20,Y,N,-,-1,-1
PILGRIM.txt,143229,145863,2634,20,Y,N,-,-1,-1
PILGRIM.txt,143699,146432,2733,20,Y,Y,1432795431094,146203,147710
PILGRIM.txt,144025,147272,3247,20,Y,Y,1432795431094,146203,147710
PILGRIM.txt,145132,148030,2898,20,Y,Y,1432795431094,146203,147710
PILGRIM.txt,145866,148805,2939,20,Y,Y,1432795431094,146203,147710
PILGRIM.txt,146433,149517,3084,20,Y,Y,1432795431094,146203,147710
PILGRIM.txt,147273,150282,3009,20,Y,Y,1432795431094,146203,147710
PILGRIM.txt,148031,150978,2947,20,Y,N,-,-1,-1
PILGRIM.txt,148806,151594,2788,20,Y,N,-,-1,-1
PILGRIM.txt,149518,152114,2596,20,Y,N,-,-1,-1
PILGRIM.txt,150283,153067,2784,20,Y,N,-,-1,-1
PILGRIM.txt,150979,153931,2952,20,Y,N,-,-1,-1
PILGRIM.txt,151596,154734,3138,20,Y,N,-,-1,-1
PILGRIM.txt,152117,155444,3327,20,Y,N,-,-1,-1
PILGRIM.txt,153068,156143,3075,20,Y,N,-,-1,-1
PILGRIM.txt,153932,156961,3029,20,Y,N,-,-1,-1
PILGRIM.txt,154735,157625,2890,20,Y,N,-,-1,-1
PILGRIM.txt,155445,158114,2669,20,Y,N,-,-1,-1
PILGRIM.txt,156144,158702,2558,20,Y,N,-,-1,-1
PILGRIM.txt,156963,159273,2310,20,Y,N,-,-1,-1
PILGRIM.txt,157626,159845,2219,20,Y,N,-,-1,-1
PILGRIM.txt,158115,160593,2478,20,Y,N,-,-1,-1
PILGRIM.txt,158703,161474,2771,20,Y,N,-,-1,-1
PILGRIM.txt,159274,162036,2762,20,Y,N,-,-1,-1
PILGRIM.txt,159846,162811,2965,20,Y,N,-,-1,-1
PILGRIM.txt,160596,163559,2963,20,Y,N,-,-1,-1
PILGRIM.txt,161475,164490,3015,20,Y,N,-,-1,-1
PILGRIM.txt,162038,165053,3015,20,Y,N,-,-1,-1
PILGRIM.txt,162812,165645,2833,20,Y,N,-,-1,-1
PILGRIM.txt,163560,166429,2869,20,Y,N,-,-1,-1
PILGRIM.txt,164491,167223,2732,20,Y,N,-,-1,-1
PILGRIM.txt,165054,167770,2716,20,Y,N,-,-1,-1
PILGRIM.txt,165647,168466,2819,20,Y,N,-,-1,-1
PILGRIM.txt,166430,168907,2477,20,Y,N,-,-1,-1
PILGRIM.txt,167224,169847,2623,20,Y,N,-,-1,-1
PILGRIM.txt,167771,170623,2852,20,Y,N,-,-1,-1
PILGRIM.txt,168467,171416,2949,20,Y,N,-,-1,-1
PILGRIM.txt,168909,172151,3242,20,Y,N,-,-1,-1
PILGRIM.txt,169848,172891,3043,20,Y,N,-,-1,-1
PILGRIM.txt,170624,174385,3761,20,Y,N,-,-1,-1
PILGRIM.txt,171419,175065,3646,20,Y,N,-,-1,-1
PILGRIM.txt,172152,175711,3559,20,Y,N,-,-1,-1
PILGRIM.txt,172892,176539,3647,20,Y,N,-,-1,-1
PILGRIM.txt,174386,177309,2923,20,Y,N,-,-1,-1
PILGRIM.txt,175066,177989,2923,20,Y,N,-,-1,-1
PILGRIM.txt,175714,178727,3013,20,Y,N,-,-1,-1
PILGRIM.txt,176541,179386,2845,20,Y,N,-,-1,-1
PILGRIM.txt,177310,180124,2814,20,Y,N,-,-1,-1
PILGRIM.txt,177990,180864,2874,20,Y,N,-,-1,-1
PILGRIM.txt,178732,181659,2927,20,Y,N,-,-1,-1
PILGRIM.txt,179388,182405,3017,20,Y,N,-,-1,-1
PILGRIM.txt,180127,182831,2704,20,Y,N,-,-1,-1
PILGRIM.txt,180865,183240,2375,20,Y,N,-,-1,-1
PILGRIM.txt,181660,183809,2149,20,N,N,-,-1,-1
PILGRIM.txt,182408,184507,2099,20,N,N,-,-1,-1
PILGRIM.txt,182832,185326,2494,20,N,N,-,-1,-1
PILGRIM.txt,183241,185775,2534,20,N,N,-,-1,-1
PILGRIM.txt,183812,186306,2494,20,N,N,-,-1,-1
PILGRIM.txt,184508,186832,2324,20,N,N,-,-1,-1
PILGRIM.txt,185329,187146,1817,20,N,N,-,-1,-1
PILGRIM.txt,185776,187507,1731,20,N,N,-,-1,-1
PILGRIM.txt,186307,187638,1331,20,N,N,-,-1,-1
PILGRIM.txt,186833,188301,1468,20,N,N,-,-1,-1
PILGRIM.txt,187148,188645,1497,20,N,N,-,-1,-1
PILGRIM.txt,187512,188967,1455,20,N,N,-,-1,-1
PILGRIM.txt,187638,189413,1775,20,N,N,-,-1,-1
PILGRIM.txt,188302,189867,1565,20,N,N,-,-1,-1
PILGRIM.txt,188650,190203,1553,20,N,N,-,-1,-1
PILGRIM.txt,188968,190883,1915,20,N,N,-,-1,-1
PILGRIM.txt,189414,191443,2029,20,N,N,-,-1,-1
PILGRIM.txt,189868,191828,1960,20,N,N,-,-1,-1
PILGRIM.txt,190204,192297,2093,20,N,N,-,-1,-1
PILGRIM.txt,190884,193057,2173,20,N,N,-,-1,-1
PILGRIM.txt,191444,193666,2222,20,N,N,-,-1,-1
PILGRIM.txt,191829,193984,2155,20,N,N,-,-1,-1
PILGRIM.txt,192298,194668,2370,20,N,N,-,-1,-1
PILGRIM.txt,193060,195296,2236,20,N,N,-,-1,-1
PILGRIM.txt,193669,195851,2182,20,N,N,-,-1,-1
PILGRIM.txt,193985,196602,2617,20,N,N,-,-1,-1
PILGRIM.txt,194669,197138,2469,20,N,N,-,-1,-1
PILGRIM.txt,195297,197935,2638,20,N,N,-,-1,-1
PILGRIM.txt,195852,198586,2734,20,N,N,-,-1,-1
PILGRIM.txt,196603,199259,2656,20,N,N,-,-1,-1
PILGRIM.txt,197139,199801,2662,20,Y,N,-,-1,-1
PILGRIM.txt,197938,200296,2358,20,Y,N,-,-1,-1
PILGRIM.txt,198587,200903,2316,20,Y,N,-,-1,-1
PILGRIM.txt,199260,201674,2414,20,Y,N,-,-1,-1
PILGRIM.txt,199802,202357,2555,20,Y,N,-,-1,-1
PILGRIM.txt,200297,203010,2713,20,Y,N,-,-1,-1
PILGRIM.txt,200904,203456,2552,20,Y,N,-,-1,-1
PILGRIM.txt,201675,203985,2310,20,N,N,-,-1,-1
PILGRIM.txt,202360,204521,2161,20,N,N,-,-1,-1
PILGRIM.txt,203011,204966,1955,20,N,N,-,-1,-1
PILGRIM.txt,203457,205487,2030,20,Y,N,-,-1,-1
PILGRIM.txt,203986,206052,2066,20,Y,N,-,-1,-1
PILGRIM.txt,204522,206298,1776,20,N,N,-,-1,-1
PILGRIM.txt,204967,207237,2270,20,N,N,-,-1,-1
PILGRIM.txt,205488,208082,2594,20,N,N,-,-1,-1
PILGRIM.txt,206053,208853,2800,20,N,N,-,-1,-1
PILGRIM.txt,206301,209487,3186,20,N,N,-,-1,-1
PILGRIM.txt,207238,210465,3227,20,N,N,-,-1,-1
PILGRIM.txt,208085,211013,2928,20,N,N,-,-1,-1
PILGRIM.txt,208854,211569,2715,20,N,N,-,-1,-1
PILGRIM.txt,209488,211964,2476,20,N,N,-,-1,-1
PILGRIM.txt,210466,212780,2314,20,N,N,-,-1,-1
PILGRIM.txt,211014,213326,2312,20,N,N,-,-1,-1
PILGRIM.txt,211570,213836,2266,20,N,N,-,-1,-1
PILGRIM.txt,211967,214367,2400,20,N,N,-,-1,-1
PILGRIM.txt,212783,214952,2169,20,N,N,-,-1,-1
PILGRIM.txt,213327,215451,2124,20,N,N,-,-1,-1
PILGRIM.txt,213837,216034,2197,20,N,N,-,-1,-1
PILGRIM.txt,214368,216540,2172,20,N,N,-,-1,-1
PILGRIM.txt,214953,217250,2297,20,Y,N,-,-1,-1
PILGRIM.txt,215452,217901,2449,20,Y,N,-,-1,-1
PILGRIM.txt,216035,218217,2182,20,Y,N,-,-1,-1
PILGRIM.txt,216541,218394,1853,20,Y,N,-,-1,-1
PILGRIM.txt,217253,218667,1414,20,Y,N,-,-1,-1
PILGRIM.txt,217902,219418,1516,20,Y,N,-,-1,-1
PILGRIM.txt,218218,219833,1615,20,Y,N,-,-1,-1
PILGRIM.txt,218395,220202,1807,20,Y,N,-,-1,-1
PILGRIM.txt,218668,220631,1963,20,N,N,-,-1,-1
PILGRIM.txt,219419,221243,1824,20,N,N,-,-1,-1
PILGRIM.txt,219834,221661,1827,20,N,N,-,-1,-1
PILGRIM.txt,220203,222139,1936,20,N,N,-,-1,-1
PILGRIM.txt,220632,223087,2455,20,N,N,-,-1,-1
PILGRIM.txt,221245,223599,2354,20,Y,N,-,-1,-1
PILGRIM.txt,221662,224468,2806,20,Y,N,-,-1,-1
PILGRIM.txt,222140,225099,2959,20,Y,N,-,-1,-1
PILGRIM.txt,223088,225710,2622,20,Y,N,-,-1,-1
PILGRIM.txt,223600,226478,2878,20,Y,N,-,-1,-1
PILGRIM.txt,224471,226915,2444,20,Y,N,-,-1,-1
PILGRIM.txt,225100,227429,2329,20,Y,N,-,-1,-1
PILGRIM.txt,225711,227830,2119,20,N,N,-,-1,-1
PILGRIM.txt,226479,228260,1781,20,N,N,-,-1,-1
PILGRIM.txt,226916,229079,2163,20,Y,Y,1432812913267,228270,230251
PILGRIM.txt,227430,229887,2457,20,Y,Y,1432812913267,228270,230251
PILGRIM.txt,227831,230557,2726,20,Y,Y,1432812913267,228270,230251
PILGRIM.txt,228263,231104,2841,20,Y,Y,1432812913267,228270,230251
PILGRIM.txt,229080,232739,3659,20,Y,Y,1432812913267,228270,230251
PILGRIM.txt,229888,233811,3923,20,Y,Y,1432812913267,228270,230251
PILGRIM.txt,230558,234712,4154,20,Y,N,-,-1,-1
PILGRIM.txt,231107,235135,4028,20,Y,N,-,-1,-1
PILGRIM.txt,232742,235742,3000,20,Y,N,-,-1,-1
PILGRIM.txt,233814,236337,2523,20,Y,N,-,-1,-1
PILGRIM.txt,234713,237337,2624,20,Y,Y,1432826715274,237060,238022
PILGRIM.txt,235136,237779,2643,20,Y,Y,1432826715274,237060,238022
PILGRIM.txt,235744,238296,2552,20,Y,Y,1432826715274,237060,238022
PILGRIM.txt,236340,238882,2542,20,Y,Y,1432826715274,237060,238022
PILGRIM.txt,237338,239379,2041,20,Y,Y,1432826715274,237060,238022
PILGRIM.txt,237780,240055,2275,20,Y,Y,1432826715274,237060,238022
PILGRIM.txt,238298,240624,2326,20,Y,N,-,-1,-1
PILGRIM.txt,238885,241249,2364,20,Y,N,-,-1,-1
PILGRIM.txt,239380,241983,2603,20,Y,N,-,-1,-1
PILGRIM.txt,240056,242767,2711,20,Y,N,-,-1,-1
PILGRIM.txt,240629,243400,2771,20,Y,N,-,-1,-1
PILGRIM.txt,241250,244227,2977,20,Y,N,-,-1,-1
PILGRIM.txt,241984,244827,2843,20,Y,N,-,-1,-1
PILGRIM.txt,242768,245353,2585,20,Y,N,-,-1,-1
PILGRIM.txt,243401,246021,2620,20,Y,N,-,-1,-1
PILGRIM.txt,244228,246587,2359,20,Y,N,-,-1,-1
PILGRIM.txt,244828,247198,2370,20,Y,N,-,-1,-1
PILGRIM.txt,245354,247925,2571,20,Y,N,-,-1,-1
PILGRIM.txt,246022,248608,2586,20,Y,N,-,-1,-1
PILGRIM.txt,246588,249206,2618,20,Y,N,-,-1,-1
PILGRIM.txt,247199,249666,2467,20,Y,N,-,-1,-1
PILGRIM.txt,247927,250229,2302,20,Y,N,-,-1,-1
PILGRIM.txt,248609,250919,2310,20,Y,N,-,-1,-1
PILGRIM.txt,249207,251723,2516,20,Y,N,-,-1,-1
PILGRIM.txt,249671,252281,2610,20,Y,N,-,-1,-1
PILGRIM.txt,250232,253052,2820,20,Y,N,-,-1,-1
PILGRIM.txt,250920,253745,2825,20,Y,N,-,-1,-1
PILGRIM.txt,251726,254420,2694,20,Y,N,-,-1,-1
PILGRIM.txt,252282,255039,2757,20,Y,N,-,-1,-1
PILGRIM.txt,253053,256116,3063,20,Y,N,-,-1,-1
PILGRIM.txt,253747,256579,2832,20,Y,N,-,-1,-1
PILGRIM.txt,254421,257186,2765,20,Y,N,-,-1,-1
PILGRIM.txt,255040,258126,3086,20,Y,N,-,-1,-1
PILGRIM.txt,256117,258807,2690,20,Y,N,-,-1,-1
PILGRIM.txt,256580,259526,2946,20,Y,N,-,-1,-1
PILGRIM.txt,257187,260737,3550,20,Y,Y,1432830272373,259940,261638
PILGRIM.txt,258129,261593,3464,20,Y,Y,1432830272373,259940,261638
PILGRIM.txt,258808,262083,3275,20,Y,Y,1432830272373,259940,261638
PILGRIM.txt,259527,262600,3073,20,Y,Y,1432830272373,259940,261638
PILGRIM.txt,260738,262899,2161,20,Y,Y,1432830272373,259940,261638
PILGRIM.txt,261593,263148,1555,20,N,Y,1432830272373,259940,261638
PILGRIM.txt,262084,263673,1589,20,N,N,-,-1,-1
PILGRIM.txt,262601,264137,1536,20,N,N,-,-1,-1
PILGRIM.txt,262904,264592,1688,20,N,N,-,-1,-1
PILGRIM.txt,263149,265279,2130,20,Y,N,-,-1,-1
PILGRIM.txt,263674,265909,2235,20,N,N,-,-1,-1
PILGRIM.txt,264138,266977,2839,20,Y,N,-,-1,-1
PILGRIM.txt,264593,267672,3079,20,Y,N,-,-1,-1
PILGRIM.txt,265280,268269,2989,20,Y,N,-,-1,-1
PILGRIM.txt,265910,269117,3207,20,Y,N,-,-1,-1
PILGRIM.txt,266979,269951,2972,20,Y,N,-,-1,-1
PILGRIM.txt,267673,270489,2816,20,Y,N,-,-1,-1
PILGRIM.txt,268270,271227,2957,20,Y,N,-,-1,-1
PILGRIM.txt,269118,271729,2611,20,Y,N,-,-1,-1
PILGRIM.txt,269954,272455,2501,20,Y,N,-,-1,-1
PILGRIM.txt,270490,272952,2462,20,Y,N,-,-1,-1
PILGRIM.txt,271228,273394,2166,20,Y,N,-,-1,-1
PILGRIM.txt,271730,274240,2510,20,Y,N,-,-1,-1
PILGRIM.txt,272456,274894,2438,20,Y,N,-,-1,-1
PILGRIM.txt,272954,275452,2498,20,Y,N,-,-1,-1
PILGRIM.txt,273395,276266,2871,20,Y,N,-,-1,-1
PILGRIM.txt,274241,277210,2969,20,Y,N,-,-1,-1
PILGRIM.txt,274895,278062,3167,20,Y,N,-,-1,-1
PILGRIM.txt,275453,279195,3742,20,Y,N,-,-1,-1
PILGRIM.txt,276269,280064,3795,20,Y,N,-,-1,-1
PILGRIM.txt,277211,280678,3467,20,Y,N,-,-1,-1
PILGRIM.txt,278063,281281,3218,20,Y,N,-,-1,-1
PILGRIM.txt,279196,281638,2442,20,Y,N,-,-1,-1
PILGRIM.txt,280065,282323,2258,20,Y,N,-,-1,-1
PILGRIM.txt,280680,282867,2187,20,Y,N,-,-1,-1
PILGRIM.txt,281284,283332,2048,20,Y,N,-,-1,-1
PILGRIM.txt,281639,284020,2381,20,Y,N,-,-1,-1
PILGRIM.txt,282324,284474,2150,20,Y,N,-,-1,-1
PILGRIM.txt,282869,285001,2132,20,Y,N,-,-1,-1
PILGRIM.txt,283333,285738,2405,20,Y,N,-,-1,-1
PILGRIM.txt,284021,286431,2410,20,Y,N,-,-1,-1
PILGRIM.txt,284475,287023,2548,20,Y,N,-,-1,-1
PILGRIM.txt,285002,287781,2779,20,Y,N,-,-1,-1
PILGRIM.txt,285739,288729,2990,20,Y,N,-,-1,-1
PILGRIM.txt,286432,289381,2949,20,Y,N,-,-1,-1
PILGRIM.txt,287024,289959,2935,20,Y,N,-,-1,-1
PILGRIM.txt,287782,290700,2918,20,Y,N,-,-1,-1
PILGRIM.txt,288730,291287,2557,20,Y,N,-,-1,-1
PILGRIM.txt,289382,292412,3030,20,Y,N,-,-1,-1
PILGRIM.txt,289960,293116,3156,20,Y,N,-,-1,-1
PILGRIM.txt,290701,293744,3043,20,Y,N,-,-1,-1
PILGRIM.txt,291288,294304,3016,20,Y,N,-,-1,-1
PILGRIM.txt,292417,294691,2274,20,Y,N,-,-1,-1
PILGRIM.txt,293117,295067,1950,20,Y,N,-,-1,-1
PILGRIM.txt,293746,295593,1847,20,Y,N,-,-1,-1
PILGRIM.txt,294305,296154,1849,20,Y,N,-,-1,-1
PILGRIM.txt,294692,296690,1998,20,Y,N,-,-1,-1
PILGRIM.txt,295068,297554,2486,20,Y,N,-,-1,-1
PILGRIM.txt,295594,298239,2645,20,Y,N,-,-1,-1
PILGRIM.txt,296155,298963,2808,20,Y,N,-,-1,-1
PILGRIM.txt,296691,299765,3074,20,Y,N,-,-1,-1
PILGRIM.txt,297556,300505,2949,20,Y,N,-,-1,-1
PILGRIM.txt,298240,301070,2830,20,Y,N,-,-1,-1
PILGRIM.txt,298966,302022,3056,20,Y,N,-,-1,-1
PILGRIM.txt,299766,302812,3046,20,Y,N,-,-1,-1
PILGRIM.txt,300506,303843,3337,20,Y,N,-,-1,-1
PILGRIM.txt,301070,304457,3387,20,Y,N,-,-1,-1
PILGRIM.txt,302023,305115,3092,20,Y,N,-,-1,-1
PILGRIM.txt,302815,305624,2809,20,Y,N,-,-1,-1
PILGRIM.txt,303844,306238,2394,20,Y,N,-,-1,-1
PILGRIM.txt,304458,306644,2186,20,Y,N,-,-1,-1
PILGRIM.txt,305118,307154,2036,20,Y,N,-,-1,-1
PILGRIM.txt,305626,307596,1970,20,Y,N,-,-1,-1
PILGRIM.txt,306239,308148,1909,20,Y,N,-,-1,-1
PILGRIM.txt,306645,308585,1940,20,Y,Y,1432919383904,308149,309945
PILGRIM.txt,307155,309255,2100,20,Y,Y,1432919383904,308149,309945
PILGRIM.txt,307597,309651,2054,20,Y,Y,1432919383904,308149,309945
PILGRIM.txt,308151,310195,2044,20,Y,Y,1432919383904,308149,309945
PILGRIM.txt,308586,310731,2145,20,Y,Y,1432919383904,308149,309945
PILGRIM.txt,309256,311528,2272,20,Y,Y,1432919383904,308149,309945
PILGRIM.txt,309652,312367,2715,20,Y,Y,1432919383904,308149,309945
PILGRIM.txt,310196,313010,2814,20,Y,N,-,-1,-1
PILGRIM.txt,310732,313556,2824,20,Y,N,-,-1,-1
PILGRIM.txt,311529,314326,2797,20,Y,N,-,-1,-1
PILGRIM.txt,312368,315024,2656,20,Y,N,-,-1,-1
PILGRIM.txt,313012,315539,2527,20,Y,N,-,-1,-1
PILGRIM.txt,313557,316224,2667,20,Y,N,-,-1,-1
PILGRIM.txt,314327,316786,2459,20,Y,N,-,-1,-1
PILGRIM.txt,315025,317447,2422,20,Y,N,-,-1,-1
PILGRIM.txt,315540,317729,2189,20,Y,N,-,-1,-1
PILGRIM.txt,316225,318581,2356,20,Y,N,-,-1,-1
PILGRIM.txt,316787,319558,2771,20,N,N,-,-1,-1
PILGRIM.txt,317450,320009,2559,20,Y,N,-,-1,-1
PILGRIM.txt,317732,320606,2874,20,N,N,-,-1,-1
PILGRIM.txt,318583,321169,2586,20,N,N,-,-1,-1
PILGRIM.txt,319559,321507,1948,20,N,N,-,-1,-1
PILGRIM.txt,320012,321989,1977,20,N,N,-,-1,-1
PILGRIM.txt,320607,322842,2235,20,N,N,-,-1,-1
PILGRIM.txt,321170,323485,2315,20,Y,N,-,-1,-1
PILGRIM.txt,321508,324446,2938,20,N,N,-,-1,-1
PILGRIM.txt,321992,325295,3303,20,Y,N,-,-1,-1
PILGRIM.txt,322845,325862,3017,20,Y,N,-,-1,-1
PILGRIM.txt,323486,326667,3181,20,Y,N,-,-1,-1
PILGRIM.txt,324447,327412,2965,20,Y,N,-,-1,-1
PILGRIM.txt,325296,327937,2641,20,Y,Y,1432976483264,327834,329881
PILGRIM.txt,325863,328774,2911,20,Y,Y,1432976483264,327834,329881
PILGRIM.txt,326668,329580,2912,20,Y,Y,1432976483264,327834,329881
PILGRIM.txt,327413,330145,2732,20,Y,Y,1432976483264,327834,329881
PILGRIM.txt,327938,330948,3010,20,Y,Y,1432976483264,327834,329881
PILGRIM.txt,328775,332111,3336,20,Y,Y,1432976483264,327834,329881
PILGRIM.txt,329581,332943,3362,20,Y,Y,1432976483264,327834,329881
PILGRIM.txt,330146,333368,3222,20,Y,N,-,-1,-1
PILGRIM.txt,330951,333827,2876,20,Y,N,-,-1,-1
PILGRIM.txt,332112,334621,2509,20,Y,N,-,-1,-1
PILGRIM.txt,332946,335853,2907,20,Y,N,-,-1,-1
PILGRIM.txt,333371,336841,3470,20,Y,N,-,-1,-1
PILGRIM.txt,333828,337401,3573,20,Y,N,-,-1,-1
PILGRIM.txt,334623,338248,3625,20,Y,N,-,-1,-1
PILGRIM.txt,335856,339403,3547,20,Y,N,-,-1,-1
PILGRIM.txt,336842,340075,3233,20,Y,N,-,-1,-1
PILGRIM.txt,337402,340972,3570,20,Y,N,-,-1,-1
PILGRIM.txt,338251,341673,3422,20,Y,N,-,-1,-1
PILGRIM.txt,339404,342471,3067,20,Y,N,-,-1,-1
PILGRIM.txt,340076,343642,3566,20,Y,N,-,-1,-1
PILGRIM.txt,340973,344524,3551,20,Y,N,-,-1,-1
PILGRIM.txt,341674,345460,3786,20,Y,N,-,-1,-1
PILGRIM.txt,342472,346231,3759,20,Y,N,-,-1,-1
PILGRIM.txt,343647,347041,3394,20,Y,N,-,-1,-1
PILGRIM.txt,344525,347675,3150,20,Y,N,-,-1,-1
PILGRIM.txt,345462,348234,2772,20,Y,N,-,-1,-1
PILGRIM.txt,346232,349033,2801,20,Y,N,-,-1,-1
PILGRIM.txt,347042,349852,2810,20,Y,N,-,-1,-1
PILGRIM.txt,347676,350745,3069,20,Y,N,-,-1,-1
PILGRIM.txt,348236,351370,3134,20,Y,N,-,-1,-1
PILGRIM.txt,349034,352176,3142,20,Y,N,-,-1,-1
PILGRIM.txt,349853,352875,3022,20,Y,N,-,-1,-1
PILGRIM.txt,350746,354054,3308,20,Y,N,-,-1,-1
PILGRIM.txt,351371,354931,3560,20,Y,N,-,-1,-1
PILGRIM.txt,352177,355520,3343,20,Y,N,-,-1,-1
PILGRIM.txt,352876,356348,3472,20,Y,N,-,-1,-1
PILGRIM.txt,354055,357119,3064,20,Y,N,-,-1,-1
PILGRIM.txt,354934,357835,2901,20,Y,N,-,-1,-1
PILGRIM.txt,355523,358418,2895,20,Y,N,-,-1,-1
PILGRIM.txt,356349,358813,2464,20,Y,N,-,-1,-1
PILGRIM.txt,357120,359423,2303,20,Y,N,-,-1,-1
PILGRIM.txt,357836,360236,2400,20,Y,N,-,-1,-1
PILGRIM.txt,358420,361034,2614,20,Y,N,-,-1,-1
PILGRIM.txt,358814,361543,2729,20,Y,N,-,-1,-1
PILGRIM.txt,359424,362105,2681,20,Y,Y,1432978478641,361921,364422
PILGRIM.txt,360237,363072,2835,20,Y,Y,1432978478641,361921,364422
PILGRIM.txt,361035,363784,2749,20,Y,Y,1432978478641,361921,364422
PILGRIM.txt,361545,365105,3560,20,Y,Y,1432978478641,361921,364422
PILGRIM.txt,362106,365682,3576,20,Y,Y,1432978478641,361921,364422
PILGRIM.txt,363074,366519,3445,20,Y,Y,1432978478641,361921,364422
PILGRIM.txt,363785,367025,3240,20,Y,Y,1432978478641,361921,364422
PILGRIM.txt,365106,367699,2593,20,Y,N,-,-1,-1
PILGRIM.txt,365683,368464,2781,20,Y,N,-,-1,-1
PILGRIM.txt,366520,369093,2573,20,Y,N,-,-1,-1
PILGRIM.txt,367028,369863,2835,20,Y,N,-,-1,-1
PILGRIM.txt,367700,370847,3147,20,Y,N,-,-1,-1
PILGRIM.txt,368465,371594,3129,20,Y,N,-,-1,-1
PILGRIM.txt,369094,372456,3362,20,Y,N,-,-1,-1
PILGRIM.txt,369863,373295,3432,20,Y,N,-,-1,-1
PILGRIM.txt,370850,373880,3030,20,Y,N,-,-1,-1
PILGRIM.txt,371595,374526,2931,20,Y,N,-,-1,-1
PILGRIM.txt,372457,375150,2693,20,Y,N,-,-1,-1
PILGRIM.txt,373296,376081,2785,20,Y,N,-,-1,-1
PILGRIM.txt,373881,376603,2722,20,Y,N,-,-1,-1
PILGRIM.txt,374526,376999,2473,20,Y,N,-,-1,-1
PILGRIM.txt,375151,377834,2683,20,Y,N,-,-1,-1
PILGRIM.txt,376083,378568,2485,20,Y,N,-,-1,-1
PILGRIM.txt,376604,379185,2581,20,Y,N,-,-1,-1
PILGRIM.txt,377004,379780,2776,20,Y,N,-,-1,-1
PILGRIM.txt,377835,380485,2650,20,Y,N,-,-1,-1
PILGRIM.txt,378573,381136,2563,20,Y,N,-,-1,-1
PILGRIM.txt,379186,382129,2943,20,Y,N,-,-1,-1
PILGRIM.txt,379781,382899,3118,20,Y,N,-,-1,-1
PILGRIM.txt,380490,383563,3073,20,Y,N,-,-1,-1
PILGRIM.txt,381139,384054,2915,20,Y,N,-,-1,-1
PILGRIM.txt,382132,385308,3176,20,Y,Y,1432979435232,384507,385447
PILGRIM.txt,382902,386224,3322,20,Y,Y,1432979435232,384507,385447
PILGRIM.txt,383566,387389,3823,20,Y,Y,1432979435232,384507,385447
PILGRIM.txt,384055,388019,3964,20,Y,Y,1432979435232,384507,385447
PILGRIM.txt,385309,388391,3082,20,Y,Y,1432979435232,384507,385447
PILGRIM.txt,386225,389091,2866,20,Y,N,-,-1,-1
PILGRIM.txt,387391,389629,2238,20,Y,N,-,-1,-1
PILGRIM.txt,388020,390449,2429,20,Y,N,-,-1,-1
PILGRIM.txt,388392,391255,2863,20,Y,N,-,-1,-1
PILGRIM.txt,389092,392484,3392,20,Y,N,-,-1,-1
PILGRIM.txt,389630,393230,3600,20,Y,N,-,-1,-1
PILGRIM.txt,390450,393573,3123,20,Y,N,-,-1,-1
PILGRIM.txt,391256,394032,2776,20,Y,N,-,-1,-1
PILGRIM.txt,392485,394708,2223,20,Y,N,-,-1,-1
PILGRIM.txt,393231,395161,1930,20,N,N,-,-1,-1
PILGRIM.txt,393574,395837,2263,20,N,N,-,-1,-1
PILGRIM.txt,394037,396600,2563,20,Y,N,-,-1,-1
PILGRIM.txt,394709,397313,2604,20,Y,N,-,-1,-1
PILGRIM.txt,395164,398592,3428,20,Y,N,-,-1,-1
PILGRIM.txt,395838,400219,4381,20,Y,Y,1432980418512,399130,400458
PILGRIM.txt,396601,401092,4491,20,Y,Y,1432980418512,399130,400458
PILGRIM.txt,397314,401912,4598,20,Y,Y,1432980418512,399130,400458
PILGRIM.txt,398595,402572,3977,20,Y,Y,1432980418512,399130,400458
PILGRIM.txt,400220,403087,2867,20,Y,Y,1432980418512,399130,400458
PILGRIM.txt,401094,403482,2388,20,N,N,-,-1,-1
PILGRIM.txt,401913,404190,2277,20,N,N,-,-1,-1
PILGRIM.txt,402573,405146,2573,20,Y,N,-,-1,-1
PILGRIM.txt,403090,405929,2839,20,Y,N,-,-1,-1
PILGRIM.txt,403484,406630,3146,20,Y,N,-,-1,-1
PILGRIM.txt,404191,407455,3264,20,Y,N,-,-1,-1
PILGRIM.txt,405147,407884,2737,20,Y,N,-,-1,-1
PILGRIM.txt,405930,408928,2998,20,Y,N,-,-1,-1
PILGRIM.txt,406632,409373,2741,20,Y,N,-,-1,-1
PILGRIM.txt,407458,410127,2669,20,N,N,-,-1,-1
PILGRIM.txt,407885,410737,2852,20,N,N,-,-1,-1
PILGRIM.txt,408929,411303,2374,20,N,N,-,-1,-1
PILGRIM.txt,409376,412187,2811,20,Y,Y,1432982795628,411959,413612
PILGRIM.txt,410132,412861,2729,20,Y,Y,1432982795628,411959,413612
PILGRIM.txt,410740,413679,2939,20,Y,Y,1432982795628,411959,413612
PILGRIM.txt,411304,414700,3396,20,Y,Y,1432982795628,411959,413612
PILGRIM.txt,412188,415529,3341,20,Y,Y,1432982795628,411959,413612
PILGRIM.txt,412862,416403,3541,20,Y,Y,1432982795628,411959,413612
PILGRIM.txt,413682,417060,3378,20,Y,N,-,-1,-1
PILGRIM.txt,414701,417977,3276,20,Y,N,-,-1,-1
PILGRIM.txt,415530,418935,3405,20,Y,N,-,-1,-1
PILGRIM.txt,416404,419613,3209,20,Y,N,-,-1,-1
PILGRIM.txt,417063,420309,3246,20,Y,N,-,-1,-1
PILGRIM.txt,417979,421108,3129,20,Y,Y,1432984504343,420736,421597
PILGRIM.txt,418938,421993,3055,20,Y,Y,1432984504343,420736,421597
PILGRIM.txt,419614,422583,2969,20,Y,Y,1432984504343,420736,421597
PILGRIM.txt,420311,423543,3232,20,Y,Y,1432984504343,420736,421597
PILGRIM.txt,421109,424142,3033,20,Y,Y,1432984504343,420736,421597
PILGRIM.txt,421994,424876,2882,20,Y,N,-,-1,-1
PILGRIM.txt,422584,425518,2934,20,Y,N,-,-1,-1
PILGRIM.txt,423544,426088,2544,20,Y,N,-,-1,-1
PILGRIM.txt,424143,427153,3010,20,Y,N,-,-1,-1
PILGRIM.txt,424878,427689,2811,20,Y,N,-,-1,-1
PILGRIM.txt,425519,428548,3029,20,Y,N,-,-1,-1
PILGRIM.txt,426091,429326,3235,20,Y,N,-,-1,-1
PILGRIM.txt,427155,430127,2972,20,Y,N,-,-1,-1
PILGRIM.txt,427690,430971,3281,20,Y,N,-,-1,-1
PILGRIM.txt,428549,431825,3276,20,Y,N,-,-1,-1
PILGRIM.txt,429327,432544,3217,20,Y,N,-,-1,-1
PILGRIM.txt,430130,433060,2930,20,Y,N,-,-1,-1
PILGRIM.txt,430974,433782,2808,20,Y,N,-,-1,-1
PILGRIM.txt,431828,434749,2921,20,Y,N,-,-1,-1
PILGRIM.txt,432545,435655,3110,20,Y,N,-,-1,-1
PILGRIM.txt,433061,436244,3183,20,Y,N,-,-1,-1
PILGRIM.txt,433784,436507,2723,20,Y,N,-,-1,-1
PILGRIM.txt,434750,436977,2227,20,Y,N,-,-1,-1
PILGRIM.txt,435656,437599,1943,20,N,N,-,-1,-1
PILGRIM.txt,436246,438312,2066,20,N,N,-,-1,-1
PILGRIM.txt,436508,439011,2503,20,N,N,-,-1,-1
PILGRIM.txt,436978,439761,2783,20,Y,N,-,-1,-1
PILGRIM.txt,437604,440428,2824,20,Y,N,-,-1,-1
PILGRIM.txt,438314,440927,2613,20,Y,N,-,-1,-1
PILGRIM.txt,439012,441567,2555,20,Y,N,-,-1,-1
PILGRIM.txt,439763,442172,2409,20,Y,N,-,-1,-1
PILGRIM.txt,440430,442685,2255,20,Y,N,-,-1,-1
PILGRIM.txt,440928,443073,2145,20,Y,N,-,-1,-1
PILGRIM.txt,441568,443344,1776,20,Y,N,-,-1,-1
PILGRIM.txt,442173,444104,1931,20,Y,N,-,-1,-1
PILGRIM.txt,442690,444751,2061,20,Y,N,-,-1,-1
PILGRIM.txt,443075,445424,2349,20,Y,N,-,-1,-1
PILGRIM.txt,443345,446120,2775,20,Y,N,-,-1,-1
PILGRIM.txt,444105,446979,2874,20,Y,N,-,-1,-1
PILGRIM.txt,444753,447538,2785,20,Y,N,-,-1,-1
PILGRIM.txt,445425,448414,2989,20,Y,N,-,-1,-1
PILGRIM.txt,446121,449026,2905,20,Y,N,-,-1,-1
PILGRIM.txt,446982,449819,2837,20,Y,N,-,-1,-1
PILGRIM.txt,447539,450246,2707,20,Y,N,-,-1,-1
PILGRIM.txt,448415,451182,2767,20,Y,N,-,-1,-1
PILGRIM.txt,449027,451735,2708,20,Y,N,-,-1,-1
PILGRIM.txt,449820,452404,2584,20,Y,N,-,-1,-1
PILGRIM.txt,450247,453139,2892,20,Y,N,-,-1,-1
PILGRIM.txt,451183,453850,2667,20,Y,N,-,-1,-1
PILGRIM.txt,451736,454701,2965,20,Y,N,-,-1,-1
PILGRIM.txt,452407,455450,3043,20,Y,N,-,-1,-1
PILGRIM.txt,453140,456165,3025,20,Y,Y,1433089799400,455451,455857
PILGRIM.txt,453853,456873,3020,20,Y,Y,1433089799400,455451,455857
PILGRIM.txt,454702,457463,2761,20,Y,Y,1433089799400,455451,455857
PILGRIM.txt,455453,457883,2430,20,Y,Y,1433089799400,455451,455857
PILGRIM.txt,456166,458491,2325,20,Y,N,-,-1,-1
PILGRIM.txt,456874,459357,2483,20,Y,N,-,-1,-1
PILGRIM.txt,457464,459901,2437,20,Y,N,-,-1,-1
PILGRIM.txt,457884,460564,2680,20,Y,N,-,-1,-1
PILGRIM.txt,458493,461138,2645,20,Y,N,-,-1,-1
PILGRIM.txt,459358,461822,2464,20,Y,N,-,-1,-1
PILGRIM.txt,459902,462786,2884,20,Y,N,-,-1,-1
PILGRIM.txt,460565,463626,3061,20,Y,N,-,-1,-1
PILGRIM.txt,461141,464145,3004,20,Y,N,-,-1,-1
PILGRIM.txt,461824,464871,3047,20,Y,N,-,-1,-1
PILGRIM.txt,462789,465298,2509,20,Y,N,-,-1,-1
PILGRIM.txt,463627,466114,2487,20,Y,N,-,-1,-1
PILGRIM.txt,464146,466890,2744,20,Y,N,-,-1,-1
PILGRIM.txt,464874,467562,2688,20,Y,N,-,-1,-1
PILGRIM.txt,465301,468070,2769,20,Y,N,-,-1,-1
PILGRIM.txt,466116,468430,2314,20,Y,N,-,-1,-1
PILGRIM.txt,466891,469154,2263,20,Y,N,-,-1,-1
PILGRIM.txt,467565,469661,2096,20,Y,N,-,-1,-1
PILGRIM.txt,468071,470570,2499,20,Y,N,-,-1,-1
PILGRIM.txt,468433,471753,3320,20,Y,Y,1433091318633,471647,472306
PILGRIM.txt,469155,472647,3492,20,Y,Y,1433091318633,471647,472306
PILGRIM.txt,469662,473280,3618,20,Y,Y,1433091318633,471647,472306
PILGRIM.txt,470573,473918,3345,20,Y,Y,1433091318633,471647,472306
PILGRIM.txt,471754,474386,2632,20,Y,Y,1433091318633,471647,472306
PILGRIM.txt,472648,474929,2281,20,Y,N,-,-1,-1
PILGRIM.txt,473281,475806,2525,20,Y,N,-,-1,-1
PILGRIM.txt,473919,476941,3022,20,Y,N,-,-1,-1
PILGRIM.txt,474388,477794,3406,20,Y,N,-,-1,-1
PILGRIM.txt,474930,478834,3904,20,Y,N,-,-1,-1
PILGRIM.txt,475809,479796,3987,20,Y,N,-,-1,-1
PILGRIM.txt,476944,481015,4071,20,Y,N,-,-1,-1
PILGRIM.txt,477795,481721,3926,20,Y,N,-,-1,-1
PILGRIM.txt,478837,482815,3978,20,Y,N,-,-1,-1
PILGRIM.txt,479797,483706,3909,20,Y,N,-,-1,-1
PILGRIM.txt,481018,484389,3371,20,Y,N,-,-1,-1
PILGRIM.txt,481722,485120,3398,20,Y,N,-,-1,-1
PILGRIM.txt,482818,486163,3345,20,Y,N,-,-1,-1
PILGRIM.txt,483707,486966,3259,20,Y,N,-,-1,-1
PILGRIM.txt,484390,487923,3533,20,Y,N,-,-1,-1
PILGRIM.txt,485125,488879,3754,20,N,N,-,-1,-1
PILGRIM.txt,486166,489538,3372,20,N,N,-,-1,-1
PILGRIM.txt,486967,490148,3181,20,Y,N,-,-1,-1
PILGRIM.txt,487924,490903,2979,20,Y,N,-,-1,-1
PILGRIM.txt,488880,491545,2665,20,Y,N,-,-1,-1
PILGRIM.txt,489539,492307,2768,20,Y,N,-,-1,-1
PILGRIM.txt,490149,493125,2976,20,Y,N,-,-1,-1
PILGRIM.txt,490905,493831,2926,20,Y,N,-,-1,-1
PILGRIM.txt,491546,494561,3015,20,Y,N,-,-1,-1
PILGRIM.txt,492308,495624,3316,20,Y,N,-,-1,-1
PILGRIM.txt,493126,496613,3487,20,Y,Y,1433092717054,496037,497172
PILGRIM.txt,493832,497600,3768,20,Y,Y,1433092717054,496037,497172
PILGRIM.txt,494562,498471,3909,20,Y,Y,1433092717054,496037,497172
PILGRIM.txt,495625,499296,3671,20,Y,Y,1433092717054,496037,497172
PILGRIM.txt,496614,500250,3636,20,Y,Y,1433092717054,496037,497172
PILGRIM.txt,497601,500991,3390,20,Y,Y,1433093250202,497882,499236
PILGRIM.txt,498473,501855,3382,20,Y,Y,1433093250202,497882,499236
PILGRIM.txt,499299,502931,3632,20,Y,N,-,-1,-1
PILGRIM.txt,500251,503477,3226,20,Y,N,-,-1,-1
PILGRIM.txt,500994,504351,3357,20,Y,N,-,-1,-1
PILGRIM.txt,501856,505338,3482,20,Y,N,-,-1,-1
PILGRIM.txt,502932,505781,2849,20,Y,N,-,-1,-1
PILGRIM.txt,503478,506347,2869,20,Y,N,-,-1,-1
PILGRIM.txt,504352,507428,3076,20,Y,N,-,-1,-1
PILGRIM.txt,505343,507942,2599,20,Y,N,-,-1,-1
PILGRIM.txt,505784,508578,2794,20,Y,N,-,-1,-1
PILGRIM.txt,506348,509108,2760,20,Y,N,-,-1,-1
PILGRIM.txt,507429,509877,2448,20,Y,N,-,-1,-1
PILGRIM.txt,507947,510143,2196,20,Y,N,-,-1,-1
PILGRIM.txt,508579,511111,2532,20,Y,N,-,-1,-1
PILGRIM.txt,509111,511655,2544,20,Y,N,-,-1,-1
PILGRIM.txt,509878,512456,2578,20,Y,N,-,-1,-1
PILGRIM.txt,510145,513219,3074,20,Y,N,-,-1,-1
PILGRIM.txt,511112,513839,2727,20,Y,N,-,-1,-1
PILGRIM.txt,511658,514667,3009,20,Y,N,-,-1,-1
PILGRIM.txt,512459,515335,2876,20,Y,N,-,-1,-1
PILGRIM.txt,513224,516008,2784,20,Y,N,-,-1,-1
PILGRIM.txt,513841,516472,2631,20,Y,N,-,-1,-1
PILGRIM.txt,514668,517131,2463,20,Y,N,-,-1,-1
PILGRIM.txt,515337,517664,2327,20,Y,N,-,-1,-1
PILGRIM.txt,516009,518421,2412,20,Y,N,-,-1,-1
PILGRIM.txt,516473,518984,2511,20,Y,N,-,-1,-1
PILGRIM.txt,517133,519986,2853,20,Y,N,-,-1,-1
PILGRIM.txt,517666,520675,3009,20,Y,N,-,-1,-1
PILGRIM.txt,518422,521077,2655,20,Y,N,-,-1,-1
PILGRIM.txt,518986,521665,2679,20,Y,N,-,-1,-1
PILGRIM.txt,519988,522278,2290,20,Y,N,-,-1,-1
PILGRIM.txt,520680,522785,2105,20,N,N,-,-1,-1
PILGRIM.txt,521080,523139,2059,20,Y,N,-,-1,-1
PILGRIM.txt,521667,523923,2256,20,Y,N,-,-1,-1
PILGRIM.txt,522279,524592,2313,20,Y,N,-,-1,-1
PILGRIM.txt,522786,525364,2578,20,Y,N,-,-1,-1
PILGRIM.txt,523142,526000,2858,20,Y,N,-,-1,-1
PILGRIM.txt,523925,526876,2951,20,Y,Y,1433140776828,526138,528487
PILGRIM.txt,524593,528553,3960,20,Y,Y,1433140776828,526138,528487
PILGRIM.txt,525365,529256,3891,20,Y,Y,1433140776828,526138,528487
PILGRIM.txt,526001,530154,4153,20,Y,Y,1433140776828,526138,528487
PILGRIM.txt,526879,530938,4059,20,Y,Y,1433140776828,526138,528487
PILGRIM.txt,528558,531660,3102,20,Y,N,-,-1,-1
PILGRIM.txt,529257,531976,2719,20,Y,N,-,-1,-1
PILGRIM.txt,530155,532622,2467,20,Y,Y,1433166467939,532258,533091
PILGRIM.txt,530941,533113,2172,20,Y,Y,1433166467939,532258,533091
PILGRIM.txt,531661,534188,2527,20,Y,Y,1433166467939,532258,533091
PILGRIM.txt,531977,535158,3181,20,Y,Y,1433166467939,532258,533091
PILGRIM.txt,532623,535736,3113,20,Y,Y,1433166467939,532258,533091
PILGRIM.txt,533116,536559,3443,20,Y,N,-,-1,-1
PILGRIM.txt,534189,537194,3005,20,Y,N,-,-1,-1
PILGRIM.txt,535159,538137,2978,20,Y,N,-,-1,-1
PILGRIM.txt,535737,538502,2765,20,N,N,-,-1,-1
PILGRIM.txt,536560,538792,2232,20,N,N,-,-1,-1
PILGRIM.txt,537195,539126,1931,20,N,N,-,-1,-1
PILGRIM.txt,538138,539561,1423,20,N,N,-,-1,-1
PILGRIM.txt,538503,540153,1650,20,N,N,-,-1,-1
PILGRIM.txt,538795,540896,2101,20,Y,N,-,-1,-1
PILGRIM.txt,539127,541551,2424,20,Y,N,-,-1,-1
PILGRIM.txt,539562,542276,2714,20,Y,N,-,-1,-1
PILGRIM.txt,540156,543002,2846,20,Y,N,-,-1,-1
PILGRIM.txt,540899,543746,2847,20,Y,N,-,-1,-1
PILGRIM.txt,541552,544410,2858,20,Y,N,-,-1,-1
PILGRIM.txt,542278,545315,3037,20,Y,Y,1433167548802,544513,546084
PILGRIM.txt,543003,545981,2978,20,N,Y,1433167548802,544513,546084
PILGRIM.txt,543749,546618,2869,20,Y,Y,1433167548802,544513,546084
PILGRIM.txt,544412,547496,3084,20,Y,Y,1433167548802,544513,546084
PILGRIM.txt,545316,548618,3302,20,Y,Y,1433168080595,547752,548387
PILGRIM.txt,545982,549306,3324,20,Y,Y,1433168080595,547752,548387
PILGRIM.txt,546620,550044,3424,20,Y,Y,1433168080595,547752,548387
PILGRIM.txt,547497,550763,3266,20,Y,Y,1433168080595,547752,548387
PILGRIM.txt,548619,551302,2683,20,Y,N,-,-1,-1
PILGRIM.txt,549309,552287,2978,20,Y,N,-,-1,-1
PILGRIM.txt,550045,552962,2917,20,Y,N,-,-1,-1
PILGRIM.txt,550764,553963,3199,20,Y,N,-,-1,-1
PILGRIM.txt,551305,554945,3640,20,Y,N,-,-1,-1
PILGRIM.txt,552290,555847,3557,20,Y,N,-,-1,-1
PILGRIM.txt,552965,556579,3614,20,Y,N,-,-1,-1
PILGRIM.txt,553966,556988,3022,20,Y,Y,1433168856414,556592,557358
PILGRIM.txt,554948,557996,3048,20,Y,Y,1433168856414,556592,557358
PILGRIM.txt,555852,558597,2745,20,Y,Y,1433168856414,556592,557358
PILGRIM.txt,556582,559062,2480,20,Y,Y,1433168856414,556592,557358
PILGRIM.txt,556990,559631,2641,20,Y,Y,1433168856414,556592,557358
PILGRIM.txt,557997,560330,2333,20,N,N,-,-1,-1
PILGRIM.txt,558597,560992,2395,20,N,N,-,-1,-1
PILGRIM.txt,559063,562000,2937,20,Y,N,-,-1,-1
PILGRIM.txt,559632,562751,3119,20,Y,N,-,-1,-1
PILGRIM.txt,560331,563447,3116,20,Y,N,-,-1,-1
PILGRIM.txt,560993,563911,2918,20,Y,N,-,-1,-1
PILGRIM.txt,562001,564346,2345,20,Y,N,-,-1,-1
PILGRIM.txt,562754,564611,1857,20,Y,N,-,-1,-1
PILGRIM.txt,563449,564933,1484,20,Y,N,-,-1,-1
PILGRIM.txt,563913,565632,1719,20,Y,N,-,-1,-1
PILGRIM.txt,564347,566124,1777,20,Y,N,-,-1,-1
PILGRIM.txt,564613,566431,1818,20,Y,N,-,-1,-1
PILGRIM.txt,564934,566903,1969,20,Y,N,-,-1,-1
PILGRIM.txt,565633,567222,1589,20,Y,N,-,-1,-1
PILGRIM.txt,566127,567940,1813,20,Y,N,-,-1,-1
PILGRIM.txt,566432,568490,2058,20,Y,N,-,-1,-1
PILGRIM.txt,566904,568862,1958,20,Y,N,-,-1,-1
PILGRIM.txt,567223,569678,2455,20,Y,N,-,-1,-1
PILGRIM.txt,567941,570218,2277,20,Y,N,-,-1,-1
PILGRIM.txt,568491,571214,2723,20,Y,N,-,-1,-1
PILGRIM.txt,568864,571605,2741,20,Y,N,-,-1,-1
PILGRIM.txt,569679,572180,2501,20,Y,N,-,-1,-1
PILGRIM.txt,570219,572663,2444,20,Y,N,-,-1,-1
PILGRIM.txt,571217,573315,2098,20,Y,N,-,-1,-1
PILGRIM.txt,571606,574063,2457,20,Y,N,-,-1,-1
PILGRIM.txt,572181,574949,2768,20,Y,N,-,-1,-1
PILGRIM.txt,572665,576078,3413,20,Y,N,-,-1,-1
PILGRIM.txt,573316,576703,3387,20,Y,N,-,-1,-1
PILGRIM.txt,574066,577179,3113,20,Y,N,-,-1,-1
PILGRIM.txt,574952,578282,3330,20,Y,N,-,-1,-1
PILGRIM.txt,576081,579017,2936,20,Y,N,-,-1,-1
PILGRIM.txt,576704,579821,3117,20,Y,N,-,-1,-1
PILGRIM.txt,577180,580549,3369,20,Y,N,-,-1,-1
PILGRIM.txt,578287,581975,3688,20,Y,N,-,-1,-1
PILGRIM.txt,579018,582402,3384,20,Y,N,-,-1,-1
PILGRIM.txt,579822,583466,3644,20,Y,N,-,-1,-1
PILGRIM.txt,580549,584459,3910,20,Y,N,-,-1,-1
PILGRIM.txt,581976,585070,3094,20,Y,N,-,-1,-1
PILGRIM.txt,582403,585538,3135,20,Y,N,-,-1,-1
PILGRIM.txt,583467,585917,2450,20,Y,N,-,-1,-1
PILGRIM.txt,584462,586255,1793,20,Y,N,-,-1,-1
PILGRIM.txt,585071,586772,1701,20,Y,N,-,-1,-1
PILGRIM.txt,585541,587451,1910,20,Y,N,-,-1,-1
PILGRIM.txt,585918,588181,2263,20,Y,N,-,-1,-1
PILGRIM.txt,586256,588421,2165,20,Y,N,-,-1,-1
PILGRIM.txt,586773,589190,2417,20,Y,N,-,-1,-1
PILGRIM.txt,587452,589418,1966,20,Y,N,-,-1,-1
PILGRIM.txt,588182,589885,1703,20,N,N,-,-1,-1
PILGRIM.txt,588422,590430,2008,20,Y,N,-,-1,-1
PILGRIM.txt,589192,590997,1805,20,Y,N,-,-1,-1
PILGRIM.txt,589419,591462,2043,20,Y,N,-,-1,-1
PILGRIM.txt,589886,592173,2287,20,Y,N,-,-1,-1
PILGRIM.txt,590433,592796,2363,20,Y,N,-,-1,-1
PILGRIM.txt,591000,593581,2581,20,Y,N,-,-1,-1
PILGRIM.txt,591463,594416,2953,20,Y,N,-,-1,-1
PILGRIM.txt,592174,595643,3469,20,Y,N,-,-1,-1
PILGRIM.txt,592797,596125,3328,20,Y,N,-,-1,-1
PILGRIM.txt,593582,596686,3104,20,Y,N,-,-1,-1
PILGRIM.txt,594416,597303,2887,20,Y,N,-,-1,-1
PILGRIM.txt,595644,597845,2201,20,Y,N,-,-1,-1
PILGRIM.txt,596126,600018,3892,20,Y,N,-,-1,-1
PILGRIM.txt,596689,600499,3810,20,Y,N,-,-1,-1
PILGRIM.txt,597304,601782,4478,20,Y,N,-,-1,-1
PILGRIM.txt,597846,602527,4681,20,Y,N,-,-1,-1
PILGRIM.txt,600021,603308,3287,20,Y,N,-,-1,-1
PILGRIM.txt,600502,603988,3486,20,Y,N,-,-1,-1
PILGRIM.txt,601787,604959,3172,20,Y,N,-,-1,-1
PILGRIM.txt,602528,605856,3328,20,Y,N,-,-1,-1
PILGRIM.txt,603311,606643,3332,20,Y,N,-,-1,-1
PILGRIM.txt,603989,607628,3639,20,Y,N,-,-1,-1
PILGRIM.txt,604960,609018,4058,20,Y,N,-,-1,-1
PILGRIM.txt,605858,609312,3454,20,Y,N,-,-1,-1
PILGRIM.txt,606644,609417,2773,20,Y,N,-,-1,-1
PILGRIM.txt,607630,609445,1815,20,N,N,-,-1,-1
PILGRIM.txt,609021,609489,468,20,N,N,-,-1,-1
PILGRIM.txt,609312,609623,311,20,N,N,-,-1,-1
PILGRIM.txt,609417,609794,377,20,N,N,-,-1,-1
PILGRIM.txt,609446,609989,543,20,N,N,-,-1,-1
PILGRIM.txt,609489,610127,638,20,N,N,-,-1,-1
PILGRIM.txt,609626,610148,522,20,N,N,-,-1,-1
PILGRIM.txt,609795,610254,459,20,N,N,-,-1,-1
PILGRIM.txt,609990,610306,316,20,N,N,-,-1,-1
PILGRIM.txt,610127,610578,451,20,N,N,-,-1,-1
PILGRIM.txt,610149,610705,556,20,N,N,-,-1,-1
PILGRIM.txt,610257,610858,601,20,N,N,-,-1,-1
PILGRIM.txt,610306,611462,1156,20,N,N,-,-1,-1
PILGRIM.txt,610578,612703,2125,20,N,N,-,-1,-1
PILGRIM.txt,610706,614038,3332,20,Y,N,-,-1,-1
PILGRIM.txt,610859,615188,4329,20,Y,N,-,-1,-1
PILGRIM.txt,611463,616322,4859,20,Y,N,-,-1,-1
PILGRIM.txt,612704,616946,4242,20,Y,N,-,-1,-1
PILGRIM.txt,614039,617713,3674,20,Y,N,-,-1,-1
PILGRIM.txt,615190,618379,3189,20,Y,N,-,-1,-1
PILGRIM.txt,616323,619046,2723,20,Y,N,-,-1,-1
PILGRIM.txt,616947,619619,2672,20,Y,N,-,-1,-1
PILGRIM.txt,617714,620899,3185,20,Y,N,-,-1,-1
PILGRIM.txt,618380,621592,3212,20,Y,N,-,-1,-1
PILGRIM.txt,619047,622321,3274,20,Y,N,-,-1,-1
PILGRIM.txt,619620,623000,3380,20,Y,N,-,-1,-1
PILGRIM.txt,620904,623584,2680,20,Y,N,-,-1,-1
PILGRIM.txt,621595,624427,2832,20,Y,N,-,-1,-1
PILGRIM.txt,622323,625050,2727,20,Y,N,-,-1,-1
PILGRIM.txt,623003,625761,2758,20,Y,N,-,-1,-1
PILGRIM.txt,623585,626873,3288,20,Y,N,-,-1,-1
PILGRIM.txt,624429,627837,3408,20,Y,N,-,-1,-1
PILGRIM.txt,625051,628616,3565,20,Y,N,-,-1,-1
PILGRIM.txt,625762,629068,3306,20,Y,N,-,-1,-1
PILGRIM.txt,626874,630137,3263,20,Y,N,-,-1,-1
PILGRIM.txt,627838,630760,2922,20,Y,N,-,-1,-1
PILGRIM.txt,628617,631184,2567,20,Y,N,-,-1,-1
PILGRIM.txt,629071,632359,3288,20,Y,N,-,-1,-1
PILGRIM.txt,630138,634372,4234,20,Y,N,-,-1,-1
PILGRIM.txt,630761,640579,9818,20,Y,N,-,-1,-1
PILGRIM.txt,631189,642095,10906,20,Y,N,-,-1,-1
PILGRIM.txt,632360,645148,12788,20,Y,N,-,-1,-1
PILGRIM.txt,634377,647485,13108,20,N,N,-,-1,-1
PILGRIM.txt,640581,653558,12977,20,N,N,-,-1,-1
PILGRIM.txt,642096,659307,17211,20,N,N,-,-1,-1
PILGRIM.txt,645151,662919,17768,20,N,N,-,-1,-1
RECMUS.txt,0,1082,1082,20,N,N,-,-1,-1
RECMUS.txt,263,1243,980,20,Y,N,-,-1,-1
RECMUS.txt,465,2109,1644,20,Y,N,-,-1,-1
RECMUS.txt,783,2889,2106,20,Y,N,-,-1,-1
RECMUS.txt,1083,3406,2323,20,Y,N,-,-1,-1
RECMUS.txt,1244,4118,2874,20,Y,N,-,-1,-1
RECMUS.txt,2110,4561,2451,20,Y,N,-,-1,-1
RECMUS.txt,2890,5492,2602,20,Y,N,-,-1,-1
RECMUS.txt,3411,7245,3834,20,Y,N,-,-1,-1
RECMUS.txt,4123,8111,3988,20,Y,N,-,-1,-1
RECMUS.txt,4564,9445,4881,20,Y,N,-,-1,-1
RECMUS.txt,5495,10749,5254,20,Y,N,-,-1,-1
RECMUS.txt,7248,11702,4454,20,Y,N,-,-1,-1
RECMUS.txt,8114,12614,4500,20,Y,N,-,-1,-1
RECMUS.txt,9448,13409,3961,20,Y,N,-,-1,-1
RECMUS.txt,10750,14274,3524,20,Y,N,-,-1,-1
RECMUS.txt,11705,15449,3744,20,Y,N,-,-1,-1
RECMUS.txt,12617,16368,3751,20,Y,N,-,-1,-1
RECMUS.txt,13412,17687,4275,20,Y,N,-,-1,-1
RECMUS.txt,14275,18498,4223,20,Y,N,-,-1,-1
RECMUS.txt,15452,18963,3511,20,Y,N,-,-1,-1
RECMUS.txt,16371,19928,3557,20,Y,N,-,-1,-1
RECMUS.txt,17690,20818,3128,20,Y,N,-,-1,-1
RECMUS.txt,18499,21385,2886,20,Y,N,-,-1,-1
RECMUS.txt,18966,22013,3047,20,Y,N,-,-1,-1
RECMUS.txt,19933,22600,2667,20,Y,N,-,-1,-1
RECMUS.txt,20819,23441,2622,20,Y,N,-,-1,-1
RECMUS.txt,21388,24052,2664,20,Y,N,-,-1,-1
RECMUS.txt,22014,24696,2682,20,Y,N,-,-1,-1
RECMUS.txt,22603,25446,2843,20,Y,N,-,-1,-1
RECMUS.txt,23442,26096,2654,20,Y,N,-,-1,-1
RECMUS.txt,24054,26796,2742,20,Y,N,-,-1,-1
RECMUS.txt,24697,27238,2541,20,Y,N,-,-1,-1
RECMUS.txt,25447,27690,2243,20,Y,N,-,-1,-1
RECMUS.txt,26096,28260,2164,20,Y,N,-,-1,-1
RECMUS.txt,26797,29127,2330,20,Y,N,-,-1,-1
RECMUS.txt,27239,29884,2645,20,Y,N,-,-1,-1
RECMUS.txt,27692,30466,2774,20,Y,N,-,-1,-1
RECMUS.txt,28262,30922,2660,20,Y,N,-,-1,-1
RECMUS.txt,29128,31673,2545,20,Y,N,-,-1,-1
RECMUS.txt,29885,32364,2479,20,Y,N,-,-1,-1
RECMUS.txt,30467,33065,2598,20,Y,N,-,-1,-1
RECMUS.txt,30925,33440,2515,20,Y,N,-,-1,-1
RECMUS.txt,31674,34255,2581,20,Y,N,-,-1,-1
RECMUS.txt,32366,35223,2857,20,Y,N,-,-1,-1
RECMUS.txt,33066,35581,2515,20,Y,N,-,-1,-1
RECMUS.txt,33441,36526,3085,20,Y,N,-,-1,-1
RECMUS.txt,34258,37467,3209,20,Y,N,-,-1,-1
RECMUS.txt,35226,38121,2895,20,Y,N,-,-1,-1
RECMUS.txt,35583,38573,2990,20,Y,N,-,-1,-1
RECMUS.txt,36527,39465,2938,20,Y,N,-,-1,-1
RECMUS.txt,37468,40197,2729,20,Y,N,-,-1,-1
RECMUS.txt,38124,40619,2495,20,Y,N,-,-1,-1
RECMUS.txt,38576,41393,2817,20,Y,N,-,-1,-1
RECMUS.txt,39468,41995,2527,20,Y,N,-,-1,-1
RECMUS.txt,40200,42653,2453,20,Y,N,-,-1,-1
RECMUS.txt,40621,43126,2505,20,Y,N,-,-1,-1
RECMUS.txt,41396,43668,2272,20,Y,N,-,-1,-1
RECMUS.txt,41996,44028,2032,20,Y,N,-,-1,-1
RECMUS.txt,42656,44965,2309,20,Y,N,-,-1,-1
RECMUS.txt,43127,45661,2534,20,Y,N,-,-1,-1
RECMUS.txt,43669,46132,2463,20,Y,N,-,-1,-1
RECMUS.txt,44029,46689,2660,20,Y,N,-,-1,-1
RECMUS.txt,44970,47506,2536,20,Y,N,-,-1,-1
RECMUS.txt,45662,48232,2570,20,Y,N,-,-1,-1
RECMUS.txt,46135,48927,2792,20,Y,N,-,-1,-1
RECMUS.txt,46690,49811,3121,20,Y,N,-,-1,-1
RECMUS.txt,47507,50458,2951,20,Y,N,-,-1,-1
RECMUS.txt,48233,51305,3072,20,Y,N,-,-1,-1
RECMUS.txt,48928,52171,3243,20,Y,N,-,-1,-1
RECMUS.txt,49816,52537,2721,20,Y,N,-,-1,-1
RECMUS.txt,50459,53127,2668,20,Y,N,-,-1,-1
RECMUS.txt,51306,53726,2420,20,Y,N,-,-1,-1
RECMUS.txt,52174,54594,2420,20,Y,N,-,-1,-1
RECMUS.txt,52539,55340,2801,20,Y,N,-,-1,-1
RECMUS.txt,53128,56469,3341,20,Y,N,-,-1,-1
RECMUS.txt,53727,56957,3230,20,Y,N,-,-1,-1
RECMUS.txt,54595,57979,3384,20,Y,N,-,-1,-1
RECMUS.txt,55341,58431,3090,20,Y,N,-,-1,-1
RECMUS.txt,56470,58925,2455,20,Y,N,-,-1,-1
RECMUS.txt,56960,59741,2781,20,Y,N,-,-1,-1
RECMUS.txt,57980,60387,2407,20,Y,N,-,-1,-1
RECMUS.txt,58432,60497,2065,20,Y,N,-,-1,-1
RECMUS.txt,58930,60571,1641,20,Y,N,-,-1,-1
RECMUS.txt,59742,60683,941,20,Y,N,-,-1,-1
RECMUS.txt,60390,61294,904,20,Y,N,-,-1,-1
RECMUS.txt,60498,61860,1362,20,Y,N,-,-1,-1
RECMUS.txt,60574,62561,1987,20,Y,N,-,-1,-1
RECMUS.txt,60684,63159,2475,20,Y,N,-,-1,-1
RECMUS.txt,61297,63697,2400,20,Y,N,-,-1,-1
RECMUS.txt,61861,64547,2686,20,Y,N,-,-1,-1
RECMUS.txt,62562,65354,2792,20,Y,N,-,-1,-1
RECMUS.txt,63160,66204,3044,20,Y,N,-,-1,-1
RECMUS.txt,63700,67100,3400,20,Y,N,-,-1,-1
RECMUS.txt,64548,67807,3259,20,Y,Y,1426859941632,67129,67357
RECMUS.txt,65356,68204,2848,20,Y,Y,1426859941632,67129,67357
RECMUS.txt,66205,69532,3327,20,Y,Y,1426859941632,67129,67357
RECMUS.txt,67101,70420,3319,20,Y,Y,1426859941632,67129,67357
RECMUS.txt,67810,71236,3426,20,Y,N,-,-1,-1
RECMUS.txt,68205,71988,3783,20,Y,N,-,-1,-1
RECMUS.txt,69533,72559,3026,20,Y,Y,1426861072576,72354,72768
RECMUS.txt,70421,72960,2539,20,Y,Y,1426861072576,72354,72768
RECMUS.txt,71237,73858,2621,20,Y,Y,1426861072576,72354,72768
RECMUS.txt,71989,74640,2651,20,Y,Y,1426861072576,72354,72768
RECMUS.txt,72561,75040,2479,20,Y,Y,1426861072576,72354,72768
RECMUS.txt,72962,75461,2499,20,Y,Y,1426861595037,75041,75166
RECMUS.txt,73861,76596,2735,20,Y,Y,1426861595037,75041,75166
RECMUS.txt,74641,77415,2774,20,Y,Y,1426861595037,75041,75166
RECMUS.txt,75041,77882,2841,20,Y,Y,1426861595037,75041,75166
RECMUS.txt,75464,78885,3421,20,Y,Y,1426863415047,78494,78880
RECMUS.txt,76597,79445,2848,20,Y,Y,1426863415047,78494,78880
RECMUS.txt,77416,80178,2762,20,Y,Y,1426863415047,78494,78880
RECMUS.txt,77885,81018,3133,20,Y,Y,1426863415047,78494,78880
RECMUS.txt,78886,81743,2857,20,Y,N,-,-1,-1
RECMUS.txt,79446,82284,2838,20,Y,N,-,-1,-1
RECMUS.txt,80179,82672,2493,20,Y,N,-,-1,-1
RECMUS.txt,81019,83185,2166,20,Y,N,-,-1,-1
RECMUS.txt,81744,83833,2089,20,Y,N,-,-1,-1
RECMUS.txt,82285,84511,2226,20,Y,N,-,-1,-1
RECMUS.txt,82673,84916,2243,20,Y,N,-,-1,-1
RECMUS.txt,83186,85593,2407,20,Y,N,-,-1,-1
RECMUS.txt,83834,86280,2446,20,Y,N,-,-1,-1
RECMUS.txt,84512,86948,2436,20,Y,N,-,-1,-1
RECMUS.txt,84919,87544,2625,20,Y,N,-,-1,-1
RECMUS.txt,85594,87854,2260,20,Y,N,-,-1,-1
RECMUS.txt,86281,88222,1941,20,Y,N,-,-1,-1
RECMUS.txt,86953,88552,1599,20,Y,N,-,-1,-1
RECMUS.txt,87545,89035,1490,20,Y,N,-,-1,-1
RECMUS.txt,87856,89726,1870,20,Y,N,-,-1,-1
RECMUS.txt,88223,90175,1952,20,Y,N,-,-1,-1
RECMUS.txt,88553,90512,1959,20,N,N,-,-1,-1
RECMUS.txt,89036,91184,2148,20,N,N,-,-1,-1
RECMUS.txt,89729,92102,2373,20,Y,N,-,-1,-1
RECMUS.txt,90176,92949,2773,20,Y,N,-,-1,-1
RECMUS.txt,90513,93906,3393,20,Y,N,-,-1,-1
RECMUS.txt,91185,94979,3794,20,Y,N,-,-1,-1
RECMUS.txt,92103,95894,3791,20,Y,N,-,-1,-1
RECMUS.txt,92950,96382,3432,20,Y,N,-,-1,-1
RECMUS.txt,93907,97060,3153,20,Y,N,-,-1,-1
RECMUS.txt,94980,97742,2762,20,Y,N,-,-1,-1
RECMUS.txt,95897,98656,2759,20,Y,N,-,-1,-1
RECMUS.txt,96383,99422,3039,20,Y,N,-,-1,-1
RECMUS.txt,97061,100063,3002,20,Y,N,-,-1,-1
RECMUS.txt,97743,100559,2816,20,Y,N,-,-1,-1
RECMUS.txt,98661,100852,2191,20,Y,N,-,-1,-1
RECMUS.txt,99423,101420,1997,20,Y,N,-,-1,-1
RECMUS.txt,100066,101820,1754,20,Y,N,-,-1,-1
RECMUS.txt,100562,102059,1497,20,Y,N,-,-1,-1
RECMUS.txt,100853,102463,1610,20,Y,N,-,-1,-1
RECMUS.txt,101421,103050,1629,20,Y,Y,1427479456712,102659,102787
RECMUS.txt,101821,103352,1531,20,Y,Y,1427479456712,102659,102787
RECMUS.txt,102060,104168,2108,20,Y,Y,1427479456712,102659,102787
RECMUS.txt,102465,104811,2346,20,Y,Y,1427479456712,102659,102787
RECMUS.txt,103051,105342,2291,20,Y,N,-,-1,-1
RECMUS.txt,103353,105930,2577,20,Y,N,-,-1,-1
RECMUS.txt,104169,107110,2941,20,Y,N,-,-1,-1
RECMUS.txt,104814,107761,2947,20,Y,N,-,-1,-1
RECMUS.txt,105343,108535,3192,20,Y,N,-,-1,-1
RECMUS.txt,105933,109039,3106,20,Y,N,-,-1,-1
RECMUS.txt,107111,109806,2695,20,Y,N,-,-1,-1
RECMUS.txt,107764,110362,2598,20,Y,N,-,-1,-1
RECMUS.txt,108536,111006,2470,20,Y,N,-,-1,-1
RECMUS.txt,109042,111693,2651,20,Y,N,-,-1,-1
RECMUS.txt,109809,112107,2298,20,Y,N,-,-1,-1
RECMUS.txt,110363,113359,2996,20,Y,N,-,-1,-1
RECMUS.txt,111012,114110,3098,20,Y,N,-,-1,-1
RECMUS.txt,111694,114570,2876,20,Y,N,-,-1,-1
RECMUS.txt,112109,114927,2818,20,Y,N,-,-1,-1
RECMUS.txt,113360,115031,1671,20,Y,N,-,-1,-1
RECMUS.txt,114111,115096,985,20,Y,N,-,-1,-1
RECMUS.txt,114573,115149,576,20,Y,N,-,-1,-1
RECMUS.txt,114930,115222,292,20,Y,N,-,-1,-1
RECMUS.txt,115032,115329,297,20,Y,N,-,-1,-1
RECMUS.txt,115099,115416,317,20,Y,N,-,-1,-1
RECMUS.txt,115150,115522,372,20,Y,N,-,-1,-1
RECMUS.txt,115225,115678,453,20,Y,N,-,-1,-1
RECMUS.txt,115332,115776,444,20,Y,N,-,-1,-1
RECMUS.txt,115421,115929,508,20,Y,N,-,-1,-1
RECMUS.txt,115523,116411,888,20,Y,N,-,-1,-1
RECMUS.txt,115679,117019,1340,20,Y,N,-,-1,-1
RECMUS.txt,115779,117669,1890,20,Y,N,-,-1,-1
RECMUS.txt,115930,118313,2383,20,Y,N,-,-1,-1
RECMUS.txt,116412,118968,2556,20,Y,N,-,-1,-1
RECMUS.txt,117020,119655,2635,20,Y,N,-,-1,-1
RECMUS.txt,117670,120848,3178,20,Y,N,-,-1,-1
RECMUS.txt,118314,121593,3279,20,Y,N,-,-1,-1
RECMUS.txt,118969,122140,3171,20,Y,N,-,-1,-1
RECMUS.txt,119658,122877,3219,20,Y,N,-,-1,-1
RECMUS.txt,120851,123345,2494,20,Y,N,-,-1,-1
RECMUS.txt,121598,124090,2492,20,Y,Y,1428494785912,123570,123801
RECMUS.txt,122143,125188,3045,20,Y,Y,1428494785912,123570,123801
RECMUS.txt,122878,126230,3352,20,Y,Y,1428494785912,123570,123801
RECMUS.txt,123346,126821,3475,20,Y,Y,1428494785912,123570,123801
RECMUS.txt,124093,127830,3737,20,Y,N,-,-1,-1
RECMUS.txt,125189,128412,3223,20,Y,N,-,-1,-1
RECMUS.txt,126231,128690,2459,20,Y,N,-,-1,-1
RECMUS.txt,126822,129641,2819,20,Y,N,-,-1,-1
RECMUS.txt,127831,130314,2483,20,Y,N,-,-1,-1
RECMUS.txt,128413,131038,2625,20,Y,N,-,-1,-1
RECMUS.txt,128692,131848,3156,20,Y,N,-,-1,-1
RECMUS.txt,129642,132555,2913,20,Y,N,-,-1,-1
RECMUS.txt,130315,133198,2883,20,Y,N,-,-1,-1
RECMUS.txt,131039,133882,2843,20,Y,N,-,-1,-1
RECMUS.txt,131849,134510,2661,20,Y,N,-,-1,-1
RECMUS.txt,132558,135089,2531,20,Y,N,-,-1,-1
RECMUS.txt,133200,135779,2579,20,Y,N,-,-1,-1
RECMUS.txt,133883,136151,2268,20,Y,N,-,-1,-1
RECMUS.txt,134511,136670,2159,20,Y,N,-,-1,-1
RECMUS.txt,135090,137504,2414,20,Y,N,-,-1,-1
RECMUS.txt,135779,137780,2001,20,Y,N,-,-1,-1
RECMUS.txt,136154,138439,2285,20,Y,N,-,-1,-1
RECMUS.txt,136673,138982,2309,20,Y,Y,1429002645768,138633,138684
RECMUS.txt,137509,139816,2307,20,Y,Y,1429002645768,138633,138684
RECMUS.txt,137781,140553,2772,20,Y,Y,1429002645768,138633,138684
RECMUS.txt,138440,140982,2542,20,Y,Y,1429002645768,138633,138684
RECMUS.txt,138983,141785,2802,20,Y,N,-,-1,-1
RECMUS.txt,139821,142688,2867,20,Y,N,-,-1,-1
RECMUS.txt,140554,143540,2986,20,Y,N,-,-1,-1
RECMUS.txt,140982,144181,3199,20,Y,N,-,-1,-1
RECMUS.txt,141786,144812,3026,20,Y,N,-,-1,-1
RECMUS.txt,142689,145166,2477,20,Y,N,-,-1,-1
RECMUS.txt,143542,146059,2517,20,Y,N,-,-1,-1
RECMUS.txt,144184,147011,2827,20,Y,N,-,-1,-1
RECMUS.txt,144813,147928,3115,20,Y,N,-,-1,-1
RECMUS.txt,145167,148686,3519,20,Y,N,-,-1,-1
RECMUS.txt,146060,149300,3240,20,Y,N,-,-1,-1
RECMUS.txt,147012,150085,3073,20,Y,N,-,-1,-1
RECMUS.txt,147929,150807,2878,20,Y,N,-,-1,-1
RECMUS.txt,148687,151831,3144,20,Y,N,-,-1,-1
RECMUS.txt,149303,152879,3576,20,Y,N,-,-1,-1
RECMUS.txt,150086,153521,3435,20,Y,N,-,-1,-1
RECMUS.txt,150810,154108,3298,20,Y,N,-,-1,-1
RECMUS.txt,151832,154790,2958,20,Y,N,-,-1,-1
RECMUS.txt,152880,155412,2532,20,Y,N,-,-1,-1
RECMUS.txt,153522,156248,2726,20,Y,N,-,-1,-1
RECMUS.txt,154111,157045,2934,20,Y,N,-,-1,-1
RECMUS.txt,154792,157598,2806,20,Y,N,-,-1,-1
RECMUS.txt,155415,158146,2731,20,Y,N,-,-1,-1
RECMUS.txt,156249,158680,2431,20,Y,N,-,-1,-1
RECMUS.txt,157046,159297,2251,20,Y,N,-,-1,-1
RECMUS.txt,157599,159840,2241,20,Y,Y,1429102663064,159583,159924
RECMUS.txt,158149,160227,2078,20,Y,Y,1429102663064,159583,159924
RECMUS.txt,158681,160835,2154,20,Y,Y,1429102663064,159583,159924
RECMUS.txt,159297,161612,2315,20,Y,Y,1429102663064,159583,159924
RECMUS.txt,159841,162648,2807,20,Y,Y,1429102663064,159583,159924
RECMUS.txt,160228,163348,3120,20,Y,Y,1429103324122,162708,162980
RECMUS.txt,160836,163664,2828,20,Y,Y,1429103324122,162708,162980
RECMUS.txt,161613,163848,2235,20,Y,Y,1429103324122,162708,162980
RECMUS.txt,162649,164462,1813,20,Y,Y,1429103324122,162708,162980
RECMUS.txt,163349,164777,1428,20,Y,N,-,-1,-1
RECMUS.txt,163665,165041,1376,20,Y,N,-,-1,-1
RECMUS.txt,163851,165534,1683,20,Y,N,-,-1,-1
RECMUS.txt,164463,165785,1322,20,Y,N,-,-1,-1
RECMUS.txt,164778,166210,1432,20,Y,N,-,-1,-1
RECMUS.txt,165042,166651,1609,20,Y,N,-,-1,-1
RECMUS.txt,165535,167600,2065,20,Y,N,-,-1,-1
RECMUS.txt,165785,168240,2455,20,Y,N,-,-1,-1
RECMUS.txt,166211,169003,2792,20,Y,N,-,-1,-1
RECMUS.txt,166654,169732,3078,20,Y,N,-,-1,-1
RECMUS.txt,167603,170389,2786,20,Y,N,-,-1,-1
RECMUS.txt,168242,170966,2724,20,Y,N,-,-1,-1
RECMUS.txt,169003,171578,2575,20,Y,N,-,-1,-1
RECMUS.txt,169733,172115,2382,20,Y,N,-,-1,-1
RECMUS.txt,170392,172498,2106,20,Y,N,-,-1,-1
RECMUS.txt,170967,172867,1900,20,Y,N,-,-1,-1
RECMUS.txt,171579,173466,1887,20,Y,N,-,-1,-1
RECMUS.txt,172116,174102,1986,20,Y,N,-,-1,-1
RECMUS.txt,172499,174492,1993,20,Y,N,-,-1,-1
RECMUS.txt,172868,175260,2392,20,Y,N,-,-1,-1
RECMUS.txt,173467,175993,2526,20,Y,N,-,-1,-1
RECMUS.txt,174103,176587,2484,20,Y,N,-,-1,-1
RECMUS.txt,174493,177098,2605,20,Y,N,-,-1,-1
RECMUS.txt,175261,177789,2528,20,Y,N,-,-1,-1
RECMUS.txt,175996,178493,2497,20,Y,N,-,-1,-1
RECMUS.txt,176588,179321,2733,20,Y,N,-,-1,-1
RECMUS.txt,177099,180084,2985,20,Y,N,-,-1,-1
RECMUS.txt,177794,180649,2855,20,Y,N,-,-1,-1
RECMUS.txt,178494,181233,2739,20,Y,N,-,-1,-1
RECMUS.txt,179322,182099,2777,20,Y,N,-,-1,-1
RECMUS.txt,180085,182796,2711,20,Y,N,-,-1,-1
RECMUS.txt,180650,183116,2466,20,Y,N,-,-1,-1
RECMUS.txt,181234,183605,2371,20,Y,N,-,-1,-1
RECMUS.txt,182102,183901,1799,20,N,N,-,-1,-1
RECMUS.txt,182797,184448,1651,20,N,N,-,-1,-1
RECMUS.txt,183118,184775,1657,20,N,N,-,-1,-1
RECMUS.txt,183606,185063,1457,20,N,N,-,-1,-1
RECMUS.txt,183902,185454,1552,20,N,N,-,-1,-1
RECMUS.txt,184449,185972,1523,20,N,N,-,-1,-1
RECMUS.txt,184776,186379,1603,20,N,N,-,-1,-1
RECMUS.txt,185064,187065,2001,20,Y,N,-,-1,-1
RECMUS.txt,185455,187638,2183,20,Y,N,-,-1,-1
RECMUS.txt,185973,188358,2385,20,Y,N,-,-1,-1
RECMUS.txt,186380,188765,2385,20,Y,Y,1429532686038,188361,188583
RECMUS.txt,187068,189181,2113,20,Y,Y,1429532686038,188361,188583
RECMUS.txt,187639,189703,2064,20,Y,Y,1429532686038,188361,188583
RECMUS.txt,188359,190255,1896,20,Y,Y,1429532686038,188361,188583
RECMUS.txt,188766,191203,2437,20,Y,N,-,-1,-1
RECMUS.txt,189182,192217,3035,20,Y,N,-,-1,-1
RECMUS.txt,189705,192997,3292,20,Y,N,-,-1,-1
RECMUS.txt,190256,193886,3630,20,Y,N,-,-1,-1
RECMUS.txt,191204,194479,3275,20,Y,N,-,-1,-1
RECMUS.txt,192220,195075,2855,20,Y,N,-,-1,-1
RECMUS.txt,192998,195353,2355,20,Y,N,-,-1,-1
RECMUS.txt,193889,196136,2247,20,Y,N,-,-1,-1
RECMUS.txt,194480,197645,3165,20,Y,Y,1429535538810,196482,199062
RECMUS.txt,195077,198393,3316,20,Y,Y,1429535538810,196482,199062
RECMUS.txt,195356,198736,3380,20,Y,Y,1429535538810,196482,199062
RECMUS.txt,196139,199182,3043,20,Y,Y,1429535538810,196482,199062
RECMUS.txt,197646,200097,2451,20,Y,Y,1429535538810,196482,199062
RECMUS.txt,198395,200977,2582,20,Y,Y,1429535538810,196482,199062
RECMUS.txt,198737,201821,3084,20,Y,Y,1429535538810,196482,199062
RECMUS.txt,199183,202565,3382,20,Y,N,-,-1,-1
RECMUS.txt,200098,202952,2854,20,Y,N,-,-1,-1
RECMUS.txt,200980,203463,2483,20,Y,N,-,-1,-1
RECMUS.txt,201822,204000,2178,20,Y,N,-,-1,-1
RECMUS.txt,202566,204287,1721,20,Y,N,-,-1,-1
RECMUS.txt,202953,205308,2355,20,Y,N,-,-1,-1
RECMUS.txt,203466,205773,2307,20,Y,N,-,-1,-1
RECMUS.txt,204001,206358,2357,20,Y,N,-,-1,-1
RECMUS.txt,204288,207012,2724,20,Y,N,-,-1,-1
RECMUS.txt,205313,207691,2378,20,Y,N,-,-1,-1
RECMUS.txt,205776,208510,2734,20,Y,N,-,-1,-1
RECMUS.txt,206359,209417,3058,20,Y,N,-,-1,-1
RECMUS.txt,207013,210075,3062,20,Y,N,-,-1,-1
RECMUS.txt,207696,210669,2973,20,Y,N,-,-1,-1
RECMUS.txt,208512,211226,2714,20,Y,N,-,-1,-1
RECMUS.txt,209418,211622,2204,20,Y,N,-,-1,-1
RECMUS.txt,210080,212067,1987,20,Y,N,-,-1,-1
RECMUS.txt,210670,212575,1905,20,Y,N,-,-1,-1
RECMUS.txt,211227,213253,2026,20,Y,N,-,-1,-1
RECMUS.txt,211623,213781,2158,20,Y,N,-,-1,-1
RECMUS.txt,212070,214381,2311,20,Y,N,-,-1,-1
RECMUS.txt,212576,215341,2765,20,Y,N,-,-1,-1
RECMUS.txt,213256,215932,2676,20,Y,N,-,-1,-1
RECMUS.txt,213782,216862,3080,20,Y,N,-,-1,-1
RECMUS.txt,214382,217252,2870,20,Y,N,-,-1,-1
RECMUS.txt,215342,218073,2731,20,Y,N,-,-1,-1
RECMUS.txt,215937,218860,2923,20,Y,N,-,-1,-1
RECMUS.txt,216863,219614,2751,20,Y,N,-,-1,-1
RECMUS.txt,217253,220152,2899,20,Y,N,-,-1,-1
RECMUS.txt,218074,221327,3253,20,Y,N,-,-1,-1
RECMUS.txt,218861,222178,3317,20,Y,N,-,-1,-1
RECMUS.txt,219615,222718,3103,20,Y,N,-,-1,-1
RECMUS.txt,220157,223238,3081,20,Y,N,-,-1,-1
RECMUS.txt,221328,223800,2472,20,Y,N,-,-1,-1
RECMUS.txt,222179,224431,2252,20,Y,N,-,-1,-1
RECMUS.txt,222719,224959,2240,20,Y,N,-,-1,-1
RECMUS.txt,223239,225303,2064,20,Y,N,-,-1,-1
RECMUS.txt,223801,226143,2342,20,Y,N,-,-1,-1
RECMUS.txt,224432,226517,2085,20,Y,N,-,-1,-1
RECMUS.txt,224964,226984,2020,20,Y,N,-,-1,-1
RECMUS.txt,225304,227430,2126,20,Y,N,-,-1,-1
RECMUS.txt,226144,227992,1848,20,Y,N,-,-1,-1
RECMUS.txt,226518,228648,2130,20,Y,N,-,-1,-1
RECMUS.txt,226985,229287,2302,20,Y,N,-,-1,-1
RECMUS.txt,227431,230337,2906,20,Y,N,-,-1,-1
RECMUS.txt,227993,231279,3286,20,Y,N,-,-1,-1
RECMUS.txt,228649,232153,3504,20,Y,N,-,-1,-1
RECMUS.txt,229288,232737,3449,20,Y,N,-,-1,-1
RECMUS.txt,230338,233003,2665,20,Y,N,-,-1,-1
RECMUS.txt,231282,233604,2322,20,Y,N,-,-1,-1
RECMUS.txt,232154,234490,2336,20,Y,N,-,-1,-1
RECMUS.txt,232738,235449,2711,20,Y,N,-,-1,-1
RECMUS.txt,233004,235933,2929,20,Y,N,-,-1,-1
RECMUS.txt,233606,236482,2876,20,Y,N,-,-1,-1
RECMUS.txt,234491,237305,2814,20,Y,N,-,-1,-1
RECMUS.txt,235452,237931,2479,20,Y,N,-,-1,-1
RECMUS.txt,235934,238372,2438,20,Y,N,-,-1,-1
RECMUS.txt,236483,238607,2124,20,Y,N,-,-1,-1
RECMUS.txt,237306,239107,1801,20,Y,N,-,-1,-1
RECMUS.txt,237932,239852,1920,20,Y,N,-,-1,-1
RECMUS.txt,238373,240189,1816,20,Y,N,-,-1,-1
RECMUS.txt,238608,240819,2211,20,Y,N,-,-1,-1
RECMUS.txt,239108,241434,2326,20,Y,N,-,-1,-1
RECMUS.txt,239855,242010,2155,20,Y,N,-,-1,-1
RECMUS.txt,240192,242588,2396,20,Y,N,-,-1,-1
RECMUS.txt,240820,243182,2362,20,Y,N,-,-1,-1
RECMUS.txt,241435,244051,2616,20,Y,N,-,-1,-1
RECMUS.txt,242011,244409,2398,20,Y,N,-,-1,-1
RECMUS.txt,242593,245088,2495,20,Y,N,-,-1,-1
RECMUS.txt,243183,246004,2821,20,Y,N,-,-1,-1
RECMUS.txt,244052,246565,2513,20,Y,N,-,-1,-1
RECMUS.txt,244412,247362,2950,20,Y,N,-,-1,-1
RECMUS.txt,245089,248113,3024,20,Y,N,-,-1,-1
RECMUS.txt,246005,248546,2541,20,Y,N,-,-1,-1
RECMUS.txt,246570,249294,2724,20,Y,N,-,-1,-1
RECMUS.txt,247363,250332,2969,20,Y,N,-,-1,-1
RECMUS.txt,248114,250879,2765,20,Y,N,-,-1,-1
RECMUS.txt,248547,251465,2918,20,Y,N,-,-1,-1
RECMUS.txt,249295,252067,2772,20,Y,N,-,-1,-1
RECMUS.txt,250333,252443,2110,20,Y,N,-,-1,-1
RECMUS.txt,250880,252695,1815,20,Y,N,-,-1,-1
RECMUS.txt,251466,253043,1577,20,Y,N,-,-1,-1
RECMUS.txt,252068,253948,1880,20,Y,N,-,-1,-1
RECMUS.txt,252444,254503,2059,20,Y,N,-,-1,-1
RECMUS.txt,252696,254949,2253,20,Y,N,-,-1,-1
RECMUS.txt,253044,255425,2381,20,Y,N,-,-1,-1
RECMUS.txt,253949,256030,2081,20,Y,N,-,-1,-1
RECMUS.txt,254504,256207,1703,20,Y,N,-,-1,-1
RECMUS.txt,254950,256886,1936,20,Y,N,-,-1,-1
RECMUS.txt,255430,257442,2012,20,Y,N,-,-1,-1
RECMUS.txt,256033,258139,2106,20,Y,N,-,-1,-1
RECMUS.txt,256210,258454,2244,20,Y,N,-,-1,-1
RECMUS.txt,256889,259167,2278,20,Y,N,-,-1,-1
RECMUS.txt,257445,259598,2153,20,N,N,-,-1,-1
RECMUS.txt,258140,260078,1938,20,Y,N,-,-1,-1
RECMUS.txt,258457,260309,1852,20,Y,N,-,-1,-1
RECMUS.txt,259170,261000,1830,20,Y,N,-,-1,-1
RECMUS.txt,259601,261830,2229,20,Y,N,-,-1,-1
RECMUS.txt,260078,262293,2215,20,Y,N,-,-1,-1
RECMUS.txt,260311,262774,2463,20,Y,N,-,-1,-1
RECMUS.txt,261001,263160,2159,20,Y,Y,1429610699650,262775,263040
RECMUS.txt,261831,264462,2631,20,Y,Y,1429610699650,262775,263040
RECMUS.txt,262294,264879,2585,20,Y,Y,1429610699650,262775,263040
RECMUS.txt,262777,265631,2854,20,Y,Y,1429610699650,262775,263040
RECMUS.txt,263161,266288,3127,20,Y,N,-,-1,-1
RECMUS.txt,264463,266543,2080,20,Y,N,-,-1,-1
RECMUS.txt,264880,267593,2713,20,Y,N,-,-1,-1
RECMUS.txt,265632,269120,3488,20,Y,N,-,-1,-1
RECMUS.txt,266289,270031,3742,20,Y,N,-,-1,-1
RECMUS.txt,266544,270700,4156,20,Y,N,-,-1,-1
RECMUS.txt,267594,271060,3466,20,Y,N,-,-1,-1
RECMUS.txt,269121,271746,2625,20,Y,N,-,-1,-1
RECMUS.txt,270032,272741,2709,20,Y,N,-,-1,-1
RECMUS.txt,270701,273174,2473,20,Y,N,-,-1,-1
RECMUS.txt,271061,273484,2423,20,Y,N,-,-1,-1
RECMUS.txt,271747,273817,2070,20,Y,N,-,-1,-1
RECMUS.txt,272742,274553,1811,20,Y,N,-,-1,-1
RECMUS.txt,273175,275480,2305,20,Y,N,-,-1,-1
RECMUS.txt,273485,276171,2686,20,Y,N,-,-1,-1
RECMUS.txt,273820,276613,2793,20,Y,N,-,-1,-1
RECMUS.txt,274554,277576,3022,20,Y,N,-,-1,-1
RECMUS.txt,275481,278030,2549,20,Y,N,-,-1,-1
RECMUS.txt,276172,278410,2238,20,Y,N,-,-1,-1
RECMUS.txt,276614,278839,2225,20,Y,N,-,-1,-1
RECMUS.txt,277577,279272,1695,20,Y,N,-,-1,-1
RECMUS.txt,278031,279851,1820,20,Y,N,-,-1,-1
RECMUS.txt,278411,280234,1823,20,Y,N,-,-1,-1
RECMUS.txt,278840,281175,2335,20,Y,N,-,-1,-1
RECMUS.txt,279274,282112,2838,20,Y,N,-,-1,-1
RECMUS.txt,279852,283677,3825,20,Y,N,-,-1,-1
RECMUS.txt,280235,284801,4566,20,Y,N,-,-1,-1
RECMUS.txt,281176,285522,4346,20,Y,N,-,-1,-1
RECMUS.txt,282114,286437,4323,20,Y,N,-,-1,-1
RECMUS.txt,283678,287258,3580,20,Y,N,-,-1,-1
RECMUS.txt,284802,287883,3081,20,Y,N,-,-1,-1
RECMUS.txt,285523,288543,3020,20,Y,N,-,-1,-1
RECMUS.txt,286438,289231,2793,20,Y,N,-,-1,-1
RECMUS.txt,287259,290221,2962,20,Y,N,-,-1,-1
RECMUS.txt,287884,291336,3452,20,Y,N,-,-1,-1
RECMUS.txt,288544,291938,3394,20,Y,N,-,-1,-1
RECMUS.txt,289231,293141,3910,20,Y,N,-,-1,-1
RECMUS.txt,290224,293681,3457,20,Y,N,-,-1,-1
RECMUS.txt,291339,294514,3175,20,Y,N,-,-1,-1
RECMUS.txt,291939,295229,3290,20,Y,N,-,-1,-1
RECMUS.txt,293142,295679,2537,20,Y,N,-,-1,-1
RECMUS.txt,293683,296188,2505,20,Y,N,-,-1,-1
RECMUS.txt,294515,297097,2582,20,Y,N,-,-1,-1
RECMUS.txt,295230,297810,2580,20,Y,N,-,-1,-1
RECMUS.txt,295682,298735,3053,20,Y,N,-,-1,-1
RECMUS.txt,296188,299634,3446,20,Y,N,-,-1,-1
RECMUS.txt,297098,300115,3017,20,Y,N,-,-1,-1
RECMUS.txt,297811,300415,2604,20,Y,N,-,-1,-1
RECMUS.txt,298736,300932,2196,20,Y,N,-,-1,-1
RECMUS.txt,299636,301212,1576,20,Y,N,-,-1,-1
RECMUS.txt,300118,301391,1273,20,N,N,-,-1,-1
RECMUS.txt,300420,302176,1756,20,N,N,-,-1,-1
RECMUS.txt,300934,302805,1871,20,N,N,-,-1,-1
RECMUS.txt,301215,303396,2181,20,Y,N,-,-1,-1
RECMUS.txt,301392,304128,2736,20,Y,N,-,-1,-1
RECMUS.txt,302177,304636,2459,20,Y,N,-,-1,-1
RECMUS.txt,302806,305262,2456,20,Y,N,-,-1,-1
RECMUS.txt,303399,305870,2471,20,Y,N,-,-1,-1
RECMUS.txt,304129,306622,2493,20,Y,N,-,-1,-1
RECMUS.txt,304639,307689,3050,20,Y,N,-,-1,-1
RECMUS.txt,305263,308299,3036,20,Y,N,-,-1,-1
RECMUS.txt,305871,309466,3595,20,Y,N,-,-1,-1
RECMUS.txt,306622,310568,3946,20,Y,N,-,-1,-1
RECMUS.txt,307690,311252,3562,20,Y,N,-,-1,-1
RECMUS.txt,308300,312286,3986,20,Y,N,-,-1,-1
RECMUS.txt,309467,312848,3381,20,Y,N,-,-1,-1
RECMUS.txt,310568,313673,3105,20,Y,N,-,-1,-1
RECMUS.txt,311253,314592,3339,20,Y,N,-,-1,-1
RECMUS.txt,312287,315231,2944,20,Y,N,-,-1,-1
RECMUS.txt,312849,316159,3310,20,N,N,-,-1,-1
RECMUS.txt,313674,316401,2727,20,Y,N,-,-1,-1
RECMUS.txt,314593,316654,2061,20,Y,N,-,-1,-1
RECMUS.txt,315234,317120,1886,20,Y,N,-,-1,-1
RECMUS.txt,316161,317672,1511,20,Y,Y,1429618477739,317165,317427
RECMUS.txt,316403,318147,1744,20,Y,Y,1429618477739,317165,317427
RECMUS.txt,316659,318578,1919,20,Y,Y,1429618477739,317165,317427
RECMUS.txt,317123,319359,2236,20,Y,Y,1429618477739,317165,317427
RECMUS.txt,317673,320159,2486,20,Y,N,-,-1,-1
RECMUS.txt,318148,320757,2609,20,Y,N,-,-1,-1
RECMUS.txt,318579,321318,2739,20,Y,N,-,-1,-1
RECMUS.txt,319361,322036,2675,20,Y,N,-,-1,-1
RECMUS.txt,320161,322478,2317,20,Y,N,-,-1,-1
RECMUS.txt,320757,323554,2797,20,Y,N,-,-1,-1
RECMUS.txt,321319,324153,2834,20,Y,N,-,-1,-1
RECMUS.txt,322037,325061,3024,20,Y,N,-,-1,-1
RECMUS.txt,322479,325586,3107,20,Y,N,-,-1,-1
RECMUS.txt,323555,326324,2769,20,Y,Y,1429619541244,325924,326642
RECMUS.txt,324154,326719,2565,20,Y,Y,1429619541244,325924,326642
RECMUS.txt,325062,327173,2111,20,Y,Y,1429619541244,325924,326642
RECMUS.txt,325587,327827,2240,20,Y,Y,1429619541244,325924,326642
RECMUS.txt,326329,328562,2233,20,Y,Y,1429619541244,325924,326642
RECMUS.txt,326720,328833,2113,20,Y,Y,1429620133235,326889,327207
RECMUS.txt,327174,329239,2065,20,Y,Y,1429620133235,326889,327207
RECMUS.txt,327828,330372,2544,20,Y,N,-,-1,-1
RECMUS.txt,328567,330892,2325,20,Y,N,-,-1,-1
RECMUS.txt,328834,331501,2667,20,Y,N,-,-1,-1
RECMUS.txt,329240,332195,2955,20,Y,N,-,-1,-1
RECMUS.txt,330373,332910,2537,20,Y,N,-,-1,-1
RECMUS.txt,330893,333891,2998,20,Y,N,-,-1,-1
RECMUS.txt,331502,334458,2956,20,Y,N,-,-1,-1
RECMUS.txt,332196,335079,2883,20,Y,N,-,-1,-1
RECMUS.txt,332913,335760,2847,20,Y,N,-,-1,-1
RECMUS.txt,333894,336669,2775,20,Y,N,-,-1,-1
RECMUS.txt,334461,337639,3178,20,Y,N,-,-1,-1
RECMUS.txt,335080,338438,3358,20,Y,N,-,-1,-1
RECMUS.txt,335763,339097,3334,20,Y,N,-,-1,-1
RECMUS.txt,336670,339227,2557,20,Y,N,-,-1,-1
RECMUS.txt,337642,339620,1978,20,Y,N,-,-1,-1
RECMUS.txt,338441,340067,1626,20,N,N,-,-1,-1
RECMUS.txt,339098,341199,2101,20,N,N,-,-1,-1
RECMUS.txt,339228,342115,2887,20,Y,Y,1429621761088,341740,341892
RECMUS.txt,339625,342692,3067,20,Y,Y,1429621761088,341740,341892
RECMUS.txt,340068,343814,3746,20,Y,Y,1429621761088,341740,341892
RECMUS.txt,341202,344649,3447,20,Y,Y,1429621761088,341740,341892
RECMUS.txt,342116,345667,3551,20,Y,N,-,-1,-1
RECMUS.txt,342693,346247,3554,20,Y,N,-,-1,-1
RECMUS.txt,343817,346795,2978,20,Y,N,-,-1,-1
RECMUS.txt,344650,347487,2837,20,Y,N,-,-1,-1
RECMUS.txt,345668,349073,3405,20,Y,N,-,-1,-1
RECMUS.txt,346248,349748,3500,20,Y,N,-,-1,-1
RECMUS.txt,346798,350573,3775,20,Y,N,-,-1,-1
RECMUS.txt,347488,351245,3757,20,Y,N,-,-1,-1
RECMUS.txt,349073,351707,2634,20,Y,N,-,-1,-1
RECMUS.txt,349749,352400,2651,20,Y,N,-,-1,-1
RECMUS.txt,350574,353283,2709,20,Y,N,-,-1,-1
RECMUS.txt,351246,353684,2438,20,Y,N,-,-1,-1
RECMUS.txt,351708,354241,2533,20,Y,N,-,-1,-1
RECMUS.txt,352401,354890,2489,20,Y,N,-,-1,-1
RECMUS.txt,353284,355522,2238,20,Y,N,-,-1,-1
RECMUS.txt,353685,356186,2501,20,N,N,-,-1,-1
RECMUS.txt,354242,356917,2675,20,N,N,-,-1,-1
RECMUS.txt,354891,357367,2476,20,N,N,-,-1,-1
RECMUS.txt,355523,358045,2522,20,N,N,-,-1,-1
RECMUS.txt,356189,358391,2202,20,Y,N,-,-1,-1
RECMUS.txt,356918,358891,1973,20,Y,N,-,-1,-1
RECMUS.txt,357368,359841,2473,20,Y,N,-,-1,-1
RECMUS.txt,358047,360678,2631,20,Y,N,-,-1,-1
RECMUS.txt,358392,361557,3165,20,Y,N,-,-1,-1
RECMUS.txt,358892,362066,3174,20,Y,N,-,-1,-1
RECMUS.txt,359843,362527,2684,20,Y,N,-,-1,-1
RECMUS.txt,360679,363081,2402,20,Y,N,-,-1,-1
RECMUS.txt,361558,363722,2164,20,Y,N,-,-1,-1
RECMUS.txt,362068,364233,2165,20,Y,N,-,-1,-1
RECMUS.txt,362528,364835,2307,20,Y,N,-,-1,-1
RECMUS.txt,363084,365262,2178,20,Y,N,-,-1,-1
RECMUS.txt,363723,365796,2073,20,Y,N,-,-1,-1
RECMUS.txt,364234,366107,1873,20,Y,N,-,-1,-1
RECMUS.txt,364835,366949,2114,20,Y,N,-,-1,-1
RECMUS.txt,365263,367809,2546,20,Y,N,-,-1,-1
RECMUS.txt,365797,368614,2817,20,Y,N,-,-1,-1
RECMUS.txt,366110,369716,3606,20,Y,N,-,-1,-1
RECMUS.txt,366950,370879,3929,20,Y,N,-,-1,-1
RECMUS.txt,367810,371153,3343,20,Y,N,-,-1,-1
RECMUS.txt,368615,372466,3851,20,Y,N,-,-1,-1
RECMUS.txt,369718,372970,3252,20,Y,N,-,-1,-1
RECMUS.txt,370880,373614,2734,20,Y,N,-,-1,-1
RECMUS.txt,371154,374623,3469,20,Y,N,-,-1,-1
RECMUS.txt,372467,375313,2846,20,Y,N,-,-1,-1
RECMUS.txt,372973,375823,2850,20,Y,N,-,-1,-1
RECMUS.txt,373616,377066,3450,20,Y,N,-,-1,-1
RECMUS.txt,374624,377845,3221,20,Y,N,-,-1,-1
RECMUS.txt,375314,378842,3528,20,Y,N,-,-1,-1
RECMUS.txt,375824,379760,3936,20,Y,N,-,-1,-1
RECMUS.txt,377068,380466,3398,20,Y,N,-,-1,-1
RECMUS.txt,377846,381126,3280,20,Y,N,-,-1,-1
RECMUS.txt,378843,382475,3632,20,Y,N,-,-1,-1
RECMUS.txt,379765,383315,3550,20,Y,N,-,-1,-1
RECMUS.txt,380469,384503,4034,20,Y,N,-,-1,-1
RECMUS.txt,381129,384898,3769,20,Y,N,-,-1,-1
RECMUS.txt,382476,385371,2895,20,Y,N,-,-1,-1
RECMUS.txt,383318,386607,3289,20,Y,Y,1429703438525,385609,386315
RECMUS.txt,384504,387152,2648,20,Y,Y,1429703438525,385609,386315
RECMUS.txt,384899,387543,2644,20,Y,Y,1429703438525,385609,386315
RECMUS.txt,385372,387945,2573,20,Y,Y,1429703438525,385609,386315
RECMUS.txt,386608,389262,2654,20,Y,Y,1429703659582,387900,389542
RECMUS.txt,387154,389993,2839,20,Y,Y,1429703659582,387900,389542
RECMUS.txt,387544,390598,3054,20,Y,Y,1429703659582,387900,389542
RECMUS.txt,387946,390920,2974,20,Y,Y,1429703659582,387900,389542
RECMUS.txt,389263,391827,2564,20,Y,Y,1429703659582,387900,389542
RECMUS.txt,389994,392716,2722,20,Y,N,-,-1,-1
RECMUS.txt,390600,393202,2602,20,Y,N,-,-1,-1
RECMUS.txt,390921,393572,2651,20,Y,N,-,-1,-1
RECMUS.txt,391828,394023,2195,20,Y,N,-,-1,-1
RECMUS.txt,392719,394639,1920,20,Y,N,-,-1,-1
RECMUS.txt,393203,395319,2116,20,Y,N,-,-1,-1
RECMUS.txt,393573,396650,3077,20,Y,N,-,-1,-1
RECMUS.txt,394024,397058,3034,20,Y,N,-,-1,-1
RECMUS.txt,394640,398301,3661,20,Y,N,-,-1,-1
RECMUS.txt,395322,398940,3618,20,Y,N,-,-1,-1
RECMUS.txt,396651,399535,2884,20,Y,N,-,-1,-1
RECMUS.txt,397059,400416,3357,20,Y,N,-,-1,-1
RECMUS.txt,398302,401214,2912,20,Y,N,-,-1,-1
RECMUS.txt,398941,401934,2993,20,Y,N,-,-1,-1
RECMUS.txt,399536,402953,3417,20,Y,N,-,-1,-1
RECMUS.txt,400419,403959,3540,20,Y,N,-,-1,-1
RECMUS.txt,401215,404779,3564,20,Y,N,-,-1,-1
RECMUS.txt,401935,405199,3264,20,Y,N,-,-1,-1
RECMUS.txt,402956,405912,2956,20,Y,Y,1429958746761,405220,405568
RECMUS.txt,403962,406433,2471,20,Y,Y,1429958746761,405220,405568
RECMUS.txt,404780,406899,2119,20,Y,Y,1429958746761,405220,405568
RECMUS.txt,405202,407746,2544,20,Y,Y,1429958746761,405220,405568
RECMUS.txt,405913,408054,2141,20,Y,N,-,-1,-1
RECMUS.txt,406434,408474,2040,20,Y,N,-,-1,-1
RECMUS.txt,406902,409273,2371,20,Y,N,-,-1,-1
RECMUS.txt,407747,409675,1928,20,Y,N,-,-1,-1
RECMUS.txt,408055,410075,2020,20,Y,Y,1430061110446,409752,410058
RECMUS.txt,408477,410379,1902,20,Y,Y,1430061110446,409752,410058
RECMUS.txt,409274,410735,1461,20,Y,Y,1430061110446,409752,410058
RECMUS.txt,409675,411511,1836,20,Y,Y,1430061110446,409752,410058
RECMUS.txt,410076,412019,1943,20,Y,Y,1430062095918,410386,410666
RECMUS.txt,410380,412786,2406,20,Y,Y,1430062095918,410386,410666
RECMUS.txt,410736,413126,2390,20,Y,N,-,-1,-1
RECMUS.txt,411512,413670,2158,20,Y,N,-,-1,-1
RECMUS.txt,412020,414537,2517,20,Y,N,-,-1,-1
RECMUS.txt,412788,415609,2821,20,Y,N,-,-1,-1
RECMUS.txt,413127,415967,2840,20,Y,N,-,-1,-1
RECMUS.txt,413671,416644,2973,20,Y,N,-,-1,-1
RECMUS.txt,414538,417304,2766,20,Y,N,-,-1,-1
RECMUS.txt,415614,418365,2751,20,Y,N,-,-1,-1
RECMUS.txt,415968,419028,3060,20,Y,N,-,-1,-1
RECMUS.txt,416645,419356,2711,20,Y,N,-,-1,-1
RECMUS.txt,417305,419968,2663,20,Y,N,-,-1,-1
RECMUS.txt,418366,420656,2290,20,Y,N,-,-1,-1
RECMUS.txt,419029,421448,2419,20,Y,N,-,-1,-1
RECMUS.txt,419357,422089,2732,20,Y,N,-,-1,-1
RECMUS.txt,419969,422648,2679,20,Y,N,-,-1,-1
RECMUS.txt,420657,423473,2816,20,Y,Y,1430132370365,422842,422953
RECMUS.txt,421449,424376,2927,20,Y,Y,1430132370365,422842,422953
RECMUS.txt,422090,424914,2824,20,Y,Y,1430132370365,422842,422953
RECMUS.txt,422649,425608,2959,20,Y,Y,1430132370365,422842,422953
RECMUS.txt,423474,426368,2894,20,Y,N,-,-1,-1
RECMUS.txt,424377,427079,2702,20,Y,N,-,-1,-1
RECMUS.txt,424916,427384,2468,20,Y,N,-,-1,-1
RECMUS.txt,425609,428447,2838,20,Y,N,-,-1,-1
RECMUS.txt,426369,429145,2776,20,Y,N,-,-1,-1
RECMUS.txt,427082,429508,2426,20,Y,N,-,-1,-1
RECMUS.txt,427385,430085,2700,20,Y,N,-,-1,-1
RECMUS.txt,428448,430740,2292,20,Y,N,-,-1,-1
RECMUS.txt,429146,431387,2241,20,Y,N,-,-1,-1
RECMUS.txt,429510,432157,2647,20,Y,N,-,-1,-1
RECMUS.txt,430086,433156,3070,20,Y,N,-,-1,-1
RECMUS.txt,430741,433754,3013,20,Y,N,-,-1,-1
RECMUS.txt,431388,435060,3672,20,Y,N,-,-1,-1
RECMUS.txt,432158,435931,3773,20,Y,N,-,-1,-1
RECMUS.txt,433159,436751,3592,20,Y,N,-,-1,-1
RECMUS.txt,433755,437534,3779,20,Y,N,-,-1,-1
RECMUS.txt,435063,438247,3184,20,Y,N,-,-1,-1
RECMUS.txt,435933,438877,2944,20,Y,N,-,-1,-1
RECMUS.txt,436752,439198,2446,20,Y,N,-,-1,-1
RECMUS.txt,437539,439610,2071,20,Y,N,-,-1,-1
RECMUS.txt,438248,440025,1777,20,Y,N,-,-1,-1
RECMUS.txt,438880,440455,1575,20,Y,N,-,-1,-1
RECMUS.txt,439199,441156,1957,20,Y,N,-,-1,-1
RECMUS.txt,439611,441888,2277,20,Y,N,-,-1,-1
RECMUS.txt,440026,442738,2712,20,Y,N,-,-1,-1
RECMUS.txt,440456,443527,3071,20,Y,N,-,-1,-1
RECMUS.txt,441157,444413,3256,20,Y,N,-,-1,-1
RECMUS.txt,441889,444863,2974,20,Y,Y,1430143421055,444786,444985
RECMUS.txt,442739,445828,3089,20,Y,Y,1430143421055,444786,444985
RECMUS.txt,443529,446899,3370,20,Y,Y,1430143421055,444786,444985
RECMUS.txt,444414,447834,3420,20,Y,Y,1430143421055,444786,444985
RECMUS.txt,444864,448608,3744,20,Y,Y,1430143421055,444786,444985
RECMUS.txt,445829,449291,3462,20,Y,N,-,-1,-1
RECMUS.txt,446904,450076,3172,20,Y,N,-,-1,-1
RECMUS.txt,447835,450676,2841,20,Y,N,-,-1,-1
RECMUS.txt,448611,451219,2608,20,Y,N,-,-1,-1
RECMUS.txt,449292,452451,3159,20,Y,N,-,-1,-1
RECMUS.txt,450079,453017,2938,20,Y,N,-,-1,-1
RECMUS.txt,450677,453595,2918,20,Y,N,-,-1,-1
RECMUS.txt,451220,454273,3053,20,Y,N,-,-1,-1
RECMUS.txt,452454,455198,2744,20,Y,N,-,-1,-1
RECMUS.txt,453018,455948,2930,20,Y,N,-,-1,-1
RECMUS.txt,453600,456607,3007,20,Y,N,-,-1,-1
RECMUS.txt,454276,457046,2770,20,Y,N,-,-1,-1
RECMUS.txt,455201,457792,2591,20,Y,N,-,-1,-1
RECMUS.txt,455949,458494,2545,20,Y,N,-,-1,-1
RECMUS.txt,456608,459512,2904,20,Y,N,-,-1,-1
RECMUS.txt,457047,460416,3369,20,Y,N,-,-1,-1
RECMUS.txt,457795,461094,3299,20,Y,N,-,-1,-1
RECMUS.txt,458495,461235,2740,20,Y,N,-,-1,-1
RECMUS.txt,459513,461294,1781,20,Y,N,-,-1,-1
RECMUS.txt,460417,461386,969,20,Y,N,-,-1,-1
RECMUS.txt,461098,461556,458,20,N,N,-,-1,-1
RECMUS.txt,461236,461656,420,20,N,N,-,-1,-1
RECMUS.txt,461295,461712,417,20,N,N,-,-1,-1
RECMUS.txt,461386,461818,432,20,N,N,-,-1,-1
RECMUS.txt,461557,462351,794,20,N,N,-,-1,-1
RECMUS.txt,461657,463299,1642,20,Y,N,-,-1,-1
RECMUS.txt,461713,463820,2107,20,Y,N,-,-1,-1
RECMUS.txt,461818,464502,2684,20,Y,N,-,-1,-1
RECMUS.txt,462352,465513,3161,20,Y,Y,1430146867800,465338,465502
RECMUS.txt,463300,466671,3371,20,Y,Y,1430146867800,465338,465502
RECMUS.txt,463821,466975,3154,20,Y,Y,1430146867800,465338,465502
RECMUS.txt,464503,468046,3543,20,Y,Y,1430146867800,465338,465502
RECMUS.txt,465514,468931,3417,20,Y,N,-,-1,-1
RECMUS.txt,466672,469459,2787,20,Y,N,-,-1,-1
RECMUS.txt,466976,470181,3205,20,Y,N,-,-1,-1
RECMUS.txt,468046,471285,3239,20,Y,N,-,-1,-1
RECMUS.txt,468932,471966,3034,20,Y,N,-,-1,-1
RECMUS.txt,469460,472555,3095,20,Y,N,-,-1,-1
RECMUS.txt,470182,473047,2865,20,Y,N,-,-1,-1
RECMUS.txt,471286,473321,2035,20,Y,N,-,-1,-1
RECMUS.txt,471967,473942,1975,20,Y,N,-,-1,-1
RECMUS.txt,472556,474546,1990,20,Y,N,-,-1,-1
RECMUS.txt,473048,475346,2298,20,Y,N,-,-1,-1
RECMUS.txt,473322,476137,2815,20,Y,N,-,-1,-1
RECMUS.txt,473943,477172,3229,20,Y,N,-,-1,-1
RECMUS.txt,474547,477865,3318,20,Y,N,-,-1,-1
RECMUS.txt,475347,478417,3070,20,Y,N,-,-1,-1
RECMUS.txt,476138,478806,2668,20,Y,N,-,-1,-1
RECMUS.txt,477175,479436,2261,20,Y,N,-,-1,-1
RECMUS.txt,477866,479897,2031,20,Y,N,-,-1,-1
RECMUS.txt,478418,480176,1758,20,Y,N,-,-1,-1
RECMUS.txt,478807,480663,1856,20,Y,N,-,-1,-1
RECMUS.txt,479437,481372,1935,20,Y,N,-,-1,-1
RECMUS.txt,479898,482188,2290,20,Y,N,-,-1,-1
RECMUS.txt,480177,482731,2554,20,Y,N,-,-1,-1
RECMUS.txt,480664,483288,2624,20,Y,N,-,-1,-1
RECMUS.txt,481373,483803,2430,20,Y,N,-,-1,-1
RECMUS.txt,482189,484372,2183,20,Y,N,-,-1,-1
RECMUS.txt,482732,485321,2589,20,Y,N,-,-1,-1
RECMUS.txt,483289,485659,2370,20,Y,N,-,-1,-1
RECMUS.txt,483804,486165,2361,20,Y,N,-,-1,-1
RECMUS.txt,484373,486450,2077,20,Y,N,-,-1,-1
RECMUS.txt,485322,486994,1672,20,Y,N,-,-1,-1
RECMUS.txt,485660,487463,1803,20,Y,N,-,-1,-1
RECMUS.txt,486167,488042,1875,20,Y,N,-,-1,-1
RECMUS.txt,486451,488290,1839,20,Y,N,-,-1,-1
RECMUS.txt,486995,488799,1804,20,Y,N,-,-1,-1
RECMUS.txt,487464,489010,1546,20,Y,N,-,-1,-1
RECMUS.txt,488045,489340,1295,20,Y,N,-,-1,-1
RECMUS.txt,488291,490022,1731,20,Y,N,-,-1,-1
RECMUS.txt,488800,490462,1662,20,Y,N,-,-1,-1
RECMUS.txt,489011,490717,1706,20,Y,N,-,-1,-1
RECMUS.txt,489341,491163,1822,20,Y,N,-,-1,-1
RECMUS.txt,490024,491472,1448,20,Y,N,-,-1,-1
RECMUS.txt,490463,492055,1592,20,Y,N,-,-1,-1
RECMUS.txt,490718,492677,1959,20,Y,N,-,-1,-1
RECMUS.txt,491166,493635,2469,20,Y,N,-,-1,-1
RECMUS.txt,491473,494312,2839,20,Y,N,-,-1,-1
RECMUS.txt,492056,495033,2977,20,Y,N,-,-1,-1
RECMUS.txt,492678,495867,3189,20,Y,N,-,-1,-1
RECMUS.txt,493637,497072,3435,20,Y,N,-,-1,-1
RECMUS.txt,494313,497733,3420,20,Y,N,-,-1,-1
RECMUS.txt,495034,498289,3255,20,Y,N,-,-1,-1
RECMUS.txt,495868,498937,3069,20,Y,N,-,-1,-1
RECMUS.txt,497073,499385,2312,20,Y,N,-,-1,-1
RECMUS.txt,497734,500032,2298,20,Y,N,-,-1,-1
RECMUS.txt,498292,500705,2413,20,Y,N,-,-1,-1
RECMUS.txt,498938,501493,2555,20,Y,N,-,-1,-1
RECMUS.txt,499386,502321,2935,20,Y,N,-,-1,-1
RECMUS.txt,500035,503107,3072,20,Y,N,-,-1,-1
RECMUS.txt,500708,503990,3282,20,Y,N,-,-1,-1
RECMUS.txt,501494,504797,3303,20,Y,N,-,-1,-1
RECMUS.txt,502322,505370,3048,20,Y,N,-,-1,-1
RECMUS.txt,503108,505950,2842,20,Y,N,-,-1,-1
RECMUS.txt,503990,506774,2784,20,Y,Y,1430222777118,506387,506555
RECMUS.txt,504798,507291,2493,20,Y,Y,1430222777118,506387,506555
RECMUS.txt,505371,507834,2463,20,Y,Y,1430222777118,506387,506555
RECMUS.txt,505952,508911,2959,20,Y,Y,1430222777118,506387,506555
RECMUS.txt,506775,509306,2531,20,Y,N,-,-1,-1
RECMUS.txt,507292,510263,2971,20,Y,N,-,-1,-1
RECMUS.txt,507835,511132,3297,20,Y,N,-,-1,-1
RECMUS.txt,508914,512262,3348,20,Y,N,-,-1,-1
RECMUS.txt,509307,513044,3737,20,Y,N,-,-1,-1
RECMUS.txt,510264,513911,3647,20,Y,N,-,-1,-1
RECMUS.txt,511133,514731,3598,20,Y,N,-,-1,-1
RECMUS.txt,512263,515263,3000,20,Y,N,-,-1,-1
RECMUS.txt,513045,515876,2831,20,Y,N,-,-1,-1
RECMUS.txt,513912,516531,2619,20,Y,N,-,-1,-1
RECMUS.txt,514732,517529,2797,20,Y,Y,1430310307659,517170,517520
RECMUS.txt,515264,518061,2797,20,Y,Y,1430310307659,517170,517520
RECMUS.txt,515876,518494,2618,20,Y,Y,1430310307659,517170,517520
RECMUS.txt,516532,519425,2893,20,Y,Y,1430310307659,517170,517520
RECMUS.txt,517530,520209,2679,20,Y,N,-,-1,-1
RECMUS.txt,518062,521209,3147,20,Y,Y,1430312272173,520626,520894
RECMUS.txt,518495,522167,3672,20,Y,Y,1430312272173,520626,520894
RECMUS.txt,519426,523079,3653,20,Y,Y,1430312272173,520626,520894
RECMUS.txt,520210,524004,3794,20,Y,Y,1430312272173,520626,520894
RECMUS.txt,521214,524676,3462,20,Y,N,-,-1,-1
RECMUS.txt,522168,525643,3475,20,Y,N,-,-1,-1
RECMUS.txt,523080,526346,3266,20,Y,N,-,-1,-1
RECMUS.txt,524007,527071,3064,20,Y,N,-,-1,-1
RECMUS.txt,524677,527962,3285,20,Y,N,-,-1,-1
RECMUS.txt,525644,528610,2966,20,Y,N,-,-1,-1
RECMUS.txt,526349,529595,3246,20,Y,N,-,-1,-1
RECMUS.txt,527072,530763,3691,20,Y,N,-,-1,-1
RECMUS.txt,527963,531219,3256,20,Y,N,-,-1,-1
RECMUS.txt,528611,532165,3554,20,Y,N,-,-1,-1
RECMUS.txt,529596,533057,3461,20,Y,N,-,-1,-1
RECMUS.txt,530764,534379,3615,20,Y,N,-,-1,-1
RECMUS.txt,531222,535588,4366,20,Y,Y,1430813590521,534892,535075
RECMUS.txt,532166,536434,4268,20,Y,Y,1430813590521,534892,535075
RECMUS.txt,533058,537585,4527,20,Y,Y,1430813590521,534892,535075
RECMUS.txt,534380,538210,3830,20,Y,Y,1430813590521,534892,535075
RECMUS.txt,535589,539162,3573,20,Y,N,-,-1,-1
RECMUS.txt,536435,539851,3416,20,Y,N,-,-1,-1
RECMUS.txt,537588,540703,3115,20,Y,N,-,-1,-1
RECMUS.txt,538213,541273,3060,20,Y,N,-,-1,-1
RECMUS.txt,539163,541932,2769,20,Y,Y,1430814562699,541292,541683
RECMUS.txt,539852,543209,3357,20,Y,Y,1430814562699,541292,541683
RECMUS.txt,540704,543859,3155,20,Y,Y,1430814562699,541292,541683
RECMUS.txt,541274,544533,3259,20,Y,Y,1430814562699,541292,541683
RECMUS.txt,541933,544870,2937,20,Y,N,-,-1,-1
RECMUS.txt,543210,545171,1961,20,Y,N,-,-1,-1
RECMUS.txt,543860,545888,2028,20,Y,N,-,-1,-1
RECMUS.txt,544534,546550,2016,20,Y,N,-,-1,-1
RECMUS.txt,544871,547298,2427,20,Y,N,-,-1,-1
RECMUS.txt,545174,547879,2705,20,Y,N,-,-1,-1
RECMUS.txt,545889,548425,2536,20,Y,N,-,-1,-1
RECMUS.txt,546551,549542,2991,20,Y,N,-,-1,-1
RECMUS.txt,547299,550488,3189,20,Y,N,-,-1,-1
RECMUS.txt,547880,551312,3432,20,Y,N,-,-1,-1
RECMUS.txt,548426,552296,3870,20,Y,N,-,-1,-1
RECMUS.txt,549545,552931,3386,20,Y,N,-,-1,-1
RECMUS.txt,550491,554189,3698,20,Y,N,-,-1,-1
RECMUS.txt,551313,555106,3793,20,Y,N,-,-1,-1
RECMUS.txt,552297,555876,3579,20,Y,N,-,-1,-1
RECMUS.txt,552932,556897,3965,20,Y,N,-,-1,-1
RECMUS.txt,554190,557829,3639,20,Y,N,-,-1,-1
RECMUS.txt,555107,559031,3924,20,Y,N,-,-1,-1
RECMUS.txt,555878,559484,3606,20,Y,N,-,-1,-1
RECMUS.txt,556898,560397,3499,20,Y,N,-,-1,-1
RECMUS.txt,557830,561451,3621,20,Y,N,-,-1,-1
RECMUS.txt,559033,562452,3419,20,Y,N,-,-1,-1
RECMUS.txt,559484,563589,4105,20,Y,N,-,-1,-1
RECMUS.txt,560398,564434,4036,20,Y,N,-,-1,-1
RECMUS.txt,561452,565294,3842,20,Y,N,-,-1,-1
RECMUS.txt,562454,566237,3783,20,Y,N,-,-1,-1
RECMUS.txt,563591,567268,3677,20,Y,N,-,-1,-1
RECMUS.txt,564435,568037,3602,20,Y,N,-,-1,-1
RECMUS.txt,565295,568850,3555,20,Y,N,-,-1,-1
RECMUS.txt,566238,569933,3695,20,Y,N,-,-1,-1
RECMUS.txt,567269,570529,3260,20,Y,N,-,-1,-1
RECMUS.txt,568040,571191,3151,20,Y,N,-,-1,-1
RECMUS.txt,568851,571876,3025,20,Y,N,-,-1,-1
RECMUS.txt,569934,572789,2855,20,Y,N,-,-1,-1
RECMUS.txt,570530,574150,3620,20,Y,N,-,-1,-1
RECMUS.txt,571192,574709,3517,20,Y,N,-,-1,-1
RECMUS.txt,571877,575753,3876,20,Y,N,-,-1,-1
RECMUS.txt,572790,576805,4015,20,Y,N,-,-1,-1
RECMUS.txt,574151,577430,3279,20,Y,N,-,-1,-1
RECMUS.txt,574710,578327,3617,20,Y,N,-,-1,-1
RECMUS.txt,575754,579155,3401,20,Y,N,-,-1,-1
RECMUS.txt,576807,579769,2962,20,Y,N,-,-1,-1
RECMUS.txt,577431,580668,3237,20,Y,N,-,-1,-1
RECMUS.txt,578328,581114,2786,20,Y,N,-,-1,-1
RECMUS.txt,579158,581574,2416,20,Y,N,-,-1,-1
RECMUS.txt,579770,582290,2520,20,Y,N,-,-1,-1
RECMUS.txt,580669,582920,2251,20,Y,Y,1430903585194,582416,582681
RECMUS.txt,581116,583282,2166,20,Y,Y,1430903585194,582416,582681
RECMUS.txt,581575,583897,2322,20,Y,Y,1430903585194,582416,582681
RECMUS.txt,582291,584377,2086,20,Y,Y,1430903585194,582416,582681
RECMUS.txt,582921,585108,2187,20,Y,N,-,-1,-1
RECMUS.txt,583283,585550,2267,20,Y,N,-,-1,-1
RECMUS.txt,583898,586205,2307,20,Y,Y,1430906475487,585907,586013
RECMUS.txt,584378,586664,2286,20,Y,Y,1430906475487,585907,586013
RECMUS.txt,585108,587325,2217,20,Y,Y,1430906475487,585907,586013
RECMUS.txt,585551,588279,2728,20,Y,Y,1430906475487,585907,586013
RECMUS.txt,586206,589217,3011,20,Y,N,-,-1,-1
RECMUS.txt,586665,589793,3128,20,Y,N,-,-1,-1
RECMUS.txt,587326,590373,3047,20,Y,N,-,-1,-1
RECMUS.txt,588282,591373,3091,20,Y,N,-,-1,-1
RECMUS.txt,589220,592049,2829,20,Y,N,-,-1,-1
RECMUS.txt,589794,592749,2955,20,Y,N,-,-1,-1
RECMUS.txt,590376,593480,3104,20,Y,N,-,-1,-1
RECMUS.txt,591374,594196,2822,20,Y,Y,1430917862299,593970,594073
RECMUS.txt,592050,594902,2852,20,Y,Y,1430917862299,593970,594073
RECMUS.txt,592750,595703,2953,20,Y,Y,1430917862299,593970,594073
RECMUS.txt,593481,596372,2891,20,Y,Y,1430917862299,593970,594073
RECMUS.txt,594197,597087,2890,20,Y,N,-,-1,-1
RECMUS.txt,594903,597919,3016,20,Y,N,-,-1,-1
RECMUS.txt,595704,598529,2825,20,Y,N,-,-1,-1
RECMUS.txt,596374,598905,2531,20,Y,N,-,-1,-1
RECMUS.txt,597088,599586,2498,20,Y,N,-,-1,-1
RECMUS.txt,597920,600369,2449,20,Y,N,-,-1,-1
RECMUS.txt,598530,600974,2444,20,Y,Y,1430919558858,600376,600634
RECMUS.txt,598906,601509,2603,20,Y,Y,1430919558858,600376,600634
RECMUS.txt,599587,602108,2521,20,Y,Y,1430919558858,600376,600634
RECMUS.txt,600370,603218,2848,20,Y,Y,1430920461435,602905,603306
RECMUS.txt,600975,603719,2744,20,Y,Y,1430920461435,602905,603306
RECMUS.txt,601510,604116,2606,20,Y,Y,1430920461435,602905,603306
RECMUS.txt,602109,604694,2585,20,Y,Y,1430920461435,602905,603306
RECMUS.txt,603219,605148,1929,20,Y,Y,1430920461435,602905,603306
RECMUS.txt,603724,605509,1785,20,Y,N,-,-1,-1
RECMUS.txt,604117,605965,1848,20,Y,N,-,-1,-1
RECMUS.txt,604697,606756,2059,20,Y,N,-,-1,-1
RECMUS.txt,605149,607001,1852,20,Y,N,-,-1,-1
RECMUS.txt,605510,607717,2207,20,Y,N,-,-1,-1
RECMUS.txt,605966,608391,2425,20,Y,N,-,-1,-1
RECMUS.txt,606757,609080,2323,20,Y,N,-,-1,-1
RECMUS.txt,607002,609361,2359,20,Y,N,-,-1,-1
RECMUS.txt,607718,609827,2109,20,Y,N,-,-1,-1
RECMUS.txt,608393,610349,1956,20,Y,N,-,-1,-1
RECMUS.txt,609081,610749,1668,20,Y,N,-,-1,-1
RECMUS.txt,609364,611333,1969,20,Y,Y,1431164339653,610804,611223
RECMUS.txt,609829,611609,1780,20,Y,Y,1431164339653,610804,611223
RECMUS.txt,610350,612166,1816,20,Y,Y,1431164339653,610804,611223
RECMUS.txt,610750,612709,1959,20,Y,Y,1431164339653,610804,611223
RECMUS.txt,611334,613255,1921,20,Y,N,-,-1,-1
RECMUS.txt,611610,613617,2007,20,Y,N,-,-1,-1
RECMUS.txt,612167,614104,1937,20,Y,N,-,-1,-1
RECMUS.txt,612712,614770,2058,20,Y,N,-,-1,-1
RECMUS.txt,613256,615274,2018,20,Y,N,-,-1,-1
RECMUS.txt,613618,615702,2084,20,Y,N,-,-1,-1
RECMUS.txt,614105,616263,2158,20,Y,N,-,-1,-1
RECMUS.txt,614771,616449,1678,20,Y,N,-,-1,-1
RECMUS.txt,615279,616681,1402,20,Y,N,-,-1,-1
RECMUS.txt,615705,617004,1299,20,Y,N,-,-1,-1
RECMUS.txt,616264,617473,1209,20,Y,N,-,-1,-1
RECMUS.txt,616452,618170,1718,20,Y,N,-,-1,-1
RECMUS.txt,616682,618940,2258,20,Y,N,-,-1,-1
RECMUS.txt,617007,619368,2361,20,Y,N,-,-1,-1
RECMUS.txt,617476,620016,2540,20,Y,N,-,-1,-1
RECMUS.txt,618171,621158,2987,20,Y,N,-,-1,-1
RECMUS.txt,618941,622119,3178,20,Y,N,-,-1,-1
RECMUS.txt,619369,623134,3765,20,Y,N,-,-1,-1
RECMUS.txt,620019,623516,3497,20,Y,N,-,-1,-1
RECMUS.txt,621161,623769,2608,20,Y,N,-,-1,-1
RECMUS.txt,622120,624691,2571,20,Y,N,-,-1,-1
RECMUS.txt,623135,625279,2144,20,Y,N,-,-1,-1
RECMUS.txt,623521,625944,2423,20,Y,N,-,-1,-1
RECMUS.txt,623771,627226,3455,20,Y,N,-,-1,-1
RECMUS.txt,624692,627885,3193,20,Y,N,-,-1,-1
RECMUS.txt,625280,628862,3582,20,Y,N,-,-1,-1
RECMUS.txt,625945,629428,3483,20,Y,N,-,-1,-1
RECMUS.txt,627227,630290,3063,20,Y,N,-,-1,-1
RECMUS.txt,627890,631004,3114,20,Y,N,-,-1,-1
RECMUS.txt,628863,632110,3247,20,Y,N,-,-1,-1
RECMUS.txt,629429,632678,3249,20,Y,N,-,-1,-1
RECMUS.txt,630295,633739,3444,20,Y,N,-,-1,-1
RECMUS.txt,631005,634712,3707,20,Y,N,-,-1,-1
RECMUS.txt,632111,635193,3082,20,Y,N,-,-1,-1
RECMUS.txt,632679,636048,3369,20,Y,N,-,-1,-1
RECMUS.txt,633742,636970,3228,20,Y,N,-,-1,-1
RECMUS.txt,634713,637389,2676,20,Y,N,-,-1,-1
RECMUS.txt,635194,638287,3093,20,Y,N,-,-1,-1
RECMUS.txt,636049,638918,2869,20,Y,N,-,-1,-1
RECMUS.txt,636973,639763,2790,20,Y,N,-,-1,-1
RECMUS.txt,637392,640632,3240,20,Y,Y,1431361104528,639924,640273
RECMUS.txt,638288,641220,2932,20,Y,Y,1431361104528,639924,640273
RECMUS.txt,638919,641602,2683,20,Y,Y,1431361104528,639924,640273
RECMUS.txt,639764,642052,2288,20,Y,Y,1431361104528,639924,640273
RECMUS.txt,640635,642822,2187,20,Y,N,-,-1,-1
RECMUS.txt,641222,643045,1823,20,Y,N,-,-1,-1
RECMUS.txt,641603,643802,2199,20,Y,N,-,-1,-1
RECMUS.txt,642053,644199,2146,20,Y,N,-,-1,-1
RECMUS.txt,642823,644906,2083,20,Y,N,-,-1,-1
RECMUS.txt,643048,645600,2552,20,Y,N,-,-1,-1
RECMUS.txt,643803,646305,2502,20,Y,N,-,-1,-1
RECMUS.txt,644200,647281,3081,20,Y,N,-,-1,-1
RECMUS.txt,644907,648560,3653,20,Y,N,-,-1,-1
RECMUS.txt,645601,649339,3738,20,Y,N,-,-1,-1
RECMUS.txt,646306,649818,3512,20,Y,N,-,-1,-1
RECMUS.txt,647282,650593,3311,20,Y,N,-,-1,-1
RECMUS.txt,648562,651616,3054,20,Y,N,-,-1,-1
RECMUS.txt,649339,652878,3539,20,Y,N,-,-1,-1
RECMUS.txt,649819,653693,3874,20,Y,N,-,-1,-1
RECMUS.txt,650595,654234,3639,20,Y,N,-,-1,-1
RECMUS.txt,651618,654806,3188,20,Y,N,-,-1,-1
RECMUS.txt,652883,655549,2666,20,Y,N,-,-1,-1
RECMUS.txt,653694,656571,2877,20,Y,N,-,-1,-1
RECMUS.txt,654235,657017,2782,20,Y,N,-,-1,-1
RECMUS.txt,654807,657593,2786,20,Y,N,-,-1,-1
RECMUS.txt,655552,658479,2927,20,Y,N,-,-1,-1
RECMUS.txt,656571,659136,2565,20,Y,N,-,-1,-1
RECMUS.txt,657018,659824,2806,20,Y,N,-,-1,-1
RECMUS.txt,657596,660505,2909,20,Y,N,-,-1,-1
RECMUS.txt,658480,661148,2668,20,Y,N,-,-1,-1
RECMUS.txt,659137,661727,2590,20,Y,N,-,-1,-1
RECMUS.txt,659825,662304,2479,20,Y,N,-,-1,-1
RECMUS.txt,660506,663199,2693,20,Y,N,-,-1,-1
RECMUS.txt,661149,664063,2914,20,Y,N,-,-1,-1
RECMUS.txt,661732,665009,3277,20,Y,N,-,-1,-1
RECMUS.txt,662306,665630,3324,20,Y,N,-,-1,-1
RECMUS.txt,663200,666599,3399,20,Y,N,-,-1,-1
RECMUS.txt,664068,666905,2837,20,Y,Y,1431440815809,666612,666881
RECMUS.txt,665014,667790,2776,20,Y,Y,1431440815809,666612,666881
RECMUS.txt,665631,668588,2957,20,Y,Y,1431440815809,666612,666881
RECMUS.txt,666602,669279,2677,20,Y,Y,1431445668256,668943,669143
RECMUS.txt,666905,669618,2713,20,Y,Y,1431445668256,668943,669143
RECMUS.txt,667793,670515,2722,20,Y,Y,1431445668256,668943,669143
RECMUS.txt,668589,671501,2912,20,Y,Y,1431445668256,668943,669143
RECMUS.txt,669280,672073,2793,20,Y,Y,1431446268360,670256,670506
RECMUS.txt,669621,672807,3186,20,Y,Y,1431446268360,670256,670506
RECMUS.txt,670515,673390,2875,20,Y,N,-,-1,-1
RECMUS.txt,671502,673676,2174,20,Y,N,-,-1,-1
RECMUS.txt,672074,674347,2273,20,Y,N,-,-1,-1
RECMUS.txt,672810,674816,2006,20,Y,N,-,-1,-1
RECMUS.txt,673391,675396,2005,20,Y,N,-,-1,-1
RECMUS.txt,673677,676091,2414,20,Y,N,-,-1,-1
RECMUS.txt,674348,676603,2255,20,Y,N,-,-1,-1
RECMUS.txt,674817,677025,2208,20,Y,N,-,-1,-1
RECMUS.txt,675397,677663,2266,20,Y,N,-,-1,-1
RECMUS.txt,676092,678074,1982,20,Y,N,-,-1,-1
RECMUS.txt,676604,678604,2000,20,Y,N,-,-1,-1
RECMUS.txt,677026,679306,2280,20,Y,N,-,-1,-1
RECMUS.txt,677666,680120,2454,20,Y,N,-,-1,-1
RECMUS.txt,678075,680652,2577,20,Y,Y,1431506517034,680207,680323
RECMUS.txt,678605,681357,2752,20,Y,Y,1431506517034,680207,680323
RECMUS.txt,679307,681943,2636,20,Y,Y,1431506517034,680207,680323
RECMUS.txt,680121,682685,2564,20,Y,Y,1431506517034,680207,680323
RECMUS.txt,680655,683297,2642,20,Y,N,-,-1,-1
RECMUS.txt,681358,684012,2654,20,Y,N,-,-1,-1
RECMUS.txt,681944,684675,2731,20,Y,N,-,-1,-1
RECMUS.txt,682688,685304,2616,20,Y,Y,1431508066369,685259,685876
RECMUS.txt,683299,685743,2444,20,Y,Y,1431508066369,685259,685876
RECMUS.txt,684013,686543,2530,20,Y,Y,1431508066369,685259,685876
RECMUS.txt,684676,687342,2666,20,Y,Y,1431508066369,685259,685876
RECMUS.txt,685305,687764,2459,20,Y,Y,1431508066369,685259,685876
RECMUS.txt,685745,688545,2800,20,Y,Y,1431508066369,685259,685876
RECMUS.txt,686544,689084,2540,20,Y,N,-,-1,-1
RECMUS.txt,687344,689393,2049,20,Y,N,-,-1,-1
RECMUS.txt,687766,689690,1924,20,Y,N,-,-1,-1
RECMUS.txt,688546,690238,1692,20,Y,Y,1431520391464,690129,690293
RECMUS.txt,689087,690525,1438,20,Y,Y,1431520391464,690129,690293
RECMUS.txt,689396,691406,2010,20,Y,Y,1431520391464,690129,690293
RECMUS.txt,689693,691948,2255,20,Y,Y,1431520391464,690129,690293
RECMUS.txt,690239,692633,2394,20,Y,Y,1431520391464,690129,690293
RECMUS.txt,690528,693322,2794,20,Y,N,-,-1,-1
RECMUS.txt,691407,694143,2736,20,Y,N,-,-1,-1
RECMUS.txt,691949,694907,2958,20,Y,N,-,-1,-1
RECMUS.txt,692635,695307,2672,20,Y,N,-,-1,-1
RECMUS.txt,693325,696193,2868,20,Y,N,-,-1,-1
RECMUS.txt,694144,697357,3213,20,Y,N,-,-1,-1
RECMUS.txt,694908,698028,3120,20,Y,N,-,-1,-1
RECMUS.txt,695308,698538,3230,20,Y,N,-,-1,-1
RECMUS.txt,696194,699335,3141,20,Y,N,-,-1,-1
RECMUS.txt,697358,700116,2758,20,Y,Y,1431686580301,699502,699758
RECMUS.txt,698029,700909,2880,20,Y,Y,1431686580301,699502,699758
RECMUS.txt,698539,701765,3226,20,Y,Y,1431686580301,699502,699758
RECMUS.txt,699336,702852,3516,20,Y,Y,1431686580301,699502,699758
RECMUS.txt,700118,703984,3866,20,Y,N,-,-1,-1
RECMUS.txt,700910,704651,3741,20,Y,N,-,-1,-1
RECMUS.txt,701766,704892,3126,20,Y,N,-,-1,-1
RECMUS.txt,702853,705195,2342,20,Y,Y,1431687599525,705104,705244
RECMUS.txt,703985,705665,1680,20,Y,Y,1431687599525,705104,705244
RECMUS.txt,704652,706328,1676,20,Y,Y,1431687599525,705104,705244
RECMUS.txt,704893,706847,1954,20,Y,Y,1431687599525,705104,705244
RECMUS.txt,705196,707074,1878,20,Y,Y,1431687599525,705104,705244
RECMUS.txt,705666,707496,1830,20,Y,N,-,-1,-1
RECMUS.txt,706329,708286,1957,20,Y,N,-,-1,-1
RECMUS.txt,706848,708678,1830,20,Y,N,-,-1,-1
RECMUS.txt,707075,709450,2375,20,Y,N,-,-1,-1
RECMUS.txt,707497,710376,2879,20,Y,N,-,-1,-1
RECMUS.txt,708287,711074,2787,20,Y,N,-,-1,-1
RECMUS.txt,708679,712132,3453,20,Y,N,-,-1,-1
RECMUS.txt,709451,712507,3056,20,Y,N,-,-1,-1
RECMUS.txt,710377,713257,2880,20,Y,N,-,-1,-1
RECMUS.txt,711079,714201,3122,20,Y,N,-,-1,-1
RECMUS.txt,712133,714825,2692,20,Y,N,-,-1,-1
RECMUS.txt,712508,715931,3423,20,Y,N,-,-1,-1
RECMUS.txt,713262,716912,3650,20,Y,N,-,-1,-1
RECMUS.txt,714202,717928,3726,20,Y,N,-,-1,-1
RECMUS.txt,714826,718870,4044,20,Y,N,-,-1,-1
RECMUS.txt,715934,719326,3392,20,Y,N,-,-1,-1
RECMUS.txt,716912,719767,2855,20,Y,N,-,-1,-1
RECMUS.txt,717929,720636,2707,20,Y,N,-,-1,-1
RECMUS.txt,718872,721690,2818,20,Y,N,-,-1,-1
RECMUS.txt,719327,722136,2809,20,Y,N,-,-1,-1
RECMUS.txt,719768,722905,3137,20,Y,N,-,-1,-1
RECMUS.txt,720637,723836,3199,20,Y,N,-,-1,-1
RECMUS.txt,721691,724735,3044,20,Y,N,-,-1,-1
RECMUS.txt,722137,725322,3185,20,Y,N,-,-1,-1
RECMUS.txt,722908,726178,3270,20,Y,Y,1431697022699,725354,725864
RECMUS.txt,723837,727242,3405,20,Y,Y,1431697022699,725354,725864
RECMUS.txt,724736,728077,3341,20,Y,Y,1431697022699,725354,725864
RECMUS.txt,725323,729092,3769,20,Y,Y,1431697022699,725354,725864
RECMUS.txt,726181,729866,3685,20,Y,N,-,-1,-1
RECMUS.txt,727243,730504,3261,20,Y,Y,1431697584022,729902,730181
RECMUS.txt,728079,730765,2686,20,Y,Y,1431697584022,729902,730181
RECMUS.txt,729093,730893,1800,20,Y,Y,1431697584022,729902,730181
RECMUS.txt,729867,731346,1479,20,Y,Y,1431697584022,729902,730181
RECMUS.txt,730507,732278,1771,20,Y,N,-,-1,-1
RECMUS.txt,730768,733143,2375,20,Y,N,-,-1,-1
RECMUS.txt,730896,733798,2902,20,Y,Y,1431790026329,733306,733503
RECMUS.txt,731347,734457,3110,20,Y,Y,1431790026329,733306,733503
RECMUS.txt,732280,734897,2617,20,Y,Y,1431790026329,733306,733503
RECMUS.txt,733145,735622,2477,20,Y,Y,1431790026329,733306,733503
RECMUS.txt,733799,736326,2527,20,Y,N,-,-1,-1
RECMUS.txt,734458,736539,2081,20,Y,Y,1431791455244,736369,736531
RECMUS.txt,734898,737441,2543,20,Y,Y,1431791455244,736369,736531
RECMUS.txt,735623,738190,2567,20,Y,Y,1431791455244,736369,736531
RECMUS.txt,736329,738927,2598,20,Y,Y,1431791455244,736369,736531
RECMUS.txt,736540,739665,3125,20,Y,N,-,-1,-1
RECMUS.txt,737443,740432,2989,20,Y,N,-,-1,-1
RECMUS.txt,738191,741105,2914,20,Y,N,-,-1,-1
RECMUS.txt,738928,741875,2947,20,Y,N,-,-1,-1
RECMUS.txt,739667,742609,2942,20,Y,N,-,-1,-1
RECMUS.txt,740434,743472,3038,20,Y,Y,1431941266117,742610,743297
RECMUS.txt,741108,744125,3017,20,Y,Y,1431941266117,742610,743297
RECMUS.txt,741880,745214,3334,20,Y,Y,1431941771447,744892,745049
RECMUS.txt,742610,745730,3120,20,Y,Y,1431941771447,744892,745049
RECMUS.txt,743474,746009,2535,20,Y,Y,1431941771447,744892,745049
RECMUS.txt,744127,747041,2914,20,Y,Y,1431941771447,744892,745049
RECMUS.txt,745215,747760,2545,20,Y,N,-,-1,-1
RECMUS.txt,745732,748472,2740,20,Y,N,-,-1,-1
RECMUS.txt,746010,749038,3028,20,Y,N,-,-1,-1
RECMUS.txt,747044,749668,2624,20,Y,Y,1431943173931,749552,750043
RECMUS.txt,747763,750305,2542,20,Y,Y,1431943173931,749552,750043
RECMUS.txt,748475,751325,2850,20,Y,Y,1431943173931,749552,750043
RECMUS.txt,749039,752027,2988,20,Y,Y,1431943173931,749552,750043
RECMUS.txt,749669,752387,2718,20,Y,Y,1431943173931,749552,750043
RECMUS.txt,750307,752986,2679,20,Y,N,-,-1,-1
RECMUS.txt,751330,753452,2122,20,Y,N,-,-1,-1
RECMUS.txt,752028,754575,2547,20,Y,N,-,-1,-1
RECMUS.txt,752388,755476,3088,20,Y,N,-,-1,-1
RECMUS.txt,752987,755769,2782,20,Y,N,-,-1,-1
RECMUS.txt,753455,756155,2700,20,Y,N,-,-1,-1
RECMUS.txt,754576,756820,2244,20,Y,N,-,-1,-1
RECMUS.txt,755477,757169,1692,20,Y,N,-,-1,-1
RECMUS.txt,755770,757512,1742,20,Y,N,-,-1,-1
RECMUS.txt,756158,757918,1760,20,Y,N,-,-1,-1
RECMUS.txt,756821,758719,1898,20,Y,N,-,-1,-1
RECMUS.txt,757171,759590,2419,20,Y,N,-,-1,-1
RECMUS.txt,757514,760170,2656,20,Y,N,-,-1,-1
RECMUS.txt,757921,760995,3074,20,Y,N,-,-1,-1
RECMUS.txt,758720,761842,3122,20,Y,N,-,-1,-1
RECMUS.txt,759591,762643,3052,20,Y,N,-,-1,-1
RECMUS.txt,760173,763458,3285,20,Y,Y,1431950693551,763304,763649
RECMUS.txt,760995,764212,3217,20,Y,Y,1431950693551,763304,763649
RECMUS.txt,761843,764567,2724,20,Y,Y,1431950693551,763304,763649
RECMUS.txt,762644,764812,2168,20,Y,Y,1431950693551,763304,763649
RECMUS.txt,763459,765420,1961,20,Y,Y,1431950693551,763304,763649
RECMUS.txt,764213,765706,1493,20,N,N,-,-1,-1
RECMUS.txt,764570,766125,1555,20,N,N,-,-1,-1
RECMUS.txt,764813,766713,1900,20,N,N,-,-1,-1
RECMUS.txt,765422,767226,1804,20,N,N,-,-1,-1
RECMUS.txt,765709,767891,2182,20,Y,N,-,-1,-1
RECMUS.txt,766126,768613,2487,20,Y,N,-,-1,-1
RECMUS.txt,766714,769384,2670,20,Y,N,-,-1,-1
RECMUS.txt,767228,770093,2865,20,Y,N,-,-1,-1
RECMUS.txt,767892,771042,3150,20,Y,N,-,-1,-1
RECMUS.txt,768614,771664,3050,20,Y,N,-,-1,-1
RECMUS.txt,769385,772529,3144,20,Y,N,-,-1,-1
RECMUS.txt,770094,773335,3241,20,Y,N,-,-1,-1
RECMUS.txt,771043,773831,2788,20,Y,N,-,-1,-1
RECMUS.txt,771667,774827,3160,20,Y,N,-,-1,-1
RECMUS.txt,772530,775656,3126,20,Y,Y,1431952551670,775158,775489
RECMUS.txt,773336,776512,3176,20,Y,Y,1431952551670,775158,775489
RECMUS.txt,773834,777173,3339,20,Y,Y,1431952551670,775158,775489
RECMUS.txt,774828,777923,3095,20,Y,Y,1431952551670,775158,775489
RECMUS.txt,775657,778226,2569,20,Y,N,-,-1,-1
RECMUS.txt,776513,778749,2236,20,Y,N,-,-1,-1
RECMUS.txt,777174,779448,2274,20,Y,N,-,-1,-1
RECMUS.txt,777924,780626,2702,20,Y,N,-,-1,-1
RECMUS.txt,778227,781273,3046,20,Y,N,-,-1,-1
RECMUS.txt,778750,781890,3140,20,Y,N,-,-1,-1
RECMUS.txt,779449,782871,3422,20,Y,Y,1431953940995,782482,782580
RECMUS.txt,780631,783714,3083,20,Y,Y,1431953940995,782482,782580
RECMUS.txt,781274,784314,3040,20,Y,Y,1431953940995,782482,782580
RECMUS.txt,781891,784921,3030,20,Y,Y,1431953940995,782482,782580
RECMUS.txt,782872,785645,2773,20,Y,N,-,-1,-1
RECMUS.txt,783717,786321,2604,20,Y,N,-,-1,-1
RECMUS.txt,784315,787059,2744,20,Y,N,-,-1,-1
RECMUS.txt,784922,787985,3063,20,Y,N,-,-1,-1
RECMUS.txt,785646,788708,3062,20,Y,N,-,-1,-1
RECMUS.txt,786322,789299,2977,20,Y,N,-,-1,-1
RECMUS.txt,787061,790192,3131,20,Y,N,-,-1,-1
RECMUS.txt,787986,790711,2725,20,Y,N,-,-1,-1
RECMUS.txt,788709,791299,2590,20,Y,N,-,-1,-1
RECMUS.txt,789300,791895,2595,20,Y,Y,1432024843245,791416,792120
RECMUS.txt,790193,792807,2614,20,Y,Y,1432024843245,791416,792120
RECMUS.txt,790712,793351,2639,20,Y,Y,1432024843245,791416,792120
RECMUS.txt,791300,793741,2441,20,Y,Y,1432024843245,791416,792120
RECMUS.txt,791896,794670,2774,20,Y,Y,1432024843245,791416,792120
RECMUS.txt,792808,795595,2787,20,Y,N,-,-1,-1
RECMUS.txt,793354,796288,2934,20,Y,N,-,-1,-1
RECMUS.txt,793744,797100,3356,20,Y,Y,1432028613565,796637,797464
RECMUS.txt,794673,797726,3053,20,Y,Y,1432028613565,796637,797464
RECMUS.txt,795596,798459,2863,20,Y,Y,1432028613565,796637,797464
RECMUS.txt,796290,798916,2626,20,Y,Y,1432028613565,796637,797464
RECMUS.txt,797101,800081,2980,20,Y,Y,1432028613565,796637,797464
RECMUS.txt,797729,801222,3493,20,Y,N,-,-1,-1
RECMUS.txt,798460,802075,3615,20,Y,N,-,-1,-1
RECMUS.txt,798919,802877,3958,20,Y,N,-,-1,-1
RECMUS.txt,800082,803397,3315,20,Y,N,-,-1,-1
RECMUS.txt,801225,804112,2887,20,Y,N,-,-1,-1
RECMUS.txt,802076,805019,2943,20,Y,N,-,-1,-1
RECMUS.txt,802878,805573,2695,20,Y,N,-,-1,-1
RECMUS.txt,803398,806215,2817,20,Y,N,-,-1,-1
RECMUS.txt,804113,807303,3190,20,Y,N,-,-1,-1
RECMUS.txt,805020,807925,2905,20,Y,N,-,-1,-1
RECMUS.txt,805576,808752,3176,20,Y,N,-,-1,-1
RECMUS.txt,806216,809241,3025,20,Y,N,-,-1,-1
RECMUS.txt,807304,810155,2851,20,Y,N,-,-1,-1
RECMUS.txt,807930,811118,3188,20,Y,N,-,-1,-1
RECMUS.txt,808753,811715,2962,20,Y,N,-,-1,-1
RECMUS.txt,809244,812605,3361,20,Y,Y,1432129974051,812469,812989
RECMUS.txt,810156,813632,3476,20,Y,Y,1432129974051,812469,812989
RECMUS.txt,811119,814155,3036,20,Y,Y,1432129974051,812469,812989
RECMUS.txt,811716,815195,3479,20,Y,Y,1432129974051,812469,812989
RECMUS.txt,812606,816010,3404,20,Y,Y,1432129974051,812469,812989
RECMUS.txt,813633,816951,3318,20,Y,N,-,-1,-1
RECMUS.txt,814156,817462,3306,20,Y,N,-,-1,-1
RECMUS.txt,815196,818504,3308,20,Y,N,-,-1,-1
RECMUS.txt,816013,819304,3291,20,Y,N,-,-1,-1
RECMUS.txt,816952,819708,2756,20,Y,N,-,-1,-1
RECMUS.txt,817463,820367,2904,20,Y,N,-,-1,-1
RECMUS.txt,818506,820780,2274,20,Y,N,-,-1,-1
RECMUS.txt,819305,821488,2183,20,Y,N,-,-1,-1
RECMUS.txt,819713,822449,2736,20,Y,N,-,-1,-1
RECMUS.txt,820372,823564,3192,20,Y,N,-,-1,-1
RECMUS.txt,820780,824094,3314,20,Y,N,-,-1,-1
RECMUS.txt,821489,824782,3293,20,Y,N,-,-1,-1
RECMUS.txt,822450,825524,3074,20,Y,N,-,-1,-1
RECMUS.txt,823565,826161,2596,20,Y,N,-,-1,-1
RECMUS.txt,824095,826712,2617,20,Y,N,-,-1,-1
RECMUS.txt,824783,827178,2395,20,Y,N,-,-1,-1
RECMUS.txt,825526,827657,2131,20,Y,N,-,-1,-1
RECMUS.txt,826162,828250,2088,20,Y,Y,1432288594537,828067,828512
RECMUS.txt,826713,828914,2201,20,Y,Y,1432288594537,828067,828512
RECMUS.txt,827179,829904,2725,20,Y,Y,1432288594537,828067,828512
RECMUS.txt,827657,830313,2656,20,Y,Y,1432288594537,828067,828512
RECMUS.txt,828251,831029,2778,20,Y,Y,1432289841006,830618,830976
RECMUS.txt,828915,831607,2692,20,Y,Y,1432289841006,830618,830976
RECMUS.txt,829905,832126,2221,20,Y,Y,1432289841006,830618,830976
RECMUS.txt,830315,833123,2808,20,Y,Y,1432289841006,830618,830976
RECMUS.txt,831030,833862,2832,20,Y,N,-,-1,-1
RECMUS.txt,831609,834952,3343,20,Y,N,-,-1,-1
RECMUS.txt,832129,835612,3483,20,Y,N,-,-1,-1
RECMUS.txt,833124,836421,3297,20,Y,N,-,-1,-1
RECMUS.txt,833863,837192,3329,20,Y,N,-,-1,-1
RECMUS.txt,834953,837844,2891,20,Y,N,-,-1,-1
RECMUS.txt,835613,838882,3269,20,Y,N,-,-1,-1
RECMUS.txt,836424,839937,3513,20,Y,Y,1432374854992,839856,840598
RECMUS.txt,837193,840316,3123,20,Y,Y,1432374854992,839856,840598
RECMUS.txt,837845,840843,2998,20,Y,Y,1432374854992,839856,840598
RECMUS.txt,838882,841045,2163,20,Y,Y,1432374854992,839856,840598
RECMUS.txt,839938,841595,1657,20,Y,Y,1432374854992,839856,840598
RECMUS.txt,840317,842316,1999,20,Y,Y,1432374854992,839856,840598
RECMUS.txt,840844,843899,3055,20,Y,Y,1432375899241,842288,842780
RECMUS.txt,841046,844614,3568,20,Y,Y,1432375899241,842288,842780
RECMUS.txt,841596,845592,3996,20,Y,Y,1432375899241,842288,842780
RECMUS.txt,842317,846143,3826,20,Y,Y,1432375899241,842288,842780
RECMUS.txt,843900,846558,2658,20,Y,N,-,-1,-1
RECMUS.txt,844615,847054,2439,20,Y,N,-,-1,-1
RECMUS.txt,845593,847617,2024,20,Y,N,-,-1,-1
RECMUS.txt,846146,848652,2506,20,Y,N,-,-1,-1
RECMUS.txt,846561,849232,2671,20,Y,N,-,-1,-1
RECMUS.txt,847055,850102,3047,20,Y,N,-,-1,-1
RECMUS.txt,847618,850900,3282,20,Y,N,-,-1,-1
RECMUS.txt,848653,851553,2900,20,Y,N,-,-1,-1
RECMUS.txt,849235,851936,2701,20,Y,N,-,-1,-1
RECMUS.txt,850105,853057,2952,20,Y,N,-,-1,-1
RECMUS.txt,850905,854361,3456,20,Y,N,-,-1,-1
RECMUS.txt,851554,855006,3452,20,Y,N,-,-1,-1
RECMUS.txt,851939,855308,3369,20,Y,N,-,-1,-1
RECMUS.txt,853058,856244,3186,20,Y,N,-,-1,-1
RECMUS.txt,854364,856872,2508,20,Y,N,-,-1,-1
RECMUS.txt,855007,857986,2979,20,Y,N,-,-1,-1
RECMUS.txt,855310,858773,3463,20,Y,N,-,-1,-1
RECMUS.txt,856245,859368,3123,20,Y,N,-,-1,-1
RECMUS.txt,856873,860173,3300,20,Y,N,-,-1,-1
RECMUS.txt,857987,860971,2984,20,Y,N,-,-1,-1
RECMUS.txt,858774,861654,2880,20,Y,N,-,-1,-1
RECMUS.txt,859369,862394,3025,20,Y,N,-,-1,-1
RECMUS.txt,860174,863576,3402,20,Y,N,-,-1,-1
RECMUS.txt,860972,864291,3319,20,Y,N,-,-1,-1
RECMUS.txt,861655,865164,3509,20,Y,N,-,-1,-1
RECMUS.txt,862397,865813,3416,20,Y,N,-,-1,-1
RECMUS.txt,863577,866880,3303,20,Y,Y,1432468347198,866650,866878
RECMUS.txt,864292,867738,3446,20,Y,Y,1432468347198,866650,866878
RECMUS.txt,865165,868302,3137,20,Y,Y,1432468347198,866650,866878
RECMUS.txt,865818,868717,2899,20,Y,Y,1432468347198,866650,866878
RECMUS.txt,866883,869438,2555,20,Y,N,-,-1,-1
RECMUS.txt,867739,870262,2523,20,Y,N,-,-1,-1
RECMUS.txt,868303,871038,2735,20,Y,N,-,-1,-1
RECMUS.txt,868718,871409,2691,20,Y,N,-,-1,-1
RECMUS.txt,869439,871658,2219,20,Y,N,-,-1,-1
RECMUS.txt,870267,871918,1651,20,Y,N,-,-1,-1
RECMUS.txt,871039,872653,1614,20,Y,N,-,-1,-1
RECMUS.txt,871410,873311,1901,20,Y,N,-,-1,-1
RECMUS.txt,871660,874254,2594,20,Y,Y,1432486376679,873579,873808
RECMUS.txt,871923,874900,2977,20,Y,Y,1432486376679,873579,873808
RECMUS.txt,872654,875967,3313,20,Y,Y,1432487662435,875600,875831
RECMUS.txt,873312,876722,3410,20,Y,Y,1432487662435,875600,875831
RECMUS.txt,874255,877219,2964,20,Y,Y,1432487662435,875600,875831
RECMUS.txt,874902,877912,3010,20,Y,Y,1432487662435,875600,875831
RECMUS.txt,875968,878848,2880,20,Y,N,-,-1,-1
RECMUS.txt,876723,879370,2647,20,Y,N,-,-1,-1
RECMUS.txt,877220,880090,2870,20,Y,N,-,-1,-1
RECMUS.txt,877913,880795,2882,20,N,N,-,-1,-1
RECMUS.txt,878851,881484,2633,20,N,N,-,-1,-1
RECMUS.txt,879371,882206,2835,20,Y,N,-,-1,-1
RECMUS.txt,880091,882800,2709,20,Y,N,-,-1,-1
RECMUS.txt,880796,883426,2630,20,Y,N,-,-1,-1
RECMUS.txt,881485,884403,2918,20,Y,N,-,-1,-1
RECMUS.txt,882207,885116,2909,20,Y,N,-,-1,-1
RECMUS.txt,882802,885606,2804,20,Y,N,-,-1,-1
RECMUS.txt,883427,885831,2404,20,Y,N,-,-1,-1
RECMUS.txt,884404,886335,1931,20,Y,N,-,-1,-1
RECMUS.txt,885117,886694,1577,20,Y,N,-,-1,-1
RECMUS.txt,885611,886887,1276,20,Y,N,-,-1,-1
RECMUS.txt,885832,887119,1287,20,Y,N,-,-1,-1
RECMUS.txt,886337,888081,1744,20,Y,Y,1432546852411,887723,888158
RECMUS.txt,886697,889067,2370,20,Y,Y,1432546852411,887723,888158
RECMUS.txt,886890,889734,2844,20,Y,Y,1432546852411,887723,888158
RECMUS.txt,887122,890338,3216,20,Y,Y,1432546852411,887723,888158
RECMUS.txt,888082,890999,2917,20,Y,Y,1432546852411,887723,888158
RECMUS.txt,889068,891646,2578,20,Y,N,-,-1,-1
RECMUS.txt,889735,892258,2523,20,Y,N,-,-1,-1
RECMUS.txt,890339,892981,2642,20,Y,N,-,-1,-1
RECMUS.txt,891000,893717,2717,20,Y,N,-,-1,-1
RECMUS.txt,891647,894491,2844,20,Y,N,-,-1,-1
RECMUS.txt,892259,895573,3314,20,Y,N,-,-1,-1
RECMUS.txt,892982,896522,3540,20,Y,N,-,-1,-1
RECMUS.txt,893720,897747,4027,20,Y,N,-,-1,-1
RECMUS.txt,894492,898706,4214,20,Y,N,-,-1,-1
RECMUS.txt,895574,899380,3806,20,Y,N,-,-1,-1
RECMUS.txt,896525,900088,3563,20,Y,N,-,-1,-1
RECMUS.txt,897748,900706,2958,20,Y,N,-,-1,-1
RECMUS.txt,898711,901175,2464,20,Y,N,-,-1,-1
RECMUS.txt,899381,901824,2443,20,N,N,-,-1,-1
RECMUS.txt,900091,902509,2418,20,N,N,-,-1,-1
RECMUS.txt,900707,903110,2403,20,Y,N,-,-1,-1
RECMUS.txt,901176,903686,2510,20,Y,N,-,-1,-1
RECMUS.txt,901825,904639,2814,20,Y,N,-,-1,-1
RECMUS.txt,902510,905232,2722,20,Y,N,-,-1,-1
RECMUS.txt,903113,905810,2697,20,Y,N,-,-1,-1
RECMUS.txt,903687,907037,3350,20,Y,N,-,-1,-1
RECMUS.txt,904640,907931,3291,20,Y,N,-,-1,-1
RECMUS.txt,905235,909029,3794,20,Y,N,-,-1,-1
RECMUS.txt,905813,910059,4246,20,Y,N,-,-1,-1
RECMUS.txt,907038,910892,3854,20,Y,N,-,-1,-1
RECMUS.txt,907934,911527,3593,20,Y,N,-,-1,-1
RECMUS.txt,909030,912473,3443,20,Y,N,-,-1,-1
RECMUS.txt,910060,913608,3548,20,Y,N,-,-1,-1
RECMUS.txt,910893,914929,4036,20,Y,Y,1432552116295,913989,914217
RECMUS.txt,911528,915802,4274,20,Y,Y,1432552116295,913989,914217
RECMUS.txt,912476,916594,4118,20,Y,Y,1432552116295,913989,914217
RECMUS.txt,913609,917523,3914,20,Y,Y,1432552116295,913989,914217
RECMUS.txt,914930,918045,3115,20,Y,N,-,-1,-1
RECMUS.txt,915804,919386,3582,20,Y,N,-,-1,-1
RECMUS.txt,916595,920551,3956,20,Y,N,-,-1,-1
RECMUS.txt,917528,921475,3947,20,Y,N,-,-1,-1
RECMUS.txt,918046,922085,4039,20,Y,N,-,-1,-1
RECMUS.txt,919387,923294,3907,20,Y,N,-,-1,-1
RECMUS.txt,920554,924168,3614,20,Y,N,-,-1,-1
RECMUS.txt,921476,924996,3520,20,Y,N,-,-1,-1
RECMUS.txt,922086,926116,4030,20,Y,Y,1432554740755,925747,926238
RECMUS.txt,923295,927183,3888,20,Y,Y,1432554740755,925747,926238
RECMUS.txt,924171,928187,4016,20,Y,Y,1432554740755,925747,926238
RECMUS.txt,924997,928911,3914,20,Y,Y,1432554740755,925747,926238
RECMUS.txt,926117,929767,3650,20,Y,Y,1432554740755,925747,926238
RECMUS.txt,927184,930224,3040,20,Y,N,-,-1,-1
RECMUS.txt,928188,930547,2359,20,Y,N,-,-1,-1
RECMUS.txt,928916,931175,2259,20,Y,N,-,-1,-1
RECMUS.txt,929769,931780,2011,20,Y,N,-,-1,-1
RECMUS.txt,930225,932295,2070,20,Y,N,-,-1,-1
RECMUS.txt,930552,932937,2385,20,Y,N,-,-1,-1
RECMUS.txt,931176,933675,2499,20,Y,N,-,-1,-1
RECMUS.txt,931781,934451,2670,20,Y,N,-,-1,-1
RECMUS.txt,932300,934773,2473,20,Y,N,-,-1,-1
RECMUS.txt,932939,934900,1961,20,Y,N,-,-1,-1
RECMUS.txt,933678,934982,1304,20,Y,N,-,-1,-1
RECMUS.txt,934452,935122,670,20,Y,N,-,-1,-1
RECMUS.txt,934776,935243,467,20,Y,N,-,-1,-1
RECMUS.txt,934901,935379,478,20,Y,N,-,-1,-1
RECMUS.txt,934983,935474,491,20,Y,N,-,-1,-1
RECMUS.txt,935125,935650,525,20,Y,N,-,-1,-1
RECMUS.txt,935245,935774,529,20,Y,N,-,-1,-1
RECMUS.txt,935380,935863,483,20,Y,N,-,-1,-1
RECMUS.txt,935475,935937,462,20,Y,N,-,-1,-1
RECMUS.txt,935651,936168,517,20,Y,N,-,-1,-1
RECMUS.txt,935775,936285,510,20,Y,N,-,-1,-1
RECMUS.txt,935865,936356,491,20,Y,N,-,-1,-1
RECMUS.txt,935938,936389,451,20,Y,N,-,-1,-1
RECMUS.txt,936170,936425,255,20,Y,N,-,-1,-1
RECMUS.txt,936286,936453,167,20,N,N,-,-1,-1
RECMUS.txt,936360,936482,122,20,N,N,-,-1,-1
RECMUS.txt,936393,936597,204,20,N,N,-,-1,-1
RECMUS.txt,936428,936736,308,20,Y,N,-,-1,-1
RECMUS.txt,936457,936874,417,20,Y,N,-,-1,-1
RECMUS.txt,936486,936945,459,20,Y,N,-,-1,-1
RECMUS.txt,936599,937091,492,20,Y,N,-,-1,-1
RECMUS.txt,936738,937267,529,20,Y,N,-,-1,-1
RECMUS.txt,936875,937394,519,20,Y,N,-,-1,-1
RECMUS.txt,936947,937608,661,20,Y,N,-,-1,-1
RECMUS.txt,937092,937728,636,20,Y,N,-,-1,-1
RECMUS.txt,937268,937909,641,20,Y,N,-,-1,-1
RECMUS.txt,937395,938045,650,20,Y,N,-,-1,-1
RECMUS.txt,937609,938194,585,20,Y,N,-,-1,-1
RECMUS.txt,937730,938329,599,20,Y,N,-,-1,-1
RECMUS.txt,937910,938575,665,20,Y,N,-,-1,-1
RECMUS.txt,938046,938657,611,20,Y,N,-,-1,-1
RECMUS.txt,938195,938836,641,20,Y,N,-,-1,-1
RECMUS.txt,938330,939018,688,20,Y,N,-,-1,-1
RECMUS.txt,938577,939217,640,20,Y,N,-,-1,-1
RECMUS.txt,938659,939401,742,20,Y,N,-,-1,-1
RECMUS.txt,938837,939578,741,20,Y,N,-,-1,-1
RECMUS.txt,939019,939683,664,20,Y,N,-,-1,-1
RECMUS.txt,939218,939949,731,20,Y,N,-,-1,-1
RECMUS.txt,939402,940065,663,20,Y,N,-,-1,-1
RECMUS.txt,939579,940181,602,20,Y,N,-,-1,-1
RECMUS.txt,939685,940358,673,20,Y,N,-,-1,-1
RECMUS.txt,939951,940607,656,20,Y,N,-,-1,-1
RECMUS.txt,940066,940779,713,20,Y,N,-,-1,-1
RECMUS.txt,940183,940904,721,20,Y,N,-,-1,-1
RECMUS.txt,940359,940990,631,20,Y,N,-,-1,-1
RECMUS.txt,940608,941156,548,20,Y,N,-,-1,-1
RECMUS.txt,940780,941253,473,20,Y,N,-,-1,-1
RECMUS.txt,940905,941288,383,20,Y,N,-,-1,-1
RECMUS.txt,940992,941330,338,20,Y,N,-,-1,-1
RECMUS.txt,941157,941365,208,20,N,N,-,-1,-1
RECMUS.txt,941257,941410,153,20,N,N,-,-1,-1
RECMUS.txt,941292,941445,153,20,N,N,-,-1,-1
RECMUS.txt,941334,941487,153,20,N,N,-,-1,-1
RECMUS.txt,941367,941599,232,20,N,N,-,-1,-1
RECMUS.txt,941414,941686,272,20,Y,N,-,-1,-1
RECMUS.txt,941449,941854,405,20,Y,N,-,-1,-1
RECMUS.txt,941489,941962,473,20,Y,N,-,-1,-1
RECMUS.txt,941600,942110,510,20,Y,N,-,-1,-1
RECMUS.txt,941687,942248,561,20,Y,N,-,-1,-1
RECMUS.txt,941855,942386,531,20,Y,N,-,-1,-1
RECMUS.txt,941963,942465,502,20,Y,N,-,-1,-1
RECMUS.txt,942111,942529,418,20,Y,N,-,-1,-1
RECMUS.txt,942249,942651,402,20,Y,N,-,-1,-1
RECMUS.txt,942387,942730,343,20,Y,N,-,-1,-1
RECMUS.txt,942466,942867,401,20,Y,N,-,-1,-1
RECMUS.txt,942530,943002,472,20,Y,N,-,-1,-1
RECMUS.txt,942652,943122,470,20,Y,N,-,-1,-1
RECMUS.txt,942733,943228,495,20,Y,N,-,-1,-1
RECMUS.txt,942868,943350,482,20,Y,N,-,-1,-1
RECMUS.txt,943003,943493,490,20,Y,N,-,-1,-1
RECMUS.txt,943125,943604,479,20,Y,N,-,-1,-1
RECMUS.txt,943229,943705,476,20,Y,N,-,-1,-1
RECMUS.txt,943351,943794,443,20,Y,N,-,-1,-1
RECMUS.txt,943494,943963,469,20,Y,N,-,-1,-1
RECMUS.txt,943605,944069,464,20,Y,N,-,-1,-1
RECMUS.txt,943706,944237,531,20,Y,N,-,-1,-1
RECMUS.txt,943795,944430,635,20,Y,N,-,-1,-1
RECMUS.txt,943964,944695,731,20,Y,N,-,-1,-1
RECMUS.txt,944070,944822,752,20,Y,N,-,-1,-1
RECMUS.txt,944238,944897,659,20,Y,N,-,-1,-1
RECMUS.txt,944433,944999,566,20,Y,N,-,-1,-1
RECMUS.txt,944696,945151,455,20,Y,N,-,-1,-1
RECMUS.txt,944823,945251,428,20,Y,N,-,-1,-1
RECMUS.txt,944900,945426,526,20,Y,N,-,-1,-1
RECMUS.txt,945000,945684,684,20,Y,N,-,-1,-1
RECMUS.txt,945154,945963,809,20,Y,N,-,-1,-1
RECMUS.txt,945254,946084,830,20,Y,N,-,-1,-1
RECMUS.txt,945427,946267,840,20,Y,N,-,-1,-1
RECMUS.txt,945685,946351,666,20,Y,N,-,-1,-1
RECMUS.txt,945964,946470,506,20,Y,N,-,-1,-1
RECMUS.txt,946085,946535,450,20,Y,N,-,-1,-1
RECMUS.txt,946268,946665,397,20,Y,N,-,-1,-1
RECMUS.txt,946352,946722,370,20,Y,N,-,-1,-1
RECMUS.txt,946471,946961,490,20,Y,N,-,-1,-1
RECMUS.txt,946536,947127,591,20,Y,N,-,-1,-1
RECMUS.txt,946668,947360,692,20,Y,N,-,-1,-1
RECMUS.txt,946723,947493,770,20,Y,N,-,-1,-1
RECMUS.txt,946964,947548,584,20,Y,N,-,-1,-1
RECMUS.txt,947128,947699,571,20,Y,N,-,-1,-1
RECMUS.txt,947363,947889,526,20,Y,N,-,-1,-1
RECMUS.txt,947494,948006,512,20,Y,N,-,-1,-1
RECMUS.txt,947549,948103,554,20,Y,N,-,-1,-1
RECMUS.txt,947700,948212,512,20,Y,N,-,-1,-1
RECMUS.txt,947890,948377,487,20,Y,N,-,-1,-1
RECMUS.txt,948009,948435,426,20,Y,N,-,-1,-1
RECMUS.txt,948106,948603,497,20,Y,N,-,-1,-1
RECMUS.txt,948215,948664,449,20,Y,N,-,-1,-1
RECMUS.txt,948378,948813,435,20,Y,N,-,-1,-1
RECMUS.txt,948438,948918,480,20,Y,N,-,-1,-1
RECMUS.txt,948604,949055,451,20,Y,N,-,-1,-1
RECMUS.txt,948665,949183,518,20,Y,N,-,-1,-1
RECMUS.txt,948815,949247,432,20,Y,N,-,-1,-1
RECMUS.txt,948921,949368,447,20,Y,N,-,-1,-1
RECMUS.txt,949056,949475,419,20,Y,N,-,-1,-1
RECMUS.txt,949184,949608,424,20,Y,N,-,-1,-1
RECMUS.txt,949248,949892,644,20,Y,N,-,-1,-1
RECMUS.txt,949369,949979,610,20,Y,N,-,-1,-1
RECMUS.txt,949476,950066,590,20,Y,N,-,-1,-1
RECMUS.txt,949609,950204,595,20,Y,N,-,-1,-1
RECMUS.txt,949895,950456,561,20,Y,N,-,-1,-1
RECMUS.txt,949980,950598,618,20,Y,N,-,-1,-1
RECMUS.txt,950067,950760,693,20,Y,N,-,-1,-1
RECMUS.txt,950207,950861,654,20,Y,N,-,-1,-1
RECMUS.txt,950459,950983,524,20,Y,N,-,-1,-1
RECMUS.txt,950599,951126,527,20,Y,N,-,-1,-1
RECMUS.txt,950761,951253,492,20,Y,N,-,-1,-1
RECMUS.txt,950862,951402,540,20,Y,N,-,-1,-1
RECMUS.txt,950984,951489,505,20,Y,N,-,-1,-1
RECMUS.txt,951129,951686,557,20,Y,N,-,-1,-1
RECMUS.txt,951254,951820,566,20,Y,N,-,-1,-1
RECMUS.txt,951405,951906,501,20,Y,N,-,-1,-1
RECMUS.txt,951490,952042,552,20,Y,N,-,-1,-1
RECMUS.txt,951687,952164,477,20,Y,N,-,-1,-1
RECMUS.txt,951823,952266,443,20,Y,N,-,-1,-1
RECMUS.txt,951907,952351,444,20,Y,N,-,-1,-1
RECMUS.txt,952043,952548,505,20,Y,N,-,-1,-1
RECMUS.txt,952165,952677,512,20,Y,N,-,-1,-1
RECMUS.txt,952269,952799,530,20,Y,N,-,-1,-1
RECMUS.txt,952352,952870,518,20,Y,N,-,-1,-1
RECMUS.txt,952551,953016,465,20,Y,N,-,-1,-1
RECMUS.txt,952678,953178,500,20,Y,N,-,-1,-1
RECMUS.txt,952800,953271,471,20,Y,N,-,-1,-1
RECMUS.txt,952873,953334,461,20,Y,N,-,-1,-1
RECMUS.txt,953017,953438,421,20,Y,N,-,-1,-1
RECMUS.txt,953179,953521,342,20,Y,N,-,-1,-1
RECMUS.txt,953272,953644,372,20,Y,N,-,-1,-1
RECMUS.txt,953335,953829,494,20,Y,N,-,-1,-1
RECMUS.txt,953441,953920,479,20,Y,N,-,-1,-1
RECMUS.txt,953522,954043,521,20,Y,N,-,-1,-1
RECMUS.txt,953647,954134,487,20,N,N,-,-1,-1
RECMUS.txt,953831,954226,395,20,N,N,-,-1,-1
RECMUS.txt,953922,954306,384,20,N,N,-,-1,-1
RECMUS.txt,954045,954414,369,20,N,N,-,-1,-1
RECMUS.txt,954137,954547,410,20,Y,N,-,-1,-1
RECMUS.txt,954228,954671,443,20,Y,N,-,-1,-1
RECMUS.txt,954308,954783,475,20,Y,N,-,-1,-1
RECMUS.txt,954416,954864,448,20,Y,N,-,-1,-1
RECMUS.txt,954549,954991,442,20,N,N,-,-1,-1
RECMUS.txt,954673,955092,419,20,N,N,-,-1,-1
RECMUS.txt,954786,955201,415,20,N,N,-,-1,-1
RECMUS.txt,954867,955316,449,20,N,N,-,-1,-1
RECMUS.txt,954994,955466,472,20,N,N,-,-1,-1
RECMUS.txt,955095,955629,534,20,N,N,-,-1,-1
RECMUS.txt,955204,955725,521,20,N,N,-,-1,-1
RECMUS.txt,955319,955879,560,20,N,N,-,-1,-1
RECMUS.txt,955469,956019,550,20,N,N,-,-1,-1
RECMUS.txt,955632,956187,555,20,N,N,-,-1,-1
RECMUS.txt,955728,956399,671,20,N,N,-,-1,-1
RECMUS.txt,955882,956499,617,20,N,N,-,-1,-1
RECMUS.txt,956022,956616,594,20,N,N,-,-1,-1
RECMUS.txt,956189,956713,524,20,N,N,-,-1,-1
RECMUS.txt,956402,956831,429,20,N,N,-,-1,-1
RECMUS.txt,956502,956935,433,20,N,N,-,-1,-1
RECMUS.txt,956619,957032,413,20,N,N,-,-1,-1
RECMUS.txt,956716,957178,462,20,N,N,-,-1,-1
RECMUS.txt,956834,957259,425,20,N,N,-,-1,-1
RECMUS.txt,956937,957343,406,20,N,N,-,-1,-1
RECMUS.txt,957034,957484,450,20,N,N,-,-1,-1
RECMUS.txt,957179,957613,434,20,N,N,-,-1,-1
RECMUS.txt,957262,957721,459,20,N,N,-,-1,-1
RECMUS.txt,957346,957811,465,20,N,N,-,-1,-1
RECMUS.txt,957486,957961,475,20,N,N,-,-1,-1
RECMUS.txt,957615,958099,484,20,N,N,-,-1,-1
RECMUS.txt,957723,958184,461,20,N,N,-,-1,-1
RECMUS.txt,957813,958299,486,20,N,N,-,-1,-1
RECMUS.txt,957963,958422,459,20,N,N,-,-1,-1
RECMUS.txt,958101,958530,429,20,Y,N,-,-1,-1
RECMUS.txt,958187,958643,456,20,Y,N,-,-1,-1
RECMUS.txt,958301,958743,442,20,Y,N,-,-1,-1
RECMUS.txt,958424,958885,461,20,Y,N,-,-1,-1
RECMUS.txt,958532,958999,467,20,N,N,-,-1,-1
RECMUS.txt,958645,959119,474,20,N,N,-,-1,-1
RECMUS.txt,958744,959229,485,20,N,N,-,-1,-1
RECMUS.txt,958888,959386,498,20,N,N,-,-1,-1
RECMUS.txt,959002,959468,466,20,N,N,-,-1,-1
RECMUS.txt,959121,959590,469,20,N,N,-,-1,-1
RECMUS.txt,959231,959712,481,20,N,N,-,-1,-1
RECMUS.txt,959387,959805,418,20,N,N,-,-1,-1
RECMUS.txt,959470,959887,417,20,N,N,-,-1,-1
RECMUS.txt,959592,959987,395,20,N,N,-,-1,-1
RECMUS.txt,959714,960109,395,20,N,N,-,-1,-1
RECMUS.txt,959807,960205,398,20,N,N,-,-1,-1
RECMUS.txt,959889,960297,408,20,N,N,-,-1,-1
RECMUS.txt,959989,960378,389,20,N,N,-,-1,-1
RECMUS.txt,960111,960459,348,20,N,N,-,-1,-1
RECMUS.txt,960207,960549,342,20,N,N,-,-1,-1
RECMUS.txt,960299,960697,398,20,N,N,-,-1,-1
RECMUS.txt,960380,960831,451,20,N,N,-,-1,-1
RECMUS.txt,960461,960948,487,20,N,N,-,-1,-1
RECMUS.txt,960552,961035,483,20,N,N,-,-1,-1
RECMUS.txt,960699,961132,433,20,N,N,-,-1,-1
RECMUS.txt,960833,961236,403,20,N,N,-,-1,-1
RECMUS.txt,960950,961353,403,20,N,N,-,-1,-1
RECMUS.txt,961037,961453,416,20,N,N,-,-1,-1
RECMUS.txt,961134,961779,645,20,N,N,-,-1,-1
RECMUS.txt,961238,961923,685,20,Y,N,-,-1,-1
RECMUS.txt,961355,962022,667,20,Y,N,-,-1,-1
RECMUS.txt,961456,962152,696,20,Y,N,-,-1,-1
RECMUS.txt,961780,962246,466,20,Y,N,-,-1,-1
RECMUS.txt,961926,962347,421,20,N,N,-,-1,-1
RECMUS.txt,962025,962462,437,20,N,N,-,-1,-1
RECMUS.txt,962153,962550,397,20,N,N,-,-1,-1
RECMUS.txt,962249,962716,467,20,N,N,-,-1,-1
RECMUS.txt,962350,962830,480,20,N,N,-,-1,-1
RECMUS.txt,962465,962928,463,20,N,N,-,-1,-1
RECMUS.txt,962552,963071,519,20,N,N,-,-1,-1
RECMUS.txt,962719,963185,466,20,N,N,-,-1,-1
RECMUS.txt,962832,963283,451,20,N,N,-,-1,-1
RECMUS.txt,962933,963391,458,20,N,N,-,-1,-1
RECMUS.txt,963074,963477,403,20,N,N,-,-1,-1
RECMUS.txt,963188,963565,377,20,N,N,-,-1,-1
RECMUS.txt,963286,963694,408,20,N,N,-,-1,-1
RECMUS.txt,963394,963795,401,20,N,N,-,-1,-1
RECMUS.txt,963479,963883,404,20,N,N,-,-1,-1
RECMUS.txt,963567,963969,402,20,N,N,-,-1,-1
RECMUS.txt,963696,964065,369,20,N,N,-,-1,-1
RECMUS.txt,963797,964170,373,20,N,N,-,-1,-1
RECMUS.txt,963884,964302,418,20,N,N,-,-1,-1
RECMUS.txt,963972,964431,459,20,N,N,-,-1,-1
RECMUS.txt,964067,964524,457,20,N,N,-,-1,-1
RECMUS.txt,964172,964618,446,20,N,N,-,-1,-1
RECMUS.txt,964304,964714,410,20,N,N,-,-1,-1
RECMUS.txt,964434,964913,479,20,N,N,-,-1,-1
RECMUS.txt,964527,965053,526,20,N,N,-,-1,-1
RECMUS.txt,964621,965197,576,20,N,N,-,-1,-1
RECMUS.txt,964717,965303,586,20,Y,N,-,-1,-1
RECMUS.txt,964915,965330,415,20,Y,N,-,-1,-1
RECMUS.txt,965055,965468,413,20,Y,N,-,-1,-1
RECMUS.txt,965199,965584,385,20,Y,N,-,-1,-1
RECMUS.txt,965304,965693,389,20,N,N,-,-1,-1
RECMUS.txt,965332,965859,527,20,N,N,-,-1,-1
RECMUS.txt,965471,966038,567,20,N,N,-,-1,-1
RECMUS.txt,965586,966112,526,20,N,N,-,-1,-1
RECMUS.txt,965695,966234,539,20,N,N,-,-1,-1
RECMUS.txt,965864,966348,484,20,N,N,-,-1,-1
RECMUS.txt,966039,966462,423,20,N,N,-,-1,-1
RECMUS.txt,966114,966628,514,20,N,N,-,-1,-1
RECMUS.txt,966236,966718,482,20,N,N,-,-1,-1
RECMUS.txt,966350,966818,468,20,N,N,-,-1,-1
RECMUS.txt,966465,966944,479,20,N,N,-,-1,-1
RECMUS.txt,966630,967052,422,20,N,N,-,-1,-1
RECMUS.txt,966720,967165,445,20,Y,N,-,-1,-1
RECMUS.txt,966820,967276,456,20,Y,N,-,-1,-1
RECMUS.txt,966946,967377,431,20,Y,N,-,-1,-1
RECMUS.txt,967055,967501,446,20,Y,N,-,-1,-1
RECMUS.txt,967168,967594,426,20,N,N,-,-1,-1
RECMUS.txt,967281,967714,433,20,N,N,-,-1,-1
RECMUS.txt,967380,967809,429,20,N,N,-,-1,-1
RECOLL.txt,0,2793,2793,20,Y,N,-,-1,-1
RECOLL.txt,632,3692,3060,20,N,N,-,-1,-1
RECOLL.txt,1442,4732,3290,20,Y,N,-,-1,-1
RECOLL.txt,2139,5038,2899,20,Y,N,-,-1,-1
RECOLL.txt,2794,5446,2652,20,Y,N,-,-1,-1
RECOLL.txt,3695,6300,2605,20,Y,N,-,-1,-1
RECOLL.txt,4735,7429,2694,20,Y,N,-,-1,-1
RECOLL.txt,5038,8411,3373,20,Y,N,-,-1,-1
RECOLL.txt,5449,9517,4068,20,Y,N,-,-1,-1
RECOLL.txt,6301,13721,7420,20,Y,N,-,-1,-1
RECOLL.txt,7432,13940,6508,20,Y,N,-,-1,-1
RECOLL.txt,8412,14163,5751,20,Y,N,-,-1,-1
RECOLL.txt,9518,15432,5914,20,Y,N,-,-1,-1
RECOLL.txt,13722,16461,2739,20,Y,N,-,-1,-1
RECOLL.txt,13940,17038,3098,20,Y,N,-,-1,-1
RECOLL.txt,14163,17740,3577,20,Y,N,-,-1,-1
RECOLL.txt,15434,18430,2996,20,Y,Y,1448997318962,17781,18305
RECOLL.txt,16463,19061,2598,20,Y,Y,1448997318962,17781,18305
RECOLL.txt,17039,19524,2485,20,Y,Y,1448997318962,17781,18305
RECOLL.txt,17741,20463,2722,20,Y,Y,1448997318962,17781,18305
RECOLL.txt,18431,21357,2926,20,Y,N,-,-1,-1
RECOLL.txt,19062,22175,3113,20,Y,N,-,-1,-1
RECOLL.txt,19525,22905,3380,20,Y,N,-,-1,-1
RECOLL.txt,20466,23566,3100,20,Y,N,-,-1,-1
RECOLL.txt,21358,24416,3058,20,Y,N,-,-1,-1
RECOLL.txt,22176,25306,3130,20,Y,N,-,-1,-1
RECOLL.txt,22906,26285,3379,20,Y,N,-,-1,-1
RECOLL.txt,23567,27143,3576,20,Y,N,-,-1,-1
RECOLL.txt,24419,27967,3548,20,Y,N,-,-1,-1
RECOLL.txt,25307,28429,3122,20,N,N,-,-1,-1
RECOLL.txt,26286,29120,2834,20,Y,N,-,-1,-1
RECOLL.txt,27145,29699,2554,20,Y,N,-,-1,-1
RECOLL.txt,27968,30151,2183,20,Y,N,-,-1,-1
RECOLL.txt,28432,30620,2188,20,Y,N,-,-1,-1
RECOLL.txt,29121,31184,2063,20,Y,N,-,-1,-1
RECOLL.txt,29700,31674,1974,20,Y,Y,1449564497346,31421,33114
RECOLL.txt,30152,32080,1928,20,Y,Y,1449564497346,31421,33114
RECOLL.txt,30622,32692,2070,20,Y,Y,1449564497346,31421,33114
RECOLL.txt,31185,33397,2212,20,Y,Y,1449564497346,31421,33114
RECOLL.txt,31675,34018,2343,20,Y,Y,1449564497346,31421,33114
RECOLL.txt,32081,35045,2964,20,Y,Y,1449564002703,34459,35028
RECOLL.txt,32693,35634,2941,20,Y,Y,1449564936771,35046,35717
RECOLL.txt,33399,36927,3528,20,Y,Y,1449564936771,35046,35717
RECOLL.txt,34019,37486,3467,20,Y,Y,1449564936771,35046,35717
RECOLL.txt,35048,38229,3181,20,Y,Y,1449564936771,35046,35717
RECOLL.txt,35635,38957,3322,20,Y,Y,1449564936771,35046,35717
RECOLL.txt,36930,39348,2418,20,Y,Y,1449565237768,37503,38152
RECOLL.txt,37491,40102,2611,20,Y,Y,1449565481530,39801,40627
RECOLL.txt,38231,40906,2675,20,Y,Y,1449565481530,39801,40627
RECOLL.txt,38958,41513,2555,20,Y,Y,1449565481530,39801,40627
RECOLL.txt,39349,42016,2667,20,Y,Y,1449565481530,39801,40627
RECOLL.txt,40105,42837,2732,20,Y,Y,1449565481530,39801,40627
RECOLL.txt,40908,43276,2368,20,N,N,-,-1,-1
RECOLL.txt,41514,43900,2386,20,Y,N,-,-1,-1
RECOLL.txt,42017,44272,2255,20,N,N,-,-1,-1
RECOLL.txt,42838,44605,1767,20,N,N,-,-1,-1
RECOLL.txt,43277,45225,1948,20,Y,N,-,-1,-1
RECOLL.txt,43902,46226,2324,20,Y,N,-,-1,-1
RECOLL.txt,44273,46944,2671,20,Y,N,-,-1,-1
RECOLL.txt,44607,47380,2773,20,Y,N,-,-1,-1
RECOLL.txt,45226,48216,2990,20,Y,Y,1449566012674,47822,49423
RECOLL.txt,46227,48780,2553,20,Y,Y,1449566012674,47822,49423
RECOLL.txt,46945,49432,2487,20,Y,Y,1449566012674,47822,49423
RECOLL.txt,47381,50040,2659,20,Y,Y,1449566012674,47822,49423
RECOLL.txt,48217,50623,2406,20,Y,Y,1449566012674,47822,49423
RECOLL.txt,48781,51332,2551,20,Y,Y,1449566012674,47822,49423
RECOLL.txt,49435,52154,2719,20,Y,Y,1449566376755,51356,52539
RECOLL.txt,50041,52686,2645,20,Y,Y,1449566376755,51356,52539
RECOLL.txt,50624,53697,3073,20,Y,Y,1449566376755,51356,52539
RECOLL.txt,51337,54390,3053,20,Y,Y,1449566376755,51356,52539
RECOLL.txt,52155,55361,3206,20,Y,Y,1449566376755,51356,52539
RECOLL.txt,52687,55895,3208,20,Y,Y,1449566781717,52623,55207
RECOLL.txt,53702,56476,2774,20,Y,Y,1449566781717,52623,55207
RECOLL.txt,54391,57295,2904,20,Y,Y,1449566781717,52623,55207
RECOLL.txt,55363,57996,2633,20,Y,Y,1449567312089,57825,59193
RECOLL.txt,55898,58793,2895,20,Y,Y,1449567312089,57825,59193
RECOLL.txt,56477,59273,2796,20,Y,Y,1449567312089,57825,59193
RECOLL.txt,57297,59751,2454,20,Y,Y,1449567312089,57825,59193
RECOLL.txt,57998,60446,2448,20,Y,Y,1449567312089,57825,59193
RECOLL.txt,58794,60945,2151,20,Y,Y,1449567312089,57825,59193
RECOLL.txt,59274,61681,2407,20,Y,N,-,-1,-1
RECOLL.txt,59752,62528,2776,20,Y,N,-,-1,-1
RECOLL.txt,60447,63615,3168,20,Y,N,-,-1,-1
RECOLL.txt,60948,64091,3143,20,Y,Y,1449604006516,63836,64388
RECOLL.txt,61684,64847,3163,20,Y,Y,1449604006516,63836,64388
RECOLL.txt,62531,65352,2821,20,Y,Y,1449604006516,63836,64388
RECOLL.txt,63616,66191,2575,20,Y,Y,1449604006516,63836,64388
RECOLL.txt,64092,66372,2280,20,Y,Y,1449604006516,63836,64388
RECOLL.txt,64848,66690,1842,20,Y,Y,1449604885298,64679,65628
RECOLL.txt,65353,67001,1648,20,Y,Y,1449604885298,64679,65628
RECOLL.txt,66192,67624,1432,20,Y,Y,1449605311607,66740,67367
RECOLL.txt,66373,68239,1866,20,Y,Y,1449605311607,66740,67367
RECOLL.txt,66693,68701,2008,20,Y,Y,1449605311607,66740,67367
RECOLL.txt,67004,69750,2746,20,Y,Y,1449605831232,69255,71638
RECOLL.txt,67625,70094,2469,20,Y,Y,1449605831232,69255,71638
RECOLL.txt,68240,70481,2241,20,Y,Y,1449605831232,69255,71638
RECOLL.txt,68702,71020,2318,20,Y,Y,1449605831232,69255,71638
RECOLL.txt,69753,71666,1913,20,Y,Y,1449605831232,69255,71638
RECOLL.txt,70095,72055,1960,20,Y,Y,1449606203855,71875,72052
RECOLL.txt,70482,72417,1935,20,Y,Y,1449606203855,71875,72052
RECOLL.txt,71021,72488,1467,20,Y,Y,1449606203855,71875,72052
RECOLL.txt,71669,72621,952,20,Y,Y,1449606203855,71875,72052
RECOLL.txt,72056,72777,721,20,Y,N,-,-1,-1
RECOLL.txt,72418,72838,420,20,Y,N,-,-1,-1
RECOLL.txt,72489,73189,700,20,Y,N,-,-1,-1
RECOLL.txt,72623,73625,1002,20,Y,N,-,-1,-1
RECOLL.txt,72778,74105,1327,20,Y,N,-,-1,-1
RECOLL.txt,72840,74806,1966,20,Y,N,-,-1,-1
RECOLL.txt,73190,75493,2303,20,Y,Y,1449606753172,75354,75839
RECOLL.txt,73626,75910,2284,20,Y,Y,1449606753172,75354,75839
RECOLL.txt,74108,76842,2734,20,Y,Y,1449606753172,75354,75839
RECOLL.txt,74807,77376,2569,20,Y,Y,1449606753172,75354,75839
RECOLL.txt,75494,77973,2479,20,Y,Y,1449606753172,75354,75839
RECOLL.txt,75911,78713,2802,20,Y,Y,1449607148586,77156,77751
RECOLL.txt,76845,79405,2560,20,Y,Y,1449607148586,77156,77751
RECOLL.txt,77378,80246,2868,20,Y,Y,1449607148586,77156,77751
RECOLL.txt,77975,80859,2884,20,Y,N,-,-1,-1
RECOLL.txt,78714,81491,2777,20,Y,Y,1450194336026,81036,82029
RECOLL.txt,79406,82275,2869,20,Y,Y,1450194336026,81036,82029
RECOLL.txt,80247,83023,2776,20,Y,Y,1450194336026,81036,82029
RECOLL.txt,80861,83661,2800,20,Y,Y,1450194336026,81036,82029
RECOLL.txt,81494,84343,2849,20,Y,Y,1450194336026,81036,82029
RECOLL.txt,82276,84858,2582,20,Y,Y,1450194991609,83440,83936
RECOLL.txt,83024,85386,2362,20,Y,Y,1450194991609,83440,83936
RECOLL.txt,83662,85940,2278,20,Y,Y,1450194991609,83440,83936
RECOLL.txt,84345,86886,2541,20,Y,Y,1450195763304,85744,87933
RECOLL.txt,84859,87549,2690,20,Y,Y,1450195763304,85744,87933
RECOLL.txt,85389,88274,2885,20,Y,Y,1450195763304,85744,87933
RECOLL.txt,85941,89069,3128,20,Y,Y,1450195763304,85744,87933
RECOLL.txt,86887,89587,2700,20,Y,Y,1450196241886,89386,90252
RECOLL.txt,87550,90153,2603,20,Y,Y,1450196241886,89386,90252
RECOLL.txt,88275,90662,2387,20,Y,Y,1450196241886,89386,90252
RECOLL.txt,89070,90972,1902,20,Y,Y,1450196241886,89386,90252
RECOLL.txt,89588,91059,1471,20,Y,Y,1450196241886,89386,90252
RECOLL.txt,90154,91117,963,20,Y,Y,1450196241886,89386,90252
RECOLL.txt,90663,91224,561,20,Y,N,-,-1,-1
RECOLL.txt,90973,91305,332,20,Y,N,-,-1,-1
RECOLL.txt,91062,91634,572,20,Y,N,-,-1,-1
RECOLL.txt,91118,92272,1154,20,Y,Y,1450196550118,92044,92813
RECOLL.txt,91225,92874,1649,20,Y,Y,1450196550118,92044,92813
RECOLL.txt,91306,93684,2378,20,Y,Y,1450196550118,92044,92813
RECOLL.txt,91635,94493,2858,20,Y,Y,1450196550118,92044,92813
RECOLL.txt,92273,95263,2990,20,Y,Y,1450196550118,92044,92813
RECOLL.txt,92877,95771,2894,20,Y,Y,1450196865042,92875,93368
RECOLL.txt,93689,96686,2997,20,Y,N,-,-1,-1
RECOLL.txt,94494,97351,2857,20,Y,Y,1450197272502,97289,98405
RECOLL.txt,95266,98097,2831,20,Y,Y,1450197272502,97289,98405
RECOLL.txt,95774,98767,2993,20,Y,Y,1450197272502,97289,98405
RECOLL.txt,96687,99383,2696,20,Y,Y,1450197272502,97289,98405
RECOLL.txt,97354,100173,2819,20,Y,Y,1450197272502,97289,98405
RECOLL.txt,98098,100999,2901,20,Y,Y,1450197272502,97289,98405
RECOLL.txt,98770,101690,2920,20,Y,Y,1450197827406,100079,100567
RECOLL.txt,99384,102440,3056,20,Y,Y,1450198228374,101899,104222
RECOLL.txt,100174,103774,3600,20,Y,Y,1450198228374,101899,104222
RECOLL.txt,101002,104390,3388,20,Y,Y,1450198228374,101899,104222
RECOLL.txt,101691,104860,3169,20,Y,Y,1450198228374,101899,104222
RECOLL.txt,102441,105525,3084,20,Y,Y,1450198228374,101899,104222
RECOLL.txt,103776,106198,2422,20,Y,Y,1450198228374,101899,104222
RECOLL.txt,104392,106989,2597,20,Y,Y,1450198608392,105951,106876
RECOLL.txt,104863,107447,2584,20,Y,Y,1450198899921,107006,107437
RECOLL.txt,105526,107766,2240,20,Y,Y,1450198899921,107006,107437
RECOLL.txt,106199,108489,2290,20,Y,Y,1450198899921,107006,107437
RECOLL.txt,106990,108941,1951,20,Y,Y,1450198899921,107006,107437
RECOLL.txt,107450,109478,2028,20,Y,Y,1450209381136,108935,109356
RECOLL.txt,107769,110152,2383,20,Y,Y,1450209381136,108935,109356
RECOLL.txt,108491,111014,2523,20,Y,Y,1450209381136,108935,109356
RECOLL.txt,108943,111659,2716,20,Y,Y,1450209381136,108935,109356
RECOLL.txt,109483,112283,2800,20,Y,Y,1450210289855,109766,110720
RECOLL.txt,110153,113168,3015,20,Y,Y,1450210289855,109766,110720
RECOLL.txt,111016,114218,3202,20,Y,N,-,-1,-1
RECOLL.txt,111660,115239,3579,20,Y,N,-,-1,-1
RECOLL.txt,112284,115911,3627,20,Y,Y,1450211094623,115807,116651
RECOLL.txt,113169,116562,3393,20,Y,Y,1450211094623,115807,116651
RECOLL.txt,114219,117016,2797,20,Y,Y,1450212524850,116654,117006
RECOLL.txt,115240,117592,2352,20,Y,Y,1450212524850,116654,117006
RECOLL.txt,115914,118111,2197,20,Y,Y,1450212524850,116654,117006
RECOLL.txt,116563,119146,2583,20,Y,Y,1450212524850,116654,117006
RECOLL.txt,117019,119687,2668,20,Y,N,-,-1,-1
RECOLL.txt,117595,120301,2706,20,Y,Y,1450213154792,119938,120294
RECOLL.txt,118114,120921,2807,20,Y,Y,1450213154792,119938,120294
RECOLL.txt,119147,121327,2180,20,Y,Y,1450213154792,119938,120294
RECOLL.txt,119688,121822,2134,20,Y,Y,1450213154792,119938,120294
RECOLL.txt,120304,122335,2031,20,Y,Y,1450214856877,122255,122760
RECOLL.txt,120924,123062,2138,20,Y,Y,1450214856877,122255,122760
RECOLL.txt,121328,123744,2416,20,Y,Y,1450214856877,122255,122760
RECOLL.txt,121823,123829,2006,20,Y,Y,1450214856877,122255,122760
RECOLL.txt,122336,123984,1648,20,Y,Y,1450214856877,122255,122760
RECOLL.txt,123063,124082,1019,20,Y,N,-,-1,-1
RECOLL.txt,123747,124710,963,20,Y,N,-,-1,-1
RECOLL.txt,123832,125256,1424,20,Y,N,-,-1,-1
RECOLL.txt,123985,125913,1928,20,Y,Y,1450215357428,125505,126500
RECOLL.txt,124083,126510,2427,20,Y,Y,1450215357428,125505,126500
RECOLL.txt,124711,127300,2589,20,Y,Y,1450215357428,125505,126500
RECOLL.txt,125257,128141,2884,20,Y,Y,1450215357428,125505,126500
RECOLL.txt,125916,128948,3032,20,Y,Y,1450215778344,128744,129064
RECOLL.txt,126513,129471,2958,20,Y,Y,1450215778344,128744,129064
RECOLL.txt,127303,130166,2863,20,Y,Y,1450215778344,128744,129064
RECOLL.txt,128142,131040,2898,20,Y,Y,1450215778344,128744,129064
RECOLL.txt,128949,131782,2833,20,Y,Y,1450215778344,128744,129064
RECOLL.txt,129472,132736,3264,20,Y,Y,1450217142535,132155,132920
RECOLL.txt,130167,133429,3262,20,Y,Y,1450217142535,132155,132920
RECOLL.txt,131041,134159,3118,20,Y,Y,1450217142535,132155,132920
RECOLL.txt,131783,135025,3242,20,Y,Y,1450217142535,132155,132920
RECOLL.txt,132739,135486,2747,20,Y,Y,1450217142535,132155,132920
RECOLL.txt,133432,136221,2789,20,Y,N,-,-1,-1
RECOLL.txt,134162,136832,2670,20,Y,N,-,-1,-1
RECOLL.txt,135026,137256,2230,20,Y,N,-,-1,-1
RECOLL.txt,135489,138238,2749,20,Y,Y,1450265940821,137499,138662
RECOLL.txt,136222,138869,2647,20,Y,Y,1450265940821,137499,138662
RECOLL.txt,136834,139334,2500,20,Y,Y,1450265940821,137499,138662
RECOLL.txt,137257,140030,2773,20,Y,Y,1450265940821,137499,138662
RECOLL.txt,138240,140818,2578,20,Y,Y,1450265940821,137499,138662
RECOLL.txt,138872,141258,2386,20,Y,N,-,-1,-1
RECOLL.txt,139335,141802,2467,20,Y,N,-,-1,-1
RECOLL.txt,140031,142418,2387,20,Y,N,-,-1,-1
RECOLL.txt,140820,143077,2257,20,Y,N,-,-1,-1
RECOLL.txt,141261,143409,2148,20,Y,N,-,-1,-1
RECOLL.txt,141803,144410,2607,20,Y,N,-,-1,-1
RECOLL.txt,142421,145014,2593,20,Y,N,-,-1,-1
RECOLL.txt,143078,145511,2433,20,Y,N,-,-1,-1
RECOLL.txt,143410,146494,3084,20,Y,N,-,-1,-1
RECOLL.txt,144413,147099,2686,20,Y,N,-,-1,-1
RECOLL.txt,145019,147706,2687,20,Y,N,-,-1,-1
RECOLL.txt,145512,148035,2523,20,Y,N,-,-1,-1
RECOLL.txt,146495,148848,2353,20,Y,N,-,-1,-1
RECOLL.txt,147100,149395,2295,20,Y,N,-,-1,-1
RECOLL.txt,147707,150267,2560,20,Y,Y,1450266255219,149476,150064
RECOLL.txt,148036,150719,2683,20,Y,Y,1450266255219,149476,150064
RECOLL.txt,148851,151340,2489,20,Y,Y,1450266255219,149476,150064
RECOLL.txt,149400,152064,2664,20,Y,Y,1450266255219,149476,150064
RECOLL.txt,150268,152643,2375,20,Y,N,-,-1,-1
RECOLL.txt,150720,153268,2548,20,Y,N,-,-1,-1
RECOLL.txt,151341,154217,2876,20,Y,N,-,-1,-1
RECOLL.txt,152065,154843,2778,20,Y,N,-,-1,-1
RECOLL.txt,152644,155800,3156,20,Y,Y,1450266659853,155779,156351
RECOLL.txt,153269,156444,3175,20,Y,Y,1450266659853,155779,156351
RECOLL.txt,154218,156945,2727,20,Y,Y,1450266659853,155779,156351
RECOLL.txt,154845,157592,2747,20,Y,Y,1450266659853,155779,156351
RECOLL.txt,155801,158790,2989,20,Y,Y,1450266659853,155779,156351
RECOLL.txt,156446,159215,2769,20,Y,Y,1450267181437,158411,159424
RECOLL.txt,156946,159566,2620,20,Y,Y,1450267181437,158411,159424
RECOLL.txt,157595,159997,2402,20,Y,Y,1450267181437,158411,159424
RECOLL.txt,158791,160333,1542,20,Y,Y,1450267181437,158411,159424
RECOLL.txt,159217,161720,2503,20,Y,Y,1450267181437,158411,159424
RECOLL.txt,159567,162425,2858,20,Y,Y,1450267451569,160340,162732
RECOLL.txt,159998,163142,3144,20,Y,Y,1450268185046,162966,163418
RECOLL.txt,160336,163828,3492,20,Y,Y,1450268185046,162966,163418
RECOLL.txt,161721,164679,2958,20,Y,Y,1450268185046,162966,163418
RECOLL.txt,162426,165379,2953,20,Y,Y,1450268185046,162966,163418
RECOLL.txt,163144,165559,2415,20,Y,Y,1450268185046,162966,163418
RECOLL.txt,163831,166211,2380,20,Y,Y,1450268661242,163528,164918
RECOLL.txt,164682,167064,2382,20,Y,Y,1450268661242,163528,164918
RECOLL.txt,165380,168016,2636,20,Y,N,-,-1,-1
RECOLL.txt,165560,169031,3471,20,Y,N,-,-1,-1
RECOLL.txt,166214,169513,3299,20,Y,Y,1450268978542,169359,170509
RECOLL.txt,167065,170079,3014,20,Y,Y,1450268978542,169359,170509
RECOLL.txt,168019,170646,2627,20,Y,Y,1450268978542,169359,170509
RECOLL.txt,169032,171305,2273,20,Y,Y,1450268978542,169359,170509
RECOLL.txt,169514,171885,2371,20,Y,Y,1450268978542,169359,170509
RECOLL.txt,170080,172534,2454,20,Y,Y,1450268978542,169359,170509
RECOLL.txt,170649,173058,2409,20,Y,N,-,-1,-1
RECOLL.txt,171307,173990,2683,20,Y,N,-,-1,-1
RECOLL.txt,171886,174560,2674,20,Y,N,-,-1,-1
RECOLL.txt,172535,175457,2922,20,Y,Y,1450269524213,175141,176459
RECOLL.txt,173061,176075,3014,20,Y,Y,1450269524213,175141,176459
RECOLL.txt,173991,176828,2837,20,Y,Y,1450272604542,176533,177646
RECOLL.txt,174561,177800,3239,20,Y,Y,1450272604542,176533,177646
RECOLL.txt,175458,178569,3111,20,Y,Y,1450272604542,176533,177646
RECOLL.txt,176076,179171,3095,20,Y,Y,1450272604542,176533,177646
RECOLL.txt,176829,179603,2774,20,Y,Y,1450272604542,176533,177646
RECOLL.txt,177801,179921,2120,20,Y,Y,1450273026631,178707,180918
RECOLL.txt,178570,180406,1836,20,Y,Y,1450273026631,178707,180918
RECOLL.txt,179172,180923,1751,20,Y,Y,1450273026631,178707,180918
RECOLL.txt,179604,181780,2176,20,Y,Y,1450273354749,181694,182351
RECOLL.txt,179922,182241,2319,20,Y,Y,1450273354749,181694,182351
RECOLL.txt,180409,182990,2581,20,Y,Y,1450273354749,181694,182351
RECOLL.txt,180926,183665,2739,20,Y,Y,1450273354749,181694,182351
RECOLL.txt,181782,184541,2759,20,Y,Y,1450273729052,184450,185295
RECOLL.txt,182242,185004,2762,20,Y,Y,1450273729052,184450,185295
RECOLL.txt,182991,185861,2870,20,Y,Y,1450273729052,184450,185295
RECOLL.txt,183668,186278,2610,20,Y,Y,1450273729052,184450,185295
RECOLL.txt,184544,186963,2419,20,Y,Y,1450273729052,184450,185295
RECOLL.txt,185007,187298,2291,20,Y,Y,1450273729052,184450,185295
RECOLL.txt,185863,188087,2224,20,Y,Y,1450273943006,185542,186034
RECOLL.txt,186279,188628,2349,20,Y,N,-,-1,-1
RECOLL.txt,186964,189120,2156,20,Y,N,-,-1,-1
RECOLL.txt,187299,189844,2545,20,Y,N,-,-1,-1
RECOLL.txt,188088,190511,2423,20,Y,N,-,-1,-1
RECOLL.txt,188629,191253,2624,20,Y,Y,1450274247305,190587,191139
RECOLL.txt,189121,191919,2798,20,Y,Y,1450274247305,190587,191139
RECOLL.txt,189845,192888,3043,20,Y,Y,1450274641828,192265,194302
RECOLL.txt,190513,193237,2724,20,Y,Y,1450274641828,192265,194302
RECOLL.txt,191256,194177,2921,20,Y,Y,1450274641828,192265,194302
RECOLL.txt,191921,194563,2642,20,Y,Y,1450274641828,192265,194302
RECOLL.txt,192889,195230,2341,20,Y,Y,1450274641828,192265,194302
RECOLL.txt,193238,195612,2374,20,Y,Y,1450274641828,192265,194302
RECOLL.txt,194178,195992,1814,20,Y,Y,1450274641828,192265,194302
RECOLL.txt,194568,196546,1978,20,Y,N,-,-1,-1
RECOLL.txt,195233,197151,1918,20,Y,N,-,-1,-1
RECOLL.txt,195617,198206,2589,20,Y,N,-,-1,-1
RECOLL.txt,195993,198682,2689,20,Y,Y,1450276878994,198569,198873
RECOLL.txt,196547,199309,2762,20,Y,Y,1450276878994,198569,198873
RECOLL.txt,197152,200093,2941,20,Y,Y,1450276878994,198569,198873
RECOLL.txt,198208,200708,2500,20,Y,Y,1450276878994,198569,198873
RECOLL.txt,198683,201106,2423,20,Y,Y,1450276878994,198569,198873
RECOLL.txt,199310,201596,2286,20,Y,Y,1450277256048,200011,201853
RECOLL.txt,200095,202345,2250,20,Y,Y,1450278260874,201966,203744
RECOLL.txt,200709,202761,2052,20,Y,Y,1450278260874,201966,203744
RECOLL.txt,201107,203529,2422,20,Y,Y,1450278260874,201966,203744
RECOLL.txt,201598,204073,2475,20,Y,Y,1450278260874,201966,203744
RECOLL.txt,202346,204493,2147,20,Y,Y,1450278260874,201966,203744
RECOLL.txt,202764,205439,2675,20,Y,Y,1450278260874,201966,203744
RECOLL.txt,203530,205969,2439,20,Y,Y,1450278260874,201966,203744
RECOLL.txt,204074,206787,2713,20,Y,Y,1450278710609,204409,206093
RECOLL.txt,204494,207423,2929,20,Y,Y,1450278710609,204409,206093
RECOLL.txt,205440,207863,2423,20,Y,Y,1450278992417,207433,208043
RECOLL.txt,205972,208577,2605,20,Y,Y,1450278992417,207433,208043
RECOLL.txt,206790,209245,2455,20,Y,Y,1450278992417,207433,208043
RECOLL.txt,207426,209734,2308,20,Y,Y,1450278992417,207433,208043
RECOLL.txt,207866,210190,2324,20,Y,Y,1450278992417,207433,208043
RECOLL.txt,208582,210600,2018,20,Y,N,-,-1,-1
RECOLL.txt,209248,211346,2098,20,Y,N,-,-1,-1
RECOLL.txt,209736,211889,2153,20,Y,N,-,-1,-1
RECOLL.txt,210192,212356,2164,20,Y,N,-,-1,-1
RECOLL.txt,210603,212934,2331,20,Y,N,-,-1,-1
RECOLL.txt,211347,213913,2566,20,Y,N,-,-1,-1
RECOLL.txt,211890,214388,2498,20,Y,N,-,-1,-1
RECOLL.txt,212357,215531,3174,20,Y,N,-,-1,-1
RECOLL.txt,212935,216275,3340,20,Y,N,-,-1,-1
RECOLL.txt,213915,217239,3324,20,Y,N,-,-1,-1
RECOLL.txt,214389,217884,3495,20,Y,Y,1450279453888,217252,218068
RECOLL.txt,215532,218745,3213,20,Y,Y,1450279453888,217252,218068
RECOLL.txt,216277,219510,3233,20,Y,Y,1450279453888,217252,218068
RECOLL.txt,217242,220502,3260,20,Y,Y,1450279955242,219797,222549
RECOLL.txt,217885,221527,3642,20,Y,Y,1450279955242,219797,222549
RECOLL.txt,218746,222454,3708,20,Y,Y,1450279955242,219797,222549
RECOLL.txt,219511,223226,3715,20,Y,Y,1450279955242,219797,222549
RECOLL.txt,220505,223881,3376,20,Y,Y,1450279955242,219797,222549
RECOLL.txt,221530,224003,2473,20,N,Y,1450279955242,219797,222549
RECOLL.txt,222455,224160,1705,20,N,Y,1450279955242,219797,222549
RECOLL.txt,223229,224835,1606,20,N,N,-,-1,-1
RECOLL.txt,223882,225541,1659,20,N,N,-,-1,-1
RECOLL.txt,224006,226286,2280,20,N,N,-,-1,-1
RECOLL.txt,224161,226786,2625,20,N,N,-,-1,-1
RECOLL.txt,224838,227190,2352,20,N,N,-,-1,-1
RECOLL.txt,225542,228055,2513,20,N,N,-,-1,-1
RECOLL.txt,226288,228884,2596,20,N,N,-,-1,-1
RECOLL.txt,226787,229308,2521,20,Y,N,-,-1,-1
RECOLL.txt,227191,229898,2707,20,N,N,-,-1,-1
RECOLL.txt,228056,230526,2470,20,N,N,-,-1,-1
RECOLL.txt,228887,231326,2439,20,N,N,-,-1,-1
RECOLL.txt,229309,231889,2580,20,N,N,-,-1,-1
RECOLL.txt,229899,232655,2756,20,N,N,-,-1,-1
RECOLL.txt,230529,233254,2725,20,Y,N,-,-1,-1
RECOLL.txt,231327,233852,2525,20,Y,N,-,-1,-1
RECOLL.txt,231890,235072,3182,20,Y,N,-,-1,-1
RECOLL.txt,232656,235952,3296,20,Y,N,-,-1,-1
RECOLL.txt,233255,236373,3118,20,N,N,-,-1,-1
RECOLL.txt,233853,237246,3393,20,Y,N,-,-1,-1
RECOLL.txt,235073,237946,2873,20,Y,N,-,-1,-1
RECOLL.txt,235953,238667,2714,20,Y,N,-,-1,-1
RECOLL.txt,236375,239285,2910,20,Y,N,-,-1,-1
RECOLL.txt,237247,239853,2606,20,Y,N,-,-1,-1
RECOLL.txt,237947,240610,2663,20,Y,Y,1450280377959,240537,241310
RECOLL.txt,238669,241569,2900,20,Y,Y,1450280673034,241380,241838
RECOLL.txt,239286,242286,3000,20,Y,Y,1450280673034,241380,241838
RECOLL.txt,239854,242855,3001,20,Y,Y,1450280673034,241380,241838
RECOLL.txt,240611,244358,3747,20,Y,Y,1450280673034,241380,241838
RECOLL.txt,241570,244846,3276,20,Y,Y,1450280673034,241380,241838
RECOLL.txt,242287,245473,3186,20,Y,Y,1450281212744,242862,245207
RECOLL.txt,242858,246132,3274,20,Y,Y,1450281212744,242862,245207
RECOLL.txt,244359,246530,2171,20,Y,Y,1450281212744,242862,245207
RECOLL.txt,244847,246876,2029,20,Y,Y,1450281212744,242862,245207
RECOLL.txt,245474,247006,1532,20,Y,N,-,-1,-1
RECOLL.txt,246137,247133,996,20,Y,N,-,-1,-1
RECOLL.txt,246531,247344,813,20,Y,N,-,-1,-1
RECOLL.txt,246877,247389,512,20,Y,N,-,-1,-1
RECOLL.txt,247007,247537,530,20,Y,N,-,-1,-1
RECOLL.txt,247134,247708,574,20,Y,N,-,-1,-1
RECOLL.txt,247347,248299,952,20,Y,N,-,-1,-1
RECOLL.txt,247392,248982,1590,20,Y,Y,1450281669613,248365,249575
RECOLL.txt,247540,249607,2067,20,Y,Y,1450281669613,248365,249575
RECOLL.txt,247709,250425,2716,20,Y,Y,1450281669613,248365,249575
RECOLL.txt,248302,251227,2925,20,Y,Y,1450281669613,248365,249575
RECOLL.txt,248983,251677,2694,20,Y,Y,1450281669613,248365,249575
RECOLL.txt,249610,252438,2828,20,Y,Y,1450282101282,251678,252272
RECOLL.txt,250428,253265,2837,20,Y,Y,1450282101282,251678,252272
RECOLL.txt,251228,254391,3163,20,Y,Y,1450282101282,251678,252272
RECOLL.txt,251680,255113,3433,20,Y,Y,1450282101282,251678,252272
RECOLL.txt,252439,255723,3284,20,Y,Y,1449243316327,255345,255936
RECOLL.txt,253266,256514,3248,20,Y,Y,1449243316327,255345,255936
RECOLL.txt,254394,257487,3093,20,Y,Y,1449243316327,255345,255936
RECOLL.txt,255114,258034,2920,20,Y,Y,1449243316327,255345,255936
RECOLL.txt,255725,258520,2795,20,Y,Y,1449243316327,255345,255936
RECOLL.txt,256515,258942,2427,20,Y,Y,1449477805345,258325,259491
RECOLL.txt,257488,259516,2028,20,Y,Y,1449477805345,258325,259491
RECOLL.txt,258035,260201,2166,20,Y,Y,1449477805345,258325,259491
RECOLL.txt,258521,261032,2511,20,Y,Y,1449477805345,258325,259491
RECOLL.txt,258943,262261,3318,20,Y,Y,1449477805345,258325,259491
RECOLL.txt,259521,262753,3232,20,Y,N,-,-1,-1
RECOLL.txt,260202,263349,3147,20,N,N,-,-1,-1
RECOLL.txt,261035,264017,2982,20,Y,N,-,-1,-1
RECOLL.txt,262262,264533,2271,20,Y,N,-,-1,-1
RECOLL.txt,262754,265178,2424,20,Y,N,-,-1,-1
RECOLL.txt,263351,265662,2311,20,Y,Y,1449478274965,265280,265790
RECOLL.txt,264020,266169,2149,20,Y,Y,1449478274965,265280,265790
RECOLL.txt,264534,266643,2109,20,Y,Y,1449478274965,265280,265790
RECOLL.txt,265179,267145,1966,20,Y,Y,1449478274965,265280,265790
RECOLL.txt,265663,267802,2139,20,Y,Y,1449478274965,265280,265790
RECOLL.txt,266170,268705,2535,20,Y,N,-,-1,-1
RECOLL.txt,266644,269494,2850,20,Y,N,-,-1,-1
RECOLL.txt,267146,270106,2960,20,Y,N,-,-1,-1
RECOLL.txt,267803,270585,2782,20,N,N,-,-1,-1
RECOLL.txt,268708,271130,2422,20,N,N,-,-1,-1
RECOLL.txt,269495,271769,2274,20,N,N,-,-1,-1
RECOLL.txt,270107,272414,2307,20,N,Y,1449478691795,272071,273405
RECOLL.txt,270586,273199,2613,20,Y,Y,1449478691795,272071,273405
RECOLL.txt,271131,274092,2961,20,Y,Y,1449478691795,272071,273405
RECOLL.txt,271770,274727,2957,20,N,Y,1449478691795,272071,273405
RECOLL.txt,272415,275979,3564,20,Y,Y,1449478691795,272071,273405
RECOLL.txt,273200,276815,3615,20,N,Y,1449478691795,272071,273405
RECOLL.txt,274093,277861,3768,20,N,N,-,-1,-1
RECOLL.txt,274728,278509,3781,20,Y,Y,1449478940431,277862,278041
RECOLL.txt,275980,279414,3434,20,Y,Y,1449478940431,277862,278041
RECOLL.txt,276816,280688,3872,20,Y,Y,1449478940431,277862,278041
RECOLL.txt,277864,281381,3517,20,Y,Y,1449478940431,277862,278041
RECOLL.txt,278512,281948,3436,20,Y,Y,1449479202651,279288,279481
RECOLL.txt,279415,282601,3186,20,Y,Y,1449479202651,279288,279481
RECOLL.txt,280691,283754,3063,20,N,N,-,-1,-1
RECOLL.txt,281382,284313,2931,20,N,N,-,-1,-1
RECOLL.txt,281949,284730,2781,20,N,N,-,-1,-1
RECOLL.txt,282604,285140,2536,20,Y,N,-,-1,-1
RECOLL.txt,283756,285785,2029,20,N,N,-,-1,-1
RECOLL.txt,284314,286447,2133,20,Y,N,-,-1,-1
RECOLL.txt,284732,287150,2418,20,N,N,-,-1,-1
RECOLL.txt,285141,287873,2732,20,Y,N,-,-1,-1
RECOLL.txt,285786,288666,2880,20,Y,Y,1449479515559,287879,288347
RECOLL.txt,286448,289114,2666,20,Y,Y,1449479515559,287879,288347
RECOLL.txt,287151,289617,2466,20,Y,Y,1449479515559,287879,288347
RECOLL.txt,287876,290031,2155,20,Y,Y,1449479980197,289681,290130
RECOLL.txt,288669,290698,2029,20,Y,Y,1449479980197,289681,290130
RECOLL.txt,289115,291306,2191,20,Y,Y,1449479980197,289681,290130
RECOLL.txt,289618,292033,2415,20,Y,Y,1449479980197,289681,290130
RECOLL.txt,290032,292796,2764,20,Y,Y,1449479980197,289681,290130
RECOLL.txt,290703,293247,2544,20,N,N,-,-1,-1
RECOLL.txt,291307,293939,2632,20,N,N,-,-1,-1
RECOLL.txt,292034,294412,2378,20,Y,Y,1449480291305,294170,295182
RECOLL.txt,292797,295184,2387,20,Y,Y,1449480291305,294170,295182
RECOLL.txt,293248,295705,2457,20,Y,Y,1449480291305,294170,295182
RECOLL.txt,293939,296191,2252,20,Y,Y,1449480505835,295854,296393
RECOLL.txt,294413,296624,2211,20,Y,Y,1449480505835,295854,296393
RECOLL.txt,295187,297273,2086,20,Y,Y,1449480505835,295854,296393
RECOLL.txt,295706,297775,2069,20,Y,Y,1449480881121,297386,298052
RECOLL.txt,296192,298233,2041,20,Y,Y,1449480881121,297386,298052
RECOLL.txt,296627,299039,2412,20,Y,Y,1449480881121,297386,298052
RECOLL.txt,297274,299581,2307,20,Y,Y,1449480881121,297386,298052
RECOLL.txt,297776,300134,2358,20,Y,Y,1449480881121,297386,298052
RECOLL.txt,298236,300969,2733,20,Y,Y,1450284116337,300339,301692
RECOLL.txt,299040,301466,2426,20,Y,Y,1450284116337,300339,301692
RECOLL.txt,299582,302205,2623,20,Y,Y,1450284116337,300339,301692
RECOLL.txt,300135,303020,2885,20,Y,Y,1450284116337,300339,301692
RECOLL.txt,300971,303388,2417,20,Y,Y,1450284116337,300339,301692
RECOLL.txt,301467,304261,2794,20,Y,Y,1450284116337,300339,301692
RECOLL.txt,302208,304843,2635,20,N,N,-,-1,-1
RECOLL.txt,303021,305548,2527,20,Y,N,-,-1,-1
RECOLL.txt,303389,306420,3031,20,Y,N,-,-1,-1
RECOLL.txt,304262,306943,2681,20,Y,N,-,-1,-1
RECOLL.txt,304846,307749,2903,20,Y,Y,1450350186677,307230,309481
RECOLL.txt,305551,308232,2681,20,Y,Y,1450350186677,307230,309481
RECOLL.txt,306421,309078,2657,20,Y,Y,1450350186677,307230,309481
RECOLL.txt,306944,309657,2713,20,Y,Y,1450350186677,307230,309481
RECOLL.txt,307750,310190,2440,20,Y,Y,1450350186677,307230,309481
RECOLL.txt,308233,310728,2495,20,Y,Y,1450350186677,307230,309481
RECOLL.txt,309079,311364,2285,20,Y,Y,1450350186677,307230,309481
RECOLL.txt,309658,311897,2239,20,Y,Y,1450350675404,309528,311486
RECOLL.txt,310191,312478,2287,20,Y,Y,1450350675404,309528,311486
RECOLL.txt,310729,313198,2469,20,Y,Y,1450350675404,309528,311486
RECOLL.txt,311366,313835,2469,20,Y,Y,1450350675404,309528,311486
RECOLL.txt,311898,314573,2675,20,N,N,-,-1,-1
RECOLL.txt,312479,314970,2491,20,N,N,-,-1,-1
RECOLL.txt,313199,315904,2705,20,N,N,-,-1,-1
RECOLL.txt,313838,316616,2778,20,N,Y,1450350993349,315954,316737
RECOLL.txt,314574,317207,2633,20,Y,Y,1450350993349,315954,316737
RECOLL.txt,314975,317561,2586,20,Y,Y,1450350993349,315954,316737
RECOLL.txt,315905,318353,2448,20,Y,Y,1450350993349,315954,316737
RECOLL.txt,316619,319190,2571,20,N,Y,1450350993349,315954,316737
RECOLL.txt,317209,319929,2720,20,N,Y,1450351323826,319770,320896
RECOLL.txt,317562,320916,3354,20,Y,Y,1450351323826,319770,320896
RECOLL.txt,318354,321780,3426,20,Y,Y,1450351323826,319770,320896
RECOLL.txt,319192,322492,3300,20,Y,Y,1450351323826,319770,320896
RECOLL.txt,319930,323254,3324,20,Y,Y,1450351323826,319770,320896
RECOLL.txt,320921,323813,2892,20,Y,N,-,-1,-1
RECOLL.txt,321781,324770,2989,20,Y,N,-,-1,-1
RECOLL.txt,322495,325552,3057,20,Y,N,-,-1,-1
RECOLL.txt,323255,326189,2934,20,Y,N,-,-1,-1
RECOLL.txt,323814,326947,3133,20,Y,N,-,-1,-1
RECOLL.txt,324771,327869,3098,20,Y,N,-,-1,-1
RECOLL.txt,325553,328252,2699,20,Y,N,-,-1,-1
RECOLL.txt,326190,329885,3695,20,Y,N,-,-1,-1
RECOLL.txt,326950,331063,4113,20,Y,N,-,-1,-1
RECOLL.txt,327869,331908,4039,20,Y,N,-,-1,-1
RECOLL.txt,328257,332412,4155,20,Y,N,-,-1,-1
RECOLL.txt,329888,333019,3131,20,Y,N,-,-1,-1
RECOLL.txt,331066,333704,2638,20,Y,N,-,-1,-1
RECOLL.txt,331909,334451,2542,20,Y,N,-,-1,-1
RECOLL.txt,332413,335500,3087,20,Y,N,-,-1,-1
RECOLL.txt,333020,336158,3138,20,Y,N,-,-1,-1
RECOLL.txt,333705,336976,3271,20,Y,N,-,-1,-1
RECOLL.txt,334454,337654,3200,20,Y,N,-,-1,-1
RECOLL.txt,335503,338555,3052,20,Y,N,-,-1,-1
RECOLL.txt,336159,339315,3156,20,Y,N,-,-1,-1
RECOLL.txt,336977,339746,2769,20,Y,N,-,-1,-1
REMKEL1.txt,3,1808,1805,20,N,N,-,-1,-1
REMKEL1.txt,361,2047,1686,20,Y,N,-,-1,-1
REMKEL1.txt,785,2256,1471,20,Y,N,-,-1,-1
REMKEL1.txt,1586,2436,850,20,Y,N,-,-1,-1
REMKEL1.txt,1809,2579,770,20,Y,N,-,-1,-1
REMKEL1.txt,2048,2772,724,20,Y,N,-,-1,-1
REMKEL1.txt,2258,3094,836,20,Y,N,-,-1,-1
REMKEL1.txt,2437,3326,889,20,Y,N,-,-1,-1
REMKEL1.txt,2582,3682,1100,20,Y,N,-,-1,-1
REMKEL1.txt,2773,3877,1104,20,Y,N,-,-1,-1
REMKEL1.txt,3096,4031,935,20,N,N,-,-1,-1
REMKEL1.txt,3327,4306,979,20,N,N,-,-1,-1
REMKEL1.txt,3683,4532,849,20,Y,N,-,-1,-1
REMKEL1.txt,3878,4743,865,20,Y,N,-,-1,-1
REMKEL1.txt,4032,4902,870,20,Y,N,-,-1,-1
REMKEL1.txt,4307,5098,791,20,Y,N,-,-1,-1
REMKEL1.txt,4533,5241,708,20,Y,N,-,-1,-1
REMKEL1.txt,4744,5510,766,20,Y,N,-,-1,-1
REMKEL1.txt,4903,5744,841,20,N,N,-,-1,-1
REMKEL1.txt,5099,5935,836,20,N,N,-,-1,-1
REMKEL1.txt,5242,6128,886,20,Y,N,-,-1,-1
REMKEL1.txt,5511,6417,906,20,Y,N,-,-1,-1
REMKEL1.txt,5745,6569,824,20,Y,N,-,-1,-1
REMKEL1.txt,5936,6791,855,20,Y,N,-,-1,-1
REMKEL1.txt,6131,6943,812,20,Y,N,-,-1,-1
REMKEL1.txt,6418,7122,704,20,Y,N,-,-1,-1
REMKEL1.txt,6570,7328,758,20,Y,N,-,-1,-1
REMKEL1.txt,6792,7572,780,20,Y,N,-,-1,-1
REMKEL1.txt,6944,7836,892,20,N,N,-,-1,-1
REMKEL1.txt,7123,7956,833,20,N,N,-,-1,-1
REMKEL1.txt,7329,8198,869,20,Y,N,-,-1,-1
REMKEL1.txt,7574,8349,775,20,Y,N,-,-1,-1
REMKEL1.txt,7837,8523,686,20,Y,N,-,-1,-1
REMKEL1.txt,7957,8740,783,20,Y,N,-,-1,-1
REMKEL1.txt,8200,8948,748,20,Y,N,-,-1,-1
REMKEL1.txt,8352,9170,818,20,Y,N,-,-1,-1
REMKEL1.txt,8525,9502,977,20,Y,N,-,-1,-1
REMKEL1.txt,8741,9719,978,20,Y,N,-,-1,-1
REMKEL1.txt,8949,9923,974,20,Y,N,-,-1,-1
REMKEL1.txt,9171,10246,1075,20,Y,N,-,-1,-1
REMKEL1.txt,9503,10537,1034,20,Y,N,-,-1,-1
REMKEL1.txt,9721,10745,1024,20,Y,N,-,-1,-1
REMKEL1.txt,9924,10969,1045,20,Y,N,-,-1,-1
REMKEL1.txt,10247,11142,895,20,Y,N,-,-1,-1
REMKEL1.txt,10540,11629,1089,20,Y,N,-,-1,-1
REMKEL1.txt,10746,11955,1209,20,Y,N,-,-1,-1
REMKEL1.txt,10970,12321,1351,20,Y,N,-,-1,-1
REMKEL1.txt,11145,12491,1346,20,Y,N,-,-1,-1
REMKEL1.txt,11630,12605,975,20,Y,N,-,-1,-1
REMKEL1.txt,11956,12879,923,20,Y,N,-,-1,-1
REMKEL1.txt,12322,13023,701,20,Y,N,-,-1,-1
REMKEL1.txt,12492,13162,670,20,Y,N,-,-1,-1
REMKEL1.txt,12606,13293,687,20,Y,N,-,-1,-1
REMKEL1.txt,12880,13389,509,20,Y,N,-,-1,-1
REMKEL1.txt,13024,13608,584,20,Y,N,-,-1,-1
REMKEL1.txt,13163,13841,678,20,Y,N,-,-1,-1
REMKEL1.txt,13295,14043,748,20,Y,N,-,-1,-1
REMKEL1.txt,13390,14343,953,20,Y,N,-,-1,-1
REMKEL1.txt,13609,14551,942,20,Y,N,-,-1,-1
REMKEL1.txt,13842,14750,908,20,Y,N,-,-1,-1
REMKEL1.txt,14044,15026,982,20,Y,N,-,-1,-1
REMKEL1.txt,14344,15238,894,20,Y,N,-,-1,-1
REMKEL1.txt,14552,15396,844,20,Y,N,-,-1,-1
REMKEL1.txt,14751,15675,924,20,Y,N,-,-1,-1
REMKEL1.txt,15028,15883,855,20,Y,N,-,-1,-1
REMKEL1.txt,15239,16138,899,20,Y,N,-,-1,-1
REMKEL1.txt,15397,16251,854,20,Y,N,-,-1,-1
REMKEL1.txt,15676,16424,748,20,Y,N,-,-1,-1
REMKEL1.txt,15884,16620,736,20,Y,N,-,-1,-1
REMKEL1.txt,16139,17248,1109,20,Y,N,-,-1,-1
REMKEL1.txt,16252,17806,1554,20,Y,N,-,-1,-1
REMKEL1.txt,16425,18921,2496,20,Y,N,-,-1,-1
REMKEL1.txt,16623,19835,3212,20,Y,N,-,-1,-1
REMKEL1.txt,17249,20685,3436,20,Y,N,-,-1,-1
REMKEL1.txt,17807,21312,3505,20,Y,N,-,-1,-1
REMKEL1.txt,18923,21789,2866,20,Y,N,-,-1,-1
REMKEL1.txt,19836,22648,2812,20,Y,N,-,-1,-1
REMKEL1.txt,20686,23735,3049,20,Y,N,-,-1,-1
REMKEL1.txt,21313,24644,3331,20,Y,N,-,-1,-1
REMKEL1.txt,21791,25658,3867,20,Y,N,-,-1,-1
REMKEL1.txt,22651,27036,4385,20,Y,N,-,-1,-1
REMKEL1.txt,23736,27459,3723,20,Y,N,-,-1,-1
REMKEL1.txt,24645,28520,3875,20,Y,N,-,-1,-1
REMKEL1.txt,25660,29264,3604,20,Y,N,-,-1,-1
REMKEL1.txt,27037,29837,2800,20,Y,N,-,-1,-1
REMKEL1.txt,27460,30378,2918,20,Y,N,-,-1,-1
REMKEL1.txt,28523,31689,3166,20,Y,N,-,-1,-1
REMKEL1.txt,29265,32683,3418,20,Y,N,-,-1,-1
REMKEL1.txt,29840,33699,3859,20,Y,N,-,-1,-1
REMKEL1.txt,30379,34848,4469,20,Y,N,-,-1,-1
REMKEL1.txt,31694,35703,4009,20,Y,N,-,-1,-1
REMKEL1.txt,32685,36744,4059,20,Y,N,-,-1,-1
REMKEL1.txt,33700,37436,3736,20,Y,N,-,-1,-1
REMKEL1.txt,34849,38242,3393,20,Y,N,-,-1,-1
REMKEL1.txt,35706,38921,3215,20,Y,N,-,-1,-1
REMKEL1.txt,36745,39421,2676,20,Y,N,-,-1,-1
REMKEL1.txt,37439,40326,2887,20,Y,N,-,-1,-1
REMKEL1.txt,38243,41405,3162,20,Y,N,-,-1,-1
REMKEL1.txt,38924,41593,2669,20,Y,N,-,-1,-1
REMKEL1.txt,39424,42317,2893,20,Y,N,-,-1,-1
REMKEL1.txt,40327,42440,2113,20,N,N,-,-1,-1
REMKEL1.txt,41407,42581,1174,20,N,N,-,-1,-1
REMKEL1.txt,41594,43529,1935,20,Y,N,-,-1,-1
REMKEL1.txt,42320,44276,1956,20,N,N,-,-1,-1
REMKEL1.txt,42443,45084,2641,20,N,N,-,-1,-1
REMKEL1.txt,42584,45656,3072,20,N,N,-,-1,-1
REMKEL1.txt,43530,46134,2604,20,N,N,-,-1,-1
REMKEL1.txt,44277,46863,2586,20,N,N,-,-1,-1
REMKEL1.txt,45085,47498,2413,20,N,N,-,-1,-1
REMKEL1.txt,45657,48621,2964,20,N,N,-,-1,-1
REMKEL1.txt,46135,49868,3733,20,N,N,-,-1,-1
REMKEL1.txt,46868,50643,3775,20,N,Y,1427373119628,50476,51323
REMKEL1.txt,47501,51802,4301,20,N,Y,1427373119628,50476,51323
REMKEL1.txt,48624,52795,4171,20,N,Y,1427373119628,50476,51323
REMKEL1.txt,49869,53880,4011,20,Y,Y,1427373119628,50476,51323
REMKEL1.txt,50644,54699,4055,20,Y,Y,1427373119628,50476,51323
REMKEL1.txt,51805,55260,3455,20,Y,Y,1427373691557,54475,55337
REMKEL1.txt,52798,55778,2980,20,Y,Y,1427373691557,54475,55337
REMKEL1.txt,53881,56639,2758,20,Y,Y,1427373691557,54475,55337
REMKEL1.txt,54700,57325,2625,20,Y,Y,1427373691557,54475,55337
REMKEL1.txt,55261,58193,2932,20,Y,Y,1427373691557,54475,55337
REMKEL1.txt,55779,59173,3394,20,N,N,-,-1,-1
REMKEL1.txt,56641,59836,3195,20,N,N,-,-1,-1
REMKEL1.txt,57326,60770,3444,20,N,N,-,-1,-1
REMKEL1.txt,58196,61666,3470,20,Y,N,-,-1,-1
REMKEL1.txt,59174,62444,3270,20,Y,N,-,-1,-1
REMKEL1.txt,59837,62967,3130,20,Y,N,-,-1,-1
REMKEL1.txt,60771,63787,3016,20,Y,N,-,-1,-1
REMKEL1.txt,61667,64746,3079,20,N,N,-,-1,-1
REMKEL1.txt,62447,65318,2871,20,N,N,-,-1,-1
REMKEL1.txt,62968,66136,3168,20,N,N,-,-1,-1
REMKEL1.txt,63792,67032,3240,20,N,N,-,-1,-1
REMKEL1.txt,64747,67976,3229,20,N,N,-,-1,-1
REMKEL1.txt,65319,69358,4039,20,N,N,-,-1,-1
REMKEL1.txt,66137,69816,3679,20,N,N,-,-1,-1
REMKEL1.txt,67034,70431,3397,20,N,N,-,-1,-1
REMKEL1.txt,67977,71360,3383,20,N,N,-,-1,-1
REMKEL1.txt,69359,72088,2729,20,N,N,-,-1,-1
REMKEL1.txt,69817,72574,2757,20,N,N,-,-1,-1
REMKEL1.txt,70433,73318,2885,20,N,N,-,-1,-1
REMKEL1.txt,71361,74510,3149,20,Y,Y,1427375995210,73781,74572
REMKEL1.txt,72091,75257,3166,20,Y,Y,1427375995210,73781,74572
REMKEL1.txt,72575,76191,3616,20,Y,Y,1427376630476,75869,76825
REMKEL1.txt,73319,77065,3746,20,Y,Y,1427376630476,75869,76825
REMKEL1.txt,74511,77688,3177,20,Y,Y,1427376630476,75869,76825
REMKEL1.txt,75258,78634,3376,20,Y,Y,1427376630476,75869,76825
REMKEL1.txt,76192,79176,2984,20,Y,Y,1427376630476,75869,76825
REMKEL1.txt,77066,80274,3208,20,Y,N,-,-1,-1
REMKEL1.txt,77689,80760,3071,20,Y,Y,1427377322048,80447,80948
REMKEL1.txt,78635,81521,2886,20,Y,Y,1427377322048,80447,80948
REMKEL1.txt,79179,82206,3027,20,Y,Y,1427377322048,80447,80948
REMKEL1.txt,80277,82683,2406,20,Y,Y,1427377322048,80447,80948
REMKEL1.txt,80763,83002,2239,20,Y,Y,1427377322048,80447,80948
REMKEL1.txt,81523,83268,1745,20,Y,Y,1427379129074,80977,81930
REMKEL1.txt,82207,83568,1361,20,Y,Y,1427379753297,81978,82676
REMKEL1.txt,82686,84160,1474,20,Y,N,-,-1,-1
REMKEL1.txt,83003,84696,1693,20,Y,Y,1427459918395,84645,85149
REMKEL1.txt,83270,85388,2118,20,Y,Y,1427459918395,84645,85149
REMKEL1.txt,83569,85812,2243,20,Y,Y,1427459918395,84645,85149
REMKEL1.txt,84161,86447,2286,20,Y,Y,1427459918395,84645,85149
REMKEL1.txt,84697,87235,2538,20,Y,Y,1427459918395,84645,85149
REMKEL1.txt,85391,88070,2679,20,Y,Y,1427460086043,85397,86219
REMKEL1.txt,85813,89379,3566,20,Y,Y,1427460086043,85397,86219
REMKEL1.txt,86448,90133,3685,20,N,N,-,-1,-1
REMKEL1.txt,87236,91558,4322,20,N,N,-,-1,-1
REMKEL1.txt,88071,92684,4613,20,N,N,-,-1,-1
REMKEL1.txt,89380,93278,3898,20,N,N,-,-1,-1
REMKEL1.txt,90134,93701,3567,20,N,N,-,-1,-1
REMKEL1.txt,91561,93900,2339,20,N,N,-,-1,-1
REMKEL1.txt,92687,94597,1910,20,N,N,-,-1,-1
REMKEL1.txt,93279,95264,1985,20,N,N,-,-1,-1
REMKEL1.txt,93702,96096,2394,20,N,N,-,-1,-1
REMKEL1.txt,93901,96790,2889,20,N,N,-,-1,-1
REMKEL1.txt,94598,97489,2891,20,N,Y,1427461889324,97013,98033
REMKEL1.txt,95265,98504,3239,20,Y,Y,1427462513930,98050,98577
REMKEL1.txt,96097,99487,3390,20,Y,Y,1427462513930,98050,98577
REMKEL1.txt,96791,100220,3429,20,Y,Y,1427462513930,98050,98577
REMKEL1.txt,97490,100937,3447,20,Y,Y,1427462513930,98050,98577
REMKEL1.txt,98505,102092,3587,20,Y,Y,1427462513930,98050,98577
REMKEL1.txt,99488,102898,3410,20,Y,Y,1427462848427,99143,100650
REMKEL1.txt,100221,103709,3488,20,Y,Y,1428065655005,103366,109009
REMKEL1.txt,100938,104579,3641,20,Y,Y,1428065655005,103366,109009
REMKEL1.txt,102095,105311,3216,20,Y,Y,1428065655005,103366,109009
REMKEL1.txt,102899,105942,3043,20,Y,Y,1428065655005,103366,109009
REMKEL1.txt,103710,107038,3328,20,Y,Y,1428065655005,103366,109009
REMKEL1.txt,104580,108070,3490,20,Y,Y,1428065655005,103366,109009
REMKEL1.txt,105312,108681,3369,20,Y,Y,1428065655005,103366,109009
REMKEL1.txt,105943,109842,3899,20,Y,Y,1428065655005,103366,109009
REMKEL1.txt,107041,110719,3678,20,Y,Y,1428065655005,103366,109009
REMKEL1.txt,108071,111433,3362,20,Y,Y,1428065655005,103366,109009
REMKEL1.txt,108682,112204,3522,20,N,Y,1428065655005,103366,109009
REMKEL1.txt,109845,112818,2973,20,N,N,-,-1,-1
REMKEL1.txt,110720,113589,2869,20,Y,N,-,-1,-1
REMKEL1.txt,111434,114252,2818,20,Y,N,-,-1,-1
REMKEL1.txt,112205,114733,2528,20,Y,Y,1428139555093,114267,115295
REMKEL1.txt,112821,116021,3200,20,Y,Y,1428139555093,114267,115295
REMKEL1.txt,113590,116704,3114,20,Y,Y,1428139555093,114267,115295
REMKEL1.txt,114255,117343,3088,20,Y,Y,1428139555093,114267,115295
REMKEL1.txt,114734,118222,3488,20,Y,Y,1428139555093,114267,115295
REMKEL1.txt,116022,118893,2871,20,Y,N,-,-1,-1
REMKEL1.txt,116705,119677,2972,20,Y,Y,1428140980187,119629,120812
REMKEL1.txt,117344,120418,3074,20,Y,Y,1428140980187,119629,120812
REMKEL1.txt,118223,121062,2839,20,Y,Y,1428140980187,119629,120812
REMKEL1.txt,118894,121231,2337,20,Y,Y,1428140980187,119629,120812
REMKEL1.txt,119678,121486,1808,20,Y,Y,1428140980187,119629,120812
REMKEL1.txt,120419,121793,1374,20,N,Y,1428140980187,119629,120812
REMKEL1.txt,121063,122543,1480,20,N,N,-,-1,-1
REMKEL1.txt,121232,123815,2583,20,N,N,-,-1,-1
REMKEL1.txt,121487,124527,3040,20,N,N,-,-1,-1
REMKEL1.txt,121794,125384,3590,20,Y,Y,1428142329788,124908,125971
REMKEL1.txt,122546,126091,3545,20,Y,Y,1428142329788,124908,125971
REMKEL1.txt,123816,127280,3464,20,Y,Y,1428142329788,124908,125971
REMKEL1.txt,124530,128061,3531,20,Y,Y,1428142329788,124908,125971
REMKEL1.txt,125386,128554,3168,20,Y,Y,1428142329788,124908,125971
REMKEL1.txt,126094,129515,3421,20,Y,N,-,-1,-1
REMKEL1.txt,127283,130238,2955,20,Y,N,-,-1,-1
REMKEL1.txt,128062,130846,2784,20,Y,N,-,-1,-1
REMKEL1.txt,128555,132162,3607,20,Y,N,-,-1,-1
REMKEL1.txt,129517,132942,3425,20,Y,N,-,-1,-1
REMKEL1.txt,130239,133658,3419,20,Y,N,-,-1,-1
REMKEL1.txt,130847,134682,3835,20,N,N,-,-1,-1
REMKEL1.txt,132163,135801,3638,20,N,N,-,-1,-1
REMKEL1.txt,132945,136433,3488,20,N,N,-,-1,-1
REMKEL1.txt,133659,136887,3228,20,N,N,-,-1,-1
REMKEL1.txt,134685,137732,3047,20,Y,N,-,-1,-1
REMKEL1.txt,135802,138672,2870,20,Y,N,-,-1,-1
REMKEL1.txt,136434,139347,2913,20,Y,N,-,-1,-1
REMKEL1.txt,136888,139840,2952,20,Y,N,-,-1,-1
REMKEL1.txt,137733,140688,2955,20,N,N,-,-1,-1
REMKEL1.txt,138674,141457,2783,20,N,N,-,-1,-1
REMKEL1.txt,139348,142256,2908,20,Y,N,-,-1,-1
REMKEL1.txt,139841,143270,3429,20,Y,Y,1428143866274,142277,143444
REMKEL1.txt,140689,144247,3558,20,Y,Y,1428143866274,142277,143444
REMKEL1.txt,141460,144977,3517,20,Y,Y,1428143866274,142277,143444
REMKEL1.txt,142259,145635,3376,20,Y,Y,1428143866274,142277,143444
REMKEL1.txt,143271,146118,2847,20,Y,Y,1428143866274,142277,143444
REMKEL1.txt,144250,147160,2910,20,N,N,-,-1,-1
REMKEL1.txt,144982,148185,3203,20,N,N,-,-1,-1
REMKEL1.txt,145636,148868,3232,20,Y,N,-,-1,-1
REMKEL1.txt,146119,149689,3570,20,Y,N,-,-1,-1
REMKEL1.txt,147161,150052,2891,20,Y,N,-,-1,-1
REMKEL1.txt,148186,150879,2693,20,Y,Y,1428144732441,150786,151788
REMKEL1.txt,148871,151803,2932,20,Y,Y,1428144732441,150786,151788
REMKEL1.txt,149692,152278,2586,20,Y,Y,1428144732441,150786,151788
REMKEL1.txt,150053,153159,3106,20,Y,Y,1428145340599,152563,152962
REMKEL1.txt,150880,153811,2931,20,Y,Y,1428145340599,152563,152962
REMKEL1.txt,151806,154461,2655,20,Y,Y,1428145340599,152563,152962
REMKEL1.txt,152280,154910,2630,20,Y,Y,1428145340599,152563,152962
REMKEL1.txt,153161,155518,2357,20,Y,N,-,-1,-1
REMKEL1.txt,153812,156221,2409,20,Y,N,-,-1,-1
REMKEL1.txt,154462,156862,2400,20,Y,N,-,-1,-1
REMKEL1.txt,154911,157728,2817,20,Y,N,-,-1,-1
REMKEL1.txt,155519,158644,3125,20,Y,N,-,-1,-1
REMKEL1.txt,156224,159127,2903,20,Y,N,-,-1,-1
REMKEL1.txt,156865,160132,3267,20,N,N,-,-1,-1
REMKEL1.txt,157729,161031,3302,20,N,N,-,-1,-1
REMKEL1.txt,158645,161902,3257,20,N,N,-,-1,-1
REMKEL1.txt,159128,162636,3508,20,N,N,-,-1,-1
REMKEL1.txt,160133,163374,3241,20,N,N,-,-1,-1
REMKEL1.txt,161034,164032,2998,20,Y,Y,1428156251387,163375,165208
REMKEL1.txt,161903,164962,3059,20,Y,Y,1428156251387,163375,165208
REMKEL1.txt,162637,165864,3227,20,Y,Y,1428156251387,163375,165208
REMKEL1.txt,163377,166400,3023,20,Y,Y,1428164866689,166001,167438
REMKEL1.txt,164035,167204,3169,20,Y,Y,1428164866689,166001,167438
REMKEL1.txt,164963,167759,2796,20,Y,Y,1428164866689,166001,167438
REMKEL1.txt,165867,168367,2500,20,Y,Y,1428164866689,166001,167438
REMKEL1.txt,166401,169156,2755,20,Y,Y,1428164866689,166001,167438
REMKEL1.txt,167205,169968,2763,20,Y,Y,1428164866689,166001,167438
REMKEL1.txt,167761,170840,3079,20,Y,Y,1428166121742,169838,170346
REMKEL1.txt,168370,171828,3458,20,Y,Y,1428166121742,169838,170346
REMKEL1.txt,169157,172283,3126,20,Y,Y,1428166121742,169838,170346
REMKEL1.txt,169969,172928,2959,20,Y,Y,1428166121742,169838,170346
REMKEL1.txt,170842,173922,3080,20,Y,Y,1428167038498,170602,172231
REMKEL1.txt,171831,174980,3149,20,Y,Y,1428167038498,170602,172231
REMKEL1.txt,172285,175842,3557,20,Y,N,-,-1,-1
REMKEL1.txt,172929,176313,3384,20,Y,N,-,-1,-1
REMKEL1.txt,173923,177299,3376,20,Y,N,-,-1,-1
REMKEL1.txt,174981,177910,2929,20,Y,N,-,-1,-1
REMKEL1.txt,175843,178661,2818,20,N,N,-,-1,-1
REMKEL1.txt,176316,178994,2678,20,N,N,-,-1,-1
REMKEL1.txt,177300,179787,2487,20,N,N,-,-1,-1
REMKEL1.txt,177911,180494,2583,20,N,N,-,-1,-1
REMKEL1.txt,178661,181340,2679,20,N,N,-,-1,-1
REMKEL1.txt,178997,181828,2831,20,N,N,-,-1,-1
REMKEL1.txt,179788,182333,2545,20,Y,N,-,-1,-1
REMKEL1.txt,180497,183386,2889,20,Y,N,-,-1,-1
REMKEL1.txt,181341,184061,2720,20,Y,N,-,-1,-1
REMKEL1.txt,181829,185262,3433,20,Y,N,-,-1,-1
REMKEL1.txt,182334,185788,3454,20,Y,N,-,-1,-1
REMKEL1.txt,183387,186607,3220,20,Y,Y,1429179224952,186363,187163
REMKEL1.txt,184062,187335,3273,20,N,Y,1429179224952,186363,187163
REMKEL1.txt,185264,187901,2637,20,Y,Y,1429179224952,186363,187163
REMKEL1.txt,185790,188191,2401,20,Y,Y,1429179224952,186363,187163
REMKEL1.txt,186608,188656,2048,20,Y,Y,1429179224952,186363,187163
REMKEL1.txt,187336,189756,2420,20,Y,N,-,-1,-1
REMKEL1.txt,187902,190426,2524,20,Y,N,-,-1,-1
REMKEL1.txt,188192,191178,2986,20,N,N,-,-1,-1
REMKEL1.txt,188657,191835,3178,20,Y,Y,1429180017418,191485,192427
REMKEL1.txt,189759,192308,2549,20,Y,Y,1429180017418,191485,192427
REMKEL1.txt,190429,193026,2597,20,Y,Y,1429180740975,192464,193718
REMKEL1.txt,191179,193894,2715,20,Y,Y,1429180740975,192464,193718
REMKEL1.txt,191836,194891,3055,20,Y,Y,1429180740975,192464,193718
REMKEL1.txt,192309,195727,3418,20,Y,Y,1429180740975,192464,193718
REMKEL1.txt,193028,196796,3768,20,Y,Y,1429180740975,192464,193718
REMKEL1.txt,193895,197838,3943,20,Y,N,-,-1,-1
REMKEL1.txt,194892,199106,4214,20,Y,N,-,-1,-1
REMKEL1.txt,195728,199923,4195,20,Y,N,-,-1,-1
REMKEL1.txt,196797,200610,3813,20,Y,N,-,-1,-1
REMKEL1.txt,197839,201329,3490,20,N,N,-,-1,-1
REMKEL1.txt,199109,202407,3298,20,N,N,-,-1,-1
REMKEL1.txt,199926,203963,4037,20,N,N,-,-1,-1
REMKEL1.txt,200611,204259,3648,20,N,N,-,-1,-1
REMKEL1.txt,201332,204769,3437,20,N,N,-,-1,-1
REMKEL1.txt,202408,205983,3575,20,N,N,-,-1,-1
REMKEL1.txt,203966,207066,3100,20,N,N,-,-1,-1
REMKEL1.txt,204260,208150,3890,20,Y,N,-,-1,-1
REMKEL1.txt,204770,208760,3990,20,Y,Y,1429183348411,208524,209310
REMKEL1.txt,205984,209323,3339,20,Y,Y,1429183348411,208524,209310
REMKEL1.txt,207067,209962,2895,20,Y,Y,1429183348411,208524,209310
REMKEL1.txt,208153,211005,2852,20,N,Y,1429183348411,208524,209310
REMKEL1.txt,208761,211791,3030,20,N,Y,1429183348411,208524,209310
REMKEL1.txt,209324,212278,2954,20,N,N,-,-1,-1
REMKEL1.txt,209963,213603,3640,20,N,N,-,-1,-1
REMKEL1.txt,211006,214114,3108,20,Y,Y,1429184555165,213619,214284
REMKEL1.txt,211794,214932,3138,20,Y,Y,1429184555165,213619,214284
REMKEL1.txt,212279,215527,3248,20,Y,Y,1429184555165,213619,214284
REMKEL1.txt,213606,216121,2515,20,Y,Y,1429184555165,213619,214284
REMKEL1.txt,214115,217090,2975,20,Y,Y,1429184555165,213619,214284
REMKEL1.txt,214933,217875,2942,20,Y,N,-,-1,-1
REMKEL1.txt,215528,218887,3359,20,Y,N,-,-1,-1
REMKEL1.txt,216122,219123,3001,20,Y,N,-,-1,-1
REMKEL1.txt,217093,219977,2884,20,Y,N,-,-1,-1
REMKEL1.txt,217876,220774,2898,20,Y,N,-,-1,-1
REMKEL1.txt,218890,221250,2360,20,Y,N,-,-1,-1
REMKEL1.txt,219126,221608,2482,20,N,N,-,-1,-1
REMKEL1.txt,219978,222516,2538,20,N,N,-,-1,-1
REMKEL1.txt,220775,223360,2585,20,N,Y,1429478561003,223319,224140
REMKEL1.txt,221251,223912,2661,20,N,Y,1429478561003,223319,224140
REMKEL1.txt,221609,224687,3078,20,N,Y,1429478561003,223319,224140
REMKEL1.txt,222517,225318,2801,20,Y,Y,1429478561003,223319,224140
REMKEL1.txt,223362,226110,2748,20,Y,Y,1429478561003,223319,224140
REMKEL1.txt,223913,226691,2778,20,Y,Y,1429478561003,223319,224140
REMKEL1.txt,224688,227067,2379,20,Y,Y,1429479695836,224360,224906
REMKEL1.txt,225320,227439,2119,20,Y,N,-,-1,-1
REMKEL1.txt,226111,228233,2122,20,Y,N,-,-1,-1
REMKEL1.txt,226692,229433,2741,20,Y,N,-,-1,-1
REMKEL1.txt,227068,230671,3603,20,Y,N,-,-1,-1
REMKEL1.txt,227440,232184,4744,20,N,N,-,-1,-1
REMKEL1.txt,228236,233659,5423,20,N,N,-,-1,-1
REMKEL1.txt,229435,234432,4997,20,N,N,-,-1,-1
REMKEL1.txt,230672,235144,4472,20,N,N,-,-1,-1
REMKEL1.txt,232187,236510,4323,20,N,N,-,-1,-1
REMKEL1.txt,233662,237428,3766,20,N,N,-,-1,-1
REMKEL1.txt,234433,238362,3929,20,Y,N,-,-1,-1
REMKEL1.txt,235145,239257,4112,20,Y,N,-,-1,-1
REMKEL1.txt,236511,240295,3784,20,Y,N,-,-1,-1
REMKEL1.txt,237430,241208,3778,20,Y,N,-,-1,-1
REMKEL1.txt,238363,242302,3939,20,Y,Y,1429702947558,242053,243400
REMKEL1.txt,239260,243005,3745,20,Y,Y,1429702947558,242053,243400
REMKEL1.txt,240298,243464,3166,20,Y,Y,1429702947558,242053,243400
REMKEL1.txt,241209,244494,3285,20,Y,Y,1429702947558,242053,243400
REMKEL1.txt,242303,245338,3035,20,Y,Y,1429702947558,242053,243400
REMKEL1.txt,243006,246604,3598,20,Y,Y,1429702947558,242053,243400
REMKEL1.txt,243467,247837,4370,20,Y,Y,1429703626688,244429,245446
REMKEL1.txt,244495,248579,4084,20,Y,Y,1429703626688,244429,245446
REMKEL1.txt,245339,249522,4183,20,N,Y,1429703626688,244429,245446
REMKEL1.txt,246605,250298,3693,20,N,N,-,-1,-1
REMKEL1.txt,247838,251835,3997,20,N,N,-,-1,-1
REMKEL1.txt,248582,253133,4551,20,N,N,-,-1,-1
REMKEL1.txt,249523,254388,4865,20,N,Y,1430585951765,253480,254126
REMKEL1.txt,250299,255724,5425,20,N,Y,1430585951765,253480,254126
REMKEL1.txt,251835,256148,4313,20,N,Y,1430585951765,253480,254126
REMKEL1.txt,253134,257068,3934,20,Y,Y,1430585951765,253480,254126
REMKEL1.txt,254389,258181,3792,20,Y,N,-,-1,-1
REMKEL1.txt,255725,259061,3336,20,Y,N,-,-1,-1
REMKEL1.txt,256149,260716,4567,20,Y,Y,1430588560920,259596,260149
REMKEL1.txt,257069,261777,4708,20,Y,Y,1430588560920,259596,260149
REMKEL1.txt,258182,262878,4696,20,Y,Y,1430588560920,259596,260149
REMKEL1.txt,259062,263725,4663,20,Y,Y,1430588560920,259596,260149
REMKEL1.txt,260719,264377,3658,20,Y,N,-,-1,-1
REMKEL1.txt,261778,265125,3347,20,Y,N,-,-1,-1
REMKEL1.txt,262879,266495,3616,20,Y,N,-,-1,-1
REMKEL1.txt,263726,266989,3263,20,Y,N,-,-1,-1
REMKEL1.txt,264378,267445,3067,20,Y,N,-,-1,-1
REMKEL1.txt,265126,268854,3728,20,Y,N,-,-1,-1
REMKEL1.txt,266498,269538,3040,20,N,N,-,-1,-1
REMKEL1.txt,266990,270070,3080,20,Y,N,-,-1,-1
REMKEL1.txt,267446,270775,3329,20,Y,N,-,-1,-1
REMKEL1.txt,268855,271739,2884,20,Y,N,-,-1,-1
REMKEL1.txt,269539,272827,3288,20,Y,N,-,-1,-1
REMKEL1.txt,270071,273776,3705,20,Y,N,-,-1,-1
REMKEL1.txt,270776,274278,3502,20,Y,N,-,-1,-1
REMKEL1.txt,271742,275513,3771,20,Y,N,-,-1,-1
REMKEL1.txt,272828,276198,3370,20,Y,Y,1430593986926,275535,275764
REMKEL1.txt,273777,277628,3851,20,Y,Y,1430593986926,275535,275764
REMKEL1.txt,274279,279210,4931,20,Y,Y,1430593986926,275535,275764
REMKEL1.txt,275514,280661,5147,20,Y,Y,1430593986926,275535,275764
REMKEL1.txt,276199,281251,5052,20,Y,Y,1430594989217,280917,281849
REMKEL1.txt,277629,282481,4852,20,Y,Y,1430594989217,280917,281849
REMKEL1.txt,279213,283098,3885,20,Y,Y,1430594989217,280917,281849
REMKEL1.txt,280662,284255,3593,20,Y,Y,1430594989217,280917,281849
REMKEL1.txt,281252,285005,3753,20,Y,Y,1430594989217,280917,281849
REMKEL1.txt,282481,285489,3008,20,Y,N,-,-1,-1
REMKEL1.txt,283099,286756,3657,20,Y,N,-,-1,-1
REMKEL1.txt,284258,287287,3029,20,Y,N,-,-1,-1
REMKEL1.txt,285006,288249,3243,20,Y,N,-,-1,-1
REMKEL1.txt,285490,288881,3391,20,Y,N,-,-1,-1
REMKEL1.txt,286759,289509,2750,20,Y,N,-,-1,-1
REMKEL1.txt,287288,289962,2674,20,Y,N,-,-1,-1
REMKEL1.txt,288250,290540,2290,20,Y,N,-,-1,-1
REMKEL1.txt,288883,291385,2502,20,Y,N,-,-1,-1
REMKEL1.txt,289510,291944,2434,20,Y,N,-,-1,-1
REMKEL1.txt,289963,292880,2917,20,Y,N,-,-1,-1
REMKEL1.txt,290541,293360,2819,20,Y,N,-,-1,-1
REMKEL1.txt,291386,294059,2673,20,Y,N,-,-1,-1
REMKEL1.txt,291945,294903,2958,20,Y,N,-,-1,-1
REMKEL1.txt,292883,295674,2791,20,Y,N,-,-1,-1
REMKEL1.txt,293361,296380,3019,20,Y,N,-,-1,-1
REMKEL1.txt,294062,297543,3481,20,Y,N,-,-1,-1
REMKEL1.txt,294905,298117,3212,20,N,N,-,-1,-1
REMKEL1.txt,295675,298978,3303,20,Y,N,-,-1,-1
REMKEL1.txt,296381,299805,3424,20,Y,N,-,-1,-1
REMKEL1.txt,297546,300450,2904,20,Y,N,-,-1,-1
REMKEL1.txt,298120,300855,2735,20,Y,N,-,-1,-1
REMKEL1.txt,298979,302068,3089,20,Y,N,-,-1,-1
REMKEL1.txt,299806,303444,3638,20,Y,N,-,-1,-1
REMKEL1.txt,300451,304103,3652,20,Y,N,-,-1,-1
REMKEL1.txt,300856,304909,4053,20,N,N,-,-1,-1
REMKEL1.txt,302069,305823,3754,20,N,N,-,-1,-1
REMKEL1.txt,303445,307217,3772,20,N,N,-,-1,-1
REMKEL1.txt,304104,308015,3911,20,Y,N,-,-1,-1
REMKEL1.txt,304910,308845,3935,20,Y,N,-,-1,-1
REMKEL1.txt,305824,309656,3832,20,Y,N,-,-1,-1
REMKEL1.txt,307218,310535,3317,20,Y,N,-,-1,-1
REMKEL1.txt,308016,311122,3106,20,Y,N,-,-1,-1
REMKEL1.txt,308846,311804,2958,20,Y,N,-,-1,-1
REMKEL1.txt,309658,312720,3062,20,Y,N,-,-1,-1
REMKEL1.txt,310536,313301,2765,20,Y,N,-,-1,-1
REMKEL1.txt,311123,314477,3354,20,Y,N,-,-1,-1
REMKEL1.txt,311805,315003,3198,20,Y,N,-,-1,-1
REMKEL1.txt,312721,315819,3098,20,Y,N,-,-1,-1
REMKEL1.txt,313304,316702,3398,20,Y,N,-,-1,-1
REMKEL1.txt,314480,317131,2651,20,Y,N,-,-1,-1
REMKEL1.txt,315005,317961,2956,20,Y,N,-,-1,-1
REMKEL1.txt,315824,318982,3158,20,Y,N,-,-1,-1
REMKEL1.txt,316704,319836,3132,20,Y,N,-,-1,-1
REMKEL1.txt,317132,320252,3120,20,Y,N,-,-1,-1
REMKEL1.txt,317963,321096,3133,20,Y,N,-,-1,-1
REMKEL1.txt,318983,322120,3137,20,Y,Y,1430747238328,321121,323743
REMKEL1.txt,319839,322431,2592,20,Y,Y,1430747238328,321121,323743
REMKEL1.txt,320253,322773,2520,20,Y,Y,1430747238328,321121,323743
REMKEL1.txt,321097,323183,2086,20,Y,Y,1430747238328,321121,323743
REMKEL1.txt,322121,324295,2174,20,Y,Y,1430747238328,321121,323743
REMKEL1.txt,322432,325139,2707,20,Y,Y,1430747238328,321121,323743
REMKEL1.txt,322775,325720,2945,20,Y,Y,1430747238328,321121,323743
REMKEL1.txt,323186,326197,3011,20,Y,Y,1430749600786,325904,327946
REMKEL1.txt,324298,326695,2397,20,Y,Y,1430749600786,325904,327946
REMKEL1.txt,325140,327214,2074,20,Y,Y,1430749600786,325904,327946
REMKEL1.txt,325723,328143,2420,20,Y,Y,1430749600786,325904,327946
REMKEL1.txt,326198,328192,1994,20,Y,Y,1430749600786,325904,327946
REMKEL1.txt,326696,329304,2608,20,Y,Y,1430749600786,325904,327946
REMKEL1.txt,327217,329453,2236,20,N,Y,1430749600786,325904,327946
REMKEL1.txt,328143,330491,2348,20,N,N,-,-1,-1
REMKEL1.txt,328193,331190,2997,20,Y,N,-,-1,-1
REMKEL1.txt,329306,332258,2952,20,Y,Y,1430751146450,332109,333778
REMKEL1.txt,329456,332925,3469,20,Y,Y,1430751146450,332109,333778
REMKEL1.txt,330492,333565,3073,20,Y,Y,1430751146450,332109,333778
REMKEL1.txt,331192,334603,3411,20,Y,Y,1430751146450,332109,333778
REMKEL1.txt,332263,335952,3689,20,Y,Y,1430751146450,332109,333778
REMKEL1.txt,332928,337027,4099,20,Y,Y,1430751146450,332109,333778
REMKEL1.txt,333566,338449,4883,20,Y,Y,1430751146450,332109,333778
REMKEL1.txt,334606,339042,4436,20,Y,N,-,-1,-1
REMKEL1.txt,335953,339880,3927,20,Y,N,-,-1,-1
REMKEL1.txt,337028,341007,3979,20,Y,N,-,-1,-1
REMKEL1.txt,338450,341873,3423,20,Y,Y,1430753605807,341769,342306
REMKEL1.txt,339043,342799,3756,20,Y,Y,1430753605807,341769,342306
REMKEL1.txt,339881,344045,4164,20,Y,Y,1430753605807,341769,342306
REMKEL1.txt,341008,344633,3625,20,Y,Y,1430753605807,341769,342306
REMKEL1.txt,341874,345535,3661,20,Y,Y,1430753605807,341769,342306
REMKEL1.txt,342800,346358,3558,20,Y,N,-,-1,-1
REMKEL1.txt,344046,346878,2832,20,Y,N,-,-1,-1
REMKEL1.txt,344634,347767,3133,20,Y,N,-,-1,-1
REMKEL1.txt,345536,348139,2603,20,Y,N,-,-1,-1
REMKEL1.txt,346361,348522,2161,20,Y,N,-,-1,-1
REMKEL1.txt,346879,349506,2627,20,Y,Y,1430927911131,348654,350235
REMKEL1.txt,347768,350290,2522,20,Y,Y,1430927911131,348654,350235
REMKEL1.txt,348140,351223,3083,20,Y,Y,1430927911131,348654,350235
REMKEL1.txt,348523,352166,3643,20,Y,Y,1430927911131,348654,350235
REMKEL1.txt,349507,352654,3147,20,Y,Y,1430927911131,348654,350235
REMKEL1.txt,350293,353102,2809,20,Y,N,-,-1,-1
REMKEL1.txt,351224,353711,2487,20,Y,N,-,-1,-1
REMKEL1.txt,352167,354671,2504,20,Y,N,-,-1,-1
REMKEL1.txt,352654,355350,2696,20,Y,N,-,-1,-1
REMKEL1.txt,353104,355993,2889,20,Y,N,-,-1,-1
REMKEL1.txt,353712,356637,2925,20,Y,N,-,-1,-1
REMKEL1.txt,354672,357347,2675,20,Y,N,-,-1,-1
REMKEL1.txt,355353,357815,2462,20,Y,N,-,-1,-1
REMKEL1.txt,355994,358440,2446,20,N,N,-,-1,-1
REMKEL1.txt,356638,359338,2700,20,N,N,-,-1,-1
REMKEL1.txt,357347,359966,2619,20,N,N,-,-1,-1
REMKEL1.txt,357818,360636,2818,20,N,N,-,-1,-1
REMKEL1.txt,358441,362084,3643,20,N,N,-,-1,-1
REMKEL1.txt,359340,363000,3660,20,N,N,-,-1,-1
REMKEL1.txt,359967,363349,3382,20,N,Y,1431600860056,363201,364042
REMKEL1.txt,360639,364062,3423,20,Y,Y,1431600860056,363201,364042
REMKEL1.txt,362085,364856,2771,20,Y,Y,1431600860056,363201,364042
REMKEL1.txt,363001,365721,2720,20,Y,Y,1431600860056,363201,364042
REMKEL1.txt,363350,366640,3290,20,Y,Y,1431600860056,363201,364042
REMKEL1.txt,364065,367206,3141,20,Y,N,-,-1,-1
REMKEL1.txt,364857,368113,3256,20,Y,N,-,-1,-1
REMKEL1.txt,365722,368915,3193,20,Y,N,-,-1,-1
REMKEL1.txt,366641,369790,3149,20,Y,Y,1431602703832,369125,369571
REMKEL1.txt,367211,370403,3192,20,Y,Y,1431602703832,369125,369571
REMKEL1.txt,368114,371428,3314,20,Y,Y,1431602703832,369125,369571
REMKEL1.txt,368916,372047,3131,20,Y,Y,1431602703832,369125,369571
REMKEL1.txt,369791,372597,2806,20,Y,N,-,-1,-1
REMKEL1.txt,370404,373335,2931,20,Y,N,-,-1,-1
REMKEL1.txt,371431,373900,2469,20,Y,N,-,-1,-1
REMKEL1.txt,372050,374922,2872,20,Y,N,-,-1,-1
REMKEL1.txt,372598,375367,2769,20,Y,N,-,-1,-1
REMKEL1.txt,373336,375892,2556,20,Y,N,-,-1,-1
REMKEL1.txt,373901,376918,3017,20,Y,N,-,-1,-1
REMKEL1.txt,374925,377476,2551,20,Y,N,-,-1,-1
REMKEL1.txt,375367,379350,3983,20,Y,N,-,-1,-1
REMKEL1.txt,375893,379912,4019,20,Y,N,-,-1,-1
REMKEL1.txt,376919,380472,3553,20,Y,N,-,-1,-1
REMKEL1.txt,377479,381324,3845,20,Y,N,-,-1,-1
REMKEL1.txt,379351,381883,2532,20,Y,N,-,-1,-1
REMKEL1.txt,379913,382530,2617,20,Y,N,-,-1,-1
REMKEL1.txt,380473,383062,2589,20,Y,N,-,-1,-1
REMKEL1.txt,381327,383685,2358,20,Y,N,-,-1,-1
REMKEL1.txt,381884,384259,2375,20,Y,N,-,-1,-1
REMKEL1.txt,382531,384746,2215,20,Y,N,-,-1,-1
REMKEL1.txt,383063,385351,2288,20,Y,N,-,-1,-1
REMKEL1.txt,383686,385964,2278,20,Y,N,-,-1,-1
REMKEL1.txt,384262,386659,2397,20,N,N,-,-1,-1
REMKEL1.txt,384749,387121,2372,20,N,N,-,-1,-1
REMKEL1.txt,385353,387796,2443,20,N,N,-,-1,-1
REMKEL1.txt,385965,388641,2676,20,N,N,-,-1,-1
REMKEL1.txt,386660,389633,2973,20,N,N,-,-1,-1
REMKEL1.txt,387122,390316,3194,20,N,N,-,-1,-1
REMKEL1.txt,387801,391195,3394,20,N,N,-,-1,-1
REMKEL1.txt,388643,391999,3356,20,N,N,-,-1,-1
REMKEL1.txt,389636,393021,3385,20,N,N,-,-1,-1
REMKEL1.txt,390317,393687,3370,20,N,N,-,-1,-1
REMKEL1.txt,391196,394958,3762,20,N,N,-,-1,-1
REMKEL1.txt,392002,395795,3793,20,N,N,-,-1,-1
REMKEL1.txt,393022,396395,3373,20,N,N,-,-1,-1
REMKEL1.txt,393690,396981,3291,20,N,N,-,-1,-1
REMKEL1.txt,394960,397616,2656,20,Y,N,-,-1,-1
REMKEL1.txt,395796,398360,2564,20,Y,N,-,-1,-1
REMKEL1.txt,396396,399480,3084,20,Y,N,-,-1,-1
REMKEL1.txt,396982,400895,3913,20,Y,Y,1431611462110,399892,400362
REMKEL1.txt,397617,401582,3965,20,Y,Y,1431611462110,399892,400362
REMKEL1.txt,398361,402262,3901,20,Y,Y,1431611462110,399892,400362
REMKEL1.txt,399482,403275,3793,20,Y,Y,1431611462110,399892,400362
REMKEL1.txt,400896,404368,3472,20,Y,N,-,-1,-1
REMKEL1.txt,401583,405350,3767,20,Y,Y,1431613303057,404779,405342
REMKEL1.txt,402265,406751,4486,20,Y,Y,1431613303057,404779,405342
REMKEL1.txt,403276,407526,4250,20,Y,Y,1431613303057,404779,405342
REMKEL1.txt,404369,408911,4542,20,Y,Y,1431613303057,404779,405342
REMKEL1.txt,405351,410606,5255,20,Y,N,-,-1,-1
REMKEL1.txt,406752,411747,4995,20,Y,N,-,-1,-1
REMKEL1.txt,407527,412980,5453,20,Y,Y,1431615187175,412407,415852
REMKEL1.txt,408913,413784,4871,20,Y,Y,1431615187175,412407,415852
REMKEL1.txt,410607,414696,4089,20,Y,Y,1431615187175,412407,415852
REMKEL1.txt,411748,415365,3617,20,Y,Y,1431615187175,412407,415852
REMKEL1.txt,412981,415882,2901,20,Y,Y,1431615187175,412407,415852
REMKEL1.txt,413785,416954,3169,20,Y,Y,1431615187175,412407,415852
REMKEL1.txt,414697,418290,3593,20,Y,Y,1431615187175,412407,415852
REMKEL1.txt,415366,419716,4350,20,Y,Y,1431615187175,412407,415852
REMKEL1.txt,415885,420605,4720,20,N,N,-,-1,-1
REMKEL1.txt,416957,421465,4508,20,Y,N,-,-1,-1
REMKEL1.txt,418293,422149,3856,20,Y,N,-,-1,-1
REMKEL1.txt,419717,422873,3156,20,Y,N,-,-1,-1
REMKEL1.txt,420606,423707,3101,20,Y,Y,1432056176787,423095,424004
REMKEL1.txt,421466,424302,2836,20,Y,Y,1432056176787,423095,424004
REMKEL1.txt,422152,425268,3116,20,Y,Y,1432056176787,423095,424004
REMKEL1.txt,422874,426911,4037,20,Y,Y,1432056176787,423095,424004
REMKEL1.txt,423708,427688,3980,20,Y,Y,1432056176787,423095,424004
REMKEL1.txt,424303,428166,3863,20,N,N,-,-1,-1
REMKEL1.txt,425269,428787,3518,20,N,N,-,-1,-1
REMKEL1.txt,426912,429567,2655,20,N,N,-,-1,-1
REMKEL1.txt,427691,430224,2533,20,Y,Y,1432060885983,429653,430653
REMKEL1.txt,428171,430901,2730,20,Y,Y,1432060885983,429653,430653
REMKEL1.txt,428788,432066,3278,20,Y,Y,1432137873706,431575,434541
REMKEL1.txt,429569,432758,3189,20,Y,Y,1432137873706,431575,434541
REMKEL1.txt,430225,433885,3660,20,Y,Y,1432137873706,431575,434541
REMKEL1.txt,430902,434688,3786,20,Y,Y,1432137873706,431575,434541
REMKEL1.txt,432067,435450,3383,20,Y,Y,1432137873706,431575,434541
REMKEL1.txt,432761,436767,4006,20,Y,Y,1432137873706,431575,434541
REMKEL1.txt,433886,437840,3954,20,Y,Y,1432137873706,431575,434541
REMKEL1.txt,434689,439068,4379,20,Y,Y,1432138360719,435276,437675
REMKEL1.txt,435453,439920,4467,20,Y,Y,1432138360719,435276,437675
REMKEL1.txt,436768,440083,3315,20,N,Y,1432138360719,435276,437675
REMKEL1.txt,437842,440558,2716,20,Y,Y,1432138782679,440486,440948
REMKEL1.txt,439070,441318,2248,20,Y,Y,1432138782679,440486,440948
REMKEL1.txt,439921,442828,2907,20,Y,Y,1432138782679,440486,440948
REMKEL1.txt,440084,443906,3822,20,Y,Y,1432138782679,440486,440948
REMKEL1.txt,440559,445164,4605,20,Y,Y,1432138782679,440486,440948
REMKEL1.txt,441319,445634,4315,20,Y,Y,1432138943360,440957,441390
REMKEL1.txt,442829,446444,3615,20,Y,Y,1432139637153,443461,444025
REMKEL1.txt,443909,447748,3839,20,Y,Y,1432139637153,443461,444025
REMKEL1.txt,445165,448649,3484,20,N,Y,1432140652765,444022,446180
REMKEL1.txt,445635,449582,3947,20,N,Y,1432140652765,444022,446180
REMKEL1.txt,446445,450298,3853,20,N,Y,1434304562715,449617,451671
REMKEL1.txt,447749,451178,3429,20,N,Y,1434304562715,449617,451671
REMKEL1.txt,448650,452092,3442,20,N,Y,1434304562715,449617,451671
REMKEL1.txt,449585,453725,4140,20,Y,Y,1434304562715,449617,451671
REMKEL1.txt,450301,454593,4292,20,Y,Y,1434304562715,449617,451671
REMKEL1.txt,451179,455646,4467,20,Y,Y,1434304562715,449617,451671
REMKEL1.txt,452094,455858,3764,20,Y,N,-,-1,-1
REMKEL1.txt,453726,455935,2209,20,N,N,-,-1,-1
REMKEL1.txt,454595,456535,1940,20,N,N,-,-1,-1
REMKEL1.txt,455647,457054,1407,20,N,Y,1435163669623,456834,458582
REMKEL1.txt,455861,457687,1826,20,N,Y,1435163669623,456834,458582
REMKEL1.txt,455936,458890,2954,20,N,Y,1435164506717,458656,459229
REMKEL1.txt,456536,459528,2992,20,Y,Y,1435164969620,459343,460812
REMKEL1.txt,457054,459636,2582,20,Y,Y,1435164969620,459343,460812
REMKEL1.txt,457688,459690,2002,20,Y,Y,1435164969620,459343,460812
REMKEL1.txt,458891,459740,849,20,Y,Y,1435164969620,459343,460812
REMKEL1.txt,459531,459840,309,20,N,Y,1435164969620,459343,460812
REMKEL1.txt,459637,460242,605,20,Y,Y,1435164969620,459343,460812
REMKEL1.txt,459693,461264,1571,20,Y,Y,1435164969620,459343,460812
REMKEL1.txt,459743,461972,2229,20,Y,Y,1435164969620,459343,460812
REMKEL1.txt,459843,462697,2854,20,Y,Y,1435164969620,459343,460812
REMKEL1.txt,460243,463658,3415,20,Y,Y,1435164969620,459343,460812
REMKEL1.txt,461265,464118,2853,20,Y,Y,1435165913179,460834,463218
REMKEL1.txt,461974,464829,2855,20,Y,Y,1435165913179,460834,463218
REMKEL1.txt,462699,465224,2525,20,Y,Y,1435165913179,460834,463218
REMKEL1.txt,463659,466281,2622,20,Y,Y,1435246956861,465116,468674
REMKEL1.txt,464120,467640,3520,20,Y,Y,1435246956861,465116,468674
REMKEL1.txt,464830,468613,3783,20,Y,Y,1435246956861,465116,468674
REMKEL1.txt,465225,469401,4176,20,Y,Y,1435246956861,465116,468674
REMKEL1.txt,466282,470232,3950,20,N,Y,1435246956861,465116,468674
REMKEL1.txt,467643,471190,3547,20,N,Y,1435246956861,465116,468674
REMKEL1.txt,468614,471832,3218,20,N,Y,1435246956861,465116,468674
REMKEL1.txt,469404,472337,2933,20,Y,N,-,-1,-1
REMKEL1.txt,470233,472688,2455,20,Y,N,-,-1,-1
REMKEL1.txt,471191,473054,1863,20,Y,N,-,-1,-1
REMKEL1.txt,471833,473793,1960,20,Y,N,-,-1,-1
REMKEL1.txt,472338,474638,2300,20,Y,Y,1435248772832,474122,475026
REMKEL1.txt,472689,475338,2649,20,Y,Y,1435248772832,474122,475026
REMKEL1.txt,473055,476339,3284,20,Y,Y,1435248772832,474122,475026
REMKEL1.txt,473794,477116,3322,20,Y,Y,1435248772832,474122,475026
REMKEL1.txt,474641,477551,2910,20,Y,Y,1435248772832,474122,475026
REMKEL1.txt,475341,478316,2975,20,Y,Y,1435249587702,477567,478661
REMKEL1.txt,476340,479358,3018,20,Y,Y,1435249587702,477567,478661
REMKEL1.txt,477117,481102,3985,20,Y,Y,1435249587702,477567,478661
REMKEL1.txt,477554,481877,4323,20,Y,Y,1435249587702,477567,478661
REMKEL1.txt,478317,482719,4402,20,N,Y,1435249587702,477567,478661
REMKEL1.txt,479359,483644,4285,20,N,Y,1435250182755,479084,480863
REMKEL1.txt,481103,484370,3267,20,N,N,-,-1,-1
REMKEL1.txt,481879,485154,3275,20,N,N,-,-1,-1
REMKEL1.txt,482720,485889,3169,20,N,N,-,-1,-1
REMKEL1.txt,483645,486503,2858,20,N,N,-,-1,-1
REMKEL1.txt,484371,487036,2665,20,N,N,-,-1,-1
REMKEL1.txt,485155,488035,2880,20,Y,N,-,-1,-1
REMKEL1.txt,485890,488639,2749,20,Y,N,-,-1,-1
REMKEL1.txt,486506,489503,2997,20,Y,N,-,-1,-1
REMKEL1.txt,487037,490643,3606,20,Y,Y,1435312884754,489937,490626
REMKEL1.txt,488038,491546,3508,20,N,Y,1435312884754,489937,490626
REMKEL1.txt,488642,492346,3704,20,N,Y,1435312884754,489937,490626
REMKEL1.txt,489504,493107,3603,20,N,Y,1435312884754,489937,490626
REMKEL1.txt,490646,494324,3678,20,N,N,-,-1,-1
REMKEL1.txt,491549,495038,3489,20,N,N,-,-1,-1
REMKEL1.txt,492347,495639,3292,20,N,N,-,-1,-1
REMKEL1.txt,493108,496430,3322,20,Y,N,-,-1,-1
REMKEL1.txt,494325,497281,2956,20,Y,N,-,-1,-1
REMKEL1.txt,495039,498084,3045,20,N,N,-,-1,-1
REMKEL1.txt,495641,498802,3161,20,Y,N,-,-1,-1
REMKEL1.txt,496431,499660,3229,20,Y,Y,1435314166443,498844,500332
REMKEL1.txt,497282,500813,3531,20,Y,Y,1435314166443,498844,500332
REMKEL1.txt,498086,501308,3222,20,Y,Y,1435314166443,498844,500332
REMKEL1.txt,498805,501417,2612,20,Y,Y,1435314166443,498844,500332
REMKEL2.txt,0,923,923,20,Y,N,-,-1,-1
REMKEL2.txt,63,1110,1047,20,Y,N,-,-1,-1
REMKEL2.txt,530,1412,882,20,Y,N,-,-1,-1
REMKEL2.txt,666,1626,960,20,Y,N,-,-1,-1
REMKEL2.txt,925,1833,908,20,Y,N,-,-1,-1
REMKEL2.txt,1111,2094,983,20,Y,N,-,-1,-1
REMKEL2.txt,1413,2390,977,20,Y,N,-,-1,-1
REMKEL2.txt,1627,2566,939,20,Y,N,-,-1,-1
REMKEL2.txt,1834,2929,1095,20,Y,N,-,-1,-1
REMKEL2.txt,2095,3215,1120,20,Y,N,-,-1,-1
REMKEL2.txt,2391,3414,1023,20,N,N,-,-1,-1
REMKEL2.txt,2568,3640,1072,20,N,N,-,-1,-1
REMKEL2.txt,2930,3860,930,20,Y,N,-,-1,-1
REMKEL2.txt,3216,4055,839,20,Y,N,-,-1,-1
REMKEL2.txt,3415,4217,802,20,Y,N,-,-1,-1
REMKEL2.txt,3642,4391,749,20,Y,N,-,-1,-1
REMKEL2.txt,3861,4542,681,20,Y,N,-,-1,-1
REMKEL2.txt,4056,4723,667,20,Y,N,-,-1,-1
REMKEL2.txt,4218,4982,764,20,Y,N,-,-1,-1
REMKEL2.txt,4394,5216,822,20,Y,N,-,-1,-1
REMKEL2.txt,4544,5423,879,20,Y,N,-,-1,-1
REMKEL2.txt,4724,5644,920,20,Y,N,-,-1,-1
REMKEL2.txt,4983,5807,824,20,Y,N,-,-1,-1
REMKEL2.txt,5217,6016,799,20,Y,N,-,-1,-1
REMKEL2.txt,5424,6199,775,20,Y,N,-,-1,-1
REMKEL2.txt,5645,6448,803,20,Y,N,-,-1,-1
REMKEL2.txt,5808,6669,861,20,Y,N,-,-1,-1
REMKEL2.txt,6017,6815,798,20,Y,N,-,-1,-1
REMKEL2.txt,6200,7063,863,20,Y,N,-,-1,-1
REMKEL2.txt,6450,7193,743,20,N,N,-,-1,-1
REMKEL2.txt,6669,7449,780,20,N,N,-,-1,-1
REMKEL2.txt,6816,7652,836,20,Y,N,-,-1,-1
REMKEL2.txt,7064,7856,792,20,Y,N,-,-1,-1
REMKEL2.txt,7194,8007,813,20,Y,N,-,-1,-1
REMKEL2.txt,7450,8160,710,20,Y,N,-,-1,-1
REMKEL2.txt,7653,8377,724,20,Y,N,-,-1,-1
REMKEL2.txt,7857,8596,739,20,Y,N,-,-1,-1
REMKEL2.txt,8008,8827,819,20,Y,N,-,-1,-1
REMKEL2.txt,8163,9094,931,20,Y,N,-,-1,-1
REMKEL2.txt,8378,9232,854,20,N,N,-,-1,-1
REMKEL2.txt,8599,9427,828,20,N,N,-,-1,-1
REMKEL2.txt,8828,9614,786,20,N,N,-,-1,-1
REMKEL2.txt,9095,9845,750,20,Y,N,-,-1,-1
REMKEL2.txt,9233,9983,750,20,Y,N,-,-1,-1
REMKEL2.txt,9428,10168,740,20,Y,N,-,-1,-1
REMKEL2.txt,9615,10366,751,20,Y,N,-,-1,-1
REMKEL2.txt,9846,10513,667,20,Y,N,-,-1,-1
REMKEL2.txt,9984,10682,698,20,Y,N,-,-1,-1
REMKEL2.txt,10169,10817,648,20,Y,N,-,-1,-1
REMKEL2.txt,10368,11065,697,20,Y,N,-,-1,-1
REMKEL2.txt,10516,11295,779,20,Y,N,-,-1,-1
REMKEL2.txt,10684,11498,814,20,Y,N,-,-1,-1
REMKEL2.txt,10818,11636,818,20,Y,N,-,-1,-1
REMKEL2.txt,11067,11799,732,20,Y,N,-,-1,-1
REMKEL2.txt,11296,11989,693,20,Y,N,-,-1,-1
REMKEL2.txt,11499,12219,720,20,Y,N,-,-1,-1
REMKEL2.txt,11637,12754,1117,20,Y,N,-,-1,-1
REMKEL2.txt,11800,13223,1423,20,Y,Y,1435351885643,13188,14403
REMKEL2.txt,11990,13775,1785,20,Y,Y,1435351885643,13188,14403
REMKEL2.txt,12220,14542,2322,20,Y,Y,1435355555620,14479,15098
REMKEL2.txt,12755,15129,2374,20,Y,Y,1435355555620,14479,15098
REMKEL2.txt,13224,17445,4221,20,Y,Y,1435355555620,14479,15098
REMKEL2.txt,13776,18420,4644,20,Y,Y,1435355555620,14479,15098
REMKEL2.txt,14543,19026,4483,20,Y,Y,1435355555620,14479,15098
REMKEL2.txt,15130,19364,4234,20,Y,Y,1435357682797,15132,15608
REMKEL2.txt,17446,20329,2883,20,Y,Y,1435766521901,15849,17824
REMKEL2.txt,18421,21074,2653,20,Y,Y,1435769270470,19677,20071
REMKEL2.txt,19031,22438,3407,20,Y,Y,1435769270470,19677,20071
REMKEL2.txt,19367,23083,3716,20,Y,Y,1435769270470,19677,20071
REMKEL2.txt,20330,24259,3929,20,Y,Y,1435771053245,23433,25540
REMKEL2.txt,21076,24811,3735,20,Y,Y,1435771053245,23433,25540
REMKEL2.txt,22439,25962,3523,20,N,Y,1435771053245,23433,25540
REMKEL2.txt,23084,26727,3643,20,N,Y,1435771053245,23433,25540
REMKEL2.txt,24260,27908,3648,20,N,Y,1435771053245,23433,25540
REMKEL2.txt,24812,28585,3773,20,Y,Y,1435771053245,23433,25540
REMKEL2.txt,25963,29124,3161,20,Y,Y,1435782599159,27378,29050
REMKEL2.txt,26728,29545,2817,20,Y,Y,1435782599159,27378,29050
REMKEL2.txt,27909,30252,2343,20,Y,Y,1435782599159,27378,29050
REMKEL2.txt,28586,30660,2074,20,Y,Y,1435782599159,27378,29050
REMKEL2.txt,29127,31270,2143,20,Y,N,-,-1,-1
REMKEL2.txt,29548,31872,2324,20,Y,Y,1435783099009,31525,31867
REMKEL2.txt,30253,33041,2788,20,N,Y,1435783099009,31525,31867
REMKEL2.txt,30663,33649,2986,20,Y,Y,1435783099009,31525,31867
REMKEL2.txt,31273,34360,3087,20,Y,Y,1435783099009,31525,31867
REMKEL2.txt,31875,35592,3717,20,Y,Y,1435784346015,31918,33454
REMKEL2.txt,33044,36626,3582,20,Y,Y,1435784346015,31918,33454
REMKEL2.txt,33650,37337,3687,20,Y,N,-,-1,-1
REMKEL2.txt,34362,38179,3817,20,Y,N,-,-1,-1
REMKEL2.txt,35595,38979,3384,20,Y,N,-,-1,-1
REMKEL2.txt,36627,40007,3380,20,Y,N,-,-1,-1
REMKEL2.txt,37338,41317,3979,20,Y,N,-,-1,-1
REMKEL2.txt,38180,42532,4352,20,Y,Y,1435857399186,41984,42949
REMKEL2.txt,38980,43957,4977,20,Y,Y,1435857399186,41984,42949
REMKEL2.txt,40008,44591,4583,20,N,Y,1435857399186,41984,42949
REMKEL2.txt,41318,45384,4066,20,N,Y,1435857399186,41984,42949
REMKEL2.txt,42535,46572,4037,20,N,Y,1435857399186,41984,42949
REMKEL2.txt,43958,47673,3715,20,N,N,-,-1,-1
REMKEL2.txt,44592,48799,4207,20,N,N,-,-1,-1
REMKEL2.txt,45387,49789,4402,20,N,N,-,-1,-1
REMKEL2.txt,46573,50609,4036,20,N,N,-,-1,-1
REMKEL2.txt,47675,51556,3881,20,N,N,-,-1,-1
REMKEL2.txt,48802,52694,3892,20,N,N,-,-1,-1
REMKEL2.txt,49792,53408,3616,20,N,N,-,-1,-1
REMKEL2.txt,50612,54036,3424,20,Y,Y,1435858450692,53412,54290
REMKEL2.txt,51557,54715,3158,20,Y,Y,1435858450692,53412,54290
REMKEL2.txt,52695,55502,2807,20,Y,Y,1435858450692,53412,54290
REMKEL2.txt,53409,55872,2463,20,Y,Y,1435858450692,53412,54290
REMKEL2.txt,54037,57100,3063,20,Y,Y,1435858450692,53412,54290
REMKEL2.txt,54717,57938,3221,20,Y,Y,1435862440580,57258,58200
REMKEL2.txt,55503,58519,3016,20,Y,Y,1435862440580,57258,58200
REMKEL2.txt,55873,59729,3856,20,Y,Y,1435862440580,57258,58200
REMKEL2.txt,57101,60594,3493,20,Y,Y,1435862440580,57258,58200
REMKEL2.txt,57939,60815,2876,20,Y,Y,1435862440580,57258,58200
REMKEL2.txt,58520,61516,2996,20,Y,Y,1435863052573,60462,60688
REMKEL2.txt,59730,62192,2462,20,Y,Y,1435863052573,60462,60688
REMKEL2.txt,60595,62818,2223,20,N,Y,1435863052573,60462,60688
REMKEL2.txt,60816,63568,2752,20,N,Y,1435863114996,60692,60989
REMKEL2.txt,61517,64416,2899,20,N,N,-,-1,-1
REMKEL2.txt,62194,65294,3100,20,N,N,-,-1,-1
REMKEL2.txt,62819,66504,3685,20,N,N,-,-1,-1
REMKEL2.txt,63569,67447,3878,20,N,N,-,-1,-1
REMKEL2.txt,64418,68332,3914,20,N,N,-,-1,-1
REMKEL2.txt,65295,68945,3650,20,N,N,-,-1,-1
REMKEL2.txt,66507,69950,3443,20,N,N,-,-1,-1
REMKEL2.txt,67450,70293,2843,20,N,N,-,-1,-1
REMKEL2.txt,68333,70986,2653,20,N,N,-,-1,-1
REMKEL2.txt,68946,72374,3428,20,N,N,-,-1,-1
REMKEL2.txt,69953,73178,3225,20,N,N,-,-1,-1
REMKEL2.txt,70298,74056,3758,20,N,N,-,-1,-1
REMKEL2.txt,70989,74433,3444,20,N,N,-,-1,-1
REMKEL2.txt,72375,74835,2460,20,Y,N,-,-1,-1
REMKEL2.txt,73179,75680,2501,20,Y,N,-,-1,-1
REMKEL2.txt,74057,76585,2528,20,Y,N,-,-1,-1
REMKEL2.txt,74434,77397,2963,20,Y,N,-,-1,-1
REMKEL2.txt,74836,78116,3280,20,N,N,-,-1,-1
REMKEL2.txt,75681,78557,2876,20,N,N,-,-1,-1
REMKEL2.txt,76586,78903,2317,20,N,N,-,-1,-1
REMKEL2.txt,77398,79838,2440,20,N,N,-,-1,-1
REMKEL2.txt,78117,80700,2583,20,N,N,-,-1,-1
REMKEL2.txt,78559,81088,2529,20,N,N,-,-1,-1
REMKEL2.txt,78905,81552,2647,20,N,Y,1435865160115,81233,81988
REMKEL2.txt,79839,82316,2477,20,N,Y,1435865160115,81233,81988
REMKEL2.txt,80703,83241,2538,20,Y,Y,1435865160115,81233,81988
REMKEL2.txt,81090,84320,3230,20,N,Y,1435865160115,81233,81988
REMKEL2.txt,81554,85287,3733,20,N,Y,1435865160115,81233,81988
REMKEL2.txt,82317,86286,3969,20,N,N,-,-1,-1
REMKEL2.txt,83243,87926,4683,20,N,Y,1435865766643,87290,87654
REMKEL2.txt,84322,88524,4202,20,N,Y,1435865766643,87290,87654
REMKEL2.txt,85289,89804,4515,20,N,Y,1435865766643,87290,87654
REMKEL2.txt,86289,90147,3858,20,Y,Y,1435865766643,87290,87654
REMKEL2.txt,87927,90883,2956,20,Y,N,-,-1,-1
REMKEL2.txt,88525,91874,3349,20,Y,N,-,-1,-1
REMKEL2.txt,89806,93089,3283,20,Y,N,-,-1,-1
REMKEL2.txt,90148,93581,3433,20,Y,N,-,-1,-1
REMKEL2.txt,90886,94597,3711,20,Y,N,-,-1,-1
REMKEL2.txt,91875,95652,3777,20,Y,N,-,-1,-1
REMKEL2.txt,93090,96174,3084,20,Y,N,-,-1,-1
REMKEL2.txt,93582,96732,3150,20,Y,N,-,-1,-1
REMKEL2.txt,94598,97456,2858,20,Y,N,-,-1,-1
REMKEL2.txt,95653,98201,2548,20,Y,Y,1436126047679,97988,98333
REMKEL2.txt,96177,98935,2758,20,Y,Y,1436126047679,97988,98333
REMKEL2.txt,96733,99894,3161,20,Y,Y,1436126047679,97988,98333
REMKEL2.txt,97459,101052,3593,20,Y,Y,1436126047679,97988,98333
REMKEL2.txt,98202,101718,3516,20,N,Y,1436126047679,97988,98333
REMKEL2.txt,98937,102387,3450,20,Y,Y,1436126680550,100972,101605
REMKEL2.txt,99897,103107,3210,20,Y,Y,1436126680550,100972,101605
REMKEL2.txt,101053,103702,2649,20,Y,Y,1436126680550,100972,101605
REMKEL2.txt,101719,103828,2109,20,Y,Y,1436126929844,101615,102764
REMKEL2.txt,102388,104680,2292,20,N,Y,1436293470468,103834,104024
REMKEL2.txt,103108,105383,2275,20,N,Y,1436293974870,105377,105629
REMKEL2.txt,103703,106291,2588,20,N,Y,1436293974870,105377,105629
REMKEL2.txt,103831,106789,2958,20,N,Y,1436293974870,105377,105629
REMKEL2.txt,104681,106943,2262,20,N,Y,1436293974870,105377,105629
REMKEL2.txt,105386,107668,2282,20,N,Y,1436293974870,105377,105629
REMKEL2.txt,106292,108471,2179,20,N,N,-,-1,-1
REMKEL2.txt,106790,108920,2130,20,Y,N,-,-1,-1
REMKEL2.txt,106946,109779,2833,20,Y,N,-,-1,-1
REMKEL2.txt,107670,110652,2982,20,Y,Y,1436297889987,109780,110435
REMKEL2.txt,108474,111584,3110,20,Y,Y,1436298400992,111204,111685
REMKEL2.txt,108921,112010,3089,20,Y,Y,1436298400992,111204,111685
REMKEL2.txt,109782,112790,3008,20,Y,Y,1436298400992,111204,111685
REMKEL2.txt,110653,113302,2649,20,Y,Y,1436298400992,111204,111685
REMKEL2.txt,111585,114513,2928,20,Y,Y,1436298400992,111204,111685
REMKEL2.txt,112011,115153,3142,20,Y,Y,1436298772179,111746,112985
REMKEL2.txt,112795,115913,3118,20,Y,Y,1436298772179,111746,112985
REMKEL2.txt,113303,116760,3457,20,Y,Y,1436352571813,115777,116442
REMKEL2.txt,114516,117527,3011,20,Y,Y,1436352919472,117021,119063
REMKEL2.txt,115154,118333,3179,20,Y,Y,1436352919472,117021,119063
REMKEL2.txt,115914,118984,3070,20,Y,Y,1436352919472,117021,119063
REMKEL2.txt,116762,119707,2945,20,Y,Y,1436352919472,117021,119063
REMKEL2.txt,117528,120052,2524,20,Y,Y,1436352919472,117021,119063
REMKEL2.txt,118334,120364,2030,20,Y,Y,1436352919472,117021,119063
REMKEL2.txt,118985,120873,1888,20,Y,Y,1436352919472,117021,119063
REMKEL2.txt,119709,121373,1664,20,Y,N,-,-1,-1
REMKEL2.txt,120057,121598,1541,20,N,N,-,-1,-1
REMKEL2.txt,120365,122359,1994,20,Y,Y,1436472126635,121874,122900
REMKEL2.txt,120876,123184,2308,20,Y,Y,1436472126635,121874,122900
REMKEL2.txt,121374,124208,2834,20,Y,Y,1436472126635,121874,122900
REMKEL2.txt,121598,124927,3329,20,Y,Y,1436472126635,121874,122900
REMKEL2.txt,122360,125752,3392,20,Y,Y,1436472126635,121874,122900
REMKEL2.txt,123185,126782,3597,20,Y,N,-,-1,-1
REMKEL2.txt,124209,127779,3570,20,Y,N,-,-1,-1
REMKEL2.txt,124928,128831,3903,20,Y,N,-,-1,-1
REMKEL2.txt,125754,129756,4002,20,Y,N,-,-1,-1
REMKEL2.txt,126785,130988,4203,20,Y,N,-,-1,-1
REMKEL2.txt,127780,131938,4158,20,Y,N,-,-1,-1
REMKEL2.txt,128832,132923,4091,20,Y,N,-,-1,-1
REMKEL2.txt,129757,133844,4087,20,Y,N,-,-1,-1
REMKEL2.txt,130991,134956,3965,20,N,Y,1436813469893,134408,134846
REMKEL2.txt,131941,135739,3798,20,N,Y,1436813469893,134408,134846
REMKEL2.txt,132924,136482,3558,20,Y,Y,1436813469893,134408,134846
REMKEL2.txt,133845,137046,3201,20,Y,Y,1436813469893,134408,134846
REMKEL2.txt,134958,137843,2885,20,Y,N,-,-1,-1
REMKEL2.txt,135740,138494,2754,20,Y,N,-,-1,-1
REMKEL2.txt,136484,138970,2486,20,N,N,-,-1,-1
REMKEL2.txt,137049,140346,3297,20,N,N,-,-1,-1
REMKEL2.txt,137846,141177,3331,20,N,N,-,-1,-1
REMKEL2.txt,138495,141893,3398,20,N,N,-,-1,-1
REMKEL2.txt,138971,142938,3967,20,N,N,-,-1,-1
REMKEL2.txt,140347,144020,3673,20,N,N,-,-1,-1
REMKEL2.txt,141178,144143,2965,20,N,N,-,-1,-1
REMKEL2.txt,141896,144751,2855,20,N,N,-,-1,-1
REMKEL2.txt,142941,145340,2399,20,N,N,-,-1,-1
REMKEL2.txt,144021,146456,2435,20,N,N,-,-1,-1
REMKEL2.txt,144144,147210,3066,20,N,N,-,-1,-1
REMKEL2.txt,144752,148480,3728,20,N,N,-,-1,-1
REMKEL2.txt,145341,149284,3943,20,N,N,-,-1,-1
REMKEL2.txt,146459,149917,3458,20,N,N,-,-1,-1
REMKEL2.txt,147211,150938,3727,20,N,N,-,-1,-1
REMKEL2.txt,148483,151851,3368,20,N,N,-,-1,-1
REMKEL2.txt,149285,152236,2951,20,N,N,-,-1,-1
REMKEL2.txt,149918,153012,3094,20,N,N,-,-1,-1
REMKEL2.txt,150939,153857,2918,20,N,N,-,-1,-1
REMKEL2.txt,151854,154863,3009,20,N,N,-,-1,-1
REMKEL2.txt,152238,155481,3243,20,N,N,-,-1,-1
REMKEL2.txt,153014,156088,3074,20,N,N,-,-1,-1
REMKEL2.txt,153858,156865,3007,20,Y,N,-,-1,-1
REMKEL2.txt,154863,157991,3128,20,Y,N,-,-1,-1
REMKEL2.txt,155482,159219,3737,20,Y,N,-,-1,-1
REMKEL2.txt,156089,159769,3680,20,Y,N,-,-1,-1
REMKEL2.txt,156866,160305,3439,20,Y,N,-,-1,-1
REMKEL2.txt,157992,161048,3056,20,Y,N,-,-1,-1
REMKEL2.txt,159222,161939,2717,20,Y,N,-,-1,-1
REMKEL2.txt,159770,163041,3271,20,N,N,-,-1,-1
REMKEL2.txt,160310,163674,3364,20,Y,N,-,-1,-1
REMKEL2.txt,161051,164571,3520,20,Y,N,-,-1,-1
REMKEL2.txt,161939,165789,3850,20,Y,N,-,-1,-1
REMKEL2.txt,163042,166717,3675,20,Y,N,-,-1,-1
REMKEL2.txt,163677,168230,4553,20,Y,N,-,-1,-1
REMKEL2.txt,164572,168990,4418,20,Y,N,-,-1,-1
REMKEL2.txt,165791,169945,4154,20,Y,N,-,-1,-1
REMKEL2.txt,166718,170914,4196,20,Y,Y,1436888170573,169972,170218
REMKEL2.txt,168231,172005,3774,20,Y,Y,1436888170573,169972,170218
REMKEL2.txt,168993,172671,3678,20,Y,Y,1436888170573,169972,170218
REMKEL2.txt,169948,173510,3562,20,Y,Y,1436888170573,169972,170218
REMKEL2.txt,170915,174400,3485,20,N,N,-,-1,-1
REMKEL2.txt,172006,175856,3850,20,N,N,-,-1,-1
REMKEL2.txt,172672,176277,3605,20,N,N,-,-1,-1
REMKEL2.txt,173513,177022,3509,20,N,N,-,-1,-1
REMKEL2.txt,174403,177741,3338,20,N,N,-,-1,-1
REMKEL2.txt,175857,178813,2956,20,N,N,-,-1,-1
REMKEL2.txt,176279,179322,3043,20,N,N,-,-1,-1
REMKEL2.txt,177023,179996,2973,20,N,N,-,-1,-1
REMKEL2.txt,177744,180793,3049,20,N,N,-,-1,-1
REMKEL2.txt,178814,181088,2274,20,N,N,-,-1,-1
REMKEL2.txt,179323,182282,2959,20,N,N,-,-1,-1
REMKEL2.txt,179999,182933,2934,20,N,N,-,-1,-1
REMKEL2.txt,180794,183765,2971,20,N,N,-,-1,-1
REMKEL2.txt,181089,184574,3485,20,Y,Y,1436889057877,184044,184421
REMKEL2.txt,182283,185354,3071,20,Y,Y,1436889057877,184044,184421
REMKEL2.txt,182936,186050,3114,20,Y,Y,1436889057877,184044,184421
REMKEL2.txt,183766,186772,3006,20,N,Y,1436889057877,184044,184421
REMKEL2.txt,184576,188032,3456,20,N,N,-,-1,-1
REMKEL2.txt,185357,188507,3150,20,Y,N,-,-1,-1
REMKEL2.txt,186051,189055,3004,20,N,N,-,-1,-1
REMKEL2.txt,186773,189452,2679,20,N,N,-,-1,-1
REMKEL2.txt,188033,190422,2389,20,Y,N,-,-1,-1
REMKEL2.txt,188510,191498,2988,20,Y,N,-,-1,-1
REMKEL2.txt,189057,192086,3029,20,Y,N,-,-1,-1
REMKEL2.txt,189454,192700,3246,20,Y,N,-,-1,-1
REMKEL2.txt,190425,193753,3328,20,Y,N,-,-1,-1
REMKEL2.txt,191501,194492,2991,20,Y,N,-,-1,-1
REMKEL2.txt,192087,195042,2955,20,Y,N,-,-1,-1
REMKEL2.txt,192703,195817,3114,20,Y,N,-,-1,-1
REMKEL2.txt,193754,196743,2989,20,Y,N,-,-1,-1
REMKEL2.txt,194493,197606,3113,20,Y,N,-,-1,-1
REMKEL2.txt,195043,198703,3660,20,Y,N,-,-1,-1
REMKEL2.txt,195820,199165,3345,20,N,N,-,-1,-1
REMKEL2.txt,196744,200519,3775,20,N,N,-,-1,-1
REMKEL2.txt,197607,201583,3976,20,N,N,-,-1,-1
REMKEL2.txt,198704,202489,3785,20,N,N,-,-1,-1
REMKEL2.txt,199168,203861,4693,20,N,N,-,-1,-1
REMKEL2.txt,200520,204244,3724,20,Y,N,-,-1,-1
REMKEL2.txt,201584,205090,3506,20,Y,N,-,-1,-1
REMKEL2.txt,202492,205803,3311,20,Y,Y,1436891628994,205586,205983
REMKEL2.txt,203864,206571,2707,20,Y,Y,1436891908281,205997,206745
REMKEL2.txt,204247,207053,2806,20,Y,Y,1436892204871,206775,207267
REMKEL2.txt,205091,207815,2724,20,Y,Y,1436892204871,206775,207267
REMKEL2.txt,205804,209338,3534,20,Y,Y,1436892204871,206775,207267
REMKEL2.txt,206573,210334,3761,20,Y,Y,1436892204871,206775,207267
REMKEL2.txt,207053,211310,4257,20,Y,Y,1436892204871,206775,207267
REMKEL2.txt,207818,212453,4635,20,Y,N,-,-1,-1
REMKEL2.txt,209341,214093,4752,20,Y,N,-,-1,-1
REMKEL2.txt,210337,215362,5025,20,Y,N,-,-1,-1
REMKEL2.txt,211311,216329,5018,20,Y,N,-,-1,-1
REMKEL2.txt,212456,217284,4828,20,N,N,-,-1,-1
REMKEL2.txt,214094,218344,4250,20,N,N,-,-1,-1
REMKEL2.txt,215364,218926,3562,20,Y,N,-,-1,-1
REMKEL2.txt,216330,219745,3415,20,Y,N,-,-1,-1
REMKEL2.txt,217287,220760,3473,20,Y,N,-,-1,-1
REMKEL2.txt,218347,221457,3110,20,Y,N,-,-1,-1
REMKEL2.txt,218927,222828,3901,20,Y,N,-,-1,-1
REMKEL2.txt,219746,223559,3813,20,Y,N,-,-1,-1
REMKEL2.txt,220761,224066,3305,20,Y,N,-,-1,-1
REMKEL2.txt,221458,224480,3022,20,Y,N,-,-1,-1
REMKEL2.txt,222831,225316,2485,20,Y,N,-,-1,-1
REMKEL2.txt,223562,225954,2392,20,Y,N,-,-1,-1
REMKEL2.txt,224069,226760,2691,20,N,N,-,-1,-1
REMKEL2.txt,224481,227321,2840,20,N,N,-,-1,-1
REMKEL2.txt,225317,228221,2904,20,N,N,-,-1,-1
REMKEL2.txt,225955,228777,2822,20,N,N,-,-1,-1
REMKEL2.txt,226761,229443,2682,20,Y,N,-,-1,-1
REMKEL2.txt,227323,230128,2805,20,Y,N,-,-1,-1
REMKEL2.txt,228222,231054,2832,20,Y,Y,1436953347952,230164,230508
REMKEL2.txt,228778,231661,2883,20,Y,Y,1436953347952,230164,230508
REMKEL2.txt,229444,232227,2783,20,Y,Y,1436953347952,230164,230508
REMKEL2.txt,230131,233258,3127,20,Y,Y,1436953347952,230164,230508
REMKEL2.txt,231055,233892,2837,20,Y,Y,1436954082750,233291,233734
REMKEL2.txt,231664,234546,2882,20,Y,Y,1436954082750,233291,233734
REMKEL2.txt,232228,235377,3149,20,Y,Y,1436954082750,233291,233734
REMKEL2.txt,233261,236313,3052,20,Y,Y,1436954082750,233291,233734
REMKEL2.txt,233893,237223,3330,20,Y,Y,1436954332871,233749,233924
REMKEL2.txt,234549,237963,3414,20,Y,N,-,-1,-1
REMKEL2.txt,235378,238600,3222,20,Y,N,-,-1,-1
REMKEL2.txt,236314,239337,3023,20,Y,N,-,-1,-1
REMKEL2.txt,237224,239926,2702,20,Y,N,-,-1,-1
REMKEL2.txt,237964,240674,2710,20,Y,N,-,-1,-1
REMKEL2.txt,238601,241331,2730,20,Y,Y,1436990194671,241135,241539
REMKEL2.txt,239338,241664,2326,20,Y,Y,1436990194671,241135,241539
REMKEL2.txt,239927,242571,2644,20,Y,Y,1436990194671,241135,241539
REMKEL2.txt,240675,242783,2108,20,Y,Y,1436990194671,241135,241539
REMKEL2.txt,241333,243640,2307,20,Y,Y,1437162662523,242944,243494
REMKEL2.txt,241665,244374,2709,20,Y,Y,1437162662523,242944,243494
REMKEL2.txt,242571,244972,2401,20,Y,Y,1437162662523,242944,243494
REMKEL2.txt,242784,245743,2959,20,Y,Y,1437162662523,242944,243494
REMKEL2.txt,243643,246377,2734,20,Y,Y,1437164000244,243648,244317
REMKEL2.txt,244377,247157,2780,20,N,N,-,-1,-1
REMKEL2.txt,244973,248227,3254,20,N,N,-,-1,-1
REMKEL2.txt,245745,249030,3285,20,N,N,-,-1,-1
REMKEL2.txt,246380,249652,3272,20,N,N,-,-1,-1
REMKEL2.txt,247158,250355,3197,20,N,N,-,-1,-1
REMKEL2.txt,248228,250923,2695,20,N,N,-,-1,-1
REMKEL2.txt,249031,251339,2308,20,N,N,-,-1,-1
REMKEL2.txt,249653,252326,2673,20,N,N,-,-1,-1
REMKEL2.txt,250357,253208,2851,20,Y,N,-,-1,-1
REMKEL2.txt,250925,254042,3117,20,Y,Y,1437230370982,253380,254066
REMKEL2.txt,251340,254532,3192,20,Y,Y,1437230370982,253380,254066
REMKEL2.txt,252327,255320,2993,20,Y,Y,1437230370982,253380,254066
REMKEL2.txt,253210,256246,3036,20,Y,Y,1437230370982,253380,254066
REMKEL2.txt,254043,256963,2920,20,Y,Y,1437230370982,253380,254066
REMKEL2.txt,254533,257956,3423,20,Y,N,-,-1,-1
REMKEL2.txt,255321,258912,3591,20,Y,N,-,-1,-1
REMKEL2.txt,256247,259697,3450,20,Y,N,-,-1,-1
REMKEL2.txt,256964,260417,3453,20,Y,N,-,-1,-1
REMKEL2.txt,257957,261753,3796,20,Y,N,-,-1,-1
REMKEL2.txt,258913,262396,3483,20,Y,N,-,-1,-1
REMKEL2.txt,259698,263219,3521,20,Y,Y,1437239674324,263038,263264
REMKEL2.txt,260420,264144,3724,20,Y,Y,1437239750517,263268,263763
REMKEL2.txt,261754,264945,3191,20,Y,Y,1437239750517,263268,263763
REMKEL2.txt,262397,265505,3108,20,Y,Y,1437239750517,263268,263763
REMKEL2.txt,263220,266081,2861,20,Y,Y,1437239750517,263268,263763
REMKEL2.txt,264145,266984,2839,20,Y,Y,1437246845677,264808,265284
REMKEL2.txt,264946,267514,2568,20,Y,Y,1437246845677,264808,265284
REMKEL2.txt,265507,268273,2766,20,N,Y,1437246918352,265302,265939
REMKEL2.txt,266082,269431,3349,20,N,Y,1437247700707,268409,269169
REMKEL2.txt,266985,270076,3091,20,Y,Y,1437248020573,269635,269983
REMKEL2.txt,267515,270503,2988,20,Y,Y,1437248020573,269635,269983
REMKEL2.txt,268275,271653,3378,20,Y,Y,1437248020573,269635,269983
REMKEL2.txt,269432,272099,2667,20,Y,Y,1437248020573,269635,269983
REMKEL2.txt,270077,272469,2392,20,Y,Y,1437248366748,269999,270475
REMKEL2.txt,270506,273069,2563,20,Y,N,-,-1,-1
REMKEL2.txt,271654,273991,2337,20,Y,N,-,-1,-1
REMKEL2.txt,272100,274968,2868,20,Y,N,-,-1,-1
REMKEL2.txt,272470,275625,3155,20,Y,N,-,-1,-1
REMKEL2.txt,273072,276249,3177,20,Y,N,-,-1,-1
REMKEL2.txt,273994,277119,3125,20,Y,N,-,-1,-1
REMKEL2.txt,274969,277881,2912,20,Y,N,-,-1,-1
REMKEL2.txt,275626,278542,2916,20,Y,N,-,-1,-1
REMKEL2.txt,276251,279864,3613,20,Y,N,-,-1,-1
REMKEL2.txt,277122,280592,3470,20,Y,N,-,-1,-1
REMKEL2.txt,277881,281378,3497,20,Y,N,-,-1,-1
REMKEL2.txt,278543,282524,3981,20,Y,N,-,-1,-1
REMKEL2.txt,279865,283315,3450,20,Y,N,-,-1,-1
REMKEL2.txt,280593,283988,3395,20,Y,N,-,-1,-1
REMKEL2.txt,281379,284377,2998,20,Y,N,-,-1,-1
REMKEL2.txt,282526,285289,2763,20,Y,N,-,-1,-1
REMKEL2.txt,283317,286001,2684,20,N,N,-,-1,-1
REMKEL2.txt,283991,286807,2816,20,Y,N,-,-1,-1
REMKEL2.txt,284378,287281,2903,20,Y,Y,1437304627219,286832,287509
REMKEL2.txt,285292,288404,3112,20,Y,Y,1437304627219,286832,287509
REMKEL2.txt,286002,289352,3350,20,Y,Y,1437304627219,286832,287509
REMKEL2.txt,286810,290016,3206,20,Y,Y,1437304627219,286832,287509
REMKEL2.txt,287283,291277,3994,20,Y,Y,1437304627219,286832,287509
REMKEL2.txt,288407,292251,3844,20,Y,N,-,-1,-1
REMKEL2.txt,289353,292705,3352,20,Y,Y,1437307314987,292427,293858
REMKEL2.txt,290017,293629,3612,20,Y,Y,1437307314987,292427,293858
REMKEL2.txt,291278,294080,2802,20,Y,Y,1437307314987,292427,293858
REMKEL2.txt,292252,294669,2417,20,Y,Y,1437307314987,292427,293858
REMKEL2.txt,292706,295256,2550,20,Y,Y,1437307314987,292427,293858
REMKEL2.txt,293631,296178,2547,20,Y,Y,1437308845347,295831,296335
REMKEL2.txt,294081,296745,2664,20,Y,Y,1437308845347,295831,296335
REMKEL2.txt,294670,297475,2805,20,Y,Y,1437308845347,295831,296335
REMKEL2.txt,295261,298087,2826,20,Y,Y,1437308845347,295831,296335
REMKEL2.txt,296179,299159,2980,20,N,Y,1437308845347,295831,296335
REMKEL2.txt,296746,299674,2928,20,N,N,-,-1,-1
REMKEL2.txt,297476,300773,3297,20,N,N,-,-1,-1
REMKEL2.txt,298088,301339,3251,20,N,N,-,-1,-1
REMKEL2.txt,299162,302010,2848,20,N,N,-,-1,-1
REMKEL2.txt,299675,302616,2941,20,N,N,-,-1,-1
REMKEL2.txt,300776,303342,2566,20,Y,Y,1437326732408,303180,303407
REMKEL2.txt,301342,304046,2704,20,Y,Y,1437326732408,303180,303407
REMKEL2.txt,302011,304786,2775,20,Y,Y,1437326732408,303180,303407
REMKEL2.txt,302618,305277,2659,20,Y,Y,1437326732408,303180,303407
REMKEL2.txt,303343,306089,2746,20,N,Y,1437326732408,303180,303407
REMKEL2.txt,304048,306843,2795,20,N,N,-,-1,-1
REMKEL2.txt,304787,307582,2795,20,N,N,-,-1,-1
REMKEL2.txt,305280,308487,3207,20,N,N,-,-1,-1
REMKEL2.txt,306090,309141,3051,20,Y,N,-,-1,-1
REMKEL2.txt,306845,309744,2899,20,Y,N,-,-1,-1
REMKEL2.txt,307583,310699,3116,20,Y,N,-,-1,-1
REMKEL2.txt,308488,311373,2885,20,Y,Y,1437327783601,310966,311726
REMKEL2.txt,309144,311934,2790,20,Y,Y,1437327783601,310966,311726
REMKEL2.txt,309746,312400,2654,20,Y,Y,1437328064404,312197,312391
REMKEL2.txt,310700,312931,2231,20,Y,Y,1437328064404,312197,312391
REMKEL2.txt,311374,313521,2147,20,Y,Y,1437328064404,312197,312391
REMKEL2.txt,311937,314205,2268,20,Y,Y,1437328064404,312197,312391
REMKEL2.txt,312403,314954,2551,20,Y,N,-,-1,-1
REMKEL2.txt,312932,315743,2811,20,N,N,-,-1,-1
REMKEL2.txt,313524,317049,3525,20,N,N,-,-1,-1
REMKEL2.txt,314206,317720,3514,20,N,N,-,-1,-1
REMKEL2.txt,314957,318927,3970,20,N,N,-,-1,-1
REMKEL2.txt,315745,319848,4103,20,N,N,-,-1,-1
REMKEL2.txt,317052,320298,3246,20,N,N,-,-1,-1
REMKEL2.txt,317721,320964,3243,20,N,N,-,-1,-1
REMKEL2.txt,318930,321505,2575,20,N,N,-,-1,-1
REMKEL2.txt,319849,322201,2352,20,Y,N,-,-1,-1
REMKEL2.txt,320299,322537,2238,20,N,N,-,-1,-1
REMKEL2.txt,320965,322997,2032,20,N,N,-,-1,-1
REMKEL2.txt,321507,323927,2420,20,Y,N,-,-1,-1
REMKEL2.txt,322202,324870,2668,20,Y,N,-,-1,-1
REMKEL2.txt,322538,325843,3305,20,Y,N,-,-1,-1
REMKEL2.txt,322998,326083,3085,20,Y,N,-,-1,-1
REMKEL2.txt,323932,326907,2975,20,Y,N,-,-1,-1
REMKEL2.txt,324871,327531,2660,20,Y,N,-,-1,-1
REMKEL2.txt,325844,328102,2258,20,N,N,-,-1,-1
REMKEL2.txt,326084,328773,2689,20,Y,Y,1437329475190,328720,329175
REMKEL2.txt,326910,329263,2353,20,Y,Y,1437329475190,328720,329175
REMKEL2.txt,327532,330204,2672,20,Y,Y,1437329475190,328720,329175
REMKEL2.txt,328103,330811,2708,20,Y,Y,1437329990944,330563,331008
REMKEL2.txt,328774,331468,2694,20,Y,Y,1437329990944,330563,331008
REMKEL2.txt,329264,332437,3173,20,Y,Y,1437329990944,330563,331008
REMKEL2.txt,330207,333017,2810,20,Y,Y,1437329990944,330563,331008
REMKEL2.txt,330812,333734,2922,20,Y,Y,1437329990944,330563,331008
REMKEL2.txt,331471,334154,2683,20,Y,Y,1437330221492,332568,334983
REMKEL2.txt,332438,335043,2605,20,Y,Y,1437330221492,332568,334983
REMKEL2.txt,333020,335898,2878,20,N,Y,1437330221492,332568,334983
REMKEL2.txt,333735,336320,2585,20,N,Y,1437330221492,332568,334983
REMKEL2.txt,334155,337082,2927,20,N,Y,1437406606228,336576,337981
REMKEL2.txt,335046,337856,2810,20,N,Y,1437406606228,336576,337981
REMKEL2.txt,335899,338381,2482,20,N,Y,1437406606228,336576,337981
REMKEL2.txt,336321,338844,2523,20,Y,Y,1437406606228,336576,337981
REMKEL2.txt,337083,339448,2365,20,Y,Y,1437406606228,336576,337981
REMKEL2.txt,337859,340003,2144,20,Y,Y,1437406606228,336576,337981
REMKEL2.txt,338382,340890,2508,20,Y,Y,1437406989981,338684,339072
REMKEL2.txt,338845,341893,3048,20,Y,Y,1437407180880,341111,341253
REMKEL2.txt,339449,342779,3330,20,Y,Y,1437407180880,341111,341253
REMKEL2.txt,340004,343238,3234,20,Y,Y,1437407180880,341111,341253
REMKEL2.txt,340893,343950,3057,20,Y,Y,1437408733806,343263,344199
REMKEL2.txt,341894,344823,2929,20,Y,Y,1437408733806,343263,344199
REMKEL2.txt,342782,345627,2845,20,Y,Y,1437408733806,343263,344199
REMKEL2.txt,343241,346465,3224,20,Y,Y,1437408733806,343263,344199
REMKEL2.txt,343951,347104,3153,20,N,Y,1437408733806,343263,344199
REMKEL2.txt,344824,347680,2856,20,N,N,-,-1,-1
REMKEL2.txt,345628,348498,2870,20,N,N,-,-1,-1
REMKEL2.txt,346466,349449,2983,20,N,N,-,-1,-1
REMKEL2.txt,347105,349839,2734,20,N,N,-,-1,-1
REMKEL2.txt,347683,350454,2771,20,N,Y,1437411277724,350226,350749
REMKEL2.txt,348503,351496,2993,20,Y,Y,1437411366462,350764,351452
REMKEL2.txt,349450,352395,2945,20,Y,Y,1437411366462,350764,351452
REMKEL2.txt,349840,352979,3139,20,Y,Y,1437411366462,350764,351452
REMKEL2.txt,350455,354311,3856,20,Y,Y,1437411366462,350764,351452
REMKEL2.txt,351499,355577,4078,20,Y,Y,1437415954991,352776,353698
REMKEL2.txt,352396,356975,4579,20,Y,Y,1437415954991,352776,353698
REMKEL2.txt,352980,358092,5112,20,N,Y,1437415954991,352776,353698
REMKEL2.txt,354314,358912,4598,20,N,N,-,-1,-1
REMKEL2.txt,355578,359940,4362,20,N,N,-,-1,-1
REMKEL2.txt,356976,361073,4097,20,N,N,-,-1,-1
REMKEL2.txt,358093,362835,4742,20,N,Y,1437426519522,362639,362832
REMKEL2.txt,358915,363476,4561,20,N,Y,1437426519522,362639,362832
REMKEL2.txt,359943,364041,4098,20,N,Y,1437426519522,362639,362832
REMKEL2.txt,361074,364716,3642,20,Y,Y,1437428195505,364284,364459
REMKEL2.txt,362838,365605,2767,20,Y,Y,1437428195505,364284,364459
REMKEL2.txt,363477,366135,2658,20,Y,Y,1437428195505,364284,364459
REMKEL2.txt,364042,366405,2363,20,Y,Y,1437428195505,364284,364459
REMKEL2.txt,364718,367304,2586,20,Y,N,-,-1,-1
REMKEL2.txt,365608,368012,2404,20,Y,N,-,-1,-1
REMKEL2.txt,366138,368930,2792,20,Y,N,-,-1,-1
REMKEL2.txt,366406,369782,3376,20,Y,N,-,-1,-1
REMKEL2.txt,367305,371074,3769,20,Y,Y,1437429287876,369796,370314
REMKEL2.txt,368015,371751,3736,20,N,Y,1437429287876,369796,370314
REMKEL2.txt,368933,372520,3587,20,Y,Y,1437429758375,371960,372645
REMKEL2.txt,369783,372940,3157,20,Y,Y,1437429758375,371960,372645
REMKEL2.txt,371075,373647,2572,20,Y,Y,1437429758375,371960,372645
REMKEL2.txt,371756,374073,2317,20,Y,Y,1437429758375,371960,372645
REMKEL2.txt,372523,374410,1887,20,Y,Y,1437429758375,371960,372645
REMKEL2.txt,372941,375136,2195,20,N,Y,1437430014246,372712,373313
REMKEL2.txt,373648,375940,2292,20,N,N,-,-1,-1
REMKEL2.txt,374076,376589,2513,20,N,N,-,-1,-1
REMKEL2.txt,374411,377080,2669,20,Y,N,-,-1,-1
REMKEL2.txt,375139,377526,2387,20,Y,N,-,-1,-1
REMKEL2.txt,375941,377842,1901,20,Y,N,-,-1,-1
REMKEL2.txt,376590,378292,1702,20,Y,N,-,-1,-1
REMKEL2.txt,377081,378808,1727,20,Y,Y,1437430915650,378465,378654
REMKEL2.txt,377529,379365,1836,20,Y,Y,1437430915650,378465,378654
REMKEL2.txt,377845,380585,2740,20,Y,Y,1437430915650,378465,378654
REMKEL2.txt,378294,381385,3091,20,Y,Y,1437430915650,378465,378654
REMKEL2.txt,378811,381856,3045,20,Y,Y,1437497691523,379511,381383
REMKEL2.txt,379368,382577,3209,20,Y,Y,1437497691523,379511,381383
REMKEL2.txt,380586,383813,3227,20,Y,Y,1437497691523,379511,381383
REMKEL2.txt,381388,384906,3518,20,Y,Y,1437499345691,382582,382870
REMKEL2.txt,381857,386177,4320,20,Y,Y,1437499345691,382582,382870
REMKEL2.txt,382579,387229,4650,20,N,Y,1437499345691,382582,382870
REMKEL2.txt,383816,387400,3584,20,N,N,-,-1,-1
REMKEL2.txt,384907,387506,2599,20,Y,N,-,-1,-1
REMKEL2.txt,386178,388059,1881,20,Y,Y,1437499592999,387747,388053
REMKEL2.txt,387230,388897,1667,20,Y,Y,1437499592999,387747,388053
REMKEL2.txt,387401,389425,2024,20,Y,Y,1437499592999,387747,388053
REMKEL2.txt,387508,389642,2134,20,Y,Y,1437499592999,387747,388053
REMKEL2.txt,388062,390952,2890,20,Y,Y,1437557057765,389552,390910
REMKEL2.txt,388900,391823,2923,20,Y,Y,1437557985724,390983,391293
REMKEL2.txt,389428,392367,2939,20,Y,Y,1437557985724,390983,391293
REMKEL2.txt,389643,393176,3533,20,Y,Y,1437557985724,390983,391293
REMKEL2.txt,390957,393997,3040,20,Y,Y,1437557985724,390983,391293
REMKEL2.txt,391826,395578,3752,20,N,Y,1437558718321,393945,394737
REMKEL2.txt,392368,396328,3960,20,N,Y,1437558718321,393945,394737
REMKEL2.txt,393179,397412,4233,20,N,Y,1437558718321,393945,394737
REMKEL2.txt,393998,398206,4208,20,N,Y,1438688689316,397692,398374
REMKEL2.txt,395581,399508,3927,20,N,Y,1438688689316,397692,398374
REMKEL2.txt,396333,400221,3888,20,N,Y,1438688689316,397692,398374
REMKEL2.txt,397413,401389,3976,20,Y,Y,1438688689316,397692,398374
REMKEL2.txt,398209,402276,4067,20,Y,Y,1438688689316,397692,398374
REMKEL2.txt,399509,402973,3464,20,Y,N,-,-1,-1
REMKEL2.txt,400224,403517,3293,20,Y,N,-,-1,-1
REMKEL2.txt,401390,403906,2516,20,N,Y,1438689541013,403594,405079
REMKEL2.txt,402277,404556,2279,20,N,Y,1438689541013,403594,405079
REMKEL2.txt,402976,404829,1853,20,Y,Y,1438689541013,403594,405079
REMKEL2.txt,403518,405039,1521,20,Y,Y,1438689541013,403594,405079
REMKEL2.txt,403907,405741,1834,20,Y,Y,1438689541013,403594,405079
REMKEL2.txt,404557,407043,2486,20,Y,Y,1438689541013,403594,405079
REMKEL2.txt,404830,407466,2636,20,Y,Y,1438689541013,403594,405079
REMKEL2.txt,405040,408395,3355,20,Y,Y,1438689541013,403594,405079
REMKEL2.txt,405743,408698,2955,20,Y,Y,1438690627657,407139,408101
REMKEL2.txt,407045,409310,2265,20,Y,Y,1438690627657,407139,408101
REMKEL2.txt,407467,410120,2653,20,Y,Y,1438690627657,407139,408101
REMKEL2.txt,408398,410897,2499,20,Y,N,-,-1,-1
REMKEL2.txt,408699,411657,2958,20,Y,N,-,-1,-1
REMKEL2.txt,409311,412484,3173,20,Y,N,-,-1,-1
REMKEL2.txt,410121,413354,3233,20,Y,N,-,-1,-1
REMKEL2.txt,410900,414071,3171,20,Y,N,-,-1,-1
REMKEL2.txt,411658,414583,2925,20,N,N,-,-1,-1
REMKEL2.txt,412486,415033,2547,20,N,N,-,-1,-1
REMKEL2.txt,413355,415988,2633,20,Y,N,-,-1,-1
REMKEL2.txt,414072,416891,2819,20,N,N,-,-1,-1
REMKEL2.txt,414584,418161,3577,20,N,N,-,-1,-1
REMKEL2.txt,415034,418937,3903,20,N,Y,1438707390329,418837,419955
REMKEL2.txt,415989,419843,3854,20,Y,Y,1438707390329,418837,419955
REMKEL2.txt,416896,420785,3889,20,Y,Y,1438707390329,418837,419955
REMKEL2.txt,418162,421728,3566,20,Y,Y,1438707390329,418837,419955
REMKEL2.txt,418938,422702,3764,20,Y,Y,1438707390329,418837,419955
REMKEL2.txt,419844,423450,3606,20,Y,Y,1438707390329,418837,419955
REMKEL2.txt,420788,424332,3544,20,Y,Y,1438708497019,423911,424226
REMKEL2.txt,421729,425059,3330,20,Y,Y,1438708497019,423911,424226
REMKEL2.txt,422703,425723,3020,20,Y,Y,1438708497019,423911,424226
REMKEL2.txt,423451,426598,3147,20,Y,Y,1438708497019,423911,424226
REMKEL2.txt,424335,427382,3047,20,Y,N,-,-1,-1
REMKEL2.txt,425061,428023,2962,20,Y,N,-,-1,-1
REMKEL2.txt,425724,429051,3327,20,Y,N,-,-1,-1
REMKEL2.txt,426601,429853,3252,20,Y,N,-,-1,-1
REMKEL2.txt,427383,430894,3511,20,N,N,-,-1,-1
REMKEL2.txt,428024,431966,3942,20,N,N,-,-1,-1
REMKEL2.txt,429052,433221,4169,20,N,N,-,-1,-1
REMKEL2.txt,429856,434103,4247,20,N,N,-,-1,-1
REMKEL2.txt,430895,435418,4523,20,N,N,-,-1,-1
REMKEL2.txt,431969,437428,5459,20,N,N,-,-1,-1
REMKEL2.txt,433222,438681,5459,20,N,N,-,-1,-1
REMKEL2.txt,434106,439580,5474,20,N,N,-,-1,-1
REMKEL2.txt,435421,440345,4924,20,N,N,-,-1,-1
REMKEL2.txt,437430,441479,4049,20,N,N,-,-1,-1
REMKEL2.txt,438682,442007,3325,20,N,N,-,-1,-1
REMKEL2.txt,439583,442955,3372,20,N,N,-,-1,-1
REMKEL2.txt,440346,443701,3355,20,N,N,-,-1,-1
REMKEL2.txt,441479,444466,2987,20,N,N,-,-1,-1
REMKEL2.txt,442010,444926,2916,20,N,N,-,-1,-1
REMKEL2.txt,442956,446221,3265,20,N,N,-,-1,-1
REMKEL2.txt,443702,446520,2818,20,N,N,-,-1,-1
REMKEL2.txt,444467,447066,2599,20,N,N,-,-1,-1
REMKEL2.txt,444929,447847,2918,20,N,N,-,-1,-1
REMKEL2.txt,446222,448299,2077,20,N,N,-,-1,-1
REMKEL2.txt,446521,449261,2740,20,N,N,-,-1,-1
REMKEL2.txt,447067,450302,3235,20,N,N,-,-1,-1
REMKEL2.txt,447848,451691,3843,20,N,N,-,-1,-1
REMKEL2.txt,448300,452228,3928,20,N,N,-,-1,-1
REMKEL2.txt,449262,452623,3361,20,Y,N,-,-1,-1
REMKEL2.txt,450305,453472,3167,20,Y,Y,1438711328776,453254,453945
REMKEL2.txt,451694,454068,2374,20,Y,Y,1438711328776,453254,453945
REMKEL2.txt,452229,454245,2016,20,Y,Y,1438711328776,453254,453945
REMKEL2.txt,452626,454373,1747,20,Y,Y,1438711328776,453254,453945
REMKEL2.txt,453473,454463,990,20,N,Y,1438711328776,453254,453945
REMKEL2.txt,454073,454844,771,20,N,N,-,-1,-1
REMKEL2.txt,454246,454931,685,20,N,N,-,-1,-1
REMKEL2.txt,454374,455042,668,20,N,N,-,-1,-1
REMKEL2.txt,454466,455089,623,20,N,N,-,-1,-1
REMKEL2.txt,454847,455155,308,20,N,N,-,-1,-1
REMKEL2.txt,454932,455458,526,20,N,N,-,-1,-1
REMKEL2.txt,455043,455505,462,20,N,N,-,-1,-1
REMKEL2.txt,455090,455700,610,20,N,N,-,-1,-1
REMKEL2.txt,455157,455734,577,20,N,N,-,-1,-1
REMKEL2.txt,455460,455985,525,20,N,N,-,-1,-1
REMKEL2.txt,455506,456065,559,20,N,N,-,-1,-1
REMKEL2.txt,455703,456184,481,20,N,N,-,-1,-1
REMKEL2.txt,455735,456285,550,20,N,N,-,-1,-1
REMKEL2.txt,455988,456350,362,20,N,N,-,-1,-1
REMKEL2.txt,456068,456451,383,20,N,N,-,-1,-1
REMKEL2.txt,456186,456480,294,20,N,N,-,-1,-1
REMKEL2.txt,456286,456800,514,20,N,N,-,-1,-1
REMKEL2.txt,456351,457131,780,20,N,N,-,-1,-1
REMKEL2.txt,456454,457204,750,20,N,N,-,-1,-1
REMKEL2.txt,456481,457325,844,20,N,N,-,-1,-1
REMKEL2.txt,456801,457417,616,20,N,N,-,-1,-1
REMKEL2.txt,457132,457523,391,20,N,N,-,-1,-1
REMKEL2.txt,457205,457674,469,20,N,N,-,-1,-1
REMKEL2.txt,457326,458495,1169,20,N,N,-,-1,-1
REMKEL2.txt,457418,459518,2100,20,N,N,-,-1,-1
REMKEL2.txt,457524,460466,2942,20,Y,N,-,-1,-1
REMKEL2.txt,457675,461280,3605,20,Y,N,-,-1,-1
REMKEL2.txt,458498,462157,3659,20,N,Y,1438857102755,461608,465337
REMKEL2.txt,459520,463252,3732,20,N,Y,1438857102755,461608,465337
REMKEL2.txt,460467,464398,3931,20,Y,Y,1438857102755,461608,465337
REMKEL2.txt,461282,464571,3289,20,Y,Y,1438857102755,461608,465337
REMKEL2.txt,462159,465519,3360,20,Y,Y,1438857102755,461608,465337
REMKEL2.txt,463253,466733,3480,20,Y,Y,1438857102755,461608,465337
REMKEL2.txt,464399,467391,2992,20,N,Y,1438857102755,461608,465337
REMKEL2.txt,464574,468883,4309,20,N,Y,1438857102755,461608,465337
REMKEL2.txt,465522,469824,4302,20,N,N,-,-1,-1
REMKEL2.txt,466736,470457,3721,20,N,N,-,-1,-1
REMKEL2.txt,467392,471639,4247,20,N,N,-,-1,-1
REMKEL2.txt,468884,472486,3602,20,N,N,-,-1,-1
REMKEL2.txt,469827,473108,3281,20,Y,N,-,-1,-1
REMKEL2.txt,470458,474342,3884,20,Y,N,-,-1,-1
REMKEL2.txt,471640,474876,3236,20,Y,N,-,-1,-1
REMKEL2.txt,472488,475088,2600,20,Y,N,-,-1,-1
REMKEL2.txt,473109,475710,2601,20,Y,N,-,-1,-1
REMKEL2.txt,474343,475754,1411,20,N,N,-,-1,-1
REMKEL2.txt,474879,476478,1599,20,N,N,-,-1,-1
REMKEL2.txt,475089,476904,1815,20,N,N,-,-1,-1
REMKEL2.txt,475711,477353,1642,20,N,N,-,-1,-1
REMKEL2.txt,475756,477533,1777,20,Y,N,-,-1,-1
REMKEL2.txt,476480,477734,1254,20,Y,N,-,-1,-1
REMKEL2.txt,476906,477931,1025,20,N,N,-,-1,-1
REMKEL2.txt,477354,477989,635,20,N,N,-,-1,-1
REMKEL2.txt,477535,478549,1014,20,N,N,-,-1,-1
REMKEL2.txt,477735,479436,1701,20,N,N,-,-1,-1
REMKEL2.txt,477932,479873,1941,20,N,N,-,-1,-1
REMKEL2.txt,477990,480554,2564,20,Y,N,-,-1,-1
REMKEL2.txt,478550,480939,2389,20,Y,N,-,-1,-1
REMKEL2.txt,479438,480984,1546,20,Y,N,-,-1,-1
REMKEL2.txt,479874,481136,1262,20,Y,N,-,-1,-1
REMKEL2.txt,480555,481593,1038,20,Y,N,-,-1,-1
REMKEL2.txt,480940,482422,1482,20,Y,N,-,-1,-1
REMKEL2.txt,480985,483073,2088,20,Y,N,-,-1,-1
REMKEL2.txt,481139,484298,3159,20,Y,N,-,-1,-1
REMKEL2.txt,481594,484677,3083,20,Y,N,-,-1,-1
REMKEL2.txt,482423,485448,3025,20,Y,N,-,-1,-1
REMKEL2.txt,483074,486120,3046,20,Y,N,-,-1,-1
REMKEL2.txt,484299,486927,2628,20,Y,N,-,-1,-1
REMKEL2.txt,484678,487153,2475,20,Y,N,-,-1,-1
REMKEL2.txt,485449,487979,2530,20,Y,N,-,-1,-1
REMKEL2.txt,486121,488259,2138,20,Y,N,-,-1,-1
REMKEL2.txt,486929,489003,2074,20,Y,N,-,-1,-1
REMKEL2.txt,487154,489689,2535,20,Y,N,-,-1,-1
REMKEL2.txt,487980,489914,1934,20,N,N,-,-1,-1
REMKEL2.txt,488260,490259,1999,20,N,N,-,-1,-1
REMKEL2.txt,489004,490933,1929,20,Y,N,-,-1,-1
REMKEL2.txt,489690,491556,1866,20,Y,N,-,-1,-1
REMKEL2.txt,489915,491989,2074,20,Y,N,-,-1,-1
REMKEL2.txt,490260,492471,2211,20,Y,N,-,-1,-1
REMKEL2.txt,490934,493238,2304,20,Y,N,-,-1,-1
REMKEL2.txt,491557,493805,2248,20,Y,N,-,-1,-1
REMKEL2.txt,491990,494168,2178,20,Y,N,-,-1,-1
REMKEL2.txt,492472,495000,2528,20,Y,N,-,-1,-1
REMKEL2.txt,493239,496149,2910,20,Y,N,-,-1,-1
REMKEL2.txt,493806,496850,3044,20,Y,N,-,-1,-1
REMKEL2.txt,494169,497327,3158,20,Y,N,-,-1,-1
REMKEL2.txt,495001,497745,2744,20,Y,N,-,-1,-1
REMKEL2.txt,496150,498614,2464,20,Y,N,-,-1,-1
REMKEL2.txt,496851,498948,2097,20,Y,N,-,-1,-1
REMKEL2.txt,497328,499460,2132,20,Y,N,-,-1,-1
REMKEL2.txt,497746,500066,2320,20,Y,N,-,-1,-1
REMKEL2.txt,498615,500272,1657,20,Y,N,-,-1,-1
REMKEL2.txt,498949,500395,1446,20,Y,N,-,-1,-1
REMKEL2.txt,499461,500750,1289,20,Y,N,-,-1,-1
REMKEL2.txt,500068,500894,826,20,Y,N,-,-1,-1
REMKEL2.txt,500273,501282,1009,20,Y,N,-,-1,-1
REMKEL2.txt,500397,501689,1292,20,Y,N,-,-1,-1
REMKEL2.txt,500751,501837,1086,20,Y,N,-,-1,-1
REMKEL2.txt,500895,502039,1144,20,Y,N,-,-1,-1
REMKEL2.txt,501283,502103,820,20,Y,N,-,-1,-1
REMKEL2.txt,501692,502298,606,20,Y,N,-,-1,-1
REMKEL2.txt,501838,502423,585,20,Y,N,-,-1,-1
REMKEL2.txt,502040,502568,528,20,N,N,-,-1,-1
REMKEL2.txt,502104,502795,691,20,N,N,-,-1,-1
REMKEL2.txt,502299,503011,712,20,Y,N,-,-1,-1
REMKEL2.txt,502424,503234,810,20,Y,N,-,-1,-1
REMKEL2.txt,502569,504254,1685,20,Y,N,-,-1,-1
REMKEL2.txt,502796,504713,1917,20,Y,N,-,-1,-1
REMKEL2.txt,503012,505319,2307,20,Y,N,-,-1,-1
REMKEL2.txt,503235,506053,2818,20,Y,N,-,-1,-1
REMKEL2.txt,504255,506630,2375,20,Y,N,-,-1,-1
REMKEL2.txt,504716,506977,2261,20,Y,N,-,-1,-1
REMKEL2.txt,505320,507203,1883,20,Y,N,-,-1,-1
REMKEL2.txt,506054,507695,1641,20,Y,N,-,-1,-1
REMKEL2.txt,506631,508173,1542,20,Y,N,-,-1,-1
REMKEL2.txt,506978,508375,1397,20,N,N,-,-1,-1
REMKEL2.txt,507204,508539,1335,20,N,N,-,-1,-1
REMKEL2.txt,507696,509113,1417,20,N,N,-,-1,-1
REMKEL2.txt,508175,509428,1253,20,N,N,-,-1,-1
REMKEL2.txt,508377,509684,1307,20,Y,N,-,-1,-1
REMKEL2.txt,508541,510163,1622,20,Y,N,-,-1,-1
REMKEL2.txt,509114,510383,1269,20,Y,N,-,-1,-1
REMKEL2.txt,509429,510662,1233,20,Y,N,-,-1,-1
REMKEL2.txt,509685,510870,1185,20,N,N,-,-1,-1
REMKEL2.txt,510164,511106,942,20,N,N,-,-1,-1
REMKEL2.txt,510384,511989,1605,20,Y,N,-,-1,-1
REMKEL2.txt,510663,512573,1910,20,Y,N,-,-1,-1
REMKEL2.txt,510871,513342,2471,20,Y,N,-,-1,-1
REMKEL2.txt,511109,513727,2618,20,Y,N,-,-1,-1
REMKEL2.txt,511990,514356,2366,20,Y,N,-,-1,-1
REMKEL2.txt,512574,514723,2149,20,Y,N,-,-1,-1
REMKEL2.txt,513343,515145,1802,20,Y,N,-,-1,-1
REMKEL2.txt,513728,515731,2003,20,N,N,-,-1,-1
REMKEL2.txt,514357,516030,1673,20,Y,N,-,-1,-1
REMKEL2.txt,514724,516355,1631,20,Y,N,-,-1,-1
REMKEL2.txt,515146,516539,1393,20,Y,N,-,-1,-1
REMKEL2.txt,515736,516985,1249,20,Y,N,-,-1,-1
REMKEL2.txt,516031,517359,1328,20,Y,N,-,-1,-1
REMKEL2.txt,516356,517461,1105,20,N,N,-,-1,-1
REMKEL2.txt,516541,517721,1180,20,N,N,-,-1,-1
REMKEL2.txt,516986,517961,975,20,N,N,-,-1,-1
REMKEL2.txt,517361,518275,914,20,N,N,-,-1,-1
REMKEL2.txt,517462,518514,1052,20,N,N,-,-1,-1
REMKEL2.txt,517722,518974,1252,20,N,N,-,-1,-1
REMKEL2.txt,517962,519124,1162,20,N,N,-,-1,-1
REMKEL2.txt,518276,519745,1469,20,N,N,-,-1,-1
REMKEL2.txt,518515,520382,1867,20,N,N,-,-1,-1
REOPER.txt,0,2690,2690,20,Y,N,-,-1,-1
REOPER.txt,641,4106,3465,20,Y,N,-,-1,-1
REOPER.txt,947,5346,4399,20,Y,N,-,-1,-1
REOPER.txt,1447,6885,5438,20,Y,N,-,-1,-1
REOPER.txt,2691,9358,6667,20,Y,N,-,-1,-1
REOPER.txt,4107,10947,6840,20,Y,N,-,-1,-1
REOPER.txt,5347,12949,7602,20,Y,N,-,-1,-1
REOPER.txt,6888,15111,8223,20,Y,N,-,-1,-1
REOPER.txt,9361,17298,7937,20,Y,N,-,-1,-1
REOPER.txt,10950,18778,7828,20,Y,N,-,-1,-1
REOPER.txt,12952,19617,6665,20,Y,N,-,-1,-1
REOPER.txt,15112,20729,5617,20,Y,N,-,-1,-1
REOPER.txt,17301,22625,5324,20,Y,N,-,-1,-1
REOPER.txt,18778,22933,4155,20,Y,N,-,-1,-1
REOPER.txt,19619,23956,4337,20,Y,N,-,-1,-1
REOPER.txt,20732,25016,4284,20,Y,N,-,-1,-1
REOPER.txt,22626,26961,4335,20,Y,N,-,-1,-1
REOPER.txt,22936,27756,4820,20,Y,N,-,-1,-1
REOPER.txt,23959,28908,4949,20,Y,N,-,-1,-1
REOPER.txt,25019,29510,4491,20,Y,N,-,-1,-1
REOPER.txt,26964,30945,3981,20,Y,N,-,-1,-1
REOPER.txt,27757,32318,4561,20,Y,N,-,-1,-1
REOPER.txt,28910,33278,4368,20,Y,N,-,-1,-1
REOPER.txt,29513,34376,4863,20,Y,N,-,-1,-1
REOPER.txt,30946,34991,4045,20,Y,N,-,-1,-1
REOPER.txt,32319,36290,3971,20,Y,N,-,-1,-1
REOPER.txt,33279,37588,4309,20,Y,N,-,-1,-1
REOPER.txt,34379,38083,3704,20,Y,N,-,-1,-1
REOPER.txt,34992,39329,4337,20,Y,N,-,-1,-1
REOPER.txt,36291,39915,3624,20,Y,N,-,-1,-1
REOPER.txt,37589,41503,3914,20,Y,N,-,-1,-1
REOPER.txt,38086,42310,4224,20,Y,N,-,-1,-1
REOPER.txt,39330,43121,3791,20,Y,N,-,-1,-1
REOPER.txt,39916,43679,3763,20,Y,N,-,-1,-1
REOPER.txt,41505,44566,3061,20,Y,N,-,-1,-1
REOPER.txt,42311,45991,3680,20,Y,N,-,-1,-1
REOPER.txt,43122,46756,3634,20,Y,N,-,-1,-1
REOPER.txt,43680,47873,4193,20,Y,N,-,-1,-1
REOPER.txt,44567,48717,4150,20,Y,N,-,-1,-1
REOPER.txt,45992,49679,3687,20,Y,N,-,-1,-1
REOPER.txt,46757,50179,3422,20,Y,N,-,-1,-1
REOPER.txt,47874,50626,2752,20,Y,N,-,-1,-1
REOPER.txt,48718,50976,2258,20,N,N,-,-1,-1
REOPER.txt,49680,51407,1727,20,N,N,-,-1,-1
REOPER.txt,50180,51855,1675,20,Y,N,-,-1,-1
REOPER.txt,50627,52787,2160,20,Y,N,-,-1,-1
REOPER.txt,50977,53305,2328,20,Y,N,-,-1,-1
REOPER.txt,51408,53719,2311,20,Y,N,-,-1,-1
REOPER.txt,51857,54267,2410,20,N,N,-,-1,-1
REOPER.txt,52788,55859,3071,20,N,N,-,-1,-1
REOPER.txt,53306,57145,3839,20,Y,N,-,-1,-1
REOPER.txt,53720,58404,4684,20,Y,N,-,-1,-1
REOPER.txt,54268,59379,5111,20,Y,N,-,-1,-1
REOPER.txt,55860,60488,4628,20,Y,N,-,-1,-1
REOPER.txt,57148,61201,4053,20,Y,N,-,-1,-1
REOPER.txt,58405,62324,3919,20,Y,N,-,-1,-1
REOPER.txt,59382,62570,3188,20,Y,N,-,-1,-1
REOPER.txt,60489,63649,3160,20,Y,N,-,-1,-1
REOPER.txt,61202,64515,3313,20,Y,N,-,-1,-1
REOPER.txt,62325,64857,2532,20,Y,N,-,-1,-1
REOPER.txt,62573,65913,3340,20,Y,N,-,-1,-1
REOPER.txt,63650,66968,3318,20,Y,N,-,-1,-1
REOPER.txt,64516,67926,3410,20,Y,N,-,-1,-1
REOPER.txt,64860,68725,3865,20,Y,N,-,-1,-1
REOPER.txt,65914,69561,3647,20,Y,N,-,-1,-1
REOPER.txt,66969,70057,3088,20,Y,N,-,-1,-1
REOPER.txt,67928,70549,2621,20,Y,N,-,-1,-1
REOPER.txt,68728,71882,3154,20,Y,N,-,-1,-1
REOPER.txt,69563,72906,3343,20,Y,N,-,-1,-1
REOPER.txt,70058,73959,3901,20,Y,N,-,-1,-1
REOPER.txt,70550,75107,4557,20,Y,N,-,-1,-1
REOPER.txt,71883,76304,4421,20,Y,N,-,-1,-1
REOPER.txt,72907,77124,4217,20,Y,N,-,-1,-1
REOPER.txt,73962,78261,4299,20,Y,N,-,-1,-1
REOPER.txt,75110,79095,3985,20,Y,N,-,-1,-1
REOPER.txt,76305,80641,4336,20,Y,N,-,-1,-1
REOPER.txt,77125,81314,4189,20,Y,N,-,-1,-1
REOPER.txt,78262,81882,3620,20,Y,N,-,-1,-1
REOPER.txt,79096,83034,3938,20,Y,N,-,-1,-1
REOPER.txt,80644,83833,3189,20,Y,N,-,-1,-1
REOPER.txt,81317,84710,3393,20,Y,N,-,-1,-1
REOPER.txt,81883,85411,3528,20,Y,N,-,-1,-1
REOPER.txt,83035,85801,2766,20,Y,N,-,-1,-1
REOPER.txt,83834,86349,2515,20,Y,N,-,-1,-1
REOPER.txt,84713,87142,2429,20,Y,Y,1438607512684,86513,88081
REOPER.txt,85412,88089,2677,20,Y,Y,1438607512684,86513,88081
REOPER.txt,85802,88877,3075,20,Y,Y,1438607512684,86513,88081
REOPER.txt,86350,89375,3025,20,Y,Y,1438607512684,86513,88081
REOPER.txt,87143,90288,3145,20,Y,Y,1438607512684,86513,88081
REOPER.txt,88090,91434,3344,20,Y,N,-,-1,-1
REOPER.txt,88882,92570,3688,20,Y,N,-,-1,-1
REOPER.txt,89378,93330,3952,20,Y,Y,1438607969604,92585,93513
REOPER.txt,90291,93986,3695,20,Y,Y,1438607969604,92585,93513
REOPER.txt,91437,95076,3639,20,Y,Y,1438607969604,92585,93513
REOPER.txt,92572,95890,3318,20,Y,Y,1438607969604,92585,93513
REOPER.txt,93331,96496,3165,20,Y,Y,1438607969604,92585,93513
REOPER.txt,93987,97225,3238,20,Y,Y,1438608430250,93743,94780
REOPER.txt,95077,98193,3116,20,Y,N,-,-1,-1
REOPER.txt,95891,98768,2877,20,Y,Y,1438609131672,98413,101156
REOPER.txt,96497,99171,2674,20,Y,Y,1438609131672,98413,101156
REOPER.txt,97226,99999,2773,20,Y,Y,1438609131672,98413,101156
REOPER.txt,98194,100852,2658,20,Y,Y,1438609131672,98413,101156
REOPER.txt,98769,101773,3004,20,Y,Y,1438609131672,98413,101156
REOPER.txt,99173,102516,3343,20,Y,Y,1438609131672,98413,101156
REOPER.txt,100000,103230,3230,20,Y,Y,1438609131672,98413,101156
REOPER.txt,100853,103769,2916,20,Y,Y,1438609131672,98413,101156
REOPER.txt,101774,104413,2639,20,Y,Y,1438609640620,101604,103071
REOPER.txt,102517,104858,2341,20,Y,Y,1438609640620,101604,103071
REOPER.txt,103231,105782,2551,20,Y,N,-,-1,-1
REOPER.txt,103770,106056,2286,20,Y,N,-,-1,-1
REOPER.txt,104414,106521,2107,20,Y,N,-,-1,-1
REOPER.txt,104859,107836,2977,20,N,N,-,-1,-1
REOPER.txt,105783,108663,2880,20,Y,Y,1438610692536,108268,109736
REOPER.txt,106059,109221,3162,20,Y,Y,1438610692536,108268,109736
REOPER.txt,106523,110267,3744,20,Y,Y,1438610692536,108268,109736
REOPER.txt,107841,110713,2872,20,Y,Y,1438610692536,108268,109736
REOPER.txt,108664,111575,2911,20,Y,Y,1438610692536,108268,109736
REOPER.txt,109222,112507,3285,20,Y,Y,1438610692536,108268,109736
REOPER.txt,110270,113289,3019,20,Y,N,-,-1,-1
REOPER.txt,110714,113660,2946,20,Y,N,-,-1,-1
REOPER.txt,111576,114694,3118,20,Y,N,-,-1,-1
REOPER.txt,112509,115727,3218,20,Y,Y,1438611798217,114785,115820
REOPER.txt,113290,116634,3344,20,Y,Y,1438611798217,114785,115820
REOPER.txt,113661,117504,3843,20,Y,Y,1438611798217,114785,115820
REOPER.txt,114695,118242,3547,20,Y,Y,1438611798217,114785,115820
REOPER.txt,115728,119268,3540,20,Y,Y,1438611798217,114785,115820
REOPER.txt,116635,120032,3397,20,Y,N,-,-1,-1
REOPER.txt,117505,120703,3198,20,Y,N,-,-1,-1
REOPER.txt,118244,121250,3006,20,Y,N,-,-1,-1
REOPER.txt,119269,121925,2656,20,Y,N,-,-1,-1
REOPER.txt,120033,122489,2456,20,Y,N,-,-1,-1
REOPER.txt,120704,123696,2992,20,Y,N,-,-1,-1
REOPER.txt,121251,124841,3590,20,Y,N,-,-1,-1
REOPER.txt,121927,125421,3494,20,Y,N,-,-1,-1
REOPER.txt,122490,125848,3358,20,Y,N,-,-1,-1
REOPER.txt,123697,126700,3003,20,Y,N,-,-1,-1
REOPER.txt,124843,127270,2427,20,Y,N,-,-1,-1
REOPER.txt,125426,128301,2875,20,Y,N,-,-1,-1
REOPER.txt,125849,129281,3432,20,Y,N,-,-1,-1
REOPER.txt,126701,130126,3425,20,Y,N,-,-1,-1
REOPER.txt,127271,130859,3588,20,Y,N,-,-1,-1
REOPER.txt,128302,131800,3498,20,Y,N,-,-1,-1
REOPER.txt,129283,132811,3528,20,Y,N,-,-1,-1
REOPER.txt,130127,133606,3479,20,Y,N,-,-1,-1
REOPER.txt,130862,134415,3553,20,Y,N,-,-1,-1
REOPER.txt,131801,135048,3247,20,Y,Y,1438612728607,134463,135433
REOPER.txt,132814,136083,3269,20,Y,Y,1438612728607,134463,135433
REOPER.txt,133607,136711,3104,20,Y,Y,1438612728607,134463,135433
REOPER.txt,134418,137602,3184,20,Y,Y,1438612728607,134463,135433
REOPER.txt,135049,138104,3055,20,Y,Y,1438612728607,134463,135433
REOPER.txt,136086,138568,2482,20,Y,Y,1438613292607,137557,139183
REOPER.txt,136712,139538,2826,20,Y,Y,1438613292607,137557,139183
REOPER.txt,137605,140235,2630,20,Y,Y,1438613292607,137557,139183
REOPER.txt,138107,141048,2941,20,Y,Y,1438613292607,137557,139183
REOPER.txt,138571,141981,3410,20,Y,Y,1438613292607,137557,139183
REOPER.txt,139541,142691,3150,20,Y,N,-,-1,-1
REOPER.txt,140238,143270,3032,20,Y,Y,1438613865632,142946,144271
REOPER.txt,141051,143882,2831,20,Y,Y,1438613865632,142946,144271
REOPER.txt,141982,144595,2613,20,Y,Y,1438613865632,142946,144271
REOPER.txt,142692,145116,2424,20,Y,Y,1438613865632,142946,144271
REOPER.txt,143271,146038,2767,20,Y,Y,1438613865632,142946,144271
REOPER.txt,143883,146950,3067,20,Y,Y,1438613865632,142946,144271
REOPER.txt,144597,147910,3313,20,Y,Y,1438614360025,144333,145484
REOPER.txt,145117,149024,3907,20,Y,Y,1438614360025,144333,145484
REOPER.txt,146039,150132,4093,20,Y,N,-,-1,-1
REOPER.txt,146951,150740,3789,20,Y,N,-,-1,-1
REOPER.txt,147911,151763,3852,20,Y,N,-,-1,-1
REOPER.txt,149027,152548,3521,20,N,N,-,-1,-1
REOPER.txt,150135,153255,3120,20,N,N,-,-1,-1
REOPER.txt,150741,154250,3509,20,N,N,-,-1,-1
REOPER.txt,151766,154986,3220,20,Y,N,-,-1,-1
REOPER.txt,152550,155974,3424,20,Y,Y,1438614732055,155289,156104
REOPER.txt,153258,156557,3299,20,Y,Y,1438614732055,155289,156104
REOPER.txt,154251,157313,3062,20,Y,Y,1438614732055,155289,156104
REOPER.txt,154987,158088,3101,20,Y,Y,1438614732055,155289,156104
REOPER.txt,155975,159006,3031,20,Y,Y,1438614732055,155289,156104
REOPER.txt,156558,160289,3731,20,Y,N,-,-1,-1
REOPER.txt,157314,160851,3537,20,Y,N,-,-1,-1
REOPER.txt,158089,161701,3612,20,Y,N,-,-1,-1
REOPER.txt,159009,162275,3266,20,N,N,-,-1,-1
REOPER.txt,160292,162852,2560,20,Y,N,-,-1,-1
REOPER.txt,160854,163773,2919,20,Y,N,-,-1,-1
REOPER.txt,161702,164341,2639,20,Y,N,-,-1,-1
REOPER.txt,162275,165107,2832,20,Y,N,-,-1,-1
REOPER.txt,162853,165828,2975,20,Y,N,-,-1,-1
REOPER.txt,163774,166702,2928,20,Y,N,-,-1,-1
REOPER.txt,164342,167618,3276,20,Y,N,-,-1,-1
REOPER.txt,165108,167967,2859,20,Y,N,-,-1,-1
REOPER.txt,165829,168690,2861,20,Y,Y,1438615349115,168230,169109
REOPER.txt,166705,169414,2709,20,Y,Y,1438615690871,169126,169616
REOPER.txt,167621,169825,2204,20,Y,Y,1438615690871,169126,169616
REOPER.txt,167968,170348,2380,20,Y,Y,1438615690871,169126,169616
REOPER.txt,168691,171187,2496,20,Y,Y,1438615690871,169126,169616
REOPER.txt,169415,171917,2502,20,Y,Y,1438615690871,169126,169616
REOPER.txt,169826,172544,2718,20,Y,N,-,-1,-1
REOPER.txt,170349,173197,2848,20,Y,N,-,-1,-1
REOPER.txt,171188,173786,2598,20,Y,N,-,-1,-1
REOPER.txt,171918,175127,3209,20,Y,Y,1438616254874,175117,176691
REOPER.txt,172545,176146,3601,20,Y,Y,1438616254874,175117,176691
REOPER.txt,173200,176926,3726,20,Y,Y,1438616254874,175117,176691
REOPER.txt,173789,178122,4333,20,Y,Y,1438616740544,177666,179189
REOPER.txt,175130,178588,3458,20,Y,Y,1438616740544,177666,179189
REOPER.txt,176147,179199,3052,20,Y,Y,1438616740544,177666,179189
REOPER.txt,176926,180186,3260,20,Y,Y,1438616740544,177666,179189
REOPER.txt,178123,181050,2927,20,Y,Y,1438617107509,180955,181678
REOPER.txt,178589,182017,3428,20,Y,Y,1438617107509,180955,181678
REOPER.txt,179202,182680,3478,20,Y,Y,1438617107509,180955,181678
REOPER.txt,180188,183915,3727,20,Y,Y,1438617107509,180955,181678
REOPER.txt,181052,184358,3306,20,Y,Y,1438617107509,180955,181678
REOPER.txt,182018,185161,3143,20,Y,N,-,-1,-1
REOPER.txt,182681,185917,3236,20,Y,N,-,-1,-1
REOPER.txt,183917,186426,2509,20,Y,N,-,-1,-1
REOPER.txt,184359,187432,3073,20,Y,N,-,-1,-1
REOPER.txt,185164,188208,3044,20,Y,N,-,-1,-1
REOPER.txt,185920,188899,2979,20,Y,N,-,-1,-1
REOPER.txt,186427,189531,3104,20,Y,N,-,-1,-1
REOPER.txt,187433,190419,2986,20,Y,N,-,-1,-1
REOPER.txt,188209,191372,3163,20,Y,N,-,-1,-1
REOPER.txt,188900,192171,3271,20,Y,N,-,-1,-1
REOPER.txt,189534,192823,3289,20,Y,N,-,-1,-1
REOPER.txt,190420,193126,2706,20,Y,N,-,-1,-1
REOPER.txt,191377,193947,2570,20,Y,N,-,-1,-1
REOPER.txt,192174,194109,1935,20,Y,N,-,-1,-1
REOPER.txt,192824,194405,1581,20,Y,N,-,-1,-1
REOPER.txt,193127,194563,1436,20,Y,N,-,-1,-1
REOPER.txt,193948,194785,837,20,N,N,-,-1,-1
REOPER.txt,194110,194985,875,20,N,N,-,-1,-1
REOPER.txt,194406,195210,804,20,Y,N,-,-1,-1
REOPER.txt,194564,195413,849,20,Y,N,-,-1,-1
REOPER.txt,194786,195763,977,20,Y,N,-,-1,-1
REOPER.txt,194988,195997,1009,20,Y,N,-,-1,-1
REOPER.txt,195211,196202,991,20,Y,N,-,-1,-1
REOPER.txt,195416,196522,1106,20,Y,N,-,-1,-1
REOPER.txt,195766,196724,958,20,Y,N,-,-1,-1
REOPER.txt,195998,197164,1166,20,Y,N,-,-1,-1
REOPER.txt,196203,198366,2163,20,Y,N,-,-1,-1
REOPER.txt,196523,199073,2550,20,Y,N,-,-1,-1
REOPER.txt,196725,199648,2923,20,Y,N,-,-1,-1
REOPER.txt,197167,200480,3313,20,Y,N,-,-1,-1
REOPER.txt,198368,201543,3175,20,Y,N,-,-1,-1
REOPER.txt,199076,202153,3077,20,Y,Y,1438678160825,201557,202648
REOPER.txt,199649,203214,3565,20,Y,Y,1438678160825,201557,202648
REOPER.txt,200481,203841,3360,20,Y,Y,1438678160825,201557,202648
REOPER.txt,201546,204530,2984,20,Y,Y,1438678160825,201557,202648
REOPER.txt,202154,205256,3102,20,Y,Y,1438678872682,204536,204996
REOPER.txt,203217,206271,3054,20,Y,Y,1438678872682,204536,204996
REOPER.txt,203842,206831,2989,20,Y,Y,1438678872682,204536,204996
REOPER.txt,204533,207886,3353,20,Y,Y,1438678872682,204536,204996
REOPER.txt,205257,208470,3213,20,Y,Y,1438679318783,205023,206296
REOPER.txt,206274,209588,3314,20,Y,Y,1438679318783,205023,206296
REOPER.txt,206834,210361,3527,20,Y,N,-,-1,-1
REOPER.txt,207889,211351,3462,20,Y,N,-,-1,-1
REOPER.txt,208471,211778,3307,20,Y,N,-,-1,-1
REOPER.txt,209589,212532,2943,20,Y,N,-,-1,-1
REOPER.txt,210364,213697,3333,20,Y,N,-,-1,-1
REOPER.txt,211353,214070,2717,20,Y,N,-,-1,-1
REOPER.txt,211780,214572,2792,20,Y,N,-,-1,-1
REOPER.txt,212533,215364,2831,20,Y,N,-,-1,-1
REOPER.txt,213698,216192,2494,20,Y,N,-,-1,-1
REOPER.txt,214071,216783,2712,20,N,N,-,-1,-1
REOPER.txt,214573,217485,2912,20,Y,N,-,-1,-1
REOPER.txt,215365,218209,2844,20,Y,N,-,-1,-1
REOPER.txt,216193,219326,3133,20,Y,N,-,-1,-1
REOPER.txt,216784,219951,3167,20,Y,N,-,-1,-1
REOPER.txt,217486,220775,3289,20,Y,N,-,-1,-1
REOPER.txt,218210,221668,3458,20,Y,N,-,-1,-1
REOPER.txt,219327,222547,3220,20,Y,N,-,-1,-1
REOPER.txt,219954,223137,3183,20,Y,N,-,-1,-1
REOPER.txt,220776,223770,2994,20,N,N,-,-1,-1
REOPER.txt,221669,224454,2785,20,Y,N,-,-1,-1
REOPER.txt,222548,225309,2761,20,N,N,-,-1,-1
REOPER.txt,223138,226262,3124,20,N,N,-,-1,-1
REOPER.txt,223771,226785,3014,20,N,N,-,-1,-1
REOPER.txt,224455,227241,2786,20,N,N,-,-1,-1
REOPER.txt,225310,227843,2533,20,N,N,-,-1,-1
REOPER.txt,226263,228256,1993,20,Y,N,-,-1,-1
REOPER.txt,226786,228655,1869,20,Y,N,-,-1,-1
REOPER.txt,227242,229007,1765,20,Y,N,-,-1,-1
REOPER.txt,227844,229512,1668,20,Y,N,-,-1,-1
REOPER.txt,228257,230661,2404,20,Y,Y,1438680128352,229816,231640
REOPER.txt,228656,231203,2547,20,Y,Y,1438680128352,229816,231640
REOPER.txt,229008,232539,3531,20,Y,Y,1438680128352,229816,231640
REOPER.txt,229513,232849,3336,20,Y,Y,1438680128352,229816,231640
REOPER.txt,230662,234522,3860,20,Y,Y,1438680128352,229816,231640
REOPER.txt,231206,235477,4271,20,Y,Y,1438680128352,229816,231640
REOPER.txt,232542,236111,3569,20,N,Y,1438680995516,235335,237205
REOPER.txt,232851,237292,4441,20,Y,Y,1438680995516,235335,237205
REOPER.txt,234525,238643,4118,20,Y,Y,1438680995516,235335,237205
REOPER.txt,235478,240372,4894,20,Y,Y,1438680995516,235335,237205
REOPER.txt,236112,241938,5826,20,Y,Y,1438680995516,235335,237205
REOPER.txt,237295,242950,5655,20,Y,N,-,-1,-1
REOPER.txt,238644,243694,5050,20,Y,N,-,-1,-1
REOPER.txt,240373,244453,4080,20,Y,N,-,-1,-1
REOPER.txt,241941,245607,3666,20,Y,N,-,-1,-1
REOPER.txt,242951,246666,3715,20,Y,N,-,-1,-1
REOPER.txt,243696,247661,3965,20,N,N,-,-1,-1
REOPER.txt,244454,248809,4355,20,Y,N,-,-1,-1
REOPER.txt,245610,249511,3901,20,Y,N,-,-1,-1
REOPER.txt,246667,250840,4173,20,Y,N,-,-1,-1
REOPER.txt,247662,251776,4114,20,Y,N,-,-1,-1
REOPER.txt,248810,253521,4711,20,Y,N,-,-1,-1
REOPER.txt,249512,255013,5501,20,Y,N,-,-1,-1
REOPER.txt,250841,256178,5337,20,Y,N,-,-1,-1
REOPER.txt,251779,257253,5474,20,Y,N,-,-1,-1
REOPER.txt,253522,258318,4796,20,Y,N,-,-1,-1
REOPER.txt,255014,258912,3898,20,Y,N,-,-1,-1
REOPER.txt,256179,259866,3687,20,Y,N,-,-1,-1
REOPER.txt,257254,260467,3213,20,Y,N,-,-1,-1
REOPER.txt,258321,261066,2745,20,Y,N,-,-1,-1
REOPER.txt,258913,261742,2829,20,Y,N,-,-1,-1
REOPER.txt,259867,262215,2348,20,Y,N,-,-1,-1
REOPER.txt,260468,262793,2325,20,Y,N,-,-1,-1
REOPER.txt,261067,263189,2122,20,Y,N,-,-1,-1
REOPER.txt,261743,263765,2022,20,Y,N,-,-1,-1
REOPER.txt,262216,264313,2097,20,Y,N,-,-1,-1
REOPER.txt,262795,264962,2167,20,Y,N,-,-1,-1
REOPER.txt,263190,265816,2626,20,Y,N,-,-1,-1
REOPER.txt,263768,266385,2617,20,Y,N,-,-1,-1
REOPER.txt,264314,267112,2798,20,Y,N,-,-1,-1
REOPER.txt,264963,268058,3095,20,Y,N,-,-1,-1
REOPER.txt,265817,268923,3106,20,Y,N,-,-1,-1
REOPER.txt,266388,270108,3720,20,Y,N,-,-1,-1
REOPER.txt,267113,270717,3604,20,Y,N,-,-1,-1
REOPER.txt,268059,271577,3518,20,Y,N,-,-1,-1
REOPER.txt,268924,272396,3472,20,Y,N,-,-1,-1
REOPER.txt,270111,273515,3404,20,Y,N,-,-1,-1
REOPER.txt,270718,274580,3862,20,Y,N,-,-1,-1
REOPER.txt,271578,275624,4046,20,Y,Y,1438682217043,275162,278631
REOPER.txt,272397,276327,3930,20,Y,Y,1438682217043,275162,278631
REOPER.txt,273518,277149,3631,20,Y,Y,1438682217043,275162,278631
REOPER.txt,274582,277718,3136,20,Y,Y,1438682217043,275162,278631
REOPER.txt,275625,279101,3476,20,Y,Y,1438682217043,275162,278631
REOPER.txt,276328,279839,3511,20,Y,Y,1438682217043,275162,278631
REOPER.txt,277151,280229,3078,20,Y,Y,1438682217043,275162,278631
REOPER.txt,277719,280985,3266,20,Y,Y,1438685164472,280335,281058
REOPER.txt,279102,281590,2488,20,Y,Y,1438685164472,280335,281058
REOPER.txt,279840,282398,2558,20,Y,Y,1438685164472,280335,281058
REOPER.txt,280230,283030,2800,20,Y,Y,1438685629660,282434,284008
REOPER.txt,280986,283746,2760,20,Y,Y,1438685629660,282434,284008
REOPER.txt,281591,284465,2874,20,Y,Y,1438685960938,284054,284833
REOPER.txt,282400,285008,2608,20,Y,Y,1438685960938,284054,284833
REOPER.txt,283031,285757,2726,20,Y,Y,1438685960938,284054,284833
REOPER.txt,283747,286458,2711,20,Y,Y,1438685960938,284054,284833
REOPER.txt,284466,286801,2335,20,Y,Y,1438685960938,284054,284833
REOPER.txt,285009,287709,2700,20,N,N,-,-1,-1
REOPER.txt,285758,288459,2701,20,Y,N,-,-1,-1
REOPER.txt,286459,289677,3218,20,Y,N,-,-1,-1
REOPER.txt,286802,290133,3331,20,Y,N,-,-1,-1
REOPER.txt,287712,290760,3048,20,Y,N,-,-1,-1
REOPER.txt,288460,291851,3391,20,Y,N,-,-1,-1
REOPER.txt,289678,292876,3198,20,Y,N,-,-1,-1
REOPER.txt,290136,293655,3519,20,Y,N,-,-1,-1
REOPER.txt,290763,294481,3718,20,Y,N,-,-1,-1
REOPER.txt,291854,295076,3222,20,Y,N,-,-1,-1
REOPER.txt,292879,296626,3747,20,Y,N,-,-1,-1
REOPER.txt,293656,297564,3908,20,Y,N,-,-1,-1
REOPER.txt,294482,298462,3980,20,Y,N,-,-1,-1
REOPER.txt,295079,299187,4108,20,Y,N,-,-1,-1
REOPER.txt,296627,300147,3520,20,Y,N,-,-1,-1
REOPER.txt,297565,301405,3840,20,Y,N,-,-1,-1
REOPER.txt,298465,302091,3626,20,Y,N,-,-1,-1
REOPER.txt,299190,302871,3681,20,Y,N,-,-1,-1
REOPER.txt,300148,303670,3522,20,Y,N,-,-1,-1
REOPER.txt,301406,304671,3265,20,Y,N,-,-1,-1
REOPER.txt,302094,305350,3256,20,Y,N,-,-1,-1
REOPER.txt,302872,306428,3556,20,Y,N,-,-1,-1
REOPER.txt,303671,307702,4031,20,Y,N,-,-1,-1
REOPER.txt,304672,308539,3867,20,Y,N,-,-1,-1
REOPER.txt,305351,309657,4306,20,Y,N,-,-1,-1
REOPER.txt,306429,311248,4819,20,Y,N,-,-1,-1
REOPER.txt,307705,312195,4490,20,Y,N,-,-1,-1
REOPER.txt,308540,312885,4345,20,Y,N,-,-1,-1
REOPER.txt,309658,313683,4025,20,Y,N,-,-1,-1
REOPER.txt,311249,314823,3574,20,Y,N,-,-1,-1
REOPER.txt,312196,315985,3789,20,Y,N,-,-1,-1
REOPER.txt,312886,317233,4347,20,Y,N,-,-1,-1
REOPER.txt,313684,318409,4725,20,Y,N,-,-1,-1
REOPER.txt,314824,318976,4152,20,Y,N,-,-1,-1
REOPER.txt,315986,320493,4507,20,Y,N,-,-1,-1
REOPER.txt,317234,321689,4455,20,Y,N,-,-1,-1
REOPER.txt,318410,322748,4338,20,Y,N,-,-1,-1
REOPER.txt,318977,323876,4899,20,Y,N,-,-1,-1
REOPER.txt,320494,324454,3960,20,Y,N,-,-1,-1
REOPER.txt,321690,325222,3532,20,Y,N,-,-1,-1
REOPER.txt,322750,325941,3191,20,Y,Y,1438686868625,325508,327523
REOPER.txt,323878,326804,2926,20,Y,Y,1438686868625,325508,327523
REOPER.txt,324455,327272,2817,20,Y,Y,1438686868625,325508,327523
REOPER.txt,325223,327642,2419,20,Y,Y,1438686868625,325508,327523
REOPER.txt,325942,328207,2265,20,Y,Y,1438686868625,325508,327523
REOPER.txt,326805,329198,2393,20,Y,Y,1438686868625,325508,327523
REOPER.txt,327273,330533,3260,20,Y,Y,1438686868625,325508,327523
REOPER.txt,327643,331351,3708,20,Y,Y,1438687348398,330268,331286
REOPER.txt,328208,332338,4130,20,Y,Y,1438687348398,330268,331286
REOPER.txt,329203,333203,4000,20,Y,Y,1438687348398,330268,331286
REOPER.txt,330534,333921,3387,20,Y,Y,1438687348398,330268,331286
REOPER.txt,331352,334824,3472,20,Y,N,-,-1,-1
REOPER.txt,332339,336044,3705,20,Y,N,-,-1,-1
REOPER.txt,333204,336529,3325,20,Y,N,-,-1,-1
REOPER.txt,333922,337227,3305,20,Y,N,-,-1,-1
REOPER.txt,334825,337548,2723,20,Y,N,-,-1,-1
REOPER.txt,336045,338631,2586,20,Y,N,-,-1,-1
REOPER.txt,336530,339161,2631,20,Y,Y,1438687949932,339086,339844
REOPER.txt,337228,339927,2699,20,Y,Y,1438687949932,339086,339844
REOPER.txt,337549,340675,3126,20,Y,Y,1438687949932,339086,339844
REOPER.txt,338632,341145,2513,20,Y,Y,1438687949932,339086,339844
REOPER.txt,339162,341693,2531,20,Y,Y,1438687949932,339086,339844
REOPER.txt,339928,342041,2113,20,Y,Y,1438702766275,340360,340868
REOPER.txt,340676,342435,1759,20,Y,Y,1438702766275,340360,340868
REOPER.txt,341146,342973,1827,20,Y,N,-,-1,-1
REOPER.txt,341696,343453,1757,20,N,N,-,-1,-1
REOPER.txt,342043,344045,2002,20,N,N,-,-1,-1
REOPER.txt,342436,344644,2208,20,Y,N,-,-1,-1
REOPER.txt,342974,345319,2345,20,Y,N,-,-1,-1
REOPER.txt,343454,346626,3172,20,Y,Y,1438703676425,346475,348599
REOPER.txt,344046,347125,3079,20,Y,Y,1438703676425,346475,348599
REOPER.txt,344645,347790,3145,20,Y,Y,1438703676425,346475,348599
REOPER.txt,345320,348216,2896,20,Y,Y,1438703676425,346475,348599
REOPER.txt,346627,348559,1932,20,Y,Y,1438703676425,346475,348599
REOPER.txt,347126,349171,2045,20,Y,Y,1438703676425,346475,348599
REOPER.txt,347791,350149,2358,20,Y,Y,1438703676425,346475,348599
REOPER.txt,348217,351441,3224,20,Y,Y,1438703676425,346475,348599
REOPER.txt,348560,352164,3604,20,Y,Y,1438703676425,346475,348599
REOPER.txt,349173,352917,3744,20,Y,Y,1438703994435,348752,349433
REOPER.txt,350154,353569,3415,20,Y,Y,1438704310167,353374,354086
REOPER.txt,351442,354524,3082,20,Y,Y,1438704734352,354115,355438
REOPER.txt,352167,355506,3339,20,Y,Y,1438704734352,354115,355438
REOPER.txt,352918,356735,3817,20,Y,Y,1438705014163,355515,357095
REOPER.txt,353570,357281,3711,20,Y,Y,1438705014163,355515,357095
REOPER.txt,354526,358117,3591,20,Y,Y,1438705014163,355515,357095
REOPER.txt,355508,359228,3720,20,Y,Y,1438705014163,355515,357095
REOPER.txt,356736,359911,3175,20,Y,Y,1438705014163,355515,357095
REOPER.txt,357282,360614,3332,20,Y,Y,1438705728692,359763,361602
REOPER.txt,358118,360977,2859,20,Y,Y,1438705728692,359763,361602
REOPER.txt,359231,361677,2446,20,Y,Y,1438705728692,359763,361602
REOPER.txt,359912,362424,2512,20,Y,Y,1438706068692,361693,362653
REOPER.txt,360615,363014,2399,20,Y,Y,1438706068692,361693,362653
REOPER.txt,360978,363605,2627,20,Y,Y,1438706068692,361693,362653
REOPER.txt,361680,364344,2664,20,Y,Y,1438706068692,361693,362653
REOPER.txt,362425,365278,2853,20,Y,Y,1438706068692,361693,362653
REOPER.txt,363015,366083,3068,20,Y,N,-,-1,-1
REOPER.txt,363608,367173,3565,20,Y,N,-,-1,-1
REOPER.txt,364346,367760,3414,20,Y,N,-,-1,-1
REOPER.txt,365279,368718,3439,20,Y,N,-,-1,-1
REOPER.txt,366084,369643,3559,20,Y,N,-,-1,-1
REOPER.txt,367174,370476,3302,20,Y,N,-,-1,-1
REOPER.txt,367761,371356,3595,20,Y,N,-,-1,-1
REOPER.txt,368720,372174,3454,20,Y,N,-,-1,-1
REOPER.txt,369646,372766,3120,20,Y,N,-,-1,-1
REOPER.txt,370477,373298,2821,20,Y,N,-,-1,-1
REOPER.txt,371357,374035,2678,20,Y,N,-,-1,-1
REOPER.txt,372175,374755,2580,20,Y,N,-,-1,-1
REOPER.txt,372767,375279,2512,20,Y,N,-,-1,-1
REOPER.txt,373299,375774,2475,20,Y,N,-,-1,-1
REOPER.txt,374036,376318,2282,20,Y,N,-,-1,-1
REOPER.txt,374756,376911,2155,20,Y,N,-,-1,-1
REOPER.txt,375280,377736,2456,20,N,N,-,-1,-1
REOPER.txt,375777,378531,2754,20,Y,N,-,-1,-1
REOPER.txt,376319,379252,2933,20,Y,N,-,-1,-1
REOPER.txt,376912,380053,3141,20,N,N,-,-1,-1
REOPER.txt,377737,380799,3062,20,Y,N,-,-1,-1
REOPER.txt,378532,381844,3312,20,Y,N,-,-1,-1
REOPER.txt,379253,382666,3413,20,N,N,-,-1,-1
REOPER.txt,380054,383364,3310,20,Y,N,-,-1,-1
REOPER.txt,380802,384166,3364,20,Y,Y,1438706551121,383929,384620
REOPER.txt,381845,384764,2919,20,Y,Y,1438706551121,383929,384620
REOPER.txt,382669,385304,2635,20,Y,Y,1438706551121,383929,384620
REOPER.txt,383365,386206,2841,20,Y,Y,1438706551121,383929,384620
REOPER.txt,384167,386938,2771,20,Y,Y,1438706551121,383929,384620
REOPER.txt,384765,387634,2869,20,Y,N,-,-1,-1
REOPER.txt,385306,388414,3108,20,Y,N,-,-1,-1
REOPER.txt,386207,388960,2753,20,Y,N,-,-1,-1
REOPER.txt,386941,389510,2569,20,Y,N,-,-1,-1
REOPER.txt,387635,390329,2694,20,Y,N,-,-1,-1
REOPER.txt,388415,391105,2690,20,Y,N,-,-1,-1
REOPER.txt,388963,392240,3277,20,Y,N,-,-1,-1
REOPER.txt,389511,393144,3633,20,Y,N,-,-1,-1
REOPER.txt,390330,393972,3642,20,Y,N,-,-1,-1
REOPER.txt,391106,394741,3635,20,Y,N,-,-1,-1
REOPER.txt,392241,396047,3806,20,Y,Y,1438707526102,395204,399120
REOPER.txt,393145,396659,3514,20,Y,Y,1438707526102,395204,399120
REOPER.txt,393975,397412,3437,20,Y,Y,1438707526102,395204,399120
REOPER.txt,394742,398008,3266,20,Y,Y,1438707526102,395204,399120
REOPER.txt,396048,398723,2675,20,Y,Y,1438707526102,395204,399120
REOPER.txt,396660,399698,3038,20,Y,Y,1438707526102,395204,399120
REOPER.txt,397413,400234,2821,20,Y,Y,1438707526102,395204,399120
REOPER.txt,398011,400988,2977,20,Y,Y,1438707526102,395204,399120
REOPER.txt,398723,401434,2711,20,Y,Y,1438707526102,395204,399120
REOPER.txt,399699,401998,2299,20,Y,Y,1438763811355,400311,402065
REOPER.txt,400236,402502,2266,20,Y,Y,1438763811355,400311,402065
REOPER.txt,400989,403331,2342,20,Y,Y,1438763811355,400311,402065
REOPER.txt,401435,404188,2753,20,Y,Y,1438763811355,400311,402065
REOPER.txt,402000,404830,2830,20,Y,Y,1438763811355,400311,402065
REOPER.txt,402503,405010,2507,20,Y,N,-,-1,-1
REOPER.txt,403333,405812,2479,20,Y,N,-,-1,-1
REOPER.txt,404191,406841,2650,20,N,Y,1438764333941,406033,406469
REOPER.txt,404831,407505,2674,20,Y,Y,1438764333941,406033,406469
REOPER.txt,405011,408794,3783,20,Y,Y,1438764333941,406033,406469
REOPER.txt,405813,410009,4196,20,Y,Y,1438764333941,406033,406469
REOPER.txt,406842,410740,3898,20,Y,Y,1438764866768,406493,408910
REOPER.txt,407508,411322,3814,20,Y,Y,1438764866768,406493,408910
REOPER.txt,408795,411917,3122,20,Y,Y,1438765478053,411548,412139
REOPER.txt,410010,412555,2545,20,Y,Y,1438765478053,411548,412139
REOPER.txt,410741,413444,2703,20,Y,Y,1438765478053,411548,412139
REOPER.txt,411324,414174,2850,20,Y,Y,1438765478053,411548,412139
REOPER.txt,411918,415370,3452,20,Y,Y,1438765478053,411548,412139
REOPER.txt,412556,416093,3537,20,Y,Y,1438767071786,415842,416696
REOPER.txt,413445,416857,3412,20,Y,Y,1438767071786,415842,416696
REOPER.txt,414177,418004,3827,20,Y,Y,1438767795308,417699,419098
REOPER.txt,415371,419583,4212,20,Y,Y,1438767795308,417699,419098
REOPER.txt,416094,420207,4113,20,Y,Y,1438767795308,417699,419098
REOPER.txt,416858,421059,4201,20,Y,Y,1438767795308,417699,419098
REOPER.txt,418007,421892,3885,20,Y,Y,1438767795308,417699,419098
REOPER.txt,419586,423007,3421,20,Y,Y,1438768079697,419611,420712
REOPER.txt,420208,423649,3441,20,Y,Y,1438768079697,419611,420712
REOPER.txt,421060,424683,3623,20,N,N,-,-1,-1
REOPER.txt,421894,425697,3803,20,N,N,-,-1,-1
REOPER.txt,423008,426554,3546,20,Y,N,-,-1,-1
REOPER.txt,423652,427534,3882,20,Y,N,-,-1,-1
REOPER.txt,424684,428052,3368,20,Y,N,-,-1,-1
REOPER.txt,425698,429133,3435,20,Y,N,-,-1,-1
REOPER.txt,426555,430342,3787,20,Y,N,-,-1,-1
REOPER.txt,427537,430799,3262,20,Y,N,-,-1,-1
REOPER.txt,428055,431501,3446,20,Y,N,-,-1,-1
REOPER.txt,429136,432242,3106,20,Y,N,-,-1,-1
REOPER.txt,430343,433395,3052,20,Y,N,-,-1,-1
REOPER.txt,430800,434263,3463,20,Y,N,-,-1,-1
REOPER.txt,431502,435029,3527,20,Y,N,-,-1,-1
REOPER.txt,432243,436102,3859,20,Y,N,-,-1,-1
REOPER.txt,433396,436926,3530,20,Y,N,-,-1,-1
REOPER.txt,434264,437987,3723,20,Y,N,-,-1,-1
REOPER.txt,435030,438658,3628,20,Y,N,-,-1,-1
REOPER.txt,436105,439812,3707,20,Y,Y,1438769202218,438794,441102
REOPER.txt,436927,440693,3766,20,Y,Y,1438769202218,438794,441102
REOPER.txt,437988,440874,2886,20,Y,Y,1438769202218,438794,441102
REOPER.txt,438659,441769,3110,20,Y,Y,1438769202218,438794,441102
REOPER.txt,439815,442462,2647,20,Y,Y,1438769202218,438794,441102
REOPER.txt,440696,443178,2482,20,N,Y,1438769202218,438794,441102
REOPER.txt,440875,443443,2568,20,Y,Y,1438769202218,438794,441102
REOPER.txt,441771,443673,1902,20,Y,N,-,-1,-1
REOPER.txt,442463,444008,1545,20,Y,N,-,-1,-1
REOPER.txt,443183,444319,1136,20,Y,N,-,-1,-1
REOPER.txt,443444,444671,1227,20,Y,N,-,-1,-1
REOPER.txt,443674,445062,1388,20,Y,N,-,-1,-1
REOPER.txt,444009,445682,1673,20,Y,N,-,-1,-1
REOPER.txt,444320,445847,1527,20,Y,N,-,-1,-1
REOPER.txt,444672,446175,1503,20,Y,N,-,-1,-1
REOPER.txt,445063,446513,1450,20,Y,N,-,-1,-1
REOPER.txt,445685,447468,1783,20,Y,N,-,-1,-1
REOPER.txt,445848,448654,2806,20,Y,N,-,-1,-1
REOPER.txt,446178,449695,3517,20,Y,N,-,-1,-1
REOPER.txt,446514,450413,3899,20,Y,Y,1438769699545,450302,451135
REOPER.txt,447469,450970,3501,20,Y,Y,1438769699545,450302,451135
REOPER.txt,448657,451956,3299,20,Y,Y,1438769699545,450302,451135
REOPER.txt,449696,452617,2921,20,Y,Y,1438769699545,450302,451135
REOPER.txt,450414,453265,2851,20,Y,Y,1438769699545,450302,451135
REOPER.txt,450971,453618,2647,20,Y,Y,1438769699545,450302,451135
REOPER.txt,451957,454059,2102,20,Y,Y,1438770629803,453971,456097
REOPER.txt,452618,454572,1954,20,Y,Y,1438770629803,453971,456097
REOPER.txt,453266,455262,1996,20,Y,Y,1438770629803,453971,456097
REOPER.txt,453619,455938,2319,20,Y,Y,1438770629803,453971,456097
REOPER.txt,454060,457045,2985,20,Y,Y,1438771010421,456188,458240
REOPER.txt,454573,457663,3090,20,Y,Y,1438771010421,456188,458240
REOPER.txt,455263,458062,2799,20,Y,Y,1438771010421,456188,458240
REOPER.txt,455939,458979,3040,20,Y,Y,1438771010421,456188,458240
REOPER.txt,457048,460135,3087,20,Y,Y,1438771010421,456188,458240
REOPER.txt,457664,461140,3476,20,Y,Y,1438771010421,456188,458240
REOPER.txt,458063,461853,3790,20,Y,Y,1438771010421,456188,458240
REOPER.txt,458980,462740,3760,20,Y,Y,1438771823978,462479,463275
REOPER.txt,460137,463879,3742,20,Y,Y,1438771823978,462479,463275
REOPER.txt,461141,464617,3476,20,Y,Y,1438771823978,462479,463275
REOPER.txt,461854,465837,3983,20,Y,Y,1438771823978,462479,463275
REOPER.txt,462741,466457,3716,20,Y,Y,1438771823978,462479,463275
REOPER.txt,463880,467644,3764,20,Y,N,-,-1,-1
REOPER.txt,464620,468031,3411,20,Y,N,-,-1,-1
REOPER.txt,465839,468609,2770,20,Y,N,-,-1,-1
REOPER.txt,466458,469274,2816,20,Y,N,-,-1,-1
REOPER.txt,467645,469744,2099,20,Y,N,-,-1,-1
REOPER.txt,468032,470546,2514,20,Y,N,-,-1,-1
REOPER.txt,468610,471388,2778,20,Y,N,-,-1,-1
REOPER.txt,469276,471963,2687,20,Y,N,-,-1,-1
REOPER.txt,469745,472744,2999,20,Y,N,-,-1,-1
REOPER.txt,470547,473525,2978,20,Y,N,-,-1,-1
REOPER.txt,471389,474192,2803,20,Y,Y,1438778151735,473810,477429
REOPER.txt,471964,474753,2789,20,Y,Y,1438778151735,473810,477429
REOPER.txt,472745,475425,2680,20,Y,Y,1438778151735,473810,477429
REOPER.txt,473526,475828,2302,20,Y,Y,1438778151735,473810,477429
REOPER.txt,474193,476424,2231,20,Y,Y,1438778151735,473810,477429
REOPER.txt,474754,476973,2219,20,Y,Y,1438778151735,473810,477429
REOPER.txt,475426,477579,2153,20,Y,Y,1438778151735,473810,477429
REOPER.txt,475829,478055,2226,20,Y,Y,1438778151735,473810,477429
REOPER.txt,476425,478826,2401,20,Y,Y,1438778151735,473810,477429
REOPER.txt,476974,479705,2731,20,Y,Y,1438778151735,473810,477429
REOPER.txt,477580,480385,2805,20,Y,Y,1438778406473,477978,478874
REOPER.txt,478056,480827,2771,20,Y,Y,1438778406473,477978,478874
REOPER.txt,478829,481414,2585,20,Y,Y,1438778406473,477978,478874
REOPER.txt,479706,481978,2272,20,Y,Y,1438778739733,480167,480764
REOPER.txt,480386,482405,2019,20,Y,Y,1438778739733,480167,480764
REOPER.txt,480828,482738,1910,20,Y,N,-,-1,-1
REOPER.txt,481415,483708,2293,20,Y,N,-,-1,-1
REOPER.txt,481979,484369,2390,20,N,N,-,-1,-1
REOPER.txt,482408,485092,2684,20,Y,N,-,-1,-1
REOPER.txt,482739,485756,3017,20,Y,N,-,-1,-1
REOPER.txt,483709,486785,3076,20,Y,N,-,-1,-1
REOPER.txt,484372,487517,3145,20,Y,N,-,-1,-1
REOPER.txt,485094,488619,3525,20,Y,N,-,-1,-1
REOPER.txt,485757,489307,3550,20,Y,N,-,-1,-1
REOPER.txt,486786,490247,3461,20,Y,N,-,-1,-1
REOPER.txt,487522,490661,3139,20,N,N,-,-1,-1
REOPER.txt,488620,491270,2650,20,N,N,-,-1,-1
REOPER.txt,489308,492337,3029,20,Y,N,-,-1,-1
REOPER.txt,490248,493105,2857,20,Y,N,-,-1,-1
REOPER.txt,490662,494311,3649,20,Y,N,-,-1,-1
REOPER.txt,491273,495507,4234,20,Y,N,-,-1,-1
REOPER.txt,492338,496863,4525,20,Y,N,-,-1,-1
REOPER.txt,493106,497872,4766,20,Y,N,-,-1,-1
REOPER.txt,494312,498230,3918,20,N,N,-,-1,-1
REOPER.txt,495508,499150,3642,20,Y,N,-,-1,-1
REOPER.txt,496864,499805,2941,20,N,N,-,-1,-1
REOPER.txt,497872,500322,2450,20,N,N,-,-1,-1
REOPER.txt,498231,501305,3074,20,N,N,-,-1,-1
REOPER.txt,499152,502287,3135,20,N,N,-,-1,-1
REOPER.txt,499807,502888,3081,20,Y,N,-,-1,-1
REOPER.txt,500323,503871,3548,20,Y,N,-,-1,-1
REOPER.txt,501308,504595,3287,20,Y,N,-,-1,-1
REOPER.txt,502288,506035,3747,20,Y,Y,1438779843654,505464,507513
REOPER.txt,502889,506801,3912,20,Y,Y,1438779843654,505464,507513
REOPER.txt,503874,507585,3711,20,Y,Y,1438779843654,505464,507513
REOPER.txt,504596,508618,4022,20,Y,Y,1438779843654,505464,507513
REOPER.txt,506036,509397,3361,20,Y,Y,1438779843654,505464,507513
REOPER.txt,506802,510338,3536,20,Y,Y,1438779843654,505464,507513
REOPER.txt,507586,510863,3277,20,Y,Y,1438780085816,508364,509135
REOPER.txt,508619,511320,2701,20,Y,Y,1438780085816,508364,509135
REOPER.txt,509398,512069,2671,20,Y,Y,1438780706972,510534,511384
REOPER.txt,510339,512926,2587,20,Y,Y,1438780706972,510534,511384
REOPER.txt,510864,513541,2677,20,Y,Y,1438780706972,510534,511384
REOPER.txt,511321,514303,2982,20,Y,Y,1438780706972,510534,511384
REOPER.txt,512070,514931,2861,20,Y,Y,1438781426985,512557,514085
REOPER.txt,512927,515828,2901,20,Y,Y,1438781426985,512557,514085
REOPER.txt,513544,516664,3120,20,Y,Y,1438781426985,512557,514085
REOPER.txt,514304,517449,3145,20,Y,N,-,-1,-1
REOPER.txt,514932,518333,3401,20,Y,N,-,-1,-1
REOPER.txt,515829,519017,3188,20,Y,N,-,-1,-1
REOPER.txt,516665,520114,3449,20,Y,N,-,-1,-1
REOPER.txt,517450,520820,3370,20,Y,N,-,-1,-1
REOPER.txt,518336,521475,3139,20,Y,N,-,-1,-1
REOPER.txt,519018,522024,3006,20,Y,Y,1438782478949,521766,525299
REOPER.txt,520115,522583,2468,20,Y,Y,1438782478949,521766,525299
REOPER.txt,520822,522778,1956,20,Y,Y,1438782478949,521766,525299
REOPER.txt,521476,523335,1859,20,Y,Y,1438782478949,521766,525299
REOPER.txt,522029,523805,1776,20,Y,Y,1438782478949,521766,525299
REOPER.txt,522584,524525,1941,20,Y,Y,1438782478949,521766,525299
REOPER.txt,522779,525705,2926,20,Y,Y,1438782478949,521766,525299
REOPER.txt,523338,526443,3105,20,Y,Y,1438782478949,521766,525299
REOPER.txt,523806,527290,3484,20,Y,Y,1438782478949,521766,525299
REOPER.txt,524526,528369,3843,20,Y,Y,1438782478949,521766,525299
REOPER.txt,525708,529042,3334,20,Y,Y,1438783041826,526732,528338
REOPER.txt,526444,529820,3376,20,Y,Y,1438783041826,526732,528338
REOPER.txt,527291,530430,3139,20,Y,Y,1438783041826,526732,528338
REOPER.txt,528372,531065,2693,20,Y,Y,1438783543267,530789,532585
REOPER.txt,529043,531639,2596,20,Y,Y,1438783543267,530789,532585
REOPER.txt,529821,532285,2464,20,Y,Y,1438783543267,530789,532585
REOPER.txt,530431,532814,2383,20,Y,Y,1438783543267,530789,532585
REOPER.txt,531066,533480,2414,20,Y,Y,1438784312899,533121,535184
REOPER.txt,531640,534342,2702,20,Y,Y,1438784312899,533121,535184
REOPER.txt,532286,534875,2589,20,Y,Y,1438784312899,533121,535184
REOPER.txt,532817,535567,2750,20,Y,Y,1438784652063,535262,536596
REOPER.txt,533481,536231,2750,20,Y,Y,1438784652063,535262,536596
REOPER.txt,534343,536927,2584,20,Y,Y,1438784652063,535262,536596
REOPER.txt,534876,537609,2733,20,Y,Y,1438784652063,535262,536596
REOPER.txt,535569,538133,2564,20,Y,Y,1438784652063,535262,536596
REOPER.txt,536232,538812,2580,20,Y,Y,1438784652063,535262,536596
REOPER.txt,536928,539858,2930,20,Y,N,-,-1,-1
REOPER.txt,537610,540784,3174,20,Y,N,-,-1,-1
REOPER.txt,538134,541526,3392,20,Y,N,-,-1,-1
REOPER.txt,538813,542169,3356,20,Y,N,-,-1,-1
REOPER.txt,539861,542763,2902,20,Y,N,-,-1,-1
REOPER.txt,540786,543560,2774,20,Y,N,-,-1,-1
REOPER.txt,541527,544073,2546,20,Y,N,-,-1,-1
REOPER.txt,542170,544832,2662,20,Y,N,-,-1,-1
REOPER.txt,542764,545604,2840,20,Y,N,-,-1,-1
REOPER.txt,543563,546558,2995,20,Y,N,-,-1,-1
REOPER.txt,544074,547213,3139,20,Y,N,-,-1,-1
REOPER.txt,544833,548009,3176,20,Y,N,-,-1,-1
REOPER.txt,545605,548758,3153,20,Y,N,-,-1,-1
REOPER.txt,546559,549432,2873,20,Y,N,-,-1,-1
REOPER.txt,547214,549890,2676,20,N,N,-,-1,-1
REOPER.txt,548010,551022,3012,20,Y,N,-,-1,-1
REOPER.txt,548761,551929,3168,20,Y,N,-,-1,-1
REOPER.txt,549433,552904,3471,20,Y,N,-,-1,-1
REOPER.txt,549893,553753,3860,20,Y,N,-,-1,-1
REOPER.txt,551023,554477,3454,20,Y,N,-,-1,-1
REOPER.txt,551930,555102,3172,20,Y,N,-,-1,-1
REOPER.txt,552905,555621,2716,20,Y,N,-,-1,-1
REOPER.txt,553754,556528,2774,20,Y,N,-,-1,-1
REOPER.txt,554478,557522,3044,20,Y,N,-,-1,-1
REOPER.txt,555105,558404,3299,20,Y,N,-,-1,-1
REOPER.txt,555623,559259,3636,20,Y,N,-,-1,-1
REOPER.txt,556531,559896,3365,20,Y,N,-,-1,-1
REOPER.txt,557523,560985,3462,20,Y,N,-,-1,-1
REOPER.txt,558405,561667,3262,20,Y,N,-,-1,-1
REOPER.txt,559260,562611,3351,20,Y,N,-,-1,-1
REOPER.txt,559896,563392,3496,20,Y,N,-,-1,-1
REOPER.txt,560988,564304,3316,20,Y,N,-,-1,-1
REOPER.txt,561668,565095,3427,20,Y,N,-,-1,-1
REOPER.txt,562613,565733,3120,20,Y,N,-,-1,-1
REOPER.txt,563394,566395,3001,20,Y,N,-,-1,-1
REOPER.txt,564305,567164,2859,20,Y,N,-,-1,-1
REOPER.txt,565096,568251,3155,20,Y,N,-,-1,-1
REOPER.txt,565734,568811,3077,20,Y,N,-,-1,-1
REOPER.txt,566396,570028,3632,20,Y,N,-,-1,-1
REOPER.txt,567165,570557,3392,20,Y,N,-,-1,-1
REOPER.txt,568252,571432,3180,20,Y,N,-,-1,-1
REOPER.txt,568812,572229,3417,20,Y,N,-,-1,-1
REOPER.txt,570029,573102,3073,20,Y,N,-,-1,-1
REOPER.txt,570558,573818,3260,20,Y,N,-,-1,-1
REOPER.txt,571433,574862,3429,20,Y,N,-,-1,-1
REOPER.txt,572232,575451,3219,20,Y,N,-,-1,-1
REOPER.txt,573103,575977,2874,20,Y,N,-,-1,-1
REOPER.txt,573819,576629,2810,20,Y,N,-,-1,-1
REOPER.txt,574863,577866,3003,20,Y,N,-,-1,-1
REOPER.txt,575454,578678,3224,20,Y,N,-,-1,-1
REOPER.txt,575978,579719,3741,20,Y,N,-,-1,-1
REOPER.txt,576630,580875,4245,20,Y,N,-,-1,-1
REOPER.txt,577869,581877,4008,20,Y,N,-,-1,-1
REOPER.txt,578679,582732,4053,20,Y,N,-,-1,-1
REOPER.txt,579721,583536,3815,20,Y,N,-,-1,-1
REOPER.txt,580876,584293,3417,20,Y,N,-,-1,-1
REOPER.txt,581878,584702,2824,20,Y,N,-,-1,-1
REOPER.txt,582735,585339,2604,20,Y,N,-,-1,-1
REOPER.txt,583539,585752,2213,20,Y,N,-,-1,-1
REOPER.txt,584294,586540,2246,20,Y,N,-,-1,-1
REOPER.txt,584703,586995,2292,20,Y,N,-,-1,-1
REOPER.txt,585340,587502,2162,20,Y,N,-,-1,-1
REOPER.txt,585753,587844,2091,20,Y,N,-,-1,-1
REOPER.txt,586542,588859,2317,20,Y,N,-,-1,-1
REOPER.txt,586996,589726,2730,20,Y,N,-,-1,-1
REOPER.txt,587503,590131,2628,20,Y,N,-,-1,-1
REOPER.txt,587847,591217,3370,20,Y,N,-,-1,-1
REOPER.txt,588860,592011,3151,20,Y,N,-,-1,-1
REOPER.txt,589727,592860,3133,20,Y,N,-,-1,-1
REOPER.txt,590133,593522,3389,20,Y,N,-,-1,-1
REOPER.txt,591218,594392,3174,20,Y,N,-,-1,-1
REOPER.txt,592012,595312,3300,20,Y,N,-,-1,-1
REOPER.txt,592861,596512,3651,20,Y,N,-,-1,-1
REOPER.txt,593523,597256,3733,20,Y,N,-,-1,-1
REOPER.txt,594393,598189,3796,20,Y,N,-,-1,-1
REOPER.txt,595313,598966,3653,20,Y,N,-,-1,-1
REOPER.txt,596514,599562,3048,20,Y,N,-,-1,-1
REOPER.txt,597257,600641,3384,20,Y,N,-,-1,-1
REOPER.txt,598190,601617,3427,20,Y,N,-,-1,-1
REOPER.txt,598967,602698,3731,20,Y,N,-,-1,-1
REOPER.txt,599563,603449,3886,20,Y,N,-,-1,-1
REOPER.txt,600642,604374,3732,20,Y,N,-,-1,-1
REOPER.txt,601618,605222,3604,20,Y,N,-,-1,-1
REOPER.txt,602703,605768,3065,20,Y,N,-,-1,-1
REOPER.txt,603450,606971,3521,20,Y,N,-,-1,-1
REOPER.txt,604375,607797,3422,20,Y,N,-,-1,-1
REOPER.txt,605223,608902,3679,20,Y,N,-,-1,-1
REOPER.txt,605769,609462,3693,20,Y,N,-,-1,-1
REOPER.txt,606974,610268,3294,20,Y,N,-,-1,-1
REOPER.txt,607798,610907,3109,20,Y,N,-,-1,-1
REOPER.txt,608903,611640,2737,20,Y,N,-,-1,-1
REOPER.txt,609463,612531,3068,20,Y,N,-,-1,-1
REOPER.txt,610269,613292,3023,20,Y,N,-,-1,-1
REOPER.txt,610908,614068,3160,20,Y,N,-,-1,-1
REOPER.txt,611643,614847,3204,20,Y,N,-,-1,-1
REOPER.txt,612532,615379,2847,20,Y,N,-,-1,-1
REOPER.txt,613293,615986,2693,20,Y,N,-,-1,-1
REOPER.txt,614069,616859,2790,20,Y,N,-,-1,-1
REOPER.txt,614848,617993,3145,20,Y,N,-,-1,-1
REOPER.txt,615380,619093,3713,20,Y,N,-,-1,-1
REOPER.txt,615987,619827,3840,20,Y,N,-,-1,-1
REOPER.txt,616860,620695,3835,20,Y,N,-,-1,-1
REOPER.txt,617996,621458,3462,20,Y,N,-,-1,-1
REOPER.txt,619094,622209,3115,20,Y,N,-,-1,-1
REOPER.txt,619828,623313,3485,20,Y,N,-,-1,-1
REOPER.txt,620697,624208,3511,20,Y,N,-,-1,-1
REOPER.txt,621463,625067,3604,20,Y,N,-,-1,-1
REOPER.txt,622210,625738,3528,20,Y,N,-,-1,-1
REOPER.txt,623318,626426,3108,20,Y,N,-,-1,-1
REOPER.txt,624209,627269,3060,20,Y,N,-,-1,-1
REOPER.txt,625070,627779,2709,20,Y,N,-,-1,-1
REOPER.txt,625741,628910,3169,20,Y,N,-,-1,-1
REOPER.txt,626427,629363,2936,20,Y,N,-,-1,-1
REOPER.txt,627270,630163,2893,20,Y,N,-,-1,-1
REOPER.txt,627780,630663,2883,20,Y,N,-,-1,-1
REOPER.txt,628911,631223,2312,20,Y,N,-,-1,-1
REOPER.txt,629364,632266,2902,20,N,N,-,-1,-1
REOPER.txt,630166,632781,2615,20,Y,N,-,-1,-1
REOPER.txt,630664,633753,3089,20,Y,N,-,-1,-1
REOPER.txt,631224,634586,3362,20,Y,N,-,-1,-1
REOPER.txt,632269,635272,3003,20,Y,N,-,-1,-1
REOPER.txt,632782,635977,3195,20,Y,N,-,-1,-1
REOPER.txt,633753,636839,3086,20,Y,N,-,-1,-1
REOPER.txt,634587,637732,3145,20,Y,N,-,-1,-1
REOPER.txt,635273,638664,3391,20,Y,N,-,-1,-1
REOPER.txt,635978,639506,3528,20,Y,N,-,-1,-1
REOPER.txt,636840,640414,3574,20,Y,N,-,-1,-1
REOPER.txt,637733,641162,3429,20,Y,N,-,-1,-1
REOPER.txt,638665,642103,3438,20,Y,N,-,-1,-1
REOPER.txt,639509,643036,3527,20,Y,N,-,-1,-1
REOPER.txt,640415,643426,3011,20,Y,N,-,-1,-1
REOPER.txt,641163,644504,3341,20,Y,N,-,-1,-1
REOPER.txt,642104,645393,3289,20,Y,N,-,-1,-1
REOPER.txt,643036,646600,3564,20,Y,N,-,-1,-1
REOPER.txt,643427,648495,5068,20,Y,N,-,-1,-1
REOPER.txt,644506,649239,4733,20,Y,N,-,-1,-1
REOPER.txt,645394,650481,5087,20,Y,N,-,-1,-1
REOPER.txt,646601,651291,4690,20,Y,N,-,-1,-1
REOPER.txt,648496,651782,3286,20,Y,N,-,-1,-1
REOPER.txt,649242,652185,2943,20,Y,N,-,-1,-1
REOPER.txt,650482,652958,2476,20,Y,N,-,-1,-1
REOPER.txt,651292,653889,2597,20,Y,N,-,-1,-1
REOPER.txt,651783,654795,3012,20,Y,N,-,-1,-1
REOPER.txt,652188,655704,3516,20,N,N,-,-1,-1
REOPER.txt,652961,656269,3308,20,N,N,-,-1,-1
REOPER.txt,653892,657149,3257,20,N,N,-,-1,-1
REOPER.txt,654796,658443,3647,20,Y,N,-,-1,-1
REOPER.txt,655707,659150,3443,20,Y,N,-,-1,-1
REOPER.txt,656270,659685,3415,20,Y,N,-,-1,-1
REOPER.txt,657151,660483,3332,20,Y,N,-,-1,-1
REOPER.txt,658444,661267,2823,20,Y,N,-,-1,-1
REOPER.txt,659152,661752,2600,20,Y,N,-,-1,-1
REOPER.txt,659686,662554,2868,20,Y,N,-,-1,-1
REOPER.txt,660486,663305,2819,20,Y,N,-,-1,-1
REOPER.txt,661268,664111,2843,20,N,N,-,-1,-1
REOPER.txt,661753,665496,3743,20,N,N,-,-1,-1
REOPER.txt,662555,666441,3886,20,N,N,-,-1,-1
REOPER.txt,663306,667464,4158,20,N,N,-,-1,-1
REOPER.txt,664112,668549,4437,20,N,N,-,-1,-1
REOPER.txt,665497,669331,3834,20,N,N,-,-1,-1
REOPER.txt,666444,670172,3728,20,N,N,-,-1,-1
REOPER.txt,667465,671003,3538,20,N,N,-,-1,-1
REOPER.txt,668549,671317,2768,20,N,N,-,-1,-1
REOPER.txt,669332,671884,2552,20,Y,N,-,-1,-1
REOPER.txt,670174,672700,2526,20,Y,N,-,-1,-1
REOPER.txt,671004,673073,2069,20,Y,N,-,-1,-1
REOPER.txt,671317,673982,2665,20,Y,N,-,-1,-1
REOPER.txt,671885,674603,2718,20,Y,N,-,-1,-1
REOPER.txt,672701,675253,2552,20,Y,N,-,-1,-1
REOPER.txt,673074,675858,2784,20,Y,N,-,-1,-1
REOPER.txt,673983,676048,2065,20,Y,N,-,-1,-1
REOPER.txt,674604,677014,2410,20,Y,N,-,-1,-1
REOPER.txt,675254,677724,2470,20,Y,N,-,-1,-1
REOPER.txt,675861,678012,2151,20,Y,N,-,-1,-1
REOPER.txt,676051,678568,2517,20,Y,N,-,-1,-1
REOPER.txt,677015,679540,2525,20,Y,N,-,-1,-1
REOPER.txt,677725,680362,2637,20,Y,N,-,-1,-1
REOPER.txt,678013,681174,3161,20,Y,N,-,-1,-1
REOPER.txt,678569,681625,3056,20,Y,N,-,-1,-1
REOPER.txt,679541,682628,3087,20,Y,N,-,-1,-1
REOPER.txt,680363,683249,2886,20,Y,N,-,-1,-1
REOPER.txt,681175,684065,2890,20,Y,N,-,-1,-1
REOPER.txt,681626,685262,3636,20,Y,N,-,-1,-1
REOPER.txt,682629,685876,3247,20,Y,N,-,-1,-1
REOPER.txt,683250,686594,3344,20,Y,N,-,-1,-1
REOPER.txt,684067,687340,3273,20,Y,N,-,-1,-1
REOPER.txt,685265,688046,2781,20,Y,N,-,-1,-1
REOPER.txt,685878,688385,2507,20,Y,N,-,-1,-1
REOPER.txt,686595,689124,2529,20,Y,N,-,-1,-1
REOPER.txt,687341,689970,2629,20,Y,N,-,-1,-1
REOPER.txt,688047,690713,2666,20,Y,N,-,-1,-1
REOPER.txt,688386,691617,3231,20,Y,N,-,-1,-1
REOPER.txt,689127,692241,3114,20,Y,N,-,-1,-1
REOPER.txt,689971,693258,3287,20,Y,N,-,-1,-1
REOPER.txt,690713,693614,2901,20,Y,N,-,-1,-1
REOPER.txt,691619,694192,2573,20,Y,N,-,-1,-1
REOPER.txt,692242,694681,2439,20,Y,N,-,-1,-1
REOPER.txt,693261,695239,1978,20,Y,N,-,-1,-1
REOPER.txt,693615,695582,1967,20,Y,N,-,-1,-1
REOPER.txt,694193,696283,2090,20,Y,N,-,-1,-1
REOPER.txt,694682,696516,1834,20,Y,N,-,-1,-1
REOPER.txt,695240,696981,1741,20,Y,N,-,-1,-1
REOPER.txt,695584,697209,1625,20,Y,N,-,-1,-1
REOPER.txt,696284,697602,1318,20,Y,N,-,-1,-1
REOPER.txt,696517,698566,2049,20,Y,N,-,-1,-1
REOPER.txt,696984,699385,2401,20,Y,N,-,-1,-1
REOPER.txt,697210,700599,3389,20,Y,N,-,-1,-1
REOPER.txt,697605,701040,3435,20,Y,N,-,-1,-1
REOPER.txt,698567,701543,2976,20,Y,N,-,-1,-1
REOPER.txt,699386,702094,2708,20,Y,N,-,-1,-1
REOPER.txt,700600,703215,2615,20,Y,N,-,-1,-1
REOPER.txt,701041,703798,2757,20,Y,N,-,-1,-1
REOPER.txt,701543,704626,3083,20,Y,N,-,-1,-1
REOPER.txt,702095,705144,3049,20,Y,N,-,-1,-1
REOPER.txt,703216,705571,2355,20,Y,N,-,-1,-1
REOPER.txt,703799,706347,2548,20,Y,N,-,-1,-1
REOPER.txt,704627,706976,2349,20,Y,N,-,-1,-1
REOPER.txt,705145,707967,2822,20,Y,N,-,-1,-1
REOPER.txt,705572,708625,3053,20,Y,N,-,-1,-1
REOPER.txt,706348,709287,2939,20,Y,N,-,-1,-1
REOPER.txt,706978,710455,3477,20,Y,N,-,-1,-1
REOPER.txt,707968,710902,2934,20,Y,N,-,-1,-1
REOPER.txt,708626,711262,2636,20,Y,N,-,-1,-1
REOPER.txt,709288,711721,2433,20,Y,N,-,-1,-1
REOPER.txt,710456,712340,1884,20,Y,N,-,-1,-1
REOPER.txt,710903,712796,1893,20,Y,N,-,-1,-1
REOPER.txt,711263,713368,2105,20,Y,N,-,-1,-1
REOPER.txt,711722,713955,2233,20,Y,N,-,-1,-1
REOPER.txt,712342,714556,2214,20,Y,N,-,-1,-1
REOPER.txt,712797,715158,2361,20,Y,N,-,-1,-1
REOPER.txt,713369,715978,2609,20,Y,N,-,-1,-1
REOPER.txt,713957,716660,2703,20,Y,N,-,-1,-1
REOPER.txt,714558,717207,2649,20,Y,N,-,-1,-1
REOPER.txt,715159,717836,2677,20,N,N,-,-1,-1
REOPER.txt,715979,718723,2744,20,Y,N,-,-1,-1
REOPER.txt,716662,719659,2997,20,Y,N,-,-1,-1
REOPER.txt,717208,720027,2819,20,Y,N,-,-1,-1
REOPER.txt,717839,720847,3008,20,Y,N,-,-1,-1
REOPER.txt,718724,721396,2672,20,Y,N,-,-1,-1
REOPER.txt,719662,722696,3034,20,Y,N,-,-1,-1
REOPER.txt,720029,723611,3582,20,Y,N,-,-1,-1
REOPER.txt,720849,724784,3935,20,Y,N,-,-1,-1
REOPER.txt,721397,725206,3809,20,Y,N,-,-1,-1
REOPER.txt,722697,726102,3405,20,Y,N,-,-1,-1
REOPER.txt,723612,726825,3213,20,Y,N,-,-1,-1
REOPER.txt,724785,727565,2780,20,Y,N,-,-1,-1
REOPER.txt,725207,728091,2884,20,Y,N,-,-1,-1
REOPER.txt,726103,728381,2278,20,Y,N,-,-1,-1
REOPER.txt,726828,728826,1998,20,N,N,-,-1,-1
REOPER.txt,727568,730155,2587,20,Y,N,-,-1,-1
REOPER.txt,728092,730680,2588,20,Y,N,-,-1,-1
REOPER.txt,728382,731206,2824,20,Y,N,-,-1,-1
REOPER.txt,728827,731725,2898,20,Y,N,-,-1,-1
REOPER.txt,730155,732336,2181,20,Y,N,-,-1,-1
REOPER.txt,730681,732913,2232,20,N,N,-,-1,-1
REOPER.txt,731207,733644,2437,20,N,N,-,-1,-1
REOPER.txt,731726,734595,2869,20,N,N,-,-1,-1
REOPER.txt,732338,735361,3023,20,N,N,-,-1,-1
REOPER.txt,732913,736339,3426,20,Y,N,-,-1,-1
REOPER.txt,733644,737250,3606,20,Y,N,-,-1,-1
REOPER.txt,734596,737816,3220,20,Y,N,-,-1,-1
REOPER.txt,735366,739153,3787,20,Y,N,-,-1,-1
REOPER.txt,736340,739499,3159,20,Y,N,-,-1,-1
REOPER.txt,737251,740298,3047,20,Y,N,-,-1,-1
REOPER.txt,737817,741016,3199,20,Y,N,-,-1,-1
REOPER.txt,739154,742027,2873,20,Y,N,-,-1,-1
REOPER.txt,739500,743082,3582,20,Y,N,-,-1,-1
REOPER.txt,740299,743900,3601,20,Y,N,-,-1,-1
REOPER.txt,741017,744808,3791,20,Y,N,-,-1,-1
REOPER.txt,742028,745408,3380,20,Y,N,-,-1,-1
REOPER.txt,743085,746100,3015,20,N,N,-,-1,-1
REOPER.txt,743901,746551,2650,20,Y,N,-,-1,-1
REOPER.txt,744809,747162,2353,20,N,N,-,-1,-1
REOPER.txt,745409,747595,2186,20,Y,N,-,-1,-1
REOPER.txt,746101,748618,2517,20,Y,N,-,-1,-1
REOPER.txt,746552,749265,2713,20,Y,N,-,-1,-1
REOPER.txt,747163,750375,3212,20,Y,N,-,-1,-1
REOPER.txt,747597,751344,3747,20,Y,N,-,-1,-1
REOPER.txt,748619,752232,3613,20,Y,N,-,-1,-1
REOPER.txt,749267,753008,3741,20,Y,N,-,-1,-1
REOPER.txt,750378,753966,3588,20,Y,N,-,-1,-1
REOPER.txt,751345,754887,3542,20,Y,N,-,-1,-1
REOPER.txt,752235,755632,3397,20,Y,N,-,-1,-1
REOPER.txt,753009,756151,3142,20,Y,N,-,-1,-1
REOPER.txt,753967,756880,2913,20,Y,N,-,-1,-1
REOPER.txt,754888,757392,2504,20,Y,N,-,-1,-1
REOPER.txt,755633,757781,2148,20,Y,N,-,-1,-1
REOPER.txt,756152,758910,2758,20,Y,N,-,-1,-1
REOPER.txt,756881,759330,2449,20,Y,N,-,-1,-1
REOPER.txt,757393,760135,2742,20,Y,N,-,-1,-1
REOPER.txt,757782,761007,3225,20,Y,N,-,-1,-1
REOPER.txt,758911,761603,2692,20,Y,N,-,-1,-1
REOPER.txt,759332,762774,3442,20,Y,N,-,-1,-1
REOPER.txt,760136,763276,3140,20,Y,N,-,-1,-1
REOPER.txt,761010,764319,3309,20,Y,N,-,-1,-1
REOPER.txt,761604,765169,3565,20,Y,N,-,-1,-1
REOPER.txt,762775,765822,3047,20,Y,N,-,-1,-1
REOPER.txt,763277,766505,3228,20,Y,N,-,-1,-1
REOPER.txt,764320,767116,2796,20,Y,N,-,-1,-1
REOPER.txt,765170,767915,2745,20,Y,N,-,-1,-1
REOPER.txt,765823,768454,2631,20,Y,N,-,-1,-1
REOPER.txt,766506,769827,3321,20,Y,N,-,-1,-1
REOPER.txt,767117,770343,3226,20,Y,N,-,-1,-1
REOPER.txt,767917,770674,2757,20,Y,N,-,-1,-1
REOPER.txt,768455,771366,2911,20,Y,N,-,-1,-1
REOPER.txt,769828,771987,2159,20,Y,N,-,-1,-1
REOPER.txt,770344,772608,2264,20,Y,N,-,-1,-1
REOPER.txt,770674,773224,2550,20,Y,N,-,-1,-1
REOPER.txt,771367,773851,2484,20,Y,N,-,-1,-1
REOPER.txt,771988,774636,2648,20,Y,N,-,-1,-1
REOPER.txt,772609,775920,3311,20,Y,N,-,-1,-1
REOPER.txt,773225,776667,3442,20,Y,N,-,-1,-1
REOPER.txt,773853,777367,3514,20,Y,N,-,-1,-1
REOPER.txt,774637,777972,3335,20,Y,N,-,-1,-1
REOPER.txt,775921,778664,2743,20,Y,N,-,-1,-1
REOPER.txt,776668,779213,2545,20,Y,N,-,-1,-1
REOPER.txt,777368,779441,2073,20,Y,N,-,-1,-1
REOPER.txt,777973,779961,1988,20,Y,N,-,-1,-1
REOPER.txt,778665,780553,1888,20,Y,N,-,-1,-1
REOPER.txt,779214,781369,2155,20,Y,N,-,-1,-1
REOPER.txt,779442,781918,2476,20,Y,N,-,-1,-1
REOPER.txt,779962,782687,2725,20,Y,N,-,-1,-1
REOPER.txt,780554,783475,2921,20,Y,N,-,-1,-1
REOPER.txt,781370,784204,2834,20,Y,N,-,-1,-1
REOPER.txt,781919,784954,3035,20,Y,N,-,-1,-1
REOPER.txt,782688,785357,2669,20,Y,N,-,-1,-1
REOPER.txt,783478,785485,2007,20,Y,N,-,-1,-1
REOPER.txt,784205,785620,1415,20,Y,N,-,-1,-1
REOPER.txt,784955,786553,1598,20,Y,N,-,-1,-1
REOPER.txt,785358,787408,2050,20,Y,N,-,-1,-1
REOPER.txt,785486,788266,2780,20,Y,N,-,-1,-1
REOPER.txt,785622,789480,3858,20,Y,N,-,-1,-1
REOPER.txt,786554,790443,3889,20,Y,N,-,-1,-1
REOPER.txt,787409,791390,3981,20,Y,N,-,-1,-1
REOPER.txt,788269,792020,3751,20,Y,N,-,-1,-1
REOPER.txt,789483,792658,3175,20,Y,N,-,-1,-1
REOPER.txt,790446,793628,3182,20,Y,N,-,-1,-1
REOPER.txt,791393,794206,2813,20,Y,N,-,-1,-1
REOPER.txt,792023,794523,2500,20,Y,N,-,-1,-1
REOPER.txt,792660,795319,2659,20,Y,N,-,-1,-1
REOPER.txt,793629,795933,2304,20,Y,N,-,-1,-1
REOPER.txt,794207,796969,2762,20,Y,N,-,-1,-1
REOPER.txt,794524,797558,3034,20,Y,N,-,-1,-1
REOPER.txt,795322,798402,3080,20,Y,N,-,-1,-1
REOPER.txt,795934,799864,3930,20,Y,N,-,-1,-1
REOPER.txt,796969,800838,3869,20,Y,N,-,-1,-1
REOPER.txt,797563,801488,3925,20,N,N,-,-1,-1
REOPER.txt,798405,802389,3984,20,Y,N,-,-1,-1
REOPER.txt,799865,802879,3014,20,Y,N,-,-1,-1
REOPER.txt,800839,803782,2943,20,Y,N,-,-1,-1
REOPER.txt,801489,804259,2770,20,Y,N,-,-1,-1
REOPER.txt,802390,804816,2426,20,Y,N,-,-1,-1
REOPER.txt,802880,805431,2551,20,Y,N,-,-1,-1
REOPER.txt,803783,806010,2227,20,Y,N,-,-1,-1
REOPER.txt,804260,806838,2578,20,Y,N,-,-1,-1
REOPER.txt,804817,807511,2694,20,Y,N,-,-1,-1
REOPER.txt,805432,808092,2660,20,Y,N,-,-1,-1
REOPER.txt,806011,808419,2408,20,Y,N,-,-1,-1
REOPER.txt,806839,809267,2428,20,Y,N,-,-1,-1
REOPER.txt,807512,810169,2657,20,Y,N,-,-1,-1
REOPER.txt,808093,811006,2913,20,Y,N,-,-1,-1
REOPER.txt,808420,812054,3634,20,Y,N,-,-1,-1
REOPER.txt,809268,812762,3494,20,Y,N,-,-1,-1
REOPER.txt,810170,813338,3168,20,Y,N,-,-1,-1
REOPER.txt,811007,814029,3022,20,Y,N,-,-1,-1
REOPER.txt,812055,814587,2532,20,Y,N,-,-1,-1
REOPER.txt,812763,815677,2914,20,Y,N,-,-1,-1
REOPER.txt,813339,816201,2862,20,Y,N,-,-1,-1
REOPER.txt,814030,816971,2941,20,Y,N,-,-1,-1
REOPER.txt,814588,817831,3243,20,Y,N,-,-1,-1
REOPER.txt,815678,818236,2558,20,Y,N,-,-1,-1
REOPER.txt,816201,819325,3124,20,Y,N,-,-1,-1
REOPER.txt,816972,820196,3224,20,Y,N,-,-1,-1
REOPER.txt,817836,820695,2859,20,Y,N,-,-1,-1
REOPER.txt,818239,821426,3187,20,N,N,-,-1,-1
REOPER.txt,819326,821950,2624,20,N,N,-,-1,-1
REOPER.txt,820199,823080,2881,20,N,N,-,-1,-1
REOPER.txt,820696,823561,2865,20,N,N,-,-1,-1
REOPER.txt,821429,823962,2533,20,Y,N,-,-1,-1
REOPER.txt,821950,825692,3742,20,Y,N,-,-1,-1
REOPER.txt,823081,827256,4175,20,Y,N,-,-1,-1
REOPER.txt,823562,827582,4020,20,Y,N,-,-1,-1
THIRTY.txt,1,5988,5987,20,Y,N,-,-1,-1
THIRTY.txt,1000,7085,6085,20,Y,N,-,-1,-1
THIRTY.txt,2896,8155,5259,20,Y,N,-,-1,-1
THIRTY.txt,4269,9748,5479,20,Y,N,-,-1,-1
THIRTY.txt,5989,10867,4878,20,Y,N,-,-1,-1
THIRTY.txt,7086,12059,4973,20,Y,N,-,-1,-1
THIRTY.txt,8156,13405,5249,20,Y,N,-,-1,-1
THIRTY.txt,9749,13850,4101,20,Y,N,-,-1,-1
THIRTY.txt,10868,14866,3998,20,Y,N,-,-1,-1
THIRTY.txt,12062,15854,3792,20,Y,N,-,-1,-1
THIRTY.txt,13408,16620,3212,20,Y,N,-,-1,-1
THIRTY.txt,13851,17521,3670,20,Y,Y,1438157398793,16921,17950
THIRTY.txt,14867,18320,3453,20,Y,Y,1438157398793,16921,17950
THIRTY.txt,15857,19029,3172,20,Y,Y,1438157398793,16921,17950
THIRTY.txt,16621,20395,3774,20,Y,Y,1438157398793,16921,17950
THIRTY.txt,17522,21139,3617,20,Y,Y,1438157398793,16921,17950
THIRTY.txt,18321,22054,3733,20,Y,Y,1438159538620,18153,19649
THIRTY.txt,19030,22737,3707,20,Y,Y,1438159538620,18153,19649
THIRTY.txt,20396,23745,3349,20,Y,N,-,-1,-1
THIRTY.txt,21139,24401,3262,20,Y,N,-,-1,-1
THIRTY.txt,22057,25360,3303,20,Y,N,-,-1,-1
THIRTY.txt,22738,25780,3042,20,Y,N,-,-1,-1
THIRTY.txt,23746,26264,2518,20,Y,N,-,-1,-1
THIRTY.txt,24404,26874,2470,20,Y,N,-,-1,-1
THIRTY.txt,25362,27743,2381,20,Y,N,-,-1,-1
THIRTY.txt,25781,28446,2665,20,Y,N,-,-1,-1
THIRTY.txt,26265,29371,3106,20,Y,Y,1438160199087,28565,29351
THIRTY.txt,26875,30026,3151,20,Y,Y,1438160199087,28565,29351
THIRTY.txt,27745,31031,3286,20,Y,Y,1438160199087,28565,29351
THIRTY.txt,28448,32129,3681,20,Y,Y,1438161785448,31562,32150
THIRTY.txt,29374,32801,3427,20,Y,Y,1438161785448,31562,32150
THIRTY.txt,30027,33359,3332,20,Y,Y,1438161785448,31562,32150
THIRTY.txt,31032,33867,2835,20,Y,Y,1438161785448,31562,32150
THIRTY.txt,32130,34610,2480,20,Y,Y,1438161785448,31562,32150
THIRTY.txt,32802,35407,2605,20,Y,Y,1438162296864,32161,34110
THIRTY.txt,33360,36194,2834,20,Y,Y,1438162296864,32161,34110
THIRTY.txt,33870,37641,3771,20,Y,Y,1438162296864,32161,34110
THIRTY.txt,34611,38481,3870,20,Y,N,-,-1,-1
THIRTY.txt,35408,39188,3780,20,Y,N,-,-1,-1
THIRTY.txt,36196,39911,3715,20,Y,N,-,-1,-1
THIRTY.txt,37642,40860,3218,20,Y,Y,1438162931556,40152,41509
THIRTY.txt,38482,41514,3032,20,Y,Y,1438162931556,40152,41509
THIRTY.txt,39189,42550,3361,20,Y,Y,1438163419525,41973,43188
THIRTY.txt,39912,43208,3296,20,Y,Y,1438163419525,41973,43188
THIRTY.txt,40861,43788,2927,20,Y,Y,1438163419525,41973,43188
THIRTY.txt,41517,44325,2808,20,Y,Y,1438163419525,41973,43188
THIRTY.txt,42551,44894,2343,20,Y,Y,1438163419525,41973,43188
THIRTY.txt,43211,46154,2943,20,Y,Y,1438165222216,44881,46194
THIRTY.txt,43789,46762,2973,20,Y,Y,1438165222216,44881,46194
THIRTY.txt,44326,47529,3203,20,Y,Y,1438165222216,44881,46194
THIRTY.txt,44895,48225,3330,20,Y,Y,1438165222216,44881,46194
THIRTY.txt,46155,48673,2518,20,Y,Y,1438165222216,44881,46194
THIRTY.txt,46763,49400,2637,20,Y,N,-,-1,-1
THIRTY.txt,47532,49786,2254,20,Y,N,-,-1,-1
THIRTY.txt,48226,50342,2116,20,Y,N,-,-1,-1
THIRTY.txt,48676,51179,2503,20,Y,N,-,-1,-1
THIRTY.txt,49401,52233,2832,20,Y,N,-,-1,-1
THIRTY.txt,49787,53435,3648,20,Y,N,-,-1,-1
THIRTY.txt,50345,54098,3753,20,Y,N,-,-1,-1
THIRTY.txt,51180,54911,3731,20,Y,N,-,-1,-1
THIRTY.txt,52236,55498,3262,20,Y,Y,1438165920566,55062,56456
THIRTY.txt,53436,56226,2790,20,Y,Y,1438165920566,55062,56456
THIRTY.txt,54099,56718,2619,20,Y,Y,1438165920566,55062,56456
THIRTY.txt,54912,57609,2697,20,Y,Y,1438165920566,55062,56456
THIRTY.txt,55503,58100,2597,20,Y,Y,1438165920566,55062,56456
THIRTY.txt,56227,59083,2856,20,Y,Y,1438165920566,55062,56456
THIRTY.txt,56719,59593,2874,20,Y,Y,1438166902193,59219,61464
THIRTY.txt,57610,60568,2958,20,Y,Y,1438166902193,59219,61464
THIRTY.txt,58101,61482,3381,20,Y,Y,1438166902193,59219,61464
THIRTY.txt,59086,62434,3348,20,Y,Y,1438166902193,59219,61464
THIRTY.txt,59594,63346,3752,20,Y,Y,1438166902193,59219,61464
THIRTY.txt,60571,64211,3640,20,Y,Y,1438166902193,59219,61464
THIRTY.txt,61483,64964,3481,20,Y,Y,1438167435224,61729,62292
THIRTY.txt,62435,65407,2972,20,Y,N,-,-1,-1
THIRTY.txt,63348,66297,2949,20,Y,N,-,-1,-1
THIRTY.txt,64212,66967,2755,20,Y,N,-,-1,-1
THIRTY.txt,64965,68084,3119,20,Y,N,-,-1,-1
THIRTY.txt,65410,68588,3178,20,Y,N,-,-1,-1
THIRTY.txt,66298,69204,2906,20,Y,N,-,-1,-1
THIRTY.txt,66968,69833,2865,20,Y,N,-,-1,-1
THIRTY.txt,68085,70933,2848,20,Y,N,-,-1,-1
THIRTY.txt,68589,72054,3465,20,Y,N,-,-1,-1
THIRTY.txt,69205,73102,3897,20,Y,N,-,-1,-1
THIRTY.txt,69834,74218,4384,20,Y,N,-,-1,-1
THIRTY.txt,70936,75056,4120,20,Y,Y,1438169169141,74247,75379
THIRTY.txt,72055,76134,4079,20,Y,Y,1438169169141,74247,75379
THIRTY.txt,73103,77214,4111,20,Y,Y,1438169169141,74247,75379
THIRTY.txt,74221,78072,3851,20,Y,Y,1438169169141,74247,75379
THIRTY.txt,75057,78743,3686,20,Y,Y,1438169169141,74247,75379
THIRTY.txt,76135,79214,3079,20,Y,N,-,-1,-1
THIRTY.txt,77215,79861,2646,20,Y,N,-,-1,-1
THIRTY.txt,78073,80929,2856,20,Y,N,-,-1,-1
THIRTY.txt,78744,81249,2505,20,Y,N,-,-1,-1
THIRTY.txt,79215,81810,2595,20,Y,N,-,-1,-1
THIRTY.txt,79863,82267,2404,20,Y,N,-,-1,-1
THIRTY.txt,80930,83244,2314,20,Y,Y,1438170164484,82295,83217
THIRTY.txt,81252,84094,2842,20,Y,Y,1438170164484,82295,83217
THIRTY.txt,81812,84938,3126,20,Y,Y,1438170164484,82295,83217
THIRTY.txt,82272,86001,3729,20,Y,Y,1438170164484,82295,83217
THIRTY.txt,83247,87332,4085,20,Y,N,-,-1,-1
THIRTY.txt,84095,88114,4019,20,Y,N,-,-1,-1
THIRTY.txt,84939,88938,3999,20,Y,N,-,-1,-1
THIRTY.txt,86002,89472,3470,20,Y,N,-,-1,-1
THIRTY.txt,87333,90084,2751,20,Y,N,-,-1,-1
THIRTY.txt,88117,90459,2342,20,Y,N,-,-1,-1
THIRTY.txt,88940,90849,1909,20,Y,N,-,-1,-1
THIRTY.txt,89473,91490,2017,20,Y,N,-,-1,-1
THIRTY.txt,90085,92165,2080,20,Y,N,-,-1,-1
THIRTY.txt,90461,92903,2442,20,Y,Y,1438189723317,92178,95121
THIRTY.txt,90852,93681,2829,20,Y,Y,1438189723317,92178,95121
THIRTY.txt,91491,94237,2746,20,Y,Y,1438189723317,92178,95121
THIRTY.txt,92168,95011,2843,20,Y,Y,1438189723317,92178,95121
THIRTY.txt,92906,95593,2687,20,Y,Y,1438189723317,92178,95121
THIRTY.txt,93682,95980,2298,20,Y,Y,1438189723317,92178,95121
THIRTY.txt,94238,96734,2496,20,Y,Y,1438189723317,92178,95121
THIRTY.txt,95012,97301,2289,20,Y,Y,1438189723317,92178,95121
THIRTY.txt,95594,97925,2331,20,Y,N,-,-1,-1
THIRTY.txt,95981,98999,3018,20,Y,N,-,-1,-1
THIRTY.txt,96737,99728,2991,20,Y,N,-,-1,-1
THIRTY.txt,97302,100579,3277,20,Y,N,-,-1,-1
THIRTY.txt,97927,101395,3468,20,Y,N,-,-1,-1
THIRTY.txt,99002,101931,2929,20,Y,N,-,-1,-1
THIRTY.txt,99730,102435,2705,20,Y,Y,1438190510320,101962,103008
THIRTY.txt,100580,103249,2669,20,Y,Y,1438190510320,101962,103008
THIRTY.txt,101395,104082,2687,20,Y,Y,1438190510320,101962,103008
THIRTY.txt,101934,104863,2929,20,Y,Y,1438190510320,101962,103008
THIRTY.txt,102436,105330,2894,20,Y,Y,1438190510320,101962,103008
THIRTY.txt,103252,106231,2979,20,Y,Y,1438191374996,103260,104214
THIRTY.txt,104083,107095,3012,20,Y,Y,1438191374996,103260,104214
THIRTY.txt,104864,107881,3017,20,Y,Y,1438246777986,107205,109556
THIRTY.txt,105333,108630,3297,20,Y,Y,1438246777986,107205,109556
THIRTY.txt,106232,109560,3328,20,Y,Y,1438246777986,107205,109556
THIRTY.txt,107096,110302,3206,20,Y,Y,1438246777986,107205,109556
THIRTY.txt,107882,111694,3812,20,Y,Y,1438246777986,107205,109556
THIRTY.txt,108631,112600,3969,20,Y,Y,1438246777986,107205,109556
THIRTY.txt,109563,113594,4031,20,Y,N,-,-1,-1
THIRTY.txt,110303,114197,3894,20,Y,N,-,-1,-1
THIRTY.txt,111695,114800,3105,20,Y,N,-,-1,-1
THIRTY.txt,112601,115082,2481,20,Y,N,-,-1,-1
THIRTY.txt,113595,115834,2239,20,Y,Y,1438247270881,115104,115832
THIRTY.txt,114198,116656,2458,20,Y,Y,1438247270881,115104,115832
THIRTY.txt,114801,117474,2673,20,Y,Y,1438247270881,115104,115832
THIRTY.txt,115085,118316,3231,20,Y,Y,1438247270881,115104,115832
THIRTY.txt,115837,119037,3200,20,Y,Y,1438247916111,118197,118881
THIRTY.txt,116657,119843,3186,20,Y,Y,1438247916111,118197,118881
THIRTY.txt,117475,120578,3103,20,Y,Y,1438247916111,118197,118881
THIRTY.txt,118317,121095,2778,20,Y,Y,1438247916111,118197,118881
THIRTY.txt,119040,121869,2829,20,Y,Y,1438248640511,119038,120318
THIRTY.txt,119844,123134,3290,20,Y,Y,1438248640511,119038,120318
THIRTY.txt,120579,123972,3393,20,Y,Y,1438249161833,123571,124012
THIRTY.txt,121096,124563,3467,20,Y,Y,1438249161833,123571,124012
THIRTY.txt,121870,125406,3536,20,Y,Y,1438249161833,123571,124012
THIRTY.txt,123135,126775,3640,20,Y,Y,1438249161833,123571,124012
THIRTY.txt,123973,127577,3604,20,Y,Y,1438249161833,123571,124012
THIRTY.txt,124564,128344,3780,20,Y,N,-,-1,-1
THIRTY.txt,125409,129021,3612,20,Y,N,-,-1,-1
THIRTY.txt,126778,130034,3256,20,Y,N,-,-1,-1
THIRTY.txt,127580,130705,3125,20,Y,N,-,-1,-1
THIRTY.txt,128347,131582,3235,20,Y,N,-,-1,-1
THIRTY.txt,129023,132080,3057,20,Y,N,-,-1,-1
THIRTY.txt,130035,132927,2892,20,Y,N,-,-1,-1
THIRTY.txt,130706,133975,3269,20,Y,N,-,-1,-1
THIRTY.txt,131585,135091,3506,20,Y,N,-,-1,-1
THIRTY.txt,132081,135648,3567,20,Y,N,-,-1,-1
THIRTY.txt,132928,136023,3095,20,Y,N,-,-1,-1
THIRTY.txt,133976,136192,2216,20,Y,N,-,-1,-1
THIRTY.txt,135092,136279,1187,20,N,N,-,-1,-1
THIRTY.txt,135649,136498,849,20,N,N,-,-1,-1
THIRTY.txt,136025,136525,500,20,N,N,-,-1,-1
THIRTY.txt,136193,136581,388,20,N,N,-,-1,-1
THIRTY.txt,136284,136622,338,20,N,N,-,-1,-1
THIRTY.txt,136501,136676,175,20,N,N,-,-1,-1
THIRTY.txt,136525,136785,260,20,N,N,-,-1,-1
THIRTY.txt,136581,136850,269,20,N,N,-,-1,-1
THIRTY.txt,136627,136945,318,20,N,N,-,-1,-1
THIRTY.txt,136677,137005,328,20,N,N,-,-1,-1
THIRTY.txt,136787,137092,305,20,N,N,-,-1,-1
THIRTY.txt,136852,138283,1431,20,N,N,-,-1,-1
THIRTY.txt,136950,139191,2241,20,Y,N,-,-1,-1
THIRTY.txt,137005,139671,2666,20,Y,N,-,-1,-1
THIRTY.txt,137092,140293,3201,20,Y,N,-,-1,-1
THIRTY.txt,138284,141023,2739,20,Y,N,-,-1,-1
THIRTY.txt,139192,141950,2758,20,Y,N,-,-1,-1
THIRTY.txt,139674,142856,3182,20,Y,N,-,-1,-1
THIRTY.txt,140294,143630,3336,20,Y,N,-,-1,-1
THIRTY.txt,141023,144557,3534,20,Y,N,-,-1,-1
THIRTY.txt,141953,145592,3639,20,Y,N,-,-1,-1
THIRTY.txt,142857,146066,3209,20,Y,Y,1438250592994,145798,147831
THIRTY.txt,143630,146744,3114,20,Y,Y,1438250592994,145798,147831
THIRTY.txt,144558,147851,3293,20,Y,Y,1438250592994,145798,147831
THIRTY.txt,145593,149301,3708,20,Y,Y,1438250592994,145798,147831
THIRTY.txt,146069,150517,4448,20,Y,Y,1438250592994,145798,147831
THIRTY.txt,146745,151050,4305,20,Y,Y,1438250592994,145798,147831
THIRTY.txt,147854,151946,4092,20,Y,Y,1438251442654,151139,153995
THIRTY.txt,149304,152906,3602,20,Y,Y,1438251442654,151139,153995
THIRTY.txt,150518,153507,2989,20,Y,Y,1438251442654,151139,153995
THIRTY.txt,151053,154244,3191,20,Y,Y,1438251442654,151139,153995
THIRTY.txt,151947,154872,2925,20,Y,Y,1438251999106,154831,155580
THIRTY.txt,152907,155821,2914,20,Y,Y,1438251999106,154831,155580
THIRTY.txt,153510,156831,3321,20,Y,Y,1438251999106,154831,155580
THIRTY.txt,154247,157395,3148,20,Y,Y,1438251999106,154831,155580
THIRTY.txt,154873,158187,3314,20,Y,Y,1438251999106,154831,155580
THIRTY.txt,155822,159078,3256,20,Y,N,-,-1,-1
THIRTY.txt,156834,159858,3024,20,Y,N,-,-1,-1
THIRTY.txt,157396,160863,3467,20,Y,N,-,-1,-1
THIRTY.txt,158188,161631,3443,20,Y,N,-,-1,-1
THIRTY.txt,159079,162153,3074,20,Y,N,-,-1,-1
THIRTY.txt,159859,163021,3162,20,Y,N,-,-1,-1
THIRTY.txt,160864,163696,2832,20,Y,N,-,-1,-1
THIRTY.txt,161632,164021,2389,20,Y,N,-,-1,-1
THIRTY.txt,162154,164603,2449,20,Y,N,-,-1,-1
THIRTY.txt,163022,165494,2472,20,Y,N,-,-1,-1
THIRTY.txt,163697,166232,2535,20,Y,N,-,-1,-1
THIRTY.txt,164022,166809,2787,20,Y,Y,1438252600776,166233,167088
THIRTY.txt,164604,167262,2658,20,Y,Y,1438252600776,166233,167088
THIRTY.txt,165497,168327,2830,20,Y,Y,1438252600776,166233,167088
THIRTY.txt,166235,169036,2801,20,Y,Y,1438252600776,166233,167088
THIRTY.txt,166810,169876,3066,20,Y,Y,1438252600776,166233,167088
THIRTY.txt,167263,171011,3748,20,Y,N,-,-1,-1
THIRTY.txt,168328,171921,3593,20,Y,N,-,-1,-1
THIRTY.txt,169036,172927,3891,20,Y,Y,1438253344818,172096,173864
THIRTY.txt,169877,173650,3773,20,Y,Y,1438253344818,172096,173864
THIRTY.txt,171012,174234,3222,20,Y,Y,1438253344818,172096,173864
THIRTY.txt,171922,174583,2661,20,Y,Y,1438253344818,172096,173864
THIRTY.txt,172928,175205,2277,20,Y,Y,1438253717853,174584,175030
THIRTY.txt,173651,176134,2483,20,Y,Y,1438253717853,174584,175030
THIRTY.txt,174235,177025,2790,20,Y,Y,1438253717853,174584,175030
THIRTY.txt,174586,177759,3173,20,Y,Y,1438253717853,174584,175030
THIRTY.txt,175208,178843,3635,20,Y,Y,1438260340275,178702,179144
THIRTY.txt,176137,179472,3335,20,Y,Y,1438260340275,178702,179144
THIRTY.txt,177026,180682,3656,20,Y,Y,1438260662836,180296,180671
THIRTY.txt,177761,181446,3685,20,Y,Y,1438260662836,180296,180671
THIRTY.txt,178844,182419,3575,20,Y,Y,1438260662836,180296,180671
THIRTY.txt,179474,183782,4308,20,Y,Y,1438260662836,180296,180671
THIRTY.txt,180683,184502,3819,20,Y,Y,1438261222496,182454,183438
THIRTY.txt,181447,185071,3624,20,Y,Y,1438261222496,182454,183438
THIRTY.txt,182420,185528,3108,20,Y,Y,1438261222496,182454,183438
THIRTY.txt,183785,186162,2377,20,Y,N,-,-1,-1
THIRTY.txt,184503,186590,2087,20,Y,N,-,-1,-1
THIRTY.txt,185072,187162,2090,20,Y,N,-,-1,-1
THIRTY.txt,185529,187674,2145,20,Y,N,-,-1,-1
THIRTY.txt,186163,188648,2485,20,Y,N,-,-1,-1
THIRTY.txt,186591,189291,2700,20,Y,N,-,-1,-1
THIRTY.txt,187163,189675,2512,20,Y,N,-,-1,-1
THIRTY.txt,187674,190263,2589,20,Y,N,-,-1,-1
THIRTY.txt,188649,190754,2105,20,Y,N,-,-1,-1
THIRTY.txt,189292,191221,1929,20,Y,N,-,-1,-1
THIRTY.txt,189677,191774,2097,20,Y,N,-,-1,-1
THIRTY.txt,190264,192226,1962,20,Y,N,-,-1,-1
THIRTY.txt,190755,192699,1944,20,Y,N,-,-1,-1
THIRTY.txt,191222,193471,2249,20,Y,N,-,-1,-1
THIRTY.txt,191775,193945,2170,20,Y,N,-,-1,-1
THIRTY.txt,192227,194694,2467,20,Y,N,-,-1,-1
THIRTY.txt,192700,195109,2409,20,Y,N,-,-1,-1
THIRTY.txt,193472,195561,2089,20,Y,N,-,-1,-1
THIRTY.txt,193946,196230,2284,20,Y,N,-,-1,-1
THIRTY.txt,194695,196697,2002,20,Y,N,-,-1,-1
THIRTY.txt,195110,197380,2270,20,Y,N,-,-1,-1
THIRTY.txt,195561,197986,2425,20,Y,N,-,-1,-1
THIRTY.txt,196231,198950,2719,20,Y,N,-,-1,-1
THIRTY.txt,196697,200233,3536,20,Y,N,-,-1,-1
THIRTY.txt,197381,200701,3320,20,Y,N,-,-1,-1
THIRTY.txt,197987,201355,3368,20,Y,N,-,-1,-1
THIRTY.txt,198951,202059,3108,20,Y,N,-,-1,-1
THIRTY.txt,200234,202806,2572,20,Y,Y,1438261922656,202060,202369
THIRTY.txt,200702,203362,2660,20,Y,Y,1438261922656,202060,202369
THIRTY.txt,201357,204054,2697,20,Y,Y,1438261922656,202060,202369
THIRTY.txt,202062,204583,2521,20,Y,Y,1438261922656,202060,202369
THIRTY.txt,202808,205057,2249,20,Y,Y,1438262221763,203293,203654
THIRTY.txt,203363,205684,2321,20,Y,Y,1438262221763,203293,203654
THIRTY.txt,204056,206549,2493,20,Y,N,-,-1,-1
THIRTY.txt,204586,207223,2637,20,Y,N,-,-1,-1
THIRTY.txt,205060,208075,3015,20,Y,N,-,-1,-1
THIRTY.txt,205685,209113,3428,20,Y,N,-,-1,-1
THIRTY.txt,206552,210135,3583,20,Y,Y,1438262649189,209904,210317
THIRTY.txt,207224,211074,3850,20,Y,Y,1438262649189,209904,210317
THIRTY.txt,208076,211837,3761,20,Y,Y,1438262649189,209904,210317
THIRTY.txt,209114,212562,3448,20,Y,Y,1438263571731,212203,213237
THIRTY.txt,210136,213491,3355,20,Y,Y,1438263571731,212203,213237
THIRTY.txt,211076,214290,3214,20,Y,Y,1438263571731,212203,213237
THIRTY.txt,211840,214841,3001,20,Y,Y,1438263571731,212203,213237
THIRTY.txt,212563,215500,2937,20,Y,Y,1438263571731,212203,213237
THIRTY.txt,213492,216110,2618,20,Y,Y,1438264301777,214763,216915
THIRTY.txt,214291,217072,2781,20,Y,Y,1438264301777,214763,216915
THIRTY.txt,214842,218099,3257,20,Y,Y,1438264301777,214763,216915
THIRTY.txt,215501,218974,3473,20,Y,Y,1438264301777,214763,216915
THIRTY.txt,216111,219744,3633,20,Y,Y,1438264301777,214763,216915
THIRTY.txt,217073,220564,3491,20,Y,Y,1438265344157,220057,220486
THIRTY.txt,218100,221511,3411,20,Y,Y,1438265344157,220057,220486
THIRTY.txt,218977,222116,3139,20,Y,Y,1438265344157,220057,220486
THIRTY.txt,219745,222994,3249,20,Y,Y,1438265344157,220057,220486
THIRTY.txt,220565,223749,3184,20,Y,N,-,-1,-1
THIRTY.txt,221514,224636,3122,20,Y,N,-,-1,-1
THIRTY.txt,222119,225160,3041,20,Y,N,-,-1,-1
THIRTY.txt,222995,225932,2937,20,Y,N,-,-1,-1
THIRTY.txt,223750,226781,3031,20,N,N,-,-1,-1
THIRTY.txt,224639,227769,3130,20,Y,N,-,-1,-1
THIRTY.txt,225160,228582,3422,20,Y,Y,1438266059280,228002,229500
THIRTY.txt,225933,229501,3568,20,Y,Y,1438266059280,228002,229500
THIRTY.txt,226783,230242,3459,20,Y,Y,1438266059280,228002,229500
THIRTY.txt,227771,230711,2940,20,Y,Y,1438266059280,228002,229500
THIRTY.txt,228583,231261,2678,20,Y,Y,1438266059280,228002,229500
THIRTY.txt,229504,231581,2077,20,Y,N,-,-1,-1
THIRTY.txt,230247,232206,1959,20,Y,N,-,-1,-1
THIRTY.txt,230712,232819,2107,20,N,N,-,-1,-1
THIRTY.txt,231262,233666,2404,20,N,N,-,-1,-1
THIRTY.txt,231584,234286,2702,20,Y,N,-,-1,-1
THIRTY.txt,232207,234634,2427,20,Y,N,-,-1,-1
THIRTY.txt,232820,235830,3010,20,Y,N,-,-1,-1
THIRTY.txt,233667,236603,2936,20,Y,N,-,-1,-1
THIRTY.txt,234287,237062,2775,20,Y,N,-,-1,-1
THIRTY.txt,234635,237879,3244,20,Y,N,-,-1,-1
THIRTY.txt,235831,238632,2801,20,Y,N,-,-1,-1
THIRTY.txt,236604,239317,2713,20,Y,N,-,-1,-1
THIRTY.txt,237062,239760,2698,20,Y,N,-,-1,-1
THIRTY.txt,237880,240365,2485,20,Y,N,-,-1,-1
THIRTY.txt,238633,240992,2359,20,Y,N,-,-1,-1
THIRTY.txt,239320,241865,2545,20,Y,N,-,-1,-1
THIRTY.txt,239761,242327,2566,20,Y,N,-,-1,-1
THIRTY.txt,240366,242652,2286,20,Y,N,-,-1,-1
THIRTY.txt,240993,243284,2291,20,Y,N,-,-1,-1
THIRTY.txt,241866,244302,2436,20,Y,N,-,-1,-1
THIRTY.txt,242328,245222,2894,20,Y,N,-,-1,-1
THIRTY.txt,242653,245863,3210,20,Y,N,-,-1,-1
THIRTY.txt,243285,246497,3212,20,Y,N,-,-1,-1
THIRTY.txt,244303,247047,2744,20,Y,N,-,-1,-1
THIRTY.txt,245223,247744,2521,20,Y,N,-,-1,-1
THIRTY.txt,245864,248265,2401,20,Y,N,-,-1,-1
THIRTY.txt,246500,248779,2279,20,Y,N,-,-1,-1
THIRTY.txt,247050,249258,2208,20,Y,N,-,-1,-1
THIRTY.txt,247747,249725,1978,20,Y,N,-,-1,-1
THIRTY.txt,248266,250102,1836,20,Y,N,-,-1,-1
THIRTY.txt,248780,250901,2121,20,Y,N,-,-1,-1
THIRTY.txt,249259,251653,2394,20,Y,Y,1438423300058,250954,251876
THIRTY.txt,249726,252274,2548,20,Y,Y,1438423300058,250954,251876
THIRTY.txt,250104,252968,2864,20,Y,Y,1438423300058,250954,251876
THIRTY.txt,250904,253923,3019,20,Y,Y,1438423300058,250954,251876
THIRTY.txt,251654,254961,3307,20,Y,Y,1438423300058,250954,251876
THIRTY.txt,252275,255914,3639,20,Y,N,-,-1,-1
THIRTY.txt,252969,256760,3791,20,Y,N,-,-1,-1
THIRTY.txt,253924,257467,3543,20,Y,Y,1438423663362,256945,257426
THIRTY.txt,254962,258558,3596,20,Y,Y,1438423663362,256945,257426
THIRTY.txt,255915,259296,3381,20,Y,Y,1438423663362,256945,257426
THIRTY.txt,256763,260155,3392,20,Y,Y,1438423663362,256945,257426
THIRTY.txt,257468,261204,3736,20,Y,Y,1438424184434,260766,262372
THIRTY.txt,258559,261733,3174,20,Y,Y,1438424184434,260766,262372
THIRTY.txt,259297,262498,3201,20,Y,Y,1438424184434,260766,262372
THIRTY.txt,260157,262904,2747,20,Y,Y,1438424184434,260766,262372
THIRTY.txt,261206,263382,2176,20,Y,Y,1438424184434,260766,262372
THIRTY.txt,261734,263701,1967,20,Y,Y,1438424184434,260766,262372
THIRTY.txt,262499,264278,1779,20,Y,N,-,-1,-1
THIRTY.txt,262905,264856,1951,20,N,N,-,-1,-1
THIRTY.txt,263383,265503,2120,20,N,N,-,-1,-1
THIRTY.txt,263702,266214,2512,20,Y,N,-,-1,-1
THIRTY.txt,264279,267085,2806,20,Y,N,-,-1,-1
THIRTY.txt,264857,267554,2697,20,Y,N,-,-1,-1
THIRTY.txt,265504,268213,2709,20,Y,N,-,-1,-1
THIRTY.txt,266217,268672,2455,20,Y,N,-,-1,-1
THIRTY.txt,267088,269539,2451,20,Y,N,-,-1,-1
THIRTY.txt,267555,270331,2776,20,Y,N,-,-1,-1
THIRTY.txt,268218,271318,3100,20,Y,N,-,-1,-1
THIRTY.txt,268673,272338,3665,20,Y,N,-,-1,-1
THIRTY.txt,269540,273200,3660,20,Y,N,-,-1,-1
THIRTY.txt,270336,274322,3986,20,Y,N,-,-1,-1
THIRTY.txt,271320,275130,3810,20,Y,Y,1438425910414,274750,276774
THIRTY.txt,272339,275892,3553,20,Y,Y,1438425910414,274750,276774
THIRTY.txt,273200,276728,3528,20,Y,Y,1438425910414,274750,276774
THIRTY.txt,274323,277743,3420,20,Y,Y,1438425910414,274750,276774
THIRTY.txt,275131,278408,3277,20,Y,Y,1438426336365,278251,279327
THIRTY.txt,275893,279331,3438,20,Y,Y,1438426336365,278251,279327
THIRTY.txt,276729,279940,3211,20,Y,Y,1438426336365,278251,279327
THIRTY.txt,277744,280484,2740,20,Y,Y,1438426336365,278251,279327
THIRTY.txt,278409,281174,2765,20,Y,Y,1438426336365,278251,279327
THIRTY.txt,279334,281744,2410,20,Y,Y,1438426775375,281224,282800
THIRTY.txt,279942,282704,2762,20,Y,Y,1438426775375,281224,282800
THIRTY.txt,280485,283772,3287,20,Y,Y,1438426775375,281224,282800
THIRTY.txt,281177,284834,3657,20,Y,Y,1438426775375,281224,282800
THIRTY.txt,281745,285393,3648,20,Y,Y,1438426775375,281224,282800
THIRTY.txt,282705,286138,3433,20,Y,Y,1438426775375,281224,282800
THIRTY.txt,283774,286566,2792,20,Y,N,-,-1,-1
THIRTY.txt,284835,287313,2478,20,Y,Y,1438427296305,286896,287713
THIRTY.txt,285394,287762,2368,20,Y,Y,1438427296305,286896,287713
THIRTY.txt,286139,288637,2498,20,Y,Y,1438427296305,286896,287713
THIRTY.txt,286571,289198,2627,20,Y,Y,1438427296305,286896,287713
THIRTY.txt,287316,289886,2570,20,Y,Y,1438427296305,286896,287713
THIRTY.txt,287765,290385,2620,20,Y,N,-,-1,-1
THIRTY.txt,288638,291627,2989,20,Y,N,-,-1,-1
THIRTY.txt,289199,292298,3099,20,Y,N,-,-1,-1
THIRTY.txt,289887,292845,2958,20,Y,N,-,-1,-1
THIRTY.txt,290385,293217,2832,20,Y,N,-,-1,-1
THIRTY.txt,291628,293691,2063,20,Y,N,-,-1,-1
THIRTY.txt,292299,294463,2164,20,Y,N,-,-1,-1
THIRTY.txt,292847,295067,2220,20,Y,N,-,-1,-1
THIRTY.txt,293218,295929,2711,20,Y,N,-,-1,-1
THIRTY.txt,293694,296220,2526,20,Y,N,-,-1,-1
THIRTY.txt,294465,297314,2849,20,Y,N,-,-1,-1
THIRTY.txt,295068,298465,3397,20,Y,N,-,-1,-1
THIRTY.txt,295930,299286,3356,20,Y,N,-,-1,-1
THIRTY.txt,296223,300143,3920,20,Y,N,-,-1,-1
THIRTY.txt,297319,300848,3529,20,Y,N,-,-1,-1
THIRTY.txt,298466,301643,3177,20,Y,Y,1438427933753,301337,301636
THIRTY.txt,299288,302435,3147,20,Y,Y,1438427933753,301337,301636
THIRTY.txt,300144,303245,3101,20,Y,Y,1438428449081,302448,305774
THIRTY.txt,300849,304119,3270,20,Y,Y,1438428449081,302448,305774
THIRTY.txt,301644,305061,3417,20,Y,Y,1438428449081,302448,305774
THIRTY.txt,302438,305875,3437,20,Y,Y,1438428449081,302448,305774
THIRTY.txt,303246,306320,3074,20,Y,Y,1438436113840,305935,306928
THIRTY.txt,304120,307109,2989,20,Y,Y,1438436113840,305935,306928
THIRTY.txt,305062,307910,2848,20,Y,Y,1438436113840,305935,306928
THIRTY.txt,305876,308448,2572,20,Y,Y,1438436113840,305935,306928
THIRTY.txt,306321,309146,2825,20,Y,Y,1438436113840,305935,306928
THIRTY.txt,307111,310114,3003,20,Y,N,-,-1,-1
THIRTY.txt,307911,311090,3179,20,Y,N,-,-1,-1
THIRTY.txt,308449,311949,3500,20,Y,N,-,-1,-1
THIRTY.txt,309147,312453,3306,20,Y,N,-,-1,-1
THIRTY.txt,310115,313048,2933,20,Y,N,-,-1,-1
THIRTY.txt,311093,313668,2575,20,Y,N,-,-1,-1
THIRTY.txt,311952,314650,2698,20,Y,Y,1438436621227,314360,314649
THIRTY.txt,312454,315307,2853,20,Y,Y,1438436987445,314654,315248
THIRTY.txt,313051,316287,3236,20,Y,Y,1438436987445,314654,315248
THIRTY.txt,313669,317130,3461,20,Y,Y,1438437740936,316545,317774
THIRTY.txt,314651,318366,3715,20,Y,Y,1438437740936,316545,317774
THIRTY.txt,315308,319231,3923,20,Y,Y,1438437740936,316545,317774
THIRTY.txt,316288,320101,3813,20,Y,Y,1438437740936,316545,317774
THIRTY.txt,317131,320699,3568,20,Y,Y,1438437740936,316545,317774
THIRTY.txt,318367,321694,3327,20,Y,Y,1438438056880,318703,319615
THIRTY.txt,319232,322266,3034,20,Y,Y,1438438056880,318703,319615
THIRTY.txt,320102,323439,3337,20,Y,N,-,-1,-1
THIRTY.txt,320702,323962,3260,20,Y,N,-,-1,-1
THIRTY.txt,321695,324693,2998,20,Y,N,-,-1,-1
THIRTY.txt,322267,325336,3069,20,Y,N,-,-1,-1
THIRTY.txt,323442,325772,2330,20,Y,N,-,-1,-1
THIRTY.txt,323963,326681,2718,20,Y,Y,1438438506460,326211,326819
THIRTY.txt,324694,327494,2800,20,Y,Y,1438438506460,326211,326819
THIRTY.txt,325337,328130,2793,20,Y,Y,1438438506460,326211,326819
THIRTY.txt,325773,329108,3335,20,Y,Y,1438438506460,326211,326819
THIRTY.txt,326682,329900,3218,20,Y,Y,1438438506460,326211,326819
THIRTY.txt,327500,330547,3047,20,Y,Y,1438442848699,330488,331687
THIRTY.txt,328135,331477,3342,20,Y,Y,1438442848699,330488,331687
THIRTY.txt,329110,332226,3116,20,Y,Y,1438442848699,330488,331687
THIRTY.txt,329901,332983,3082,20,Y,Y,1438442848699,330488,331687
THIRTY.txt,330548,333911,3363,20,Y,Y,1438442848699,330488,331687
THIRTY.txt,331478,334395,2917,20,Y,Y,1438442848699,330488,331687
THIRTY.txt,332227,334844,2617,20,Y,N,-,-1,-1
THIRTY.txt,332984,335620,2636,20,Y,Y,1438443458585,334890,335870
THIRTY.txt,333914,336598,2684,20,Y,Y,1438443458585,334890,335870
THIRTY.txt,334396,337157,2761,20,Y,Y,1438443458585,334890,335870
THIRTY.txt,334847,337846,2999,20,Y,Y,1438443458585,334890,335870
THIRTY.txt,335621,338418,2797,20,Y,Y,1438443458585,334890,335870
THIRTY.txt,336599,339156,2557,20,Y,Y,1438443842388,336005,338631
THIRTY.txt,337158,340019,2861,20,Y,Y,1438444169457,339222,340309
THIRTY.txt,337847,341139,3292,20,Y,Y,1438444169457,339222,340309
THIRTY.txt,338419,342076,3657,20,Y,Y,1438444169457,339222,340309
THIRTY.txt,339156,343013,3857,20,Y,Y,1438444169457,339222,340309
THIRTY.txt,340020,343786,3766,20,Y,Y,1438444169457,339222,340309
THIRTY.txt,341140,344607,3467,20,Y,Y,1438444885260,343875,346542
THIRTY.txt,342077,345419,3342,20,Y,Y,1438444885260,343875,346542
THIRTY.txt,343016,346217,3201,20,Y,Y,1438444885260,343875,346542
THIRTY.txt,343789,346913,3124,20,Y,Y,1438444885260,343875,346542
THIRTY.txt,344608,347695,3087,20,Y,Y,1438445209833,347185,347720
THIRTY.txt,345420,348614,3194,20,Y,Y,1438445991237,347950,348352
THIRTY.txt,346218,349240,3022,20,Y,Y,1438445991237,347950,348352
THIRTY.txt,346914,350306,3392,20,Y,Y,1438445991237,347950,348352
THIRTY.txt,347696,351179,3483,20,Y,Y,1438445991237,347950,348352
THIRTY.txt,348614,352026,3412,20,Y,Y,1438446807342,351574,353976
THIRTY.txt,349241,352698,3457,20,Y,Y,1438446807342,351574,353976
THIRTY.txt,350307,353192,2885,20,Y,Y,1438446807342,351574,353976
THIRTY.txt,351180,353662,2482,20,Y,Y,1438446807342,351574,353976
THIRTY.txt,352027,354253,2226,20,Y,Y,1438446807342,351574,353976
THIRTY.txt,352699,355352,2653,20,Y,Y,1438446807342,351574,353976
THIRTY.txt,353195,356423,3228,20,Y,Y,1438446807342,351574,353976
THIRTY.txt,353663,357762,4099,20,Y,Y,1438446807342,351574,353976
THIRTY.txt,354253,358473,4220,20,Y,N,-,-1,-1
THIRTY.txt,355354,359278,3924,20,Y,N,-,-1,-1
THIRTY.txt,356424,359663,3239,20,Y,N,-,-1,-1
THIRTY.txt,357763,360691,2928,20,Y,N,-,-1,-1
THIRTY.txt,358475,361320,2845,20,Y,N,-,-1,-1
THIRTY.txt,359279,362035,2756,20,Y,N,-,-1,-1
THIRTY.txt,359664,362783,3119,20,Y,N,-,-1,-1
THIRTY.txt,360693,363413,2720,20,Y,N,-,-1,-1
THIRTY.txt,361323,364207,2884,20,Y,N,-,-1,-1
THIRTY.txt,362036,364876,2840,20,Y,N,-,-1,-1
THIRTY.txt,362788,365407,2619,20,Y,N,-,-1,-1
THIRTY.txt,363414,366044,2630,20,Y,N,-,-1,-1
THIRTY.txt,364208,366463,2255,20,Y,N,-,-1,-1
THIRTY.txt,364877,366999,2122,20,Y,N,-,-1,-1
THIRTY.txt,365408,367842,2434,20,Y,N,-,-1,-1
THIRTY.txt,366047,368328,2281,20,Y,N,-,-1,-1
THIRTY.txt,366464,369373,2909,20,Y,N,-,-1,-1
THIRTY.txt,367000,370356,3356,20,Y,Y,1438447751146,369829,370680
THIRTY.txt,367845,371520,3675,20,Y,Y,1438447751146,369829,370680
THIRTY.txt,368331,372307,3976,20,Y,Y,1438447751146,369829,370680
THIRTY.txt,369376,373094,3718,20,Y,Y,1438448043481,372740,373741
THIRTY.txt,370358,373761,3403,20,Y,Y,1438448043481,372740,373741
THIRTY.txt,371521,374418,2897,20,Y,Y,1438448043481,372740,373741
THIRTY.txt,372308,375102,2794,20,Y,Y,1438448043481,372740,373741
THIRTY.txt,373095,375954,2859,20,Y,Y,1438448043481,372740,373741
THIRTY.txt,373764,376525,2761,20,Y,N,-,-1,-1
THIRTY.txt,374421,377068,2647,20,Y,N,-,-1,-1
THIRTY.txt,375102,377990,2888,20,Y,N,-,-1,-1
THIRTY.txt,375959,379058,3099,20,Y,N,-,-1,-1
THIRTY.txt,376526,380086,3560,20,Y,N,-,-1,-1
THIRTY.txt,377069,380709,3640,20,Y,N,-,-1,-1
THIRTY.txt,377991,381758,3767,20,Y,N,-,-1,-1
THIRTY.txt,379059,382080,3021,20,Y,N,-,-1,-1
THIRTY.txt,380087,382394,2307,20,N,N,-,-1,-1
THIRTY.txt,380710,383192,2482,20,Y,N,-,-1,-1
THIRTY.txt,381759,384119,2360,20,Y,N,-,-1,-1
THIRTY.txt,382081,384708,2627,20,Y,N,-,-1,-1
THIRTY.txt,382399,385348,2949,20,Y,N,-,-1,-1
THIRTY.txt,383194,386210,3016,20,Y,N,-,-1,-1
THIRTY.txt,384124,387148,3024,20,Y,N,-,-1,-1
THIRTY.txt,384709,387802,3093,20,Y,N,-,-1,-1
THIRTY.txt,385349,388198,2849,20,Y,N,-,-1,-1
THIRTY.txt,386211,388912,2701,20,Y,N,-,-1,-1
THIRTY.txt,387149,389956,2807,20,Y,N,-,-1,-1
THIRTY.txt,387804,391009,3205,20,Y,N,-,-1,-1
THIRTY.txt,388199,391577,3378,20,Y,N,-,-1,-1
THIRTY.txt,388913,392251,3338,20,Y,N,-,-1,-1
THIRTY.txt,389958,392739,2781,20,Y,Y,1438520691591,392603,394020
THIRTY.txt,391012,393289,2277,20,Y,Y,1438520691591,392603,394020
THIRTY.txt,391581,393862,2281,20,Y,Y,1438520691591,392603,394020
THIRTY.txt,392252,394451,2199,20,Y,Y,1438520691591,392603,394020
THIRTY.txt,392741,395668,2927,20,Y,Y,1438521312859,395053,395651
THIRTY.txt,393294,396613,3319,20,Y,Y,1438521743713,395976,397187
THIRTY.txt,393862,397591,3729,20,Y,Y,1438521743713,395976,397187
THIRTY.txt,394452,398462,4010,20,Y,Y,1438521743713,395976,397187
THIRTY.txt,395671,399276,3605,20,Y,Y,1438521743713,395976,397187
THIRTY.txt,396613,399748,3135,20,Y,Y,1438521743713,395976,397187
THIRTY.txt,397592,400176,2584,20,Y,Y,1438522094902,397281,398089
THIRTY.txt,398464,400687,2223,20,Y,Y,1438522453832,399958,400307
THIRTY.txt,399277,401226,1949,20,Y,Y,1438522453832,399958,400307
THIRTY.txt,399749,401805,2056,20,Y,Y,1438522453832,399958,400307
THIRTY.txt,400177,402737,2560,20,Y,Y,1438522453832,399958,400307
THIRTY.txt,400688,403333,2645,20,Y,N,-,-1,-1
THIRTY.txt,401227,403988,2761,20,Y,N,-,-1,-1
THIRTY.txt,401806,404916,3110,20,Y,N,-,-1,-1
THIRTY.txt,402738,405598,2860,20,Y,N,-,-1,-1
THIRTY.txt,403334,406523,3189,20,Y,N,-,-1,-1
THIRTY.txt,403988,407081,3093,20,Y,N,-,-1,-1
THIRTY.txt,404918,408007,3089,20,Y,Y,1438523309595,407082,408026
THIRTY.txt,405599,408767,3168,20,Y,Y,1438523309595,407082,408026
THIRTY.txt,406525,409188,2663,20,Y,Y,1438523309595,407082,408026
THIRTY.txt,407082,409613,2531,20,Y,Y,1438523309595,407082,408026
THIRTY.txt,408008,409982,1974,20,Y,Y,1438523309595,407082,408026
THIRTY.txt,408769,410399,1630,20,Y,N,-,-1,-1
THIRTY.txt,409189,411890,2701,20,Y,N,-,-1,-1
THIRTY.txt,409614,412763,3149,20,Y,Y,1438524170239,412054,412585
THIRTY.txt,409985,413539,3554,20,Y,Y,1438524170239,412054,412585
THIRTY.txt,410400,414397,3997,20,Y,Y,1438524762496,413657,414319
THIRTY.txt,411891,415432,3541,20,Y,Y,1438524762496,413657,414319
THIRTY.txt,412764,416175,3411,20,Y,Y,1438524762496,413657,414319
THIRTY.txt,413540,417004,3464,20,Y,Y,1438524762496,413657,414319
THIRTY.txt,414400,417725,3325,20,Y,N,-,-1,-1
THIRTY.txt,415437,418421,2984,20,Y,N,-,-1,-1
THIRTY.txt,416176,419027,2851,20,Y,N,-,-1,-1
THIRTY.txt,417009,419631,2622,20,Y,Y,1438525236574,419169,419622
THIRTY.txt,417726,420378,2652,20,Y,Y,1438525660625,420215,421606
THIRTY.txt,418422,421196,2774,20,Y,Y,1438525660625,420215,421606
THIRTY.txt,419028,421635,2607,20,Y,Y,1438525660625,420215,421606
THIRTY.txt,419632,422707,3075,20,Y,Y,1438525660625,420215,421606
THIRTY.txt,420378,423297,2919,20,Y,Y,1438525660625,420215,421606
THIRTY.txt,421197,424645,3448,20,Y,Y,1438525660625,420215,421606
THIRTY.txt,421640,425292,3652,20,Y,Y,1438525989298,421681,422296
THIRTY.txt,422707,426255,3548,20,Y,N,-,-1,-1
THIRTY.txt,423298,426881,3583,20,Y,N,-,-1,-1
THIRTY.txt,424646,427794,3148,20,Y,Y,1438526435174,427361,428109
THIRTY.txt,425293,428829,3536,20,Y,Y,1438526435174,427361,428109
THIRTY.txt,426256,430111,3855,20,Y,Y,1438526435174,427361,428109
THIRTY.txt,426882,431123,4241,20,Y,Y,1438526435174,427361,428109
THIRTY.txt,427795,432540,4745,20,Y,Y,1438526435174,427361,428109
THIRTY.txt,428830,433610,4780,20,Y,N,-,-1,-1
THIRTY.txt,430112,434462,4350,20,Y,N,-,-1,-1
THIRTY.txt,431126,435466,4340,20,Y,N,-,-1,-1
THIRTY.txt,432541,436245,3704,20,Y,Y,1438527042090,435881,437111
THIRTY.txt,433611,437304,3693,20,Y,Y,1438527042090,435881,437111
THIRTY.txt,434463,438227,3764,20,Y,Y,1438527042090,435881,437111
THIRTY.txt,435467,438989,3522,20,Y,Y,1438527042090,435881,437111
THIRTY.txt,436246,439627,3381,20,Y,Y,1438532103693,439032,440498
THIRTY.txt,437305,440432,3127,20,Y,Y,1438532103693,439032,440498
THIRTY.txt,438229,441510,3281,20,Y,Y,1438532103693,439032,440498
THIRTY.txt,438992,442452,3460,20,Y,Y,1438532103693,439032,440498
THIRTY.txt,439628,443218,3590,20,Y,Y,1438532103693,439032,440498
THIRTY.txt,440433,444086,3653,20,Y,Y,1438532103693,439032,440498
THIRTY.txt,441511,444784,3273,20,Y,N,-,-1,-1
THIRTY.txt,442454,445559,3105,20,Y,N,-,-1,-1
THIRTY.txt,443219,445868,2649,20,Y,N,-,-1,-1
THIRTY.txt,444087,446362,2275,20,Y,N,-,-1,-1
THIRTY.txt,444785,447076,2291,20,Y,Y,1438532730981,446979,448516
THIRTY.txt,445562,447836,2274,20,Y,Y,1438532730981,446979,448516
THIRTY.txt,445869,448585,2716,20,Y,Y,1438532730981,446979,448516
THIRTY.txt,446363,449365,3002,20,Y,Y,1438533206356,448586,449872
THIRTY.txt,447077,450616,3539,20,Y,Y,1438533206356,448586,449872
THIRTY.txt,447837,451439,3602,20,Y,Y,1438533206356,448586,449872
THIRTY.txt,448586,451957,3371,20,Y,Y,1438533206356,448586,449872
THIRTY.txt,449368,452631,3263,20,Y,Y,1438533206356,448586,449872
THIRTY.txt,450617,453310,2693,20,Y,N,-,-1,-1
THIRTY.txt,451440,453680,2240,20,Y,N,-,-1,-1
THIRTY.txt,451960,454486,2526,20,Y,N,-,-1,-1
THIRTY.txt,452633,455401,2768,20,Y,N,-,-1,-1
THIRTY.txt,453313,456352,3039,20,Y,N,-,-1,-1
THIRTY.txt,453681,457773,4092,20,Y,Y,1438533757046,457288,458186
THIRTY.txt,454487,458539,4052,20,Y,Y,1438533757046,457288,458186
THIRTY.txt,455404,459616,4212,20,Y,Y,1438533757046,457288,458186
THIRTY.txt,456353,461041,4688,20,Y,Y,1438533757046,457288,458186
THIRTY.txt,457774,462170,4396,20,Y,Y,1438533757046,457288,458186
THIRTY.txt,458540,463334,4794,20,Y,N,-,-1,-1
THIRTY.txt,459617,464178,4561,20,Y,Y,1438534266920,463977,464515
THIRTY.txt,461042,464828,3786,20,Y,Y,1438534266920,463977,464515
THIRTY.txt,462170,465772,3602,20,Y,Y,1438534266920,463977,464515
THIRTY.txt,463335,466934,3599,20,Y,Y,1438534266920,463977,464515
THIRTY.txt,464179,467621,3442,20,Y,Y,1438534266920,463977,464515
THIRTY.txt,464833,468440,3607,20,Y,N,-,-1,-1
THIRTY.txt,465774,469460,3686,20,Y,N,-,-1,-1
THIRTY.txt,466937,470291,3354,20,Y,N,-,-1,-1
THIRTY.txt,467622,470857,3235,20,Y,N,-,-1,-1
THIRTY.txt,468441,471717,3276,20,Y,N,-,-1,-1
THIRTY.txt,469461,472442,2981,20,Y,Y,1438535069627,471751,472764
THIRTY.txt,470293,473588,3295,20,Y,Y,1438589777282,472848,474072
THIRTY.txt,470858,474381,3523,20,Y,Y,1438589777282,472848,474072
THIRTY.txt,471720,475069,3349,20,Y,Y,1438589777282,472848,474072
THIRTY.txt,472443,475613,3170,20,Y,Y,1438589777282,472848,474072
THIRTY.txt,473589,476543,2954,20,Y,Y,1438589777282,472848,474072
THIRTY.txt,474382,477326,2944,20,Y,Y,1438590330949,474159,475584
THIRTY.txt,475070,478102,3032,20,Y,Y,1438590330949,474159,475584
THIRTY.txt,475613,478884,3271,20,Y,N,-,-1,-1
THIRTY.txt,476544,479479,2935,20,Y,Y,1438591228595,478885,480708
THIRTY.txt,477327,480114,2787,20,Y,Y,1438591228595,478885,480708
THIRTY.txt,478104,480476,2372,20,Y,Y,1438591228595,478885,480708
THIRTY.txt,478887,481357,2470,20,Y,Y,1438591228595,478885,480708
THIRTY.txt,479480,482315,2835,20,Y,Y,1438591228595,478885,480708
THIRTY.txt,480115,483292,3177,20,Y,Y,1438591228595,478885,480708
THIRTY.txt,480479,484336,3857,20,Y,Y,1438592214311,484044,484590
THIRTY.txt,481358,485320,3962,20,Y,Y,1438592530594,484631,485560
THIRTY.txt,482316,486465,4149,20,Y,Y,1438592530594,484631,485560
THIRTY.txt,483293,487271,3978,20,Y,Y,1438592530594,484631,485560
THIRTY.txt,484337,487907,3570,20,Y,Y,1438592530594,484631,485560
THIRTY.txt,485322,488778,3456,20,Y,Y,1438592530594,484631,485560
THIRTY.txt,486468,489263,2795,20,Y,Y,1438592996577,488903,489682
THIRTY.txt,487272,489770,2498,20,Y,Y,1438592996577,488903,489682
THIRTY.txt,487908,490868,2960,20,Y,Y,1438592996577,488903,489682
THIRTY.txt,488779,491700,2921,20,Y,Y,1438592996577,488903,489682
THIRTY.txt,489264,492558,3294,20,Y,Y,1438592996577,488903,489682
THIRTY.txt,489771,493175,3404,20,Y,Y,1438593512176,489782,492138
THIRTY.txt,490869,493671,2802,20,Y,Y,1438593512176,489782,492138
THIRTY.txt,491701,494432,2731,20,Y,Y,1438593512176,489782,492138
THIRTY.txt,492559,495135,2576,20,Y,N,-,-1,-1
THIRTY.txt,493176,495992,2816,20,Y,N,-,-1,-1
THIRTY.txt,493672,497168,3496,20,Y,N,-,-1,-1
THIRTY.txt,494433,497976,3543,20,Y,N,-,-1,-1
THIRTY.txt,495136,498907,3771,20,Y,Y,1438594174047,498899,500136
THIRTY.txt,495993,499748,3755,20,Y,Y,1438594174047,498899,500136
THIRTY.txt,497169,500873,3704,20,Y,Y,1438594174047,498899,500136
THIRTY.txt,497977,502359,4382,20,Y,Y,1438594174047,498899,500136
THIRTY.txt,498908,503220,4312,20,Y,Y,1438594174047,498899,500136
THIRTY.txt,499749,504005,4256,20,Y,Y,1438594174047,498899,500136
THIRTY.txt,500874,505073,4199,20,Y,Y,1438596375620,500735,501901
THIRTY.txt,502360,505902,3542,20,Y,Y,1438596889671,505129,506172
THIRTY.txt,503221,506755,3534,20,Y,Y,1438596889671,505129,506172
THIRTY.txt,504006,507677,3671,20,Y,Y,1438596889671,505129,506172
THIRTY.txt,505076,508290,3214,20,Y,Y,1438596889671,505129,506172
THIRTY.txt,505903,509266,3363,20,Y,Y,1438596889671,505129,506172
THIRTY.txt,506758,510466,3708,20,Y,N,-,-1,-1
THIRTY.txt,507679,511285,3606,20,Y,N,-,-1,-1
THIRTY.txt,508291,512170,3879,20,Y,Y,1438597622333,511659,513933
THIRTY.txt,509267,512787,3520,20,Y,Y,1438597622333,511659,513933
THIRTY.txt,510467,514037,3570,20,Y,Y,1438597622333,511659,513933
THIRTY.txt,511286,514568,3282,20,Y,Y,1438597622333,511659,513933
THIRTY.txt,512173,515284,3111,20,Y,Y,1438597622333,511659,513933
THIRTY.txt,512788,516064,3276,20,Y,Y,1438597622333,511659,513933
THIRTY.txt,514040,516981,2941,20,Y,N,-,-1,-1
THIRTY.txt,514569,517750,3181,20,Y,N,-,-1,-1
THIRTY.txt,515285,518342,3057,20,Y,N,-,-1,-1
THIRTY.txt,516066,519274,3208,20,Y,N,-,-1,-1
THIRTY.txt,516982,519966,2984,20,Y,Y,1438598288957,519286,519820
THIRTY.txt,517753,520772,3019,20,Y,Y,1438598288957,519286,519820
THIRTY.txt,518344,521635,3291,20,Y,Y,1438598288957,519286,519820
THIRTY.txt,519275,522470,3195,20,Y,Y,1438598938260,522322,523335
THIRTY.txt,519967,523344,3377,20,Y,Y,1438598938260,522322,523335
THIRTY.txt,520773,524720,3947,20,Y,Y,1438598938260,522322,523335
THIRTY.txt,521636,525929,4293,20,Y,Y,1438598938260,522322,523335
THIRTY.txt,522471,526663,4192,20,Y,Y,1438598938260,522322,523335
THIRTY.txt,523345,527021,3676,20,Y,Y,1438599418291,525144,526021
THIRTY.txt,524721,527236,2515,20,Y,Y,1438599418291,525144,526021
THIRTY.txt,525930,527895,1965,20,N,Y,1438599418291,525144,526021
THIRTY.txt,526664,529188,2524,20,Y,N,-,-1,-1
THIRTY.txt,527022,529779,2757,20,Y,Y,1438599831167,529511,530072
THIRTY.txt,527237,530553,3316,20,Y,Y,1438599831167,529511,530072
THIRTY.txt,527896,531108,3212,20,Y,Y,1438599831167,529511,530072
THIRTY.txt,529189,531939,2750,20,Y,Y,1438599831167,529511,530072
THIRTY.txt,529780,532792,3012,20,Y,Y,1438599831167,529511,530072
THIRTY.txt,530554,533135,2581,20,Y,N,-,-1,-1
THIRTY.txt,531109,533916,2807,20,Y,N,-,-1,-1
THIRTY.txt,531940,535100,3160,20,Y,Y,1438600198307,534335,534790
THIRTY.txt,532793,536040,3247,20,Y,Y,1438600198307,534335,534790
THIRTY.txt,533140,537134,3994,20,Y,Y,1438600198307,534335,534790
THIRTY.txt,533917,538675,4758,20,Y,Y,1438600198307,534335,534790
THIRTY.txt,535101,539527,4426,20,Y,N,-,-1,-1
THIRTY.txt,536041,540397,4356,20,Y,N,-,-1,-1
THIRTY.txt,537135,543587,6452,20,Y,N,-,-1,-1
THIRTY.txt,538676,545939,7263,20,Y,N,-,-1,-1
THIRTY.txt,539532,556923,17391,20,Y,N,-,-1,-1
THIRTY.txt,540398,559079,18681,20,Y,N,-,-1,-1
THIRTY.txt,543588,570720,27132,20,Y,N,-,-1,-1
THIRTY.txt,545940,575368,29428,20,Y,N,-,-1,-1
TWOMEN.txt,2,4697,4695,20,N,N,-,-1,-1
TWOMEN.txt,1593,4908,3315,20,N,N,-,-1,-1
TWOMEN.txt,3381,5059,1678,20,N,N,-,-1,-1
TWOMEN.txt,4506,5274,768,20,N,N,-,-1,-1
TWOMEN.txt,4698,5784,1086,20,N,N,-,-1,-1
TWOMEN.txt,4909,6776,1867,20,N,N,-,-1,-1
TWOMEN.txt,5061,7601,2540,20,Y,N,-,-1,-1
TWOMEN.txt,5276,8367,3091,20,Y,N,-,-1,-1
TWOMEN.txt,5785,8865,3080,20,Y,N,-,-1,-1
TWOMEN.txt,6777,9768,2991,20,Y,N,-,-1,-1
TWOMEN.txt,7603,10749,3146,20,Y,Y,1433438168945,10115,10944
TWOMEN.txt,8368,11543,3175,20,Y,Y,1433438168945,10115,10944
TWOMEN.txt,8867,12850,3983,20,Y,Y,1433438168945,10115,10944
TWOMEN.txt,9770,13531,3761,20,Y,Y,1433438168945,10115,10944
TWOMEN.txt,10750,14827,4077,20,Y,Y,1433438168945,10115,10944
TWOMEN.txt,11544,15858,4314,20,Y,N,-,-1,-1
TWOMEN.txt,12851,16923,4072,20,Y,N,-,-1,-1
TWOMEN.txt,13532,17767,4235,20,Y,N,-,-1,-1
TWOMEN.txt,14829,18472,3643,20,Y,N,-,-1,-1
TWOMEN.txt,15859,19850,3991,20,Y,N,-,-1,-1
TWOMEN.txt,16924,20202,3278,20,N,N,-,-1,-1
TWOMEN.txt,17768,20849,3081,20,N,N,-,-1,-1
TWOMEN.txt,18473,21325,2852,20,Y,N,-,-1,-1
TWOMEN.txt,19851,21813,1962,20,Y,N,-,-1,-1
TWOMEN.txt,20204,22550,2346,20,Y,N,-,-1,-1
TWOMEN.txt,20850,23352,2502,20,Y,N,-,-1,-1
TWOMEN.txt,21326,23802,2476,20,Y,N,-,-1,-1
TWOMEN.txt,21815,23976,2161,20,Y,N,-,-1,-1
TWOMEN.txt,22551,24257,1706,20,Y,N,-,-1,-1
TWOMEN.txt,23354,24446,1092,20,N,N,-,-1,-1
TWOMEN.txt,23804,24653,849,20,N,N,-,-1,-1
TWOMEN.txt,23977,25250,1273,20,N,N,-,-1,-1
TWOMEN.txt,24258,25601,1343,20,Y,N,-,-1,-1
TWOMEN.txt,24447,25969,1522,20,Y,N,-,-1,-1
TWOMEN.txt,24656,26676,2020,20,Y,N,-,-1,-1
TWOMEN.txt,25251,27672,2421,20,Y,N,-,-1,-1
TWOMEN.txt,25602,28734,3132,20,Y,N,-,-1,-1
TWOMEN.txt,25971,29496,3525,20,Y,N,-,-1,-1
TWOMEN.txt,26677,30020,3343,20,Y,N,-,-1,-1
TWOMEN.txt,27674,30150,2476,20,Y,N,-,-1,-1
TWOMEN.txt,28735,30397,1662,20,N,N,-,-1,-1
TWOMEN.txt,29497,30515,1018,20,N,N,-,-1,-1
TWOMEN.txt,30020,30616,596,20,N,N,-,-1,-1
TWOMEN.txt,30152,30684,532,20,N,N,-,-1,-1
TWOMEN.txt,30400,31127,727,20,N,N,-,-1,-1
TWOMEN.txt,30516,31397,881,20,Y,N,-,-1,-1
TWOMEN.txt,30617,31642,1025,20,Y,N,-,-1,-1
TWOMEN.txt,30686,31959,1273,20,Y,N,-,-1,-1
TWOMEN.txt,31129,32022,893,20,Y,N,-,-1,-1
TWOMEN.txt,31398,32599,1201,20,Y,N,-,-1,-1
TWOMEN.txt,31644,32878,1234,20,Y,N,-,-1,-1
TWOMEN.txt,31960,33201,1241,20,Y,N,-,-1,-1
TWOMEN.txt,32027,33995,1968,20,Y,N,-,-1,-1
TWOMEN.txt,32601,34362,1761,20,Y,N,-,-1,-1
TWOMEN.txt,32879,34638,1759,20,Y,N,-,-1,-1
TWOMEN.txt,33202,34870,1668,20,Y,N,-,-1,-1
TWOMEN.txt,33998,35014,1016,20,Y,N,-,-1,-1
TWOMEN.txt,34364,35312,948,20,Y,N,-,-1,-1
TWOMEN.txt,34639,35432,793,20,Y,N,-,-1,-1
TWOMEN.txt,34873,35765,892,20,N,N,-,-1,-1
TWOMEN.txt,35016,36003,987,20,N,N,-,-1,-1
TWOMEN.txt,35313,36253,940,20,N,N,-,-1,-1
TWOMEN.txt,35433,36420,987,20,N,N,-,-1,-1
TWOMEN.txt,35766,36904,1138,20,N,N,-,-1,-1
TWOMEN.txt,36005,37140,1135,20,N,N,-,-1,-1
TWOMEN.txt,36254,37318,1064,20,N,N,-,-1,-1
TWOMEN.txt,36421,37674,1253,20,N,N,-,-1,-1
TWOMEN.txt,36906,37916,1010,20,Y,N,-,-1,-1
TWOMEN.txt,37142,38158,1016,20,Y,N,-,-1,-1
TWOMEN.txt,37319,38760,1441,20,Y,N,-,-1,-1
TWOMEN.txt,37676,39062,1386,20,Y,N,-,-1,-1
TWOMEN.txt,37918,40034,2116,20,N,N,-,-1,-1
TWOMEN.txt,38160,40974,2814,20,N,N,-,-1,-1
TWOMEN.txt,38762,41270,2508,20,N,N,-,-1,-1
TWOMEN.txt,39063,41864,2801,20,N,N,-,-1,-1
TWOMEN.txt,40035,42190,2155,20,N,N,-,-1,-1
TWOMEN.txt,40976,42244,1268,20,N,N,-,-1,-1
TWOMEN.txt,41272,42684,1412,20,N,N,-,-1,-1
TWOMEN.txt,41865,43176,1311,20,N,N,-,-1,-1
TWOMEN.txt,42191,43678,1487,20,N,N,-,-1,-1
TWOMEN.txt,42246,43880,1634,20,Y,N,-,-1,-1
TWOMEN.txt,42685,44316,1631,20,Y,N,-,-1,-1
TWOMEN.txt,43177,45351,2174,20,Y,N,-,-1,-1
TWOMEN.txt,43680,46227,2547,20,N,N,-,-1,-1
TWOMEN.txt,43883,47210,3327,20,N,N,-,-1,-1
TWOMEN.txt,44317,48438,4121,20,N,N,-,-1,-1
TWOMEN.txt,45352,48869,3517,20,N,N,-,-1,-1
TWOMEN.txt,46228,49571,3343,20,N,N,-,-1,-1
TWOMEN.txt,47212,49825,2613,20,N,N,-,-1,-1
TWOMEN.txt,48440,50139,1699,20,N,N,-,-1,-1
TWOMEN.txt,48870,50262,1392,20,N,N,-,-1,-1
TWOMEN.txt,49573,50417,844,20,N,N,-,-1,-1
TWOMEN.txt,49827,50652,825,20,N,N,-,-1,-1
TWOMEN.txt,50140,51412,1272,20,N,N,-,-1,-1
TWOMEN.txt,50264,52155,1891,20,Y,N,-,-1,-1
TWOMEN.txt,50418,52697,2279,20,Y,N,-,-1,-1
TWOMEN.txt,50653,53349,2696,20,Y,N,-,-1,-1
TWOMEN.txt,51417,55321,3904,20,Y,N,-,-1,-1
TWOMEN.txt,52156,56554,4398,20,Y,N,-,-1,-1
TWOMEN.txt,52698,57404,4706,20,Y,N,-,-1,-1
TWOMEN.txt,53354,58347,4993,20,N,N,-,-1,-1
TWOMEN.txt,55322,58919,3597,20,N,N,-,-1,-1
TWOMEN.txt,56555,59510,2955,20,N,N,-,-1,-1
TWOMEN.txt,57405,60321,2916,20,N,N,-,-1,-1
TWOMEN.txt,58348,60778,2430,20,N,N,-,-1,-1
TWOMEN.txt,58920,60941,2021,20,N,N,-,-1,-1
TWOMEN.txt,59511,61188,1677,20,N,N,-,-1,-1
TWOMEN.txt,60323,61444,1121,20,N,N,-,-1,-1
TWOMEN.txt,60780,61838,1058,20,Y,N,-,-1,-1
TWOMEN.txt,60943,62150,1207,20,Y,N,-,-1,-1
TWOMEN.txt,61189,62924,1735,20,Y,N,-,-1,-1
TWOMEN.txt,61444,63653,2209,20,Y,N,-,-1,-1
TWOMEN.txt,61840,64639,2799,20,Y,N,-,-1,-1
TWOMEN.txt,62152,65167,3015,20,N,N,-,-1,-1
TWOMEN.txt,62925,65592,2667,20,N,N,-,-1,-1
TWOMEN.txt,63654,66427,2773,20,N,N,-,-1,-1
TWOMEN.txt,64640,66997,2357,20,N,N,-,-1,-1
TWOMEN.txt,65168,67622,2454,20,N,N,-,-1,-1
TWOMEN.txt,65594,67949,2355,20,N,N,-,-1,-1
TWOMEN.txt,66429,68500,2071,20,N,N,-,-1,-1
TWOMEN.txt,66998,68840,1842,20,N,N,-,-1,-1
TWOMEN.txt,67622,69619,1997,20,N,Y,1435165746603,69147,70419
TWOMEN.txt,67951,70381,2430,20,N,Y,1435165746603,69147,70419
TWOMEN.txt,68501,71537,3036,20,Y,Y,1435165746603,69147,70419
TWOMEN.txt,68841,72365,3524,20,Y,Y,1435165746603,69147,70419
TWOMEN.txt,69620,73010,3390,20,Y,Y,1435165746603,69147,70419
TWOMEN.txt,70382,73539,3157,20,N,Y,1435165746603,69147,70419
TWOMEN.txt,71539,74203,2664,20,N,N,-,-1,-1
TWOMEN.txt,72366,74838,2472,20,N,N,-,-1,-1
TWOMEN.txt,73011,75287,2276,20,N,N,-,-1,-1
TWOMEN.txt,73541,75588,2047,20,N,N,-,-1,-1
TWOMEN.txt,74204,75979,1775,20,N,N,-,-1,-1
TWOMEN.txt,74839,76575,1736,20,N,N,-,-1,-1
TWOMEN.txt,75288,76986,1698,20,N,N,-,-1,-1
TWOMEN.txt,75589,77480,1891,20,N,N,-,-1,-1
TWOMEN.txt,75980,77903,1923,20,N,N,-,-1,-1
TWOMEN.txt,76578,78313,1735,20,N,N,-,-1,-1
TWOMEN.txt,76987,79056,2069,20,N,N,-,-1,-1
TWOMEN.txt,77481,79965,2484,20,N,N,-,-1,-1
TWOMEN.txt,77905,80436,2531,20,N,N,-,-1,-1
TWOMEN.txt,78314,80799,2485,20,N,N,-,-1,-1
TWOMEN.txt,79057,81410,2353,20,N,N,-,-1,-1
TWOMEN.txt,79966,81828,1862,20,N,N,-,-1,-1
TWOMEN.txt,80438,82457,2019,20,N,N,-,-1,-1
TWOMEN.txt,80800,82680,1880,20,N,N,-,-1,-1
TWOMEN.txt,81411,83205,1794,20,N,N,-,-1,-1
TWOMEN.txt,81829,83827,1998,20,N,N,-,-1,-1
TWOMEN.txt,82457,84199,1742,20,N,N,-,-1,-1
TWOMEN.txt,82685,84961,2276,20,N,N,-,-1,-1
TWOMEN.txt,83206,85234,2028,20,N,N,-,-1,-1
TWOMEN.txt,83828,85914,2086,20,N,N,-,-1,-1
TWOMEN.txt,84201,86372,2171,20,N,N,-,-1,-1
TWOMEN.txt,84963,86872,1909,20,N,N,-,-1,-1
TWOMEN.txt,85235,87473,2238,20,N,N,-,-1,-1
TWOMEN.txt,85918,87681,1763,20,N,N,-,-1,-1
TWOMEN.txt,86373,88219,1846,20,N,N,-,-1,-1
TWOMEN.txt,86874,88929,2055,20,N,N,-,-1,-1
TWOMEN.txt,87475,89129,1654,20,N,N,-,-1,-1
TWOMEN.txt,87683,89398,1715,20,N,N,-,-1,-1
TWOMEN.txt,88220,90038,1818,20,N,N,-,-1,-1
TWOMEN.txt,88932,90139,1207,20,N,N,-,-1,-1
TWOMEN.txt,89131,90334,1203,20,N,N,-,-1,-1
TWOMEN.txt,89399,90442,1043,20,N,N,-,-1,-1
TWOMEN.txt,90039,90787,748,20,N,N,-,-1,-1
TWOMEN.txt,90140,91950,1810,20,N,N,-,-1,-1
TWOMEN.txt,90335,92688,2353,20,N,N,-,-1,-1
TWOMEN.txt,90443,93020,2577,20,N,N,-,-1,-1
TWOMEN.txt,90788,93232,2444,20,N,N,-,-1,-1
TWOMEN.txt,91951,93846,1895,20,N,N,-,-1,-1
TWOMEN.txt,92690,94241,1551,20,N,N,-,-1,-1
TWOMEN.txt,93021,94564,1543,20,N,N,-,-1,-1
TWOMEN.txt,93233,94910,1677,20,N,N,-,-1,-1
TWOMEN.txt,93847,95289,1442,20,N,N,-,-1,-1
TWOMEN.txt,94242,95845,1603,20,N,N,-,-1,-1
TWOMEN.txt,94565,96536,1971,20,N,N,-,-1,-1
TWOMEN.txt,94912,97250,2338,20,N,N,-,-1,-1
TWOMEN.txt,95291,97820,2529,20,N,N,-,-1,-1
TWOMEN.txt,95846,98063,2217,20,N,N,-,-1,-1
TWOMEN.txt,96537,98760,2223,20,N,N,-,-1,-1
TWOMEN.txt,97251,99653,2402,20,N,N,-,-1,-1
TWOMEN.txt,97821,99728,1907,20,N,N,-,-1,-1
TWOMEN.txt,98064,100719,2655,20,N,N,-,-1,-1
TWOMEN.txt,98761,101066,2305,20,N,N,-,-1,-1
TWOMEN.txt,99653,101412,1759,20,N,N,-,-1,-1
TWOMEN.txt,99729,101954,2225,20,N,N,-,-1,-1
TWOMEN.txt,100720,102429,1709,20,N,N,-,-1,-1
TWOMEN.txt,101068,102843,1775,20,N,N,-,-1,-1
TWOMEN.txt,101413,103263,1850,20,N,N,-,-1,-1
TWOMEN.txt,101956,103773,1817,20,N,N,-,-1,-1
TWOMEN.txt,102434,104414,1980,20,N,N,-,-1,-1
TWOMEN.txt,102845,105286,2441,20,N,N,-,-1,-1
TWOMEN.txt,103264,106456,3192,20,N,N,-,-1,-1
TWOMEN.txt,103775,107006,3231,20,N,N,-,-1,-1
TWOMEN.txt,104415,107813,3398,20,N,N,-,-1,-1
TWOMEN.txt,105287,108957,3670,20,N,N,-,-1,-1
TWOMEN.txt,106458,109591,3133,20,N,N,-,-1,-1
TWOMEN.txt,107007,110162,3155,20,N,N,-,-1,-1
TWOMEN.txt,107814,111163,3349,20,N,N,-,-1,-1
TWOMEN.txt,108959,111380,2421,20,N,N,-,-1,-1
TWOMEN.txt,109596,111703,2107,20,N,N,-,-1,-1
TWOMEN.txt,110164,112125,1961,20,N,N,-,-1,-1
TWOMEN.txt,111168,112869,1701,20,N,N,-,-1,-1
TWOMEN.txt,111384,113300,1916,20,N,N,-,-1,-1
TWOMEN.txt,111705,113383,1678,20,N,N,-,-1,-1
TWOMEN.txt,112127,114112,1985,20,N,N,-,-1,-1
TWOMEN.txt,112871,114715,1844,20,N,N,-,-1,-1
TWOMEN.txt,113301,115506,2205,20,N,N,-,-1,-1
TWOMEN.txt,113385,116173,2788,20,N,N,-,-1,-1
TWOMEN.txt,114113,116732,2619,20,N,N,-,-1,-1
TWOMEN.txt,114716,117324,2608,20,N,N,-,-1,-1
TWOMEN.txt,115507,118052,2545,20,N,N,-,-1,-1
TWOMEN.txt,116174,118772,2598,20,N,N,-,-1,-1
TWOMEN.txt,116734,119401,2667,20,N,N,-,-1,-1
TWOMEN.txt,117326,120523,3197,20,N,N,-,-1,-1
TWOMEN.txt,118054,121107,3053,20,N,N,-,-1,-1
TWOMEN.txt,118773,121929,3156,20,N,N,-,-1,-1
TWOMEN.txt,119402,122735,3333,20,N,Y,1435248397073,122627,123247
TWOMEN.txt,120524,123313,2789,20,N,Y,1435248397073,122627,123247
TWOMEN.txt,121108,124096,2988,20,N,Y,1435248397073,122627,123247
TWOMEN.txt,121931,124926,2995,20,N,Y,1435248397073,122627,123247
TWOMEN.txt,122736,125629,2893,20,N,Y,1435251420562,125574,126313
TWOMEN.txt,123314,125894,2580,20,N,Y,1435251420562,125574,126313
TWOMEN.txt,124097,126232,2135,20,N,Y,1435251420562,125574,126313
TWOMEN.txt,124928,126740,1812,20,N,Y,1435251420562,125574,126313
TWOMEN.txt,125630,127594,1964,20,N,Y,1435251420562,125574,126313
TWOMEN.txt,125895,128275,2380,20,N,Y,1435251420562,125574,126313
TWOMEN.txt,126233,128640,2407,20,N,Y,1435251420562,125574,126313
TWOMEN.txt,126742,129333,2591,20,N,N,-,-1,-1
TWOMEN.txt,127595,129978,2383,20,N,N,-,-1,-1
TWOMEN.txt,128277,130356,2079,20,N,N,-,-1,-1
TWOMEN.txt,128640,130892,2252,20,N,N,-,-1,-1
TWOMEN.txt,129335,131604,2269,20,N,N,-,-1,-1
TWOMEN.txt,129979,131806,1827,20,N,N,-,-1,-1
TWOMEN.txt,130357,133460,3103,20,N,N,-,-1,-1
TWOMEN.txt,130893,134462,3569,20,N,N,-,-1,-1
TWOMEN.txt,131606,135088,3482,20,N,N,-,-1,-1
TWOMEN.txt,131806,135648,3842,20,N,N,-,-1,-1
TWOMEN.txt,133462,135951,2489,20,N,N,-,-1,-1
TWOMEN.txt,134464,136459,1995,20,N,N,-,-1,-1
TWOMEN.txt,135090,137217,2127,20,N,N,-,-1,-1
TWOMEN.txt,135649,137964,2315,20,N,N,-,-1,-1
TWOMEN.txt,135952,138472,2520,20,N,N,-,-1,-1
TWOMEN.txt,136460,138810,2350,20,Y,N,-,-1,-1
TWOMEN.txt,137218,139390,2172,20,Y,N,-,-1,-1
TWOMEN.txt,137965,139599,1634,20,Y,N,-,-1,-1
TWOMEN.txt,138473,139863,1390,20,Y,N,-,-1,-1
TWOMEN.txt,138811,140107,1296,20,N,N,-,-1,-1
TWOMEN.txt,139395,140347,952,20,N,N,-,-1,-1
TWOMEN.txt,139601,140891,1290,20,N,N,-,-1,-1
TWOMEN.txt,139865,141138,1273,20,N,N,-,-1,-1
TWOMEN.txt,140108,141513,1405,20,N,N,-,-1,-1
TWOMEN.txt,140350,141870,1520,20,N,N,-,-1,-1
TWOMEN.txt,140892,142093,1201,20,N,N,-,-1,-1
TWOMEN.txt,141139,142910,1771,20,N,N,-,-1,-1
TWOMEN.txt,141514,142994,1480,20,N,N,-,-1,-1
TWOMEN.txt,141873,143416,1543,20,N,N,-,-1,-1
TWOMEN.txt,142096,143803,1707,20,N,N,-,-1,-1
TWOMEN.txt,142911,144393,1482,20,N,N,-,-1,-1
TWOMEN.txt,142994,144692,1698,20,N,Y,1435252280553,144644,145005
TWOMEN.txt,143417,145057,1640,20,N,Y,1435252280553,144644,145005
TWOMEN.txt,143805,145311,1506,20,N,Y,1435252280553,144644,145005
TWOMEN.txt,144395,145716,1321,20,Y,Y,1435252280553,144644,145005
TWOMEN.txt,144693,146067,1374,20,N,Y,1435252280553,144644,145005
TWOMEN.txt,145058,146529,1471,20,N,N,-,-1,-1
TWOMEN.txt,145313,146636,1323,20,N,N,-,-1,-1
TWOMEN.txt,145717,146943,1226,20,N,N,-,-1,-1
TWOMEN.txt,146067,147307,1240,20,N,N,-,-1,-1
TWOMEN.txt,146530,147671,1141,20,N,N,-,-1,-1
TWOMEN.txt,146637,147932,1295,20,N,N,-,-1,-1
TWOMEN.txt,146944,148054,1110,20,N,N,-,-1,-1
TWOMEN.txt,147308,148692,1384,20,N,N,-,-1,-1
TWOMEN.txt,147674,148765,1091,20,N,N,-,-1,-1
TWOMEN.txt,147934,149342,1408,20,N,N,-,-1,-1
TWOMEN.txt,148054,149609,1555,20,N,N,-,-1,-1
TWOMEN.txt,148694,149798,1104,20,N,N,-,-1,-1
TWOMEN.txt,148766,149964,1198,20,N,N,-,-1,-1
TWOMEN.txt,149343,150472,1129,20,N,N,-,-1,-1
TWOMEN.txt,149614,150882,1268,20,N,N,-,-1,-1
TWOMEN.txt,149799,151132,1333,20,N,N,-,-1,-1
TWOMEN.txt,149965,151659,1694,20,N,N,-,-1,-1
TWOMEN.txt,150474,151978,1504,20,N,N,-,-1,-1
TWOMEN.txt,150883,152068,1185,20,N,N,-,-1,-1
TWOMEN.txt,151133,152488,1355,20,N,N,-,-1,-1
TWOMEN.txt,151660,152715,1055,20,N,N,-,-1,-1
TWOMEN.txt,151979,153132,1153,20,N,N,-,-1,-1
TWOMEN.txt,152070,153385,1315,20,N,N,-,-1,-1
TWOMEN.txt,152493,153507,1014,20,N,N,-,-1,-1
TWOMEN.txt,152716,153989,1273,20,N,N,-,-1,-1
TWOMEN.txt,153135,154349,1214,20,N,N,-,-1,-1
TWOMEN.txt,153389,154632,1243,20,N,N,-,-1,-1
TWOMEN.txt,153508,155130,1622,20,N,N,-,-1,-1
TWOMEN.txt,153990,155813,1823,20,N,N,-,-1,-1
TWOMEN.txt,154351,155992,1641,20,N,N,-,-1,-1
TWOMEN.txt,154634,156311,1677,20,N,N,-,-1,-1
TWOMEN.txt,155131,156513,1382,20,N,N,-,-1,-1
TWOMEN.txt,155814,156845,1031,20,N,N,-,-1,-1
TWOMEN.txt,155993,157515,1522,20,N,N,-,-1,-1
TWOMEN.txt,156311,157919,1608,20,N,N,-,-1,-1
TWOMEN.txt,156513,158426,1913,20,N,N,-,-1,-1
TWOMEN.txt,156847,159086,2239,20,N,N,-,-1,-1
TWOMEN.txt,157517,159502,1985,20,N,N,-,-1,-1
TWOMEN.txt,157920,159992,2072,20,Y,Y,1435252717170,159519,160234
TWOMEN.txt,158428,160541,2113,20,Y,Y,1435252717170,159519,160234
TWOMEN.txt,159087,161076,1989,20,Y,Y,1435252717170,159519,160234
TWOMEN.txt,159504,161523,2019,20,Y,Y,1435252717170,159519,160234
TWOMEN.txt,159993,161596,1603,20,Y,Y,1435252717170,159519,160234
TWOMEN.txt,160543,162056,1513,20,N,N,-,-1,-1
TWOMEN.txt,161078,162751,1673,20,N,N,-,-1,-1
TWOMEN.txt,161526,163358,1832,20,N,N,-,-1,-1
TWOMEN.txt,161598,164111,2513,20,N,N,-,-1,-1
TWOMEN.txt,162058,164611,2553,20,N,N,-,-1,-1
TWOMEN.txt,162752,164737,1985,20,N,N,-,-1,-1
TWOMEN.txt,163359,165114,1755,20,N,N,-,-1,-1
TWOMEN.txt,164113,165391,1278,20,N,N,-,-1,-1
TWOMEN.txt,164616,165704,1088,20,N,N,-,-1,-1
TWOMEN.txt,164737,165947,1210,20,N,N,-,-1,-1
TWOMEN.txt,165116,166052,936,20,N,N,-,-1,-1
TWOMEN.txt,165394,166473,1079,20,N,N,-,-1,-1
TWOMEN.txt,165706,166626,920,20,N,N,-,-1,-1
TWOMEN.txt,165948,167441,1493,20,N,N,-,-1,-1
TWOMEN.txt,166054,167875,1821,20,N,N,-,-1,-1
TWOMEN.txt,166474,168275,1801,20,N,N,-,-1,-1
TWOMEN.txt,166628,168913,2285,20,N,N,-,-1,-1
TWOMEN.txt,167442,169524,2082,20,N,N,-,-1,-1
TWOMEN.txt,167876,169646,1770,20,N,N,-,-1,-1
TWOMEN.txt,168276,170208,1932,20,N,N,-,-1,-1
TWOMEN.txt,168914,171005,2091,20,N,N,-,-1,-1
TWOMEN.txt,169527,171192,1665,20,N,N,-,-1,-1
TWOMEN.txt,169648,171466,1818,20,N,N,-,-1,-1
TWOMEN.txt,170209,171920,1711,20,N,N,-,-1,-1
TWOMEN.txt,171006,172385,1379,20,N,N,-,-1,-1
TWOMEN.txt,171193,172819,1626,20,N,N,-,-1,-1
TWOMEN.txt,171468,173212,1744,20,N,N,-,-1,-1
TWOMEN.txt,171923,173577,1654,20,N,N,-,-1,-1
TWOMEN.txt,172386,173984,1598,20,N,N,-,-1,-1
TWOMEN.txt,172820,174334,1514,20,N,N,-,-1,-1
TWOMEN.txt,173214,174736,1522,20,N,N,-,-1,-1
TWOMEN.txt,173578,175650,2072,20,N,N,-,-1,-1
TWOMEN.txt,173988,176133,2145,20,N,N,-,-1,-1
TWOMEN.txt,174335,176504,2169,20,N,N,-,-1,-1
TWOMEN.txt,174737,177037,2300,20,N,N,-,-1,-1
TWOMEN.txt,175655,177378,1723,20,N,N,-,-1,-1
TWOMEN.txt,176135,178351,2216,20,N,N,-,-1,-1
TWOMEN.txt,176505,178661,2156,20,N,N,-,-1,-1
TWOMEN.txt,177038,179474,2436,20,N,N,-,-1,-1
TWOMEN.txt,177380,179899,2519,20,N,N,-,-1,-1
TWOMEN.txt,178352,180253,1901,20,N,N,-,-1,-1
TWOMEN.txt,178663,180511,1848,20,N,N,-,-1,-1
TWOMEN.txt,179476,181261,1785,20,N,N,-,-1,-1
TWOMEN.txt,179900,181803,1903,20,N,N,-,-1,-1
TWOMEN.txt,180255,182178,1923,20,N,N,-,-1,-1
TWOMEN.txt,180513,182724,2211,20,N,N,-,-1,-1
TWOMEN.txt,181261,183820,2559,20,N,N,-,-1,-1
TWOMEN.txt,181804,184237,2433,20,N,N,-,-1,-1
TWOMEN.txt,182181,184724,2543,20,N,N,-,-1,-1
TWOMEN.txt,182725,185318,2593,20,N,N,-,-1,-1
TWOMEN.txt,183821,185791,1970,20,N,N,-,-1,-1
TWOMEN.txt,184238,186531,2293,20,N,N,-,-1,-1
TWOMEN.txt,184725,187229,2504,20,N,N,-,-1,-1
TWOMEN.txt,185319,187715,2396,20,N,N,-,-1,-1
TWOMEN.txt,185793,188057,2264,20,N,N,-,-1,-1
TWOMEN.txt,186532,188496,1964,20,N,N,-,-1,-1
TWOMEN.txt,187230,189273,2043,20,N,N,-,-1,-1
TWOMEN.txt,187716,189769,2053,20,N,N,-,-1,-1
TWOMEN.txt,188060,190253,2193,20,N,N,-,-1,-1
TWOMEN.txt,188497,190491,1994,20,N,N,-,-1,-1
TWOMEN.txt,189278,191028,1750,20,N,N,-,-1,-1
TWOMEN.txt,189771,191710,1939,20,N,N,-,-1,-1
TWOMEN.txt,190256,192414,2158,20,N,N,-,-1,-1
TWOMEN.txt,190492,193181,2689,20,N,N,-,-1,-1
TWOMEN.txt,191030,193457,2427,20,N,N,-,-1,-1
TWOMEN.txt,191712,194043,2331,20,N,N,-,-1,-1
TWOMEN.txt,192416,194287,1871,20,N,N,-,-1,-1
TWOMEN.txt,193182,194402,1220,20,N,N,-,-1,-1
TWOMEN.txt,193458,194538,1080,20,N,N,-,-1,-1
TWOMEN.txt,194045,194713,668,20,N,N,-,-1,-1
TWOMEN.txt,194289,194808,519,20,N,N,-,-1,-1
TWOMEN.txt,194405,195088,683,20,N,N,-,-1,-1
TWOMEN.txt,194539,195712,1173,20,N,N,-,-1,-1
TWOMEN.txt,194714,196057,1343,20,N,N,-,-1,-1
TWOMEN.txt,194811,196502,1691,20,N,N,-,-1,-1
TWOMEN.txt,195090,196856,1766,20,N,N,-,-1,-1
TWOMEN.txt,195714,197685,1971,20,N,N,-,-1,-1
TWOMEN.txt,196059,197762,1703,20,N,N,-,-1,-1
TWOMEN.txt,196503,198476,1973,20,N,N,-,-1,-1
TWOMEN.txt,196858,198953,2095,20,N,N,-,-1,-1
TWOMEN.txt,197688,199314,1626,20,N,N,-,-1,-1
TWOMEN.txt,197764,199534,1770,20,N,N,-,-1,-1
TWOMEN.txt,198476,199645,1169,20,N,N,-,-1,-1
TWOMEN.txt,198954,200036,1082,20,N,N,-,-1,-1
TWOMEN.txt,199316,200400,1084,20,N,N,-,-1,-1
TWOMEN.txt,199537,201057,1520,20,N,Y,1435559512755,200724,201031
TWOMEN.txt,199646,201260,1614,20,N,Y,1435559512755,200724,201031
TWOMEN.txt,200037,201651,1614,20,N,Y,1435559512755,200724,201031
TWOMEN.txt,200401,201867,1466,20,N,Y,1435559512755,200724,201031
TWOMEN.txt,201058,202102,1044,20,N,N,-,-1,-1
TWOMEN.txt,201262,202755,1493,20,N,N,-,-1,-1
TWOMEN.txt,201653,203454,1801,20,N,N,-,-1,-1
TWOMEN.txt,201868,203891,2023,20,N,N,-,-1,-1
TWOMEN.txt,202103,204388,2285,20,N,N,-,-1,-1
TWOMEN.txt,202756,204797,2041,20,N,N,-,-1,-1
TWOMEN.txt,203459,205308,1849,20,N,N,-,-1,-1
TWOMEN.txt,203893,205515,1622,20,N,N,-,-1,-1
TWOMEN.txt,204389,205703,1314,20,N,N,-,-1,-1
TWOMEN.txt,204798,205969,1171,20,N,N,-,-1,-1
TWOMEN.txt,205311,206073,762,20,N,N,-,-1,-1
TWOMEN.txt,205516,206657,1141,20,N,N,-,-1,-1
TWOMEN.txt,205706,206857,1151,20,N,N,-,-1,-1
TWOMEN.txt,205974,207214,1240,20,N,N,-,-1,-1
TWOMEN.txt,206073,207709,1636,20,N,N,-,-1,-1
TWOMEN.txt,206658,207969,1311,20,N,N,-,-1,-1
TWOMEN.txt,206858,208654,1796,20,N,N,-,-1,-1
TWOMEN.txt,207217,209089,1872,20,N,N,-,-1,-1
TWOMEN.txt,207711,209706,1995,20,N,N,-,-1,-1
TWOMEN.txt,207970,210428,2458,20,N,N,-,-1,-1
TWOMEN.txt,208655,211044,2389,20,N,N,-,-1,-1
TWOMEN.txt,209090,211207,2117,20,N,N,-,-1,-1
TWOMEN.txt,209708,211969,2261,20,N,N,-,-1,-1
TWOMEN.txt,210429,212876,2447,20,N,N,-,-1,-1
TWOMEN.txt,211045,213517,2472,20,N,N,-,-1,-1
TWOMEN.txt,211207,213987,2780,20,N,N,-,-1,-1
TWOMEN.txt,211970,214454,2484,20,N,N,-,-1,-1
TWOMEN.txt,212877,214920,2043,20,N,N,-,-1,-1
TWOMEN.txt,213520,215468,1948,20,N,N,-,-1,-1
TWOMEN.txt,213988,215952,1964,20,N,N,-,-1,-1
TWOMEN.txt,214456,216299,1843,20,N,N,-,-1,-1
TWOMEN.txt,214922,217494,2572,20,N,N,-,-1,-1
TWOMEN.txt,215469,217979,2510,20,N,N,-,-1,-1
TWOMEN.txt,215953,218484,2531,20,N,N,-,-1,-1
TWOMEN.txt,216304,218686,2382,20,N,N,-,-1,-1
TWOMEN.txt,217495,219855,2360,20,N,N,-,-1,-1
TWOMEN.txt,217980,220275,2295,20,N,N,-,-1,-1
TWOMEN.txt,218485,220752,2267,20,N,N,-,-1,-1
TWOMEN.txt,218687,221115,2428,20,N,N,-,-1,-1
TWOMEN.txt,219856,221643,1787,20,N,N,-,-1,-1
TWOMEN.txt,220276,222040,1764,20,N,N,-,-1,-1
TWOMEN.txt,220753,222739,1986,20,N,N,-,-1,-1
TWOMEN.txt,221116,223254,2138,20,N,Y,1435560377740,223014,223315
TWOMEN.txt,221644,223766,2122,20,N,Y,1435560377740,223014,223315
TWOMEN.txt,222041,224132,2091,20,N,Y,1435560377740,223014,223315
TWOMEN.txt,222740,224420,1680,20,N,Y,1435560377740,223014,223315
TWOMEN.txt,223255,224960,1705,20,Y,Y,1435560377740,223014,223315
TWOMEN.txt,223768,225241,1473,20,Y,N,-,-1,-1
TWOMEN.txt,224135,225470,1335,20,N,N,-,-1,-1
TWOMEN.txt,224425,225753,1328,20,N,N,-,-1,-1
TWOMEN.txt,224961,226026,1065,20,N,N,-,-1,-1
TWOMEN.txt,225242,226287,1045,20,N,N,-,-1,-1
TWOMEN.txt,225471,227027,1556,20,N,N,-,-1,-1
TWOMEN.txt,225754,227455,1701,20,N,N,-,-1,-1
TWOMEN.txt,226027,227608,1581,20,N,N,-,-1,-1
TWOMEN.txt,226289,227782,1493,20,N,N,-,-1,-1
TWOMEN.txt,227028,228226,1198,20,N,N,-,-1,-1
TWOMEN.txt,227456,228970,1514,20,N,N,-,-1,-1
TWOMEN.txt,227609,229144,1535,20,N,N,-,-1,-1
TWOMEN.txt,227783,229467,1684,20,N,N,-,-1,-1
TWOMEN.txt,228228,229819,1591,20,N,N,-,-1,-1
TWOMEN.txt,228972,230464,1492,20,N,N,-,-1,-1
TWOMEN.txt,229146,230722,1576,20,N,N,-,-1,-1
TWOMEN.txt,229468,230990,1522,20,Y,N,-,-1,-1
TWOMEN.txt,229820,231561,1741,20,Y,N,-,-1,-1
TWOMEN.txt,230466,232336,1870,20,Y,N,-,-1,-1
TWOMEN.txt,230724,232470,1746,20,Y,N,-,-1,-1
TWOMEN.txt,230992,232681,1689,20,N,N,-,-1,-1
TWOMEN.txt,231562,232809,1247,20,N,N,-,-1,-1
TWOMEN.txt,232338,233104,766,20,N,N,-,-1,-1
TWOMEN.txt,232472,233492,1020,20,N,N,-,-1,-1
TWOMEN.txt,232683,233656,973,20,Y,N,-,-1,-1
TWOMEN.txt,232810,234201,1391,20,Y,N,-,-1,-1
TWOMEN.txt,233105,234555,1450,20,Y,N,-,-1,-1
TWOMEN.txt,233493,234687,1194,20,Y,N,-,-1,-1
TWOMEN.txt,233657,235201,1544,20,Y,N,-,-1,-1
TWOMEN.txt,234202,235396,1194,20,N,N,-,-1,-1
TWOMEN.txt,234557,235542,985,20,N,N,-,-1,-1
TWOMEN.txt,234688,235880,1192,20,N,N,-,-1,-1
TWOMEN.txt,235202,236531,1329,20,N,N,-,-1,-1
TWOMEN.txt,235402,236878,1476,20,N,N,-,-1,-1
TWOMEN.txt,235543,237373,1830,20,N,Y,1435569753505,236911,237277
TWOMEN.txt,235882,237966,2084,20,N,Y,1435569753505,236911,237277
TWOMEN.txt,236533,238227,1694,20,N,Y,1435569753505,236911,237277
TWOMEN.txt,236879,238355,1476,20,N,Y,1435569753505,236911,237277
TWOMEN.txt,237375,239099,1724,20,N,N,-,-1,-1
TWOMEN.txt,237967,239691,1724,20,N,N,-,-1,-1
TWOMEN.txt,238228,240195,1967,20,N,N,-,-1,-1
TWOMEN.txt,238357,240629,2272,20,N,N,-,-1,-1
TWOMEN.txt,239100,241223,2123,20,N,N,-,-1,-1
TWOMEN.txt,239692,241602,1910,20,N,N,-,-1,-1
TWOMEN.txt,240196,242093,1897,20,N,N,-,-1,-1
TWOMEN.txt,240631,242586,1955,20,N,Y,1435570787049,242195,242945
TWOMEN.txt,241225,242985,1760,20,N,Y,1435570787049,242195,242945
TWOMEN.txt,241603,243375,1772,20,N,Y,1435570787049,242195,242945
TWOMEN.txt,242095,243752,1657,20,N,Y,1435570787049,242195,242945
TWOMEN.txt,242588,243803,1215,20,N,Y,1435570787049,242195,242945
TWOMEN.txt,242986,244424,1438,20,N,N,-,-1,-1
TWOMEN.txt,243380,244759,1379,20,N,N,-,-1,-1
TWOMEN.txt,243753,245439,1686,20,N,N,-,-1,-1
TWOMEN.txt,243804,245607,1803,20,N,N,-,-1,-1
TWOMEN.txt,244426,246160,1734,20,N,N,-,-1,-1
TWOMEN.txt,244761,246686,1925,20,N,N,-,-1,-1
TWOMEN.txt,245440,247047,1607,20,N,N,-,-1,-1
TWOMEN.txt,245609,247466,1857,20,N,N,-,-1,-1
TWOMEN.txt,246162,247870,1708,20,N,N,-,-1,-1
TWOMEN.txt,246686,248404,1718,20,N,N,-,-1,-1
TWOMEN.txt,247049,249429,2380,20,N,N,-,-1,-1
TWOMEN.txt,247469,250471,3002,20,N,N,-,-1,-1
TWOMEN.txt,247871,250785,2914,20,N,N,-,-1,-1
TWOMEN.txt,248405,251317,2912,20,N,N,-,-1,-1
TWOMEN.txt,249430,251687,2257,20,N,N,-,-1,-1
TWOMEN.txt,250473,252439,1966,20,N,N,-,-1,-1
TWOMEN.txt,250786,252853,2067,20,N,N,-,-1,-1
TWOMEN.txt,251318,253549,2231,20,N,N,-,-1,-1
TWOMEN.txt,251688,253968,2280,20,N,N,-,-1,-1
TWOMEN.txt,252440,254290,1850,20,N,N,-,-1,-1
TWOMEN.txt,252855,254661,1806,20,N,N,-,-1,-1
TWOMEN.txt,253551,255083,1532,20,N,N,-,-1,-1
TWOMEN.txt,253970,255244,1274,20,N,N,-,-1,-1
TWOMEN.txt,254291,255897,1606,20,N,N,-,-1,-1
TWOMEN.txt,254661,256393,1732,20,N,N,-,-1,-1
TWOMEN.txt,255086,256749,1663,20,N,N,-,-1,-1
TWOMEN.txt,255245,257296,2051,20,N,N,-,-1,-1
TWOMEN.txt,255898,257775,1877,20,N,N,-,-1,-1
TWOMEN.txt,256394,258586,2192,20,N,N,-,-1,-1
TWOMEN.txt,256750,259113,2363,20,N,N,-,-1,-1
TWOMEN.txt,257297,259830,2533,20,N,N,-,-1,-1
TWOMEN.txt,257777,260311,2534,20,N,N,-,-1,-1
TWOMEN.txt,258588,260745,2157,20,N,N,-,-1,-1
TWOMEN.txt,259114,261265,2151,20,N,N,-,-1,-1
TWOMEN.txt,259832,262220,2388,20,N,N,-,-1,-1
TWOMEN.txt,260312,262530,2218,20,N,N,-,-1,-1
TWOMEN.txt,260750,262974,2224,20,N,N,-,-1,-1
TWOMEN.txt,261266,263207,1941,20,N,N,-,-1,-1
TWOMEN.txt,262222,263758,1536,20,N,N,-,-1,-1
TWOMEN.txt,262531,264089,1558,20,N,N,-,-1,-1
TWOMEN.txt,262975,264675,1700,20,N,N,-,-1,-1
TWOMEN.txt,263208,265433,2225,20,N,N,-,-1,-1
TWOMEN.txt,263760,265950,2190,20,N,N,-,-1,-1
TWOMEN.txt,264090,266092,2002,20,N,N,-,-1,-1
TWOMEN.txt,264676,266796,2120,20,N,N,-,-1,-1
TWOMEN.txt,265434,267225,1791,20,N,N,-,-1,-1
TWOMEN.txt,265951,267526,1575,20,N,N,-,-1,-1
TWOMEN.txt,266093,268503,2410,20,N,N,-,-1,-1
TWOMEN.txt,266798,268930,2132,20,N,N,-,-1,-1
TWOMEN.txt,267226,269533,2307,20,N,N,-,-1,-1
TWOMEN.txt,267529,269926,2397,20,N,N,-,-1,-1
TWOMEN.txt,268505,270290,1785,20,N,N,-,-1,-1
TWOMEN.txt,268931,271015,2084,20,N,N,-,-1,-1
TWOMEN.txt,269534,271696,2162,20,N,N,-,-1,-1
TWOMEN.txt,269927,272367,2440,20,N,N,-,-1,-1
TWOMEN.txt,270292,272893,2601,20,N,N,-,-1,-1
TWOMEN.txt,271016,273573,2557,20,N,N,-,-1,-1
TWOMEN.txt,271697,274010,2313,20,N,N,-,-1,-1
TWOMEN.txt,272368,275037,2669,20,N,N,-,-1,-1
TWOMEN.txt,272900,275339,2439,20,N,N,-,-1,-1
TWOMEN.txt,273575,275501,1926,20,N,N,-,-1,-1
TWOMEN.txt,274012,276277,2265,20,N,N,-,-1,-1
TWOMEN.txt,275038,276689,1651,20,N,N,-,-1,-1
TWOMEN.txt,275340,277088,1748,20,N,N,-,-1,-1
TWOMEN.txt,275502,277809,2307,20,N,N,-,-1,-1
TWOMEN.txt,276283,278316,2033,20,N,N,-,-1,-1
TWOMEN.txt,276691,278747,2056,20,N,N,-,-1,-1
TWOMEN.txt,277089,279194,2105,20,N,N,-,-1,-1
TWOMEN.txt,277810,279829,2019,20,N,N,-,-1,-1
TWOMEN.txt,278319,280075,1756,20,N,N,-,-1,-1
TWOMEN.txt,278748,280403,1655,20,N,N,-,-1,-1
TWOMEN.txt,279196,281224,2028,20,N,N,-,-1,-1
TWOMEN.txt,279830,281495,1665,20,N,N,-,-1,-1
TWOMEN.txt,280076,282017,1941,20,N,N,-,-1,-1
TWOMEN.txt,280405,282897,2492,20,N,N,-,-1,-1
TWOMEN.txt,281229,283162,1933,20,N,N,-,-1,-1
TWOMEN.txt,281496,283543,2047,20,N,N,-,-1,-1
TWOMEN.txt,282018,283744,1726,20,N,N,-,-1,-1
TWOMEN.txt,282898,283887,989,20,N,N,-,-1,-1
TWOMEN.txt,283163,284089,926,20,N,N,-,-1,-1
TWOMEN.txt,283544,284477,933,20,N,N,-,-1,-1
TWOMEN.txt,283745,284996,1251,20,N,N,-,-1,-1
TWOMEN.txt,283887,285355,1468,20,N,N,-,-1,-1
TWOMEN.txt,284091,285829,1738,20,N,N,-,-1,-1
TWOMEN.txt,284478,286471,1993,20,N,N,-,-1,-1
TWOMEN.txt,284999,287439,2440,20,N,N,-,-1,-1
TWOMEN.txt,285356,287683,2327,20,N,N,-,-1,-1
TWOMEN.txt,285830,288162,2332,20,N,N,-,-1,-1
TWOMEN.txt,286476,288803,2327,20,N,N,-,-1,-1
TWOMEN.txt,287441,289305,1864,20,N,N,-,-1,-1
TWOMEN.txt,287684,289867,2183,20,N,N,-,-1,-1
TWOMEN.txt,288167,290180,2013,20,N,N,-,-1,-1
TWOMEN.txt,288803,290884,2081,20,N,N,-,-1,-1
TWOMEN.txt,289306,291496,2190,20,N,N,-,-1,-1
TWOMEN.txt,289868,292791,2923,20,N,N,-,-1,-1
TWOMEN.txt,290180,293105,2925,20,N,N,-,-1,-1
TWOMEN.txt,290885,293828,2943,20,N,N,-,-1,-1
TWOMEN.txt,291497,294420,2923,20,N,N,-,-1,-1
TWOMEN.txt,292794,294614,1820,20,N,N,-,-1,-1
TWOMEN.txt,293106,295218,2112,20,N,N,-,-1,-1
TWOMEN.txt,293830,295607,1777,20,N,N,-,-1,-1
TWOMEN.txt,294422,296108,1686,20,N,N,-,-1,-1
TWOMEN.txt,294614,296421,1807,20,N,N,-,-1,-1
TWOMEN.txt,295219,297343,2124,20,N,N,-,-1,-1
TWOMEN.txt,295609,297678,2069,20,N,N,-,-1,-1
TWOMEN.txt,296110,298226,2116,20,N,N,-,-1,-1
TWOMEN.txt,296422,298940,2518,20,N,N,-,-1,-1
TWOMEN.txt,297344,299232,1888,20,N,N,-,-1,-1
TWOMEN.txt,297680,299594,1914,20,N,N,-,-1,-1
TWOMEN.txt,298227,300237,2010,20,N,N,-,-1,-1
TWOMEN.txt,298940,300691,1751,20,N,N,-,-1,-1
TWOMEN.txt,299233,301055,1822,20,N,N,-,-1,-1
TWOMEN.txt,299595,301869,2274,20,N,N,-,-1,-1
TWOMEN.txt,300240,302279,2039,20,N,N,-,-1,-1
TWOMEN.txt,300693,302484,1791,20,N,N,-,-1,-1
TWOMEN.txt,301057,303019,1962,20,N,N,-,-1,-1
TWOMEN.txt,301870,303688,1818,20,N,N,-,-1,-1
TWOMEN.txt,302281,304212,1931,20,N,N,-,-1,-1
TWOMEN.txt,302485,304427,1942,20,N,N,-,-1,-1
TWOMEN.txt,303021,304944,1923,20,N,N,-,-1,-1
TWOMEN.txt,303690,305652,1962,20,N,N,-,-1,-1
TWOMEN.txt,304214,306642,2428,20,N,N,-,-1,-1
TWOMEN.txt,304428,307144,2716,20,N,N,-,-1,-1
TWOMEN.txt,304945,307339,2394,20,N,N,-,-1,-1
TWOMEN.txt,305653,308076,2423,20,N,N,-,-1,-1
TWOMEN.txt,306648,308338,1690,20,N,N,-,-1,-1
TWOMEN.txt,307145,308777,1632,20,N,N,-,-1,-1
TWOMEN.txt,307341,309572,2231,20,N,N,-,-1,-1
TWOMEN.txt,308080,310620,2540,20,N,N,-,-1,-1
TWOMEN.txt,308343,311151,2808,20,N,N,-,-1,-1
TWOMEN.txt,308778,311363,2585,20,N,N,-,-1,-1
TWOMEN.txt,309574,311462,1888,20,N,N,-,-1,-1
TWOMEN.txt,310621,311531,910,20,N,N,-,-1,-1
TWOMEN.txt,311152,311819,667,20,N,N,-,-1,-1
TWOMEN.txt,311365,312406,1041,20,N,N,-,-1,-1
TWOMEN.txt,311463,312699,1236,20,N,N,-,-1,-1
TWOMEN.txt,311532,313377,1845,20,N,N,-,-1,-1
TWOMEN.txt,311821,313811,1990,20,N,N,-,-1,-1
TWOMEN.txt,312409,314125,1716,20,N,N,-,-1,-1
TWOMEN.txt,312701,315129,2428,20,N,N,-,-1,-1
TWOMEN.txt,313378,315326,1948,20,N,N,-,-1,-1
TWOMEN.txt,313812,316300,2488,20,N,N,-,-1,-1
TWOMEN.txt,314127,316954,2827,20,N,N,-,-1,-1
TWOMEN.txt,315131,317406,2275,20,N,N,-,-1,-1
TWOMEN.txt,315327,318116,2789,20,N,N,-,-1,-1
TWOMEN.txt,316301,318436,2135,20,N,N,-,-1,-1
TWOMEN.txt,316955,319008,2053,20,N,N,-,-1,-1
TWOMEN.txt,317408,319506,2098,20,N,N,-,-1,-1
TWOMEN.txt,318117,319922,1805,20,N,N,-,-1,-1
TWOMEN.txt,318437,320439,2002,20,N,N,-,-1,-1
TWOMEN.txt,319010,320982,1972,20,N,N,-,-1,-1
TWOMEN.txt,319507,321392,1885,20,N,N,-,-1,-1
TWOMEN.txt,319924,321783,1859,20,N,N,-,-1,-1
TWOMEN.txt,320441,322316,1875,20,N,N,-,-1,-1
TWOMEN.txt,320983,322905,1922,20,N,N,-,-1,-1
TWOMEN.txt,321395,323235,1840,20,N,N,-,-1,-1
TWOMEN.txt,321784,323432,1648,20,N,N,-,-1,-1
TWOMEN.txt,322317,323922,1605,20,N,N,-,-1,-1
TWOMEN.txt,322907,324347,1440,20,N,N,-,-1,-1
TWOMEN.txt,323236,324702,1466,20,N,N,-,-1,-1
TWOMEN.txt,323433,325118,1685,20,N,N,-,-1,-1
TWOMEN.txt,323924,325621,1697,20,N,N,-,-1,-1
TWOMEN.txt,324348,326010,1662,20,N,N,-,-1,-1
TWOMEN.txt,324704,326208,1504,20,N,N,-,-1,-1
TWOMEN.txt,325120,326740,1620,20,N,N,-,-1,-1
TWOMEN.txt,325622,327157,1535,20,Y,N,-,-1,-1
TWOMEN.txt,326011,327547,1536,20,N,N,-,-1,-1
TWOMEN.txt,326209,328050,1841,20,N,N,-,-1,-1
TWOMEN.txt,326745,328482,1737,20,N,N,-,-1,-1
TWOMEN.txt,327158,328873,1715,20,N,N,-,-1,-1
TWOMEN.txt,327549,329330,1781,20,N,N,-,-1,-1
TWOMEN.txt,328052,330088,2036,20,N,N,-,-1,-1
TWOMEN.txt,328483,330554,2071,20,N,N,-,-1,-1
TWOMEN.txt,328874,331431,2557,20,Y,N,-,-1,-1
TWOMEN.txt,329332,332219,2887,20,Y,N,-,-1,-1
TWOMEN.txt,330089,332816,2727,20,Y,N,-,-1,-1
TWOMEN.txt,330555,333278,2723,20,Y,N,-,-1,-1
TWOMEN.txt,331432,333710,2278,20,N,N,-,-1,-1
TWOMEN.txt,332221,334049,1828,20,N,N,-,-1,-1
TWOMEN.txt,332817,334325,1508,20,N,N,-,-1,-1
TWOMEN.txt,333281,334677,1396,20,N,N,-,-1,-1
TWOMEN.txt,333711,335203,1492,20,N,N,-,-1,-1
TWOMEN.txt,334050,336010,1960,20,N,N,-,-1,-1
TWOMEN.txt,334328,336696,2368,20,N,N,-,-1,-1
TWOMEN.txt,334678,337020,2342,20,N,N,-,-1,-1
TWOMEN.txt,335204,337408,2204,20,Y,N,-,-1,-1
TWOMEN.txt,336011,337698,1687,20,N,N,-,-1,-1
TWOMEN.txt,336697,338047,1350,20,N,N,-,-1,-1
TWOMEN.txt,337021,338413,1392,20,N,N,-,-1,-1
TWOMEN.txt,337410,338959,1549,20,N,N,-,-1,-1
TWOMEN.txt,337701,339331,1630,20,N,N,-,-1,-1
TWOMEN.txt,338048,339599,1551,20,N,N,-,-1,-1
TWOMEN.txt,338414,340028,1614,20,N,N,-,-1,-1
TWOMEN.txt,338962,340333,1371,20,Y,N,-,-1,-1
TWOMEN.txt,339332,340559,1227,20,Y,N,-,-1,-1
TWOMEN.txt,339600,340848,1248,20,N,N,-,-1,-1
TWOMEN.txt,340029,340975,946,20,N,N,-,-1,-1
TWOMEN.txt,340334,341157,823,20,N,N,-,-1,-1
TWOMEN.txt,340560,341404,844,20,N,N,-,-1,-1
TWOMEN.txt,340849,341562,713,20,N,N,-,-1,-1
TWOMEN.txt,340978,342088,1110,20,N,N,-,-1,-1
TWOMEN.txt,341158,342971,1813,20,N,N,-,-1,-1
TWOMEN.txt,341405,343154,1749,20,N,N,-,-1,-1
TWOMEN.txt,341563,343379,1816,20,N,N,-,-1,-1
TWOMEN.txt,342089,343680,1591,20,N,N,-,-1,-1
TWOMEN.txt,342973,343942,969,20,N,N,-,-1,-1
TWOMEN.txt,343155,344008,853,20,N,N,-,-1,-1
TWOMEN.txt,343380,344178,798,20,N,N,-,-1,-1
TWOMEN.txt,343681,344437,756,20,N,N,-,-1,-1
TWOMEN.txt,343943,344816,873,20,N,N,-,-1,-1
TWOMEN.txt,344009,345213,1204,20,N,N,-,-1,-1
TWOMEN.txt,344179,345729,1550,20,N,N,-,-1,-1
TWOMEN.txt,344439,346026,1587,20,N,N,-,-1,-1
TWOMEN.txt,344819,346392,1573,20,N,N,-,-1,-1
TWOMEN.txt,345215,347428,2213,20,N,N,-,-1,-1
TWOMEN.txt,345730,347778,2048,20,N,N,-,-1,-1
TWOMEN.txt,346028,348211,2183,20,N,N,-,-1,-1
TWOMEN.txt,346393,348521,2128,20,N,N,-,-1,-1
TWOMEN.txt,347431,348970,1539,20,N,N,-,-1,-1
TWOMEN.txt,347780,349346,1566,20,N,N,-,-1,-1
TWOMEN.txt,348211,349780,1569,20,N,N,-,-1,-1
TWOMEN.txt,348521,350174,1653,20,N,N,-,-1,-1
TWOMEN.txt,348971,350387,1416,20,N,N,-,-1,-1
TWOMEN.txt,349348,350691,1343,20,N,N,-,-1,-1
TWOMEN.txt,349782,350936,1154,20,N,N,-,-1,-1
TWOMEN.txt,350175,351354,1179,20,N,N,-,-1,-1
TWOMEN.txt,350389,351919,1530,20,N,N,-,-1,-1
TWOMEN.txt,350692,352048,1356,20,N,N,-,-1,-1
TWOMEN.txt,350937,352332,1395,20,N,N,-,-1,-1
TWOMEN.txt,351356,352707,1351,20,N,N,-,-1,-1
TWOMEN.txt,351924,352899,975,20,N,N,-,-1,-1
TWOMEN.txt,352050,353377,1327,20,N,N,-,-1,-1
TWOMEN.txt,352332,353840,1508,20,N,N,-,-1,-1
TWOMEN.txt,352708,354225,1517,20,N,N,-,-1,-1
TWOMEN.txt,352899,354709,1810,20,N,N,-,-1,-1
TWOMEN.txt,353378,355103,1725,20,N,N,-,-1,-1
TWOMEN.txt,353840,355739,1899,20,N,N,-,-1,-1
TWOMEN.txt,354227,355971,1744,20,N,N,-,-1,-1
TWOMEN.txt,354710,356350,1640,20,N,N,-,-1,-1
TWOMEN.txt,355103,356557,1454,20,N,N,-,-1,-1
TWOMEN.txt,355740,357029,1289,20,N,N,-,-1,-1
TWOMEN.txt,355973,357479,1506,20,N,N,-,-1,-1
TWOMEN.txt,356352,357623,1271,20,N,N,-,-1,-1
TWOMEN.txt,356558,358025,1467,20,N,N,-,-1,-1
TWOMEN.txt,357034,358381,1347,20,N,N,-,-1,-1
TWOMEN.txt,357481,358904,1423,20,N,N,-,-1,-1
TWOMEN.txt,357625,359326,1701,20,N,N,-,-1,-1
TWOMEN.txt,358027,359707,1680,20,N,N,-,-1,-1
TWOMEN.txt,358383,360315,1932,20,N,N,-,-1,-1
TWOMEN.txt,358905,360636,1731,20,N,N,-,-1,-1
TWOMEN.txt,359327,361218,1891,20,N,N,-,-1,-1
TWOMEN.txt,359708,361853,2145,20,N,N,-,-1,-1
TWOMEN.txt,360316,362082,1766,20,N,N,-,-1,-1
TWOMEN.txt,360637,362397,1760,20,N,N,-,-1,-1
TWOMEN.txt,361220,363070,1850,20,N,N,-,-1,-1
TWOMEN.txt,361854,363610,1756,20,N,N,-,-1,-1
TWOMEN.txt,362087,364087,2000,20,N,N,-,-1,-1
TWOMEN.txt,362398,364365,1967,20,N,N,-,-1,-1
TWOMEN.txt,363071,364598,1527,20,N,N,-,-1,-1
TWOMEN.txt,363611,364726,1115,20,N,N,-,-1,-1
TWOMEN.txt,364088,364930,842,20,N,N,-,-1,-1
TWOMEN.txt,364366,365226,860,20,Y,N,-,-1,-1
TWOMEN.txt,364599,365401,802,20,N,N,-,-1,-1
TWOMEN.txt,364727,365928,1201,20,N,N,-,-1,-1
TWOMEN.txt,364931,366377,1446,20,N,N,-,-1,-1
TWOMEN.txt,365227,366556,1329,20,N,N,-,-1,-1
TWOMEN.txt,365403,367090,1687,20,N,N,-,-1,-1
TWOMEN.txt,365930,367528,1598,20,N,N,-,-1,-1
TWOMEN.txt,366378,367886,1508,20,N,N,-,-1,-1
TWOMEN.txt,366556,368706,2150,20,N,N,-,-1,-1
TWOMEN.txt,367091,369045,1954,20,N,N,-,-1,-1
TWOMEN.txt,367529,369288,1759,20,N,N,-,-1,-1
TWOMEN.txt,367888,369592,1704,20,N,N,-,-1,-1
TWOMEN.txt,368707,369657,950,20,N,N,-,-1,-1
TWOMEN.txt,369046,370111,1065,20,N,N,-,-1,-1
TWOMEN.txt,369289,370357,1068,20,N,N,-,-1,-1
TWOMEN.txt,369595,370550,955,20,N,N,-,-1,-1
TWOMEN.txt,369659,370946,1287,20,N,N,-,-1,-1
TWOMEN.txt,370112,371067,955,20,N,N,-,-1,-1
TWOMEN.txt,370358,371414,1056,20,N,N,-,-1,-1
TWOMEN.txt,370551,371935,1384,20,N,N,-,-1,-1
TWOMEN.txt,370949,372222,1273,20,N,N,-,-1,-1
TWOMEN.txt,371070,372651,1581,20,N,N,-,-1,-1
TWOMEN.txt,371419,373065,1646,20,N,N,-,-1,-1
TWOMEN.txt,371936,373575,1639,20,N,N,-,-1,-1
TWOMEN.txt,372225,374158,1933,20,N,N,-,-1,-1
TWOMEN.txt,372652,374495,1843,20,N,N,-,-1,-1
TWOMEN.txt,373066,374914,1848,20,N,N,-,-1,-1
TWOMEN.txt,373576,375253,1677,20,N,N,-,-1,-1
TWOMEN.txt,374161,375763,1602,20,N,N,-,-1,-1
TWOMEN.txt,374496,376268,1772,20,N,N,-,-1,-1
TWOMEN.txt,374915,376537,1622,20,N,N,-,-1,-1
TWOMEN.txt,375255,377411,2156,20,N,N,-,-1,-1
TWOMEN.txt,375764,377831,2067,20,N,N,-,-1,-1
TWOMEN.txt,376272,378431,2159,20,N,N,-,-1,-1
TWOMEN.txt,376538,378564,2026,20,N,N,-,-1,-1
TWOMEN.txt,377412,379111,1699,20,N,N,-,-1,-1
TWOMEN.txt,377836,379492,1656,20,N,N,-,-1,-1
TWOMEN.txt,378434,379735,1301,20,N,N,-,-1,-1
TWOMEN.txt,378565,380350,1785,20,N,N,-,-1,-1
TWOMEN.txt,379113,380600,1487,20,N,N,-,-1,-1
TWOMEN.txt,379494,381248,1754,20,N,N,-,-1,-1
TWOMEN.txt,379737,382155,2418,20,N,Y,1435574979068,381547,381864
TWOMEN.txt,380351,382585,2234,20,N,Y,1435574979068,381547,381864
TWOMEN.txt,380602,383075,2473,20,N,Y,1435574979068,381547,381864
TWOMEN.txt,381249,383441,2192,20,N,Y,1435574979068,381547,381864
TWOMEN.txt,382157,383726,1569,20,N,N,-,-1,-1
TWOMEN.txt,382586,384257,1671,20,N,N,-,-1,-1
TWOMEN.txt,383076,385183,2107,20,N,N,-,-1,-1
TWOMEN.txt,383442,385658,2216,20,N,N,-,-1,-1
TWOMEN.txt,383728,385865,2137,20,N,N,-,-1,-1
TWOMEN.txt,384258,386322,2064,20,N,N,-,-1,-1
TWOMEN.txt,385184,386537,1353,20,N,N,-,-1,-1
TWOMEN.txt,385659,387078,1419,20,N,N,-,-1,-1
TWOMEN.txt,385867,387611,1744,20,N,N,-,-1,-1
TWOMEN.txt,386323,388026,1703,20,N,N,-,-1,-1
TWOMEN.txt,386539,388750,2211,20,N,N,-,-1,-1
TWOMEN.txt,387080,389330,2250,20,N,N,-,-1,-1
TWOMEN.txt,387616,389792,2176,20,N,N,-,-1,-1
TWOMEN.txt,388027,390572,2545,20,N,N,-,-1,-1
TWOMEN.txt,388751,391048,2297,20,Y,N,-,-1,-1
TWOMEN.txt,389331,391393,2062,20,N,N,-,-1,-1
TWOMEN.txt,389793,391839,2046,20,N,N,-,-1,-1
TWOMEN.txt,390574,392350,1776,20,N,N,-,-1,-1
TWOMEN.txt,391051,392829,1778,20,N,N,-,-1,-1
TWOMEN.txt,391394,393085,1691,20,N,N,-,-1,-1
TWOMEN.txt,391840,393527,1687,20,N,N,-,-1,-1
TWOMEN.txt,392351,393982,1631,20,N,N,-,-1,-1
TWOMEN.txt,392830,394120,1290,20,N,N,-,-1,-1
TWOMEN.txt,393087,394445,1358,20,N,N,-,-1,-1
TWOMEN.txt,393527,394643,1116,20,N,N,-,-1,-1
TWOMEN.txt,393983,395161,1178,20,N,N,-,-1,-1
TWOMEN.txt,394121,395401,1280,20,N,N,-,-1,-1
TWOMEN.txt,394446,395880,1434,20,N,N,-,-1,-1
TWOMEN.txt,394645,396467,1822,20,N,N,-,-1,-1
TWOMEN.txt,395166,397041,1875,20,N,N,-,-1,-1
TWOMEN.txt,395402,397657,2255,20,N,N,-,-1,-1
TWOMEN.txt,395881,398018,2137,20,N,N,-,-1,-1
TWOMEN.txt,396468,398489,2021,20,N,N,-,-1,-1
TWOMEN.txt,397042,398716,1674,20,N,N,-,-1,-1
TWOMEN.txt,397658,398946,1288,20,N,N,-,-1,-1
TWOMEN.txt,398019,399390,1371,20,N,N,-,-1,-1
TWOMEN.txt,398490,399616,1126,20,N,N,-,-1,-1
TWOMEN.txt,398718,399791,1073,20,N,N,-,-1,-1
TWOMEN.txt,398946,400395,1449,20,N,N,-,-1,-1
TWOMEN.txt,399392,400635,1243,20,N,N,-,-1,-1
TWOMEN.txt,399617,401360,1743,20,N,N,-,-1,-1
TWOMEN.txt,399792,401848,2056,20,N,N,-,-1,-1
TWOMEN.txt,400397,402352,1955,20,N,N,-,-1,-1
TWOMEN.txt,400635,402814,2179,20,N,N,-,-1,-1
TWOMEN.txt,401361,403634,2273,20,N,N,-,-1,-1
TWOMEN.txt,401849,404227,2378,20,N,N,-,-1,-1
TWOMEN.txt,402354,404535,2181,20,N,N,-,-1,-1
TWOMEN.txt,402815,405256,2441,20,N,N,-,-1,-1
TWOMEN.txt,403635,405576,1941,20,N,N,-,-1,-1
TWOMEN.txt,404228,405902,1674,20,N,N,-,-1,-1
TWOMEN.txt,404536,406974,2438,20,N,N,-,-1,-1
TWOMEN.txt,405257,407260,2003,20,N,N,-,-1,-1
TWOMEN.txt,405577,407676,2099,20,N,N,-,-1,-1
TWOMEN.txt,405904,407956,2052,20,N,N,-,-1,-1
TWOMEN.txt,406975,408550,1575,20,N,N,-,-1,-1
TWOMEN.txt,407261,408979,1718,20,N,N,-,-1,-1
TWOMEN.txt,407677,409241,1564,20,N,N,-,-1,-1
TWOMEN.txt,407957,409732,1775,20,N,N,-,-1,-1
TWOMEN.txt,408552,410059,1507,20,N,N,-,-1,-1
TWOMEN.txt,408980,410341,1361,20,N,N,-,-1,-1
TWOMEN.txt,409243,410407,1164,20,N,N,-,-1,-1
TWOMEN.txt,409733,410732,999,20,N,N,-,-1,-1
TWOMEN.txt,410062,410966,904,20,N,N,-,-1,-1
TWOMEN.txt,410342,411125,783,20,N,N,-,-1,-1
TWOMEN.txt,410410,411380,970,20,N,N,-,-1,-1
TWOMEN.txt,410734,412155,1421,20,N,N,-,-1,-1
TWOMEN.txt,410967,412864,1897,20,N,N,-,-1,-1
TWOMEN.txt,411126,413236,2110,20,N,N,-,-1,-1
TWOMEN.txt,411381,415102,3721,20,N,N,-,-1,-1
TWOMEN.txt,412157,415305,3148,20,N,N,-,-1,-1
TWOMEN.txt,412867,415645,2778,20,N,N,-,-1,-1
TWOMEN.txt,413237,415992,2755,20,N,N,-,-1,-1
TWOMEN.txt,415104,416338,1234,20,N,N,-,-1,-1
TWOMEN.txt,415307,416691,1384,20,N,N,-,-1,-1
TWOMEN.txt,415646,417447,1801,20,N,N,-,-1,-1
TWOMEN.txt,415993,417760,1767,20,N,N,-,-1,-1
TWOMEN.txt,416343,417952,1609,20,N,N,-,-1,-1
TWOMEN.txt,416692,418281,1589,20,N,N,-,-1,-1
TWOMEN.txt,417448,418773,1325,20,N,N,-,-1,-1
TWOMEN.txt,417762,419289,1527,20,Y,N,-,-1,-1
TWOMEN.txt,417954,419756,1802,20,Y,N,-,-1,-1
TWOMEN.txt,418283,420169,1886,20,N,N,-,-1,-1
TWOMEN.txt,418775,420995,2220,20,N,N,-,-1,-1
TWOMEN.txt,419291,421368,2077,20,N,N,-,-1,-1
TWOMEN.txt,419758,421859,2101,20,N,N,-,-1,-1
TWOMEN.txt,420170,422358,2188,20,N,N,-,-1,-1
TWOMEN.txt,420997,423103,2106,20,N,N,-,-1,-1
TWOMEN.txt,421369,423612,2243,20,N,N,-,-1,-1
TWOMEN.txt,421862,424170,2308,20,N,N,-,-1,-1
TWOMEN.txt,422362,424606,2244,20,N,N,-,-1,-1
TWOMEN.txt,423104,425463,2359,20,N,N,-,-1,-1
TWOMEN.txt,423613,425942,2329,20,N,N,-,-1,-1
TWOMEN.txt,424171,426856,2685,20,N,N,-,-1,-1
TWOMEN.txt,424607,427198,2591,20,N,N,-,-1,-1
TWOMEN.txt,425464,427658,2194,20,N,N,-,-1,-1
TWOMEN.txt,425943,428410,2467,20,N,N,-,-1,-1
TWOMEN.txt,426858,428923,2065,20,N,N,-,-1,-1
TWOMEN.txt,427198,429288,2090,20,N,N,-,-1,-1
TWOMEN.txt,427659,429709,2050,20,N,N,-,-1,-1
TWOMEN.txt,428411,430393,1982,20,N,N,-,-1,-1
TWOMEN.txt,428924,431363,2439,20,N,N,-,-1,-1
TWOMEN.txt,429289,431720,2431,20,N,N,-,-1,-1
TWOMEN.txt,429710,432271,2561,20,N,N,-,-1,-1
TWOMEN.txt,430395,432905,2510,20,N,N,-,-1,-1
TWOMEN.txt,431364,433830,2466,20,N,N,-,-1,-1
TWOMEN.txt,431721,434170,2449,20,N,N,-,-1,-1
TWOMEN.txt,432272,435150,2878,20,N,N,-,-1,-1
TWOMEN.txt,432906,435495,2589,20,N,N,-,-1,-1
TWOMEN.txt,433831,436066,2235,20,N,N,-,-1,-1
TWOMEN.txt,434172,436500,2328,20,N,N,-,-1,-1
TWOMEN.txt,435151,437333,2182,20,N,N,-,-1,-1
TWOMEN.txt,435496,438090,2594,20,N,N,-,-1,-1
TWOMEN.txt,436067,438215,2148,20,N,N,-,-1,-1
TWOMEN.txt,436501,439150,2649,20,N,N,-,-1,-1
TWOMEN.txt,437334,439897,2563,20,N,N,-,-1,-1
TWOMEN.txt,438091,440247,2156,20,N,N,-,-1,-1
TWOMEN.txt,438216,440737,2521,20,N,N,-,-1,-1
TWOMEN.txt,439152,441444,2292,20,N,N,-,-1,-1
TWOMEN.txt,439898,441841,1943,20,N,N,-,-1,-1
TWOMEN.txt,440248,442985,2737,20,N,N,-,-1,-1
TWOMEN.txt,440738,443339,2601,20,N,N,-,-1,-1
TWOMEN.txt,441445,443922,2477,20,N,N,-,-1,-1
TWOMEN.txt,441842,444316,2474,20,N,Y,1435577123675,444026,444632
TWOMEN.txt,442987,444903,1916,20,Y,Y,1435577123675,444026,444632
TWOMEN.txt,443340,445473,2133,20,Y,Y,1435577123675,444026,444632
TWOMEN.txt,443923,445596,1673,20,N,Y,1435577123675,444026,444632
TWOMEN.txt,444317,446077,1760,20,N,Y,1435577123675,444026,444632
TWOMEN.txt,444904,446703,1799,20,N,N,-,-1,-1
TWOMEN.txt,445474,446996,1522,20,N,N,-,-1,-1
TWOMEN.txt,445597,447388,1791,20,N,N,-,-1,-1
TWOMEN.txt,446078,447705,1627,20,N,N,-,-1,-1
TWOMEN.txt,446704,448321,1617,20,N,N,-,-1,-1
TWOMEN.txt,446998,448962,1964,20,N,N,-,-1,-1
TWOMEN.txt,447389,449204,1815,20,N,N,-,-1,-1
TWOMEN.txt,447707,450112,2405,20,N,N,-,-1,-1
TWOMEN.txt,448323,450589,2266,20,N,N,-,-1,-1
TWOMEN.txt,448965,451063,2098,20,N,N,-,-1,-1
TWOMEN.txt,449205,451228,2023,20,N,N,-,-1,-1
TWOMEN.txt,450114,451848,1734,20,N,N,-,-1,-1
TWOMEN.txt,450591,452045,1454,20,N,N,-,-1,-1
TWOMEN.txt,451066,452242,1176,20,N,N,-,-1,-1
TWOMEN.txt,451229,452632,1403,20,N,N,-,-1,-1
TWOMEN.txt,451848,453345,1497,20,N,N,-,-1,-1
TWOMEN.txt,452046,454100,2054,20,N,N,-,-1,-1
TWOMEN.txt,452242,454801,2559,20,N,N,-,-1,-1
TWOMEN.txt,452634,455127,2493,20,N,N,-,-1,-1
TWOMEN.txt,453347,455346,1999,20,N,N,-,-1,-1
TWOMEN.txt,454101,455687,1586,20,N,N,-,-1,-1
TWOMEN.txt,454802,456316,1514,20,N,N,-,-1,-1
TWOMEN.txt,455129,456843,1714,20,N,N,-,-1,-1
TWOMEN.txt,455347,457418,2071,20,N,N,-,-1,-1
TWOMEN.txt,455689,457762,2073,20,N,N,-,-1,-1
TWOMEN.txt,456317,457899,1582,20,N,N,-,-1,-1
TWOMEN.txt,456843,458407,1564,20,N,N,-,-1,-1
TWOMEN.txt,457419,459186,1767,20,N,N,-,-1,-1
TWOMEN.txt,457763,459739,1976,20,N,N,-,-1,-1
TWOMEN.txt,457901,460805,2904,20,N,N,-,-1,-1
TWOMEN.txt,458409,461463,3054,20,N,N,-,-1,-1
TWOMEN.txt,459187,462086,2899,20,N,N,-,-1,-1
TWOMEN.txt,459740,462776,3036,20,N,N,-,-1,-1
TWOMEN.txt,460806,463213,2407,20,N,N,-,-1,-1
TWOMEN.txt,461464,463505,2041,20,N,N,-,-1,-1
TWOMEN.txt,462087,464442,2355,20,N,N,-,-1,-1
TWOMEN.txt,462778,465311,2533,20,N,N,-,-1,-1
TWOMEN.txt,463214,465694,2480,20,N,N,-,-1,-1
TWOMEN.txt,463507,466216,2709,20,N,N,-,-1,-1
TWOMEN.txt,464443,466564,2121,20,N,N,-,-1,-1
TWOMEN.txt,465312,467585,2273,20,N,N,-,-1,-1
TWOMEN.txt,465695,468169,2474,20,N,N,-,-1,-1
TWOMEN.txt,466216,468616,2400,20,N,N,-,-1,-1
TWOMEN.txt,466565,469356,2791,20,N,N,-,-1,-1
TWOMEN.txt,467587,469637,2050,20,N,N,-,-1,-1
TWOMEN.txt,468171,470005,1834,20,N,N,-,-1,-1
TWOMEN.txt,468618,470105,1487,20,N,N,-,-1,-1
TWOMEN.txt,469357,470515,1158,20,N,N,-,-1,-1
TWOMEN.txt,469639,471494,1855,20,N,N,-,-1,-1
TWOMEN.txt,470005,472296,2291,20,N,N,-,-1,-1
TWOMEN.txt,470106,473140,3034,20,N,N,-,-1,-1
TWOMEN.txt,470516,474017,3501,20,N,N,-,-1,-1
TWOMEN.txt,471496,474730,3234,20,N,N,-,-1,-1
TWOMEN.txt,472297,475105,2808,20,N,N,-,-1,-1
TWOMEN.txt,473141,476094,2953,20,N,N,-,-1,-1
TWOMEN.txt,474017,476567,2550,20,N,N,-,-1,-1
TWOMEN.txt,474731,477246,2515,20,N,N,-,-1,-1
TWOMEN.txt,475106,478088,2982,20,N,N,-,-1,-1
TWOMEN.txt,476095,478498,2403,20,N,N,-,-1,-1
TWOMEN.txt,476569,478526,1957,20,N,N,-,-1,-1
TWOMEN.txt,477247,478806,1559,20,N,N,-,-1,-1
TWOMEN.txt,478089,478983,894,20,N,N,-,-1,-1
TWOMEN.txt,478499,479530,1031,20,N,N,-,-1,-1
TWOMEN.txt,478527,479945,1418,20,N,N,-,-1,-1
TWOMEN.txt,478807,480326,1519,20,N,N,-,-1,-1
TWOMEN.txt,478984,480908,1924,20,N,N,-,-1,-1
TWOMEN.txt,479534,481206,1672,20,N,N,-,-1,-1
TWOMEN.txt,479947,481736,1789,20,N,N,-,-1,-1
TWOMEN.txt,480327,481994,1667,20,N,N,-,-1,-1
TWOMEN.txt,480911,482490,1579,20,N,N,-,-1,-1
TWOMEN.txt,481207,483027,1820,20,N,N,-,-1,-1
TWOMEN.txt,481736,483441,1705,20,N,N,-,-1,-1
TWOMEN.txt,481996,484018,2022,20,N,N,-,-1,-1
TWOMEN.txt,482490,484530,2040,20,N,N,-,-1,-1
TWOMEN.txt,483028,484816,1788,20,N,N,-,-1,-1
TWOMEN.txt,483442,485365,1923,20,N,N,-,-1,-1
TWOMEN.txt,484019,485792,1773,20,N,N,-,-1,-1
TWOMEN.txt,484531,486757,2226,20,N,N,-,-1,-1
TWOMEN.txt,484819,487613,2794,20,N,N,-,-1,-1
TWOMEN.txt,485366,488249,2883,20,N,N,-,-1,-1
TWOMEN.txt,485794,488745,2951,20,N,N,-,-1,-1
TWOMEN.txt,486758,489325,2567,20,N,N,-,-1,-1
TWOMEN.txt,487614,489962,2348,20,N,N,-,-1,-1
TWOMEN.txt,488254,490280,2026,20,N,N,-,-1,-1
TWOMEN.txt,488746,491456,2710,20,N,N,-,-1,-1
TWOMEN.txt,489326,492132,2806,20,Y,N,-,-1,-1
TWOMEN.txt,489963,492809,2846,20,Y,N,-,-1,-1
TWOMEN.txt,490281,493702,3421,20,Y,N,-,-1,-1
WESLEY.txt,1,9161,9160,20,N,N,-,-1,-1
WESLEY.txt,1045,11330,10285,20,N,N,-,-1,-1
WESLEY.txt,3982,14013,10031,20,N,N,-,-1,-1
WESLEY.txt,6282,14612,8330,20,N,N,-,-1,-1
WESLEY.txt,9162,15087,5925,20,N,N,-,-1,-1
WESLEY.txt,11331,15427,4096,20,N,N,-,-1,-1
WESLEY.txt,14014,16895,2881,20,N,N,-,-1,-1
WESLEY.txt,14613,17593,2980,20,N,N,-,-1,-1
WESLEY.txt,15088,18249,3161,20,N,N,-,-1,-1
WESLEY.txt,15428,18979,3551,20,N,N,-,-1,-1
WESLEY.txt,16896,19695,2799,20,Y,N,-,-1,-1
WESLEY.txt,17594,20243,2649,20,Y,N,-,-1,-1
WESLEY.txt,18250,20832,2582,20,Y,N,-,-1,-1
WESLEY.txt,18980,21355,2375,20,Y,N,-,-1,-1
WESLEY.txt,19696,22037,2341,20,Y,N,-,-1,-1
WESLEY.txt,20244,22537,2293,20,Y,N,-,-1,-1
WESLEY.txt,20833,23027,2194,20,Y,N,-,-1,-1
WESLEY.txt,21356,23730,2374,20,Y,N,-,-1,-1
WESLEY.txt,22038,24691,2653,20,Y,N,-,-1,-1
WESLEY.txt,22538,25858,3320,20,Y,N,-,-1,-1
WESLEY.txt,23028,26608,3580,20,Y,N,-,-1,-1
WESLEY.txt,23731,27796,4065,20,Y,N,-,-1,-1
WESLEY.txt,24692,28627,3935,20,N,N,-,-1,-1
WESLEY.txt,25859,29124,3265,20,N,N,-,-1,-1
WESLEY.txt,26609,29636,3027,20,N,N,-,-1,-1
WESLEY.txt,27797,30463,2666,20,N,N,-,-1,-1
WESLEY.txt,28628,30892,2264,20,N,N,-,-1,-1
WESLEY.txt,29125,31617,2492,20,N,N,-,-1,-1
WESLEY.txt,29637,32192,2555,20,N,N,-,-1,-1
WESLEY.txt,30464,32697,2233,20,N,N,-,-1,-1
WESLEY.txt,30893,33516,2623,20,N,N,-,-1,-1
WESLEY.txt,31618,34436,2818,20,N,N,-,-1,-1
WESLEY.txt,32193,35212,3019,20,Y,N,-,-1,-1
WESLEY.txt,32698,35679,2981,20,Y,N,-,-1,-1
WESLEY.txt,33517,36269,2752,20,Y,N,-,-1,-1
WESLEY.txt,34437,37279,2842,20,Y,N,-,-1,-1
WESLEY.txt,35213,37810,2597,20,Y,N,-,-1,-1
WESLEY.txt,35680,38241,2561,20,N,N,-,-1,-1
WESLEY.txt,36270,38778,2508,20,N,N,-,-1,-1
WESLEY.txt,37280,39452,2172,20,N,N,-,-1,-1
WESLEY.txt,37811,40591,2780,20,N,N,-,-1,-1
WESLEY.txt,38242,41030,2788,20,N,N,-,-1,-1
WESLEY.txt,38779,41696,2917,20,N,N,-,-1,-1
WESLEY.txt,39453,42163,2710,20,N,N,-,-1,-1
WESLEY.txt,40592,42938,2346,20,Y,N,-,-1,-1
WESLEY.txt,41031,43626,2595,20,Y,N,-,-1,-1
WESLEY.txt,41697,44248,2551,20,Y,N,-,-1,-1
WESLEY.txt,42164,44718,2554,20,Y,N,-,-1,-1
WESLEY.txt,42939,45312,2373,20,Y,N,-,-1,-1
WESLEY.txt,43626,46015,2389,20,Y,N,-,-1,-1
WESLEY.txt,44249,46761,2512,20,Y,N,-,-1,-1
WESLEY.txt,44719,47192,2473,20,Y,N,-,-1,-1
WESLEY.txt,45314,47975,2661,20,N,N,-,-1,-1
WESLEY.txt,46017,48449,2432,20,N,N,-,-1,-1
WESLEY.txt,46762,49191,2429,20,Y,N,-,-1,-1
WESLEY.txt,47193,49655,2462,20,Y,N,-,-1,-1
WESLEY.txt,47976,50588,2612,20,N,N,-,-1,-1
WESLEY.txt,48450,51242,2792,20,Y,N,-,-1,-1
WESLEY.txt,49192,51967,2775,20,N,N,-,-1,-1
WESLEY.txt,49656,52459,2803,20,N,N,-,-1,-1
WESLEY.txt,50589,52903,2314,20,N,N,-,-1,-1
WESLEY.txt,51243,53364,2121,20,N,N,-,-1,-1
WESLEY.txt,51968,53824,1856,20,N,N,-,-1,-1
WESLEY.txt,52460,54590,2130,20,N,N,-,-1,-1
WESLEY.txt,52904,55157,2253,20,N,N,-,-1,-1
WESLEY.txt,53365,56031,2666,20,N,N,-,-1,-1
WESLEY.txt,53825,56800,2975,20,N,N,-,-1,-1
WESLEY.txt,54591,57385,2794,20,N,N,-,-1,-1
WESLEY.txt,55158,58189,3031,20,Y,N,-,-1,-1
WESLEY.txt,56032,59563,3531,20,N,N,-,-1,-1
WESLEY.txt,56801,60689,3888,20,N,N,-,-1,-1
WESLEY.txt,57386,61279,3893,20,N,N,-,-1,-1
WESLEY.txt,58190,61808,3618,20,N,N,-,-1,-1
WESLEY.txt,59564,62061,2497,20,N,N,-,-1,-1
WESLEY.txt,60690,62420,1730,20,N,N,-,-1,-1
WESLEY.txt,61279,62928,1649,20,N,N,-,-1,-1
WESLEY.txt,61809,63529,1720,20,N,N,-,-1,-1
WESLEY.txt,62062,63809,1747,20,N,N,-,-1,-1
WESLEY.txt,62421,64185,1764,20,N,N,-,-1,-1
WESLEY.txt,62929,64693,1764,20,N,N,-,-1,-1
WESLEY.txt,63530,64994,1464,20,N,N,-,-1,-1
WESLEY.txt,63810,65516,1706,20,N,N,-,-1,-1
WESLEY.txt,64186,65827,1641,20,N,N,-,-1,-1
WESLEY.txt,64694,66329,1635,20,N,N,-,-1,-1
WESLEY.txt,64994,66495,1501,20,N,N,-,-1,-1
WESLEY.txt,65517,67108,1591,20,N,N,-,-1,-1
WESLEY.txt,65828,67586,1758,20,N,N,-,-1,-1
WESLEY.txt,66330,67836,1506,20,N,N,-,-1,-1
WESLEY.txt,66496,68186,1690,20,N,N,-,-1,-1
WESLEY.txt,67109,68573,1464,20,N,N,-,-1,-1
WESLEY.txt,67587,68901,1314,20,N,N,-,-1,-1
WESLEY.txt,67837,69257,1420,20,N,N,-,-1,-1
WESLEY.txt,68187,69538,1351,20,N,N,-,-1,-1
WESLEY.txt,68574,69728,1154,20,N,N,-,-1,-1
WESLEY.txt,68902,70209,1307,20,N,N,-,-1,-1
WESLEY.txt,69258,70651,1393,20,N,N,-,-1,-1
WESLEY.txt,69540,71025,1485,20,N,N,-,-1,-1
WESLEY.txt,69729,72322,2593,20,N,N,-,-1,-1
WESLEY.txt,70210,72709,2499,20,N,N,-,-1,-1
WESLEY.txt,70652,73261,2609,20,N,N,-,-1,-1
WESLEY.txt,71026,74225,3199,20,N,N,-,-1,-1
WESLEY.txt,72322,74650,2328,20,N,N,-,-1,-1
WESLEY.txt,72710,75028,2318,20,N,N,-,-1,-1
WESLEY.txt,73262,75366,2104,20,N,N,-,-1,-1
WESLEY.txt,74226,75919,1693,20,N,N,-,-1,-1
WESLEY.txt,74650,76291,1641,20,N,N,-,-1,-1
WESLEY.txt,75029,76459,1430,20,N,N,-,-1,-1
WESLEY.txt,75367,76928,1561,20,N,N,-,-1,-1
WESLEY.txt,75920,77302,1382,20,Y,N,-,-1,-1
WESLEY.txt,76292,77791,1499,20,Y,N,-,-1,-1
WESLEY.txt,76461,78439,1978,20,Y,N,-,-1,-1
WESLEY.txt,76929,79080,2151,20,N,N,-,-1,-1
WESLEY.txt,77303,79751,2448,20,N,N,-,-1,-1
WESLEY.txt,77792,80291,2499,20,N,N,-,-1,-1
WESLEY.txt,78440,81194,2754,20,N,N,-,-1,-1
WESLEY.txt,79081,81842,2761,20,N,N,-,-1,-1
WESLEY.txt,79752,82710,2958,20,N,N,-,-1,-1
WESLEY.txt,80292,83101,2809,20,N,N,-,-1,-1
WESLEY.txt,81195,83562,2367,20,N,N,-,-1,-1
WESLEY.txt,81843,84315,2472,20,N,N,-,-1,-1
WESLEY.txt,82711,85161,2450,20,N,N,-,-1,-1
WESLEY.txt,83101,85611,2510,20,N,N,-,-1,-1
WESLEY.txt,83562,85934,2372,20,N,N,-,-1,-1
WESLEY.txt,84316,86684,2368,20,N,N,-,-1,-1
WESLEY.txt,85162,86823,1661,20,N,N,-,-1,-1
WESLEY.txt,85612,87273,1661,20,N,N,-,-1,-1
WESLEY.txt,85935,87676,1741,20,N,N,-,-1,-1
WESLEY.txt,86685,88329,1644,20,N,N,-,-1,-1
WESLEY.txt,86824,88937,2113,20,N,N,-,-1,-1
WESLEY.txt,87273,89649,2376,20,N,N,-,-1,-1
WESLEY.txt,87677,90542,2865,20,N,N,-,-1,-1
WESLEY.txt,88330,91016,2686,20,N,N,-,-1,-1
WESLEY.txt,88938,91167,2229,20,N,N,-,-1,-1
WESLEY.txt,89650,91371,1721,20,N,N,-,-1,-1
WESLEY.txt,90543,91600,1057,20,N,N,-,-1,-1
WESLEY.txt,91017,91947,930,20,N,N,-,-1,-1
WESLEY.txt,91168,92803,1635,20,N,N,-,-1,-1
WESLEY.txt,91372,93511,2139,20,N,N,-,-1,-1
WESLEY.txt,91601,94503,2902,20,N,N,-,-1,-1
WESLEY.txt,91948,95117,3169,20,N,N,-,-1,-1
WESLEY.txt,92804,95503,2699,20,N,N,-,-1,-1
WESLEY.txt,93512,95948,2436,20,N,N,-,-1,-1
WESLEY.txt,94504,96401,1897,20,N,N,-,-1,-1
WESLEY.txt,95118,97512,2394,20,N,N,-,-1,-1
WESLEY.txt,95504,98151,2647,20,N,N,-,-1,-1
WESLEY.txt,95949,98716,2767,20,N,N,-,-1,-1
WESLEY.txt,96402,99485,3083,20,N,N,-,-1,-1
WESLEY.txt,97513,99993,2480,20,N,N,-,-1,-1
WESLEY.txt,98152,100786,2634,20,N,N,-,-1,-1
WESLEY.txt,98716,101151,2435,20,N,N,-,-1,-1
WESLEY.txt,99486,101744,2258,20,N,N,-,-1,-1
WESLEY.txt,99994,102169,2175,20,N,N,-,-1,-1
WESLEY.txt,100787,102423,1636,20,N,N,-,-1,-1
WESLEY.txt,101152,102883,1731,20,N,N,-,-1,-1
WESLEY.txt,101745,103339,1594,20,N,N,-,-1,-1
WESLEY.txt,102170,103886,1716,20,N,N,-,-1,-1
WESLEY.txt,102424,104277,1853,20,N,N,-,-1,-1
WESLEY.txt,102884,104861,1977,20,N,N,-,-1,-1
WESLEY.txt,103340,105184,1844,20,N,N,-,-1,-1
WESLEY.txt,103886,105447,1561,20,N,N,-,-1,-1
WESLEY.txt,104278,105570,1292,20,N,N,-,-1,-1
WESLEY.txt,104862,106382,1520,20,N,N,-,-1,-1
WESLEY.txt,105185,107201,2016,20,N,N,-,-1,-1
WESLEY.txt,105448,107759,2311,20,N,N,-,-1,-1
WESLEY.txt,105571,108287,2716,20,N,N,-,-1,-1
WESLEY.txt,106382,108775,2393,20,N,N,-,-1,-1
WESLEY.txt,107202,109239,2037,20,N,N,-,-1,-1
WESLEY.txt,107760,109779,2019,20,N,N,-,-1,-1
WESLEY.txt,108288,110118,1830,20,N,N,-,-1,-1
WESLEY.txt,108776,110567,1791,20,N,N,-,-1,-1
WESLEY.txt,109240,110895,1655,20,N,N,-,-1,-1
WESLEY.txt,109780,111154,1374,20,N,N,-,-1,-1
WESLEY.txt,110120,111624,1504,20,N,N,-,-1,-1
WESLEY.txt,110568,112136,1568,20,N,N,-,-1,-1
WESLEY.txt,110895,112478,1583,20,N,N,-,-1,-1
WESLEY.txt,111155,112819,1664,20,N,N,-,-1,-1
WESLEY.txt,111625,113517,1892,20,N,N,-,-1,-1
WESLEY.txt,112137,113742,1605,20,N,N,-,-1,-1
WESLEY.txt,112478,114354,1876,20,N,N,-,-1,-1
WESLEY.txt,112820,114631,1811,20,N,N,-,-1,-1
WESLEY.txt,113518,115129,1611,20,N,N,-,-1,-1
WESLEY.txt,113743,115373,1630,20,N,N,-,-1,-1
WESLEY.txt,114355,115759,1404,20,N,N,-,-1,-1
WESLEY.txt,114632,116431,1799,20,N,N,-,-1,-1
WESLEY.txt,115130,116930,1800,20,N,N,-,-1,-1
WESLEY.txt,115374,117692,2318,20,N,N,-,-1,-1
WESLEY.txt,115760,118432,2672,20,N,N,-,-1,-1
WESLEY.txt,116432,118928,2496,20,N,N,-,-1,-1
WESLEY.txt,116931,119305,2374,20,N,N,-,-1,-1
WESLEY.txt,117694,120057,2363,20,N,N,-,-1,-1
WESLEY.txt,118433,120470,2037,20,N,N,-,-1,-1
WESLEY.txt,118929,121040,2111,20,N,N,-,-1,-1
WESLEY.txt,119306,121674,2368,20,N,N,-,-1,-1
WESLEY.txt,120058,122189,2131,20,N,N,-,-1,-1
WESLEY.txt,120471,122711,2240,20,N,N,-,-1,-1
WESLEY.txt,121041,123292,2251,20,N,N,-,-1,-1
WESLEY.txt,121675,123770,2095,20,N,N,-,-1,-1
WESLEY.txt,122190,124651,2461,20,N,N,-,-1,-1
WESLEY.txt,122712,125280,2568,20,N,N,-,-1,-1
WESLEY.txt,123293,125599,2306,20,N,N,-,-1,-1
WESLEY.txt,123771,126000,2229,20,N,N,-,-1,-1
WESLEY.txt,124652,126329,1677,20,N,N,-,-1,-1
WESLEY.txt,125281,126822,1541,20,N,N,-,-1,-1
WESLEY.txt,125600,127127,1527,20,N,N,-,-1,-1
WESLEY.txt,126001,127652,1651,20,N,N,-,-1,-1
WESLEY.txt,126330,128146,1816,20,N,N,-,-1,-1
WESLEY.txt,126823,128758,1935,20,N,N,-,-1,-1
WESLEY.txt,127127,129368,2241,20,N,N,-,-1,-1
WESLEY.txt,127653,129980,2327,20,N,N,-,-1,-1
WESLEY.txt,128147,130274,2127,20,N,N,-,-1,-1
WESLEY.txt,128759,130839,2080,20,N,N,-,-1,-1
WESLEY.txt,129369,131322,1953,20,Y,N,-,-1,-1
WESLEY.txt,129981,131906,1925,20,N,N,-,-1,-1
WESLEY.txt,130274,132473,2199,20,Y,N,-,-1,-1
WESLEY.txt,130840,132752,1912,20,N,N,-,-1,-1
WESLEY.txt,131323,133113,1790,20,N,N,-,-1,-1
WESLEY.txt,131907,133498,1591,20,N,N,-,-1,-1
WESLEY.txt,132474,134286,1812,20,N,N,-,-1,-1
WESLEY.txt,132753,134600,1847,20,N,N,-,-1,-1
WESLEY.txt,133114,135305,2191,20,N,N,-,-1,-1
WESLEY.txt,133498,136010,2512,20,N,N,-,-1,-1
WESLEY.txt,134287,136353,2066,20,N,N,-,-1,-1
WESLEY.txt,134601,137005,2404,20,N,N,-,-1,-1
WESLEY.txt,135305,137558,2253,20,N,N,-,-1,-1
WESLEY.txt,136010,138501,2491,20,N,N,-,-1,-1
WESLEY.txt,136354,139631,3277,20,N,N,-,-1,-1
WESLEY.txt,137006,140458,3452,20,N,N,-,-1,-1
WESLEY.txt,137558,141276,3718,20,N,N,-,-1,-1
WESLEY.txt,138502,141771,3269,20,Y,N,-,-1,-1
WESLEY.txt,139632,142629,2997,20,N,N,-,-1,-1
WESLEY.txt,140459,143507,3048,20,N,N,-,-1,-1
WESLEY.txt,141278,144184,2906,20,N,N,-,-1,-1
WESLEY.txt,141772,144834,3062,20,N,N,-,-1,-1
WESLEY.txt,142630,145220,2590,20,N,N,-,-1,-1
WESLEY.txt,143508,145430,1922,20,N,N,-,-1,-1
WESLEY.txt,144185,145902,1717,20,N,N,-,-1,-1
WESLEY.txt,144835,146402,1567,20,N,N,-,-1,-1
WESLEY.txt,145221,146907,1686,20,N,N,-,-1,-1
WESLEY.txt,145431,147573,2142,20,N,N,-,-1,-1
WESLEY.txt,145903,148288,2385,20,Y,N,-,-1,-1
WESLEY.txt,146403,149158,2755,20,Y,N,-,-1,-1
WESLEY.txt,146908,149646,2738,20,Y,N,-,-1,-1
WESLEY.txt,147574,150302,2728,20,Y,N,-,-1,-1
WESLEY.txt,148289,151109,2820,20,N,N,-,-1,-1
WESLEY.txt,149159,151729,2570,20,N,N,-,-1,-1
WESLEY.txt,149647,152378,2731,20,N,N,-,-1,-1
WESLEY.txt,150303,152893,2590,20,N,N,-,-1,-1
WESLEY.txt,151110,153163,2053,20,N,N,-,-1,-1
WESLEY.txt,151730,153526,1796,20,N,N,-,-1,-1
WESLEY.txt,152379,154342,1963,20,N,N,-,-1,-1
WESLEY.txt,152894,154854,1960,20,N,N,-,-1,-1
WESLEY.txt,153164,155165,2001,20,N,N,-,-1,-1
WESLEY.txt,153526,155529,2003,20,N,N,-,-1,-1
WESLEY.txt,154343,156061,1718,20,N,N,-,-1,-1
WESLEY.txt,154855,156724,1869,20,N,N,-,-1,-1
WESLEY.txt,155165,157138,1973,20,N,N,-,-1,-1
WESLEY.txt,155530,157851,2321,20,N,N,-,-1,-1
WESLEY.txt,156062,158617,2555,20,N,N,-,-1,-1
WESLEY.txt,156725,159332,2607,20,N,N,-,-1,-1
WESLEY.txt,157139,159650,2511,20,N,N,-,-1,-1
WESLEY.txt,157852,160357,2505,20,N,N,-,-1,-1
WESLEY.txt,158619,160825,2206,20,N,N,-,-1,-1
WESLEY.txt,159333,161281,1948,20,N,N,-,-1,-1
WESLEY.txt,159650,161645,1995,20,N,N,-,-1,-1
WESLEY.txt,160358,162320,1962,20,N,N,-,-1,-1
WESLEY.txt,160826,163052,2226,20,N,N,-,-1,-1
WESLEY.txt,161282,163854,2572,20,N,N,-,-1,-1
WESLEY.txt,161646,164212,2566,20,N,N,-,-1,-1
WESLEY.txt,162321,164751,2430,20,N,N,-,-1,-1
WESLEY.txt,163054,165034,1980,20,N,N,-,-1,-1
WESLEY.txt,163855,165400,1545,20,N,N,-,-1,-1
WESLEY.txt,164212,165645,1433,20,N,N,-,-1,-1
WESLEY.txt,164752,165998,1246,20,N,N,-,-1,-1
WESLEY.txt,165034,166113,1079,20,N,N,-,-1,-1
WESLEY.txt,165401,166220,819,20,Y,N,-,-1,-1
WESLEY.txt,165646,166373,727,20,Y,N,-,-1,-1
WESLEY.txt,165999,166623,624,20,Y,N,-,-1,-1
WESLEY.txt,166114,166857,743,20,Y,N,-,-1,-1
WESLEY.txt,166221,166976,755,20,Y,N,-,-1,-1
WESLEY.txt,166374,167426,1052,20,Y,N,-,-1,-1
WESLEY.txt,166624,167870,1246,20,Y,N,-,-1,-1
WESLEY.txt,166858,168219,1361,20,Y,N,-,-1,-1
WESLEY.txt,166977,168597,1620,20,N,N,-,-1,-1
WESLEY.txt,167426,169117,1691,20,N,N,-,-1,-1
WESLEY.txt,167871,169553,1682,20,N,N,-,-1,-1
WESLEY.txt,168220,169888,1668,20,N,N,-,-1,-1
WESLEY.txt,168598,170171,1573,20,N,N,-,-1,-1
WESLEY.txt,169118,170252,1134,20,Y,N,-,-1,-1
WESLEY.txt,169554,171097,1543,20,Y,N,-,-1,-1
WESLEY.txt,169889,171456,1567,20,Y,N,-,-1,-1
WESLEY.txt,170172,171829,1657,20,N,N,-,-1,-1
WESLEY.txt,170253,172816,2563,20,N,N,-,-1,-1
WESLEY.txt,171098,173347,2249,20,N,N,-,-1,-1
WESLEY.txt,171457,173858,2401,20,N,N,-,-1,-1
WESLEY.txt,171830,174440,2610,20,N,N,-,-1,-1
WESLEY.txt,172817,175085,2268,20,N,N,-,-1,-1
WESLEY.txt,173348,175534,2186,20,N,N,-,-1,-1
WESLEY.txt,173859,175887,2028,20,N,N,-,-1,-1
WESLEY.txt,174441,176389,1948,20,N,N,-,-1,-1
WESLEY.txt,175086,177047,1961,20,N,N,-,-1,-1
WESLEY.txt,175535,177553,2018,20,Y,N,-,-1,-1
WESLEY.txt,175888,178048,2160,20,Y,N,-,-1,-1
WESLEY.txt,176389,178691,2302,20,N,N,-,-1,-1
WESLEY.txt,177047,179494,2447,20,N,N,-,-1,-1
WESLEY.txt,177554,179741,2187,20,N,N,-,-1,-1
WESLEY.txt,178048,179986,1938,20,N,N,-,-1,-1
WESLEY.txt,178691,180514,1823,20,N,N,-,-1,-1
WESLEY.txt,179496,181156,1660,20,N,N,-,-1,-1
WESLEY.txt,179742,181418,1676,20,N,N,-,-1,-1
WESLEY.txt,179986,182033,2047,20,N,N,-,-1,-1
WESLEY.txt,180515,182632,2117,20,N,N,-,-1,-1
WESLEY.txt,181157,182978,1821,20,N,N,-,-1,-1
WESLEY.txt,181419,183603,2184,20,N,N,-,-1,-1
WESLEY.txt,182034,184074,2040,20,N,N,-,-1,-1
WESLEY.txt,182633,184485,1852,20,N,N,-,-1,-1
WESLEY.txt,182979,184899,1920,20,N,N,-,-1,-1
WESLEY.txt,183604,185486,1882,20,N,N,-,-1,-1
WESLEY.txt,184075,185909,1834,20,N,N,-,-1,-1
WESLEY.txt,184486,186487,2001,20,N,N,-,-1,-1
WESLEY.txt,184901,186982,2081,20,N,N,-,-1,-1
WESLEY.txt,185487,187356,1869,20,N,N,-,-1,-1
WESLEY.txt,185910,187812,1902,20,N,N,-,-1,-1
WESLEY.txt,186488,188474,1986,20,N,N,-,-1,-1
WESLEY.txt,186982,188953,1971,20,N,N,-,-1,-1
WESLEY.txt,187357,189683,2326,20,N,N,-,-1,-1
WESLEY.txt,187813,190198,2385,20,N,N,-,-1,-1
WESLEY.txt,188475,190471,1996,20,N,N,-,-1,-1
WESLEY.txt,188954,190816,1862,20,N,N,-,-1,-1
WESLEY.txt,189683,191326,1643,20,N,N,-,-1,-1
WESLEY.txt,190199,191629,1430,20,N,N,-,-1,-1
WESLEY.txt,190472,192392,1920,20,N,N,-,-1,-1
WESLEY.txt,190817,193052,2235,20,N,N,-,-1,-1
WESLEY.txt,191327,193582,2255,20,N,N,-,-1,-1
WESLEY.txt,191630,194287,2657,20,N,N,-,-1,-1
WESLEY.txt,192393,195114,2721,20,N,N,-,-1,-1
WESLEY.txt,193053,195905,2852,20,N,N,-,-1,-1
WESLEY.txt,193583,196631,3048,20,N,N,-,-1,-1
WESLEY.txt,194288,197050,2762,20,N,N,-,-1,-1
WESLEY.txt,195114,197730,2616,20,N,N,-,-1,-1
WESLEY.txt,195906,198187,2281,20,N,N,-,-1,-1
WESLEY.txt,196631,198633,2002,20,Y,N,-,-1,-1
WESLEY.txt,197051,199061,2010,20,N,N,-,-1,-1
WESLEY.txt,197731,199744,2013,20,N,N,-,-1,-1
WESLEY.txt,198187,200217,2030,20,N,N,-,-1,-1
WESLEY.txt,198634,200927,2293,20,N,N,-,-1,-1
WESLEY.txt,199062,201386,2324,20,N,N,-,-1,-1
WESLEY.txt,199745,201948,2203,20,N,N,-,-1,-1
WESLEY.txt,200218,202197,1979,20,N,N,-,-1,-1
WESLEY.txt,200928,202536,1608,20,N,N,-,-1,-1
WESLEY.txt,201387,203262,1875,20,N,N,-,-1,-1
WESLEY.txt,201949,203827,1878,20,N,N,-,-1,-1
WESLEY.txt,202198,204161,1963,20,N,N,-,-1,-1
WESLEY.txt,202537,204687,2150,20,N,N,-,-1,-1
WESLEY.txt,203263,205138,1875,20,N,N,-,-1,-1
WESLEY.txt,203828,205833,2005,20,N,N,-,-1,-1
WESLEY.txt,204162,206557,2395,20,N,N,-,-1,-1
WESLEY.txt,204688,206831,2143,20,N,N,-,-1,-1
WESLEY.txt,205139,207353,2214,20,N,N,-,-1,-1
WESLEY.txt,205834,208272,2438,20,N,N,-,-1,-1
WESLEY.txt,206558,208897,2339,20,N,N,-,-1,-1
WESLEY.txt,206832,210331,3499,20,N,N,-,-1,-1
WESLEY.txt,207353,210942,3589,20,N,N,-,-1,-1
WESLEY.txt,208273,211680,3407,20,N,N,-,-1,-1
WESLEY.txt,208898,212161,3263,20,Y,N,-,-1,-1
WESLEY.txt,210332,212620,2288,20,Y,N,-,-1,-1
WESLEY.txt,210944,212960,2016,20,Y,N,-,-1,-1
WESLEY.txt,211681,213355,1674,20,Y,N,-,-1,-1
WESLEY.txt,212163,214360,2197,20,N,N,-,-1,-1
WESLEY.txt,212621,215281,2660,20,N,N,-,-1,-1
WESLEY.txt,212961,215900,2939,20,N,N,-,-1,-1
WESLEY.txt,213356,216978,3622,20,N,N,-,-1,-1
WESLEY.txt,214361,217884,3523,20,Y,N,-,-1,-1
WESLEY.txt,215282,218794,3512,20,Y,N,-,-1,-1
WESLEY.txt,215901,219580,3679,20,Y,N,-,-1,-1
WESLEY.txt,216979,220556,3577,20,Y,N,-,-1,-1
WESLEY.txt,217885,221269,3384,20,N,N,-,-1,-1
WESLEY.txt,218795,222446,3651,20,Y,N,-,-1,-1
WESLEY.txt,219581,223395,3814,20,Y,N,-,-1,-1
WESLEY.txt,220557,224077,3520,20,Y,N,-,-1,-1
WESLEY.txt,221270,224980,3710,20,Y,N,-,-1,-1
WESLEY.txt,222447,225886,3439,20,Y,N,-,-1,-1
WESLEY.txt,223396,226418,3022,20,Y,N,-,-1,-1
WESLEY.txt,224078,226908,2830,20,N,N,-,-1,-1
WESLEY.txt,224981,227645,2664,20,N,N,-,-1,-1
WESLEY.txt,225887,228294,2407,20,N,N,-,-1,-1
WESLEY.txt,226419,228721,2302,20,N,N,-,-1,-1
WESLEY.txt,226909,229419,2510,20,N,N,-,-1,-1
WESLEY.txt,227646,229819,2173,20,N,N,-,-1,-1
WESLEY.txt,228295,230284,1989,20,N,N,-,-1,-1
WESLEY.txt,228722,230757,2035,20,N,N,-,-1,-1
WESLEY.txt,229419,231278,1859,20,N,N,-,-1,-1
WESLEY.txt,229820,231778,1958,20,N,N,-,-1,-1
WESLEY.txt,230285,232061,1776,20,N,N,-,-1,-1
WESLEY.txt,230757,232259,1502,20,N,N,-,-1,-1
WESLEY.txt,231279,232577,1298,20,N,N,-,-1,-1
WESLEY.txt,231779,232937,1158,20,N,N,-,-1,-1
WESLEY.txt,232062,233381,1319,20,N,N,-,-1,-1
WESLEY.txt,232260,234156,1896,20,N,N,-,-1,-1
WESLEY.txt,232578,234484,1906,20,N,N,-,-1,-1
WESLEY.txt,232938,234903,1965,20,N,N,-,-1,-1
WESLEY.txt,233382,235558,2176,20,N,N,-,-1,-1
WESLEY.txt,234157,236124,1967,20,N,N,-,-1,-1
WESLEY.txt,234484,236814,2330,20,Y,N,-,-1,-1
WESLEY.txt,234904,237097,2193,20,N,N,-,-1,-1
WESLEY.txt,235560,237661,2101,20,N,N,-,-1,-1
WESLEY.txt,236124,238296,2172,20,N,N,-,-1,-1
WESLEY.txt,236815,238827,2012,20,N,N,-,-1,-1
WESLEY.txt,237098,239279,2181,20,N,N,-,-1,-1
WESLEY.txt,237662,239610,1948,20,N,N,-,-1,-1
WESLEY.txt,238297,240170,1873,20,N,N,-,-1,-1
WESLEY.txt,238828,241042,2214,20,N,N,-,-1,-1
WESLEY.txt,239280,241385,2105,20,N,N,-,-1,-1
WESLEY.txt,239611,241643,2032,20,N,N,-,-1,-1
WESLEY.txt,240171,241952,1781,20,N,N,-,-1,-1
WESLEY.txt,241043,242374,1331,20,N,Y,1432378713402,242169,242662
WESLEY.txt,241386,243179,1793,20,N,Y,1432378713402,242169,242662
WESLEY.txt,241644,243752,2108,20,N,Y,1432378713402,242169,242662
WESLEY.txt,241954,244303,2349,20,N,Y,1432378713402,242169,242662
WESLEY.txt,242375,244671,2296,20,N,Y,1432378713402,242169,242662
WESLEY.txt,243180,245316,2136,20,N,N,-,-1,-1
WESLEY.txt,243753,245576,1823,20,N,N,-,-1,-1
WESLEY.txt,244304,245918,1614,20,N,N,-,-1,-1
WESLEY.txt,244672,246506,1834,20,N,Y,1432379217690,245991,246965
WESLEY.txt,245317,247207,1890,20,N,Y,1432379217690,245991,246965
WESLEY.txt,245577,248018,2441,20,N,Y,1432379217690,245991,246965
WESLEY.txt,245919,248663,2744,20,N,Y,1432379217690,245991,246965
WESLEY.txt,246507,249138,2631,20,N,Y,1432379217690,245991,246965
WESLEY.txt,247208,249622,2414,20,N,N,-,-1,-1
WESLEY.txt,248019,249897,1878,20,N,N,-,-1,-1
WESLEY.txt,248664,250284,1620,20,N,N,-,-1,-1
WESLEY.txt,249140,250826,1686,20,N,N,-,-1,-1
WESLEY.txt,249623,251297,1674,20,N,N,-,-1,-1
WESLEY.txt,249898,251703,1805,20,N,N,-,-1,-1
WESLEY.txt,250284,252163,1879,20,N,N,-,-1,-1
WESLEY.txt,250827,252577,1750,20,N,N,-,-1,-1
WESLEY.txt,251298,252877,1579,20,N,N,-,-1,-1
WESLEY.txt,251704,253217,1513,20,N,N,-,-1,-1
WESLEY.txt,252164,253740,1576,20,N,N,-,-1,-1
WESLEY.txt,252578,254426,1848,20,N,N,-,-1,-1
WESLEY.txt,252878,254672,1794,20,N,N,-,-1,-1
WESLEY.txt,253218,255163,1945,20,N,N,-,-1,-1
WESLEY.txt,253741,255688,1947,20,N,N,-,-1,-1
WESLEY.txt,254427,256644,2217,20,N,N,-,-1,-1
WESLEY.txt,254674,257067,2393,20,N,N,-,-1,-1
WESLEY.txt,255164,257988,2824,20,N,N,-,-1,-1
WESLEY.txt,255689,258877,3188,20,N,N,-,-1,-1
WESLEY.txt,256645,259244,2599,20,N,N,-,-1,-1
WESLEY.txt,257068,259810,2742,20,N,N,-,-1,-1
WESLEY.txt,257989,260594,2605,20,N,N,-,-1,-1
WESLEY.txt,258878,260897,2019,20,N,N,-,-1,-1
WESLEY.txt,259245,261318,2073,20,N,N,-,-1,-1
WESLEY.txt,259811,262844,3033,20,N,N,-,-1,-1
WESLEY.txt,260595,263579,2984,20,N,N,-,-1,-1
WESLEY.txt,260898,264378,3480,20,N,N,-,-1,-1
WESLEY.txt,261319,264665,3346,20,N,N,-,-1,-1
WESLEY.txt,262845,265409,2564,20,N,N,-,-1,-1
WESLEY.txt,263580,265949,2369,20,N,N,-,-1,-1
WESLEY.txt,264379,266435,2056,20,N,N,-,-1,-1
WESLEY.txt,264665,267007,2342,20,N,N,-,-1,-1
WESLEY.txt,265410,267484,2074,20,N,N,-,-1,-1
WESLEY.txt,265950,267766,1816,20,N,N,-,-1,-1
WESLEY.txt,266436,267940,1504,20,N,N,-,-1,-1
WESLEY.txt,267008,268556,1548,20,N,N,-,-1,-1
WESLEY.txt,267485,268986,1501,20,N,N,-,-1,-1
WESLEY.txt,267766,269557,1791,20,N,N,-,-1,-1
WESLEY.txt,267941,270025,2084,20,N,N,-,-1,-1
WESLEY.txt,268557,270502,1945,20,N,N,-,-1,-1
WESLEY.txt,268987,271002,2015,20,N,N,-,-1,-1
WESLEY.txt,269558,271861,2303,20,N,N,-,-1,-1
WESLEY.txt,270026,272248,2222,20,N,N,-,-1,-1
WESLEY.txt,270503,273187,2684,20,N,N,-,-1,-1
WESLEY.txt,271003,273693,2690,20,N,N,-,-1,-1
WESLEY.txt,271862,273960,2098,20,N,N,-,-1,-1
WESLEY.txt,272249,274429,2180,20,N,N,-,-1,-1
WESLEY.txt,273188,274698,1510,20,N,N,-,-1,-1
WESLEY.txt,273694,275087,1393,20,N,N,-,-1,-1
WESLEY.txt,273961,275547,1586,20,N,N,-,-1,-1
WESLEY.txt,274430,276118,1688,20,N,N,-,-1,-1
WESLEY.txt,274699,276724,2025,20,N,N,-,-1,-1
WESLEY.txt,275088,277274,2186,20,N,N,-,-1,-1
WESLEY.txt,275547,277718,2171,20,N,N,-,-1,-1
WESLEY.txt,276119,278072,1953,20,N,N,-,-1,-1
WESLEY.txt,276726,278419,1693,20,N,N,-,-1,-1
WESLEY.txt,277275,278847,1572,20,N,N,-,-1,-1
WESLEY.txt,277719,279089,1370,20,N,N,-,-1,-1
WESLEY.txt,278073,279545,1472,20,N,N,-,-1,-1
WESLEY.txt,278420,279885,1465,20,N,N,-,-1,-1
WESLEY.txt,278848,280485,1637,20,N,N,-,-1,-1
WESLEY.txt,279090,281187,2097,20,N,N,-,-1,-1
WESLEY.txt,279546,281424,1878,20,N,N,-,-1,-1
WESLEY.txt,279886,281820,1934,20,N,N,-,-1,-1
WESLEY.txt,280486,282175,1689,20,N,N,-,-1,-1
WESLEY.txt,281188,282498,1310,20,N,N,-,-1,-1
WESLEY.txt,281425,282945,1520,20,N,N,-,-1,-1
WESLEY.txt,281821,283182,1361,20,N,N,-,-1,-1
WESLEY.txt,282176,283632,1456,20,N,N,-,-1,-1
WESLEY.txt,282499,283898,1399,20,N,N,-,-1,-1
WESLEY.txt,282946,284022,1076,20,N,N,-,-1,-1
WESLEY.txt,283183,284673,1490,20,N,N,-,-1,-1
WESLEY.txt,283633,285680,2047,20,N,N,-,-1,-1
WESLEY.txt,283899,286173,2274,20,N,N,-,-1,-1
WESLEY.txt,284023,286580,2557,20,N,N,-,-1,-1
WESLEY.txt,284674,287273,2599,20,N,N,-,-1,-1
WESLEY.txt,285681,287795,2114,20,N,N,-,-1,-1
WESLEY.txt,286174,288511,2337,20,N,N,-,-1,-1
WESLEY.txt,286581,288887,2306,20,N,N,-,-1,-1
WESLEY.txt,287274,289249,1975,20,N,N,-,-1,-1
WESLEY.txt,287796,289835,2039,20,N,N,-,-1,-1
WESLEY.txt,288511,290178,1667,20,N,N,-,-1,-1
WESLEY.txt,288888,290515,1627,20,N,N,-,-1,-1
WESLEY.txt,289250,290968,1718,20,N,N,-,-1,-1
WESLEY.txt,289836,291269,1433,20,N,N,-,-1,-1
WESLEY.txt,290178,291771,1593,20,N,N,-,-1,-1
WESLEY.txt,290516,292215,1699,20,N,N,-,-1,-1
WESLEY.txt,290969,292777,1808,20,N,N,-,-1,-1
WESLEY.txt,291270,293598,2328,20,N,N,-,-1,-1
WESLEY.txt,291772,294041,2269,20,N,N,-,-1,-1
WESLEY.txt,292216,294411,2195,20,N,N,-,-1,-1
WESLEY.txt,292778,294863,2085,20,N,N,-,-1,-1
WESLEY.txt,293599,295325,1726,20,N,N,-,-1,-1
WESLEY.txt,294042,296054,2012,20,N,N,-,-1,-1
WESLEY.txt,294412,296530,2118,20,N,N,-,-1,-1
WESLEY.txt,294864,297062,2198,20,N,N,-,-1,-1
WESLEY.txt,295326,297996,2670,20,N,N,-,-1,-1
WESLEY.txt,296055,298550,2495,20,N,N,-,-1,-1
WESLEY.txt,296531,299120,2589,20,N,N,-,-1,-1
WESLEY.txt,297063,299880,2817,20,N,N,-,-1,-1
WESLEY.txt,297997,300582,2585,20,N,N,-,-1,-1
WESLEY.txt,298551,300974,2423,20,N,N,-,-1,-1
WESLEY.txt,299120,301543,2423,20,N,N,-,-1,-1
WESLEY.txt,299881,302144,2263,20,N,N,-,-1,-1
WESLEY.txt,300583,302712,2129,20,N,N,-,-1,-1
WESLEY.txt,300975,303220,2245,20,N,N,-,-1,-1
WESLEY.txt,301544,303603,2059,20,N,N,-,-1,-1
WESLEY.txt,302145,303944,1799,20,N,N,-,-1,-1
WESLEY.txt,302713,304438,1725,20,N,N,-,-1,-1
WESLEY.txt,303221,304754,1533,20,N,N,-,-1,-1
WESLEY.txt,303604,305288,1684,20,N,N,-,-1,-1
WESLEY.txt,303945,305670,1725,20,N,N,-,-1,-1
WESLEY.txt,304440,306090,1650,20,N,N,-,-1,-1
WESLEY.txt,304755,306451,1696,20,N,N,-,-1,-1
WESLEY.txt,305289,306918,1629,20,N,N,-,-1,-1
WESLEY.txt,305671,307392,1721,20,N,N,-,-1,-1
WESLEY.txt,306091,308047,1956,20,N,N,-,-1,-1
WESLEY.txt,306452,308406,1954,20,N,N,-,-1,-1
WESLEY.txt,306919,308800,1881,20,N,N,-,-1,-1
WESLEY.txt,307393,309311,1918,20,N,N,-,-1,-1
WESLEY.txt,308048,309691,1643,20,N,N,-,-1,-1
WESLEY.txt,308406,310197,1791,20,N,N,-,-1,-1
WESLEY.txt,308801,310486,1685,20,N,N,-,-1,-1
WESLEY.txt,309311,310870,1559,20,N,N,-,-1,-1
WESLEY.txt,309692,311544,1852,20,N,N,-,-1,-1
WESLEY.txt,310197,311969,1772,20,N,N,-,-1,-1
WESLEY.txt,310488,312511,2023,20,N,N,-,-1,-1
WESLEY.txt,310871,312860,1989,20,N,N,-,-1,-1
WESLEY.txt,311545,313401,1856,20,Y,N,-,-1,-1
WESLEY.txt,311970,313725,1755,20,Y,N,-,-1,-1
WESLEY.txt,312512,314087,1575,20,N,N,-,-1,-1
WESLEY.txt,312861,314391,1530,20,N,N,-,-1,-1
WESLEY.txt,313402,314762,1360,20,N,N,-,-1,-1
WESLEY.txt,313725,315181,1456,20,N,N,-,-1,-1
WESLEY.txt,314088,315791,1703,20,N,N,-,-1,-1
WESLEY.txt,314392,316233,1841,20,N,Y,1433324150625,315900,316317
WESLEY.txt,314763,316824,2061,20,N,Y,1433324150625,315900,316317
WESLEY.txt,315183,317389,2206,20,N,Y,1433324150625,315900,316317
WESLEY.txt,315792,317745,1953,20,N,Y,1433324150625,315900,316317
WESLEY.txt,316234,318326,2092,20,N,Y,1433324150625,315900,316317
WESLEY.txt,316826,318738,1912,20,N,N,-,-1,-1
WESLEY.txt,317390,319210,1820,20,N,N,-,-1,-1
WESLEY.txt,317747,319974,2227,20,N,N,-,-1,-1
WESLEY.txt,318326,320824,2498,20,N,N,-,-1,-1
WESLEY.txt,318739,320968,2229,20,N,N,-,-1,-1
WESLEY.txt,319211,321509,2298,20,N,N,-,-1,-1
WESLEY.txt,319975,322171,2196,20,N,N,-,-1,-1
WESLEY.txt,320825,322461,1636,20,N,N,-,-1,-1
WESLEY.txt,320969,322916,1947,20,N,N,-,-1,-1
WESLEY.txt,321510,323285,1775,20,N,N,-,-1,-1
WESLEY.txt,322172,323854,1682,20,N,N,-,-1,-1
WESLEY.txt,322462,324508,2046,20,N,N,-,-1,-1
WESLEY.txt,322917,325014,2097,20,N,N,-,-1,-1
WESLEY.txt,323285,325406,2121,20,N,N,-,-1,-1
WESLEY.txt,323855,325806,1951,20,N,N,-,-1,-1
WESLEY.txt,324509,326372,1863,20,N,N,-,-1,-1
WESLEY.txt,325015,326813,1798,20,Y,N,-,-1,-1
WESLEY.txt,325407,327103,1696,20,Y,N,-,-1,-1
WESLEY.txt,325807,327505,1698,20,N,N,-,-1,-1
WESLEY.txt,326373,328122,1749,20,N,N,-,-1,-1
WESLEY.txt,326814,328394,1580,20,N,N,-,-1,-1
WESLEY.txt,327104,328800,1696,20,N,N,-,-1,-1
WESLEY.txt,327506,329311,1805,20,N,N,-,-1,-1
WESLEY.txt,328123,329712,1589,20,N,N,-,-1,-1
WESLEY.txt,328395,329976,1581,20,N,N,-,-1,-1
WESLEY.txt,328800,330388,1588,20,N,N,-,-1,-1
WESLEY.txt,329311,330920,1609,20,N,N,-,-1,-1
WESLEY.txt,329713,332197,2484,20,N,N,-,-1,-1
WESLEY.txt,329977,332923,2946,20,N,N,-,-1,-1
WESLEY.txt,330389,334000,3611,20,N,N,-,-1,-1
WESLEY.txt,330921,334524,3603,20,N,N,-,-1,-1
WESLEY.txt,332198,335102,2904,20,N,N,-,-1,-1
WESLEY.txt,332924,335504,2580,20,N,N,-,-1,-1
WESLEY.txt,334001,336166,2165,20,N,N,-,-1,-1
WESLEY.txt,334525,336797,2272,20,N,N,-,-1,-1
WESLEY.txt,335103,337417,2314,20,N,N,-,-1,-1
WESLEY.txt,335505,338005,2500,20,N,N,-,-1,-1
WESLEY.txt,336167,338424,2257,20,N,N,-,-1,-1
WESLEY.txt,336798,338942,2144,20,N,N,-,-1,-1
WESLEY.txt,337418,339274,1856,20,N,N,-,-1,-1
WESLEY.txt,338006,339683,1677,20,N,N,-,-1,-1
WESLEY.txt,338425,340027,1602,20,N,N,-,-1,-1
WESLEY.txt,338943,340503,1560,20,N,N,-,-1,-1
WESLEY.txt,339275,340877,1602,20,N,N,-,-1,-1
WESLEY.txt,339684,341060,1376,20,N,N,-,-1,-1
WESLEY.txt,340027,341370,1343,20,N,N,-,-1,-1
WESLEY.txt,340504,341719,1215,20,N,N,-,-1,-1
WESLEY.txt,340878,342243,1365,20,N,N,-,-1,-1
WESLEY.txt,341061,342759,1698,20,N,N,-,-1,-1
WESLEY.txt,341371,343265,1894,20,N,N,-,-1,-1
WESLEY.txt,341720,343734,2014,20,N,N,-,-1,-1
WESLEY.txt,342244,344287,2043,20,N,N,-,-1,-1
WESLEY.txt,342760,344686,1926,20,N,N,-,-1,-1
WESLEY.txt,343267,344911,1644,20,N,N,-,-1,-1
WESLEY.txt,343735,345341,1606,20,N,N,-,-1,-1
WESLEY.txt,344288,345695,1407,20,N,N,-,-1,-1
WESLEY.txt,344687,346040,1353,20,N,N,-,-1,-1
WESLEY.txt,344912,346491,1579,20,N,N,-,-1,-1
WESLEY.txt,345342,346999,1657,20,N,N,-,-1,-1
WESLEY.txt,345695,347434,1739,20,N,N,-,-1,-1
WESLEY.txt,346040,348289,2249,20,N,N,-,-1,-1
WESLEY.txt,346492,348719,2227,20,N,N,-,-1,-1
WESLEY.txt,347000,349023,2023,20,N,N,-,-1,-1
WESLEY.txt,347435,349400,1965,20,N,N,-,-1,-1
WESLEY.txt,348289,349910,1621,20,N,N,-,-1,-1
WESLEY.txt,348720,350331,1611,20,N,N,-,-1,-1
WESLEY.txt,349024,350886,1862,20,N,N,-,-1,-1
WESLEY.txt,349401,351461,2060,20,N,N,-,-1,-1
WESLEY.txt,349911,351789,1878,20,N,N,-,-1,-1
WESLEY.txt,350332,352259,1927,20,N,N,-,-1,-1
WESLEY.txt,350887,352686,1799,20,N,N,-,-1,-1
WESLEY.txt,351462,353043,1581,20,N,N,-,-1,-1
WESLEY.txt,351790,353696,1906,20,N,N,-,-1,-1
WESLEY.txt,352260,354194,1934,20,N,N,-,-1,-1
WESLEY.txt,352687,354909,2222,20,N,N,-,-1,-1
WESLEY.txt,353044,355177,2133,20,N,N,-,-1,-1
WESLEY.txt,353697,355663,1966,20,N,N,-,-1,-1
WESLEY.txt,354195,356047,1852,20,N,N,-,-1,-1
WESLEY.txt,354910,356721,1811,20,N,N,-,-1,-1
WESLEY.txt,355178,357083,1905,20,N,N,-,-1,-1
WESLEY.txt,355664,357614,1950,20,N,N,-,-1,-1
WESLEY.txt,356048,357990,1942,20,N,N,-,-1,-1
WESLEY.txt,356722,358588,1866,20,N,N,-,-1,-1
WESLEY.txt,357084,358960,1876,20,N,N,-,-1,-1
WESLEY.txt,357615,359338,1723,20,N,N,-,-1,-1
WESLEY.txt,357990,359782,1792,20,N,N,-,-1,-1
WESLEY.txt,358589,360458,1869,20,N,N,-,-1,-1
WESLEY.txt,358961,360869,1908,20,N,N,-,-1,-1
WESLEY.txt,359340,361494,2154,20,N,N,-,-1,-1
WESLEY.txt,359782,362021,2239,20,N,N,-,-1,-1
WESLEY.txt,360459,362393,1934,20,N,N,-,-1,-1
WESLEY.txt,360870,363123,2253,20,N,N,-,-1,-1
WESLEY.txt,361495,363574,2079,20,N,N,-,-1,-1
WESLEY.txt,362022,364161,2139,20,N,N,-,-1,-1
WESLEY.txt,362394,364528,2134,20,N,N,-,-1,-1
WESLEY.txt,363124,364862,1738,20,N,N,-,-1,-1
WESLEY.txt,363575,365555,1980,20,N,N,-,-1,-1
WESLEY.txt,364162,365970,1808,20,N,N,-,-1,-1
WESLEY.txt,364529,366173,1644,20,N,N,-,-1,-1
WESLEY.txt,364863,366497,1634,20,N,N,-,-1,-1
WESLEY.txt,365556,366900,1344,20,N,N,-,-1,-1
WESLEY.txt,365971,367532,1561,20,N,Y,1435058414135,367148,369648
WESLEY.txt,366175,367798,1623,20,N,Y,1435058414135,367148,369648
WESLEY.txt,366498,368279,1781,20,N,Y,1435058414135,367148,369648
WESLEY.txt,366901,368893,1992,20,N,Y,1435058414135,367148,369648
WESLEY.txt,367534,369982,2448,20,N,Y,1435058414135,367148,369648
WESLEY.txt,367799,370405,2606,20,N,Y,1435058414135,367148,369648
WESLEY.txt,368280,371039,2759,20,N,Y,1435058414135,367148,369648
WESLEY.txt,368894,371638,2744,20,N,Y,1435058414135,367148,369648
WESLEY.txt,369983,372272,2289,20,N,N,-,-1,-1
WESLEY.txt,370406,372636,2230,20,N,N,-,-1,-1
WESLEY.txt,371040,373275,2235,20,N,N,-,-1,-1
WESLEY.txt,371639,373663,2024,20,N,N,-,-1,-1
WESLEY.txt,372273,374178,1905,20,N,N,-,-1,-1
WESLEY.txt,372637,374834,2197,20,N,N,-,-1,-1
WESLEY.txt,373275,375399,2124,20,N,N,-,-1,-1
WESLEY.txt,373664,375860,2196,20,N,N,-,-1,-1
WESLEY.txt,374179,376293,2114,20,N,N,-,-1,-1
WESLEY.txt,374834,376806,1972,20,N,N,-,-1,-1
WESLEY.txt,375400,377350,1950,20,N,N,-,-1,-1
WESLEY.txt,375861,377779,1918,20,N,N,-,-1,-1
WESLEY.txt,376294,378372,2078,20,N,N,-,-1,-1
WESLEY.txt,376807,378698,1891,20,N,N,-,-1,-1
WESLEY.txt,377351,379202,1851,20,N,N,-,-1,-1
WESLEY.txt,377780,379792,2012,20,N,N,-,-1,-1
WESLEY.txt,378373,380256,1883,20,N,N,-,-1,-1
WESLEY.txt,378699,380509,1810,20,N,N,-,-1,-1
WESLEY.txt,379203,380783,1580,20,N,N,-,-1,-1
WESLEY.txt,379793,381222,1429,20,N,N,-,-1,-1
WESLEY.txt,380257,381665,1408,20,N,N,-,-1,-1
WESLEY.txt,380510,381906,1396,20,N,N,-,-1,-1
WESLEY.txt,380784,382234,1450,20,N,N,-,-1,-1
WESLEY.txt,381223,382535,1312,20,N,N,-,-1,-1
WESLEY.txt,381666,382986,1320,20,N,N,-,-1,-1
WESLEY.txt,381907,383394,1487,20,N,N,-,-1,-1
WESLEY.txt,382235,383745,1510,20,N,N,-,-1,-1
WESLEY.txt,382536,384002,1466,20,N,N,-,-1,-1
WESLEY.txt,382986,384516,1530,20,N,N,-,-1,-1
WESLEY.txt,383395,385113,1718,20,N,N,-,-1,-1
WESLEY.txt,383746,385697,1951,20,N,N,-,-1,-1
WESLEY.txt,384003,385875,1872,20,N,N,-,-1,-1
WESLEY.txt,384517,386503,1986,20,N,N,-,-1,-1
WESLEY.txt,385114,386967,1853,20,N,N,-,-1,-1
WESLEY.txt,385699,387630,1931,20,N,N,-,-1,-1
WESLEY.txt,385876,388158,2282,20,N,N,-,-1,-1
WESLEY.txt,386504,388703,2199,20,N,N,-,-1,-1
WESLEY.txt,386968,389083,2115,20,N,N,-,-1,-1
WESLEY.txt,387631,389583,1952,20,N,N,-,-1,-1
WESLEY.txt,388158,390079,1921,20,N,N,-,-1,-1
WESLEY.txt,388704,390521,1817,20,N,N,-,-1,-1
WESLEY.txt,389084,390756,1672,20,N,N,-,-1,-1
WESLEY.txt,389584,391339,1755,20,N,N,-,-1,-1
WESLEY.txt,390080,391779,1699,20,N,N,-,-1,-1
WESLEY.txt,390522,392339,1817,20,N,N,-,-1,-1
WESLEY.txt,390757,393111,2354,20,N,N,-,-1,-1
WESLEY.txt,391340,393607,2267,20,N,N,-,-1,-1
WESLEY.txt,391780,393863,2083,20,N,N,-,-1,-1
WESLEY.txt,392340,394300,1960,20,N,N,-,-1,-1
WESLEY.txt,393112,394872,1760,20,N,N,-,-1,-1
WESLEY.txt,393608,395314,1706,20,N,N,-,-1,-1
WESLEY.txt,393864,395941,2077,20,N,N,-,-1,-1
WESLEY.txt,394300,396579,2279,20,N,N,-,-1,-1
WESLEY.txt,394873,397035,2162,20,N,N,-,-1,-1
WESLEY.txt,395315,397436,2121,20,N,N,-,-1,-1
WESLEY.txt,395942,397836,1894,20,N,N,-,-1,-1
WESLEY.txt,396580,398305,1725,20,N,N,-,-1,-1
WESLEY.txt,397036,398736,1700,20,N,N,-,-1,-1
WESLEY.txt,397437,399582,2145,20,N,N,-,-1,-1
WESLEY.txt,397837,399893,2056,20,N,N,-,-1,-1
WESLEY.txt,398306,400248,1942,20,N,N,-,-1,-1
WESLEY.txt,398736,400712,1976,20,N,N,-,-1,-1
WESLEY.txt,399583,401405,1822,20,N,N,-,-1,-1
WESLEY.txt,399894,401761,1867,20,N,N,-,-1,-1
WESLEY.txt,400249,402125,1876,20,N,N,-,-1,-1
WESLEY.txt,400713,402501,1788,20,N,N,-,-1,-1
WESLEY.txt,401406,402810,1404,20,N,N,-,-1,-1
WESLEY.txt,401762,403145,1383,20,N,N,-,-1,-1
WESLEY.txt,402126,403598,1472,20,N,N,-,-1,-1
WESLEY.txt,402501,404236,1735,20,N,N,-,-1,-1
WESLEY.txt,402811,404591,1780,20,N,N,-,-1,-1
WESLEY.txt,403146,405092,1946,20,N,N,-,-1,-1
WESLEY.txt,403599,405437,1838,20,N,N,-,-1,-1
WESLEY.txt,404237,405939,1702,20,N,N,-,-1,-1
WESLEY.txt,404592,406347,1755,20,N,N,-,-1,-1
WESLEY.txt,405093,406743,1650,20,N,N,-,-1,-1
WESLEY.txt,405438,407127,1689,20,N,N,-,-1,-1
WESLEY.txt,405940,407732,1792,20,N,N,-,-1,-1
WESLEY.txt,406348,408456,2108,20,N,N,-,-1,-1
WESLEY.txt,406743,408890,2147,20,N,N,-,-1,-1
WESLEY.txt,407129,409309,2180,20,N,N,-,-1,-1
WESLEY.txt,407733,409735,2002,20,N,N,-,-1,-1
WESLEY.txt,408457,410094,1637,20,N,N,-,-1,-1
WESLEY.txt,408890,410798,1908,20,N,N,-,-1,-1
WESLEY.txt,409309,411272,1963,20,N,N,-,-1,-1
WESLEY.txt,409737,411904,2167,20,N,N,-,-1,-1
WESLEY.txt,410094,412381,2287,20,N,N,-,-1,-1
WESLEY.txt,410799,412882,2083,20,N,N,-,-1,-1
WESLEY.txt,411273,413654,2381,20,N,N,-,-1,-1
WESLEY.txt,411905,414095,2190,20,N,N,-,-1,-1
WESLEY.txt,412381,414663,2282,20,N,N,-,-1,-1
WESLEY.txt,412883,415155,2272,20,N,N,-,-1,-1
WESLEY.txt,413655,415436,1781,20,N,N,-,-1,-1
WESLEY.txt,414096,415905,1809,20,N,N,-,-1,-1
WESLEY.txt,414664,416770,2106,20,N,N,-,-1,-1
WESLEY.txt,415156,417353,2197,20,N,N,-,-1,-1
WESLEY.txt,415437,417817,2380,20,N,N,-,-1,-1
WESLEY.txt,415907,418528,2621,20,N,N,-,-1,-1
WESLEY.txt,416771,419124,2353,20,N,N,-,-1,-1
WESLEY.txt,417354,419761,2407,20,N,N,-,-1,-1
WESLEY.txt,417818,420030,2212,20,N,N,-,-1,-1
WESLEY.txt,418529,420645,2116,20,N,N,-,-1,-1
WESLEY.txt,419125,420936,1811,20,N,N,-,-1,-1
WESLEY.txt,419762,421308,1546,20,N,N,-,-1,-1
WESLEY.txt,420031,421663,1632,20,N,N,-,-1,-1
WESLEY.txt,420646,422131,1485,20,N,N,-,-1,-1
WESLEY.txt,420936,422501,1565,20,N,N,-,-1,-1
WESLEY.txt,421308,422972,1664,20,N,N,-,-1,-1
WESLEY.txt,421664,423498,1834,20,N,N,-,-1,-1
WESLEY.txt,422132,423985,1853,20,N,N,-,-1,-1
WESLEY.txt,422501,424302,1801,20,N,N,-,-1,-1
WESLEY.txt,422973,424556,1583,20,N,N,-,-1,-1
WESLEY.txt,423499,424898,1399,20,N,N,-,-1,-1
WESLEY.txt,423986,425192,1206,20,N,N,-,-1,-1
WESLEY.txt,424303,425766,1463,20,N,N,-,-1,-1
WESLEY.txt,424557,426214,1657,20,N,N,-,-1,-1
WESLEY.txt,424899,426851,1952,20,N,N,-,-1,-1
WESLEY.txt,425193,427309,2116,20,N,N,-,-1,-1
WESLEY.txt,425767,427575,1808,20,N,N,-,-1,-1
WESLEY.txt,426215,427909,1694,20,N,N,-,-1,-1
WESLEY.txt,426852,428111,1259,20,N,N,-,-1,-1
WESLEY.txt,427310,428527,1217,20,N,N,-,-1,-1
WESLEY.txt,427576,428938,1362,20,N,N,-,-1,-1
WESLEY.txt,427910,429268,1358,20,N,N,-,-1,-1
WESLEY.txt,428112,429686,1574,20,N,N,-,-1,-1
WESLEY.txt,428527,430140,1613,20,N,N,-,-1,-1
WESLEY.txt,428939,430664,1725,20,N,N,-,-1,-1
WESLEY.txt,429269,431562,2293,20,N,N,-,-1,-1
WESLEY.txt,429687,432024,2337,20,N,N,-,-1,-1
WESLEY.txt,430141,432389,2248,20,N,N,-,-1,-1
WESLEY.txt,430665,432882,2217,20,N,N,-,-1,-1
WESLEY.txt,431563,433286,1723,20,N,N,-,-1,-1
WESLEY.txt,432025,434254,2229,20,N,N,-,-1,-1
WESLEY.txt,432390,434706,2316,20,N,N,-,-1,-1
WESLEY.txt,432883,435010,2127,20,N,N,-,-1,-1
WESLEY.txt,433287,435572,2285,20,N,N,-,-1,-1
WESLEY.txt,434255,436016,1761,20,N,N,-,-1,-1
WESLEY.txt,434707,436699,1992,20,N,N,-,-1,-1
WESLEY.txt,435011,437363,2352,20,N,N,-,-1,-1
WESLEY.txt,435573,437900,2327,20,N,N,-,-1,-1
WESLEY.txt,436016,438359,2343,20,N,N,-,-1,-1
WESLEY.txt,436700,438875,2175,20,N,N,-,-1,-1
WESLEY.txt,437364,439491,2127,20,N,N,-,-1,-1
WESLEY.txt,437900,440041,2141,20,N,N,-,-1,-1
WESLEY.txt,438360,440291,1931,20,N,N,-,-1,-1
WESLEY.txt,438876,440645,1769,20,N,N,-,-1,-1
WESLEY.txt,439493,440992,1499,20,N,N,-,-1,-1
WESLEY.txt,440042,441373,1331,20,N,N,-,-1,-1
WESLEY.txt,440292,441737,1445,20,N,N,-,-1,-1
WESLEY.txt,440645,442046,1401,20,N,N,-,-1,-1
WESLEY.txt,440993,442346,1353,20,N,N,-,-1,-1
WESLEY.txt,441374,442889,1515,20,N,N,-,-1,-1
WESLEY.txt,441738,443324,1586,20,N,N,-,-1,-1
WESLEY.txt,442047,443791,1744,20,N,N,-,-1,-1
WESLEY.txt,442347,444156,1809,20,N,N,-,-1,-1
WESLEY.txt,442890,444837,1947,20,N,N,-,-1,-1
WESLEY.txt,443324,445319,1995,20,N,N,-,-1,-1
WESLEY.txt,443792,445857,2065,20,N,N,-,-1,-1
WESLEY.txt,444157,446007,1850,20,N,N,-,-1,-1
WESLEY.txt,444838,446391,1553,20,N,N,-,-1,-1
WESLEY.txt,445320,446775,1455,20,N,N,-,-1,-1
WESLEY.txt,445858,447152,1294,20,N,N,-,-1,-1
WESLEY.txt,446008,447427,1419,20,N,N,-,-1,-1
WESLEY.txt,446393,447884,1491,20,N,N,-,-1,-1
WESLEY.txt,446776,448417,1641,20,N,N,-,-1,-1
WESLEY.txt,447153,448823,1670,20,N,N,-,-1,-1
WESLEY.txt,447428,449351,1923,20,N,N,-,-1,-1
WESLEY.txt,447885,449818,1933,20,N,N,-,-1,-1
WESLEY.txt,448418,450278,1860,20,N,N,-,-1,-1
WESLEY.txt,448824,450717,1893,20,N,N,-,-1,-1
WESLEY.txt,449352,451154,1802,20,N,N,-,-1,-1
WESLEY.txt,449820,451816,1996,20,N,N,-,-1,-1
WESLEY.txt,450280,452327,2047,20,N,N,-,-1,-1
WESLEY.txt,450717,452869,2152,20,N,N,-,-1,-1
WESLEY.txt,451155,453710,2555,20,N,N,-,-1,-1
WESLEY.txt,451817,454078,2261,20,N,N,-,-1,-1
WESLEY.txt,452328,454789,2461,20,N,N,-,-1,-1
WESLEY.txt,452870,455327,2457,20,N,N,-,-1,-1
WESLEY.txt,453711,455703,1992,20,N,N,-,-1,-1
WESLEY.txt,454079,456118,2039,20,N,N,-,-1,-1
WESLEY.txt,454790,456371,1581,20,N,N,-,-1,-1
WESLEY.txt,455327,456749,1422,20,N,N,-,-1,-1
WESLEY.txt,455704,457140,1436,20,N,N,-,-1,-1
WESLEY.txt,456119,457738,1619,20,N,N,-,-1,-1
WESLEY.txt,456371,458237,1866,20,N,N,-,-1,-1
WESLEY.txt,456750,458601,1851,20,N,N,-,-1,-1
WESLEY.txt,457141,458956,1815,20,N,N,-,-1,-1
WESLEY.txt,457739,459377,1638,20,N,N,-,-1,-1
WESLEY.txt,458238,459877,1639,20,N,N,-,-1,-1
WESLEY.txt,458602,460901,2299,20,N,N,-,-1,-1
WESLEY.txt,458956,461506,2550,20,N,N,-,-1,-1
WESLEY.txt,459378,462012,2634,20,N,N,-,-1,-1
WESLEY.txt,459877,462453,2576,20,N,N,-,-1,-1
WESLEY.txt,460902,462998,2096,20,N,N,-,-1,-1
WESLEY.txt,461507,463577,2070,20,N,N,-,-1,-1
WESLEY.txt,462012,464007,1995,20,N,N,-,-1,-1
WESLEY.txt,462454,464392,1938,20,N,N,-,-1,-1
WESLEY.txt,462999,465018,2019,20,Y,N,-,-1,-1
WESLEY.txt,463578,465531,1953,20,N,N,-,-1,-1
WESLEY.txt,464008,465959,1951,20,N,N,-,-1,-1
WESLEY.txt,464393,466352,1959,20,N,N,-,-1,-1
WESLEY.txt,465019,466958,1939,20,N,N,-,-1,-1
WESLEY.txt,465532,467617,2085,20,N,N,-,-1,-1
WESLEY.txt,465960,467981,2021,20,N,N,-,-1,-1
WESLEY.txt,466353,468351,1998,20,N,N,-,-1,-1
WESLEY.txt,466959,468942,1983,20,N,N,-,-1,-1
WESLEY.txt,467618,469138,1520,20,N,N,-,-1,-1
WESLEY.txt,467982,469728,1746,20,N,N,-,-1,-1
WESLEY.txt,468352,470089,1737,20,N,N,-,-1,-1
WESLEY.txt,468943,470649,1706,20,N,N,-,-1,-1
WESLEY.txt,469139,470993,1854,20,N,N,-,-1,-1
WESLEY.txt,469729,471460,1731,20,N,N,-,-1,-1
WESLEY.txt,470090,472020,1930,20,N,N,-,-1,-1
WESLEY.txt,470650,472327,1677,20,N,N,-,-1,-1
WESLEY.txt,470994,472736,1742,20,N,N,-,-1,-1
WESLEY.txt,471461,473152,1691,20,N,N,-,-1,-1
WESLEY.txt,472021,473613,1592,20,N,N,-,-1,-1
WESLEY.txt,472328,474137,1809,20,N,N,-,-1,-1
WESLEY.txt,472737,474673,1936,20,N,N,-,-1,-1
WESLEY.txt,473153,475202,2049,20,N,N,-,-1,-1
WESLEY.txt,473614,475957,2343,20,N,N,-,-1,-1
WESLEY.txt,474138,476463,2325,20,N,N,-,-1,-1
WESLEY.txt,474674,476837,2163,20,N,N,-,-1,-1
WESLEY.txt,475203,477169,1966,20,N,N,-,-1,-1
WESLEY.txt,475957,477906,1949,20,N,N,-,-1,-1
WESLEY.txt,476464,478240,1776,20,N,N,-,-1,-1
WESLEY.txt,476838,478688,1850,20,N,N,-,-1,-1
WESLEY.txt,477169,479232,2063,20,N,N,-,-1,-1
WESLEY.txt,477907,479764,1857,20,N,N,-,-1,-1
WESLEY.txt,478241,480457,2216,20,N,N,-,-1,-1
WESLEY.txt,478689,480966,2277,20,Y,Y,1435062319127,480703,480943
WESLEY.txt,479233,481372,2139,20,N,Y,1435062319127,480703,480943
WESLEY.txt,479765,481861,2096,20,N,Y,1435062319127,480703,480943
WESLEY.txt,480458,482464,2006,20,N,Y,1435062319127,480703,480943
WESLEY.txt,480966,483085,2119,20,N,N,-,-1,-1
WESLEY.txt,481373,483496,2123,20,Y,N,-,-1,-1
WESLEY.txt,481862,483849,1987,20,Y,N,-,-1,-1
WESLEY.txt,482464,484201,1737,20,Y,N,-,-1,-1
WESLEY.txt,483086,484840,1754,20,N,N,-,-1,-1
WESLEY.txt,483497,485120,1623,20,N,N,-,-1,-1
WESLEY.txt,483850,485985,2135,20,N,N,-,-1,-1
WESLEY.txt,484202,486534,2332,20,N,N,-,-1,-1
WESLEY.txt,484841,487005,2164,20,N,N,-,-1,-1
WESLEY.txt,485121,487576,2455,20,N,N,-,-1,-1
WESLEY.txt,485986,488041,2055,20,N,N,-,-1,-1
WESLEY.txt,486535,488517,1982,20,N,N,-,-1,-1
WESLEY.txt,487006,488900,1894,20,N,N,-,-1,-1
WESLEY.txt,487577,489253,1676,20,N,N,-,-1,-1
WESLEY.txt,488042,489685,1643,20,N,N,-,-1,-1
WESLEY.txt,488518,490115,1597,20,N,N,-,-1,-1
WESLEY.txt,488901,490588,1687,20,N,N,-,-1,-1
WESLEY.txt,489254,491089,1835,20,N,N,-,-1,-1
WESLEY.txt,489686,491564,1878,20,N,N,-,-1,-1
WESLEY.txt,490116,491941,1825,20,N,N,-,-1,-1
WESLEY.txt,490589,492375,1786,20,N,N,-,-1,-1
WESLEY.txt,491089,492725,1636,20,N,N,-,-1,-1
WESLEY.txt,491565,493348,1783,20,N,N,-,-1,-1
WESLEY.txt,491942,493741,1799,20,N,N,-,-1,-1
WESLEY.txt,492376,494598,2222,20,N,Y,1435062617921,494000,496406
WESLEY.txt,492726,495078,2352,20,Y,Y,1435062617921,494000,496406
WESLEY.txt,493349,495752,2403,20,Y,Y,1435062617921,494000,496406
WESLEY.txt,493742,495967,2225,20,Y,Y,1435062617921,494000,496406
WESLEY.txt,494599,496128,1529,20,N,Y,1435062617921,494000,496406
WESLEY.txt,495079,496528,1449,20,N,Y,1435062617921,494000,496406
WESLEY.txt,495753,497026,1273,20,N,Y,1435062617921,494000,496406
WESLEY.txt,495968,497725,1757,20,N,Y,1435062617921,494000,496406
WESLEY.txt,496129,498138,2009,20,N,Y,1435062617921,494000,496406
WESLEY.txt,496528,498760,2232,20,N,N,-,-1,-1
WESLEY.txt,497027,499382,2355,20,N,N,-,-1,-1
WESLEY.txt,497726,499754,2028,20,N,N,-,-1,-1
WESLEY.txt,498139,500032,1893,20,N,N,-,-1,-1
WESLEY.txt,498761,500408,1647,20,N,N,-,-1,-1
WESLEY.txt,499382,500794,1412,20,N,N,-,-1,-1
WESLEY.txt,499755,501204,1449,20,N,N,-,-1,-1
WESLEY.txt,500033,501988,1955,20,N,N,-,-1,-1
WESLEY.txt,500409,502569,2160,20,N,N,-,-1,-1
WESLEY.txt,500794,503068,2274,20,N,N,-,-1,-1
WESLEY.txt,501205,503460,2255,20,N,N,-,-1,-1
WESLEY.txt,501989,503968,1979,20,N,N,-,-1,-1
WESLEY.txt,502570,505085,2515,20,N,N,-,-1,-1
WESLEY.txt,503069,505591,2522,20,N,N,-,-1,-1
WESLEY.txt,503461,506021,2560,20,N,N,-,-1,-1
WESLEY.txt,503969,506673,2704,20,N,N,-,-1,-1
WESLEY.txt,505086,507062,1976,20,N,N,-,-1,-1
WESLEY.txt,505592,507765,2173,20,N,N,-,-1,-1
WESLEY.txt,506021,508376,2355,20,N,N,-,-1,-1
WESLEY.txt,506674,508990,2316,20,N,N,-,-1,-1
WESLEY.txt,507062,509546,2484,20,N,N,-,-1,-1
WESLEY.txt,507766,510017,2251,20,N,N,-,-1,-1
WESLEY.txt,508377,510671,2294,20,N,N,-,-1,-1
WESLEY.txt,508991,511110,2119,20,N,N,-,-1,-1
WESLEY.txt,509547,511399,1852,20,N,N,-,-1,-1
WESLEY.txt,510018,511908,1890,20,N,N,-,-1,-1
WESLEY.txt,510672,512380,1708,20,N,N,-,-1,-1
WESLEY.txt,511111,512870,1759,20,N,N,-,-1,-1
WESLEY.txt,511400,513173,1773,20,N,N,-,-1,-1
WESLEY.txt,511909,513757,1848,20,N,N,-,-1,-1
WESLEY.txt,512381,514133,1752,20,N,N,-,-1,-1
WESLEY.txt,512870,514674,1804,20,N,N,-,-1,-1
WESLEY.txt,513174,515202,2028,20,N,N,-,-1,-1
WESLEY.txt,513758,515628,1870,20,N,N,-,-1,-1
WESLEY.txt,514134,516009,1875,20,Y,N,-,-1,-1
WESLEY.txt,514675,516431,1756,20,Y,N,-,-1,-1
WESLEY.txt,515203,517093,1890,20,Y,N,-,-1,-1
WESLEY.txt,515629,517600,1971,20,N,N,-,-1,-1
WESLEY.txt,516010,518490,2480,20,N,N,-,-1,-1
WESLEY.txt,516431,519046,2615,20,N,N,-,-1,-1
WESLEY.txt,517094,519312,2218,20,N,N,-,-1,-1
WESLEY.txt,517601,519721,2120,20,N,N,-,-1,-1
WESLEY.txt,518491,520053,1562,20,N,N,-,-1,-1
WESLEY.txt,519047,520419,1372,20,N,N,-,-1,-1
WESLEY.txt,519313,521051,1738,20,N,N,-,-1,-1
WESLEY.txt,519722,521431,1709,20,N,N,-,-1,-1
WESLEY.txt,520054,522015,1961,20,N,N,-,-1,-1
WESLEY.txt,520420,522531,2111,20,N,N,-,-1,-1
WESLEY.txt,521052,522914,1862,20,N,N,-,-1,-1
WESLEY.txt,521432,523289,1857,20,N,N,-,-1,-1
WESLEY.txt,522016,523859,1843,20,N,N,-,-1,-1
WESLEY.txt,522532,524282,1750,20,N,N,-,-1,-1
WESLEY.txt,522915,524885,1970,20,N,N,-,-1,-1
WESLEY.txt,523290,525370,2080,20,N,N,-,-1,-1
WESLEY.txt,523860,525826,1966,20,N,N,-,-1,-1
WESLEY.txt,524283,526225,1942,20,N,N,-,-1,-1
WESLEY.txt,524885,526742,1857,20,N,N,-,-1,-1
WESLEY.txt,525371,527210,1839,20,N,N,-,-1,-1
WESLEY.txt,525827,527459,1632,20,N,N,-,-1,-1
WESLEY.txt,526226,528171,1945,20,N,N,-,-1,-1
WESLEY.txt,526743,528627,1884,20,N,N,-,-1,-1
WESLEY.txt,527211,529117,1906,20,N,N,-,-1,-1
WESLEY.txt,527460,529681,2221,20,N,N,-,-1,-1
WESLEY.txt,528172,530109,1937,20,N,N,-,-1,-1
WESLEY.txt,528628,530727,2099,20,N,N,-,-1,-1
WESLEY.txt,529118,531147,2029,20,N,N,-,-1,-1
WESLEY.txt,529682,531651,1969,20,Y,N,-,-1,-1
WESLEY.txt,530110,532001,1891,20,N,N,-,-1,-1
WESLEY.txt,530728,532512,1784,20,N,N,-,-1,-1
WESLEY.txt,531148,533252,2104,20,N,N,-,-1,-1
WESLEY.txt,531652,533733,2081,20,N,N,-,-1,-1
WESLEY.txt,532001,534433,2432,20,N,N,-,-1,-1
WESLEY.txt,532512,534851,2339,20,N,N,-,-1,-1
WESLEY.txt,533253,535323,2070,20,N,N,-,-1,-1
WESLEY.txt,533734,535838,2104,20,N,N,-,-1,-1
WESLEY.txt,534434,536068,1634,20,N,N,-,-1,-1
WESLEY.txt,534852,536523,1671,20,N,N,-,-1,-1
WESLEY.txt,535324,536961,1637,20,N,Y,1435063028928,536935,537559
WESLEY.txt,535839,537305,1466,20,N,Y,1435063028928,536935,537559
WESLEY.txt,536069,537685,1616,20,N,Y,1435063028928,536935,537559
WESLEY.txt,536524,537992,1468,20,N,Y,1435063028928,536935,537559
WESLEY.txt,536961,538614,1653,20,N,Y,1435063028928,536935,537559
WESLEY.txt,537306,539122,1816,20,N,Y,1435063028928,536935,537559
WESLEY.txt,537685,539815,2130,20,N,N,-,-1,-1
WESLEY.txt,537993,540513,2520,20,N,N,-,-1,-1
WESLEY.txt,538615,540889,2274,20,N,N,-,-1,-1
WESLEY.txt,539123,541418,2295,20,N,N,-,-1,-1
WESLEY.txt,539816,541924,2108,20,N,N,-,-1,-1
WESLEY.txt,540514,542654,2140,20,N,N,-,-1,-1
WESLEY.txt,540890,543340,2450,20,N,N,-,-1,-1
WESLEY.txt,541419,543904,2485,20,N,N,-,-1,-1
WESLEY.txt,541925,544453,2528,20,N,N,-,-1,-1
WESLEY.txt,542655,545049,2394,20,N,N,-,-1,-1
WESLEY.txt,543341,545672,2331,20,N,N,-,-1,-1
WESLEY.txt,543905,546096,2191,20,N,N,-,-1,-1
WESLEY.txt,544454,546380,1926,20,N,N,-,-1,-1
WESLEY.txt,545050,547030,1980,20,N,N,-,-1,-1
WESLEY.txt,545673,547572,1899,20,N,N,-,-1,-1
WESLEY.txt,546097,548118,2021,20,N,N,-,-1,-1
WESLEY.txt,546381,548575,2194,20,N,N,-,-1,-1
WESLEY.txt,547031,548900,1869,20,N,N,-,-1,-1
WESLEY.txt,547573,549306,1733,20,N,N,-,-1,-1
WESLEY.txt,548119,549815,1696,20,N,N,-,-1,-1
WESLEY.txt,548576,550094,1518,20,N,N,-,-1,-1
WESLEY.txt,548901,550761,1860,20,N,N,-,-1,-1
WESLEY.txt,549307,551176,1869,20,Y,N,-,-1,-1
WESLEY.txt,549816,551800,1984,20,Y,N,-,-1,-1
WESLEY.txt,550095,552186,2091,20,N,N,-,-1,-1
WESLEY.txt,550762,552575,1813,20,N,N,-,-1,-1
WESLEY.txt,551177,553233,2056,20,N,N,-,-1,-1
WESLEY.txt,551801,553669,1868,20,N,N,-,-1,-1
WESLEY.txt,552187,554179,1992,20,N,N,-,-1,-1
WESLEY.txt,552576,554943,2367,20,N,N,-,-1,-1
WESLEY.txt,553234,555431,2197,20,N,N,-,-1,-1
WESLEY.txt,553670,555943,2273,20,N,N,-,-1,-1
WESLEY.txt,554180,556266,2086,20,N,N,-,-1,-1
WESLEY.txt,554944,556668,1724,20,N,N,-,-1,-1
WESLEY.txt,555432,557254,1822,20,N,N,-,-1,-1
WESLEY.txt,555944,557702,1758,20,N,N,-,-1,-1
WESLEY.txt,556267,557912,1645,20,N,N,-,-1,-1
WESLEY.txt,556669,558598,1929,20,N,N,-,-1,-1
WESLEY.txt,557255,559037,1782,20,N,N,-,-1,-1
WESLEY.txt,557702,559353,1651,20,N,N,-,-1,-1
WESLEY.txt,557913,559931,2018,20,N,N,-,-1,-1
WESLEY.txt,558599,560510,1911,20,N,Y,1435063804274,560047,562154
WESLEY.txt,559038,560846,1808,20,N,Y,1435063804274,560047,562154
WESLEY.txt,559354,561500,2146,20,N,Y,1435063804274,560047,562154
WESLEY.txt,559932,561914,1982,20,N,Y,1435063804274,560047,562154
WESLEY.txt,560511,562277,1766,20,N,Y,1435063804274,560047,562154
WESLEY.txt,560847,562807,1960,20,N,Y,1435063804274,560047,562154
WESLEY.txt,561501,563593,2092,20,N,Y,1435063804274,560047,562154
WESLEY.txt,561915,564353,2438,20,N,Y,1435063804274,560047,562154
WESLEY.txt,562277,564896,2619,20,N,N,-,-1,-1
WESLEY.txt,562808,565584,2776,20,N,N,-,-1,-1
WESLEY.txt,563594,565941,2347,20,N,N,-,-1,-1
WESLEY.txt,564354,566353,1999,20,N,N,-,-1,-1
WESLEY.txt,564897,566765,1868,20,N,N,-,-1,-1
WESLEY.txt,565585,567283,1698,20,N,N,-,-1,-1
WESLEY.txt,565942,567762,1820,20,N,N,-,-1,-1
WESLEY.txt,566354,568144,1790,20,N,N,-,-1,-1
WESLEY.txt,566766,568545,1779,20,N,N,-,-1,-1
WESLEY.txt,567283,569046,1763,20,N,N,-,-1,-1
WESLEY.txt,567763,569232,1469,20,N,N,-,-1,-1
WESLEY.txt,568145,569501,1356,20,N,N,-,-1,-1
WESLEY.txt,568546,570006,1460,20,Y,N,-,-1,-1
WESLEY.txt,569047,570467,1420,20,Y,N,-,-1,-1
WESLEY.txt,569233,570860,1627,20,Y,N,-,-1,-1
WESLEY.txt,569502,571086,1584,20,Y,N,-,-1,-1
WESLEY.txt,570007,571706,1699,20,N,N,-,-1,-1
WESLEY.txt,570468,571998,1530,20,N,N,-,-1,-1
WESLEY.txt,570861,572524,1663,20,N,N,-,-1,-1
WESLEY.txt,571087,572975,1888,20,N,N,-,-1,-1
WESLEY.txt,571707,573622,1915,20,N,N,-,-1,-1
WESLEY.txt,571999,574201,2202,20,N,N,-,-1,-1
WESLEY.txt,572525,574743,2218,20,N,N,-,-1,-1
WESLEY.txt,572976,575299,2323,20,N,N,-,-1,-1
WESLEY.txt,573623,575801,2178,20,N,N,-,-1,-1
WESLEY.txt,574202,576154,1952,20,N,N,-,-1,-1
WESLEY.txt,574744,576542,1798,20,N,N,-,-1,-1
WESLEY.txt,575300,576984,1684,20,N,N,-,-1,-1
WESLEY.txt,575802,577402,1600,20,N,N,-,-1,-1
WESLEY.txt,576155,578091,1936,20,N,N,-,-1,-1
WESLEY.txt,576543,578340,1797,20,N,N,-,-1,-1
WESLEY.txt,576985,578707,1722,20,N,N,-,-1,-1
WESLEY.txt,577403,579545,2142,20,N,N,-,-1,-1
WESLEY.txt,578092,579824,1732,20,N,N,-,-1,-1
WESLEY.txt,578341,580239,1898,20,N,N,-,-1,-1
WESLEY.txt,578707,580519,1812,20,N,N,-,-1,-1
WESLEY.txt,579546,580925,1379,20,N,N,-,-1,-1
WESLEY.txt,579825,581236,1411,20,N,N,-,-1,-1
WESLEY.txt,580240,581960,1720,20,N,N,-,-1,-1
WESLEY.txt,580519,582442,1923,20,N,N,-,-1,-1
WESLEY.txt,580926,583072,2146,20,N,N,-,-1,-1
WESLEY.txt,581236,583505,2269,20,N,N,-,-1,-1
WESLEY.txt,581961,584091,2130,20,N,N,-,-1,-1
WESLEY.txt,582443,584632,2189,20,N,N,-,-1,-1
WESLEY.txt,583073,585067,1994,20,N,N,-,-1,-1
WESLEY.txt,583506,585603,2097,20,N,N,-,-1,-1
WESLEY.txt,584092,586264,2172,20,N,N,-,-1,-1
WESLEY.txt,584633,586719,2086,20,N,N,-,-1,-1
WESLEY.txt,585068,587210,2142,20,N,N,-,-1,-1
WESLEY.txt,585604,587553,1949,20,Y,N,-,-1,-1
WESLEY.txt,586265,588192,1927,20,Y,N,-,-1,-1
WESLEY.txt,586720,588717,1997,20,Y,N,-,-1,-1
WESLEY.txt,587211,589145,1934,20,Y,N,-,-1,-1
WESLEY.txt,587554,589603,2049,20,N,N,-,-1,-1
WESLEY.txt,588193,589968,1775,20,N,N,-,-1,-1
WESLEY.txt,588718,590295,1577,20,N,N,-,-1,-1
WESLEY.txt,589146,590594,1448,20,N,N,-,-1,-1
WESLEY.txt,589604,591030,1426,20,N,N,-,-1,-1
WESLEY.txt,589969,591482,1513,20,N,N,-,-1,-1
WESLEY.txt,590296,592193,1897,20,N,N,-,-1,-1
WESLEY.txt,590595,592705,2110,20,N,N,-,-1,-1
WESLEY.txt,591031,593324,2293,20,N,N,-,-1,-1
WESLEY.txt,591483,594006,2523,20,N,N,-,-1,-1
WESLEY.txt,592194,594582,2388,20,N,N,-,-1,-1
WESLEY.txt,592706,595051,2345,20,N,N,-,-1,-1
WESLEY.txt,593325,595629,2304,20,N,N,-,-1,-1
WESLEY.txt,594007,596059,2052,20,N,N,-,-1,-1
WESLEY.txt,594583,596581,1998,20,N,N,-,-1,-1
WESLEY.txt,595052,597344,2292,20,N,N,-,-1,-1
WESLEY.txt,595629,597957,2328,20,N,N,-,-1,-1
WESLEY.txt,596060,598383,2323,20,N,N,-,-1,-1
WESLEY.txt,596582,599009,2427,20,N,N,-,-1,-1
WESLEY.txt,597345,599583,2238,20,Y,N,-,-1,-1
WESLEY.txt,597958,600075,2117,20,Y,N,-,-1,-1
WESLEY.txt,598383,600477,2094,20,Y,N,-,-1,-1
WESLEY.txt,599010,600903,1893,20,Y,N,-,-1,-1
WESLEY.txt,599584,601249,1665,20,N,N,-,-1,-1
WESLEY.txt,600076,601818,1742,20,N,N,-,-1,-1
WESLEY.txt,600478,602208,1730,20,N,N,-,-1,-1
WESLEY.txt,600904,602937,2033,20,N,N,-,-1,-1
WESLEY.txt,601249,603382,2133,20,N,N,-,-1,-1
WESLEY.txt,601819,603752,1933,20,N,N,-,-1,-1
WESLEY.txt,602209,604194,1985,20,N,N,-,-1,-1
WESLEY.txt,602938,604362,1424,20,N,N,-,-1,-1
WESLEY.txt,603383,604875,1492,20,N,N,-,-1,-1
WESLEY.txt,603752,605193,1441,20,N,N,-,-1,-1
WESLEY.txt,604195,606142,1947,20,N,N,-,-1,-1
WESLEY.txt,604363,606854,2491,20,N,N,-,-1,-1
WESLEY.txt,604876,607355,2479,20,N,N,-,-1,-1
WESLEY.txt,605194,607959,2765,20,N,N,-,-1,-1
WESLEY.txt,606143,608478,2335,20,N,N,-,-1,-1
WESLEY.txt,606855,609027,2172,20,N,N,-,-1,-1
WESLEY.txt,607356,609458,2102,20,N,N,-,-1,-1
WESLEY.txt,607960,609915,1955,20,N,N,-,-1,-1
WESLEY.txt,608479,610159,1680,20,N,N,-,-1,-1
WESLEY.txt,609028,610802,1774,20,N,N,-,-1,-1
WESLEY.txt,609458,611163,1705,20,N,N,-,-1,-1
WESLEY.txt,609916,611680,1764,20,N,N,-,-1,-1
WESLEY.txt,610160,612186,2026,20,N,N,-,-1,-1
WESLEY.txt,610803,612446,1643,20,N,N,-,-1,-1
WESLEY.txt,611164,613019,1855,20,N,N,-,-1,-1
WESLEY.txt,611681,613365,1684,20,N,N,-,-1,-1
WESLEY.txt,612187,613736,1549,20,N,N,-,-1,-1
WESLEY.txt,612447,614461,2014,20,N,N,-,-1,-1
WESLEY.txt,613020,614711,1691,20,N,N,-,-1,-1
WESLEY.txt,613366,615164,1798,20,N,N,-,-1,-1
WESLEY.txt,613737,615507,1770,20,N,N,-,-1,-1
WESLEY.txt,614461,615890,1429,20,N,N,-,-1,-1
WESLEY.txt,614712,616296,1584,20,N,N,-,-1,-1
WESLEY.txt,615165,617030,1865,20,N,N,-,-1,-1
WESLEY.txt,615508,618079,2571,20,N,N,-,-1,-1
WESLEY.txt,615891,618382,2491,20,N,N,-,-1,-1
WESLEY.txt,616296,618765,2469,20,N,N,-,-1,-1
WESLEY.txt,617031,619105,2074,20,N,N,-,-1,-1
WESLEY.txt,618080,619833,1753,20,N,N,-,-1,-1
WESLEY.txt,618383,620418,2035,20,N,N,-,-1,-1
WESLEY.txt,618766,620884,2118,20,N,N,-,-1,-1
WESLEY.txt,619106,621392,2286,20,N,N,-,-1,-1
WESLEY.txt,619834,621985,2151,20,N,N,-,-1,-1
WESLEY.txt,620419,622369,1950,20,N,N,-,-1,-1
WESLEY.txt,620885,622852,1967,20,N,N,-,-1,-1
WESLEY.txt,621393,623481,2088,20,N,N,-,-1,-1
WESLEY.txt,621986,623885,1899,20,N,N,-,-1,-1
WESLEY.txt,622370,624154,1784,20,N,N,-,-1,-1
WESLEY.txt,622853,624749,1896,20,N,N,-,-1,-1
WESLEY.txt,623482,625193,1711,20,N,N,-,-1,-1
WESLEY.txt,623886,625511,1625,20,N,N,-,-1,-1
WESLEY.txt,624155,625826,1671,20,N,N,-,-1,-1
WESLEY.txt,624749,626414,1665,20,N,N,-,-1,-1
WESLEY.txt,625194,626732,1538,20,N,N,-,-1,-1
WESLEY.txt,625512,627229,1717,20,N,N,-,-1,-1
WESLEY.txt,625827,627626,1799,20,N,N,-,-1,-1
WESLEY.txt,626414,627928,1514,20,N,N,-,-1,-1
WESLEY.txt,626733,628178,1445,20,N,N,-,-1,-1
WESLEY.txt,627230,628692,1462,20,N,N,-,-1,-1
WESLEY.txt,627627,629049,1422,20,N,N,-,-1,-1
WESLEY.txt,627929,629500,1571,20,N,N,-,-1,-1
WESLEY.txt,628179,629952,1773,20,N,N,-,-1,-1
WESLEY.txt,628692,630208,1516,20,N,N,-,-1,-1
WESLEY.txt,629050,630767,1717,20,N,N,-,-1,-1
WESLEY.txt,629501,631078,1577,20,N,N,-,-1,-1
WESLEY.txt,629953,631708,1755,20,N,N,-,-1,-1
WESLEY.txt,630209,632021,1812,20,N,N,-,-1,-1
WESLEY.txt,630768,632937,2169,20,N,N,-,-1,-1
WESLEY.txt,631079,633309,2230,20,N,N,-,-1,-1
WESLEY.txt,631709,633907,2198,20,N,N,-,-1,-1
WESLEY.txt,632022,634436,2414,20,N,N,-,-1,-1
WESLEY.txt,632938,634880,1942,20,N,N,-,-1,-1
WESLEY.txt,633309,635508,2199,20,N,N,-,-1,-1
WESLEY.txt,633907,636032,2125,20,N,N,-,-1,-1
WESLEY.txt,634437,636244,1807,20,N,N,-,-1,-1
WESLEY.txt,634881,636650,1769,20,N,N,-,-1,-1
WESLEY.txt,635509,637023,1514,20,N,N,-,-1,-1
WESLEY.txt,636033,637491,1458,20,N,N,-,-1,-1
WESLEY.txt,636245,637833,1588,20,N,N,-,-1,-1
WESLEY.txt,636650,638327,1677,20,N,N,-,-1,-1
WESLEY.txt,637023,638834,1811,20,N,N,-,-1,-1
WESLEY.txt,637492,639251,1759,20,N,N,-,-1,-1
WESLEY.txt,637834,639486,1652,20,N,N,-,-1,-1
WESLEY.txt,638327,639896,1569,20,N,N,-,-1,-1
WESLEY.txt,638835,640280,1445,20,N,N,-,-1,-1
WESLEY.txt,639252,640623,1371,20,N,N,-,-1,-1
WESLEY.txt,639486,640884,1398,20,N,N,-,-1,-1
WESLEY.txt,639897,641420,1523,20,N,N,-,-1,-1
WESLEY.txt,640281,641818,1537,20,N,N,-,-1,-1
WESLEY.txt,640624,642158,1534,20,N,N,-,-1,-1
WESLEY.txt,640884,642717,1833,20,Y,N,-,-1,-1
WESLEY.txt,641421,642984,1563,20,Y,N,-,-1,-1
WESLEY.txt,641819,643542,1723,20,N,N,-,-1,-1
WESLEY.txt,642159,644220,2061,20,N,N,-,-1,-1
WESLEY.txt,642718,644807,2089,20,N,N,-,-1,-1
WESLEY.txt,642985,644983,1998,20,N,N,-,-1,-1
WESLEY.txt,643543,645381,1838,20,N,N,-,-1,-1
WESLEY.txt,644221,645690,1469,20,Y,N,-,-1,-1
WESLEY.txt,644808,646142,1334,20,Y,N,-,-1,-1
WESLEY.txt,644984,646621,1637,20,Y,N,-,-1,-1
WESLEY.txt,645382,646871,1489,20,N,N,-,-1,-1
WESLEY.txt,645691,647059,1368,20,N,N,-,-1,-1
WESLEY.txt,646143,647578,1435,20,N,N,-,-1,-1
WESLEY.txt,646621,648015,1394,20,Y,N,-,-1,-1
WESLEY.txt,646872,648703,1831,20,Y,N,-,-1,-1
WESLEY.txt,647060,648947,1887,20,Y,N,-,-1,-1
WESLEY.txt,647579,649338,1759,20,Y,N,-,-1,-1
WESLEY.txt,648016,649855,1839,20,N,N,-,-1,-1
WESLEY.txt,648704,650230,1526,20,N,N,-,-1,-1
WESLEY.txt,648948,650722,1774,20,N,N,-,-1,-1
WESLEY.txt,649339,651120,1781,20,N,N,-,-1,-1
WESLEY.txt,649855,651619,1764,20,N,N,-,-1,-1
WESLEY.txt,650231,652055,1824,20,N,N,-,-1,-1
WESLEY.txt,650723,652923,2200,20,N,N,-,-1,-1
WESLEY.txt,651120,653129,2009,20,N,N,-,-1,-1
WESLEY.txt,651620,653931,2311,20,N,N,-,-1,-1
WESLEY.txt,652056,654449,2393,20,N,N,-,-1,-1
WESLEY.txt,652924,654701,1777,20,N,N,-,-1,-1
WESLEY.txt,653130,655015,1885,20,N,N,-,-1,-1
WESLEY.txt,653932,655644,1712,20,N,N,-,-1,-1
WESLEY.txt,654450,656092,1642,20,N,N,-,-1,-1
WESLEY.txt,654702,656499,1797,20,N,N,-,-1,-1
WESLEY.txt,655016,656795,1779,20,N,N,-,-1,-1
WESLEY.txt,655645,657370,1725,20,N,N,-,-1,-1
WESLEY.txt,656093,657990,1897,20,N,N,-,-1,-1
WESLEY.txt,656500,658265,1765,20,N,N,-,-1,-1
WESLEY.txt,656796,658777,1981,20,N,N,-,-1,-1
WESLEY.txt,657371,659273,1902,20,N,N,-,-1,-1
WESLEY.txt,657991,659804,1813,20,N,N,-,-1,-1
WESLEY.txt,658266,660267,2001,20,N,N,-,-1,-1
WESLEY.txt,658778,660735,1957,20,N,N,-,-1,-1
WESLEY.txt,659273,661060,1787,20,N,N,-,-1,-1
WESLEY.txt,659805,661396,1591,20,N,N,-,-1,-1
WESLEY.txt,660268,661709,1441,20,N,N,-,-1,-1
WESLEY.txt,660736,662041,1305,20,N,N,-,-1,-1
WESLEY.txt,661061,662433,1372,20,N,N,-,-1,-1
WESLEY.txt,661397,662804,1407,20,N,N,-,-1,-1
WESLEY.txt,661710,663513,1803,20,N,N,-,-1,-1
WESLEY.txt,662042,664020,1978,20,N,N,-,-1,-1
WESLEY.txt,662434,664292,1858,20,N,N,-,-1,-1
WESLEY.txt,662805,665002,2197,20,N,N,-,-1,-1
WESLEY.txt,663514,665303,1789,20,N,N,-,-1,-1
WESLEY.txt,664021,665659,1638,20,N,N,-,-1,-1
WESLEY.txt,664292,666047,1755,20,N,N,-,-1,-1
WESLEY.txt,665003,666380,1377,20,N,N,-,-1,-1
WESLEY.txt,665304,666842,1538,20,N,N,-,-1,-1
WESLEY.txt,665660,667185,1525,20,N,N,-,-1,-1
WESLEY.txt,666048,667609,1561,20,N,N,-,-1,-1
WESLEY.txt,666381,668221,1840,20,N,N,-,-1,-1
WESLEY.txt,666843,668640,1797,20,N,N,-,-1,-1
WESLEY.txt,667186,669288,2102,20,N,N,-,-1,-1
WESLEY.txt,667609,669750,2141,20,N,N,-,-1,-1
WESLEY.txt,668222,670187,1965,20,N,N,-,-1,-1
WESLEY.txt,668641,670632,1991,20,N,N,-,-1,-1
WESLEY.txt,669289,671039,1750,20,N,N,-,-1,-1
WESLEY.txt,669751,671474,1723,20,N,N,-,-1,-1
WESLEY.txt,670188,671896,1708,20,N,N,-,-1,-1
WESLEY.txt,670633,672568,1935,20,N,N,-,-1,-1
WESLEY.txt,671040,673284,2244,20,N,N,-,-1,-1
WESLEY.txt,671475,673731,2256,20,N,N,-,-1,-1
WESLEY.txt,671897,673988,2091,20,N,N,-,-1,-1
WESLEY.txt,672569,674380,1811,20,N,N,-,-1,-1
WESLEY.txt,673284,674700,1416,20,N,N,-,-1,-1
WESLEY.txt,673732,675106,1374,20,N,N,-,-1,-1
WESLEY.txt,673989,675562,1573,20,N,N,-,-1,-1
WESLEY.txt,674381,675908,1527,20,N,N,-,-1,-1
WESLEY.txt,674701,676426,1725,20,N,N,-,-1,-1
WESLEY.txt,675107,676802,1695,20,N,N,-,-1,-1
WESLEY.txt,675563,677327,1764,20,N,N,-,-1,-1
WESLEY.txt,675909,677735,1826,20,N,N,-,-1,-1
WESLEY.txt,676427,678221,1794,20,N,N,-,-1,-1
WESLEY.txt,676803,678595,1792,20,N,N,-,-1,-1
WESLEY.txt,677328,678861,1533,20,N,N,-,-1,-1
WESLEY.txt,677736,679281,1545,20,N,N,-,-1,-1
WESLEY.txt,678222,679700,1478,20,N,N,-,-1,-1
WESLEY.txt,678596,679932,1336,20,N,N,-,-1,-1
WESLEY.txt,678862,680332,1470,20,N,N,-,-1,-1
WESLEY.txt,679282,680783,1501,20,N,N,-,-1,-1
WESLEY.txt,679701,681446,1745,20,N,N,-,-1,-1
WESLEY.txt,679933,682001,2068,20,N,N,-,-1,-1
WESLEY.txt,680333,682728,2395,20,N,N,-,-1,-1
WESLEY.txt,680784,683049,2265,20,N,N,-,-1,-1
WESLEY.txt,681447,683532,2085,20,Y,N,-,-1,-1
WESLEY.txt,682002,683924,1922,20,Y,N,-,-1,-1
WESLEY.txt,682729,684360,1631,20,N,N,-,-1,-1
WESLEY.txt,683050,684753,1703,20,N,N,-,-1,-1
WESLEY.txt,683533,685089,1556,20,N,N,-,-1,-1
WESLEY.txt,683925,685451,1526,20,N,N,-,-1,-1
WESLEY.txt,684361,685923,1562,20,N,N,-,-1,-1
WESLEY.txt,684754,686339,1585,20,N,N,-,-1,-1
WESLEY.txt,685090,686989,1899,20,N,N,-,-1,-1
WESLEY.txt,685452,687277,1825,20,N,N,-,-1,-1
WESLEY.txt,685924,687570,1646,20,N,N,-,-1,-1
WESLEY.txt,686340,688045,1705,20,N,N,-,-1,-1
WESLEY.txt,686990,688414,1424,20,N,N,-,-1,-1
WESLEY.txt,687278,688998,1720,20,N,N,-,-1,-1
WESLEY.txt,687571,689264,1693,20,N,N,-,-1,-1
WESLEY.txt,688045,689661,1616,20,N,N,-,-1,-1
WESLEY.txt,688415,689833,1418,20,N,N,-,-1,-1
WESLEY.txt,688999,690244,1245,20,N,N,-,-1,-1
WESLEY.txt,689265,690764,1499,20,N,N,-,-1,-1
WESLEY.txt,689662,691294,1632,20,N,N,-,-1,-1
WESLEY.txt,689834,691488,1654,20,N,N,-,-1,-1
WESLEY.txt,690245,691894,1649,20,N,N,-,-1,-1
WESLEY.txt,690765,692330,1565,20,N,N,-,-1,-1
WESLEY.txt,691295,692808,1513,20,N,N,-,-1,-1
WESLEY.txt,691488,693207,1719,20,Y,N,-,-1,-1
WESLEY.txt,691895,693927,2032,20,Y,N,-,-1,-1
WESLEY.txt,692331,694582,2251,20,N,N,-,-1,-1
WESLEY.txt,692809,695003,2194,20,N,N,-,-1,-1
WESLEY.txt,693207,695403,2196,20,N,N,-,-1,-1
WESLEY.txt,693928,695651,1723,20,N,N,-,-1,-1
WESLEY.txt,694583,696206,1623,20,N,N,-,-1,-1
WESLEY.txt,695004,696579,1575,20,N,N,-,-1,-1
WESLEY.txt,695403,697069,1666,20,N,N,-,-1,-1
WESLEY.txt,695652,697395,1743,20,N,N,-,-1,-1
WESLEY.txt,696207,698086,1879,20,N,N,-,-1,-1
WESLEY.txt,696580,698674,2094,20,N,N,-,-1,-1
WESLEY.txt,697069,699063,1994,20,N,N,-,-1,-1
WESLEY.txt,697396,699487,2091,20,N,N,-,-1,-1
WESLEY.txt,698087,699817,1730,20,N,N,-,-1,-1
WESLEY.txt,698675,700174,1499,20,N,N,-,-1,-1
WESLEY.txt,699063,700468,1405,20,N,N,-,-1,-1
WESLEY.txt,699488,700836,1348,20,N,N,-,-1,-1
WESLEY.txt,699817,701374,1557,20,N,N,-,-1,-1
WESLEY.txt,700175,701797,1622,20,N,N,-,-1,-1
WESLEY.txt,700469,702383,1914,20,N,N,-,-1,-1
WESLEY.txt,700836,702785,1949,20,N,N,-,-1,-1
WESLEY.txt,701375,703694,2319,20,N,N,-,-1,-1
WESLEY.txt,701798,704166,2368,20,Y,N,-,-1,-1
WESLEY.txt,702384,704659,2275,20,Y,N,-,-1,-1
WESLEY.txt,702786,705313,2527,20,Y,N,-,-1,-1
WESLEY.txt,703695,705690,1995,20,N,N,-,-1,-1
WESLEY.txt,704167,706136,1969,20,N,N,-,-1,-1
WESLEY.txt,704660,706562,1902,20,N,N,-,-1,-1
WESLEY.txt,705314,706806,1492,20,N,N,-,-1,-1
WESLEY.txt,705691,707181,1490,20,N,N,-,-1,-1
WESLEY.txt,706137,707455,1318,20,N,N,-,-1,-1
WESLEY.txt,706563,707953,1390,20,N,N,-,-1,-1
WESLEY.txt,706807,708684,1877,20,N,N,-,-1,-1
WESLEY.txt,707182,710026,2844,20,N,N,-,-1,-1
WESLEY.txt,707456,710393,2937,20,N,N,-,-1,-1
WESLEY.txt,707954,710772,2818,20,N,N,-,-1,-1
WESLEY.txt,708685,711132,2447,20,N,N,-,-1,-1
WESLEY.txt,710027,711564,1537,20,N,N,-,-1,-1
WESLEY.txt,710394,711815,1421,20,N,N,-,-1,-1
WESLEY.txt,710773,712340,1567,20,N,N,-,-1,-1
WESLEY.txt,711133,712870,1737,20,N,N,-,-1,-1
WESLEY.txt,711564,713146,1582,20,N,N,-,-1,-1
WESLEY.txt,711816,713627,1811,20,N,N,-,-1,-1
WESLEY.txt,712341,713974,1633,20,N,N,-,-1,-1
WESLEY.txt,712871,714661,1790,20,N,N,-,-1,-1
WESLEY.txt,713147,715168,2021,20,N,N,-,-1,-1
WESLEY.txt,713628,716130,2502,20,N,N,-,-1,-1
WESLEY.txt,713975,716617,2642,20,N,N,-,-1,-1
WESLEY.txt,714661,717022,2361,20,N,N,-,-1,-1
WESLEY.txt,715169,717580,2411,20,N,N,-,-1,-1
WESLEY.txt,716130,718082,1952,20,N,N,-,-1,-1
WESLEY.txt,716618,718547,1929,20,N,N,-,-1,-1
WESLEY.txt,717023,719217,2194,20,N,N,-,-1,-1
WESLEY.txt,717581,719401,1820,20,N,N,-,-1,-1
WESLEY.txt,718083,719830,1747,20,N,N,-,-1,-1
WESLEY.txt,718548,720111,1563,20,N,N,-,-1,-1
WESLEY.txt,719218,720600,1382,20,N,N,-,-1,-1
WESLEY.txt,719402,721280,1878,20,N,N,-,-1,-1
WESLEY.txt,719831,721499,1668,20,N,N,-,-1,-1
WESLEY.txt,720112,721780,1668,20,N,N,-,-1,-1
WESLEY.txt,720601,722216,1615,20,N,N,-,-1,-1
WESLEY.txt,721281,722647,1366,20,N,N,-,-1,-1
WESLEY.txt,721500,723072,1572,20,N,N,-,-1,-1
WESLEY.txt,721781,723965,2184,20,N,N,-,-1,-1
WESLEY.txt,722217,724438,2221,20,N,N,-,-1,-1
WESLEY.txt,722647,725047,2400,20,N,N,-,-1,-1
WESLEY.txt,723073,725339,2266,20,N,N,-,-1,-1
WESLEY.txt,723966,725964,1998,20,Y,N,-,-1,-1
WESLEY.txt,724438,726249,1811,20,Y,N,-,-1,-1
WESLEY.txt,725048,726920,1872,20,N,N,-,-1,-1
WESLEY.txt,725340,727241,1901,20,N,N,-,-1,-1
WESLEY.txt,725965,727734,1769,20,N,N,-,-1,-1
WESLEY.txt,726250,728095,1845,20,N,N,-,-1,-1
WESLEY.txt,726921,728479,1558,20,N,N,-,-1,-1
WESLEY.txt,727241,729169,1928,20,N,N,-,-1,-1
WESLEY.txt,727735,729701,1966,20,N,N,-,-1,-1
WESLEY.txt,728096,730057,1961,20,N,N,-,-1,-1
WESLEY.txt,728480,730517,2037,20,N,N,-,-1,-1
WESLEY.txt,729170,730859,1689,20,N,N,-,-1,-1
WESLEY.txt,729702,731319,1617,20,N,N,-,-1,-1
WESLEY.txt,730058,731646,1588,20,N,N,-,-1,-1
WESLEY.txt,730518,732098,1580,20,N,N,-,-1,-1
WESLEY.txt,730860,732425,1565,20,N,N,-,-1,-1
WESLEY.txt,731320,733099,1779,20,N,N,-,-1,-1
WESLEY.txt,731647,733633,1986,20,N,N,-,-1,-1
WESLEY.txt,732099,734310,2211,20,N,N,-,-1,-1
WESLEY.txt,732425,734576,2151,20,N,N,-,-1,-1
WESLEY.txt,733100,734950,1850,20,N,N,-,-1,-1
WESLEY.txt,733634,735475,1841,20,N,N,-,-1,-1
WESLEY.txt,734311,735897,1586,20,N,N,-,-1,-1
WESLEY.txt,734577,736609,2032,20,N,N,-,-1,-1
WESLEY.txt,734951,737004,2053,20,N,N,-,-1,-1
WESLEY.txt,735476,737511,2035,20,N,N,-,-1,-1
WESLEY.txt,735897,738179,2282,20,Y,N,-,-1,-1
WESLEY.txt,736610,738595,1985,20,N,N,-,-1,-1
WESLEY.txt,737005,739156,2151,20,N,N,-,-1,-1
WESLEY.txt,737512,739804,2292,20,N,N,-,-1,-1
WESLEY.txt,738180,740530,2350,20,N,N,-,-1,-1
WESLEY.txt,738596,740790,2194,20,N,N,-,-1,-1
WESLEY.txt,739156,741188,2032,20,N,N,-,-1,-1
WESLEY.txt,739805,741540,1735,20,N,N,-,-1,-1
WESLEY.txt,740530,742009,1479,20,N,N,-,-1,-1
WESLEY.txt,740791,742353,1562,20,N,N,-,-1,-1
WESLEY.txt,741189,742591,1402,20,N,N,-,-1,-1
WESLEY.txt,741541,743342,1801,20,N,N,-,-1,-1
WESLEY.txt,742010,743857,1847,20,N,N,-,-1,-1
WESLEY.txt,742354,744290,1936,20,N,N,-,-1,-1
WESLEY.txt,742592,744576,1984,20,N,N,-,-1,-1
WESLEY.txt,743343,744927,1584,20,N,N,-,-1,-1
WESLEY.txt,743858,745513,1655,20,N,N,-,-1,-1
WESLEY.txt,744291,745905,1614,20,N,N,-,-1,-1
WESLEY.txt,744577,746295,1718,20,N,N,-,-1,-1
WESLEY.txt,744928,747414,2486,20,N,N,-,-1,-1
WESLEY.txt,745514,748154,2640,20,N,N,-,-1,-1
WESLEY.txt,745906,748556,2650,20,N,N,-,-1,-1
WESLEY.txt,746296,749065,2769,20,N,N,-,-1,-1
WESLEY.txt,747415,749659,2244,20,N,N,-,-1,-1
WESLEY.txt,748155,750589,2434,20,N,N,-,-1,-1
WESLEY.txt,748557,751302,2745,20,N,N,-,-1,-1
WESLEY.txt,749066,751653,2587,20,Y,N,-,-1,-1
WESLEY.txt,749660,751962,2302,20,Y,N,-,-1,-1
WESLEY.txt,750590,752446,1856,20,Y,N,-,-1,-1
WESLEY.txt,751303,752869,1566,20,Y,N,-,-1,-1
WESLEY.txt,751654,753539,1885,20,N,N,-,-1,-1
WESLEY.txt,751963,753916,1953,20,N,N,-,-1,-1
WESLEY.txt,752447,754548,2101,20,N,N,-,-1,-1
WESLEY.txt,752870,755160,2290,20,N,N,-,-1,-1
WESLEY.txt,753540,755570,2030,20,N,N,-,-1,-1
WESLEY.txt,753917,755905,1988,20,N,N,-,-1,-1
WESLEY.txt,754549,756227,1678,20,N,N,-,-1,-1
WESLEY.txt,755161,756670,1509,20,N,N,-,-1,-1
WESLEY.txt,755571,757250,1679,20,N,N,-,-1,-1
WESLEY.txt,755906,757718,1812,20,N,N,-,-1,-1
WESLEY.txt,756228,758190,1962,20,N,N,-,-1,-1
WESLEY.txt,756671,758885,2214,20,N,N,-,-1,-1
WESLEY.txt,757251,759306,2055,20,N,N,-,-1,-1
WESLEY.txt,757719,759575,1856,20,N,N,-,-1,-1
WESLEY.txt,758191,760000,1809,20,N,N,-,-1,-1
WESLEY.txt,758886,760315,1429,20,N,N,-,-1,-1
WESLEY.txt,759307,760858,1551,20,N,N,-,-1,-1
WESLEY.txt,759576,761329,1753,20,Y,N,-,-1,-1
WESLEY.txt,760001,761838,1837,20,Y,N,-,-1,-1
WESLEY.txt,760316,762246,1930,20,N,N,-,-1,-1
WESLEY.txt,760859,762699,1840,20,N,N,-,-1,-1
WESLEY.txt,761329,763252,1923,20,N,N,-,-1,-1
WESLEY.txt,761839,763655,1816,20,N,N,-,-1,-1
WESLEY.txt,762247,764222,1975,20,N,N,-,-1,-1
WESLEY.txt,762700,764478,1778,20,N,N,-,-1,-1
WESLEY.txt,763253,764852,1599,20,N,N,-,-1,-1
WESLEY.txt,763655,765223,1568,20,N,N,-,-1,-1
WESLEY.txt,764223,765778,1555,20,N,N,-,-1,-1
WESLEY.txt,764479,766261,1782,20,N,N,-,-1,-1
WESLEY.txt,764853,766607,1754,20,N,N,-,-1,-1
WESLEY.txt,765224,767031,1807,20,N,N,-,-1,-1
WESLEY.txt,765779,767437,1658,20,N,N,-,-1,-1
WESLEY.txt,766262,767882,1620,20,N,N,-,-1,-1
WESLEY.txt,766608,768320,1712,20,N,N,-,-1,-1
WESLEY.txt,767032,768597,1565,20,N,N,-,-1,-1
WESLEY.txt,767438,768929,1491,20,N,N,-,-1,-1
WESLEY.txt,767883,769388,1505,20,N,N,-,-1,-1
WESLEY.txt,768321,769834,1513,20,N,N,-,-1,-1
WESLEY.txt,768598,770128,1530,20,N,N,-,-1,-1
WESLEY.txt,768930,771031,2101,20,N,N,-,-1,-1
WESLEY.txt,769389,771658,2269,20,N,N,-,-1,-1
WESLEY.txt,769835,772356,2521,20,N,N,-,-1,-1
WESLEY.txt,770129,772914,2785,20,N,N,-,-1,-1
WESLEY.txt,771032,773249,2217,20,N,N,-,-1,-1
WESLEY.txt,771659,773607,1948,20,N,N,-,-1,-1
WESLEY.txt,772357,773949,1592,20,N,N,-,-1,-1
WESLEY.txt,772915,774359,1444,20,N,N,-,-1,-1
WESLEY.txt,773250,774765,1515,20,N,N,-,-1,-1
WESLEY.txt,773608,775212,1604,20,N,N,-,-1,-1
WESLEY.txt,773950,775637,1687,20,N,N,-,-1,-1
WESLEY.txt,774360,776131,1771,20,N,N,-,-1,-1
WESLEY.txt,774766,776527,1761,20,N,N,-,-1,-1
WESLEY.txt,775213,776957,1744,20,N,N,-,-1,-1
WESLEY.txt,775637,777252,1615,20,N,N,-,-1,-1
WESLEY.txt,776132,777937,1805,20,N,N,-,-1,-1
WESLEY.txt,776528,778456,1928,20,N,N,-,-1,-1
WESLEY.txt,776958,778853,1895,20,N,N,-,-1,-1
WESLEY.txt,777252,779028,1776,20,N,N,-,-1,-1
WESLEY.txt,777938,779310,1372,20,N,N,-,-1,-1
WESLEY.txt,778457,779715,1258,20,N,N,-,-1,-1
WESLEY.txt,778854,780155,1301,20,N,N,-,-1,-1
WESLEY.txt,779029,780536,1507,20,N,N,-,-1,-1
WESLEY.txt,779310,780801,1491,20,N,N,-,-1,-1
WESLEY.txt,779716,781112,1396,20,N,N,-,-1,-1
WESLEY.txt,780156,781334,1178,20,N,N,-,-1,-1
WESLEY.txt,780537,781735,1198,20,N,N,-,-1,-1
WESLEY.txt,780802,782242,1440,20,N,N,-,-1,-1
WESLEY.txt,781113,783017,1904,20,N,N,-,-1,-1
WESLEY.txt,781335,783392,2057,20,N,N,-,-1,-1
WESLEY.txt,781736,783679,1943,20,N,N,-,-1,-1
WESLEY.txt,782243,784272,2029,20,N,N,-,-1,-1
WESLEY.txt,783018,784692,1674,20,N,N,-,-1,-1
WESLEY.txt,783392,785192,1800,20,N,N,-,-1,-1
WESLEY.txt,783680,785800,2120,20,N,N,-,-1,-1
WESLEY.txt,784273,786179,1906,20,N,N,-,-1,-1
WESLEY.txt,784693,786802,2109,20,N,N,-,-1,-1
WESLEY.txt,785193,787209,2016,20,N,N,-,-1,-1
WESLEY.txt,785801,787773,1972,20,N,N,-,-1,-1
WESLEY.txt,786180,788132,1952,20,N,N,-,-1,-1
WESLEY.txt,786803,788566,1763,20,N,N,-,-1,-1
WESLEY.txt,787210,789004,1794,20,N,N,-,-1,-1
WESLEY.txt,787774,789564,1790,20,N,N,-,-1,-1
WESLEY.txt,788133,789993,1860,20,N,N,-,-1,-1
WESLEY.txt,788567,790600,2033,20,N,N,-,-1,-1
WESLEY.txt,789005,790773,1768,20,N,N,-,-1,-1
WESLEY.txt,789565,791049,1484,20,N,N,-,-1,-1
WESLEY.txt,789994,791394,1400,20,N,N,-,-1,-1
WESLEY.txt,790601,791731,1130,20,N,N,-,-1,-1
WESLEY.txt,790774,792048,1274,20,Y,N,-,-1,-1
WESLEY.txt,791050,792626,1576,20,Y,N,-,-1,-1
WESLEY.txt,791395,793172,1777,20,Y,N,-,-1,-1
WESLEY.txt,791732,793716,1984,20,Y,N,-,-1,-1
WESLEY.txt,792048,794303,2255,20,N,N,-,-1,-1
WESLEY.txt,792627,794636,2009,20,N,N,-,-1,-1
WESLEY.txt,793173,795086,1913,20,N,N,-,-1,-1
WESLEY.txt,793717,795509,1792,20,Y,N,-,-1,-1
WESLEY.txt,794304,795801,1497,20,N,N,-,-1,-1
WESLEY.txt,794637,796301,1664,20,N,N,-,-1,-1
WESLEY.txt,795087,796757,1670,20,N,N,-,-1,-1
WESLEY.txt,795510,797259,1749,20,N,N,-,-1,-1
WESLEY.txt,795802,797651,1849,20,N,N,-,-1,-1
WESLEY.txt,796302,798090,1788,20,N,N,-,-1,-1
WESLEY.txt,796758,798624,1866,20,N,N,-,-1,-1
WESLEY.txt,797260,799133,1873,20,N,N,-,-1,-1
WESLEY.txt,797652,799571,1919,20,Y,N,-,-1,-1
WESLEY.txt,798090,799786,1696,20,Y,N,-,-1,-1
WESLEY.txt,798625,800225,1600,20,Y,N,-,-1,-1
WESLEY.txt,799134,800730,1596,20,Y,N,-,-1,-1
WESLEY.txt,799572,801354,1782,20,N,N,-,-1,-1
WESLEY.txt,799787,801682,1895,20,N,N,-,-1,-1
WESLEY.txt,800226,802041,1815,20,N,N,-,-1,-1
WESLEY.txt,800731,802550,1819,20,N,N,-,-1,-1
WESLEY.txt,801355,802775,1420,20,N,N,-,-1,-1
WESLEY.txt,801683,803200,1517,20,N,N,-,-1,-1
WESLEY.txt,802042,803400,1358,20,N,N,-,-1,-1
WESLEY.txt,802551,803772,1221,20,Y,N,-,-1,-1
WESLEY.txt,802775,804203,1428,20,Y,N,-,-1,-1
WESLEY.txt,803201,804646,1445,20,Y,N,-,-1,-1
WESLEY.txt,803400,804939,1539,20,Y,N,-,-1,-1
WESLEY.txt,803773,805321,1548,20,N,N,-,-1,-1
WESLEY.txt,804204,805809,1605,20,N,N,-,-1,-1
WESLEY.txt,804647,806077,1430,20,N,N,-,-1,-1
WESLEY.txt,804939,806567,1628,20,N,N,-,-1,-1
WESLEY.txt,805321,806922,1601,20,N,N,-,-1,-1
WESLEY.txt,805810,807297,1487,20,N,N,-,-1,-1
WESLEY.txt,806077,807699,1622,20,N,N,-,-1,-1
WESLEY.txt,806568,807998,1430,20,N,N,-,-1,-1
WESLEY.txt,806923,808364,1441,20,N,N,-,-1,-1
WESLEY.txt,807298,808914,1616,20,N,N,-,-1,-1
WESLEY.txt,807700,809398,1698,20,Y,N,-,-1,-1
WESLEY.txt,807999,810396,2397,20,N,N,-,-1,-1
WESLEY.txt,808364,810646,2282,20,N,N,-,-1,-1
WESLEY.txt,808915,811004,2089,20,N,N,-,-1,-1
WESLEY.txt,809399,811391,1992,20,N,N,-,-1,-1
WESLEY.txt,810397,811800,1403,20,N,N,-,-1,-1
WESLEY.txt,810647,812364,1717,20,N,N,-,-1,-1
WESLEY.txt,811005,812815,1810,20,N,N,-,-1,-1
WESLEY.txt,811392,813374,1982,20,N,N,-,-1,-1
WESLEY.txt,811801,814275,2474,20,N,N,-,-1,-1
WESLEY.txt,812365,814754,2389,20,N,N,-,-1,-1
WESLEY.txt,812815,815024,2209,20,N,N,-,-1,-1
WESLEY.txt,813375,815371,1996,20,N,N,-,-1,-1
WESLEY.txt,814276,816079,1803,20,N,N,-,-1,-1
WESLEY.txt,814754,816777,2023,20,Y,N,-,-1,-1
WESLEY.txt,815025,817219,2194,20,N,N,-,-1,-1
WESLEY.txt,815372,817720,2348,20,Y,N,-,-1,-1
WESLEY.txt,816080,818442,2362,20,Y,N,-,-1,-1
WESLEY.txt,816778,818652,1874,20,Y,N,-,-1,-1
WESLEY.txt,817220,819309,2089,20,Y,N,-,-1,-1
WESLEY.txt,817721,819632,1911,20,N,N,-,-1,-1
WESLEY.txt,818443,820074,1631,20,N,N,-,-1,-1
WESLEY.txt,818653,820417,1764,20,N,N,-,-1,-1
WESLEY.txt,819310,820878,1568,20,N,N,-,-1,-1
WESLEY.txt,819633,821357,1724,20,Y,N,-,-1,-1
WESLEY.txt,820075,821836,1761,20,Y,N,-,-1,-1
WESLEY.txt,820418,822263,1845,20,Y,N,-,-1,-1
WESLEY.txt,820879,822611,1732,20,Y,N,-,-1,-1
WESLEY.txt,821358,822974,1616,20,N,N,-,-1,-1
WESLEY.txt,821837,823394,1557,20,N,N,-,-1,-1
WESLEY.txt,822264,823770,1506,20,N,N,-,-1,-1
WESLEY.txt,822612,824350,1738,20,N,N,-,-1,-1
WESLEY.txt,822975,824735,1760,20,N,N,-,-1,-1
WESLEY.txt,823395,825296,1901,20,N,N,-,-1,-1
WESLEY.txt,823771,825614,1843,20,N,N,-,-1,-1
WESLEY.txt,824351,826311,1960,20,N,N,-,-1,-1
WESLEY.txt,824736,827179,2443,20,Y,N,-,-1,-1
WESLEY.txt,825296,827736,2440,20,N,N,-,-1,-1
WESLEY.txt,825614,828164,2550,20,N,N,-,-1,-1
WESLEY.txt,826312,828590,2278,20,N,N,-,-1,-1
WESLEY.txt,827180,828997,1817,20,N,N,-,-1,-1
WESLEY.txt,827737,829374,1637,20,N,N,-,-1,-1
WESLEY.txt,828165,829766,1601,20,N,N,-,-1,-1
WESLEY.txt,828590,830203,1613,20,N,N,-,-1,-1
WESLEY.txt,828998,830649,1651,20,N,N,-,-1,-1
WESLEY.txt,829375,831049,1674,20,N,N,-,-1,-1
WESLEY.txt,829767,831523,1756,20,N,N,-,-1,-1
WESLEY.txt,830204,831919,1715,20,N,N,-,-1,-1
WESLEY.txt,830650,832269,1619,20,N,N,-,-1,-1
WESLEY.txt,831050,832996,1946,20,N,N,-,-1,-1
WESLEY.txt,831523,833402,1879,20,N,N,-,-1,-1
WESLEY.txt,831920,833735,1815,20,N,N,-,-1,-1
WESLEY.txt,832270,834083,1813,20,N,N,-,-1,-1
WESLEY.txt,832997,834448,1451,20,N,N,-,-1,-1
WESLEY.txt,833403,834838,1435,20,N,N,-,-1,-1
WESLEY.txt,833736,835284,1548,20,N,N,-,-1,-1
WESLEY.txt,834084,835894,1810,20,N,N,-,-1,-1
WESLEY.txt,834448,836251,1803,20,N,N,-,-1,-1
WESLEY.txt,834839,836820,1981,20,N,N,-,-1,-1
WESLEY.txt,835285,837230,1945,20,N,N,-,-1,-1
WESLEY.txt,835895,837719,1824,20,N,N,-,-1,-1
WESLEY.txt,836252,838354,2102,20,N,N,-,-1,-1
WESLEY.txt,836820,838692,1872,20,Y,N,-,-1,-1
WESLEY.txt,837231,839090,1859,20,Y,N,-,-1,-1
WESLEY.txt,837720,839430,1710,20,N,N,-,-1,-1
WESLEY.txt,838355,839774,1419,20,N,N,-,-1,-1
WESLEY.txt,838693,840468,1775,20,N,N,-,-1,-1
WESLEY.txt,839091,840934,1843,20,N,N,-,-1,-1
WESLEY.txt,839430,841154,1724,20,N,N,-,-1,-1
WESLEY.txt,839775,841563,1788,20,N,N,-,-1,-1
WESLEY.txt,840468,842080,1612,20,N,N,-,-1,-1
WESLEY.txt,840935,842553,1618,20,N,N,-,-1,-1
WESLEY.txt,841155,842815,1660,20,N,N,-,-1,-1
WESLEY.txt,841563,843153,1590,20,N,N,-,-1,-1
WESLEY.txt,842081,843480,1399,20,N,N,-,-1,-1
WESLEY.txt,842554,843884,1330,20,N,N,-,-1,-1
WESLEY.txt,842816,844501,1685,20,N,N,-,-1,-1
WESLEY.txt,843154,844756,1602,20,N,N,-,-1,-1
WESLEY.txt,843481,845313,1832,20,N,N,-,-1,-1
WESLEY.txt,843885,845697,1812,20,N,N,-,-1,-1
WESLEY.txt,844501,845994,1493,20,N,N,-,-1,-1
WESLEY.txt,844757,846520,1763,20,N,N,-,-1,-1
WESLEY.txt,845314,846931,1617,20,N,N,-,-1,-1
WESLEY.txt,845698,847408,1710,20,N,N,-,-1,-1
WESLEY.txt,845995,847856,1861,20,N,N,-,-1,-1
WESLEY.txt,846521,848387,1866,20,N,N,-,-1,-1
WESLEY.txt,846932,849091,2159,20,N,N,-,-1,-1
WESLEY.txt,847409,849650,2241,20,N,N,-,-1,-1
WESLEY.txt,847857,850168,2311,20,N,N,-,-1,-1
WESLEY.txt,848387,850578,2191,20,N,N,-,-1,-1
WESLEY.txt,849092,851373,2281,20,N,N,-,-1,-1
WESLEY.txt,849651,851788,2137,20,N,N,-,-1,-1
WESLEY.txt,850169,852376,2207,20,N,N,-,-1,-1
WESLEY.txt,850579,852786,2207,20,N,N,-,-1,-1
WESLEY.txt,851374,853239,1865,20,N,N,-,-1,-1
WESLEY.txt,851789,853558,1769,20,N,N,-,-1,-1
WESLEY.txt,852377,854064,1687,20,N,N,-,-1,-1
WESLEY.txt,852787,854569,1782,20,N,N,-,-1,-1
WESLEY.txt,853240,855206,1966,20,N,N,-,-1,-1
WESLEY.txt,853559,855460,1901,20,N,N,-,-1,-1
WESLEY.txt,854065,855875,1810,20,N,N,-,-1,-1
WESLEY.txt,854570,856447,1877,20,N,N,-,-1,-1
WESLEY.txt,855207,856818,1611,20,N,N,-,-1,-1
WESLEY.txt,855461,857444,1983,20,N,N,-,-1,-1
WESLEY.txt,855875,857820,1945,20,N,N,-,-1,-1
WESLEY.txt,856448,858452,2004,20,N,N,-,-1,-1
WESLEY.txt,856819,858904,2085,20,N,N,-,-1,-1
WESLEY.txt,857445,859382,1937,20,N,N,-,-1,-1
WESLEY.txt,857821,860079,2258,20,Y,N,-,-1,-1
WESLEY.txt,858453,860369,1916,20,Y,N,-,-1,-1
WESLEY.txt,858905,861044,2139,20,Y,N,-,-1,-1
WESLEY.txt,859383,861556,2173,20,Y,N,-,-1,-1
WESLEY.txt,860079,862454,2375,20,Y,N,-,-1,-1
WESLEY.txt,860370,862792,2422,20,N,N,-,-1,-1
WESLEY.txt,861045,863083,2038,20,N,N,-,-1,-1
WESLEY.txt,861557,863374,1817,20,N,N,-,-1,-1
WESLEY.txt,862455,864098,1643,20,N,N,-,-1,-1
WESLEY.txt,862793,864493,1700,20,N,N,-,-1,-1
WESLEY.txt,863084,865033,1949,20,N,N,-,-1,-1
WESLEY.txt,863375,865421,2046,20,N,N,-,-1,-1
WESLEY.txt,864099,865982,1883,20,N,N,-,-1,-1
WESLEY.txt,864494,866357,1863,20,Y,N,-,-1,-1
WESLEY.txt,865034,867117,2083,20,Y,N,-,-1,-1
WESLEY.txt,865422,867480,2058,20,Y,N,-,-1,-1
WESLEY.txt,865983,868147,2164,20,N,N,-,-1,-1
WESLEY.txt,866358,868512,2154,20,N,N,-,-1,-1
WESLEY.txt,867117,868898,1781,20,N,N,-,-1,-1
WESLEY.txt,867481,869322,1841,20,N,N,-,-1,-1
WESLEY.txt,868148,869804,1656,20,N,N,-,-1,-1
WESLEY.txt,868513,870277,1764,20,N,N,-,-1,-1
WESLEY.txt,868899,870611,1712,20,N,N,-,-1,-1
WESLEY.txt,869323,870945,1622,20,N,N,-,-1,-1
WESLEY.txt,869805,871179,1374,20,N,N,-,-1,-1
WESLEY.txt,870278,871798,1520,20,N,N,-,-1,-1
WESLEY.txt,870612,872208,1596,20,N,N,-,-1,-1
WESLEY.txt,870945,873318,2373,20,N,N,-,-1,-1
WESLEY.txt,871180,874361,3181,20,N,N,-,-1,-1
WESLEY.txt,871799,874774,2975,20,N,N,-,-1,-1
WESLEY.txt,872209,875295,3086,20,N,N,-,-1,-1
WESLEY.txt,873319,875695,2376,20,N,N,-,-1,-1
WESLEY.txt,874362,875942,1580,20,N,N,-,-1,-1
WESLEY.txt,874775,876251,1476,20,N,N,-,-1,-1
WESLEY.txt,875295,876653,1358,20,N,N,-,-1,-1
WESLEY.txt,875696,876936,1240,20,N,N,-,-1,-1
WESLEY.txt,875942,877430,1488,20,N,N,-,-1,-1
WESLEY.txt,876251,877778,1527,20,N,N,-,-1,-1
WESLEY.txt,876654,878175,1521,20,Y,N,-,-1,-1
WESLEY.txt,876937,878463,1526,20,Y,N,-,-1,-1
WESLEY.txt,877431,878835,1404,20,Y,N,-,-1,-1
WESLEY.txt,877779,879098,1319,20,Y,N,-,-1,-1
WESLEY.txt,878175,879397,1222,20,N,N,-,-1,-1
WESLEY.txt,878463,879873,1410,20,N,N,-,-1,-1
WESLEY.txt,878836,880541,1705,20,Y,N,-,-1,-1
WESLEY.txt,879099,880764,1665,20,N,N,-,-1,-1
WESLEY.txt,879398,881221,1823,20,N,N,-,-1,-1
WESLEY.txt,879874,881660,1786,20,N,N,-,-1,-1
WESLEY.txt,880542,881983,1441,20,N,N,-,-1,-1
WESLEY.txt,880765,882331,1566,20,N,N,-,-1,-1
WESLEY.txt,881222,882736,1514,20,N,N,-,-1,-1
WESLEY.txt,881661,882955,1294,20,N,N,-,-1,-1
WESLEY.txt,881984,883448,1464,20,N,N,-,-1,-1
WESLEY.txt,882332,883942,1610,20,N,N,-,-1,-1
WESLEY.txt,882736,884509,1773,20,N,N,-,-1,-1
WESLEY.txt,882955,884808,1853,20,N,N,-,-1,-1
WESLEY.txt,883449,885408,1959,20,N,N,-,-1,-1
WESLEY.txt,883943,886287,2344,20,N,N,-,-1,-1
WESLEY.txt,884510,886931,2421,20,N,N,-,-1,-1
WESLEY.txt,884808,887716,2908,20,N,N,-,-1,-1
WESLEY.txt,885409,888753,3344,20,N,N,-,-1,-1
WESLEY.txt,886288,889699,3411,20,N,N,-,-1,-1
WESLEY.txt,886932,890635,3703,20,Y,N,-,-1,-1
WESLEY.txt,887717,891936,4219,20,Y,N,-,-1,-1
WESLEY.txt,888754,892400,3646,20,Y,N,-,-1,-1
WESLEY.txt,889700,894507,4807,20,N,N,-,-1,-1
WESLEY.txt,890636,894981,4345,20,N,N,-,-1,-1
WESLEY.txt,891937,895571,3634,20,N,N,-,-1,-1
WESLEY.txt,892401,896164,3763,20,Y,N,-,-1,-1
WESLEY.txt,894508,896713,2205,20,Y,N,-,-1,-1
