GLOVER.txt,0,1301,1301,10,N,N,-,-1,-1
GLOVER.txt,12,1306,1294,10,N,N,-,-1,-1
GLOVER.txt,101,1313,1212,10,N,N,-,-1,-1
GLOVER.txt,108,1366,1258,10,N,N,-,-1,-1
GLOVER.txt,152,1430,1278,10,N,N,-,-1,-1
GLOVER.txt,157,2600,2443,10,N,N,-,-1,-1
GLOVER.txt,185,2663,2478,10,N,N,-,-1,-1
GLOVER.txt,186,2693,2507,10,N,N,-,-1,-1
GLOVER.txt,216,2711,2495,10,N,N,-,-1,-1
GLOVER.txt,274,2737,2463,10,N,N,-,-1,-1
GLOVER.txt,1302,3994,2692,10,N,N,-,-1,-1
GLOVER.txt,1307,4764,3457,10,N,N,-,-1,-1
GLOVER.txt,1314,5258,3944,10,N,N,-,-1,-1
GLOVER.txt,1367,6119,4752,10,N,N,-,-1,-1
GLOVER.txt,1433,6791,5358,10,N,N,-,-1,-1
GLOVER.txt,2603,7196,4593,10,N,N,-,-1,-1
GLOVER.txt,2663,7539,4876,10,N,N,-,-1,-1
GLOVER.txt,2695,9636,6941,10,N,N,-,-1,-1
GLOVER.txt,2716,10191,7475,10,Y,N,-,-1,-1
GLOVER.txt,2738,11465,8727,10,Y,N,-,-1,-1
GLOVER.txt,3995,11467,7472,10,Y,N,-,-1,-1
GLOVER.txt,4765,13290,8525,10,N,N,-,-1,-1
GLOVER.txt,5260,14751,9491,10,N,N,-,-1,-1
GLOVER.txt,6120,14985,8865,10,N,N,-,-1,-1
GLOVER.txt,6792,15086,8294,10,N,N,-,-1,-1
GLOVER.txt,7197,15511,8314,10,N,N,-,-1,-1
GLOVER.txt,7540,15684,8144,10,N,N,-,-1,-1
GLOVER.txt,9637,15873,6236,10,Y,N,-,-1,-1
GLOVER.txt,10192,15902,5710,10,N,N,-,-1,-1
GLOVER.txt,11466,15956,4490,10,N,N,-,-1,-1
GLOVER.txt,11468,16363,4895,10,N,N,-,-1,-1
GLOVER.txt,13291,16571,3280,10,N,N,-,-1,-1
GLOVER.txt,14754,17147,2393,10,N,N,-,-1,-1
GLOVER.txt,14986,17341,2355,10,N,N,-,-1,-1
GLOVER.txt,15087,17420,2333,10,N,N,-,-1,-1
GLOVER.txt,15514,17590,2076,10,N,N,-,-1,-1
GLOVER.txt,15685,17849,2164,10,N,N,-,-1,-1
GLOVER.txt,15874,18127,2253,10,N,N,-,-1,-1
GLOVER.txt,15903,18492,2589,10,N,N,-,-1,-1
GLOVER.txt,15958,18570,2612,10,N,N,-,-1,-1
GLOVER.txt,16364,18754,2390,10,N,N,-,-1,-1
GLOVER.txt,16574,19246,2672,10,N,N,-,-1,-1
GLOVER.txt,17148,19337,2189,10,N,N,-,-1,-1
GLOVER.txt,17344,19753,2409,10,N,N,-,-1,-1
GLOVER.txt,17421,19950,2529,10,N,N,-,-1,-1
GLOVER.txt,17592,20075,2483,10,N,N,-,-1,-1
GLOVER.txt,17850,20119,2269,10,N,N,-,-1,-1
GLOVER.txt,18128,20386,2258,10,N,N,-,-1,-1
GLOVER.txt,18493,20589,2096,10,N,N,-,-1,-1
GLOVER.txt,18573,20651,2078,10,N,N,-,-1,-1
GLOVER.txt,18757,20786,2029,10,Y,N,-,-1,-1
GLOVER.txt,19247,20968,1721,10,Y,N,-,-1,-1
GLOVER.txt,19338,21080,1742,10,Y,N,-,-1,-1
GLOVER.txt,19756,21224,1468,10,Y,N,-,-1,-1
GLOVER.txt,19953,21648,1695,10,N,N,-,-1,-1
GLOVER.txt,20076,21810,1734,10,N,N,-,-1,-1
GLOVER.txt,20120,22040,1920,10,N,N,-,-1,-1
GLOVER.txt,20388,22091,1703,10,N,N,-,-1,-1
GLOVER.txt,20589,22401,1812,10,N,N,-,-1,-1
GLOVER.txt,20652,22698,2046,10,N,N,-,-1,-1
GLOVER.txt,20789,22790,2001,10,N,N,-,-1,-1
GLOVER.txt,20969,23092,2123,10,N,N,-,-1,-1
GLOVER.txt,21081,23196,2115,10,N,N,-,-1,-1
GLOVER.txt,21225,23351,2126,10,N,N,-,-1,-1
GLOVER.txt,21649,23480,1831,10,N,N,-,-1,-1
GLOVER.txt,21811,23617,1806,10,N,N,-,-1,-1
GLOVER.txt,22041,23733,1692,10,N,N,-,-1,-1
GLOVER.txt,22092,24146,2054,10,N,N,-,-1,-1
GLOVER.txt,22403,24272,1869,10,N,N,-,-1,-1
GLOVER.txt,22701,24383,1682,10,N,N,-,-1,-1
GLOVER.txt,22791,24428,1637,10,N,N,-,-1,-1
GLOVER.txt,23094,24475,1381,10,N,N,-,-1,-1
GLOVER.txt,23197,24514,1317,10,N,N,-,-1,-1
GLOVER.txt,23352,24598,1246,10,N,N,-,-1,-1
GLOVER.txt,23481,24618,1137,10,N,N,-,-1,-1
GLOVER.txt,23618,24644,1026,10,N,N,-,-1,-1
GLOVER.txt,23734,24718,984,10,N,N,-,-1,-1
GLOVER.txt,24147,24970,823,10,N,N,-,-1,-1
GLOVER.txt,24275,25009,734,10,N,N,-,-1,-1
GLOVER.txt,24384,25621,1237,10,N,N,-,-1,-1
GLOVER.txt,24429,25726,1297,10,N,N,-,-1,-1
GLOVER.txt,24476,25940,1464,10,N,N,-,-1,-1
GLOVER.txt,24515,26030,1515,10,N,N,-,-1,-1
GLOVER.txt,24599,26178,1579,10,N,N,-,-1,-1
GLOVER.txt,24619,26611,1992,10,N,N,-,-1,-1
GLOVER.txt,24645,26678,2033,10,N,N,-,-1,-1
GLOVER.txt,24721,26715,1994,10,N,N,-,-1,-1
GLOVER.txt,24971,26733,1762,10,N,N,-,-1,-1
GLOVER.txt,25010,26913,1903,10,N,N,-,-1,-1
GLOVER.txt,25624,27244,1620,10,N,N,-,-1,-1
GLOVER.txt,25731,27271,1540,10,N,N,-,-1,-1
GLOVER.txt,25941,27386,1445,10,N,N,-,-1,-1
GLOVER.txt,26031,27487,1456,10,N,N,-,-1,-1
GLOVER.txt,26181,27502,1321,10,N,N,-,-1,-1
GLOVER.txt,26612,27590,978,10,N,N,-,-1,-1
GLOVER.txt,26680,27890,1210,10,N,N,-,-1,-1
GLOVER.txt,26716,28280,1564,10,N,N,-,-1,-1
GLOVER.txt,26734,28435,1701,10,N,N,-,-1,-1
GLOVER.txt,26914,28596,1682,10,N,N,-,-1,-1
GLOVER.txt,27245,29039,1794,10,N,N,-,-1,-1
GLOVER.txt,27272,29377,2105,10,N,N,-,-1,-1
GLOVER.txt,27387,29503,2116,10,N,N,-,-1,-1
GLOVER.txt,27490,29703,2213,10,N,N,-,-1,-1
GLOVER.txt,27503,29728,2225,10,N,N,-,-1,-1
GLOVER.txt,27592,30182,2590,10,N,N,-,-1,-1
GLOVER.txt,27891,30590,2699,10,N,N,-,-1,-1
GLOVER.txt,28283,30880,2597,10,N,N,-,-1,-1
GLOVER.txt,28436,31253,2817,10,N,N,-,-1,-1
GLOVER.txt,28597,31500,2903,10,N,N,-,-1,-1
GLOVER.txt,29040,31590,2550,10,Y,N,-,-1,-1
GLOVER.txt,29378,31921,2543,10,N,N,-,-1,-1
GLOVER.txt,29506,31986,2480,10,N,N,-,-1,-1
GLOVER.txt,29705,32255,2550,10,N,N,-,-1,-1
GLOVER.txt,29729,32410,2681,10,N,N,-,-1,-1
GLOVER.txt,30184,32650,2466,10,Y,N,-,-1,-1
GLOVER.txt,30593,33075,2482,10,Y,N,-,-1,-1
GLOVER.txt,30883,33170,2287,10,N,N,-,-1,-1
GLOVER.txt,31254,33231,1977,10,N,N,-,-1,-1
GLOVER.txt,31503,33234,1731,10,N,N,-,-1,-1
GLOVER.txt,31591,33296,1705,10,N,N,-,-1,-1
GLOVER.txt,31922,33372,1450,10,N,N,-,-1,-1
GLOVER.txt,31987,33542,1555,10,N,N,-,-1,-1
GLOVER.txt,32258,33808,1550,10,N,N,-,-1,-1
GLOVER.txt,32411,33858,1447,10,N,N,-,-1,-1
GLOVER.txt,32651,34219,1568,10,N,N,-,-1,-1
GLOVER.txt,33078,34270,1192,10,N,N,-,-1,-1
GLOVER.txt,33172,34479,1307,10,N,N,-,-1,-1
GLOVER.txt,33232,34491,1259,10,N,N,-,-1,-1
GLOVER.txt,33235,34689,1454,10,N,N,-,-1,-1
GLOVER.txt,33297,35018,1721,10,N,N,-,-1,-1
GLOVER.txt,33373,35169,1796,10,N,N,-,-1,-1
GLOVER.txt,33543,35389,1846,10,N,N,-,-1,-1
GLOVER.txt,33811,35431,1620,10,N,N,-,-1,-1
GLOVER.txt,33863,35651,1788,10,N,N,-,-1,-1
GLOVER.txt,34220,35793,1573,10,N,N,-,-1,-1
GLOVER.txt,34271,35858,1587,10,N,N,-,-1,-1
GLOVER.txt,34480,35979,1499,10,N,N,-,-1,-1
GLOVER.txt,34493,36054,1561,10,N,N,-,-1,-1
GLOVER.txt,34692,36227,1535,10,N,N,-,-1,-1
GLOVER.txt,35019,36423,1404,10,N,N,-,-1,-1
GLOVER.txt,35171,36684,1513,10,N,N,-,-1,-1
GLOVER.txt,35392,36931,1539,10,N,N,-,-1,-1
GLOVER.txt,35432,36975,1543,10,N,N,-,-1,-1
GLOVER.txt,35652,37360,1708,10,N,N,-,-1,-1
GLOVER.txt,35796,37796,2000,10,N,N,-,-1,-1
GLOVER.txt,35859,37902,2043,10,N,N,-,-1,-1
GLOVER.txt,35980,38200,2220,10,N,N,-,-1,-1
GLOVER.txt,36055,38229,2174,10,N,N,-,-1,-1
GLOVER.txt,36228,38310,2082,10,N,N,-,-1,-1
GLOVER.txt,36426,38529,2103,10,N,N,-,-1,-1
GLOVER.txt,36685,38824,2139,10,N,N,-,-1,-1
GLOVER.txt,36934,38975,2041,10,N,N,-,-1,-1
GLOVER.txt,36976,39100,2124,10,N,N,-,-1,-1
GLOVER.txt,37361,39131,1770,10,N,N,-,-1,-1
GLOVER.txt,37799,39164,1365,10,N,N,-,-1,-1
GLOVER.txt,37905,39214,1309,10,N,N,-,-1,-1
GLOVER.txt,38203,39254,1051,10,N,N,-,-1,-1
GLOVER.txt,38230,39583,1353,10,N,N,-,-1,-1
GLOVER.txt,38311,39749,1438,10,N,N,-,-1,-1
GLOVER.txt,38530,40187,1657,10,N,N,-,-1,-1
GLOVER.txt,38825,40559,1734,10,N,N,-,-1,-1
GLOVER.txt,38976,40744,1768,10,N,N,-,-1,-1
GLOVER.txt,39101,40970,1869,10,N,N,-,-1,-1
GLOVER.txt,39132,41318,2186,10,N,N,-,-1,-1
GLOVER.txt,39165,41515,2350,10,N,N,-,-1,-1
GLOVER.txt,39217,41633,2416,10,N,N,-,-1,-1
GLOVER.txt,39257,41763,2506,10,N,N,-,-1,-1
GLOVER.txt,39584,42047,2463,10,N,N,-,-1,-1
GLOVER.txt,39750,42342,2592,10,N,N,-,-1,-1
GLOVER.txt,40188,42618,2430,10,N,N,-,-1,-1
GLOVER.txt,40560,42834,2274,10,N,N,-,-1,-1
GLOVER.txt,40745,43236,2491,10,N,N,-,-1,-1
GLOVER.txt,40971,43568,2597,10,N,N,-,-1,-1
GLOVER.txt,41321,43793,2472,10,N,N,-,-1,-1
GLOVER.txt,41516,43814,2298,10,N,N,-,-1,-1
GLOVER.txt,41634,43849,2215,10,N,N,-,-1,-1
GLOVER.txt,41765,43904,2139,10,N,N,-,-1,-1
GLOVER.txt,42049,44040,1991,10,N,N,-,-1,-1
GLOVER.txt,42345,44082,1737,10,N,N,-,-1,-1
GLOVER.txt,42619,44134,1515,10,N,N,-,-1,-1
GLOVER.txt,42834,44368,1534,10,N,N,-,-1,-1
GLOVER.txt,43237,44424,1187,10,N,N,-,-1,-1
GLOVER.txt,43569,44429,860,10,N,N,-,-1,-1
GLOVER.txt,43794,44539,745,10,N,N,-,-1,-1
GLOVER.txt,43815,44593,778,10,N,N,-,-1,-1
GLOVER.txt,43850,44893,1043,10,N,N,-,-1,-1
GLOVER.txt,43905,44931,1026,10,N,N,-,-1,-1
GLOVER.txt,44041,44963,922,10,N,N,-,-1,-1
GLOVER.txt,44083,45033,950,10,N,N,-,-1,-1
GLOVER.txt,44135,45046,911,10,N,N,-,-1,-1
GLOVER.txt,44369,45108,739,10,N,N,-,-1,-1
GLOVER.txt,44425,45176,751,10,N,N,-,-1,-1
GLOVER.txt,44430,45189,759,10,N,N,-,-1,-1
GLOVER.txt,44540,45634,1094,10,N,N,-,-1,-1
GLOVER.txt,44594,45702,1108,10,N,N,-,-1,-1
GLOVER.txt,44894,45855,961,10,N,N,-,-1,-1
GLOVER.txt,44932,45884,952,10,N,N,-,-1,-1
GLOVER.txt,44964,45889,925,10,N,N,-,-1,-1
GLOVER.txt,45034,45920,886,10,N,N,-,-1,-1
GLOVER.txt,45047,45942,895,10,N,N,-,-1,-1
GLOVER.txt,45109,45973,864,10,N,N,-,-1,-1
GLOVER.txt,45177,45990,813,10,N,N,-,-1,-1
GLOVER.txt,45190,46008,818,10,N,N,-,-1,-1
GLOVER.txt,45635,46039,404,10,N,N,-,-1,-1
GLOVER.txt,45703,46053,350,10,N,N,-,-1,-1
GLOVER.txt,45856,46066,210,10,N,N,-,-1,-1
GLOVER.txt,45885,46123,238,10,N,N,-,-1,-1
GLOVER.txt,45890,46231,341,10,N,N,-,-1,-1
GLOVER.txt,45922,46261,339,10,N,N,-,-1,-1
GLOVER.txt,45943,46299,356,10,N,N,-,-1,-1
GLOVER.txt,45974,46321,347,10,N,N,-,-1,-1
GLOVER.txt,45991,46336,345,10,N,N,-,-1,-1
GLOVER.txt,46009,46358,349,10,N,N,-,-1,-1
GLOVER.txt,46040,46485,445,10,N,N,-,-1,-1
GLOVER.txt,46054,46527,473,10,N,N,-,-1,-1
GLOVER.txt,46067,46630,563,10,N,N,-,-1,-1
GLOVER.txt,46124,46662,538,10,N,N,-,-1,-1
GLOVER.txt,46232,46897,665,10,N,N,-,-1,-1
GLOVER.txt,46262,46927,665,10,N,N,-,-1,-1
GLOVER.txt,46300,46929,629,10,N,N,-,-1,-1
GLOVER.txt,46322,46931,609,10,N,N,-,-1,-1
GLOVER.txt,46337,46971,634,10,N,N,-,-1,-1
GLOVER.txt,46359,47082,723,10,N,N,-,-1,-1
GLOVER.txt,46486,47110,624,10,N,N,-,-1,-1
GLOVER.txt,46529,47153,624,10,N,N,-,-1,-1
GLOVER.txt,46632,47200,568,10,N,N,-,-1,-1
GLOVER.txt,46663,47276,613,10,N,N,-,-1,-1
GLOVER.txt,46898,47351,453,10,N,N,-,-1,-1
GLOVER.txt,46928,47432,504,10,N,N,-,-1,-1
GLOVER.txt,46930,47574,644,10,N,N,-,-1,-1
GLOVER.txt,46932,47632,700,10,N,N,-,-1,-1
GLOVER.txt,46974,47874,900,10,N,N,-,-1,-1
GLOVER.txt,47083,48172,1089,10,N,N,-,-1,-1
GLOVER.txt,47111,48428,1317,10,N,N,-,-1,-1
GLOVER.txt,47154,48607,1453,10,N,N,-,-1,-1
GLOVER.txt,47201,48839,1638,10,N,N,-,-1,-1
GLOVER.txt,47279,48846,1567,10,N,N,-,-1,-1
GLOVER.txt,47352,49023,1671,10,N,N,-,-1,-1
GLOVER.txt,47433,49074,1641,10,N,N,-,-1,-1
GLOVER.txt,47576,49244,1668,10,N,N,-,-1,-1
GLOVER.txt,47633,49516,1883,10,N,N,-,-1,-1
GLOVER.txt,47875,49664,1789,10,N,N,-,-1,-1
GLOVER.txt,48175,49783,1608,10,N,N,-,-1,-1
GLOVER.txt,48431,49844,1413,10,N,N,-,-1,-1
GLOVER.txt,48609,50221,1612,10,N,N,-,-1,-1
GLOVER.txt,48840,50459,1619,10,N,N,-,-1,-1
GLOVER.txt,48847,50594,1747,10,N,N,-,-1,-1
GLOVER.txt,49026,50896,1870,10,N,N,-,-1,-1
GLOVER.txt,49076,51166,2090,10,N,N,-,-1,-1
GLOVER.txt,49245,51455,2210,10,N,N,-,-1,-1
GLOVER.txt,49517,51487,1970,10,N,N,-,-1,-1
GLOVER.txt,49665,51893,2228,10,N,N,-,-1,-1
GLOVER.txt,49785,51975,2190,10,N,N,-,-1,-1
GLOVER.txt,49845,51997,2152,10,N,N,-,-1,-1
GLOVER.txt,50222,52069,1847,10,N,N,-,-1,-1
GLOVER.txt,50462,52266,1804,10,N,N,-,-1,-1
GLOVER.txt,50597,52379,1782,10,N,N,-,-1,-1
GLOVER.txt,50897,52782,1885,10,N,N,-,-1,-1
GLOVER.txt,51167,52802,1635,10,N,N,-,-1,-1
GLOVER.txt,51456,52898,1442,10,N,N,-,-1,-1
GLOVER.txt,51490,52905,1415,10,N,N,-,-1,-1
GLOVER.txt,51895,53005,1110,10,N,N,-,-1,-1
GLOVER.txt,51978,53023,1045,10,N,N,-,-1,-1
GLOVER.txt,51998,53106,1108,10,N,N,-,-1,-1
GLOVER.txt,52070,53161,1091,10,N,N,-,-1,-1
GLOVER.txt,52269,53412,1143,10,N,N,-,-1,-1
GLOVER.txt,52380,53480,1100,10,N,N,-,-1,-1
GLOVER.txt,52785,53503,718,10,N,N,-,-1,-1
GLOVER.txt,52803,53602,799,10,N,N,-,-1,-1
GLOVER.txt,52901,53678,777,10,N,N,-,-1,-1
GLOVER.txt,52906,54018,1112,10,N,N,-,-1,-1
GLOVER.txt,53006,54072,1066,10,N,N,-,-1,-1
GLOVER.txt,53024,54177,1153,10,N,N,-,-1,-1
GLOVER.txt,53107,54314,1207,10,N,N,-,-1,-1
GLOVER.txt,53164,54343,1179,10,N,N,-,-1,-1
GLOVER.txt,53413,54398,985,10,N,N,-,-1,-1
GLOVER.txt,53481,54416,935,10,N,N,-,-1,-1
GLOVER.txt,53504,54427,923,10,N,N,-,-1,-1
GLOVER.txt,53603,54564,961,10,N,N,-,-1,-1
GLOVER.txt,53679,54675,996,10,N,N,-,-1,-1
GLOVER.txt,54019,54679,660,10,N,N,-,-1,-1
GLOVER.txt,54073,54687,614,10,N,N,-,-1,-1
GLOVER.txt,54178,54710,532,10,N,N,-,-1,-1
GLOVER.txt,54315,54911,596,10,N,N,-,-1,-1
GLOVER.txt,54344,55279,935,10,N,N,-,-1,-1
GLOVER.txt,54399,55368,969,10,N,N,-,-1,-1
GLOVER.txt,54417,55565,1148,10,N,N,-,-1,-1
GLOVER.txt,54428,55697,1269,10,N,N,-,-1,-1
GLOVER.txt,54565,55943,1378,10,N,N,-,-1,-1
GLOVER.txt,54676,56046,1370,10,N,N,-,-1,-1
GLOVER.txt,54680,56585,1905,10,N,N,-,-1,-1
GLOVER.txt,54688,56830,2142,10,N,N,-,-1,-1
GLOVER.txt,54712,57009,2297,10,N,N,-,-1,-1
GLOVER.txt,54914,57234,2320,10,N,N,-,-1,-1
GLOVER.txt,55281,57342,2061,10,N,N,-,-1,-1
GLOVER.txt,55370,57573,2203,10,N,N,-,-1,-1
GLOVER.txt,55568,57620,2052,10,N,N,-,-1,-1
GLOVER.txt,55700,57797,2097,10,N,N,-,-1,-1
GLOVER.txt,55944,57846,1902,10,N,N,-,-1,-1
GLOVER.txt,56047,58066,2019,10,N,N,-,-1,-1
GLOVER.txt,56586,58108,1522,10,N,N,-,-1,-1
GLOVER.txt,56833,58320,1487,10,N,N,-,-1,-1
GLOVER.txt,57010,58436,1426,10,N,N,-,-1,-1
GLOVER.txt,57235,58754,1519,10,N,N,-,-1,-1
GLOVER.txt,57343,58864,1521,10,N,N,-,-1,-1
GLOVER.txt,57576,59066,1490,10,N,N,-,-1,-1
GLOVER.txt,57622,59363,1741,10,N,N,-,-1,-1
GLOVER.txt,57798,59557,1759,10,N,N,-,-1,-1
GLOVER.txt,57847,59655,1808,10,N,N,-,-1,-1
GLOVER.txt,58068,59772,1704,10,N,N,-,-1,-1
GLOVER.txt,58109,59931,1822,10,N,N,-,-1,-1
GLOVER.txt,58321,60050,1729,10,N,N,-,-1,-1
GLOVER.txt,58437,60195,1758,10,N,N,-,-1,-1
GLOVER.txt,58755,60377,1622,10,N,N,-,-1,-1
GLOVER.txt,58865,60439,1574,10,N,N,-,-1,-1
GLOVER.txt,59069,60683,1614,10,N,N,-,-1,-1
GLOVER.txt,59365,60906,1541,10,N,N,-,-1,-1
GLOVER.txt,59558,61155,1597,10,N,N,-,-1,-1
GLOVER.txt,59656,61204,1548,10,N,N,-,-1,-1
GLOVER.txt,59773,61666,1893,10,N,N,-,-1,-1
GLOVER.txt,59934,62385,2451,10,N,N,-,-1,-1
GLOVER.txt,60053,62910,2857,10,N,N,-,-1,-1
GLOVER.txt,60197,63122,2925,10,N,N,-,-1,-1
GLOVER.txt,60378,63166,2788,10,N,N,-,-1,-1
GLOVER.txt,60441,63358,2917,10,N,N,-,-1,-1
GLOVER.txt,60684,63424,2740,10,N,N,-,-1,-1
GLOVER.txt,60909,63547,2638,10,N,N,-,-1,-1
GLOVER.txt,61156,63723,2567,10,Y,N,-,-1,-1
GLOVER.txt,61205,63871,2666,10,Y,N,-,-1,-1
GLOVER.txt,61671,63984,2313,10,Y,N,-,-1,-1
GLOVER.txt,62388,64142,1754,10,N,N,-,-1,-1
GLOVER.txt,62911,64239,1328,10,N,N,-,-1,-1
GLOVER.txt,63125,64515,1390,10,N,N,-,-1,-1
GLOVER.txt,63167,64653,1486,10,N,N,-,-1,-1
GLOVER.txt,63359,64822,1463,10,N,N,-,-1,-1
GLOVER.txt,63425,64894,1469,10,N,N,-,-1,-1
GLOVER.txt,63550,64967,1417,10,N,N,-,-1,-1
GLOVER.txt,63724,65082,1358,10,N,N,-,-1,-1
GLOVER.txt,63872,65423,1551,10,N,N,-,-1,-1
GLOVER.txt,63985,65463,1478,10,N,N,-,-1,-1
GLOVER.txt,64143,65652,1509,10,N,N,-,-1,-1
GLOVER.txt,64242,65761,1519,10,N,N,-,-1,-1
GLOVER.txt,64516,65848,1332,10,N,N,-,-1,-1
GLOVER.txt,64656,66083,1427,10,N,N,-,-1,-1
GLOVER.txt,64823,66278,1455,10,N,N,-,-1,-1
GLOVER.txt,64897,66399,1502,10,N,N,-,-1,-1
GLOVER.txt,64968,67137,2169,10,N,N,-,-1,-1
GLOVER.txt,65083,67237,2154,10,N,N,-,-1,-1
GLOVER.txt,65425,67424,1999,10,N,N,-,-1,-1
GLOVER.txt,65466,67552,2086,10,N,N,-,-1,-1
GLOVER.txt,65653,67838,2185,10,N,N,-,-1,-1
GLOVER.txt,65763,67979,2216,10,N,N,-,-1,-1
GLOVER.txt,65851,68215,2364,10,N,N,-,-1,-1
GLOVER.txt,66084,68435,2351,10,N,N,-,-1,-1
GLOVER.txt,66279,68729,2450,10,N,N,-,-1,-1
GLOVER.txt,66402,68793,2391,10,N,N,-,-1,-1
GLOVER.txt,67140,68941,1801,10,N,N,-,-1,-1
GLOVER.txt,67238,69058,1820,10,N,N,-,-1,-1
GLOVER.txt,67425,69249,1824,10,N,N,-,-1,-1
GLOVER.txt,67553,69460,1907,10,N,N,-,-1,-1
GLOVER.txt,67839,69760,1921,10,N,N,-,-1,-1
GLOVER.txt,67982,69848,1866,10,N,N,-,-1,-1
GLOVER.txt,68218,70067,1849,10,N,N,-,-1,-1
GLOVER.txt,68438,70151,1713,10,N,N,-,-1,-1
GLOVER.txt,68730,70651,1921,10,N,N,-,-1,-1
GLOVER.txt,68794,70950,2156,10,N,N,-,-1,-1
GLOVER.txt,68944,71217,2273,10,N,N,-,-1,-1
GLOVER.txt,69059,71439,2380,10,N,N,-,-1,-1
GLOVER.txt,69250,71840,2590,10,N,N,-,-1,-1
GLOVER.txt,69461,72062,2601,10,N,N,-,-1,-1
GLOVER.txt,69761,72139,2378,10,N,N,-,-1,-1
GLOVER.txt,69850,72464,2614,10,N,N,-,-1,-1
GLOVER.txt,70070,72704,2634,10,N,N,-,-1,-1
GLOVER.txt,70152,72981,2829,10,N,N,-,-1,-1
GLOVER.txt,70654,73091,2437,10,N,N,-,-1,-1
GLOVER.txt,70952,73239,2287,10,N,N,-,-1,-1
GLOVER.txt,71220,73732,2512,10,N,N,-,-1,-1
GLOVER.txt,71440,73911,2471,10,N,N,-,-1,-1
GLOVER.txt,71841,74262,2421,10,N,N,-,-1,-1
GLOVER.txt,72063,74481,2418,10,N,N,-,-1,-1
GLOVER.txt,72142,74651,2509,10,N,N,-,-1,-1
GLOVER.txt,72465,75003,2538,10,N,N,-,-1,-1
GLOVER.txt,72707,75042,2335,10,N,N,-,-1,-1
GLOVER.txt,72982,75073,2091,10,N,N,-,-1,-1
GLOVER.txt,73092,75242,2150,10,N,N,-,-1,-1
GLOVER.txt,73240,75406,2166,10,N,N,-,-1,-1
GLOVER.txt,73734,75662,1928,10,N,N,-,-1,-1
GLOVER.txt,73914,75999,2085,10,N,N,-,-1,-1
GLOVER.txt,74263,76058,1795,10,N,N,-,-1,-1
GLOVER.txt,74482,76231,1749,10,N,N,-,-1,-1
GLOVER.txt,74654,76383,1729,10,N,N,-,-1,-1
GLOVER.txt,75006,76498,1492,10,N,N,-,-1,-1
GLOVER.txt,75043,76621,1578,10,N,N,-,-1,-1
GLOVER.txt,75074,77073,1999,10,N,N,-,-1,-1
GLOVER.txt,75243,77189,1946,10,N,N,-,-1,-1
GLOVER.txt,75409,77412,2003,10,N,N,-,-1,-1
GLOVER.txt,75663,77614,1951,10,N,N,-,-1,-1
GLOVER.txt,76000,77989,1989,10,N,N,-,-1,-1
GLOVER.txt,76061,78286,2225,10,N,N,-,-1,-1
GLOVER.txt,76232,78588,2356,10,N,N,-,-1,-1
GLOVER.txt,76384,78666,2282,10,N,N,-,-1,-1
GLOVER.txt,76501,78733,2232,10,N,N,-,-1,-1
GLOVER.txt,76622,79151,2529,10,N,N,-,-1,-1
GLOVER.txt,77074,79328,2254,10,N,N,-,-1,-1
GLOVER.txt,77192,79518,2326,10,N,N,-,-1,-1
GLOVER.txt,77413,79974,2561,10,N,N,-,-1,-1
GLOVER.txt,77615,80178,2563,10,N,N,-,-1,-1
GLOVER.txt,77992,80906,2914,10,N,N,-,-1,-1
GLOVER.txt,78287,81106,2819,10,N,N,-,-1,-1
GLOVER.txt,78589,81335,2746,10,N,N,-,-1,-1
GLOVER.txt,78667,81497,2830,10,N,N,-,-1,-1
GLOVER.txt,78734,81725,2991,10,N,N,-,-1,-1
GLOVER.txt,79154,81787,2633,10,N,N,-,-1,-1
GLOVER.txt,79329,82066,2737,10,N,N,-,-1,-1
GLOVER.txt,79519,82221,2702,10,N,N,-,-1,-1
GLOVER.txt,79975,82469,2494,10,N,N,-,-1,-1
GLOVER.txt,80179,82837,2658,10,N,N,-,-1,-1
GLOVER.txt,80909,83118,2209,10,N,N,-,-1,-1
GLOVER.txt,81108,83456,2348,10,N,N,-,-1,-1
GLOVER.txt,81336,83511,2175,10,N,N,-,-1,-1
GLOVER.txt,81500,83739,2239,10,N,N,-,-1,-1
GLOVER.txt,81728,83826,2098,10,N,N,-,-1,-1
GLOVER.txt,81788,84102,2314,10,N,N,-,-1,-1
GLOVER.txt,82067,84336,2269,10,N,N,-,-1,-1
GLOVER.txt,82223,84675,2452,10,N,N,-,-1,-1
GLOVER.txt,82470,84841,2371,10,N,N,-,-1,-1
GLOVER.txt,82840,85216,2376,10,N,N,-,-1,-1
GLOVER.txt,83119,85295,2176,10,N,N,-,-1,-1
GLOVER.txt,83457,85550,2093,10,N,N,-,-1,-1
GLOVER.txt,83512,86241,2729,10,N,N,-,-1,-1
GLOVER.txt,83740,86480,2740,10,N,N,-,-1,-1
GLOVER.txt,83827,86571,2744,10,N,N,-,-1,-1
GLOVER.txt,84105,86807,2702,10,N,N,-,-1,-1
GLOVER.txt,84337,87037,2700,10,N,N,-,-1,-1
GLOVER.txt,84676,87088,2412,10,N,N,-,-1,-1
GLOVER.txt,84842,87212,2370,10,N,N,-,-1,-1
GLOVER.txt,85217,87603,2386,10,N,N,-,-1,-1
GLOVER.txt,85296,87799,2503,10,N,N,-,-1,-1
GLOVER.txt,85553,88024,2471,10,N,N,-,-1,-1
GLOVER.txt,86242,88106,1864,10,N,N,-,-1,-1
GLOVER.txt,86481,88226,1745,10,N,N,-,-1,-1
GLOVER.txt,86576,88440,1864,10,N,N,-,-1,-1
GLOVER.txt,86808,88521,1713,10,N,N,-,-1,-1
GLOVER.txt,87039,88624,1585,10,N,N,-,-1,-1
GLOVER.txt,87091,88644,1553,10,N,N,-,-1,-1
GLOVER.txt,87213,88775,1562,10,Y,N,-,-1,-1
GLOVER.txt,87604,88943,1339,10,N,N,-,-1,-1
GLOVER.txt,87800,89000,1200,10,N,N,-,-1,-1
GLOVER.txt,88025,89064,1039,10,N,N,-,-1,-1
GLOVER.txt,88107,89100,993,10,N,N,-,-1,-1
GLOVER.txt,88227,89144,917,10,N,N,-,-1,-1
GLOVER.txt,88441,89344,903,10,N,N,-,-1,-1
GLOVER.txt,88522,89388,866,10,N,N,-,-1,-1
GLOVER.txt,88625,89397,772,10,N,N,-,-1,-1
GLOVER.txt,88645,89551,906,10,N,N,-,-1,-1
GLOVER.txt,88776,89711,935,10,N,N,-,-1,-1
GLOVER.txt,88944,89775,831,10,N,N,-,-1,-1
GLOVER.txt,89003,89865,862,10,N,N,-,-1,-1
GLOVER.txt,89065,90279,1214,10,N,N,-,-1,-1
GLOVER.txt,89101,90309,1208,10,N,N,-,-1,-1
GLOVER.txt,89144,90339,1195,10,N,N,-,-1,-1
GLOVER.txt,89344,90580,1236,10,N,N,-,-1,-1
GLOVER.txt,89389,90877,1488,10,N,N,-,-1,-1
GLOVER.txt,89397,91047,1650,10,N,N,-,-1,-1
GLOVER.txt,89551,91876,2325,10,N,N,-,-1,-1
GLOVER.txt,89712,91938,2226,10,N,N,-,-1,-1
GLOVER.txt,89775,92347,2572,10,N,N,-,-1,-1
GLOVER.txt,89866,92556,2690,10,N,N,-,-1,-1
GLOVER.txt,90280,93253,2973,10,N,N,-,-1,-1
GLOVER.txt,90312,93257,2945,10,N,N,-,-1,-1
GLOVER.txt,90340,93266,2926,10,N,N,-,-1,-1
GLOVER.txt,90581,93391,2810,10,N,N,-,-1,-1
GLOVER.txt,90878,93444,2566,10,N,N,-,-1,-1
GLOVER.txt,91048,93704,2656,10,N,N,-,-1,-1
GLOVER.txt,91879,93771,1892,10,N,N,-,-1,-1
GLOVER.txt,91939,93996,2057,10,N,N,-,-1,-1
GLOVER.txt,92348,94106,1758,10,N,N,-,-1,-1
GLOVER.txt,92557,94140,1583,10,N,N,-,-1,-1
GLOVER.txt,93254,94182,928,10,N,N,-,-1,-1
GLOVER.txt,93258,94273,1015,10,N,N,-,-1,-1
GLOVER.txt,93267,94525,1258,10,N,N,-,-1,-1
GLOVER.txt,93392,94978,1586,10,N,N,-,-1,-1
GLOVER.txt,93447,95085,1638,10,N,N,-,-1,-1
GLOVER.txt,93705,95699,1994,10,Y,N,-,-1,-1
GLOVER.txt,93772,95813,2041,10,Y,N,-,-1,-1
GLOVER.txt,93997,96128,2131,10,Y,N,-,-1,-1
GLOVER.txt,94107,96151,2044,10,Y,N,-,-1,-1
GLOVER.txt,94142,96185,2043,10,Y,N,-,-1,-1
GLOVER.txt,94183,96279,2096,10,Y,N,-,-1,-1
GLOVER.txt,94274,96301,2027,10,Y,N,-,-1,-1
GLOVER.txt,94526,96552,2026,10,Y,N,-,-1,-1
GLOVER.txt,94979,96716,1737,10,Y,N,-,-1,-1
GLOVER.txt,95090,97086,1996,10,N,N,-,-1,-1
GLOVER.txt,95702,97328,1626,10,N,N,-,-1,-1
GLOVER.txt,95814,97528,1714,10,N,N,-,-1,-1
GLOVER.txt,96129,97560,1431,10,N,N,-,-1,-1
GLOVER.txt,96153,97590,1437,10,N,N,-,-1,-1
GLOVER.txt,96186,97721,1535,10,N,N,-,-1,-1
GLOVER.txt,96280,98058,1778,10,N,N,-,-1,-1
GLOVER.txt,96304,98207,1903,10,N,N,-,-1,-1
GLOVER.txt,96554,98325,1771,10,N,N,-,-1,-1
GLOVER.txt,96719,98446,1727,10,N,N,-,-1,-1
GLOVER.txt,97087,98593,1506,10,N,N,-,-1,-1
GLOVER.txt,97329,99079,1750,10,N,N,-,-1,-1
GLOVER.txt,97529,99118,1589,10,N,N,-,-1,-1
GLOVER.txt,97563,99363,1800,10,N,N,-,-1,-1
GLOVER.txt,97591,99583,1992,10,N,N,-,-1,-1
GLOVER.txt,97722,99886,2164,10,N,N,-,-1,-1
GLOVER.txt,98061,99969,1908,10,N,N,-,-1,-1
GLOVER.txt,98209,100142,1933,10,N,N,-,-1,-1
GLOVER.txt,98326,100433,2107,10,N,N,-,-1,-1
GLOVER.txt,98447,100502,2055,10,N,N,-,-1,-1
GLOVER.txt,98594,100534,1940,10,N,N,-,-1,-1
GLOVER.txt,99080,100652,1572,10,N,N,-,-1,-1
GLOVER.txt,99119,100781,1662,10,N,N,-,-1,-1
GLOVER.txt,99364,100901,1537,10,N,N,-,-1,-1
GLOVER.txt,99585,101015,1430,10,N,N,-,-1,-1
GLOVER.txt,99889,101157,1268,10,N,N,-,-1,-1
GLOVER.txt,99970,101350,1380,10,N,N,-,-1,-1
GLOVER.txt,100143,101473,1330,10,N,N,-,-1,-1
GLOVER.txt,100434,101615,1181,10,N,N,-,-1,-1
GLOVER.txt,100505,101796,1291,10,N,N,-,-1,-1
GLOVER.txt,100539,101864,1325,10,N,N,-,-1,-1
GLOVER.txt,100653,101903,1250,10,N,N,-,-1,-1
GLOVER.txt,100782,102008,1226,10,N,N,-,-1,-1
GLOVER.txt,100903,102035,1132,10,N,N,-,-1,-1
GLOVER.txt,101016,102050,1034,10,N,N,-,-1,-1
GLOVER.txt,101160,102069,909,10,N,N,-,-1,-1
GLOVER.txt,101351,102152,801,10,N,N,-,-1,-1
GLOVER.txt,101476,102216,740,10,N,N,-,-1,-1
GLOVER.txt,101616,102765,1149,10,N,N,-,-1,-1
GLOVER.txt,101797,103137,1340,10,N,N,-,-1,-1
GLOVER.txt,101865,103272,1407,10,N,N,-,-1,-1
GLOVER.txt,101904,103428,1524,10,N,N,-,-1,-1
GLOVER.txt,102009,103557,1548,10,N,N,-,-1,-1
GLOVER.txt,102036,103902,1866,10,N,N,-,-1,-1
GLOVER.txt,102051,104065,2014,10,N,N,-,-1,-1
GLOVER.txt,102070,104545,2475,10,N,N,-,-1,-1
GLOVER.txt,102153,104800,2647,10,N,N,-,-1,-1
GLOVER.txt,102219,104857,2638,10,N,N,-,-1,-1
GLOVER.txt,102768,104972,2204,10,N,N,-,-1,-1
GLOVER.txt,103140,105135,1995,10,N,N,-,-1,-1
GLOVER.txt,103273,105297,2024,10,N,N,-,-1,-1
GLOVER.txt,103430,105406,1976,10,N,N,-,-1,-1
GLOVER.txt,103558,105673,2115,10,N,N,-,-1,-1
GLOVER.txt,103903,105769,1866,10,N,Y,1436867017136,105674,106651
GLOVER.txt,104066,106144,2078,10,N,Y,1436867017136,105674,106651
GLOVER.txt,104546,106250,1704,10,N,Y,1436867017136,105674,106651
GLOVER.txt,104801,106675,1874,10,N,Y,1436867017136,105674,106651
GLOVER.txt,104858,106787,1929,10,N,Y,1436867017136,105674,106651
GLOVER.txt,104975,107082,2107,10,N,Y,1436867017136,105674,106651
GLOVER.txt,105136,107392,2256,10,Y,Y,1436867017136,105674,106651
GLOVER.txt,105300,107684,2384,10,Y,Y,1436867017136,105674,106651
GLOVER.txt,105407,107779,2372,10,Y,Y,1436867017136,105674,106651
GLOVER.txt,105676,107853,2177,10,Y,Y,1436867017136,105674,106651
GLOVER.txt,105770,108118,2348,10,Y,Y,1436867017136,105674,106651
GLOVER.txt,106145,108299,2154,10,Y,Y,1436867017136,105674,106651
GLOVER.txt,106251,108406,2155,10,Y,Y,1436867017136,105674,106651
GLOVER.txt,106676,108976,2300,10,N,N,-,-1,-1
GLOVER.txt,106789,109147,2358,10,N,N,-,-1,-1
GLOVER.txt,107083,109242,2159,10,N,N,-,-1,-1
GLOVER.txt,107395,109430,2035,10,N,N,-,-1,-1
GLOVER.txt,107687,109583,1896,10,N,N,-,-1,-1
GLOVER.txt,107780,109685,1905,10,N,N,-,-1,-1
GLOVER.txt,107854,109831,1977,10,N,N,-,-1,-1
GLOVER.txt,108119,110055,1936,10,N,N,-,-1,-1
GLOVER.txt,108300,110162,1862,10,N,N,-,-1,-1
GLOVER.txt,108407,110274,1867,10,N,N,-,-1,-1
GLOVER.txt,108981,110398,1417,10,N,N,-,-1,-1
GLOVER.txt,109148,110499,1351,10,N,N,-,-1,-1
GLOVER.txt,109243,110511,1268,10,N,N,-,-1,-1
GLOVER.txt,109431,110752,1321,10,N,N,-,-1,-1
GLOVER.txt,109584,110955,1371,10,N,N,-,-1,-1
GLOVER.txt,109688,111107,1419,10,N,N,-,-1,-1
GLOVER.txt,109832,111276,1444,10,N,N,-,-1,-1
GLOVER.txt,110056,111385,1329,10,N,N,-,-1,-1
GLOVER.txt,110163,111660,1497,10,N,N,-,-1,-1
GLOVER.txt,110275,112012,1737,10,N,N,-,-1,-1
GLOVER.txt,110399,112215,1816,10,N,N,-,-1,-1
GLOVER.txt,110501,112384,1883,10,N,N,-,-1,-1
GLOVER.txt,110514,112511,1997,10,Y,N,-,-1,-1
GLOVER.txt,110753,112651,1898,10,N,N,-,-1,-1
GLOVER.txt,110957,112819,1862,10,N,N,-,-1,-1
GLOVER.txt,111108,112930,1822,10,Y,N,-,-1,-1
GLOVER.txt,111277,112950,1673,10,Y,N,-,-1,-1
GLOVER.txt,111386,113040,1654,10,Y,N,-,-1,-1
GLOVER.txt,111661,113093,1432,10,Y,N,-,-1,-1
GLOVER.txt,112015,113101,1086,10,N,N,-,-1,-1
GLOVER.txt,112218,113326,1108,10,N,N,-,-1,-1
GLOVER.txt,112385,113539,1154,10,N,N,-,-1,-1
GLOVER.txt,112513,113817,1304,10,N,N,-,-1,-1
GLOVER.txt,112652,113839,1187,10,N,N,-,-1,-1
GLOVER.txt,112820,114070,1250,10,N,N,-,-1,-1
GLOVER.txt,112931,114241,1310,10,N,N,-,-1,-1
GLOVER.txt,112951,114331,1380,10,N,N,-,-1,-1
GLOVER.txt,113041,114360,1319,10,N,N,-,-1,-1
GLOVER.txt,113094,114539,1445,10,N,N,-,-1,-1
GLOVER.txt,113103,114743,1640,10,N,N,-,-1,-1
GLOVER.txt,113327,114816,1489,10,N,N,-,-1,-1
GLOVER.txt,113542,115303,1761,10,N,N,-,-1,-1
GLOVER.txt,113818,115452,1634,10,N,N,-,-1,-1
GLOVER.txt,113840,115518,1678,10,N,N,-,-1,-1
GLOVER.txt,114072,115635,1563,10,N,N,-,-1,-1
GLOVER.txt,114242,115837,1595,10,N,N,-,-1,-1
GLOVER.txt,114332,116048,1716,10,N,N,-,-1,-1
GLOVER.txt,114361,116395,2034,10,N,N,-,-1,-1
GLOVER.txt,114540,116485,1945,10,N,N,-,-1,-1
GLOVER.txt,114746,116576,1830,10,N,N,-,-1,-1
GLOVER.txt,114817,116694,1877,10,N,N,-,-1,-1
GLOVER.txt,115304,117243,1939,10,N,N,-,-1,-1
GLOVER.txt,115455,117354,1899,10,N,N,-,-1,-1
GLOVER.txt,115519,117409,1890,10,N,N,-,-1,-1
GLOVER.txt,115636,117496,1860,10,N,N,-,-1,-1
GLOVER.txt,115838,117521,1683,10,N,N,-,-1,-1
GLOVER.txt,116049,117616,1567,10,N,N,-,-1,-1
GLOVER.txt,116396,117690,1294,10,N,N,-,-1,-1
GLOVER.txt,116486,118098,1612,10,N,N,-,-1,-1
GLOVER.txt,116577,118468,1891,10,Y,N,-,-1,-1
GLOVER.txt,116695,118633,1938,10,Y,N,-,-1,-1
GLOVER.txt,117248,118705,1457,10,Y,N,-,-1,-1
GLOVER.txt,117357,118847,1490,10,Y,N,-,-1,-1
GLOVER.txt,117410,118921,1511,10,Y,N,-,-1,-1
GLOVER.txt,117497,118966,1469,10,N,N,-,-1,-1
GLOVER.txt,117522,118990,1468,10,N,N,-,-1,-1
GLOVER.txt,117617,119173,1556,10,N,N,-,-1,-1
GLOVER.txt,117691,119246,1555,10,N,N,-,-1,-1
GLOVER.txt,118099,119444,1345,10,Y,N,-,-1,-1
GLOVER.txt,118469,119498,1029,10,Y,N,-,-1,-1
GLOVER.txt,118636,119568,932,10,N,N,-,-1,-1
GLOVER.txt,118706,119809,1103,10,N,N,-,-1,-1
GLOVER.txt,118850,120141,1291,10,Y,N,-,-1,-1
GLOVER.txt,118922,120473,1551,10,Y,N,-,-1,-1
GLOVER.txt,118967,120719,1752,10,Y,N,-,-1,-1
GLOVER.txt,118991,120755,1764,10,Y,N,-,-1,-1
GLOVER.txt,119174,120896,1722,10,Y,N,-,-1,-1
GLOVER.txt,119247,121270,2023,10,Y,N,-,-1,-1
GLOVER.txt,119445,121403,1958,10,Y,N,-,-1,-1
GLOVER.txt,119499,121575,2076,10,Y,Y,1437028092146,121457,123204
GLOVER.txt,119569,121596,2027,10,Y,Y,1437028092146,121457,123204
GLOVER.txt,119810,121759,1949,10,N,Y,1437028092146,121457,123204
GLOVER.txt,120144,121872,1728,10,Y,Y,1437028092146,121457,123204
GLOVER.txt,120474,121976,1502,10,Y,Y,1437028092146,121457,123204
GLOVER.txt,120720,122220,1500,10,Y,Y,1437028092146,121457,123204
GLOVER.txt,120756,122298,1542,10,Y,Y,1437028092146,121457,123204
GLOVER.txt,120897,122348,1451,10,Y,Y,1437028092146,121457,123204
GLOVER.txt,121273,122519,1246,10,N,Y,1437028092146,121457,123204
GLOVER.txt,121405,122727,1322,10,N,Y,1437028092146,121457,123204
GLOVER.txt,121576,123205,1629,10,N,Y,1437028092146,121457,123204
GLOVER.txt,121597,123288,1691,10,N,Y,1437028092146,121457,123204
GLOVER.txt,121760,123371,1611,10,N,Y,1437028092146,121457,123204
GLOVER.txt,121873,123497,1624,10,N,Y,1437028092146,121457,123204
GLOVER.txt,121977,123906,1929,10,N,Y,1437028092146,121457,123204
GLOVER.txt,122221,124043,1822,10,N,Y,1437028092146,121457,123204
GLOVER.txt,122298,124345,2047,10,N,Y,1437028092146,121457,123204
GLOVER.txt,122349,124527,2178,10,N,Y,1437028092146,121457,123204
GLOVER.txt,122520,124702,2182,10,N,Y,1437028092146,121457,123204
GLOVER.txt,122728,124897,2169,10,N,Y,1437028092146,121457,123204
GLOVER.txt,123208,125078,1870,10,N,N,-,-1,-1
GLOVER.txt,123289,125173,1884,10,N,N,-,-1,-1
GLOVER.txt,123372,125385,2013,10,N,N,-,-1,-1
GLOVER.txt,123502,125433,1931,10,N,N,-,-1,-1
GLOVER.txt,123909,125842,1933,10,N,N,-,-1,-1
GLOVER.txt,124044,125898,1854,10,Y,N,-,-1,-1
GLOVER.txt,124346,125971,1625,10,N,N,-,-1,-1
GLOVER.txt,124530,126303,1773,10,N,N,-,-1,-1
GLOVER.txt,124703,126316,1613,10,N,N,-,-1,-1
GLOVER.txt,124898,126451,1553,10,N,N,-,-1,-1
GLOVER.txt,125080,126555,1475,10,N,N,-,-1,-1
GLOVER.txt,125174,126634,1460,10,N,N,-,-1,-1
GLOVER.txt,125386,126638,1252,10,N,N,-,-1,-1
GLOVER.txt,125434,126669,1235,10,N,N,-,-1,-1
GLOVER.txt,125843,126795,952,10,Y,N,-,-1,-1
GLOVER.txt,125899,126932,1033,10,Y,N,-,-1,-1
GLOVER.txt,125972,127088,1116,10,Y,N,-,-1,-1
GLOVER.txt,126304,127284,980,10,Y,N,-,-1,-1
GLOVER.txt,126319,127361,1042,10,N,N,-,-1,-1
GLOVER.txt,126454,127490,1036,10,N,N,-,-1,-1
GLOVER.txt,126556,127580,1024,10,N,N,-,-1,-1
GLOVER.txt,126635,127666,1031,10,N,N,-,-1,-1
GLOVER.txt,126639,127846,1207,10,N,N,-,-1,-1
GLOVER.txt,126670,127977,1307,10,N,N,-,-1,-1
GLOVER.txt,126798,128028,1230,10,N,N,-,-1,-1
GLOVER.txt,126933,128725,1792,10,N,N,-,-1,-1
GLOVER.txt,127089,128874,1785,10,N,N,-,-1,-1
GLOVER.txt,127287,129133,1846,10,N,N,-,-1,-1
GLOVER.txt,127364,129418,2054,10,N,N,-,-1,-1
GLOVER.txt,127491,129608,2117,10,N,N,-,-1,-1
GLOVER.txt,127581,129848,2267,10,N,N,-,-1,-1
GLOVER.txt,127671,129951,2280,10,N,N,-,-1,-1
GLOVER.txt,127847,130298,2451,10,N,N,-,-1,-1
GLOVER.txt,127978,130778,2800,10,N,N,-,-1,-1
GLOVER.txt,128033,130982,2949,10,N,N,-,-1,-1
GLOVER.txt,128728,131023,2295,10,N,N,-,-1,-1
GLOVER.txt,128876,131076,2200,10,N,N,-,-1,-1
GLOVER.txt,129134,131097,1963,10,N,N,-,-1,-1
GLOVER.txt,129419,131147,1728,10,N,N,-,-1,-1
GLOVER.txt,129610,131169,1559,10,N,N,-,-1,-1
GLOVER.txt,129849,131241,1392,10,N,N,-,-1,-1
GLOVER.txt,129952,131599,1647,10,N,N,-,-1,-1
GLOVER.txt,130299,131700,1401,10,N,N,-,-1,-1
GLOVER.txt,130779,132228,1449,10,N,N,-,-1,-1
GLOVER.txt,130983,132412,1429,10,N,N,-,-1,-1
GLOVER.txt,131024,132667,1643,10,N,N,-,-1,-1
GLOVER.txt,131077,132775,1698,10,N,N,-,-1,-1
GLOVER.txt,131098,133176,2078,10,N,N,-,-1,-1
GLOVER.txt,131148,133436,2288,10,N,N,-,-1,-1
GLOVER.txt,131170,133754,2584,10,N,N,-,-1,-1
GLOVER.txt,131242,133944,2702,10,N,N,-,-1,-1
GLOVER.txt,131600,134109,2509,10,N,N,-,-1,-1
GLOVER.txt,131703,134513,2810,10,N,N,-,-1,-1
GLOVER.txt,132229,134743,2514,10,N,N,-,-1,-1
GLOVER.txt,132415,135125,2710,10,N,N,-,-1,-1
GLOVER.txt,132668,135177,2509,10,N,N,-,-1,-1
GLOVER.txt,132776,135550,2774,10,N,N,-,-1,-1
GLOVER.txt,133177,135822,2645,10,N,N,-,-1,-1
GLOVER.txt,133439,136023,2584,10,N,N,-,-1,-1
GLOVER.txt,133755,136184,2429,10,N,N,-,-1,-1
GLOVER.txt,133949,136310,2361,10,N,N,-,-1,-1
GLOVER.txt,134110,136352,2242,10,N,N,-,-1,-1
GLOVER.txt,134514,136645,2131,10,N,N,-,-1,-1
GLOVER.txt,134744,136706,1962,10,N,N,-,-1,-1
GLOVER.txt,135126,136754,1628,10,N,N,-,-1,-1
GLOVER.txt,135178,137359,2181,10,N,N,-,-1,-1
GLOVER.txt,135553,137486,1933,10,N,N,-,-1,-1
GLOVER.txt,135823,137671,1848,10,N,N,-,-1,-1
GLOVER.txt,136024,137883,1859,10,N,N,-,-1,-1
GLOVER.txt,136185,138196,2011,10,N,N,-,-1,-1
GLOVER.txt,136313,138304,1991,10,N,N,-,-1,-1
GLOVER.txt,136353,138437,2084,10,N,N,-,-1,-1
GLOVER.txt,136646,138527,1881,10,N,N,-,-1,-1
GLOVER.txt,136708,138576,1868,10,N,N,-,-1,-1
GLOVER.txt,136756,138613,1857,10,N,N,-,-1,-1
GLOVER.txt,137361,138639,1278,10,N,N,-,-1,-1
GLOVER.txt,137487,138677,1190,10,N,N,-,-1,-1
GLOVER.txt,137674,138693,1019,10,N,N,-,-1,-1
GLOVER.txt,137884,138858,974,10,N,N,-,-1,-1
GLOVER.txt,138197,139100,903,10,N,N,-,-1,-1
GLOVER.txt,138306,139280,974,10,N,N,-,-1,-1
GLOVER.txt,138438,139361,923,10,N,N,-,-1,-1
GLOVER.txt,138528,139423,895,10,N,N,-,-1,-1
GLOVER.txt,138577,139529,952,10,N,N,-,-1,-1
GLOVER.txt,138614,139543,929,10,N,N,-,-1,-1
GLOVER.txt,138640,139574,934,10,N,N,-,-1,-1
GLOVER.txt,138678,139595,917,10,N,N,-,-1,-1
GLOVER.txt,138694,139668,974,10,N,N,-,-1,-1
GLOVER.txt,138859,139737,878,10,N,N,-,-1,-1
GLOVER.txt,139101,139849,748,10,N,N,-,-1,-1
GLOVER.txt,139281,139911,630,10,N,N,-,-1,-1
GLOVER.txt,139362,140033,671,10,N,N,-,-1,-1
GLOVER.txt,139426,140090,664,10,N,N,-,-1,-1
GLOVER.txt,139530,140141,611,10,N,N,-,-1,-1
GLOVER.txt,139544,140244,700,10,N,N,-,-1,-1
GLOVER.txt,139576,140317,741,10,N,N,-,-1,-1
GLOVER.txt,139596,140679,1083,10,N,N,-,-1,-1
GLOVER.txt,139669,140725,1056,10,N,N,-,-1,-1
GLOVER.txt,139738,140752,1014,10,N,N,-,-1,-1
GLOVER.txt,139850,140795,945,10,N,N,-,-1,-1
GLOVER.txt,139912,141020,1108,10,N,N,-,-1,-1
GLOVER.txt,140034,141373,1339,10,N,N,-,-1,-1
GLOVER.txt,140091,141540,1449,10,N,N,-,-1,-1
GLOVER.txt,140142,141669,1527,10,N,N,-,-1,-1
GLOVER.txt,140245,141785,1540,10,N,N,-,-1,-1
GLOVER.txt,140318,141908,1590,10,N,N,-,-1,-1
GLOVER.txt,140680,142397,1717,10,N,N,-,-1,-1
GLOVER.txt,140726,142743,2017,10,N,N,-,-1,-1
GLOVER.txt,140753,142926,2173,10,N,N,-,-1,-1
GLOVER.txt,140796,143013,2217,10,N,N,-,-1,-1
GLOVER.txt,141021,143184,2163,10,N,N,-,-1,-1
GLOVER.txt,141374,143384,2010,10,N,N,-,-1,-1
GLOVER.txt,141542,143589,2047,10,N,N,-,-1,-1
GLOVER.txt,141670,143963,2293,10,N,N,-,-1,-1
GLOVER.txt,141788,144175,2387,10,N,N,-,-1,-1
GLOVER.txt,141911,144498,2587,10,N,N,-,-1,-1
GLOVER.txt,142402,144740,2338,10,N,N,-,-1,-1
GLOVER.txt,142746,144789,2043,10,N,N,-,-1,-1
GLOVER.txt,142927,144921,1994,10,N,N,-,-1,-1
GLOVER.txt,143014,144992,1978,10,N,N,-,-1,-1
GLOVER.txt,143185,145222,2037,10,N,N,-,-1,-1
GLOVER.txt,143385,145329,1944,10,N,N,-,-1,-1
GLOVER.txt,143590,145580,1990,10,N,N,-,-1,-1
GLOVER.txt,143964,145863,1899,10,N,N,-,-1,-1
GLOVER.txt,144178,145995,1817,10,N,N,-,-1,-1
GLOVER.txt,144500,146115,1615,10,N,N,-,-1,-1
GLOVER.txt,144741,146133,1392,10,N,N,-,-1,-1
GLOVER.txt,144790,146242,1452,10,N,N,-,-1,-1
GLOVER.txt,144922,146277,1355,10,N,N,-,-1,-1
GLOVER.txt,144993,146339,1346,10,N,N,-,-1,-1
GLOVER.txt,145223,146361,1138,10,N,N,-,-1,-1
GLOVER.txt,145330,146392,1062,10,N,N,-,-1,-1
GLOVER.txt,145581,146604,1023,10,N,N,-,-1,-1
GLOVER.txt,145864,146650,786,10,N,N,-,-1,-1
GLOVER.txt,145997,146692,695,10,N,N,-,-1,-1
GLOVER.txt,146116,146725,609,10,N,N,-,-1,-1
GLOVER.txt,146134,146730,596,10,N,N,-,-1,-1
GLOVER.txt,146243,146774,531,10,N,N,-,-1,-1
GLOVER.txt,146278,146792,514,10,N,N,-,-1,-1
GLOVER.txt,146340,146908,568,10,N,N,-,-1,-1
GLOVER.txt,146362,146935,573,10,N,N,-,-1,-1
GLOVER.txt,146393,147219,826,10,N,N,-,-1,-1
GLOVER.txt,146605,147258,653,10,N,N,-,-1,-1
GLOVER.txt,146651,147346,695,10,N,N,-,-1,-1
GLOVER.txt,146693,147443,750,10,N,N,-,-1,-1
GLOVER.txt,146726,147466,740,10,N,N,-,-1,-1
GLOVER.txt,146731,147495,764,10,N,N,-,-1,-1
GLOVER.txt,146775,147530,755,10,N,N,-,-1,-1
GLOVER.txt,146793,147552,759,10,N,N,-,-1,-1
GLOVER.txt,146909,147708,799,10,N,N,-,-1,-1
GLOVER.txt,146938,147820,882,10,N,N,-,-1,-1
GLOVER.txt,147222,147894,672,10,N,N,-,-1,-1
GLOVER.txt,147259,148023,764,10,N,N,-,-1,-1
GLOVER.txt,147347,148185,838,10,N,N,-,-1,-1
GLOVER.txt,147444,148296,852,10,N,N,-,-1,-1
GLOVER.txt,147467,148330,863,10,N,N,-,-1,-1
GLOVER.txt,147496,148385,889,10,N,N,-,-1,-1
GLOVER.txt,147531,148412,881,10,N,N,-,-1,-1
GLOVER.txt,147553,148488,935,10,N,N,-,-1,-1
GLOVER.txt,147711,148634,923,10,N,N,-,-1,-1
GLOVER.txt,147821,148721,900,10,N,N,-,-1,-1
GLOVER.txt,147895,148842,947,10,N,N,-,-1,-1
GLOVER.txt,148024,148962,938,10,N,N,-,-1,-1
GLOVER.txt,148186,149227,1041,10,N,N,-,-1,-1
GLOVER.txt,148298,149256,958,10,N,N,-,-1,-1
GLOVER.txt,148331,149366,1035,10,N,N,-,-1,-1
GLOVER.txt,148386,149443,1057,10,N,N,-,-1,-1
GLOVER.txt,148413,149539,1126,10,N,N,-,-1,-1
GLOVER.txt,148489,149633,1144,10,N,N,-,-1,-1
GLOVER.txt,148635,149818,1183,10,N,N,-,-1,-1
GLOVER.txt,148722,149845,1123,10,N,N,-,-1,-1
GLOVER.txt,148843,149907,1064,10,N,N,-,-1,-1
GLOVER.txt,148963,149935,972,10,N,N,-,-1,-1
GLOVER.txt,149229,150116,887,10,N,N,-,-1,-1
GLOVER.txt,149257,150231,974,10,N,N,-,-1,-1
GLOVER.txt,149367,150272,905,10,N,N,-,-1,-1
GLOVER.txt,149444,150322,878,10,N,N,-,-1,-1
GLOVER.txt,149540,150388,848,10,N,N,-,-1,-1
GLOVER.txt,149635,150409,774,10,N,N,-,-1,-1
GLOVER.txt,149819,150487,668,10,N,N,-,-1,-1
GLOVER.txt,149846,150567,721,10,N,N,-,-1,-1
GLOVER.txt,149908,150726,818,10,N,N,-,-1,-1
GLOVER.txt,149938,150832,894,10,N,N,-,-1,-1
GLOVER.txt,150117,150971,854,10,N,N,-,-1,-1
GLOVER.txt,150232,151239,1007,10,N,N,-,-1,-1
GLOVER.txt,150273,151548,1275,10,N,N,-,-1,-1
GLOVER.txt,150323,151769,1446,10,N,N,-,-1,-1
GLOVER.txt,150391,151956,1565,10,N,N,-,-1,-1
GLOVER.txt,150410,151988,1578,10,N,N,-,-1,-1
GLOVER.txt,150489,152124,1635,10,N,N,-,-1,-1
GLOVER.txt,150568,152200,1632,10,N,N,-,-1,-1
GLOVER.txt,150729,152324,1595,10,N,Y,1437470299748,152207,152889
GLOVER.txt,150833,152379,1546,10,N,Y,1437470299748,152207,152889
GLOVER.txt,150973,152510,1537,10,N,Y,1437470299748,152207,152889
GLOVER.txt,151240,152567,1327,10,N,Y,1437470299748,152207,152889
GLOVER.txt,151549,152644,1095,10,N,Y,1437470299748,152207,152889
GLOVER.txt,151770,152745,975,10,N,Y,1437470299748,152207,152889
GLOVER.txt,151957,152853,896,10,N,Y,1437470299748,152207,152889
GLOVER.txt,151991,152902,911,10,N,Y,1437470299748,152207,152889
GLOVER.txt,152125,152919,794,10,N,Y,1437470299748,152207,152889
GLOVER.txt,152203,152934,731,10,N,Y,1437470299748,152207,152889
GLOVER.txt,152325,153209,884,10,N,Y,1437470299748,152207,152889
GLOVER.txt,152380,153389,1009,10,N,Y,1437470299748,152207,152889
GLOVER.txt,152511,153400,889,10,N,Y,1437470299748,152207,152889
GLOVER.txt,152568,153430,862,10,N,Y,1437470299748,152207,152889
GLOVER.txt,152645,153478,833,10,N,Y,1437470299748,152207,152889
GLOVER.txt,152746,153529,783,10,N,Y,1437470299748,152207,152889
GLOVER.txt,152854,153592,738,10,N,Y,1437470299748,152207,152889
GLOVER.txt,152903,153766,863,10,N,N,-,-1,-1
GLOVER.txt,152920,153782,862,10,N,N,-,-1,-1
GLOVER.txt,152935,153790,855,10,N,N,-,-1,-1
GLOVER.txt,153210,153852,642,10,N,N,-,-1,-1
GLOVER.txt,153390,153876,486,10,N,N,-,-1,-1
GLOVER.txt,153401,154241,840,10,N,N,-,-1,-1
GLOVER.txt,153431,154302,871,10,N,N,-,-1,-1
GLOVER.txt,153481,154570,1089,10,N,N,-,-1,-1
GLOVER.txt,153530,154908,1378,10,N,N,-,-1,-1
GLOVER.txt,153595,155010,1415,10,N,N,-,-1,-1
GLOVER.txt,153767,155326,1559,10,N,N,-,-1,-1
GLOVER.txt,153783,155418,1635,10,N,N,-,-1,-1
GLOVER.txt,153793,155527,1734,10,N,N,-,-1,-1
GLOVER.txt,153853,155625,1772,10,N,N,-,-1,-1
GLOVER.txt,153879,155853,1974,10,N,N,-,-1,-1
GLOVER.txt,154243,156573,2330,10,N,N,-,-1,-1
GLOVER.txt,154303,156822,2519,10,N,N,-,-1,-1
GLOVER.txt,154573,156942,2369,10,N,N,-,-1,-1
GLOVER.txt,154913,157227,2314,10,N,N,-,-1,-1
GLOVER.txt,155010,157534,2524,10,Y,N,-,-1,-1
GLOVER.txt,155329,157682,2353,10,Y,N,-,-1,-1
GLOVER.txt,155419,158115,2696,10,Y,N,-,-1,-1
GLOVER.txt,155527,158270,2743,10,Y,N,-,-1,-1
GLOVER.txt,155627,158520,2893,10,Y,N,-,-1,-1
GLOVER.txt,155854,158717,2863,10,N,N,-,-1,-1
GLOVER.txt,156576,158980,2404,10,Y,N,-,-1,-1
GLOVER.txt,156823,159062,2239,10,Y,N,-,-1,-1
GLOVER.txt,156944,159184,2240,10,N,N,-,-1,-1
GLOVER.txt,157228,159224,1996,10,N,N,-,-1,-1
GLOVER.txt,157535,159252,1717,10,N,N,-,-1,-1
GLOVER.txt,157683,159479,1796,10,N,N,-,-1,-1
GLOVER.txt,158116,159575,1459,10,N,N,-,-1,-1
GLOVER.txt,158273,159589,1316,10,N,N,-,-1,-1
GLOVER.txt,158521,159744,1223,10,N,N,-,-1,-1
GLOVER.txt,158720,159935,1215,10,N,N,-,-1,-1
GLOVER.txt,158981,160267,1286,10,N,N,-,-1,-1
GLOVER.txt,159063,160307,1244,10,N,N,-,-1,-1
GLOVER.txt,159185,160683,1498,10,N,N,-,-1,-1
GLOVER.txt,159224,160871,1647,10,N,N,-,-1,-1
GLOVER.txt,159253,161051,1798,10,N,N,-,-1,-1
GLOVER.txt,159480,161231,1751,10,N,N,-,-1,-1
GLOVER.txt,159575,161265,1690,10,N,N,-,-1,-1
GLOVER.txt,159590,161473,1883,10,N,N,-,-1,-1
GLOVER.txt,159747,161928,2181,10,N,N,-,-1,-1
GLOVER.txt,159936,161961,2025,10,N,N,-,-1,-1
GLOVER.txt,160268,162023,1755,10,N,N,-,-1,-1
GLOVER.txt,160308,162120,1812,10,N,N,-,-1,-1
GLOVER.txt,160684,162310,1626,10,N,N,-,-1,-1
GLOVER.txt,160872,162690,1818,10,N,N,-,-1,-1
GLOVER.txt,161052,162844,1792,10,N,N,-,-1,-1
GLOVER.txt,161232,162933,1701,10,N,N,-,-1,-1
GLOVER.txt,161266,163027,1761,10,N,N,-,-1,-1
GLOVER.txt,161476,163303,1827,10,N,N,-,-1,-1
GLOVER.txt,161931,163527,1596,10,N,N,-,-1,-1
GLOVER.txt,161962,163766,1804,10,N,N,-,-1,-1
GLOVER.txt,162025,163926,1901,10,N,N,-,-1,-1
GLOVER.txt,162121,164168,2047,10,N,N,-,-1,-1
GLOVER.txt,162311,164383,2072,10,N,N,-,-1,-1
GLOVER.txt,162691,164556,1865,10,N,N,-,-1,-1
GLOVER.txt,162845,164723,1878,10,N,N,-,-1,-1
GLOVER.txt,162938,165023,2085,10,N,N,-,-1,-1
GLOVER.txt,163028,165066,2038,10,N,N,-,-1,-1
GLOVER.txt,163304,165231,1927,10,N,N,-,-1,-1
GLOVER.txt,163530,165590,2060,10,N,N,-,-1,-1
GLOVER.txt,163769,165620,1851,10,N,N,-,-1,-1
GLOVER.txt,163929,166069,2140,10,N,N,-,-1,-1
GLOVER.txt,164169,166419,2250,10,N,N,-,-1,-1
GLOVER.txt,164384,166456,2072,10,N,N,-,-1,-1
GLOVER.txt,164557,166598,2041,10,N,N,-,-1,-1
GLOVER.txt,164724,166676,1952,10,N,N,-,-1,-1
GLOVER.txt,165024,166822,1798,10,N,N,-,-1,-1
GLOVER.txt,165067,167047,1980,10,N,N,-,-1,-1
GLOVER.txt,165234,167289,2055,10,N,N,-,-1,-1
GLOVER.txt,165593,167440,1847,10,N,N,-,-1,-1
GLOVER.txt,165621,167441,1820,10,N,N,-,-1,-1
GLOVER.txt,166072,167609,1537,10,N,N,-,-1,-1
GLOVER.txt,166422,167682,1260,10,N,N,-,-1,-1
GLOVER.txt,166457,167954,1497,10,N,N,-,-1,-1
GLOVER.txt,166599,168366,1767,10,N,N,-,-1,-1
GLOVER.txt,166677,168551,1874,10,N,N,-,-1,-1
GLOVER.txt,166823,168775,1952,10,N,N,-,-1,-1
GLOVER.txt,167050,169092,2042,10,N,N,-,-1,-1
GLOVER.txt,167290,169122,1832,10,N,N,-,-1,-1
GLOVER.txt,167440,169305,1865,10,N,N,-,-1,-1
GLOVER.txt,167441,169372,1931,10,N,N,-,-1,-1
GLOVER.txt,167610,169547,1937,10,N,N,-,-1,-1
GLOVER.txt,167685,169606,1921,10,N,N,-,-1,-1
GLOVER.txt,167955,169924,1969,10,N,N,-,-1,-1
GLOVER.txt,168367,170108,1741,10,N,N,-,-1,-1
GLOVER.txt,168552,170156,1604,10,N,N,-,-1,-1
GLOVER.txt,168777,170246,1469,10,N,N,-,-1,-1
GLOVER.txt,169093,170492,1399,10,N,N,-,-1,-1
GLOVER.txt,169125,170508,1383,10,N,N,-,-1,-1
GLOVER.txt,169306,170570,1264,10,N,N,-,-1,-1
GLOVER.txt,169375,170753,1378,10,N,N,-,-1,-1
GLOVER.txt,169548,170867,1319,10,N,N,-,-1,-1
GLOVER.txt,169607,171113,1506,10,N,N,-,-1,-1
GLOVER.txt,169925,171515,1590,10,N,N,-,-1,-1
GLOVER.txt,170109,171854,1745,10,N,N,-,-1,-1
GLOVER.txt,170157,172140,1983,10,N,N,-,-1,-1
GLOVER.txt,170249,172250,2001,10,N,N,-,-1,-1
GLOVER.txt,170493,172493,2000,10,N,N,-,-1,-1
GLOVER.txt,170511,172851,2340,10,N,N,-,-1,-1
GLOVER.txt,170573,173169,2596,10,N,N,-,-1,-1
GLOVER.txt,170754,173195,2441,10,N,N,-,-1,-1
GLOVER.txt,170872,173316,2444,10,N,N,-,-1,-1
GLOVER.txt,171114,173615,2501,10,N,N,-,-1,-1
GLOVER.txt,171516,173716,2200,10,N,N,-,-1,-1
GLOVER.txt,171857,173751,1894,10,N,N,-,-1,-1
GLOVER.txt,172141,173780,1639,10,N,N,-,-1,-1
GLOVER.txt,172252,173918,1666,10,N,N,-,-1,-1
GLOVER.txt,172495,173992,1497,10,N,N,-,-1,-1
GLOVER.txt,172852,174066,1214,10,N,N,-,-1,-1
GLOVER.txt,173172,174205,1033,10,N,N,-,-1,-1
GLOVER.txt,173196,174451,1255,10,N,N,-,-1,-1
GLOVER.txt,173318,174811,1493,10,N,N,-,-1,-1
GLOVER.txt,173616,174951,1335,10,N,N,-,-1,-1
GLOVER.txt,173717,174989,1272,10,N,N,-,-1,-1
GLOVER.txt,173752,175481,1729,10,N,N,-,-1,-1
GLOVER.txt,173781,175506,1725,10,N,N,-,-1,-1
GLOVER.txt,173920,175590,1670,10,N,N,-,-1,-1
GLOVER.txt,173993,175757,1764,10,N,N,-,-1,-1
GLOVER.txt,174067,175996,1929,10,N,N,-,-1,-1
GLOVER.txt,174208,176097,1889,10,N,N,-,-1,-1
GLOVER.txt,174452,176489,2037,10,N,N,-,-1,-1
GLOVER.txt,174814,176589,1775,10,N,N,-,-1,-1
GLOVER.txt,174952,176780,1828,10,N,N,-,-1,-1
GLOVER.txt,174990,176925,1935,10,N,N,-,-1,-1
GLOVER.txt,175483,177154,1671,10,N,N,-,-1,-1
GLOVER.txt,175509,177424,1915,10,N,N,-,-1,-1
GLOVER.txt,175591,177860,2269,10,N,N,-,-1,-1
GLOVER.txt,175758,177954,2196,10,N,N,-,-1,-1
GLOVER.txt,175998,178130,2132,10,N,N,-,-1,-1
GLOVER.txt,176099,178206,2107,10,N,N,-,-1,-1
GLOVER.txt,176490,178327,1837,10,N,N,-,-1,-1
GLOVER.txt,176592,178673,2081,10,N,N,-,-1,-1
GLOVER.txt,176781,178846,2065,10,N,N,-,-1,-1
GLOVER.txt,176926,178962,2036,10,N,N,-,-1,-1
GLOVER.txt,177155,179113,1958,10,N,N,-,-1,-1
GLOVER.txt,177427,179174,1747,10,N,N,-,-1,-1
GLOVER.txt,177863,179306,1443,10,N,N,-,-1,-1
GLOVER.txt,177955,179370,1415,10,N,N,-,-1,-1
GLOVER.txt,178131,179550,1419,10,N,N,-,-1,-1
GLOVER.txt,178208,179653,1445,10,N,N,-,-1,-1
GLOVER.txt,178328,179695,1367,10,N,N,-,-1,-1
GLOVER.txt,178674,179719,1045,10,N,N,-,-1,-1
GLOVER.txt,178847,179862,1015,10,N,N,-,-1,-1
GLOVER.txt,178963,179880,917,10,N,N,-,-1,-1
GLOVER.txt,179114,179942,828,10,N,N,-,-1,-1
GLOVER.txt,179175,179971,796,10,N,N,-,-1,-1
GLOVER.txt,179307,179979,672,10,N,N,-,-1,-1
GLOVER.txt,179371,180024,653,10,N,N,-,-1,-1
GLOVER.txt,179551,180266,715,10,N,N,-,-1,-1
GLOVER.txt,179654,180300,646,10,N,N,-,-1,-1
GLOVER.txt,179696,180324,628,10,N,N,-,-1,-1
GLOVER.txt,179720,180342,622,10,N,N,-,-1,-1
GLOVER.txt,179863,180421,558,10,N,N,-,-1,-1
GLOVER.txt,179881,180621,740,10,N,N,-,-1,-1
GLOVER.txt,179943,180886,943,10,N,N,-,-1,-1
GLOVER.txt,179972,180991,1019,10,N,N,-,-1,-1
GLOVER.txt,179980,181182,1202,10,N,N,-,-1,-1
GLOVER.txt,180025,181284,1259,10,N,N,-,-1,-1
GLOVER.txt,180267,181498,1231,10,N,N,-,-1,-1
GLOVER.txt,180301,181894,1593,10,N,N,-,-1,-1
GLOVER.txt,180325,181916,1591,10,N,N,-,-1,-1
GLOVER.txt,180344,182253,1909,10,N,N,-,-1,-1
GLOVER.txt,180424,182279,1855,10,N,N,-,-1,-1
GLOVER.txt,180622,182334,1712,10,N,N,-,-1,-1
GLOVER.txt,180887,182448,1561,10,N,N,-,-1,-1
GLOVER.txt,180992,182615,1623,10,N,N,-,-1,-1
GLOVER.txt,181183,182665,1482,10,N,N,-,-1,-1
GLOVER.txt,181285,182793,1508,10,N,N,-,-1,-1
GLOVER.txt,181499,183199,1700,10,N,N,-,-1,-1
GLOVER.txt,181897,183245,1348,10,N,N,-,-1,-1
GLOVER.txt,181917,183275,1358,10,N,N,-,-1,-1
GLOVER.txt,182256,183444,1188,10,N,N,-,-1,-1
GLOVER.txt,182280,183573,1293,10,N,N,-,-1,-1
GLOVER.txt,182335,183893,1558,10,N,N,-,-1,-1
GLOVER.txt,182449,184065,1616,10,N,N,-,-1,-1
GLOVER.txt,182616,184102,1486,10,N,N,-,-1,-1
GLOVER.txt,182666,184173,1507,10,N,N,-,-1,-1
GLOVER.txt,182794,184238,1444,10,N,N,-,-1,-1
GLOVER.txt,183200,184398,1198,10,N,N,-,-1,-1
GLOVER.txt,183246,184483,1237,10,N,N,-,-1,-1
GLOVER.txt,183278,184704,1426,10,N,N,-,-1,-1
GLOVER.txt,183445,184751,1306,10,N,N,-,-1,-1
GLOVER.txt,183574,184807,1233,10,N,N,-,-1,-1
GLOVER.txt,183894,185047,1153,10,N,N,-,-1,-1
GLOVER.txt,184066,185102,1036,10,N,N,-,-1,-1
GLOVER.txt,184103,185361,1258,10,N,N,-,-1,-1
GLOVER.txt,184176,185438,1262,10,N,N,-,-1,-1
GLOVER.txt,184241,185491,1250,10,N,N,-,-1,-1
GLOVER.txt,184399,185559,1160,10,N,N,-,-1,-1
GLOVER.txt,184485,185828,1343,10,N,N,-,-1,-1
GLOVER.txt,184705,186173,1468,10,N,N,-,-1,-1
GLOVER.txt,184752,186398,1646,10,N,N,-,-1,-1
GLOVER.txt,184808,186623,1815,10,N,N,-,-1,-1
GLOVER.txt,185048,186687,1639,10,N,N,-,-1,-1
GLOVER.txt,185103,186854,1751,10,N,N,-,-1,-1
GLOVER.txt,185363,187054,1691,10,N,N,-,-1,-1
GLOVER.txt,185439,187086,1647,10,N,N,-,-1,-1
GLOVER.txt,185492,187316,1824,10,N,N,-,-1,-1
GLOVER.txt,185562,187622,2060,10,N,N,-,-1,-1
GLOVER.txt,185829,187691,1862,10,N,N,-,-1,-1
GLOVER.txt,186175,187869,1694,10,N,N,-,-1,-1
GLOVER.txt,186399,187924,1525,10,N,N,-,-1,-1
GLOVER.txt,186624,187976,1352,10,N,N,-,-1,-1
GLOVER.txt,186690,188127,1437,10,N,N,-,-1,-1
GLOVER.txt,186855,188417,1562,10,N,N,-,-1,-1
GLOVER.txt,187055,188612,1557,10,N,N,-,-1,-1
GLOVER.txt,187087,188827,1740,10,N,N,-,-1,-1
GLOVER.txt,187317,188875,1558,10,N,N,-,-1,-1
GLOVER.txt,187623,189109,1486,10,N,N,-,-1,-1
GLOVER.txt,187692,189140,1448,10,N,N,-,-1,-1
GLOVER.txt,187870,189181,1311,10,N,N,-,-1,-1
GLOVER.txt,187925,189346,1421,10,N,N,-,-1,-1
GLOVER.txt,187977,189552,1575,10,N,N,-,-1,-1
GLOVER.txt,188128,189602,1474,10,N,N,-,-1,-1
GLOVER.txt,188418,189710,1292,10,N,N,-,-1,-1
GLOVER.txt,188614,189727,1113,10,N,N,-,-1,-1
GLOVER.txt,188828,189761,933,10,N,N,-,-1,-1
GLOVER.txt,188876,189829,953,10,N,N,-,-1,-1
GLOVER.txt,189111,189875,764,10,N,N,-,-1,-1
GLOVER.txt,189141,189987,846,10,N,N,-,-1,-1
GLOVER.txt,189184,190072,888,10,N,N,-,-1,-1
GLOVER.txt,189347,190178,831,10,N,N,-,-1,-1
GLOVER.txt,189553,190291,738,10,N,N,-,-1,-1
GLOVER.txt,189603,190370,767,10,N,N,-,-1,-1
GLOVER.txt,189712,190553,841,10,N,N,-,-1,-1
GLOVER.txt,189728,190698,970,10,N,N,-,-1,-1
GLOVER.txt,189763,190991,1228,10,N,N,-,-1,-1
GLOVER.txt,189830,191093,1263,10,N,N,-,-1,-1
GLOVER.txt,189876,191214,1338,10,N,N,-,-1,-1
GLOVER.txt,189988,191497,1509,10,N,N,-,-1,-1
GLOVER.txt,190075,191737,1662,10,N,N,-,-1,-1
GLOVER.txt,190179,192225,2046,10,N,N,-,-1,-1
GLOVER.txt,190292,192402,2110,10,N,N,-,-1,-1
GLOVER.txt,190372,192503,2131,10,N,N,-,-1,-1
GLOVER.txt,190554,192865,2311,10,N,N,-,-1,-1
GLOVER.txt,190699,192959,2260,10,N,N,-,-1,-1
GLOVER.txt,190994,192995,2001,10,N,N,-,-1,-1
GLOVER.txt,191095,193245,2150,10,N,N,-,-1,-1
GLOVER.txt,191215,193272,2057,10,N,N,-,-1,-1
GLOVER.txt,191498,193599,2101,10,N,N,-,-1,-1
GLOVER.txt,191738,193791,2053,10,N,N,-,-1,-1
GLOVER.txt,192226,193895,1669,10,N,N,-,-1,-1
GLOVER.txt,192403,194104,1701,10,N,N,-,-1,-1
GLOVER.txt,192504,194249,1745,10,N,N,-,-1,-1
GLOVER.txt,192866,194545,1679,10,N,N,-,-1,-1
GLOVER.txt,192960,194584,1624,10,N,N,-,-1,-1
GLOVER.txt,192996,194811,1815,10,N,N,-,-1,-1
GLOVER.txt,193246,194992,1746,10,N,N,-,-1,-1
GLOVER.txt,193273,195154,1881,10,N,N,-,-1,-1
GLOVER.txt,193604,195297,1693,10,N,N,-,-1,-1
GLOVER.txt,193792,195454,1662,10,N,N,-,-1,-1
GLOVER.txt,193898,195632,1734,10,N,N,-,-1,-1
GLOVER.txt,194105,195707,1602,10,N,N,-,-1,-1
GLOVER.txt,194250,195793,1543,10,N,N,-,-1,-1
GLOVER.txt,194547,195815,1268,10,N,N,-,-1,-1
GLOVER.txt,194585,195873,1288,10,N,N,-,-1,-1
GLOVER.txt,194812,196024,1212,10,N,N,-,-1,-1
GLOVER.txt,194995,196073,1078,10,N,N,-,-1,-1
GLOVER.txt,195155,196208,1053,10,N,N,-,-1,-1
GLOVER.txt,195298,196613,1315,10,N,N,-,-1,-1
GLOVER.txt,195455,196824,1369,10,N,N,-,-1,-1
GLOVER.txt,195633,197145,1512,10,N,N,-,-1,-1
GLOVER.txt,195708,197263,1555,10,N,N,-,-1,-1
GLOVER.txt,195794,197304,1510,10,N,N,-,-1,-1
GLOVER.txt,195816,197502,1686,10,N,N,-,-1,-1
GLOVER.txt,195874,197704,1830,10,N,N,-,-1,-1
GLOVER.txt,196025,197803,1778,10,N,N,-,-1,-1
GLOVER.txt,196076,197982,1906,10,N,N,-,-1,-1
GLOVER.txt,196211,198007,1796,10,N,N,-,-1,-1
GLOVER.txt,196614,198025,1411,10,N,N,-,-1,-1
GLOVER.txt,196825,198214,1389,10,N,N,-,-1,-1
GLOVER.txt,197146,198385,1239,10,N,N,-,-1,-1
GLOVER.txt,197264,198530,1266,10,N,N,-,-1,-1
GLOVER.txt,197307,198647,1340,10,N,N,-,-1,-1
GLOVER.txt,197503,198760,1257,10,N,N,-,-1,-1
GLOVER.txt,197707,198862,1155,10,N,N,-,-1,-1
GLOVER.txt,197805,198940,1135,10,N,N,-,-1,-1
GLOVER.txt,197983,199033,1050,10,N,N,-,-1,-1
GLOVER.txt,198008,199233,1225,10,N,N,-,-1,-1
GLOVER.txt,198026,199452,1426,10,N,N,-,-1,-1
GLOVER.txt,198215,199552,1337,10,N,N,-,-1,-1
GLOVER.txt,198388,199632,1244,10,N,N,-,-1,-1
GLOVER.txt,198531,199736,1205,10,N,N,-,-1,-1
GLOVER.txt,198650,199966,1316,10,N,N,-,-1,-1
GLOVER.txt,198761,200021,1260,10,N,N,-,-1,-1
GLOVER.txt,198863,200142,1279,10,N,N,-,-1,-1
GLOVER.txt,198943,200287,1344,10,N,N,-,-1,-1
GLOVER.txt,199034,200433,1399,10,N,N,-,-1,-1
GLOVER.txt,199236,200555,1319,10,N,N,-,-1,-1
GLOVER.txt,199453,200818,1365,10,N,N,-,-1,-1
GLOVER.txt,199553,200954,1401,10,N,N,-,-1,-1
GLOVER.txt,199633,201002,1369,10,N,N,-,-1,-1
GLOVER.txt,199739,201128,1389,10,N,N,-,-1,-1
GLOVER.txt,199967,202157,2190,10,N,N,-,-1,-1
GLOVER.txt,200022,202487,2465,10,N,N,-,-1,-1
GLOVER.txt,200144,202543,2399,10,N,N,-,-1,-1
GLOVER.txt,200288,202829,2541,10,N,N,-,-1,-1
GLOVER.txt,200434,203059,2625,10,N,N,-,-1,-1
GLOVER.txt,200556,203302,2746,10,N,N,-,-1,-1
GLOVER.txt,200819,203481,2662,10,N,N,-,-1,-1
GLOVER.txt,200956,203600,2644,10,N,N,-,-1,-1
GLOVER.txt,201004,203710,2706,10,N,N,-,-1,-1
GLOVER.txt,201133,203902,2769,10,N,N,-,-1,-1
GLOVER.txt,202160,204182,2022,10,N,N,-,-1,-1
GLOVER.txt,202488,204366,1878,10,N,N,-,-1,-1
GLOVER.txt,202543,204665,2122,10,N,N,-,-1,-1
GLOVER.txt,202830,204950,2120,10,Y,N,-,-1,-1
GLOVER.txt,203060,205141,2081,10,Y,N,-,-1,-1
GLOVER.txt,203305,205266,1961,10,Y,N,-,-1,-1
GLOVER.txt,203482,205674,2192,10,Y,N,-,-1,-1
GLOVER.txt,203600,205928,2328,10,Y,N,-,-1,-1
GLOVER.txt,203711,206217,2506,10,Y,N,-,-1,-1
GLOVER.txt,203903,206424,2521,10,Y,N,-,-1,-1
GLOVER.txt,204183,206577,2394,10,N,N,-,-1,-1
GLOVER.txt,204369,206682,2313,10,N,N,-,-1,-1
GLOVER.txt,204668,206719,2051,10,N,N,-,-1,-1
GLOVER.txt,204951,207014,2063,10,N,N,-,-1,-1
GLOVER.txt,205142,207221,2079,10,N,N,-,-1,-1
GLOVER.txt,205267,207382,2115,10,N,N,-,-1,-1
GLOVER.txt,205675,207413,1738,10,N,N,-,-1,-1
GLOVER.txt,205929,207613,1684,10,N,N,-,-1,-1
GLOVER.txt,206218,207737,1519,10,N,N,-,-1,-1
GLOVER.txt,206427,208026,1599,10,N,N,-,-1,-1
GLOVER.txt,206578,208269,1691,10,N,N,-,-1,-1
GLOVER.txt,206683,208521,1838,10,N,N,-,-1,-1
GLOVER.txt,206721,208718,1997,10,N,N,-,-1,-1
GLOVER.txt,207015,208887,1872,10,N,N,-,-1,-1
GLOVER.txt,207222,209002,1780,10,Y,N,-,-1,-1
GLOVER.txt,207383,209373,1990,10,Y,N,-,-1,-1
GLOVER.txt,207414,209405,1991,10,Y,N,-,-1,-1
GLOVER.txt,207614,209578,1964,10,Y,N,-,-1,-1
GLOVER.txt,207740,209662,1922,10,Y,N,-,-1,-1
GLOVER.txt,208027,209832,1805,10,N,N,-,-1,-1
GLOVER.txt,208270,209911,1641,10,N,N,-,-1,-1
GLOVER.txt,208522,210107,1585,10,N,N,-,-1,-1
GLOVER.txt,208719,210359,1640,10,N,N,-,-1,-1
GLOVER.txt,208889,210533,1644,10,N,N,-,-1,-1
GLOVER.txt,209007,210636,1629,10,N,N,-,-1,-1
GLOVER.txt,209374,210968,1594,10,N,N,-,-1,-1
GLOVER.txt,209406,211207,1801,10,N,N,-,-1,-1
GLOVER.txt,209580,211249,1669,10,N,N,-,-1,-1
GLOVER.txt,209663,211375,1712,10,N,N,-,-1,-1
GLOVER.txt,209833,211460,1627,10,N,N,-,-1,-1
GLOVER.txt,209912,211476,1564,10,N,N,-,-1,-1
GLOVER.txt,210108,211524,1416,10,N,N,-,-1,-1
GLOVER.txt,210360,211738,1378,10,N,N,-,-1,-1
GLOVER.txt,210534,211858,1324,10,N,N,-,-1,-1
GLOVER.txt,210637,212275,1638,10,Y,N,-,-1,-1
GLOVER.txt,210969,212536,1567,10,N,N,-,-1,-1
GLOVER.txt,211208,212594,1386,10,N,N,-,-1,-1
GLOVER.txt,211250,212646,1396,10,N,N,-,-1,-1
GLOVER.txt,211378,212854,1476,10,Y,N,-,-1,-1
GLOVER.txt,211461,212933,1472,10,Y,N,-,-1,-1
GLOVER.txt,211477,212978,1501,10,Y,N,-,-1,-1
GLOVER.txt,211525,212998,1473,10,N,N,-,-1,-1
GLOVER.txt,211739,213146,1407,10,N,N,-,-1,-1
GLOVER.txt,211861,213213,1352,10,N,N,-,-1,-1
GLOVER.txt,212276,213253,977,10,N,N,-,-1,-1
GLOVER.txt,212537,213298,761,10,N,N,-,-1,-1
GLOVER.txt,212595,213366,771,10,N,N,-,-1,-1
GLOVER.txt,212647,213376,729,10,N,N,-,-1,-1
GLOVER.txt,212857,213392,535,10,N,N,-,-1,-1
GLOVER.txt,212934,213435,501,10,N,N,-,-1,-1
GLOVER.txt,212979,213457,478,10,N,N,-,-1,-1
GLOVER.txt,212999,213519,520,10,N,N,-,-1,-1
GLOVER.txt,213147,213531,384,10,N,N,-,-1,-1
GLOVER.txt,213214,213670,456,10,N,N,-,-1,-1
GLOVER.txt,213254,213808,554,10,N,N,-,-1,-1
GLOVER.txt,213299,213901,602,10,N,N,-,-1,-1
GLOVER.txt,213367,213914,547,10,N,N,-,-1,-1
GLOVER.txt,213378,213929,551,10,N,N,-,-1,-1
GLOVER.txt,213393,213955,562,10,N,N,-,-1,-1
GLOVER.txt,213436,214038,602,10,N,N,-,-1,-1
GLOVER.txt,213458,214201,743,10,N,N,-,-1,-1
GLOVER.txt,213520,214223,703,10,N,N,-,-1,-1
GLOVER.txt,213532,214325,793,10,N,N,-,-1,-1
GLOVER.txt,213671,214335,664,10,N,N,-,-1,-1
GLOVER.txt,213809,214627,818,10,N,N,-,-1,-1
GLOVER.txt,213902,214664,762,10,N,N,-,-1,-1
GLOVER.txt,213915,214788,873,10,N,N,-,-1,-1
GLOVER.txt,213930,214837,907,10,N,N,-,-1,-1
GLOVER.txt,213956,214864,908,10,N,N,-,-1,-1
GLOVER.txt,214039,214883,844,10,N,N,-,-1,-1
GLOVER.txt,214203,214966,763,10,N,N,-,-1,-1
GLOVER.txt,214224,215070,846,10,N,N,-,-1,-1
GLOVER.txt,214326,215440,1114,10,N,N,-,-1,-1
GLOVER.txt,214336,215502,1166,10,N,N,-,-1,-1
GLOVER.txt,214628,215615,987,10,N,N,-,-1,-1
GLOVER.txt,214666,215780,1114,10,N,N,-,-1,-1
GLOVER.txt,214789,215955,1166,10,N,N,-,-1,-1
GLOVER.txt,214838,216095,1257,10,N,N,-,-1,-1
GLOVER.txt,214865,216509,1644,10,N,N,-,-1,-1
GLOVER.txt,214885,216526,1641,10,N,N,-,-1,-1
GLOVER.txt,214967,216745,1778,10,N,N,-,-1,-1
GLOVER.txt,215071,216965,1894,10,N,N,-,-1,-1
GLOVER.txt,215441,217133,1692,10,N,N,-,-1,-1
GLOVER.txt,215505,217598,2093,10,N,N,-,-1,-1
GLOVER.txt,215616,217658,2042,10,N,N,-,-1,-1
GLOVER.txt,215781,217722,1941,10,N,N,-,-1,-1
GLOVER.txt,215956,217913,1957,10,N,N,-,-1,-1
GLOVER.txt,216097,218137,2040,10,N,N,-,-1,-1
GLOVER.txt,216510,218180,1670,10,N,N,-,-1,-1
GLOVER.txt,216527,218324,1797,10,N,N,-,-1,-1
GLOVER.txt,216746,218407,1661,10,N,N,-,-1,-1
GLOVER.txt,216966,218541,1575,10,N,N,-,-1,-1
GLOVER.txt,217134,218660,1526,10,N,N,-,-1,-1
GLOVER.txt,217600,218822,1222,10,N,N,-,-1,-1
GLOVER.txt,217661,219013,1352,10,N,N,-,-1,-1
GLOVER.txt,217723,219109,1386,10,N,N,-,-1,-1
GLOVER.txt,217914,219262,1348,10,N,N,-,-1,-1
GLOVER.txt,218138,219481,1343,10,N,N,-,-1,-1
GLOVER.txt,218181,219964,1783,10,N,N,-,-1,-1
GLOVER.txt,218325,219986,1661,10,Y,N,-,-1,-1
GLOVER.txt,218408,220299,1891,10,Y,N,-,-1,-1
GLOVER.txt,218542,220443,1901,10,Y,N,-,-1,-1
GLOVER.txt,218661,220522,1861,10,N,N,-,-1,-1
GLOVER.txt,218823,220750,1927,10,N,N,-,-1,-1
GLOVER.txt,219014,220851,1837,10,N,N,-,-1,-1
GLOVER.txt,219110,220958,1848,10,N,N,-,-1,-1
GLOVER.txt,219263,221026,1763,10,N,N,-,-1,-1
GLOVER.txt,219482,221172,1690,10,N,N,-,-1,-1
GLOVER.txt,219967,221599,1632,10,N,N,-,-1,-1
GLOVER.txt,219987,222181,2194,10,N,N,-,-1,-1
GLOVER.txt,220300,222345,2045,10,N,N,-,-1,-1
GLOVER.txt,220444,222587,2143,10,N,N,-,-1,-1
GLOVER.txt,220523,222650,2127,10,N,N,-,-1,-1
GLOVER.txt,220751,222953,2202,10,N,N,-,-1,-1
GLOVER.txt,220852,223061,2209,10,N,N,-,-1,-1
GLOVER.txt,220960,223175,2215,10,N,N,-,-1,-1
GLOVER.txt,221027,223394,2367,10,N,N,-,-1,-1
GLOVER.txt,221173,223683,2510,10,N,N,-,-1,-1
GLOVER.txt,221600,223890,2290,10,N,N,-,-1,-1
GLOVER.txt,222184,223979,1795,10,N,N,-,-1,-1
GLOVER.txt,222346,224226,1880,10,N,N,-,-1,-1
GLOVER.txt,222589,224785,2196,10,N,N,-,-1,-1
GLOVER.txt,222651,224820,2169,10,N,N,-,-1,-1
GLOVER.txt,222956,224860,1904,10,N,N,-,-1,-1
GLOVER.txt,223064,225156,2092,10,N,N,-,-1,-1
GLOVER.txt,223176,225255,2079,10,N,N,-,-1,-1
GLOVER.txt,223395,225330,1935,10,N,N,-,-1,-1
GLOVER.txt,223684,225400,1716,10,N,N,-,-1,-1
GLOVER.txt,223891,225508,1617,10,N,N,-,-1,-1
GLOVER.txt,223982,225807,1825,10,N,N,-,-1,-1
GLOVER.txt,224227,225881,1654,10,N,N,-,-1,-1
GLOVER.txt,224786,226065,1279,10,N,N,-,-1,-1
GLOVER.txt,224821,226135,1314,10,N,N,-,-1,-1
GLOVER.txt,224862,226202,1340,10,N,N,-,-1,-1
GLOVER.txt,225157,226259,1102,10,N,N,-,-1,-1
GLOVER.txt,225258,226330,1072,10,N,N,-,-1,-1
GLOVER.txt,225331,226652,1321,10,N,N,-,-1,-1
GLOVER.txt,225403,226894,1491,10,N,N,-,-1,-1
GLOVER.txt,225509,227088,1579,10,N,N,-,-1,-1
GLOVER.txt,225808,227231,1423,10,N,N,-,-1,-1
GLOVER.txt,225882,227323,1441,10,N,N,-,-1,-1
GLOVER.txt,226066,227491,1425,10,N,N,-,-1,-1
GLOVER.txt,226136,227826,1690,10,N,N,-,-1,-1
GLOVER.txt,226205,228187,1982,10,N,N,-,-1,-1
GLOVER.txt,226260,228270,2010,10,N,N,-,-1,-1
GLOVER.txt,226331,228406,2075,10,N,N,-,-1,-1
GLOVER.txt,226654,228421,1767,10,N,N,-,-1,-1
GLOVER.txt,226897,228476,1579,10,N,N,-,-1,-1
GLOVER.txt,227089,228587,1498,10,N,N,-,-1,-1
GLOVER.txt,227232,228666,1434,10,N,N,-,-1,-1
GLOVER.txt,227324,228700,1376,10,N,N,-,-1,-1
GLOVER.txt,227492,228890,1398,10,N,N,-,-1,-1
GLOVER.txt,227831,228980,1149,10,N,N,-,-1,-1
GLOVER.txt,228188,229024,836,10,N,N,-,-1,-1
GLOVER.txt,228271,229086,815,10,N,N,-,-1,-1
GLOVER.txt,228408,229141,733,10,N,N,-,-1,-1
GLOVER.txt,228422,229387,965,10,N,N,-,-1,-1
GLOVER.txt,228477,229504,1027,10,N,N,-,-1,-1
GLOVER.txt,228588,229612,1024,10,N,N,-,-1,-1
GLOVER.txt,228667,229745,1078,10,N,N,-,-1,-1
GLOVER.txt,228702,230048,1346,10,Y,N,-,-1,-1
GLOVER.txt,228891,230124,1233,10,N,N,-,-1,-1
GLOVER.txt,228981,230334,1353,10,N,N,-,-1,-1
GLOVER.txt,229025,230426,1401,10,N,N,-,-1,-1
GLOVER.txt,229087,230501,1414,10,N,N,-,-1,-1
GLOVER.txt,229143,230653,1510,10,Y,N,-,-1,-1
GLOVER.txt,229390,230941,1551,10,N,N,-,-1,-1
GLOVER.txt,229505,231276,1771,10,N,N,-,-1,-1
GLOVER.txt,229613,231285,1672,10,N,N,-,-1,-1
GLOVER.txt,229746,231476,1730,10,N,N,-,-1,-1
GLOVER.txt,230051,231588,1537,10,N,N,-,-1,-1
GLOVER.txt,230125,231626,1501,10,N,N,-,-1,-1
GLOVER.txt,230337,231643,1306,10,N,N,-,-1,-1
GLOVER.txt,230428,231650,1222,10,N,N,-,-1,-1
GLOVER.txt,230502,231722,1220,10,N,N,-,-1,-1
GLOVER.txt,230654,231735,1081,10,N,N,-,-1,-1
GLOVER.txt,230942,231807,865,10,N,N,-,-1,-1
GLOVER.txt,231277,231858,581,10,N,N,-,-1,-1
GLOVER.txt,231286,231972,686,10,N,N,-,-1,-1
GLOVER.txt,231479,231982,503,10,N,N,-,-1,-1
GLOVER.txt,231589,232065,476,10,N,N,-,-1,-1
GLOVER.txt,231628,232227,599,10,N,N,-,-1,-1
GLOVER.txt,231644,232468,824,10,N,N,-,-1,-1
GLOVER.txt,231651,232600,949,10,N,N,-,-1,-1
GLOVER.txt,231724,232781,1057,10,N,N,-,-1,-1
GLOVER.txt,231736,233088,1352,10,N,N,-,-1,-1
GLOVER.txt,231808,233150,1342,10,N,N,-,-1,-1
GLOVER.txt,231863,233410,1547,10,N,N,-,-1,-1
GLOVER.txt,231973,233799,1826,10,N,N,-,-1,-1
GLOVER.txt,231985,234150,2165,10,N,N,-,-1,-1
GLOVER.txt,232066,234246,2180,10,N,N,-,-1,-1
GLOVER.txt,232228,234425,2197,10,N,N,-,-1,-1
GLOVER.txt,232469,234477,2008,10,N,N,-,-1,-1
GLOVER.txt,232601,234569,1968,10,N,N,-,-1,-1
GLOVER.txt,232782,234642,1860,10,N,N,-,-1,-1
GLOVER.txt,233089,234711,1622,10,N,N,-,-1,-1
GLOVER.txt,233153,234880,1727,10,N,N,-,-1,-1
GLOVER.txt,233412,235003,1591,10,N,N,-,-1,-1
GLOVER.txt,233802,235034,1232,10,N,N,-,-1,-1
GLOVER.txt,234152,235276,1124,10,N,N,-,-1,-1
GLOVER.txt,234247,235335,1088,10,N,N,-,-1,-1
GLOVER.txt,234426,235465,1039,10,N,N,-,-1,-1
GLOVER.txt,234478,235499,1021,10,N,N,-,-1,-1
GLOVER.txt,234572,235533,961,10,N,N,-,-1,-1
GLOVER.txt,234645,235612,967,10,N,N,-,-1,-1
GLOVER.txt,234716,236180,1464,10,Y,N,-,-1,-1
GLOVER.txt,234881,236282,1401,10,N,N,-,-1,-1
GLOVER.txt,235004,236436,1432,10,N,N,-,-1,-1
GLOVER.txt,235035,236569,1534,10,N,N,-,-1,-1
GLOVER.txt,235277,236679,1402,10,N,N,-,-1,-1
GLOVER.txt,235336,236861,1525,10,N,N,-,-1,-1
GLOVER.txt,235466,237026,1560,10,N,N,-,-1,-1
GLOVER.txt,235500,237251,1751,10,N,N,-,-1,-1
GLOVER.txt,235534,237306,1772,10,N,N,-,-1,-1
GLOVER.txt,235613,237370,1757,10,N,N,-,-1,-1
GLOVER.txt,236183,237597,1414,10,N,N,-,-1,-1
GLOVER.txt,236283,237623,1340,10,N,N,-,-1,-1
GLOVER.txt,236437,237713,1276,10,N,N,-,-1,-1
GLOVER.txt,236570,237786,1216,10,N,N,-,-1,-1
GLOVER.txt,236681,237824,1143,10,N,N,-,-1,-1
GLOVER.txt,236862,237987,1125,10,N,N,-,-1,-1
GLOVER.txt,237027,238016,989,10,N,N,-,-1,-1
GLOVER.txt,237252,238166,914,10,N,N,-,-1,-1
GLOVER.txt,237309,238464,1155,10,N,N,-,-1,-1
GLOVER.txt,237371,238680,1309,10,Y,N,-,-1,-1
GLOVER.txt,237598,238947,1349,10,Y,N,-,-1,-1
GLOVER.txt,237624,239359,1735,10,N,N,-,-1,-1
GLOVER.txt,237714,239765,2051,10,N,N,-,-1,-1
GLOVER.txt,237787,240133,2346,10,N,N,-,-1,-1
GLOVER.txt,237827,240263,2436,10,N,N,-,-1,-1
GLOVER.txt,237988,240403,2415,10,N,N,-,-1,-1
GLOVER.txt,238019,240767,2748,10,N,N,-,-1,-1
GLOVER.txt,238168,241017,2849,10,N,N,-,-1,-1
GLOVER.txt,238465,241127,2662,10,N,N,-,-1,-1
GLOVER.txt,238681,241308,2627,10,N,N,-,-1,-1
GLOVER.txt,238948,241454,2506,10,Y,N,-,-1,-1
GLOVER.txt,239362,241798,2436,10,N,N,-,-1,-1
GLOVER.txt,239768,241857,2089,10,N,N,-,-1,-1
GLOVER.txt,240136,242338,2202,10,N,N,-,-1,-1
GLOVER.txt,240266,242636,2370,10,N,N,-,-1,-1
GLOVER.txt,240404,242715,2311,10,N,N,-,-1,-1
GLOVER.txt,240768,242986,2218,10,N,N,-,-1,-1
GLOVER.txt,241018,243032,2014,10,N,N,-,-1,-1
GLOVER.txt,241130,243211,2081,10,N,N,-,-1,-1
GLOVER.txt,241310,243218,1908,10,N,N,-,-1,-1
GLOVER.txt,241457,243264,1807,10,N,N,-,-1,-1
GLOVER.txt,241801,243292,1491,10,N,N,-,-1,-1
GLOVER.txt,241858,243297,1439,10,N,N,-,-1,-1
GLOVER.txt,242341,243299,958,10,N,N,-,-1,-1
GLOVER.txt,242638,243326,688,10,N,N,-,-1,-1
GLOVER.txt,242718,243378,660,10,N,N,-,-1,-1
GLOVER.txt,242987,243486,499,10,N,N,-,-1,-1
GLOVER.txt,243033,243527,494,10,N,N,-,-1,-1
GLOVER.txt,243212,243634,422,10,N,N,-,-1,-1
GLOVER.txt,243219,243820,601,10,N,N,-,-1,-1
GLOVER.txt,243265,244163,898,10,N,N,-,-1,-1
GLOVER.txt,243293,244491,1198,10,N,N,-,-1,-1
GLOVER.txt,243298,244605,1307,10,N,N,-,-1,-1
GLOVER.txt,243300,244643,1343,10,N,N,-,-1,-1
GLOVER.txt,243328,244689,1361,10,N,N,-,-1,-1
GLOVER.txt,243379,244774,1395,10,N,N,-,-1,-1
GLOVER.txt,243487,244795,1308,10,N,N,-,-1,-1
GLOVER.txt,243528,244819,1291,10,N,N,-,-1,-1
GLOVER.txt,243637,244897,1260,10,N,N,-,-1,-1
GLOVER.txt,243821,245003,1182,10,N,N,-,-1,-1
GLOVER.txt,244164,245025,861,10,N,N,-,-1,-1
GLOVER.txt,244492,245043,551,10,N,N,-,-1,-1
GLOVER.txt,244607,245063,456,10,N,N,-,-1,-1
GLOVER.txt,244644,245271,627,10,N,N,-,-1,-1
GLOVER.txt,244690,245399,709,10,N,N,-,-1,-1
GLOVER.txt,244775,245915,1140,10,N,N,-,-1,-1
GLOVER.txt,244796,245996,1200,10,N,N,-,-1,-1
GLOVER.txt,244820,246077,1257,10,N,N,-,-1,-1
GLOVER.txt,244898,246164,1266,10,N,N,-,-1,-1
GLOVER.txt,245004,246499,1495,10,N,N,-,-1,-1
GLOVER.txt,245026,246672,1646,10,N,N,-,-1,-1
GLOVER.txt,245044,247004,1960,10,N,N,-,-1,-1
GLOVER.txt,245064,247410,2346,10,N,N,-,-1,-1
GLOVER.txt,245274,247625,2351,10,N,N,-,-1,-1
GLOVER.txt,245400,247925,2525,10,N,N,-,-1,-1
GLOVER.txt,245916,248006,2090,10,N,N,-,-1,-1
GLOVER.txt,245997,248232,2235,10,N,N,-,-1,-1
GLOVER.txt,246078,248442,2364,10,N,N,-,-1,-1
GLOVER.txt,246165,248473,2308,10,N,N,-,-1,-1
GLOVER.txt,246501,248702,2201,10,N,N,-,-1,-1
GLOVER.txt,246673,249031,2358,10,N,N,-,-1,-1
GLOVER.txt,247005,249196,2191,10,N,N,-,-1,-1
GLOVER.txt,247411,249318,1907,10,N,N,-,-1,-1
GLOVER.txt,247626,249393,1767,10,N,N,-,-1,-1
GLOVER.txt,247928,249645,1717,10,N,N,-,-1,-1
GLOVER.txt,248007,250028,2021,10,N,N,-,-1,-1
GLOVER.txt,248233,250339,2106,10,N,N,-,-1,-1
GLOVER.txt,248443,250445,2002,10,N,N,-,-1,-1
GLOVER.txt,248476,250505,2029,10,N,N,-,-1,-1
GLOVER.txt,248703,250533,1830,10,N,N,-,-1,-1
GLOVER.txt,249034,250722,1688,10,N,N,-,-1,-1
GLOVER.txt,249197,250832,1635,10,N,N,-,-1,-1
GLOVER.txt,249321,251073,1752,10,N,N,-,-1,-1
GLOVER.txt,249394,251224,1830,10,N,N,-,-1,-1
GLOVER.txt,249646,251243,1597,10,N,N,-,-1,-1
GLOVER.txt,250030,251440,1410,10,N,N,-,-1,-1
GLOVER.txt,250340,251575,1235,10,N,N,-,-1,-1
GLOVER.txt,250446,251648,1202,10,N,N,-,-1,-1
GLOVER.txt,250507,251710,1203,10,N,N,-,-1,-1
GLOVER.txt,250534,251794,1260,10,N,N,-,-1,-1
GLOVER.txt,250723,251817,1094,10,N,N,-,-1,-1
GLOVER.txt,250835,251874,1039,10,N,N,-,-1,-1
GLOVER.txt,251074,252148,1074,10,N,N,-,-1,-1
GLOVER.txt,251225,252290,1065,10,N,N,-,-1,-1
GLOVER.txt,251244,252382,1138,10,N,N,-,-1,-1
GLOVER.txt,251443,252598,1155,10,N,N,-,-1,-1
GLOVER.txt,251576,252996,1420,10,N,N,-,-1,-1
GLOVER.txt,251649,253363,1714,10,N,N,-,-1,-1
GLOVER.txt,251711,253488,1777,10,N,N,-,-1,-1
GLOVER.txt,251797,253691,1894,10,N,N,-,-1,-1
GLOVER.txt,251818,253797,1979,10,N,N,-,-1,-1
GLOVER.txt,251875,254062,2187,10,N,N,-,-1,-1
GLOVER.txt,252151,254147,1996,10,N,N,-,-1,-1
GLOVER.txt,252293,254173,1880,10,N,N,-,-1,-1
GLOVER.txt,252383,254191,1808,10,N,N,-,-1,-1
GLOVER.txt,252599,254295,1696,10,N,N,-,-1,-1
GLOVER.txt,252997,254382,1385,10,N,N,-,-1,-1
GLOVER.txt,253364,254491,1127,10,N,N,-,-1,-1
GLOVER.txt,253489,254581,1092,10,N,N,-,-1,-1
GLOVER.txt,253692,254614,922,10,N,N,-,-1,-1
GLOVER.txt,253800,254691,891,10,N,N,-,-1,-1
GLOVER.txt,254063,254895,832,10,N,N,-,-1,-1
GLOVER.txt,254148,255192,1044,10,N,N,-,-1,-1
GLOVER.txt,254174,255329,1155,10,N,N,-,-1,-1
GLOVER.txt,254192,255470,1278,10,N,N,-,-1,-1
GLOVER.txt,254296,255553,1257,10,N,N,-,-1,-1
GLOVER.txt,254383,255591,1208,10,N,N,-,-1,-1
GLOVER.txt,254493,255875,1382,10,N,N,-,-1,-1
GLOVER.txt,254582,256204,1622,10,N,N,-,-1,-1
GLOVER.txt,254615,256434,1819,10,N,N,-,-1,-1
GLOVER.txt,254692,256544,1852,10,N,N,-,-1,-1
GLOVER.txt,254896,256642,1746,10,N,N,-,-1,-1
GLOVER.txt,255195,256737,1542,10,N,N,-,-1,-1
GLOVER.txt,255330,257102,1772,10,Y,N,-,-1,-1
GLOVER.txt,255473,257317,1844,10,Y,N,-,-1,-1
GLOVER.txt,255556,257498,1942,10,Y,N,-,-1,-1
GLOVER.txt,255592,257588,1996,10,Y,N,-,-1,-1
GLOVER.txt,255878,257725,1847,10,Y,N,-,-1,-1
GLOVER.txt,256205,257846,1641,10,N,N,-,-1,-1
GLOVER.txt,256435,257994,1559,10,N,N,-,-1,-1
GLOVER.txt,256547,258168,1621,10,N,N,-,-1,-1
GLOVER.txt,256644,258267,1623,10,Y,N,-,-1,-1
GLOVER.txt,256739,258420,1681,10,N,N,-,-1,-1
GLOVER.txt,257105,258594,1489,10,N,N,-,-1,-1
GLOVER.txt,257318,258868,1550,10,N,N,-,-1,-1
GLOVER.txt,257499,258996,1497,10,N,N,-,-1,-1
GLOVER.txt,257591,259158,1567,10,N,N,-,-1,-1
GLOVER.txt,257726,259379,1653,10,N,N,-,-1,-1
GLOVER.txt,257849,259501,1652,10,N,N,-,-1,-1
GLOVER.txt,257996,259551,1555,10,N,N,-,-1,-1
GLOVER.txt,258169,259659,1490,10,N,N,-,-1,-1
GLOVER.txt,258268,259733,1465,10,N,N,-,-1,-1
GLOVER.txt,258421,259778,1357,10,N,N,-,-1,-1
GLOVER.txt,258597,259797,1200,10,N,N,-,-1,-1
GLOVER.txt,258869,260026,1157,10,N,N,-,-1,-1
GLOVER.txt,258999,260144,1145,10,N,N,-,-1,-1
GLOVER.txt,259159,260209,1050,10,N,N,-,-1,-1
GLOVER.txt,259380,260243,863,10,N,N,-,-1,-1
GLOVER.txt,259502,260357,855,10,N,N,-,-1,-1
GLOVER.txt,259552,260379,827,10,N,N,-,-1,-1
GLOVER.txt,259660,260511,851,10,N,N,-,-1,-1
GLOVER.txt,259734,260916,1182,10,N,N,-,-1,-1
GLOVER.txt,259779,261057,1278,10,N,N,-,-1,-1
GLOVER.txt,259798,261105,1307,10,N,N,-,-1,-1
GLOVER.txt,260027,261212,1185,10,N,N,-,-1,-1
GLOVER.txt,260145,261470,1325,10,N,N,-,-1,-1
GLOVER.txt,260210,261721,1511,10,N,N,-,-1,-1
GLOVER.txt,260244,261775,1531,10,N,N,-,-1,-1
GLOVER.txt,260359,261986,1627,10,N,N,-,-1,-1
GLOVER.txt,260380,262025,1645,10,N,N,-,-1,-1
GLOVER.txt,260514,262055,1541,10,N,N,-,-1,-1
GLOVER.txt,260921,262134,1213,10,N,N,-,-1,-1
GLOVER.txt,261058,262314,1256,10,N,N,-,-1,-1
GLOVER.txt,261106,262561,1455,10,N,N,-,-1,-1
GLOVER.txt,261213,262958,1745,10,N,N,-,-1,-1
GLOVER.txt,261472,263038,1566,10,N,N,-,-1,-1
GLOVER.txt,261722,263134,1412,10,N,N,-,-1,-1
GLOVER.txt,261778,263261,1483,10,N,N,-,-1,-1
GLOVER.txt,261987,263763,1776,10,N,N,-,-1,-1
GLOVER.txt,262027,263785,1758,10,N,N,-,-1,-1
GLOVER.txt,262056,263787,1731,10,N,N,-,-1,-1
GLOVER.txt,262137,263789,1652,10,N,N,-,-1,-1
GLOVER.txt,262315,263850,1535,10,N,N,-,-1,-1
GLOVER.txt,262566,264184,1618,10,N,N,-,-1,-1
GLOVER.txt,262961,264208,1247,10,N,N,-,-1,-1
GLOVER.txt,263039,264232,1193,10,N,N,-,-1,-1
GLOVER.txt,263135,264342,1207,10,N,N,-,-1,-1
GLOVER.txt,263262,264444,1182,10,N,N,-,-1,-1
GLOVER.txt,263764,264694,930,10,N,N,-,-1,-1
GLOVER.txt,263786,264987,1201,10,N,N,-,-1,-1
GLOVER.txt,263788,265023,1235,10,N,N,-,-1,-1
GLOVER.txt,263790,265322,1532,10,N,N,-,-1,-1
GLOVER.txt,263852,265364,1512,10,N,N,-,-1,-1
GLOVER.txt,264185,265396,1211,10,N,N,-,-1,-1
GLOVER.txt,264209,265555,1346,10,N,N,-,-1,-1
GLOVER.txt,264233,265670,1437,10,N,N,-,-1,-1
GLOVER.txt,264343,265897,1554,10,N,N,-,-1,-1
GLOVER.txt,264445,265940,1495,10,N,N,-,-1,-1
GLOVER.txt,264695,266281,1586,10,N,N,-,-1,-1
GLOVER.txt,264990,266351,1361,10,N,N,-,-1,-1
GLOVER.txt,265024,266363,1339,10,N,N,-,-1,-1
GLOVER.txt,265323,266400,1077,10,N,N,-,-1,-1
GLOVER.txt,265365,267028,1663,10,N,N,-,-1,-1
GLOVER.txt,265397,267049,1652,10,N,N,-,-1,-1
GLOVER.txt,265556,267051,1495,10,N,N,-,-1,-1
GLOVER.txt,265671,267079,1408,10,N,N,-,-1,-1
GLOVER.txt,265898,267098,1200,10,N,N,-,-1,-1
GLOVER.txt,265941,267135,1194,10,N,N,-,-1,-1
GLOVER.txt,266282,267333,1051,10,N,N,-,-1,-1
GLOVER.txt,266352,267566,1214,10,N,N,-,-1,-1
GLOVER.txt,266364,267870,1506,10,N,N,-,-1,-1
GLOVER.txt,266401,268098,1697,10,N,N,-,-1,-1
GLOVER.txt,267029,268155,1126,10,N,N,-,-1,-1
GLOVER.txt,267050,268541,1491,10,N,N,-,-1,-1
GLOVER.txt,267052,268755,1703,10,N,N,-,-1,-1
GLOVER.txt,267080,268851,1771,10,N,N,-,-1,-1
GLOVER.txt,267099,268968,1869,10,N,N,-,-1,-1
GLOVER.txt,267137,268983,1846,10,N,N,-,-1,-1
GLOVER.txt,267336,269145,1809,10,N,N,-,-1,-1
GLOVER.txt,267567,269220,1653,10,N,N,-,-1,-1
GLOVER.txt,267873,269507,1634,10,N,N,-,-1,-1
GLOVER.txt,268099,269525,1426,10,N,N,-,-1,-1
GLOVER.txt,268156,269756,1600,10,N,N,-,-1,-1
GLOVER.txt,268542,269800,1258,10,N,N,-,-1,-1
GLOVER.txt,268758,269954,1196,10,N,N,-,-1,-1
GLOVER.txt,268853,270154,1301,10,N,N,-,-1,-1
GLOVER.txt,268968,270226,1258,10,N,N,-,-1,-1
GLOVER.txt,268986,270357,1371,10,N,N,-,-1,-1
GLOVER.txt,269146,270817,1671,10,N,N,-,-1,-1
GLOVER.txt,269221,270855,1634,10,N,N,-,-1,-1
GLOVER.txt,269508,270919,1411,10,N,N,-,-1,-1
GLOVER.txt,269527,270982,1455,10,N,N,-,-1,-1
GLOVER.txt,269757,271038,1281,10,N,N,-,-1,-1
GLOVER.txt,269803,271121,1318,10,N,N,-,-1,-1
GLOVER.txt,269955,271154,1199,10,N,N,-,-1,-1
GLOVER.txt,270156,271229,1073,10,N,N,-,-1,-1
GLOVER.txt,270227,271305,1078,10,N,N,-,-1,-1
GLOVER.txt,270358,271383,1025,10,N,N,-,-1,-1
GLOVER.txt,270818,271515,697,10,N,N,-,-1,-1
GLOVER.txt,270858,271566,708,10,N,N,-,-1,-1
GLOVER.txt,270920,271658,738,10,N,N,-,-1,-1
GLOVER.txt,270983,271775,792,10,N,N,-,-1,-1
GLOVER.txt,271039,271933,894,10,N,N,-,-1,-1
GLOVER.txt,271122,272070,948,10,N,N,-,-1,-1
GLOVER.txt,271156,272092,936,10,N,N,-,-1,-1
GLOVER.txt,271230,272274,1044,10,N,N,-,-1,-1
GLOVER.txt,271307,272619,1312,10,N,N,-,-1,-1
GLOVER.txt,271384,272741,1357,10,N,N,-,-1,-1
GLOVER.txt,271516,272851,1335,10,N,N,-,-1,-1
GLOVER.txt,271567,272977,1410,10,N,N,-,-1,-1
GLOVER.txt,271659,273004,1345,10,N,N,-,-1,-1
GLOVER.txt,271776,273082,1306,10,N,N,-,-1,-1
GLOVER.txt,271934,273348,1414,10,N,N,-,-1,-1
GLOVER.txt,272071,273412,1341,10,N,N,-,-1,-1
GLOVER.txt,272093,273692,1599,10,N,N,-,-1,-1
GLOVER.txt,272275,273810,1535,10,N,N,-,-1,-1
GLOVER.txt,272620,273849,1229,10,N,N,-,-1,-1
GLOVER.txt,272743,273996,1253,10,N,N,-,-1,-1
GLOVER.txt,272854,274202,1348,10,N,N,-,-1,-1
GLOVER.txt,272978,274338,1360,10,N,N,-,-1,-1
GLOVER.txt,273004,274617,1613,10,N,N,-,-1,-1
GLOVER.txt,273083,274818,1735,10,N,N,-,-1,-1
GLOVER.txt,273351,275315,1964,10,N,N,-,-1,-1
GLOVER.txt,273413,275341,1928,10,N,N,-,-1,-1
GLOVER.txt,273695,275409,1714,10,N,N,-,-1,-1
GLOVER.txt,273811,275464,1653,10,N,N,-,-1,-1
GLOVER.txt,273850,275614,1764,10,N,N,-,-1,-1
GLOVER.txt,273997,275697,1700,10,N,N,-,-1,-1
GLOVER.txt,274203,275706,1503,10,N,N,-,-1,-1
GLOVER.txt,274339,275724,1385,10,N,N,-,-1,-1
GLOVER.txt,274618,275868,1250,10,N,N,-,-1,-1
GLOVER.txt,274819,276030,1211,10,N,N,-,-1,-1
GLOVER.txt,275318,276306,988,10,N,N,-,-1,-1
GLOVER.txt,275342,276311,969,10,N,N,-,-1,-1
GLOVER.txt,275410,276316,906,10,N,N,-,-1,-1
GLOVER.txt,275466,276422,956,10,N,N,-,-1,-1
GLOVER.txt,275615,276610,995,10,N,N,-,-1,-1
GLOVER.txt,275698,276925,1227,10,N,N,-,-1,-1
GLOVER.txt,275708,277133,1425,10,N,N,-,-1,-1
GLOVER.txt,275725,277247,1522,10,N,N,-,-1,-1
GLOVER.txt,275869,277307,1438,10,N,N,-,-1,-1
GLOVER.txt,276033,277394,1361,10,N,N,-,-1,-1
GLOVER.txt,276307,277689,1382,10,N,N,-,-1,-1
GLOVER.txt,276312,277942,1630,10,N,N,-,-1,-1
GLOVER.txt,276317,278043,1726,10,N,N,-,-1,-1
GLOVER.txt,276425,278146,1721,10,N,N,-,-1,-1
GLOVER.txt,276611,278292,1681,10,N,N,-,-1,-1
GLOVER.txt,276926,278371,1445,10,N,N,-,-1,-1
GLOVER.txt,277136,278396,1260,10,N,N,-,-1,-1
GLOVER.txt,277248,278487,1239,10,N,N,-,-1,-1
GLOVER.txt,277308,278707,1399,10,N,N,-,-1,-1
GLOVER.txt,277395,278729,1334,10,N,N,-,-1,-1
GLOVER.txt,277692,278871,1179,10,N,N,-,-1,-1
GLOVER.txt,277943,278905,962,10,N,N,-,-1,-1
GLOVER.txt,278044,279050,1006,10,N,N,-,-1,-1
GLOVER.txt,278148,279064,916,10,N,N,-,-1,-1
GLOVER.txt,278293,279334,1041,10,N,N,-,-1,-1
GLOVER.txt,278374,279416,1042,10,N,N,-,-1,-1
GLOVER.txt,278397,279485,1088,10,N,N,-,-1,-1
GLOVER.txt,278488,279496,1008,10,N,N,-,-1,-1
GLOVER.txt,278710,279587,877,10,N,N,-,-1,-1
GLOVER.txt,278734,279645,911,10,N,N,-,-1,-1
GLOVER.txt,278874,279694,820,10,N,N,-,-1,-1
GLOVER.txt,278908,279807,899,10,N,N,-,-1,-1
GLOVER.txt,279053,279879,826,10,N,N,-,-1,-1
GLOVER.txt,279067,279955,888,10,N,N,-,-1,-1
GLOVER.txt,279337,280100,763,10,N,N,-,-1,-1
GLOVER.txt,279419,280160,741,10,N,N,-,-1,-1
GLOVER.txt,279486,280209,723,10,N,N,-,-1,-1
GLOVER.txt,279499,280233,734,10,N,N,-,-1,-1
GLOVER.txt,279588,280274,686,10,N,N,-,-1,-1
GLOVER.txt,279647,280290,643,10,N,N,-,-1,-1
GLOVER.txt,279695,280373,678,10,N,N,-,-1,-1
GLOVER.txt,279808,280417,609,10,N,N,-,-1,-1
GLOVER.txt,279880,280546,666,10,N,N,-,-1,-1
GLOVER.txt,279956,280775,819,10,N,N,-,-1,-1
GLOVER.txt,280102,280876,774,10,N,N,-,-1,-1
GLOVER.txt,280161,280964,803,10,N,N,-,-1,-1
GLOVER.txt,280210,281208,998,10,N,N,-,-1,-1
GLOVER.txt,280234,281291,1057,10,N,N,-,-1,-1
GLOVER.txt,280275,281407,1132,10,N,N,-,-1,-1
GLOVER.txt,280291,281505,1214,10,N,N,-,-1,-1
GLOVER.txt,280374,281590,1216,10,N,N,-,-1,-1
GLOVER.txt,280418,281705,1287,10,N,N,-,-1,-1
GLOVER.txt,280547,281773,1226,10,N,N,-,-1,-1
GLOVER.txt,280778,281842,1064,10,N,N,-,-1,-1
GLOVER.txt,280878,282292,1414,10,N,N,-,-1,-1
GLOVER.txt,280965,282377,1412,10,N,N,-,-1,-1
GLOVER.txt,281209,282480,1271,10,N,N,-,-1,-1
GLOVER.txt,281293,282851,1558,10,N,N,-,-1,-1
GLOVER.txt,281410,283175,1765,10,N,N,-,-1,-1
GLOVER.txt,281508,283303,1795,10,N,N,-,-1,-1
GLOVER.txt,281591,283637,2046,10,N,N,-,-1,-1
GLOVER.txt,281707,283995,2288,10,N,N,-,-1,-1
GLOVER.txt,281774,284128,2354,10,N,N,-,-1,-1
GLOVER.txt,281843,284184,2341,10,N,N,-,-1,-1
GLOVER.txt,282293,284395,2102,10,N,N,-,-1,-1
GLOVER.txt,282378,284445,2067,10,N,N,-,-1,-1
GLOVER.txt,282481,284469,1988,10,N,N,-,-1,-1
GLOVER.txt,282852,284573,1721,10,N,N,-,-1,-1
GLOVER.txt,283176,284820,1644,10,N,N,-,-1,-1
GLOVER.txt,283306,285051,1745,10,N,N,-,-1,-1
GLOVER.txt,283640,285142,1502,10,N,N,-,-1,-1
GLOVER.txt,283998,285316,1318,10,N,N,-,-1,-1
GLOVER.txt,284131,285724,1593,10,N,N,-,-1,-1
GLOVER.txt,284185,285779,1594,10,N,N,-,-1,-1
GLOVER.txt,284396,286053,1657,10,N,N,-,-1,-1
GLOVER.txt,284446,286338,1892,10,N,N,-,-1,-1
GLOVER.txt,284470,286696,2226,10,N,N,-,-1,-1
GLOVER.txt,284576,287040,2464,10,N,N,-,-1,-1
GLOVER.txt,284823,287102,2279,10,N,N,-,-1,-1
GLOVER.txt,285052,287502,2450,10,N,N,-,-1,-1
GLOVER.txt,285145,287712,2567,10,N,N,-,-1,-1
GLOVER.txt,285317,287874,2557,10,N,N,-,-1,-1
GLOVER.txt,285725,288051,2326,10,N,N,-,-1,-1
GLOVER.txt,285782,288106,2324,10,N,N,-,-1,-1
GLOVER.txt,286054,288125,2071,10,N,N,-,-1,-1
GLOVER.txt,286339,288219,1880,10,N,N,-,-1,-1
GLOVER.txt,286701,288505,1804,10,N,N,-,-1,-1
GLOVER.txt,287041,288712,1671,10,N,N,-,-1,-1
GLOVER.txt,287103,288805,1702,10,N,N,-,-1,-1
GLOVER.txt,287503,288820,1317,10,N,N,-,-1,-1
GLOVER.txt,287713,288855,1142,10,N,N,-,-1,-1
GLOVER.txt,287877,288918,1041,10,N,N,-,-1,-1
GLOVER.txt,288054,288958,904,10,N,N,-,-1,-1
GLOVER.txt,288107,289314,1207,10,N,N,-,-1,-1
GLOVER.txt,288126,289514,1388,10,N,N,-,-1,-1
GLOVER.txt,288220,289689,1469,10,N,N,-,-1,-1
GLOVER.txt,288506,289778,1272,10,N,N,-,-1,-1
GLOVER.txt,288713,289805,1092,10,N,N,-,-1,-1
GLOVER.txt,288806,290173,1367,10,N,N,-,-1,-1
GLOVER.txt,288821,290271,1450,10,N,N,-,-1,-1
GLOVER.txt,288856,290323,1467,10,N,N,-,-1,-1
GLOVER.txt,288919,290554,1635,10,N,N,-,-1,-1
GLOVER.txt,288959,291012,2053,10,N,N,-,-1,-1
GLOVER.txt,289317,291114,1797,10,N,N,-,-1,-1
GLOVER.txt,289515,291184,1669,10,N,N,-,-1,-1
GLOVER.txt,289690,291279,1589,10,N,N,-,-1,-1
GLOVER.txt,289779,291328,1549,10,N,N,-,-1,-1
GLOVER.txt,289806,291362,1556,10,N,N,-,-1,-1
GLOVER.txt,290174,291479,1305,10,N,N,-,-1,-1
GLOVER.txt,290274,291677,1403,10,N,N,-,-1,-1
GLOVER.txt,290325,291801,1476,10,N,N,-,-1,-1
GLOVER.txt,290559,291876,1317,10,N,N,-,-1,-1
GLOVER.txt,291015,291905,890,10,N,N,-,-1,-1
GLOVER.txt,291115,291933,818,10,N,N,-,-1,-1
GLOVER.txt,291185,291993,808,10,N,N,-,-1,-1
GLOVER.txt,291280,292009,729,10,N,N,-,-1,-1
GLOVER.txt,291331,292038,707,10,N,N,-,-1,-1
GLOVER.txt,291363,292102,739,10,N,N,-,-1,-1
GLOVER.txt,291482,292228,746,10,N,N,-,-1,-1
GLOVER.txt,291679,292318,639,10,N,N,-,-1,-1
GLOVER.txt,291802,292462,660,10,N,N,-,-1,-1
GLOVER.txt,291877,292594,717,10,N,N,-,-1,-1
GLOVER.txt,291906,292694,788,10,N,N,-,-1,-1
GLOVER.txt,291934,292809,875,10,N,N,-,-1,-1
GLOVER.txt,291996,292828,832,10,N,N,-,-1,-1
GLOVER.txt,292010,292852,842,10,N,N,-,-1,-1
GLOVER.txt,292040,292907,867,10,N,N,-,-1,-1
GLOVER.txt,292103,292953,850,10,N,N,-,-1,-1
GLOVER.txt,292231,292973,742,10,N,N,-,-1,-1
GLOVER.txt,292319,293001,682,10,N,N,-,-1,-1
GLOVER.txt,292463,293008,545,10,N,N,-,-1,-1
GLOVER.txt,292595,293047,452,10,N,N,-,-1,-1
GLOVER.txt,292697,293129,432,10,N,N,-,-1,-1
GLOVER.txt,292810,293146,336,10,N,N,-,-1,-1
GLOVER.txt,292829,293236,407,10,N,N,-,-1,-1
GLOVER.txt,292853,293248,395,10,N,N,-,-1,-1
GLOVER.txt,292908,293268,360,10,N,N,-,-1,-1
GLOVER.txt,292954,293341,387,10,N,N,-,-1,-1
GLOVER.txt,292974,293348,374,10,N,N,-,-1,-1
GLOVER.txt,293002,293355,353,10,N,N,-,-1,-1
GLOVER.txt,293009,293527,518,10,N,N,-,-1,-1
GLOVER.txt,293049,293549,500,10,N,N,-,-1,-1
GLOVER.txt,293130,293596,466,10,N,N,-,-1,-1
GLOVER.txt,293148,293702,554,10,N,N,-,-1,-1
GLOVER.txt,293237,293716,479,10,N,N,-,-1,-1
GLOVER.txt,293249,293900,651,10,N,N,-,-1,-1
GLOVER.txt,293269,293947,678,10,N,N,-,-1,-1
GLOVER.txt,293344,294032,688,10,N,N,-,-1,-1
GLOVER.txt,293349,294087,738,10,N,N,-,-1,-1
GLOVER.txt,293356,294131,775,10,N,N,-,-1,-1
GLOVER.txt,293528,294136,608,10,N,N,-,-1,-1
GLOVER.txt,293550,294164,614,10,N,N,-,-1,-1
GLOVER.txt,293597,294187,590,10,N,N,-,-1,-1
GLOVER.txt,293703,294260,557,10,N,N,-,-1,-1
GLOVER.txt,293719,294352,633,10,N,N,-,-1,-1
GLOVER.txt,293901,294543,642,10,N,N,-,-1,-1
GLOVER.txt,293948,294684,736,10,N,N,-,-1,-1
GLOVER.txt,294033,294720,687,10,N,N,-,-1,-1
GLOVER.txt,294089,295015,926,10,N,N,-,-1,-1
GLOVER.txt,294132,295222,1090,10,N,N,-,-1,-1
GLOVER.txt,294138,295295,1157,10,N,N,-,-1,-1
GLOVER.txt,294165,295367,1202,10,N,N,-,-1,-1
GLOVER.txt,294189,295486,1297,10,N,N,-,-1,-1
GLOVER.txt,294263,295502,1239,10,N,N,-,-1,-1
GLOVER.txt,294353,295619,1266,10,N,N,-,-1,-1
GLOVER.txt,294546,295648,1102,10,N,N,-,-1,-1
GLOVER.txt,294685,295764,1079,10,N,N,-,-1,-1
GLOVER.txt,294721,295799,1078,10,N,N,-,-1,-1
GLOVER.txt,295018,295893,875,10,N,N,-,-1,-1
GLOVER.txt,295224,296443,1219,10,N,N,-,-1,-1
GLOVER.txt,295296,296547,1251,10,N,N,-,-1,-1
GLOVER.txt,295368,296691,1323,10,N,N,-,-1,-1
GLOVER.txt,295487,296782,1295,10,N,N,-,-1,-1
GLOVER.txt,295503,296923,1420,10,N,N,-,-1,-1
GLOVER.txt,295620,297009,1389,10,N,N,-,-1,-1
GLOVER.txt,295649,297082,1433,10,N,N,-,-1,-1
GLOVER.txt,295765,297223,1458,10,N,N,-,-1,-1
GLOVER.txt,295800,297402,1602,10,N,N,-,-1,-1
GLOVER.txt,295898,297546,1648,10,N,N,-,-1,-1
GLOVER.txt,296446,297564,1118,10,N,N,-,-1,-1
GLOVER.txt,296549,297704,1155,10,N,N,-,-1,-1
GLOVER.txt,296691,297793,1102,10,N,N,-,-1,-1
GLOVER.txt,296783,297876,1093,10,N,N,-,-1,-1
GLOVER.txt,296924,297970,1046,10,N,N,-,-1,-1
GLOVER.txt,297012,297985,973,10,N,N,-,-1,-1
GLOVER.txt,297083,298069,986,10,N,N,-,-1,-1
GLOVER.txt,297224,298125,901,10,N,N,-,-1,-1
GLOVER.txt,297403,298291,888,10,N,N,-,-1,-1
GLOVER.txt,297547,298470,923,10,N,N,-,-1,-1
GLOVER.txt,297565,298570,1005,10,N,N,-,-1,-1
GLOVER.txt,297706,298686,980,10,N,N,-,-1,-1
GLOVER.txt,297796,298719,923,10,N,N,-,-1,-1
GLOVER.txt,297877,298753,876,10,N,N,-,-1,-1
GLOVER.txt,297971,298828,857,10,N,N,-,-1,-1
GLOVER.txt,297987,298890,903,10,N,N,-,-1,-1
GLOVER.txt,298072,298917,845,10,N,N,-,-1,-1
GLOVER.txt,298126,298941,815,10,N,N,-,-1,-1
GLOVER.txt,298292,299067,775,10,N,N,-,-1,-1
GLOVER.txt,298471,299183,712,10,N,N,-,-1,-1
GLOVER.txt,298571,299194,623,10,N,N,-,-1,-1
GLOVER.txt,298688,299252,564,10,N,N,-,-1,-1
GLOVER.txt,298721,299411,690,10,N,N,-,-1,-1
GLOVER.txt,298756,299552,796,10,N,N,-,-1,-1
GLOVER.txt,298829,299594,765,10,N,N,-,-1,-1
GLOVER.txt,298891,299617,726,10,N,N,-,-1,-1
GLOVER.txt,298918,299646,728,10,N,N,-,-1,-1
GLOVER.txt,298942,299677,735,10,N,N,-,-1,-1
GLOVER.txt,299070,299728,658,10,N,N,-,-1,-1
GLOVER.txt,299184,300032,848,10,N,N,-,-1,-1
GLOVER.txt,299197,300047,850,10,N,N,-,-1,-1
GLOVER.txt,299253,300118,865,10,N,N,-,-1,-1
GLOVER.txt,299412,300167,755,10,N,N,-,-1,-1
GLOVER.txt,299555,300234,679,10,N,N,-,-1,-1
GLOVER.txt,299595,300376,781,10,N,N,-,-1,-1
GLOVER.txt,299618,300785,1167,10,N,N,-,-1,-1
GLOVER.txt,299648,300900,1252,10,N,N,-,-1,-1
GLOVER.txt,299678,301051,1373,10,N,N,-,-1,-1
GLOVER.txt,299729,301232,1503,10,N,N,-,-1,-1
GLOVER.txt,300033,301277,1244,10,N,N,-,-1,-1
GLOVER.txt,300048,301353,1305,10,N,N,-,-1,-1
GLOVER.txt,300119,301419,1300,10,N,N,-,-1,-1
GLOVER.txt,300168,301460,1292,10,N,N,-,-1,-1
GLOVER.txt,300236,301519,1283,10,N,N,-,-1,-1
GLOVER.txt,300377,301612,1235,10,N,N,-,-1,-1
GLOVER.txt,300786,301787,1001,10,N,N,-,-1,-1
GLOVER.txt,300901,301920,1019,10,N,N,-,-1,-1
GLOVER.txt,301052,302025,973,10,N,N,-,-1,-1
GLOVER.txt,301233,302080,847,10,N,N,-,-1,-1
GLOVER.txt,301279,302088,809,10,N,N,-,-1,-1
GLOVER.txt,301354,302120,766,10,N,N,-,-1,-1
GLOVER.txt,301420,302235,815,10,N,N,-,-1,-1
GLOVER.txt,301463,302277,814,10,N,N,-,-1,-1
GLOVER.txt,301520,302450,930,10,N,N,-,-1,-1
GLOVER.txt,301615,302596,981,10,N,N,-,-1,-1
GLOVER.txt,301788,302617,829,10,N,N,-,-1,-1
GLOVER.txt,301923,302743,820,10,N,N,-,-1,-1
GLOVER.txt,302026,302783,757,10,N,N,-,-1,-1
GLOVER.txt,302081,302825,744,10,N,N,-,-1,-1
GLOVER.txt,302089,302948,859,10,N,N,-,-1,-1
GLOVER.txt,302121,303080,959,10,N,N,-,-1,-1
GLOVER.txt,302236,303241,1005,10,N,N,-,-1,-1
GLOVER.txt,302278,303310,1032,10,N,N,-,-1,-1
GLOVER.txt,302452,303494,1042,10,N,N,-,-1,-1
GLOVER.txt,302599,303516,917,10,N,N,-,-1,-1
GLOVER.txt,302618,303812,1194,10,N,N,-,-1,-1
GLOVER.txt,302744,303925,1181,10,N,N,-,-1,-1
GLOVER.txt,302784,304051,1267,10,N,N,-,-1,-1
GLOVER.txt,302826,304199,1373,10,N,N,-,-1,-1
GLOVER.txt,302949,304211,1262,10,N,N,-,-1,-1
GLOVER.txt,303081,304221,1140,10,N,N,-,-1,-1
GLOVER.txt,303243,304509,1266,10,N,N,-,-1,-1
GLOVER.txt,303311,304644,1333,10,N,N,-,-1,-1
GLOVER.txt,303495,304708,1213,10,N,N,-,-1,-1
GLOVER.txt,303517,305090,1573,10,N,N,-,-1,-1
GLOVER.txt,303815,305123,1308,10,N,N,-,-1,-1
GLOVER.txt,303926,305187,1261,10,N,N,-,-1,-1
GLOVER.txt,304052,305337,1285,10,N,N,-,-1,-1
GLOVER.txt,304200,305366,1166,10,N,N,-,-1,-1
GLOVER.txt,304213,305568,1355,10,N,N,-,-1,-1
GLOVER.txt,304224,305674,1450,10,N,N,-,-1,-1
GLOVER.txt,304510,305920,1410,10,N,N,-,-1,-1
GLOVER.txt,304645,306019,1374,10,N,N,-,-1,-1
GLOVER.txt,304709,306080,1371,10,N,N,-,-1,-1
GLOVER.txt,305091,306305,1214,10,N,N,-,-1,-1
GLOVER.txt,305124,306509,1385,10,N,N,-,-1,-1
GLOVER.txt,305188,306725,1537,10,Y,N,-,-1,-1
GLOVER.txt,305338,306957,1619,10,N,N,-,-1,-1
GLOVER.txt,305367,307204,1837,10,Y,N,-,-1,-1
GLOVER.txt,305569,307363,1794,10,Y,N,-,-1,-1
GLOVER.txt,305675,307517,1842,10,Y,N,-,-1,-1
GLOVER.txt,305921,307614,1693,10,Y,N,-,-1,-1
GLOVER.txt,306020,307656,1636,10,Y,N,-,-1,-1
GLOVER.txt,306083,307688,1605,10,Y,N,-,-1,-1
GLOVER.txt,306306,307734,1428,10,N,N,-,-1,-1
GLOVER.txt,306510,307760,1250,10,N,N,-,-1,-1
GLOVER.txt,306726,307768,1042,10,N,N,-,-1,-1
GLOVER.txt,306960,307783,823,10,N,N,-,-1,-1
GLOVER.txt,307205,307832,627,10,N,N,-,-1,-1
GLOVER.txt,307364,307840,476,10,N,N,-,-1,-1
GLOVER.txt,307518,307943,425,10,N,N,-,-1,-1
GLOVER.txt,307615,307962,347,10,N,N,-,-1,-1
GLOVER.txt,307657,308071,414,10,N,N,-,-1,-1
GLOVER.txt,307691,308107,416,10,N,N,-,-1,-1
GLOVER.txt,307735,308129,394,10,N,N,-,-1,-1
GLOVER.txt,307763,308208,445,10,N,N,-,-1,-1
GLOVER.txt,307769,308248,479,10,N,N,-,-1,-1
GLOVER.txt,307786,308339,553,10,N,N,-,-1,-1
GLOVER.txt,307835,308427,592,10,N,N,-,-1,-1
GLOVER.txt,307841,308493,652,10,N,N,-,-1,-1
GLOVER.txt,307944,308678,734,10,N,N,-,-1,-1
GLOVER.txt,307963,308796,833,10,N,N,-,-1,-1
GLOVER.txt,308072,308894,822,10,N,N,-,-1,-1
GLOVER.txt,308110,309072,962,10,N,N,-,-1,-1
GLOVER.txt,308130,309094,964,10,N,N,-,-1,-1
GLOVER.txt,308210,309244,1034,10,N,N,-,-1,-1
GLOVER.txt,308251,309450,1199,10,N,N,-,-1,-1
GLOVER.txt,308340,309545,1205,10,N,N,-,-1,-1
GLOVER.txt,308428,309922,1494,10,N,N,-,-1,-1
GLOVER.txt,308494,310079,1585,10,N,N,-,-1,-1
GLOVER.txt,308681,310235,1554,10,N,N,-,-1,-1
GLOVER.txt,308797,310413,1616,10,N,N,-,-1,-1
GLOVER.txt,308895,310487,1592,10,N,N,-,-1,-1
GLOVER.txt,309073,310557,1484,10,N,N,-,-1,-1
GLOVER.txt,309095,310737,1642,10,N,N,-,-1,-1
GLOVER.txt,309245,310880,1635,10,N,N,-,-1,-1
GLOVER.txt,309451,310939,1488,10,N,N,-,-1,-1
GLOVER.txt,309546,310988,1442,10,N,N,-,-1,-1
GLOVER.txt,309923,311119,1196,10,N,N,-,-1,-1
GLOVER.txt,310080,311454,1374,10,N,N,-,-1,-1
GLOVER.txt,310236,311676,1440,10,N,N,-,-1,-1
GLOVER.txt,310416,311793,1377,10,N,N,-,-1,-1
GLOVER.txt,310488,312115,1627,10,N,N,-,-1,-1
GLOVER.txt,310559,312377,1818,10,N,N,-,-1,-1
GLOVER.txt,310738,312520,1782,10,N,N,-,-1,-1
GLOVER.txt,310881,312585,1704,10,N,N,-,-1,-1
GLOVER.txt,310940,312836,1896,10,N,N,-,-1,-1
GLOVER.txt,310989,313037,2048,10,N,N,-,-1,-1
GLOVER.txt,311120,313119,1999,10,N,N,-,-1,-1
GLOVER.txt,311457,313303,1846,10,N,N,-,-1,-1
GLOVER.txt,311677,313465,1788,10,N,N,-,-1,-1
GLOVER.txt,311796,313900,2104,10,N,N,-,-1,-1
GLOVER.txt,312116,314041,1925,10,Y,N,-,-1,-1
GLOVER.txt,312378,314171,1793,10,Y,N,-,-1,-1
GLOVER.txt,312521,314252,1731,10,N,N,-,-1,-1
GLOVER.txt,312586,314498,1912,10,N,N,-,-1,-1
GLOVER.txt,312837,314651,1814,10,N,N,-,-1,-1
GLOVER.txt,313040,315009,1969,10,Y,N,-,-1,-1
GLOVER.txt,313120,315173,2053,10,Y,N,-,-1,-1
GLOVER.txt,313304,315244,1940,10,Y,N,-,-1,-1
GLOVER.txt,313466,315379,1913,10,Y,N,-,-1,-1
GLOVER.txt,313903,315532,1629,10,Y,N,-,-1,-1
GLOVER.txt,314044,315622,1578,10,Y,N,-,-1,-1
GLOVER.txt,314174,315749,1575,10,Y,N,-,-1,-1
GLOVER.txt,314253,315927,1674,10,Y,N,-,-1,-1
GLOVER.txt,314501,316129,1628,10,Y,N,-,-1,-1
GLOVER.txt,314653,316209,1556,10,Y,N,-,-1,-1
GLOVER.txt,315010,316314,1304,10,Y,N,-,-1,-1
GLOVER.txt,315174,316489,1315,10,Y,N,-,-1,-1
GLOVER.txt,315245,316576,1331,10,Y,N,-,-1,-1
GLOVER.txt,315380,316703,1323,10,Y,N,-,-1,-1
GLOVER.txt,315534,316826,1292,10,Y,N,-,-1,-1
GLOVER.txt,315623,317026,1403,10,Y,N,-,-1,-1
GLOVER.txt,315750,317204,1454,10,Y,N,-,-1,-1
GLOVER.txt,315930,317247,1317,10,N,N,-,-1,-1
GLOVER.txt,316132,317286,1154,10,N,N,-,-1,-1
GLOVER.txt,316210,317345,1135,10,N,N,-,-1,-1
GLOVER.txt,316315,317397,1082,10,N,N,-,-1,-1
GLOVER.txt,316491,317503,1012,10,N,N,-,-1,-1
GLOVER.txt,316577,317627,1050,10,N,N,-,-1,-1
GLOVER.txt,316704,317657,953,10,N,N,-,-1,-1
GLOVER.txt,316827,317881,1054,10,N,N,-,-1,-1
GLOVER.txt,317027,318083,1056,10,N,N,-,-1,-1
GLOVER.txt,317207,318236,1029,10,N,N,-,-1,-1
GLOVER.txt,317248,318324,1076,10,N,N,-,-1,-1
GLOVER.txt,317287,318513,1226,10,N,N,-,-1,-1
GLOVER.txt,317346,318749,1403,10,N,N,-,-1,-1
GLOVER.txt,317398,318986,1588,10,N,N,-,-1,-1
GLOVER.txt,317504,319060,1556,10,N,N,-,-1,-1
GLOVER.txt,317629,319089,1460,10,N,N,-,-1,-1
GLOVER.txt,317660,319090,1430,10,N,N,-,-1,-1
GLOVER.txt,317882,319108,1226,10,N,N,-,-1,-1
GLOVER.txt,318084,319113,1029,10,N,N,-,-1,-1
GLOVER.txt,318237,319146,909,10,N,N,-,-1,-1
GLOVER.txt,318327,319153,826,10,N,N,-,-1,-1
GLOVER.txt,318514,319167,653,10,N,N,-,-1,-1
GLOVER.txt,318750,319248,498,10,N,N,-,-1,-1
GLOVER.txt,318987,319329,342,10,N,N,-,-1,-1
GLOVER.txt,319061,319554,493,10,N,N,-,-1,-1
GLOVER.txt,319089,319669,580,10,N,N,-,-1,-1
GLOVER.txt,319091,319777,686,10,N,N,-,-1,-1
GLOVER.txt,319109,319923,814,10,N,N,-,-1,-1
GLOVER.txt,319114,320008,894,10,N,N,-,-1,-1
GLOVER.txt,319147,320369,1222,10,N,N,-,-1,-1
GLOVER.txt,319154,320472,1318,10,N,N,-,-1,-1
GLOVER.txt,319168,320662,1494,10,N,N,-,-1,-1
GLOVER.txt,319249,320740,1491,10,N,N,-,-1,-1
GLOVER.txt,319330,320999,1669,10,N,N,-,-1,-1
GLOVER.txt,319559,321053,1494,10,N,N,-,-1,-1
GLOVER.txt,319672,321122,1450,10,N,N,-,-1,-1
GLOVER.txt,319778,321340,1562,10,N,N,-,-1,-1
GLOVER.txt,319924,321378,1454,10,N,N,-,-1,-1
GLOVER.txt,320011,321438,1427,10,N,N,-,-1,-1
GLOVER.txt,320370,321616,1246,10,N,N,-,-1,-1
GLOVER.txt,320473,321686,1213,10,N,N,-,-1,-1
GLOVER.txt,320663,321793,1130,10,N,N,-,-1,-1
GLOVER.txt,320741,321860,1119,10,N,N,-,-1,-1
GLOVER.txt,321000,322198,1198,10,Y,N,-,-1,-1
GLOVER.txt,321055,322342,1287,10,Y,N,-,-1,-1
GLOVER.txt,321123,322536,1413,10,Y,N,-,-1,-1
GLOVER.txt,321341,322685,1344,10,Y,N,-,-1,-1
GLOVER.txt,321379,322735,1356,10,Y,N,-,-1,-1
GLOVER.txt,321439,322758,1319,10,Y,N,-,-1,-1
GLOVER.txt,321617,322803,1186,10,Y,N,-,-1,-1
GLOVER.txt,321691,323614,1923,10,Y,N,-,-1,-1
GLOVER.txt,321794,323706,1912,10,N,N,-,-1,-1
GLOVER.txt,321861,323976,2115,10,N,N,-,-1,-1
GLOVER.txt,322199,324014,1815,10,N,N,-,-1,-1
GLOVER.txt,322345,324319,1974,10,N,N,-,-1,-1
GLOVER.txt,322539,324575,2036,10,N,N,-,-1,-1
GLOVER.txt,322687,324787,2100,10,N,N,-,-1,-1
GLOVER.txt,322737,324966,2229,10,N,N,-,-1,-1
GLOVER.txt,322759,325299,2540,10,N,N,-,-1,-1
GLOVER.txt,322808,325425,2617,10,N,N,-,-1,-1
GLOVER.txt,323617,325699,2082,10,N,N,-,-1,-1
GLOVER.txt,323708,325971,2263,10,N,N,-,-1,-1
GLOVER.txt,323977,326015,2038,10,N,N,-,-1,-1
GLOVER.txt,324017,326037,2020,10,N,N,-,-1,-1
GLOVER.txt,324320,326329,2009,10,N,N,-,-1,-1
GLOVER.txt,324576,326443,1867,10,Y,N,-,-1,-1
GLOVER.txt,324790,326540,1750,10,N,N,-,-1,-1
GLOVER.txt,324967,326681,1714,10,N,N,-,-1,-1
GLOVER.txt,325300,326730,1430,10,N,N,-,-1,-1
GLOVER.txt,325426,326888,1462,10,N,N,-,-1,-1
GLOVER.txt,325702,326997,1295,10,N,N,-,-1,-1
GLOVER.txt,325972,327085,1113,10,N,N,-,-1,-1
GLOVER.txt,326018,327190,1172,10,N,N,-,-1,-1
GLOVER.txt,326038,327514,1476,10,N,N,-,-1,-1
GLOVER.txt,326334,327760,1426,10,Y,N,-,-1,-1
GLOVER.txt,326446,327877,1431,10,Y,N,-,-1,-1
GLOVER.txt,326542,327885,1343,10,Y,N,-,-1,-1
GLOVER.txt,326682,327963,1281,10,Y,N,-,-1,-1
GLOVER.txt,326731,328058,1327,10,N,N,-,-1,-1
GLOVER.txt,326890,328217,1327,10,Y,N,-,-1,-1
GLOVER.txt,326999,328363,1364,10,Y,N,-,-1,-1
GLOVER.txt,327086,328452,1366,10,Y,N,-,-1,-1
GLOVER.txt,327193,328722,1529,10,Y,N,-,-1,-1
GLOVER.txt,327515,329345,1830,10,Y,N,-,-1,-1
GLOVER.txt,327761,329454,1693,10,N,N,-,-1,-1
GLOVER.txt,327878,329594,1716,10,N,N,-,-1,-1
GLOVER.txt,327886,330139,2253,10,N,N,-,-1,-1
GLOVER.txt,327964,330267,2303,10,N,N,-,-1,-1
GLOVER.txt,328059,330302,2243,10,N,N,-,-1,-1
GLOVER.txt,328218,330492,2274,10,Y,N,-,-1,-1
GLOVER.txt,328364,330541,2177,10,Y,N,-,-1,-1
GLOVER.txt,328455,330861,2406,10,N,N,-,-1,-1
GLOVER.txt,328723,330986,2263,10,N,N,-,-1,-1
GLOVER.txt,329346,331220,1874,10,N,N,-,-1,-1
GLOVER.txt,329457,331381,1924,10,N,N,-,-1,-1
GLOVER.txt,329595,331442,1847,10,N,N,-,-1,-1
GLOVER.txt,330142,331638,1496,10,N,N,-,-1,-1
GLOVER.txt,330268,331723,1455,10,N,N,-,-1,-1
GLOVER.txt,330303,332096,1793,10,N,N,-,-1,-1
GLOVER.txt,330494,332260,1766,10,N,N,-,-1,-1
GLOVER.txt,330543,332374,1831,10,N,N,-,-1,-1
GLOVER.txt,330864,332416,1552,10,N,N,-,-1,-1
GLOVER.txt,330987,333140,2153,10,N,N,-,-1,-1
GLOVER.txt,331222,333250,2028,10,N,N,-,-1,-1
GLOVER.txt,331382,333486,2104,10,N,N,-,-1,-1
GLOVER.txt,331443,333619,2176,10,Y,N,-,-1,-1
GLOVER.txt,331639,333714,2075,10,Y,N,-,-1,-1
GLOVER.txt,331725,333925,2200,10,Y,N,-,-1,-1
GLOVER.txt,332097,334236,2139,10,N,N,-,-1,-1
GLOVER.txt,332263,334268,2005,10,N,N,-,-1,-1
GLOVER.txt,332375,334860,2485,10,Y,N,-,-1,-1
GLOVER.txt,332417,335236,2819,10,N,N,-,-1,-1
GLOVER.txt,333141,335586,2445,10,N,N,-,-1,-1
GLOVER.txt,333253,335682,2429,10,N,N,-,-1,-1
GLOVER.txt,333487,335805,2318,10,N,N,-,-1,-1
GLOVER.txt,333622,335953,2331,10,N,N,-,-1,-1
GLOVER.txt,333715,336044,2329,10,N,N,-,-1,-1
GLOVER.txt,333927,336530,2603,10,N,N,-,-1,-1
GLOVER.txt,334239,337038,2799,10,N,N,-,-1,-1
GLOVER.txt,334269,337105,2836,10,N,N,-,-1,-1
GLOVER.txt,334861,337238,2377,10,N,N,-,-1,-1
GLOVER.txt,335237,337263,2026,10,N,N,-,-1,-1
GLOVER.txt,335589,337582,1993,10,N,N,-,-1,-1
GLOVER.txt,335684,337636,1952,10,N,N,-,-1,-1
GLOVER.txt,335806,337706,1900,10,N,N,-,-1,-1
GLOVER.txt,335954,337733,1779,10,N,N,-,-1,-1
GLOVER.txt,336046,337915,1869,10,N,N,-,-1,-1
GLOVER.txt,336531,337967,1436,10,N,N,-,-1,-1
GLOVER.txt,337041,338044,1003,10,N,N,-,-1,-1
GLOVER.txt,337108,338140,1032,10,N,N,-,-1,-1
GLOVER.txt,337239,338162,923,10,N,N,-,-1,-1
GLOVER.txt,337264,338340,1076,10,N,N,-,-1,-1
GLOVER.txt,337583,338609,1026,10,N,N,-,-1,-1
GLOVER.txt,337637,338639,1002,10,N,N,-,-1,-1
GLOVER.txt,337707,338766,1059,10,N,N,-,-1,-1
GLOVER.txt,337734,339047,1313,10,N,N,-,-1,-1
GLOVER.txt,337916,339197,1281,10,N,N,-,-1,-1
GLOVER.txt,337970,339300,1330,10,N,N,-,-1,-1
GLOVER.txt,338045,339505,1460,10,N,N,-,-1,-1
GLOVER.txt,338141,339592,1451,10,N,N,-,-1,-1
GLOVER.txt,338164,339723,1559,10,N,N,-,-1,-1
GLOVER.txt,338341,339728,1387,10,N,N,-,-1,-1
GLOVER.txt,338611,339748,1137,10,N,N,-,-1,-1
GLOVER.txt,338640,339770,1130,10,N,N,-,-1,-1
GLOVER.txt,338767,339778,1011,10,N,N,-,-1,-1
GLOVER.txt,339049,339819,770,10,N,N,-,-1,-1
GLOVER.txt,339200,339830,630,10,N,N,-,-1,-1
GLOVER.txt,339301,339846,545,10,N,N,-,-1,-1
GLOVER.txt,339506,339883,377,10,N,N,-,-1,-1
GLOVER.txt,339593,339901,308,10,N,N,-,-1,-1
GLOVER.txt,339726,340104,378,10,N,N,-,-1,-1
GLOVER.txt,339729,340193,464,10,N,N,-,-1,-1
GLOVER.txt,339753,340409,656,10,N,N,-,-1,-1
GLOVER.txt,339776,340502,726,10,N,N,-,-1,-1
GLOVER.txt,339779,340676,897,10,N,N,-,-1,-1
GLOVER.txt,339821,340738,917,10,N,N,-,-1,-1
GLOVER.txt,339844,340935,1091,10,N,N,-,-1,-1
GLOVER.txt,339847,341315,1468,10,N,N,-,-1,-1
GLOVER.txt,339885,341564,1679,10,N,N,-,-1,-1
GLOVER.txt,339907,341811,1904,10,N,N,-,-1,-1
GLOVER.txt,340105,341922,1817,10,N,N,-,-1,-1
GLOVER.txt,340194,342068,1874,10,N,N,-,-1,-1
GLOVER.txt,340411,342162,1751,10,N,N,-,-1,-1
GLOVER.txt,340503,342233,1730,10,N,N,-,-1,-1
GLOVER.txt,340679,342259,1580,10,N,N,-,-1,-1
GLOVER.txt,340739,342320,1581,10,N,N,-,-1,-1
GLOVER.txt,340936,342428,1492,10,N,N,-,-1,-1
GLOVER.txt,341318,342487,1169,10,N,N,-,-1,-1
GLOVER.txt,341565,342518,953,10,N,N,-,-1,-1
GLOVER.txt,341812,342685,873,10,N,N,-,-1,-1
GLOVER.txt,341925,343097,1172,10,N,N,-,-1,-1
GLOVER.txt,342069,343291,1222,10,N,N,-,-1,-1
GLOVER.txt,342163,343430,1267,10,N,N,-,-1,-1
GLOVER.txt,342234,343486,1252,10,N,N,-,-1,-1
GLOVER.txt,342262,343745,1483,10,N,N,-,-1,-1
GLOVER.txt,342321,343818,1497,10,N,N,-,-1,-1
GLOVER.txt,342429,343842,1413,10,N,N,-,-1,-1
GLOVER.txt,342490,343872,1382,10,N,N,-,-1,-1
GLOVER.txt,342519,344011,1492,10,N,N,-,-1,-1
GLOVER.txt,342687,344095,1408,10,N,N,-,-1,-1
GLOVER.txt,343098,344407,1309,10,N,N,-,-1,-1
GLOVER.txt,343292,344493,1201,10,N,N,-,-1,-1
GLOVER.txt,343432,344518,1086,10,N,N,-,-1,-1
GLOVER.txt,343487,344550,1063,10,N,N,-,-1,-1
GLOVER.txt,343746,344680,934,10,N,N,-,-1,-1
GLOVER.txt,343819,344785,966,10,N,N,-,-1,-1
GLOVER.txt,343843,344886,1043,10,N,N,-,-1,-1
GLOVER.txt,343877,345110,1233,10,N,N,-,-1,-1
GLOVER.txt,344012,345268,1256,10,N,N,-,-1,-1
GLOVER.txt,344096,345373,1277,10,N,N,-,-1,-1
GLOVER.txt,344408,345445,1037,10,N,N,-,-1,-1
GLOVER.txt,344495,345566,1071,10,N,N,-,-1,-1
GLOVER.txt,344519,345672,1153,10,N,N,-,-1,-1
GLOVER.txt,344551,345949,1398,10,N,N,-,-1,-1
GLOVER.txt,344683,346309,1626,10,Y,N,-,-1,-1
GLOVER.txt,344786,346476,1690,10,N,N,-,-1,-1
GLOVER.txt,344887,346504,1617,10,N,N,-,-1,-1
GLOVER.txt,345113,346534,1421,10,N,N,-,-1,-1
GLOVER.txt,345269,346614,1345,10,N,N,-,-1,-1
GLOVER.txt,345374,346693,1319,10,N,N,-,-1,-1
GLOVER.txt,345446,346848,1402,10,N,N,-,-1,-1
GLOVER.txt,345569,347038,1469,10,N,N,-,-1,-1
GLOVER.txt,345673,347163,1490,10,N,N,-,-1,-1
GLOVER.txt,345950,347274,1324,10,N,N,-,-1,-1
GLOVER.txt,346310,347389,1079,10,N,N,-,-1,-1
GLOVER.txt,346477,347421,944,10,N,N,-,-1,-1
GLOVER.txt,346505,347478,973,10,N,N,-,-1,-1
GLOVER.txt,346537,347553,1016,10,N,N,-,-1,-1
GLOVER.txt,346615,347836,1221,10,N,N,-,-1,-1
GLOVER.txt,346694,347967,1273,10,N,N,-,-1,-1
GLOVER.txt,346849,348186,1337,10,N,N,-,-1,-1
GLOVER.txt,347039,348315,1276,10,N,N,-,-1,-1
GLOVER.txt,347166,348528,1362,10,N,N,-,-1,-1
GLOVER.txt,347275,348693,1418,10,N,N,-,-1,-1
GLOVER.txt,347392,348780,1388,10,N,N,-,-1,-1
GLOVER.txt,347422,349006,1584,10,N,N,-,-1,-1
GLOVER.txt,347479,349274,1795,10,N,N,-,-1,-1
GLOVER.txt,347554,349442,1888,10,N,N,-,-1,-1
GLOVER.txt,347837,349515,1678,10,N,N,-,-1,-1
GLOVER.txt,347968,349587,1619,10,N,N,-,-1,-1
GLOVER.txt,348187,349750,1563,10,N,N,-,-1,-1
GLOVER.txt,348316,349866,1550,10,N,N,-,-1,-1
GLOVER.txt,348531,349919,1388,10,N,N,-,-1,-1
GLOVER.txt,348694,350006,1312,10,N,N,-,-1,-1
GLOVER.txt,348782,350156,1374,10,N,N,-,-1,-1
GLOVER.txt,349007,350336,1329,10,N,N,-,-1,-1
GLOVER.txt,349277,350431,1154,10,N,N,-,-1,-1
GLOVER.txt,349443,350520,1077,10,N,N,-,-1,-1
GLOVER.txt,349516,350565,1049,10,N,N,-,-1,-1
GLOVER.txt,349588,350643,1055,10,N,N,-,-1,-1
GLOVER.txt,349751,350759,1008,10,N,Y,1437471397525,350644,351290
GLOVER.txt,349867,350818,951,10,N,Y,1437471397525,350644,351290
GLOVER.txt,349921,350977,1056,10,N,Y,1437471397525,350644,351290
GLOVER.txt,350009,350994,985,10,N,Y,1437471397525,350644,351290
GLOVER.txt,350158,351019,861,10,N,Y,1437471397525,350644,351290
GLOVER.txt,350337,351131,794,10,N,Y,1437471397525,350644,351290
GLOVER.txt,350432,351224,792,10,N,Y,1437471397525,350644,351290
GLOVER.txt,350521,351312,791,10,N,Y,1437471397525,350644,351290
GLOVER.txt,350566,351769,1203,10,N,Y,1437471397525,350644,351290
GLOVER.txt,350646,351898,1252,10,N,Y,1437471397525,350644,351290
GLOVER.txt,350760,351996,1236,10,N,Y,1437471397525,350644,351290
GLOVER.txt,350819,352044,1225,10,N,Y,1437471397525,350644,351290
GLOVER.txt,350978,352198,1220,10,N,Y,1437471397525,350644,351290
GLOVER.txt,350995,352240,1245,10,N,Y,1437471397525,350644,351290
GLOVER.txt,351020,352418,1398,10,N,Y,1437471397525,350644,351290
GLOVER.txt,351132,352539,1407,10,N,Y,1437471397525,350644,351290
GLOVER.txt,351227,352695,1468,10,N,Y,1437471397525,350644,351290
GLOVER.txt,351315,353011,1696,10,N,Y,1437471855423,351318,351853
GLOVER.txt,351770,353067,1297,10,N,Y,1437471855423,351318,351853
GLOVER.txt,351901,353184,1283,10,N,Y,1437472380836,351899,352666
GLOVER.txt,351998,353247,1249,10,N,Y,1437472380836,351899,352666
GLOVER.txt,352046,353372,1326,10,N,Y,1437472380836,351899,352666
GLOVER.txt,352198,353588,1390,10,N,Y,1437472380836,351899,352666
GLOVER.txt,352241,353700,1459,10,N,Y,1437472380836,351899,352666
GLOVER.txt,352421,353778,1357,10,N,Y,1437472380836,351899,352666
GLOVER.txt,352540,353863,1323,10,N,Y,1437472380836,351899,352666
GLOVER.txt,352698,353931,1233,10,N,N,-,-1,-1
GLOVER.txt,353014,354122,1108,10,N,N,-,-1,-1
GLOVER.txt,353069,354423,1354,10,N,N,-,-1,-1
GLOVER.txt,353187,354458,1271,10,N,N,-,-1,-1
GLOVER.txt,353248,354519,1271,10,Y,N,-,-1,-1
GLOVER.txt,353373,354604,1231,10,Y,N,-,-1,-1
GLOVER.txt,353589,354783,1194,10,Y,N,-,-1,-1
GLOVER.txt,353701,354984,1283,10,Y,N,-,-1,-1
GLOVER.txt,353779,355081,1302,10,Y,N,-,-1,-1
GLOVER.txt,353864,355105,1241,10,N,N,-,-1,-1
GLOVER.txt,353932,355489,1557,10,Y,N,-,-1,-1
GLOVER.txt,354123,355642,1519,10,Y,N,-,-1,-1
GLOVER.txt,354425,355939,1514,10,Y,N,-,-1,-1
GLOVER.txt,354459,356069,1610,10,Y,N,-,-1,-1
GLOVER.txt,354520,356239,1719,10,Y,N,-,-1,-1
GLOVER.txt,354605,356305,1700,10,Y,N,-,-1,-1
GLOVER.txt,354784,356548,1764,10,N,N,-,-1,-1
GLOVER.txt,354987,356707,1720,10,N,N,-,-1,-1
GLOVER.txt,355082,357032,1950,10,N,N,-,-1,-1
GLOVER.txt,355106,357060,1954,10,N,N,-,-1,-1
GLOVER.txt,355492,357071,1579,10,N,N,-,-1,-1
GLOVER.txt,355643,357099,1456,10,N,N,-,-1,-1
GLOVER.txt,355940,357278,1338,10,N,N,-,-1,-1
GLOVER.txt,356070,357418,1348,10,N,N,-,-1,-1
GLOVER.txt,356240,357536,1296,10,N,N,-,-1,-1
GLOVER.txt,356306,357656,1350,10,N,N,-,-1,-1
GLOVER.txt,356549,357843,1294,10,N,N,-,-1,-1
GLOVER.txt,356708,357994,1286,10,N,N,-,-1,-1
GLOVER.txt,357034,358312,1278,10,N,N,-,-1,-1
GLOVER.txt,357061,358438,1377,10,N,N,-,-1,-1
GLOVER.txt,357072,358506,1434,10,N,N,-,-1,-1
GLOVER.txt,357102,358714,1612,10,N,N,-,-1,-1
GLOVER.txt,357279,358878,1599,10,N,N,-,-1,-1
GLOVER.txt,357419,358899,1480,10,N,N,-,-1,-1
GLOVER.txt,357537,358933,1396,10,N,N,-,-1,-1
GLOVER.txt,357657,358947,1290,10,N,N,-,-1,-1
GLOVER.txt,357844,358994,1150,10,N,N,-,-1,-1
GLOVER.txt,357995,359057,1062,10,N,N,-,-1,-1
GLOVER.txt,358313,359216,903,10,N,N,-,-1,-1
GLOVER.txt,358439,359306,867,10,N,N,-,-1,-1
GLOVER.txt,358507,359716,1209,10,N,N,-,-1,-1
GLOVER.txt,358715,359812,1097,10,N,N,-,-1,-1
GLOVER.txt,358881,359918,1037,10,N,N,-,-1,-1
GLOVER.txt,358900,360050,1150,10,N,N,-,-1,-1
GLOVER.txt,358934,360176,1242,10,N,N,-,-1,-1
GLOVER.txt,358948,360436,1488,10,N,N,-,-1,-1
GLOVER.txt,358995,360705,1710,10,N,N,-,-1,-1
GLOVER.txt,359060,360784,1724,10,N,N,-,-1,-1
GLOVER.txt,359217,361347,2130,10,N,N,-,-1,-1
GLOVER.txt,359311,361439,2128,10,N,N,-,-1,-1
GLOVER.txt,359719,361661,1942,10,Y,N,-,-1,-1
GLOVER.txt,359813,361918,2105,10,Y,N,-,-1,-1
GLOVER.txt,359919,361983,2064,10,Y,N,-,-1,-1
GLOVER.txt,360051,362121,2070,10,Y,N,-,-1,-1
GLOVER.txt,360177,362351,2174,10,Y,N,-,-1,-1
GLOVER.txt,360437,362484,2047,10,Y,N,-,-1,-1
GLOVER.txt,360707,362615,1908,10,Y,N,-,-1,-1
GLOVER.txt,360785,362820,2035,10,Y,N,-,-1,-1
GLOVER.txt,361348,362861,1513,10,Y,N,-,-1,-1
GLOVER.txt,361440,363020,1580,10,Y,N,-,-1,-1
GLOVER.txt,361662,363051,1389,10,Y,N,-,-1,-1
GLOVER.txt,361919,363096,1177,10,Y,N,-,-1,-1
GLOVER.txt,361985,363232,1247,10,Y,N,-,-1,-1
GLOVER.txt,362122,363438,1316,10,Y,N,-,-1,-1
GLOVER.txt,362352,363506,1154,10,N,N,-,-1,-1
GLOVER.txt,362485,363527,1042,10,N,N,-,-1,-1
GLOVER.txt,362616,363630,1014,10,N,N,-,-1,-1
GLOVER.txt,362825,363689,864,10,N,N,-,-1,-1
GLOVER.txt,362862,363849,987,10,N,N,-,-1,-1
GLOVER.txt,363021,363930,909,10,N,N,-,-1,-1
GLOVER.txt,363053,363978,925,10,N,N,-,-1,-1
GLOVER.txt,363097,364071,974,10,N,N,-,-1,-1
GLOVER.txt,363233,364108,875,10,N,N,-,-1,-1
GLOVER.txt,363439,364277,838,10,N,N,-,-1,-1
GLOVER.txt,363507,364369,862,10,N,N,-,-1,-1
GLOVER.txt,363528,364421,893,10,N,N,-,-1,-1
GLOVER.txt,363631,364476,845,10,N,N,-,-1,-1
GLOVER.txt,363690,364506,816,10,N,N,-,-1,-1
GLOVER.txt,363851,364577,726,10,N,N,-,-1,-1
GLOVER.txt,363931,364728,797,10,N,N,-,-1,-1
GLOVER.txt,363979,364764,785,10,N,N,-,-1,-1
GLOVER.txt,364072,364985,913,10,N,N,-,-1,-1
GLOVER.txt,364109,365328,1219,10,N,N,-,-1,-1
GLOVER.txt,364278,365450,1172,10,N,N,-,-1,-1
GLOVER.txt,364370,365674,1304,10,N,N,-,-1,-1
GLOVER.txt,364422,365820,1398,10,N,N,-,-1,-1
GLOVER.txt,364478,365908,1430,10,N,N,-,-1,-1
GLOVER.txt,364507,366103,1596,10,N,N,-,-1,-1
GLOVER.txt,364579,366202,1623,10,N,N,-,-1,-1
GLOVER.txt,364731,366389,1658,10,N,N,-,-1,-1
GLOVER.txt,364765,366437,1672,10,N,N,-,-1,-1
GLOVER.txt,364986,367338,2352,10,N,N,-,-1,-1
GLOVER.txt,365329,367635,2306,10,N,N,-,-1,-1
GLOVER.txt,365451,367959,2508,10,N,N,-,-1,-1
GLOVER.txt,365675,368281,2606,10,N,N,-,-1,-1
GLOVER.txt,365821,368522,2701,10,N,N,-,-1,-1
GLOVER.txt,365909,368901,2992,10,N,N,-,-1,-1
GLOVER.txt,366104,369058,2954,10,N,N,-,-1,-1
GLOVER.txt,366203,369134,2931,10,N,N,-,-1,-1
GLOVER.txt,366392,369205,2813,10,N,N,-,-1,-1
GLOVER.txt,366440,369416,2976,10,Y,N,-,-1,-1
GLOVER.txt,367339,369526,2187,10,Y,N,-,-1,-1
GLOVER.txt,367638,369764,2126,10,N,N,-,-1,-1
GLOVER.txt,367960,369888,1928,10,N,N,-,-1,-1
GLOVER.txt,368282,370108,1826,10,N,N,-,-1,-1
GLOVER.txt,368523,370340,1817,10,N,N,-,-1,-1
GLOVER.txt,368902,370366,1464,10,N,N,-,-1,-1
GLOVER.txt,369059,370387,1328,10,N,N,-,-1,-1
GLOVER.txt,369137,370642,1505,10,N,N,-,-1,-1
GLOVER.txt,369206,370785,1579,10,N,N,-,-1,-1
GLOVER.txt,369417,371006,1589,10,N,N,-,-1,-1
GLOVER.txt,369527,371052,1525,10,N,N,-,-1,-1
GLOVER.txt,369765,371150,1385,10,N,N,-,-1,-1
GLOVER.txt,369891,371309,1418,10,N,N,-,-1,-1
GLOVER.txt,370109,371504,1395,10,N,N,-,-1,-1
GLOVER.txt,370341,371573,1232,10,N,N,-,-1,-1
GLOVER.txt,370367,371718,1351,10,N,N,-,-1,-1
GLOVER.txt,370390,371943,1553,10,N,N,-,-1,-1
GLOVER.txt,370643,372069,1426,10,N,N,-,-1,-1
GLOVER.txt,370788,372265,1477,10,N,N,-,-1,-1
GLOVER.txt,371007,372427,1420,10,N,N,-,-1,-1
GLOVER.txt,371053,372514,1461,10,N,N,-,-1,-1
GLOVER.txt,371153,372746,1593,10,N,N,-,-1,-1
GLOVER.txt,371312,372755,1443,10,N,N,-,-1,-1
GLOVER.txt,371506,372814,1308,10,N,N,-,-1,-1
GLOVER.txt,371574,372846,1272,10,N,N,-,-1,-1
GLOVER.txt,371719,372901,1182,10,N,N,-,-1,-1
GLOVER.txt,371946,372929,983,10,N,N,-,-1,-1
GLOVER.txt,372072,372983,911,10,N,N,-,-1,-1
GLOVER.txt,372268,373017,749,10,N,N,-,-1,-1
GLOVER.txt,372429,373071,642,10,N,N,-,-1,-1
GLOVER.txt,372515,373164,649,10,N,N,-,-1,-1
GLOVER.txt,372749,373288,539,10,N,N,-,-1,-1
GLOVER.txt,372758,373444,686,10,N,N,-,-1,-1
GLOVER.txt,372815,373553,738,10,N,N,-,-1,-1
GLOVER.txt,372849,373704,855,10,N,N,-,-1,-1
GLOVER.txt,372902,373949,1047,10,N,N,-,-1,-1
GLOVER.txt,372932,373969,1037,10,N,N,-,-1,-1
GLOVER.txt,372984,374119,1135,10,N,N,-,-1,-1
GLOVER.txt,373020,374375,1355,10,N,N,-,-1,-1
GLOVER.txt,373074,374620,1546,10,N,N,-,-1,-1
GLOVER.txt,373165,374713,1548,10,N,N,-,-1,-1
GLOVER.txt,373289,374867,1578,10,N,N,-,-1,-1
GLOVER.txt,373445,374910,1465,10,N,N,-,-1,-1
GLOVER.txt,373554,374976,1422,10,N,N,-,-1,-1
GLOVER.txt,373705,375102,1397,10,N,N,-,-1,-1
GLOVER.txt,373950,375496,1546,10,N,N,-,-1,-1
GLOVER.txt,373970,375606,1636,10,N,N,-,-1,-1
GLOVER.txt,374120,375754,1634,10,N,N,-,-1,-1
GLOVER.txt,374376,375869,1493,10,N,N,-,-1,-1
GLOVER.txt,374623,376198,1575,10,N,N,-,-1,-1
GLOVER.txt,374714,376504,1790,10,N,N,-,-1,-1
GLOVER.txt,374868,376713,1845,10,N,N,-,-1,-1
GLOVER.txt,374911,376952,2041,10,N,N,-,-1,-1
GLOVER.txt,374977,376980,2003,10,N,N,-,-1,-1
GLOVER.txt,375103,377130,2027,10,Y,N,-,-1,-1
GLOVER.txt,375497,377316,1819,10,N,N,-,-1,-1
GLOVER.txt,375609,377541,1932,10,N,N,-,-1,-1
GLOVER.txt,375757,377583,1826,10,N,N,-,-1,-1
GLOVER.txt,375870,377652,1782,10,N,N,-,-1,-1
GLOVER.txt,376199,377716,1517,10,N,N,-,-1,-1
GLOVER.txt,376505,377790,1285,10,N,N,-,-1,-1
GLOVER.txt,376715,377882,1167,10,N,N,-,-1,-1
GLOVER.txt,376953,378100,1147,10,N,N,-,-1,-1
GLOVER.txt,376981,378220,1239,10,N,N,-,-1,-1
GLOVER.txt,377131,378355,1224,10,N,N,-,-1,-1
GLOVER.txt,377319,378446,1127,10,N,N,-,-1,-1
GLOVER.txt,377542,378456,914,10,N,N,-,-1,-1
GLOVER.txt,377584,378525,941,10,N,N,-,-1,-1
GLOVER.txt,377653,378589,936,10,N,N,-,-1,-1
GLOVER.txt,377717,378972,1255,10,N,N,-,-1,-1
GLOVER.txt,377791,379315,1524,10,N,N,-,-1,-1
GLOVER.txt,377883,379390,1507,10,N,N,-,-1,-1
GLOVER.txt,378101,379485,1384,10,N,N,-,-1,-1
GLOVER.txt,378221,379570,1349,10,N,N,-,-1,-1
GLOVER.txt,378357,379656,1299,10,N,N,-,-1,-1
GLOVER.txt,378447,379731,1284,10,N,N,-,-1,-1
GLOVER.txt,378458,380049,1591,10,N,N,-,-1,-1
GLOVER.txt,378526,380268,1742,10,N,N,-,-1,-1
GLOVER.txt,378590,380324,1734,10,N,N,-,-1,-1
GLOVER.txt,378974,380472,1498,10,N,N,-,-1,-1
GLOVER.txt,379316,380687,1371,10,N,N,-,-1,-1
GLOVER.txt,379391,380915,1524,10,N,N,-,-1,-1
GLOVER.txt,379487,380967,1480,10,N,N,-,-1,-1
GLOVER.txt,379571,381072,1501,10,N,N,-,-1,-1
GLOVER.txt,379657,381167,1510,10,N,N,-,-1,-1
GLOVER.txt,379734,381372,1638,10,N,N,-,-1,-1
GLOVER.txt,380050,381421,1371,10,N,N,-,-1,-1
GLOVER.txt,380269,381546,1277,10,N,N,-,-1,-1
GLOVER.txt,380325,381754,1429,10,N,N,-,-1,-1
GLOVER.txt,380473,381906,1433,10,N,N,-,-1,-1
GLOVER.txt,380688,381955,1267,10,N,N,-,-1,-1
GLOVER.txt,380916,382393,1477,10,Y,N,-,-1,-1
GLOVER.txt,380968,382436,1468,10,Y,N,-,-1,-1
GLOVER.txt,381073,382560,1487,10,Y,N,-,-1,-1
GLOVER.txt,381170,382835,1665,10,Y,N,-,-1,-1
GLOVER.txt,381373,382918,1545,10,Y,N,-,-1,-1
GLOVER.txt,381422,383021,1599,10,Y,N,-,-1,-1
GLOVER.txt,381547,383245,1698,10,Y,N,-,-1,-1
GLOVER.txt,381755,383428,1673,10,N,N,-,-1,-1
GLOVER.txt,381907,383465,1558,10,N,N,-,-1,-1
GLOVER.txt,381956,383481,1525,10,N,N,-,-1,-1
GLOVER.txt,382394,383555,1161,10,N,N,-,-1,-1
GLOVER.txt,382437,383819,1382,10,N,N,-,-1,-1
GLOVER.txt,382561,384000,1439,10,N,N,-,-1,-1
GLOVER.txt,382836,384086,1250,10,N,N,-,-1,-1
GLOVER.txt,382919,384178,1259,10,N,N,-,-1,-1
GLOVER.txt,383022,384323,1301,10,N,N,-,-1,-1
GLOVER.txt,383246,384549,1303,10,N,N,-,-1,-1
GLOVER.txt,383429,384714,1285,10,N,N,-,-1,-1
GLOVER.txt,383466,384744,1278,10,N,N,-,-1,-1
GLOVER.txt,383484,384870,1386,10,N,N,-,-1,-1
GLOVER.txt,383556,384987,1431,10,N,N,-,-1,-1
GLOVER.txt,383820,385220,1400,10,N,N,-,-1,-1
GLOVER.txt,384003,385288,1285,10,N,N,-,-1,-1
GLOVER.txt,384087,385545,1458,10,N,N,-,-1,-1
GLOVER.txt,384181,385733,1552,10,N,N,-,-1,-1
GLOVER.txt,384325,386001,1676,10,N,N,-,-1,-1
GLOVER.txt,384550,386022,1472,10,N,N,-,-1,-1
GLOVER.txt,384715,386336,1621,10,N,N,-,-1,-1
GLOVER.txt,384747,386400,1653,10,N,N,-,-1,-1
GLOVER.txt,384873,386416,1543,10,N,N,-,-1,-1
GLOVER.txt,384988,386489,1501,10,N,N,-,-1,-1
GLOVER.txt,385221,386724,1503,10,N,N,-,-1,-1
GLOVER.txt,385289,386891,1602,10,N,N,-,-1,-1
GLOVER.txt,385546,387006,1460,10,N,N,-,-1,-1
GLOVER.txt,385734,387215,1481,10,N,N,-,-1,-1
GLOVER.txt,386002,387291,1289,10,N,N,-,-1,-1
GLOVER.txt,386023,387314,1291,10,N,N,-,-1,-1
GLOVER.txt,386337,387330,993,10,N,N,-,-1,-1
GLOVER.txt,386401,387405,1004,10,N,N,-,-1,-1
GLOVER.txt,386419,387422,1003,10,N,N,-,-1,-1
GLOVER.txt,386490,387548,1058,10,N,N,-,-1,-1
GLOVER.txt,386725,387640,915,10,N,N,-,-1,-1
GLOVER.txt,386892,387833,941,10,N,N,-,-1,-1
GLOVER.txt,387009,388010,1001,10,N,N,-,-1,-1
GLOVER.txt,387216,388228,1012,10,N,N,-,-1,-1
GLOVER.txt,387292,388543,1251,10,N,N,-,-1,-1
GLOVER.txt,387315,388553,1238,10,N,N,-,-1,-1
GLOVER.txt,387333,388697,1364,10,N,N,-,-1,-1
GLOVER.txt,387406,388777,1371,10,N,N,-,-1,-1
GLOVER.txt,387423,388977,1554,10,N,N,-,-1,-1
GLOVER.txt,387549,389025,1476,10,N,N,-,-1,-1
GLOVER.txt,387641,389081,1440,10,N,N,-,-1,-1
GLOVER.txt,387835,389105,1270,10,N,N,-,-1,-1
GLOVER.txt,388013,389235,1222,10,N,N,-,-1,-1
GLOVER.txt,388229,389403,1174,10,N,N,-,-1,-1
GLOVER.txt,388544,389444,900,10,N,N,-,-1,-1
GLOVER.txt,388554,389490,936,10,N,N,-,-1,-1
GLOVER.txt,388698,389626,928,10,N,N,-,-1,-1
GLOVER.txt,388778,389897,1119,10,N,N,-,-1,-1
GLOVER.txt,388978,390039,1061,10,N,N,-,-1,-1
GLOVER.txt,389026,390136,1110,10,N,N,-,-1,-1
GLOVER.txt,389082,390235,1153,10,N,N,-,-1,-1
GLOVER.txt,389106,390303,1197,10,N,N,-,-1,-1
GLOVER.txt,389236,390413,1177,10,N,N,-,-1,-1
GLOVER.txt,389404,390554,1150,10,N,N,-,-1,-1
GLOVER.txt,389445,390669,1224,10,N,N,-,-1,-1
GLOVER.txt,389491,390677,1186,10,N,N,-,-1,-1
GLOVER.txt,389628,390864,1236,10,N,N,-,-1,-1
GLOVER.txt,389900,391039,1139,10,N,N,-,-1,-1
GLOVER.txt,390040,391189,1149,10,N,N,-,-1,-1
GLOVER.txt,390137,391274,1137,10,N,N,-,-1,-1
GLOVER.txt,390238,391297,1059,10,N,N,-,-1,-1
GLOVER.txt,390304,391500,1196,10,N,N,-,-1,-1
GLOVER.txt,390414,391731,1317,10,N,N,-,-1,-1
GLOVER.txt,390555,391793,1238,10,N,N,-,-1,-1
GLOVER.txt,390670,391997,1327,10,N,N,-,-1,-1
GLOVER.txt,390677,392179,1502,10,N,N,-,-1,-1
GLOVER.txt,390865,392259,1394,10,N,N,-,-1,-1
GLOVER.txt,391040,392487,1447,10,N,N,-,-1,-1
GLOVER.txt,391190,392566,1376,10,N,N,-,-1,-1
GLOVER.txt,391275,392627,1352,10,N,N,-,-1,-1
GLOVER.txt,391300,393061,1761,10,Y,N,-,-1,-1
GLOVER.txt,391501,393223,1722,10,N,N,-,-1,-1
GLOVER.txt,391732,393568,1836,10,N,N,-,-1,-1
GLOVER.txt,391794,393604,1810,10,N,N,-,-1,-1
GLOVER.txt,391998,393662,1664,10,N,N,-,-1,-1
GLOVER.txt,392180,393825,1645,10,N,N,-,-1,-1
GLOVER.txt,392260,393864,1604,10,N,N,-,-1,-1
GLOVER.txt,392489,393881,1392,10,N,N,-,-1,-1
GLOVER.txt,392569,394010,1441,10,N,N,-,-1,-1
GLOVER.txt,392628,394414,1786,10,N,N,-,-1,-1
GLOVER.txt,393062,394608,1546,10,N,N,-,-1,-1
GLOVER.txt,393228,394841,1613,10,N,Y,1437472966198,394609,395892
GLOVER.txt,393571,395010,1439,10,N,Y,1437472966198,394609,395892
GLOVER.txt,393605,395129,1524,10,N,Y,1437472966198,394609,395892
GLOVER.txt,393664,395334,1670,10,N,Y,1437472966198,394609,395892
GLOVER.txt,393827,395602,1775,10,N,Y,1437472966198,394609,395892
GLOVER.txt,393865,395626,1761,10,N,Y,1437472966198,394609,395892
GLOVER.txt,393882,395696,1814,10,N,Y,1437472966198,394609,395892
GLOVER.txt,394011,395738,1727,10,N,Y,1437472966198,394609,395892
GLOVER.txt,394415,395977,1562,10,N,Y,1437472966198,394609,395892
GLOVER.txt,394611,396066,1455,10,N,Y,1437472966198,394609,395892
GLOVER.txt,394843,396152,1309,10,N,Y,1437472966198,394609,395892
GLOVER.txt,395011,396391,1380,10,N,Y,1437472966198,394609,395892
GLOVER.txt,395131,396590,1459,10,N,Y,1437472966198,394609,395892
GLOVER.txt,395337,396787,1450,10,N,Y,1437472966198,394609,395892
GLOVER.txt,395603,396941,1338,10,N,Y,1437472966198,394609,395892
GLOVER.txt,395629,397158,1529,10,N,Y,1437472966198,394609,395892
GLOVER.txt,395697,397272,1575,10,N,Y,1437472966198,394609,395892
GLOVER.txt,395739,397299,1560,10,N,Y,1437472966198,394609,395892
GLOVER.txt,395980,397360,1380,10,N,N,-,-1,-1
GLOVER.txt,396067,397604,1537,10,N,N,-,-1,-1
GLOVER.txt,396153,397836,1683,10,N,N,-,-1,-1
GLOVER.txt,396392,398041,1649,10,N,N,-,-1,-1
GLOVER.txt,396591,398162,1571,10,N,N,-,-1,-1
GLOVER.txt,396788,398268,1480,10,N,N,-,-1,-1
GLOVER.txt,396942,398372,1430,10,N,N,-,-1,-1
GLOVER.txt,397161,398423,1262,10,N,N,-,-1,-1
GLOVER.txt,397273,398563,1290,10,N,N,-,-1,-1
GLOVER.txt,397300,398675,1375,10,N,N,-,-1,-1
GLOVER.txt,397361,398784,1423,10,N,N,-,-1,-1
GLOVER.txt,397606,398805,1199,10,N,N,-,-1,-1
GLOVER.txt,397837,398928,1091,10,N,N,-,-1,-1
GLOVER.txt,398042,398979,937,10,N,N,-,-1,-1
GLOVER.txt,398163,399027,864,10,N,N,-,-1,-1
GLOVER.txt,398270,399079,809,10,N,N,-,-1,-1
GLOVER.txt,398374,399131,757,10,N,N,-,-1,-1
GLOVER.txt,398424,399347,923,10,N,N,-,-1,-1
GLOVER.txt,398564,399570,1006,10,N,N,-,-1,-1
GLOVER.txt,398676,399634,958,10,N,N,-,-1,-1
GLOVER.txt,398785,399664,879,10,N,N,-,-1,-1
GLOVER.txt,398806,399735,929,10,N,N,-,-1,-1
GLOVER.txt,398929,400037,1108,10,N,N,-,-1,-1
GLOVER.txt,398980,400202,1222,10,N,N,-,-1,-1
GLOVER.txt,399028,400464,1436,10,N,N,-,-1,-1
GLOVER.txt,399080,400579,1499,10,N,N,-,-1,-1
GLOVER.txt,399134,400670,1536,10,N,N,-,-1,-1
GLOVER.txt,399350,400982,1632,10,N,N,-,-1,-1
GLOVER.txt,399571,401071,1500,10,N,N,-,-1,-1
GLOVER.txt,399635,401252,1617,10,N,N,-,-1,-1
GLOVER.txt,399665,401662,1997,10,N,N,-,-1,-1
GLOVER.txt,399736,402119,2383,10,N,N,-,-1,-1
GLOVER.txt,400038,402291,2253,10,N,N,-,-1,-1
GLOVER.txt,400203,402488,2285,10,N,N,-,-1,-1
GLOVER.txt,400467,402631,2164,10,N,N,-,-1,-1
GLOVER.txt,400580,402676,2096,10,N,N,-,-1,-1
GLOVER.txt,400671,402753,2082,10,N,N,-,-1,-1
GLOVER.txt,400983,402824,1841,10,N,N,-,-1,-1
GLOVER.txt,401074,402923,1849,10,N,N,-,-1,-1
GLOVER.txt,401253,403152,1899,10,N,N,-,-1,-1
GLOVER.txt,401665,403278,1613,10,N,N,-,-1,-1
GLOVER.txt,402122,403653,1531,10,N,N,-,-1,-1
GLOVER.txt,402294,403844,1550,10,N,N,-,-1,-1
GLOVER.txt,402493,403916,1423,10,N,N,-,-1,-1
GLOVER.txt,402632,403958,1326,10,N,N,-,-1,-1
GLOVER.txt,402677,404128,1451,10,N,N,-,-1,-1
GLOVER.txt,402754,404290,1536,10,N,N,-,-1,-1
GLOVER.txt,402827,404423,1596,10,N,N,-,-1,-1
GLOVER.txt,402925,404691,1766,10,N,N,-,-1,-1
GLOVER.txt,403153,404809,1656,10,N,N,-,-1,-1
GLOVER.txt,403280,404961,1681,10,N,N,-,-1,-1
GLOVER.txt,403654,405058,1404,10,N,N,-,-1,-1
GLOVER.txt,403847,405161,1314,10,N,N,-,-1,-1
GLOVER.txt,403917,405400,1483,10,N,N,-,-1,-1
GLOVER.txt,403959,405425,1466,10,N,N,-,-1,-1
GLOVER.txt,404129,405474,1345,10,N,N,-,-1,-1
GLOVER.txt,404291,405581,1290,10,N,N,-,-1,-1
GLOVER.txt,404426,406012,1586,10,N,N,-,-1,-1
GLOVER.txt,404692,406294,1602,10,N,N,-,-1,-1
GLOVER.txt,404810,406380,1570,10,N,N,-,-1,-1
GLOVER.txt,404962,406676,1714,10,N,N,-,-1,-1
GLOVER.txt,405059,406780,1721,10,N,N,-,-1,-1
GLOVER.txt,405164,406906,1742,10,N,N,-,-1,-1
GLOVER.txt,405403,406927,1524,10,N,N,-,-1,-1
GLOVER.txt,405426,406936,1510,10,N,N,-,-1,-1
GLOVER.txt,405475,407082,1607,10,N,N,-,-1,-1
GLOVER.txt,405582,407298,1716,10,N,N,-,-1,-1
GLOVER.txt,406015,407379,1364,10,N,N,-,-1,-1
GLOVER.txt,406295,407508,1213,10,N,N,-,-1,-1
GLOVER.txt,406381,407560,1179,10,N,N,-,-1,-1
GLOVER.txt,406681,407840,1159,10,N,N,-,-1,-1
GLOVER.txt,406781,408039,1258,10,N,N,-,-1,-1
GLOVER.txt,406907,408242,1335,10,N,N,-,-1,-1
GLOVER.txt,406928,408255,1327,10,N,N,-,-1,-1
GLOVER.txt,406937,408340,1403,10,N,N,-,-1,-1
GLOVER.txt,407083,408440,1357,10,N,N,-,-1,-1
GLOVER.txt,407299,408552,1253,10,N,N,-,-1,-1
GLOVER.txt,407382,408748,1366,10,N,N,-,-1,-1
GLOVER.txt,407509,409167,1658,10,N,N,-,-1,-1
GLOVER.txt,407561,409287,1726,10,N,N,-,-1,-1
GLOVER.txt,407841,409443,1602,10,N,N,-,-1,-1
GLOVER.txt,408040,409615,1575,10,N,N,-,-1,-1
GLOVER.txt,408243,409811,1568,10,N,N,-,-1,-1
GLOVER.txt,408256,410121,1865,10,N,N,-,-1,-1
GLOVER.txt,408343,410316,1973,10,N,N,-,-1,-1
GLOVER.txt,408442,410491,2049,10,N,N,-,-1,-1
GLOVER.txt,408553,410589,2036,10,N,N,-,-1,-1
GLOVER.txt,408753,410758,2005,10,N,N,-,-1,-1
GLOVER.txt,409168,411219,2051,10,N,N,-,-1,-1
GLOVER.txt,409288,411274,1986,10,N,N,-,-1,-1
GLOVER.txt,409446,411467,2021,10,N,N,-,-1,-1
GLOVER.txt,409616,411568,1952,10,N,N,-,-1,-1
GLOVER.txt,409812,411664,1852,10,N,N,-,-1,-1
GLOVER.txt,410122,411800,1678,10,N,N,-,-1,-1
GLOVER.txt,410319,411988,1669,10,N,N,-,-1,-1
GLOVER.txt,410492,412109,1617,10,N,N,-,-1,-1
GLOVER.txt,410590,412236,1646,10,N,N,-,-1,-1
GLOVER.txt,410759,412320,1561,10,N,N,-,-1,-1
GLOVER.txt,411222,412475,1253,10,N,N,-,-1,-1
GLOVER.txt,411275,412551,1276,10,N,N,-,-1,-1
GLOVER.txt,411468,412846,1378,10,N,N,-,-1,-1
GLOVER.txt,411569,412921,1352,10,N,N,-,-1,-1
GLOVER.txt,411667,413157,1490,10,N,N,-,-1,-1
GLOVER.txt,411801,413297,1496,10,N,N,-,-1,-1
GLOVER.txt,411989,413577,1588,10,N,N,-,-1,-1
GLOVER.txt,412112,413660,1548,10,N,N,-,-1,-1
GLOVER.txt,412237,413712,1475,10,N,N,-,-1,-1
GLOVER.txt,412321,414057,1736,10,N,N,-,-1,-1
GLOVER.txt,412476,414070,1594,10,N,N,-,-1,-1
GLOVER.txt,412552,414159,1607,10,N,N,-,-1,-1
GLOVER.txt,412849,414453,1604,10,N,N,-,-1,-1
GLOVER.txt,412922,414602,1680,10,N,N,-,-1,-1
GLOVER.txt,413158,414839,1681,10,N,N,-,-1,-1
GLOVER.txt,413298,415189,1891,10,N,N,-,-1,-1
GLOVER.txt,413578,415373,1795,10,N,N,-,-1,-1
GLOVER.txt,413661,415485,1824,10,N,N,-,-1,-1
GLOVER.txt,413713,415555,1842,10,N,N,-,-1,-1
GLOVER.txt,414058,415683,1625,10,N,N,-,-1,-1
GLOVER.txt,414071,415912,1841,10,N,N,-,-1,-1
GLOVER.txt,414160,415936,1776,10,N,N,-,-1,-1
GLOVER.txt,414456,415942,1486,10,N,N,-,-1,-1
GLOVER.txt,414605,416074,1469,10,N,N,-,-1,-1
GLOVER.txt,414840,416145,1305,10,N,N,-,-1,-1
GLOVER.txt,415190,416183,993,10,N,N,-,-1,-1
GLOVER.txt,415375,416222,847,10,N,N,-,-1,-1
GLOVER.txt,415487,416258,771,10,N,N,-,-1,-1
GLOVER.txt,415558,416297,739,10,N,N,-,-1,-1
GLOVER.txt,415686,416336,650,10,N,N,-,-1,-1
GLOVER.txt,415915,416384,469,10,N,N,-,-1,-1
GLOVER.txt,415937,416426,489,10,N,N,-,-1,-1
GLOVER.txt,415945,416503,558,10,N,N,-,-1,-1
GLOVER.txt,416075,416556,481,10,N,N,-,-1,-1
GLOVER.txt,416148,416567,419,10,N,N,-,-1,-1
GLOVER.txt,416184,416898,714,10,N,N,-,-1,-1
GLOVER.txt,416225,417346,1121,10,N,N,-,-1,-1
GLOVER.txt,416261,417677,1416,10,N,N,-,-1,-1
GLOVER.txt,416298,417809,1511,10,N,N,-,-1,-1
GLOVER.txt,416339,418074,1735,10,N,N,-,-1,-1
GLOVER.txt,416387,418334,1947,10,N,N,-,-1,-1
GLOVER.txt,416429,418470,2041,10,N,N,-,-1,-1
GLOVER.txt,416506,418549,2043,10,N,N,-,-1,-1
GLOVER.txt,416557,418621,2064,10,N,N,-,-1,-1
GLOVER.txt,416572,419113,2541,10,N,N,-,-1,-1
GLOVER.txt,416903,419593,2690,10,N,N,-,-1,-1
GLOVER.txt,417349,419624,2275,10,N,N,-,-1,-1
GLOVER.txt,417678,420047,2369,10,N,N,-,-1,-1
GLOVER.txt,417810,420262,2452,10,N,N,-,-1,-1
GLOVER.txt,418075,420425,2350,10,N,N,-,-1,-1
GLOVER.txt,418337,420442,2105,10,N,N,-,-1,-1
GLOVER.txt,418472,420755,2283,10,N,N,-,-1,-1
GLOVER.txt,418550,420873,2323,10,N,N,-,-1,-1
GLOVER.txt,418622,420882,2260,10,N,N,-,-1,-1
GLOVER.txt,419114,420903,1789,10,N,N,-,-1,-1
GLOVER.txt,419596,421065,1469,10,N,N,-,-1,-1
GLOVER.txt,419625,421121,1496,10,N,N,-,-1,-1
GLOVER.txt,420048,421137,1089,10,N,N,-,-1,-1
GLOVER.txt,420263,421175,912,10,N,N,-,-1,-1
GLOVER.txt,420426,421196,770,10,N,N,-,-1,-1
GLOVER.txt,420443,421231,788,10,N,N,-,-1,-1
GLOVER.txt,420756,421246,490,10,N,N,-,-1,-1
GLOVER.txt,420874,421259,385,10,N,N,-,-1,-1
GLOVER.txt,420883,421302,419,10,N,N,-,-1,-1
GLOVER.txt,420904,421335,431,10,N,N,-,-1,-1
GLOVER.txt,421066,421389,323,10,N,N,-,-1,-1
GLOVER.txt,421123,421496,373,10,N,N,-,-1,-1
GLOVER.txt,421138,421732,594,10,N,N,-,-1,-1
GLOVER.txt,421176,422279,1103,10,N,N,-,-1,-1
GLOVER.txt,421197,422440,1243,10,N,N,-,-1,-1
GLOVER.txt,421232,422519,1287,10,N,N,-,-1,-1
GLOVER.txt,421247,422574,1327,10,N,N,-,-1,-1
GLOVER.txt,421262,422581,1319,10,N,N,-,-1,-1
GLOVER.txt,421303,422616,1313,10,N,N,-,-1,-1
GLOVER.txt,421338,422758,1420,10,N,N,-,-1,-1
GLOVER.txt,421391,422805,1414,10,N,N,-,-1,-1
GLOVER.txt,421497,422956,1459,10,N,N,-,-1,-1
GLOVER.txt,421735,423080,1345,10,N,N,-,-1,-1
GLOVER.txt,422282,423374,1092,10,N,N,-,-1,-1
GLOVER.txt,422441,423620,1179,10,N,N,-,-1,-1
GLOVER.txt,422520,423704,1184,10,N,N,-,-1,-1
GLOVER.txt,422575,423762,1187,10,N,N,-,-1,-1
GLOVER.txt,422582,424141,1559,10,N,N,-,-1,-1
GLOVER.txt,422617,424186,1569,10,N,N,-,-1,-1
GLOVER.txt,422759,424341,1582,10,N,N,-,-1,-1
GLOVER.txt,422806,424418,1612,10,N,N,-,-1,-1
GLOVER.txt,422959,424558,1599,10,N,N,-,-1,-1
GLOVER.txt,423081,424679,1598,10,N,N,-,-1,-1
GLOVER.txt,423375,424834,1459,10,N,N,-,-1,-1
GLOVER.txt,423622,424869,1247,10,N,N,-,-1,-1
GLOVER.txt,423707,424921,1214,10,N,N,-,-1,-1
GLOVER.txt,423765,424976,1211,10,N,N,-,-1,-1
GLOVER.txt,424142,425152,1010,10,N,N,-,-1,-1
GLOVER.txt,424187,425195,1008,10,N,N,-,-1,-1
GLOVER.txt,424342,425305,963,10,N,N,-,-1,-1
GLOVER.txt,424421,425361,940,10,N,N,-,-1,-1
GLOVER.txt,424559,425431,872,10,N,N,-,-1,-1
GLOVER.txt,424680,425463,783,10,N,N,-,-1,-1
GLOVER.txt,424835,425502,667,10,N,N,-,-1,-1
GLOVER.txt,424871,425523,652,10,N,N,-,-1,-1
GLOVER.txt,424922,425539,617,10,N,N,-,-1,-1
GLOVER.txt,424977,425575,598,10,N,N,-,-1,-1
GLOVER.txt,425153,425629,476,10,N,N,-,-1,-1
GLOVER.txt,425198,425722,524,10,N,N,-,-1,-1
GLOVER.txt,425306,425758,452,10,N,N,-,-1,-1
GLOVER.txt,425362,425830,468,10,N,N,-,-1,-1
GLOVER.txt,425432,425868,436,10,N,N,-,-1,-1
GLOVER.txt,425464,426017,553,10,N,N,-,-1,-1
GLOVER.txt,425503,426043,540,10,N,N,-,-1,-1
GLOVER.txt,425524,426110,586,10,N,N,-,-1,-1
GLOVER.txt,425540,426334,794,10,N,N,-,-1,-1
GLOVER.txt,425576,426400,824,10,N,N,-,-1,-1
GLOVER.txt,425630,426505,875,10,N,N,-,-1,-1
GLOVER.txt,425723,426518,795,10,N,N,-,-1,-1
GLOVER.txt,425759,426533,774,10,N,N,-,-1,-1
GLOVER.txt,425831,426599,768,10,N,N,-,-1,-1
GLOVER.txt,425869,426635,766,10,N,N,-,-1,-1
GLOVER.txt,426018,426683,665,10,N,N,-,-1,-1
GLOVER.txt,426044,426702,658,10,N,N,-,-1,-1
GLOVER.txt,426111,426808,697,10,N,N,-,-1,-1
GLOVER.txt,426335,426859,524,10,N,N,-,-1,-1
GLOVER.txt,426401,426945,544,10,N,N,-,-1,-1
GLOVER.txt,426506,426979,473,10,N,N,-,-1,-1
GLOVER.txt,426519,427135,616,10,N,N,-,-1,-1
GLOVER.txt,426534,427170,636,10,N,N,-,-1,-1
GLOVER.txt,426600,427188,588,10,N,N,-,-1,-1
GLOVER.txt,426636,427195,559,10,N,N,-,-1,-1
GLOVER.txt,426684,427238,554,10,N,N,-,-1,-1
GLOVER.txt,426703,427307,604,10,N,N,-,-1,-1
GLOVER.txt,426809,427369,560,10,N,N,-,-1,-1
GLOVER.txt,426860,427382,522,10,N,N,-,-1,-1
GLOVER.txt,426946,427385,439,10,N,N,-,-1,-1
GLOVER.txt,426980,427495,515,10,N,N,-,-1,-1
GLOVER.txt,427136,427542,406,10,N,N,-,-1,-1
GLOVER.txt,427171,427649,478,10,N,N,-,-1,-1
GLOVER.txt,427189,427760,571,10,N,N,-,-1,-1
GLOVER.txt,427196,427777,581,10,N,N,-,-1,-1
GLOVER.txt,427239,427791,552,10,N,N,-,-1,-1
GLOVER.txt,427309,427991,682,10,N,N,-,-1,-1
GLOVER.txt,427370,428023,653,10,N,N,-,-1,-1
GLOVER.txt,427382,428116,734,10,N,N,-,-1,-1
GLOVER.txt,427386,428240,854,10,N,N,-,-1,-1
GLOVER.txt,427496,428532,1036,10,N,N,-,-1,-1
GLOVER.txt,427543,428702,1159,10,N,N,-,-1,-1
GLOVER.txt,427650,428908,1258,10,N,N,-,-1,-1
GLOVER.txt,427763,428983,1220,10,N,N,-,-1,-1
GLOVER.txt,427778,428985,1207,10,N,N,-,-1,-1
GLOVER.txt,427792,429039,1247,10,N,N,-,-1,-1
GLOVER.txt,427994,429043,1049,10,N,N,-,-1,-1
GLOVER.txt,428024,429049,1025,10,N,N,-,-1,-1
GLOVER.txt,428119,429067,948,10,N,N,-,-1,-1
GLOVER.txt,428241,429071,830,10,N,N,-,-1,-1
GLOVER.txt,428533,429080,547,10,N,N,-,-1,-1
GLOVER.txt,428703,429099,396,10,N,N,-,-1,-1
GLOVER.txt,428909,429109,200,10,N,N,-,-1,-1
GLOVER.txt,428984,429129,145,10,N,N,-,-1,-1
GLOVER.txt,428986,429137,151,10,N,N,-,-1,-1
GLOVER.txt,429040,429187,147,10,N,N,-,-1,-1
GLOVER.txt,429044,429203,159,10,N,N,-,-1,-1
GLOVER.txt,429050,429237,187,10,N,N,-,-1,-1
GLOVER.txt,429068,429241,173,10,N,N,-,-1,-1
GLOVER.txt,429072,429277,205,10,N,N,-,-1,-1
GLOVER.txt,429081,429460,379,10,N,N,-,-1,-1
GLOVER.txt,429100,429744,644,10,N,N,-,-1,-1
GLOVER.txt,429110,429925,815,10,N,N,-,-1,-1
GLOVER.txt,429130,430100,970,10,N,N,-,-1,-1
GLOVER.txt,429138,430343,1205,10,N,N,-,-1,-1
GLOVER.txt,429188,430567,1379,10,N,N,-,-1,-1
GLOVER.txt,429204,430768,1564,10,N,N,-,-1,-1
GLOVER.txt,429238,430989,1751,10,N,N,-,-1,-1
GLOVER.txt,429243,431067,1824,10,N,N,-,-1,-1
GLOVER.txt,429280,431135,1855,10,N,N,-,-1,-1
GLOVER.txt,429461,431413,1952,10,N,N,-,-1,-1
GLOVER.txt,429745,431473,1728,10,N,N,-,-1,-1
GLOVER.txt,429928,431678,1750,10,N,N,-,-1,-1
GLOVER.txt,430101,431870,1769,10,N,N,-,-1,-1
GLOVER.txt,430346,432084,1738,10,N,N,-,-1,-1
GLOVER.txt,430569,432112,1543,10,N,N,-,-1,-1
GLOVER.txt,430770,432159,1389,10,N,N,-,-1,-1
GLOVER.txt,430990,432436,1446,10,N,N,-,-1,-1
GLOVER.txt,431070,432483,1413,10,N,N,-,-1,-1
GLOVER.txt,431136,432567,1431,10,N,N,-,-1,-1
GLOVER.txt,431416,432759,1343,10,N,N,-,-1,-1
GLOVER.txt,431474,433049,1575,10,N,N,-,-1,-1
GLOVER.txt,431679,433314,1635,10,N,N,-,-1,-1
GLOVER.txt,431871,433533,1662,10,N,N,-,-1,-1
GLOVER.txt,432085,433657,1572,10,N,N,-,-1,-1
GLOVER.txt,432113,433692,1579,10,N,N,-,-1,-1
GLOVER.txt,432160,433741,1581,10,N,N,-,-1,-1
GLOVER.txt,432437,433872,1435,10,N,N,-,-1,-1
GLOVER.txt,432484,433920,1436,10,N,N,-,-1,-1
GLOVER.txt,432570,434071,1501,10,N,N,-,-1,-1
GLOVER.txt,432760,434326,1566,10,N,N,-,-1,-1
GLOVER.txt,433052,434556,1504,10,N,N,-,-1,-1
GLOVER.txt,433315,434664,1349,10,N,N,-,-1,-1
GLOVER.txt,433534,434844,1310,10,N,N,-,-1,-1
GLOVER.txt,433658,434913,1255,10,N,N,-,-1,-1
GLOVER.txt,433693,435037,1344,10,N,N,-,-1,-1
GLOVER.txt,433744,435132,1388,10,N,N,-,-1,-1
GLOVER.txt,433873,435354,1481,10,N,N,-,-1,-1
GLOVER.txt,433923,435422,1499,10,N,N,-,-1,-1
GLOVER.txt,434072,435466,1394,10,N,N,-,-1,-1
GLOVER.txt,434328,435552,1224,10,N,N,-,-1,-1
GLOVER.txt,434557,435832,1275,10,N,N,-,-1,-1
GLOVER.txt,434666,436028,1362,10,N,N,-,-1,-1
GLOVER.txt,434847,436145,1298,10,N,N,-,-1,-1
GLOVER.txt,434914,436381,1467,10,N,N,-,-1,-1
GLOVER.txt,435038,436406,1368,10,N,N,-,-1,-1
GLOVER.txt,435133,436528,1395,10,N,N,-,-1,-1
GLOVER.txt,435355,436642,1287,10,N,N,-,-1,-1
GLOVER.txt,435423,436825,1402,10,N,N,-,-1,-1
GLOVER.txt,435467,436976,1509,10,N,N,-,-1,-1
GLOVER.txt,435553,437002,1449,10,N,N,-,-1,-1
GLOVER.txt,435833,437052,1219,10,N,N,-,-1,-1
GLOVER.txt,436029,437123,1094,10,N,N,-,-1,-1
GLOVER.txt,436146,437365,1219,10,N,N,-,-1,-1
GLOVER.txt,436384,437678,1294,10,N,N,-,-1,-1
GLOVER.txt,436407,438348,1941,10,N,N,-,-1,-1
GLOVER.txt,436529,438492,1963,10,N,N,-,-1,-1
GLOVER.txt,436645,438711,2066,10,N,N,-,-1,-1
GLOVER.txt,436826,439409,2583,10,N,N,-,-1,-1
GLOVER.txt,436977,439439,2462,10,N,N,-,-1,-1
GLOVER.txt,437003,439565,2562,10,N,N,-,-1,-1
GLOVER.txt,437053,439751,2698,10,N,N,-,-1,-1
GLOVER.txt,437126,440056,2930,10,N,N,-,-1,-1
GLOVER.txt,437366,440375,3009,10,N,N,-,-1,-1
GLOVER.txt,437683,440621,2938,10,N,N,-,-1,-1
GLOVER.txt,438351,440793,2442,10,N,N,-,-1,-1
GLOVER.txt,438493,441012,2519,10,N,N,-,-1,-1
GLOVER.txt,438712,441161,2449,10,N,N,-,-1,-1
GLOVER.txt,439410,441276,1866,10,N,N,-,-1,-1
GLOVER.txt,439440,441533,2093,10,N,N,-,-1,-1
GLOVER.txt,439566,441822,2256,10,N,N,-,-1,-1
GLOVER.txt,439754,442093,2339,10,N,N,-,-1,-1
GLOVER.txt,440057,442273,2216,10,N,N,-,-1,-1
GLOVER.txt,440376,442479,2103,10,N,N,-,-1,-1
GLOVER.txt,440623,442489,1866,10,N,N,-,-1,-1
GLOVER.txt,440793,442569,1776,10,N,N,-,-1,-1
GLOVER.txt,441014,442703,1689,10,N,N,-,-1,-1
GLOVER.txt,441164,442977,1813,10,N,N,-,-1,-1
GLOVER.txt,441277,443050,1773,10,N,N,-,-1,-1
GLOVER.txt,441535,443141,1606,10,N,N,-,-1,-1
GLOVER.txt,441823,443532,1709,10,N,N,-,-1,-1
GLOVER.txt,442095,443615,1520,10,N,N,-,-1,-1
GLOVER.txt,442274,443931,1657,10,N,N,-,-1,-1
GLOVER.txt,442480,444535,2055,10,N,N,-,-1,-1
GLOVER.txt,442491,444670,2179,10,N,N,-,-1,-1
GLOVER.txt,442572,444843,2271,10,N,N,-,-1,-1
GLOVER.txt,442706,445045,2339,10,N,N,-,-1,-1
GLOVER.txt,442978,445318,2340,10,N,N,-,-1,-1
GLOVER.txt,443052,445434,2382,10,N,N,-,-1,-1
GLOVER.txt,443142,445631,2489,10,N,N,-,-1,-1
GLOVER.txt,443534,445694,2160,10,N,N,-,-1,-1
GLOVER.txt,443616,445829,2213,10,N,N,-,-1,-1
GLOVER.txt,443933,445978,2045,10,N,N,-,-1,-1
GLOVER.txt,444538,446059,1521,10,N,N,-,-1,-1
GLOVER.txt,444673,446314,1641,10,N,N,-,-1,-1
GLOVER.txt,444844,446378,1534,10,N,N,-,-1,-1
GLOVER.txt,445048,446521,1473,10,N,N,-,-1,-1
GLOVER.txt,445319,446781,1462,10,N,N,-,-1,-1
GLOVER.txt,445435,447109,1674,10,N,N,-,-1,-1
GLOVER.txt,445634,447219,1585,10,N,N,-,-1,-1
GLOVER.txt,445695,447292,1597,10,N,N,-,-1,-1
GLOVER.txt,445831,447331,1500,10,N,N,-,-1,-1
GLOVER.txt,445981,447567,1586,10,N,N,-,-1,-1
GLOVER.txt,446062,447853,1791,10,N,N,-,-1,-1
GLOVER.txt,446317,447880,1563,10,N,N,-,-1,-1
GLOVER.txt,446379,447967,1588,10,N,N,-,-1,-1
GLOVER.txt,446522,448125,1603,10,N,N,-,-1,-1
GLOVER.txt,446782,448191,1409,10,N,N,-,-1,-1
GLOVER.txt,447110,448306,1196,10,N,N,-,-1,-1
GLOVER.txt,447222,448451,1229,10,N,N,-,-1,-1
GLOVER.txt,447293,448588,1295,10,N,N,-,-1,-1
GLOVER.txt,447332,448729,1397,10,N,N,-,-1,-1
GLOVER.txt,447569,448839,1270,10,N,N,-,-1,-1
GLOVER.txt,447854,449020,1166,10,N,N,-,-1,-1
GLOVER.txt,447881,449041,1160,10,N,N,-,-1,-1
GLOVER.txt,447969,449274,1305,10,N,N,-,-1,-1
GLOVER.txt,448126,449441,1315,10,N,N,-,-1,-1
GLOVER.txt,448194,449458,1264,10,N,N,-,-1,-1
GLOVER.txt,448307,449558,1251,10,N,N,-,-1,-1
GLOVER.txt,448452,449878,1426,10,N,N,-,-1,-1
GLOVER.txt,448589,449997,1408,10,N,N,-,-1,-1
GLOVER.txt,448730,450113,1383,10,N,N,-,-1,-1
GLOVER.txt,448840,450449,1609,10,N,N,-,-1,-1
GLOVER.txt,449021,450531,1510,10,N,N,-,-1,-1
GLOVER.txt,449042,450810,1768,10,N,N,-,-1,-1
GLOVER.txt,449277,450952,1675,10,N,N,-,-1,-1
GLOVER.txt,449442,451119,1677,10,N,N,-,-1,-1
GLOVER.txt,449461,451165,1704,10,N,N,-,-1,-1
GLOVER.txt,449559,451508,1949,10,N,N,-,-1,-1
GLOVER.txt,449879,451758,1879,10,N,N,-,-1,-1
GLOVER.txt,449998,451811,1813,10,N,N,-,-1,-1
GLOVER.txt,450116,451931,1815,10,N,N,-,-1,-1
GLOVER.txt,450450,452113,1663,10,N,N,-,-1,-1
GLOVER.txt,450532,452254,1722,10,N,N,-,-1,-1
GLOVER.txt,450811,452500,1689,10,N,N,-,-1,-1
GLOVER.txt,450952,452635,1683,10,N,N,-,-1,-1
GLOVER.txt,451120,452703,1583,10,N,N,-,-1,-1
GLOVER.txt,451166,452776,1610,10,N,N,-,-1,-1
GLOVER.txt,451511,453096,1585,10,N,N,-,-1,-1
GLOVER.txt,451758,453546,1788,10,N,N,-,-1,-1
GLOVER.txt,451812,453770,1958,10,N,N,-,-1,-1
GLOVER.txt,451932,454389,2457,10,N,N,-,-1,-1
GLOVER.txt,452116,454735,2619,10,N,N,-,-1,-1
GLOVER.txt,452257,454986,2729,10,N,N,-,-1,-1
GLOVER.txt,452501,455172,2671,10,N,N,-,-1,-1
GLOVER.txt,452638,455236,2598,10,N,N,-,-1,-1
GLOVER.txt,452704,455351,2647,10,N,N,-,-1,-1
GLOVER.txt,452778,455442,2664,10,N,N,-,-1,-1
GLOVER.txt,453097,455466,2369,10,N,N,-,-1,-1
GLOVER.txt,453547,455616,2069,10,N,N,-,-1,-1
GLOVER.txt,453772,455654,1882,10,N,N,-,-1,-1
GLOVER.txt,454390,455928,1538,10,N,N,-,-1,-1
GLOVER.txt,454736,456099,1363,10,N,N,-,-1,-1
GLOVER.txt,454989,456268,1279,10,N,N,-,-1,-1
GLOVER.txt,455173,456690,1517,10,N,N,-,-1,-1
GLOVER.txt,455238,456974,1736,10,N,N,-,-1,-1
GLOVER.txt,455352,457162,1810,10,N,N,-,-1,-1
GLOVER.txt,455443,457182,1739,10,N,N,-,-1,-1
GLOVER.txt,455467,457318,1851,10,N,N,-,-1,-1
GLOVER.txt,455617,457527,1910,10,N,N,-,-1,-1
GLOVER.txt,455655,457704,2049,10,N,N,-,-1,-1
GLOVER.txt,455929,457765,1836,10,N,N,-,-1,-1
GLOVER.txt,456100,457793,1693,10,N,N,-,-1,-1
GLOVER.txt,456269,457826,1557,10,N,N,-,-1,-1
GLOVER.txt,456691,457947,1256,10,N,N,-,-1,-1
GLOVER.txt,456977,458075,1098,10,N,N,-,-1,-1
GLOVER.txt,457163,458083,920,10,N,N,-,-1,-1
GLOVER.txt,457183,458096,913,10,N,N,-,-1,-1
GLOVER.txt,457319,458162,843,10,N,N,-,-1,-1
GLOVER.txt,457530,458297,767,10,N,N,-,-1,-1
GLOVER.txt,457705,458526,821,10,N,N,-,-1,-1
GLOVER.txt,457766,458655,889,10,N,N,-,-1,-1
GLOVER.txt,457794,458874,1080,10,N,N,-,-1,-1
GLOVER.txt,457827,458917,1090,10,N,N,-,-1,-1
GLOVER.txt,457950,459116,1166,10,N,N,-,-1,-1
GLOVER.txt,458076,459224,1148,10,N,N,-,-1,-1
GLOVER.txt,458084,459418,1334,10,N,N,-,-1,-1
GLOVER.txt,458097,459538,1441,10,N,N,-,-1,-1
GLOVER.txt,458165,459658,1493,10,N,N,-,-1,-1
GLOVER.txt,458298,459778,1480,10,N,N,-,-1,-1
GLOVER.txt,458527,459856,1329,10,N,N,-,-1,-1
GLOVER.txt,458656,459941,1285,10,N,N,-,-1,-1
GLOVER.txt,458875,459949,1074,10,N,N,-,-1,-1
GLOVER.txt,458918,459974,1056,10,N,N,-,-1,-1
GLOVER.txt,459119,460076,957,10,N,N,-,-1,-1
GLOVER.txt,459225,460085,860,10,N,N,-,-1,-1
GLOVER.txt,459419,460123,704,10,N,N,-,-1,-1
GLOVER.txt,459541,460253,712,10,N,N,-,-1,-1
GLOVER.txt,459659,460430,771,10,N,N,-,-1,-1
GLOVER.txt,459779,460686,907,10,N,N,-,-1,-1
GLOVER.txt,459857,460829,972,10,N,N,-,-1,-1
GLOVER.txt,459942,461319,1377,10,N,N,-,-1,-1
GLOVER.txt,459950,461466,1516,10,N,N,-,-1,-1
GLOVER.txt,459975,461679,1704,10,N,N,-,-1,-1
GLOVER.txt,460077,461797,1720,10,N,N,-,-1,-1
GLOVER.txt,460087,462096,2009,10,N,N,-,-1,-1
GLOVER.txt,460124,462313,2189,10,N,N,-,-1,-1
GLOVER.txt,460256,462595,2339,10,N,N,-,-1,-1
GLOVER.txt,460431,462674,2243,10,N,N,-,-1,-1
GLOVER.txt,460689,462743,2054,10,N,N,-,-1,-1
GLOVER.txt,460830,462788,1958,10,N,N,-,-1,-1
GLOVER.txt,461320,463026,1706,10,N,N,-,-1,-1
GLOVER.txt,461467,463045,1578,10,N,N,-,-1,-1
GLOVER.txt,461682,463123,1441,10,N,N,-,-1,-1
GLOVER.txt,461798,463192,1394,10,N,N,-,-1,-1
GLOVER.txt,462099,463208,1109,10,N,N,-,-1,-1
GLOVER.txt,462314,463250,936,10,N,N,-,-1,-1
GLOVER.txt,462598,463564,966,10,N,N,-,-1,-1
GLOVER.txt,462675,463667,992,10,N,N,-,-1,-1
GLOVER.txt,462745,463736,991,10,N,N,-,-1,-1
GLOVER.txt,462789,463779,990,10,N,N,-,-1,-1
GLOVER.txt,463027,463845,818,10,N,N,-,-1,-1
GLOVER.txt,463046,464460,1414,10,N,N,-,-1,-1
GLOVER.txt,463126,464706,1580,10,N,N,-,-1,-1
GLOVER.txt,463193,464865,1672,10,N,N,-,-1,-1
GLOVER.txt,463209,465054,1845,10,N,N,-,-1,-1
GLOVER.txt,463251,465209,1958,10,N,N,-,-1,-1
GLOVER.txt,463567,465470,1903,10,N,N,-,-1,-1
GLOVER.txt,463670,465616,1946,10,N,N,-,-1,-1
GLOVER.txt,463738,465772,2034,10,N,N,-,-1,-1
GLOVER.txt,463782,465945,2163,10,N,N,-,-1,-1
GLOVER.txt,463848,466141,2293,10,N,N,-,-1,-1
GLOVER.txt,464465,466269,1804,10,N,N,-,-1,-1
GLOVER.txt,464709,466359,1650,10,N,N,-,-1,-1
GLOVER.txt,464866,466529,1663,10,N,N,-,-1,-1
GLOVER.txt,465055,466563,1508,10,N,N,-,-1,-1
GLOVER.txt,465210,466689,1479,10,N,N,-,-1,-1
GLOVER.txt,465472,466801,1329,10,N,N,-,-1,-1
GLOVER.txt,465617,466826,1209,10,N,N,-,-1,-1
GLOVER.txt,465774,466879,1105,10,N,N,-,-1,-1
GLOVER.txt,465946,466920,974,10,N,N,-,-1,-1
GLOVER.txt,466142,466986,844,10,N,N,-,-1,-1
GLOVER.txt,466270,467124,854,10,N,N,-,-1,-1
GLOVER.txt,466360,467343,983,10,N,N,-,-1,-1
GLOVER.txt,466530,467493,963,10,N,N,-,-1,-1
GLOVER.txt,466564,467539,975,10,N,N,-,-1,-1
GLOVER.txt,466690,467554,864,10,N,N,-,-1,-1
GLOVER.txt,466802,467573,771,10,N,N,-,-1,-1
GLOVER.txt,466827,467674,847,10,N,N,-,-1,-1
GLOVER.txt,466880,467693,813,10,N,N,-,-1,-1
GLOVER.txt,466922,467906,984,10,N,N,-,-1,-1
GLOVER.txt,466987,467930,943,10,N,N,-,-1,-1
GLOVER.txt,467126,467977,851,10,N,N,-,-1,-1
GLOVER.txt,467344,468126,782,10,N,N,-,-1,-1
GLOVER.txt,467494,468206,712,10,N,N,-,-1,-1
GLOVER.txt,467540,468519,979,10,N,N,-,-1,-1
GLOVER.txt,467555,468650,1095,10,N,N,-,-1,-1
GLOVER.txt,467575,468809,1234,10,N,N,-,-1,-1
GLOVER.txt,467676,468888,1212,10,N,N,-,-1,-1
GLOVER.txt,467693,469110,1417,10,N,N,-,-1,-1
GLOVER.txt,467907,469241,1334,10,N,N,-,-1,-1
GLOVER.txt,467931,469295,1364,10,N,N,-,-1,-1
GLOVER.txt,467978,469505,1527,10,N,N,-,-1,-1
GLOVER.txt,468129,469721,1592,10,N,N,-,-1,-1
GLOVER.txt,468207,469922,1715,10,N,N,-,-1,-1
GLOVER.txt,468522,470148,1626,10,N,N,-,-1,-1
GLOVER.txt,468651,470427,1776,10,N,N,-,-1,-1
GLOVER.txt,468810,470489,1679,10,N,N,-,-1,-1
GLOVER.txt,468889,470722,1833,10,N,N,-,-1,-1
GLOVER.txt,469113,470987,1874,10,N,N,-,-1,-1
GLOVER.txt,469242,471442,2200,10,N,N,-,-1,-1
GLOVER.txt,469296,471614,2318,10,N,N,-,-1,-1
GLOVER.txt,469506,471658,2152,10,N,N,-,-1,-1
GLOVER.txt,469724,471884,2160,10,N,N,-,-1,-1
GLOVER.txt,469923,472116,2193,10,N,N,-,-1,-1
GLOVER.txt,470151,472660,2509,10,N,N,-,-1,-1
GLOVER.txt,470428,472683,2255,10,N,N,-,-1,-1
GLOVER.txt,470490,472842,2352,10,N,N,-,-1,-1
GLOVER.txt,470725,472866,2141,10,N,N,-,-1,-1
GLOVER.txt,470988,472990,2002,10,N,N,-,-1,-1
GLOVER.txt,471445,473014,1569,10,N,N,-,-1,-1
GLOVER.txt,471615,473077,1462,10,N,N,-,-1,-1
GLOVER.txt,471659,473555,1896,10,N,N,-,-1,-1
GLOVER.txt,471887,473697,1810,10,N,N,-,-1,-1
GLOVER.txt,472119,473840,1721,10,N,N,-,-1,-1
GLOVER.txt,472661,474020,1359,10,N,N,-,-1,-1
GLOVER.txt,472684,474165,1481,10,N,N,-,-1,-1
GLOVER.txt,472843,474341,1498,10,N,N,-,-1,-1
GLOVER.txt,472869,474409,1540,10,N,N,-,-1,-1
GLOVER.txt,472991,474542,1551,10,N,N,-,-1,-1
GLOVER.txt,473017,474579,1562,10,N,N,-,-1,-1
GLOVER.txt,473080,474750,1670,10,N,N,-,-1,-1
GLOVER.txt,473556,474818,1262,10,N,N,-,-1,-1
GLOVER.txt,473698,474915,1217,10,N,N,-,-1,-1
GLOVER.txt,473845,474922,1077,10,N,N,-,-1,-1
GLOVER.txt,474021,474938,917,10,N,N,-,-1,-1
GLOVER.txt,474170,474997,827,10,N,N,-,-1,-1
GLOVER.txt,474344,475007,663,10,N,N,-,-1,-1
GLOVER.txt,474410,475272,862,10,N,N,-,-1,-1
GLOVER.txt,474543,475479,936,10,N,N,-,-1,-1
GLOVER.txt,474580,475631,1051,10,N,N,-,-1,-1
GLOVER.txt,474751,475650,899,10,N,N,-,-1,-1
GLOVER.txt,474819,475723,904,10,N,N,-,-1,-1
GLOVER.txt,474916,475730,814,10,N,N,-,-1,-1
GLOVER.txt,474923,475805,882,10,N,N,-,-1,-1
GLOVER.txt,474939,475812,873,10,N,N,-,-1,-1
GLOVER.txt,474998,475870,872,10,N,N,-,-1,-1
GLOVER.txt,475010,475957,947,10,N,N,-,-1,-1
GLOVER.txt,475273,475964,691,10,N,N,-,-1,-1
GLOVER.txt,475482,476058,576,10,N,N,-,-1,-1
GLOVER.txt,475632,476066,434,10,N,N,-,-1,-1
GLOVER.txt,475651,476117,466,10,N,N,-,-1,-1
GLOVER.txt,475725,476125,400,10,N,N,-,-1,-1
GLOVER.txt,475731,476220,489,10,N,N,-,-1,-1
GLOVER.txt,475807,476228,421,10,N,N,-,-1,-1
GLOVER.txt,475813,476277,464,10,N,N,-,-1,-1
GLOVER.txt,475871,476285,414,10,N,N,-,-1,-1
GLOVER.txt,475959,476332,373,10,N,N,-,-1,-1
GLOVER.txt,475965,476340,375,10,N,N,-,-1,-1
GLOVER.txt,476061,476397,336,10,N,N,-,-1,-1
GLOVER.txt,476067,476405,338,10,N,N,-,-1,-1
GLOVER.txt,476120,476446,326,10,N,N,-,-1,-1
GLOVER.txt,476126,476454,328,10,N,N,-,-1,-1
GLOVER.txt,476223,476505,282,10,N,N,-,-1,-1
GLOVER.txt,476229,476513,284,10,N,N,-,-1,-1
GLOVER.txt,476280,476588,308,10,N,N,-,-1,-1
GLOVER.txt,476286,476596,310,10,N,N,-,-1,-1
GLOVER.txt,476335,476656,321,10,N,N,-,-1,-1
GLOVER.txt,476341,476664,323,10,N,N,-,-1,-1
GLOVER.txt,476400,476837,437,10,N,N,-,-1,-1
GLOVER.txt,476406,476845,439,10,N,N,-,-1,-1
GLOVER.txt,476449,476927,478,10,N,N,-,-1,-1
GLOVER.txt,476455,476943,488,10,N,N,-,-1,-1
GLOVER.txt,476508,476987,479,10,N,N,-,-1,-1
GLOVER.txt,476514,477364,850,10,N,N,-,-1,-1
GLOVER.txt,476591,477495,904,10,N,N,-,-1,-1
GLOVER.txt,476597,477582,985,10,N,N,-,-1,-1
GLOVER.txt,476659,477889,1230,10,N,N,-,-1,-1
GLOVER.txt,476665,478118,1453,10,N,N,-,-1,-1
GLOVER.txt,476840,478225,1385,10,N,N,-,-1,-1
GLOVER.txt,476846,478304,1458,10,N,N,-,-1,-1
GLOVER.txt,476929,478466,1537,10,N,N,-,-1,-1
GLOVER.txt,476945,478791,1846,10,N,N,-,-1,-1
GLOVER.txt,476990,478870,1880,10,N,N,-,-1,-1
GLOVER.txt,477367,478956,1589,10,N,N,-,-1,-1
GLOVER.txt,477496,479012,1516,10,N,N,-,-1,-1
GLOVER.txt,477587,479092,1505,10,N,N,-,-1,-1
GLOVER.txt,477890,479430,1540,10,N,N,-,-1,-1
GLOVER.txt,478121,479624,1503,10,N,N,-,-1,-1
GLOVER.txt,478226,480139,1913,10,N,N,-,-1,-1
GLOVER.txt,478305,480351,2046,10,N,N,-,-1,-1
GLOVER.txt,478469,480430,1961,10,N,N,-,-1,-1
GLOVER.txt,478792,480528,1736,10,N,N,-,-1,-1
GLOVER.txt,478871,480957,2086,10,N,N,-,-1,-1
GLOVER.txt,478958,481172,2214,10,N,N,-,-1,-1
GLOVER.txt,479014,481382,2368,10,N,N,-,-1,-1
GLOVER.txt,479093,481499,2406,10,N,N,-,-1,-1
GLOVER.txt,479431,481916,2485,10,N,N,-,-1,-1
GLOVER.txt,479625,482414,2789,10,N,N,-,-1,-1
GLOVER.txt,480140,482416,2276,10,N,N,-,-1,-1
GLOVER.txt,480354,482579,2225,10,N,N,-,-1,-1
GLOVER.txt,480431,482581,2150,10,N,N,-,-1,-1
GLOVER.txt,480529,482720,2191,10,N,N,-,-1,-1
GLOVER.txt,480959,482904,1945,10,N,N,-,-1,-1
GLOVER.txt,481173,483078,1905,10,N,N,-,-1,-1
GLOVER.txt,481387,483500,2113,10,N,N,-,-1,-1
GLOVER.txt,481502,483843,2341,10,N,N,-,-1,-1
GLOVER.txt,481917,483927,2010,10,N,N,-,-1,-1
GLOVER.txt,482415,484029,1614,10,N,N,-,-1,-1
GLOVER.txt,482417,484182,1765,10,N,N,-,-1,-1
GLOVER.txt,482580,484338,1758,10,N,N,-,-1,-1
GLOVER.txt,482582,484394,1812,10,N,N,-,-1,-1
GLOVER.txt,482723,484404,1681,10,N,N,-,-1,-1
GLOVER.txt,482906,484452,1546,10,N,N,-,-1,-1
GLOVER.txt,483079,484545,1466,10,N,N,-,-1,-1
GLOVER.txt,483501,484576,1075,10,N,N,-,-1,-1
GLOVER.txt,483844,484582,738,10,N,N,-,-1,-1
GLOVER.txt,483928,484592,664,10,N,N,-,-1,-1
GLOVER.txt,484032,484623,591,10,N,N,-,-1,-1
GLOVER.txt,484183,484693,510,10,N,N,-,-1,-1
GLOVER.txt,484341,484723,382,10,N,N,-,-1,-1
GLOVER.txt,484397,484731,334,10,N,N,-,-1,-1
GLOVER.txt,484405,484888,483,10,N,N,-,-1,-1
GLOVER.txt,484453,484894,441,10,N,N,-,-1,-1
GLOVER.txt,484546,484902,356,10,N,N,-,-1,-1
GLOVER.txt,484577,485031,454,10,N,N,-,-1,-1
GLOVER.txt,484585,485060,475,10,N,N,-,-1,-1
GLOVER.txt,484593,485070,477,10,N,N,-,-1,-1
GLOVER.txt,484624,485318,694,10,N,N,-,-1,-1
GLOVER.txt,484696,485324,628,10,N,N,-,-1,-1
GLOVER.txt,484726,485368,642,10,N,N,-,-1,-1
GLOVER.txt,484732,485376,644,10,N,N,-,-1,-1
GLOVER.txt,484889,485642,753,10,N,N,-,-1,-1
GLOVER.txt,484897,485678,781,10,N,N,-,-1,-1
GLOVER.txt,484903,485849,946,10,N,N,-,-1,-1
GLOVER.txt,485034,485855,821,10,N,N,-,-1,-1
GLOVER.txt,485063,485923,860,10,N,N,-,-1,-1
GLOVER.txt,485071,485933,862,10,N,N,-,-1,-1
GLOVER.txt,485319,486389,1070,10,N,N,-,-1,-1
GLOVER.txt,485327,486453,1126,10,N,N,-,-1,-1
GLOVER.txt,485371,486515,1144,10,N,N,-,-1,-1
GLOVER.txt,485377,486521,1144,10,N,N,-,-1,-1
GLOVER.txt,485645,486547,902,10,N,N,-,-1,-1
GLOVER.txt,485679,486557,878,10,N,N,-,-1,-1
GLOVER.txt,485850,486798,948,10,N,N,-,-1,-1
GLOVER.txt,485860,486862,1002,10,N,N,-,-1,-1
GLOVER.txt,485926,486868,942,10,N,N,-,-1,-1
GLOVER.txt,485934,486878,944,10,N,N,-,-1,-1
GLOVER.txt,486390,487130,740,10,N,N,-,-1,-1
GLOVER.txt,486454,487184,730,10,N,N,-,-1,-1
GLOVER.txt,486516,487190,674,10,N,N,-,-1,-1
GLOVER.txt,486524,487198,674,10,N,N,-,-1,-1
GLOVER.txt,486550,487527,977,10,N,N,-,-1,-1
GLOVER.txt,486558,487533,975,10,N,N,-,-1,-1
GLOVER.txt,486799,487571,772,10,N,N,-,-1,-1
GLOVER.txt,486863,487692,829,10,N,N,-,-1,-1
GLOVER.txt,486871,487740,869,10,N,N,-,-1,-1
GLOVER.txt,486879,487793,914,10,N,N,-,-1,-1
GLOVER.txt,487132,487799,667,10,N,N,-,-1,-1
GLOVER.txt,487185,487805,620,10,N,N,-,-1,-1
GLOVER.txt,487193,487815,622,10,N,N,-,-1,-1
GLOVER.txt,487199,487932,733,10,N,N,-,-1,-1
GLOVER.txt,487528,488058,530,10,N,N,-,-1,-1
GLOVER.txt,487538,488064,526,10,N,N,-,-1,-1
GLOVER.txt,487572,488074,502,10,N,N,-,-1,-1
GLOVER.txt,487693,488126,433,10,N,N,-,-1,-1
GLOVER.txt,487742,488208,466,10,N,N,-,-1,-1
GLOVER.txt,487794,488214,420,10,N,N,-,-1,-1
GLOVER.txt,487800,488222,422,10,N,N,-,-1,-1
GLOVER.txt,487808,488357,549,10,N,N,-,-1,-1
GLOVER.txt,487816,488434,618,10,N,N,-,-1,-1
GLOVER.txt,487933,488440,507,10,N,N,-,-1,-1
GLOVER.txt,488059,488450,391,10,N,N,-,-1,-1
GLOVER.txt,488067,488662,595,10,N,N,-,-1,-1
GLOVER.txt,488075,488734,659,10,N,N,-,-1,-1
GLOVER.txt,488127,488741,614,10,N,N,-,-1,-1
GLOVER.txt,488209,488749,540,10,N,N,-,-1,-1
GLOVER.txt,488217,488924,707,10,N,N,-,-1,-1
GLOVER.txt,488223,488996,773,10,N,N,-,-1,-1
GLOVER.txt,488358,489002,644,10,N,N,-,-1,-1
GLOVER.txt,488435,489010,575,10,N,N,-,-1,-1
GLOVER.txt,488443,489240,797,10,N,N,-,-1,-1
GLOVER.txt,488451,489386,935,10,N,N,-,-1,-1
GLOVER.txt,488663,489392,729,10,N,N,-,-1,-1
GLOVER.txt,488736,489400,664,10,N,N,-,-1,-1
GLOVER.txt,488744,489716,972,10,N,N,-,-1,-1
GLOVER.txt,488750,489824,1074,10,N,N,-,-1,-1
GLOVER.txt,488925,489830,905,10,N,N,-,-1,-1
GLOVER.txt,488997,489838,841,10,N,N,-,-1,-1
GLOVER.txt,489005,490115,1110,10,N,N,-,-1,-1
GLOVER.txt,489011,490279,1268,10,N,N,-,-1,-1
GLOVER.txt,489241,490285,1044,10,N,N,-,-1,-1
GLOVER.txt,489387,490293,906,10,N,N,-,-1,-1
GLOVER.txt,489395,490379,984,10,N,N,-,-1,-1
GLOVER.txt,489401,490421,1020,10,N,N,-,-1,-1
GLOVER.txt,489717,490510,793,10,N,N,-,-1,-1
GLOVER.txt,489825,490543,718,10,N,N,-,-1,-1
GLOVER.txt,489833,490656,823,10,N,N,-,-1,-1
GLOVER.txt,489839,490662,823,10,N,N,-,-1,-1
GLOVER.txt,490116,490705,589,10,N,N,-,-1,-1
GLOVER.txt,490280,490715,435,10,N,N,-,-1,-1
GLOVER.txt,490288,490786,498,10,N,N,-,-1,-1
GLOVER.txt,490294,490889,595,10,N,N,-,-1,-1
GLOVER.txt,490382,490895,513,10,N,N,-,-1,-1
GLOVER.txt,490422,490935,513,10,N,N,-,-1,-1
GLOVER.txt,490511,491048,537,10,N,N,-,-1,-1
GLOVER.txt,490544,491153,609,10,N,N,-,-1,-1
GLOVER.txt,490657,491159,502,10,N,N,-,-1,-1
GLOVER.txt,490665,491169,504,10,N,N,-,-1,-1
GLOVER.txt,490708,491231,523,10,N,N,-,-1,-1
GLOVER.txt,490716,491340,624,10,N,N,-,-1,-1
GLOVER.txt,490787,491344,557,10,N,N,-,-1,-1
GLOVER.txt,490890,491354,464,10,N,N,-,-1,-1
GLOVER.txt,490900,491476,576,10,N,N,-,-1,-1
GLOVER.txt,490936,491595,659,10,N,N,-,-1,-1
GLOVER.txt,491049,491601,552,10,N,N,-,-1,-1
GLOVER.txt,491154,491611,457,10,N,N,-,-1,-1
GLOVER.txt,491162,491677,515,10,N,N,-,-1,-1
GLOVER.txt,491170,491773,603,10,N,N,-,-1,-1
GLOVER.txt,491232,491780,548,10,N,N,-,-1,-1
GLOVER.txt,491341,491790,449,10,N,N,-,-1,-1
GLOVER.txt,491347,491961,614,10,N,N,-,-1,-1
GLOVER.txt,491355,492060,705,10,N,N,-,-1,-1
GLOVER.txt,491477,492066,589,10,N,N,-,-1,-1
GLOVER.txt,491596,492076,480,10,N,N,-,-1,-1
GLOVER.txt,491604,492283,679,10,N,N,-,-1,-1
GLOVER.txt,491612,492388,776,10,N,N,-,-1,-1
GLOVER.txt,491678,492394,716,10,N,N,-,-1,-1
GLOVER.txt,491775,492402,627,10,N,N,-,-1,-1
GLOVER.txt,491783,492440,657,10,N,N,-,-1,-1
GLOVER.txt,491791,492492,701,10,N,N,-,-1,-1
GLOVER.txt,491962,492536,574,10,N,N,-,-1,-1
GLOVER.txt,492061,492658,597,10,N,N,-,-1,-1
GLOVER.txt,492069,492664,595,10,N,N,-,-1,-1
GLOVER.txt,492077,492672,595,10,N,N,-,-1,-1
GLOVER.txt,492284,492784,500,10,N,N,-,-1,-1
GLOVER.txt,492389,492931,542,10,N,N,-,-1,-1
GLOVER.txt,492397,492937,540,10,N,N,-,-1,-1
GLOVER.txt,492403,492945,542,10,N,N,-,-1,-1
GLOVER.txt,492443,493000,557,10,N,N,-,-1,-1
GLOVER.txt,492493,493082,589,10,N,N,-,-1,-1
GLOVER.txt,492537,493088,551,10,N,N,-,-1,-1
GLOVER.txt,492659,493096,437,10,N,N,-,-1,-1
GLOVER.txt,492667,493234,567,10,N,N,-,-1,-1
GLOVER.txt,492673,493340,667,10,N,N,-,-1,-1
GLOVER.txt,492785,493347,562,10,N,N,-,-1,-1
GLOVER.txt,492932,493413,481,10,N,N,-,-1,-1
GLOVER.txt,492940,493423,483,10,N,N,-,-1,-1
GLOVER.txt,492946,493512,566,10,N,N,-,-1,-1
GLOVER.txt,493001,493576,575,10,N,N,-,-1,-1
GLOVER.txt,493083,493582,499,10,N,N,-,-1,-1
GLOVER.txt,493091,493590,499,10,N,N,-,-1,-1
GLOVER.txt,493097,493723,626,10,N,N,-,-1,-1
GLOVER.txt,493235,493831,596,10,N,N,-,-1,-1
GLOVER.txt,493342,493838,496,10,N,N,-,-1,-1
GLOVER.txt,493350,493846,496,10,N,N,-,-1,-1
GLOVER.txt,493416,493946,530,10,N,N,-,-1,-1
GLOVER.txt,493424,493952,528,10,N,N,-,-1,-1
GLOVER.txt,493513,493962,449,10,N,N,-,-1,-1
GLOVER.txt,493577,494007,430,10,N,N,-,-1,-1
GLOVER.txt,493585,494078,493,10,N,N,-,-1,-1
GLOVER.txt,493591,494298,707,10,N,N,-,-1,-1
GLOVER.txt,493724,494792,1068,10,N,N,-,-1,-1
GLOVER.txt,493833,494843,1010,10,N,N,-,-1,-1
GLOVER.txt,493841,495275,1434,10,N,N,-,-1,-1
GLOVER.txt,493847,495579,1732,10,N,N,-,-1,-1
GLOVER.txt,493947,495657,1710,10,N,N,-,-1,-1
GLOVER.txt,493955,495710,1755,10,N,N,-,-1,-1
GLOVER.txt,493963,495757,1794,10,N,N,-,-1,-1
GLOVER.txt,494010,495836,1826,10,N,N,-,-1,-1
GLOVER.txt,494079,495883,1804,10,N,N,-,-1,-1
GLOVER.txt,494300,495902,1602,10,N,N,-,-1,-1
GLOVER.txt,494793,495921,1128,10,N,N,-,-1,-1
GLOVER.txt,494844,495939,1095,10,N,N,-,-1,-1
GLOVER.txt,495276,496039,763,10,N,N,-,-1,-1
GLOVER.txt,495580,496058,478,10,N,N,-,-1,-1
GLOVER.txt,495659,496221,562,10,N,N,-,-1,-1
GLOVER.txt,495712,496240,528,10,N,N,-,-1,-1
GLOVER.txt,495758,496258,500,10,N,N,-,-1,-1
GLOVER.txt,495837,496573,736,10,N,N,-,-1,-1
GLOVER.txt,495884,496742,858,10,N,N,-,-1,-1
GLOVER.txt,495903,496850,947,10,N,N,-,-1,-1
GLOVER.txt,495922,496851,929,10,N,N,-,-1,-1
GLOVER.txt,495940,497132,1192,10,N,N,-,-1,-1
GLOVER.txt,496040,497176,1136,10,N,N,-,-1,-1
GLOVER.txt,496059,497222,1163,10,N,N,-,-1,-1
GLOVER.txt,496223,497263,1040,10,N,N,-,-1,-1
GLOVER.txt,496241,497300,1059,10,N,N,-,-1,-1
GLOVER.txt,496259,497324,1065,10,N,N,-,-1,-1
GLOVER.txt,496576,497326,750,10,N,N,-,-1,-1
GLOVER.txt,496743,497343,600,10,N,N,-,-1,-1
GLOVER.txt,496850,497368,518,10,N,N,-,-1,-1
GLOVER.txt,496856,497378,522,10,N,N,-,-1,-1
GLOVER.txt,497134,497387,253,10,N,N,-,-1,-1
GLOVER.txt,497181,497424,243,10,N,N,-,-1,-1
GLOVER.txt,497227,497460,233,10,N,N,-,-1,-1
GLOVER.txt,497265,497490,225,10,N,N,-,-1,-1
GLOVER.txt,497302,497501,199,10,N,N,-,-1,-1
GLOVER.txt,497325,497517,192,10,N,N,-,-1,-1
GLOVER.txt,497327,497538,211,10,N,N,-,-1,-1
GLOVER.txt,497345,497584,239,10,N,N,-,-1,-1
GLOVER.txt,497369,497659,290,10,N,N,-,-1,-1
GLOVER.txt,497379,497671,292,10,N,N,-,-1,-1
GLOVER.txt,497389,497691,302,10,N,N,-,-1,-1
GLOVER.txt,497426,497718,292,10,N,N,-,-1,-1
GLOVER.txt,497462,497727,265,10,N,N,-,-1,-1
GLOVER.txt,497491,497741,250,10,N,N,-,-1,-1
GLOVER.txt,497503,497743,240,10,N,N,-,-1,-1
GLOVER.txt,497518,497767,249,10,N,N,-,-1,-1
GLOVER.txt,497540,497781,241,10,N,N,-,-1,-1
GLOVER.txt,497589,497805,216,10,N,N,-,-1,-1
GLOVER.txt,497662,497840,178,10,N,N,-,-1,-1
GLOVER.txt,497672,497852,180,10,N,N,-,-1,-1
GLOVER.txt,497694,497873,179,10,N,N,-,-1,-1
GLOVER.txt,497719,497908,189,10,N,N,-,-1,-1
GLOVER.txt,497730,497945,215,10,N,N,-,-1,-1
GLOVER.txt,497742,497981,239,10,N,N,-,-1,-1
GLOVER.txt,497744,497995,251,10,N,N,-,-1,-1
GLOVER.txt,497770,498013,243,10,N,N,-,-1,-1
GLOVER.txt,497782,498025,243,10,N,N,-,-1,-1
GLOVER.txt,497808,498046,238,10,N,N,-,-1,-1
GLOVER.txt,497843,498071,228,10,N,N,-,-1,-1
GLOVER.txt,497853,498089,236,10,N,N,-,-1,-1
GLOVER.txt,497876,498107,231,10,N,N,-,-1,-1
GLOVER.txt,497911,498109,198,10,N,N,-,-1,-1
GLOVER.txt,497948,498130,182,10,N,N,-,-1,-1
GLOVER.txt,497984,498149,165,10,N,N,-,-1,-1
GLOVER.txt,497996,498151,155,10,N,N,-,-1,-1
GLOVER.txt,498016,498176,160,10,N,N,-,-1,-1
GLOVER.txt,498026,498194,168,10,N,N,-,-1,-1
GLOVER.txt,498049,498196,147,10,N,N,-,-1,-1
GLOVER.txt,498072,498217,145,10,N,N,-,-1,-1
GLOVER.txt,498092,498811,719,10,N,N,-,-1,-1
GLOVER.txt,498108,498871,763,10,N,N,-,-1,-1
GLOVER.txt,498110,498905,795,10,N,N,-,-1,-1
GLOVER.txt,498133,498938,805,10,N,N,-,-1,-1
GLOVER.txt,498150,498960,810,10,N,N,-,-1,-1
GLOVER.txt,498152,499040,888,10,N,N,-,-1,-1
GLOVER.txt,498179,499114,935,10,N,N,-,-1,-1
GLOVER.txt,498195,499144,949,10,N,N,-,-1,-1
GLOVER.txt,498197,499430,1233,10,N,N,-,-1,-1
GLOVER.txt,498220,499713,1493,10,N,N,-,-1,-1
GLOVER.txt,498814,500147,1333,10,N,N,-,-1,-1
GLOVER.txt,498874,500286,1412,10,N,N,-,-1,-1
GLOVER.txt,498907,500371,1464,10,N,N,-,-1,-1
GLOVER.txt,498941,500682,1741,10,N,N,-,-1,-1
GLOVER.txt,498961,500789,1828,10,N,N,-,-1,-1
GLOVER.txt,499042,500967,1925,10,N,N,-,-1,-1
GLOVER.txt,499115,501035,1920,10,N,N,-,-1,-1
GLOVER.txt,499149,501155,2006,10,N,N,-,-1,-1
GLOVER.txt,499431,501408,1977,10,N,N,-,-1,-1
GLOVER.txt,499714,501549,1835,10,N,N,-,-1,-1
GLOVER.txt,500148,501578,1430,10,N,N,-,-1,-1
GLOVER.txt,500288,501765,1477,10,N,N,-,-1,-1
GLOVER.txt,500372,502010,1638,10,N,N,-,-1,-1
GLOVER.txt,500683,502245,1562,10,N,N,-,-1,-1
GLOVER.txt,500790,502416,1626,10,N,N,-,-1,-1
GLOVER.txt,500968,502653,1685,10,N,N,-,-1,-1
GLOVER.txt,501036,502688,1652,10,N,N,-,-1,-1
GLOVER.txt,501158,502824,1666,10,N,N,-,-1,-1
GLOVER.txt,501409,502921,1512,10,N,N,-,-1,-1
GLOVER.txt,501550,503107,1557,10,N,N,-,-1,-1
GLOVER.txt,501579,503188,1609,10,N,N,-,-1,-1
GLOVER.txt,501766,503351,1585,10,N,N,-,-1,-1
GLOVER.txt,502011,503476,1465,10,N,N,-,-1,-1
GLOVER.txt,502246,503495,1249,10,N,N,-,-1,-1
GLOVER.txt,502417,503547,1130,10,N,N,-,-1,-1
GLOVER.txt,502654,503625,971,10,N,N,-,-1,-1
GLOVER.txt,502689,503672,983,10,N,N,-,-1,-1
GLOVER.txt,502825,503902,1077,10,N,N,-,-1,-1
GLOVER.txt,502922,504379,1457,10,N,N,-,-1,-1
GLOVER.txt,503108,504500,1392,10,N,N,-,-1,-1
GLOVER.txt,503189,504602,1413,10,N,N,-,-1,-1
GLOVER.txt,503354,504675,1321,10,N,N,-,-1,-1
GLOVER.txt,503477,504798,1321,10,N,N,-,-1,-1
GLOVER.txt,503496,504916,1420,10,N,N,-,-1,-1
GLOVER.txt,503549,505016,1467,10,N,N,-,-1,-1
GLOVER.txt,503626,505126,1500,10,N,N,-,-1,-1
GLOVER.txt,503673,505179,1506,10,N,N,-,-1,-1
GLOVER.txt,503904,505256,1352,10,N,N,-,-1,-1
GLOVER.txt,504380,505374,994,10,N,N,-,-1,-1
GLOVER.txt,504501,505583,1082,10,N,N,-,-1,-1
GLOVER.txt,504603,505712,1109,10,N,N,-,-1,-1
GLOVER.txt,504676,505748,1072,10,N,N,-,-1,-1
GLOVER.txt,504800,505967,1167,10,N,N,-,-1,-1
GLOVER.txt,504917,506134,1217,10,N,N,-,-1,-1
GLOVER.txt,505017,506370,1353,10,N,N,-,-1,-1
GLOVER.txt,505127,506393,1266,10,N,N,-,-1,-1
GLOVER.txt,505182,506419,1237,10,N,N,-,-1,-1
GLOVER.txt,505257,506741,1484,10,N,N,-,-1,-1
GLOVER.txt,505375,506980,1605,10,N,N,-,-1,-1
GLOVER.txt,505584,506989,1405,10,N,N,-,-1,-1
GLOVER.txt,505715,507073,1358,10,N,N,-,-1,-1
GLOVER.txt,505749,507177,1428,10,N,N,-,-1,-1
GLOVER.txt,505968,507182,1214,10,N,N,-,-1,-1
GLOVER.txt,506135,507340,1205,10,N,N,-,-1,-1
GLOVER.txt,506371,507376,1005,10,N,N,-,-1,-1
GLOVER.txt,506394,507578,1184,10,N,N,-,-1,-1
GLOVER.txt,506420,507583,1163,10,N,N,-,-1,-1
GLOVER.txt,506742,507681,939,10,N,N,-,-1,-1
GLOVER.txt,506985,507743,758,10,N,N,-,-1,-1
GLOVER.txt,506990,507748,758,10,N,N,-,-1,-1
GLOVER.txt,507074,507857,783,10,N,N,-,-1,-1
GLOVER.txt,507180,508002,822,10,N,N,-,-1,-1
GLOVER.txt,507183,508007,824,10,N,N,-,-1,-1
GLOVER.txt,507341,508072,731,10,N,N,-,-1,-1
GLOVER.txt,507377,508114,737,10,N,N,-,-1,-1
GLOVER.txt,507581,508119,538,10,N,N,-,-1,-1
GLOVER.txt,507584,508230,646,10,N,N,-,-1,-1
GLOVER.txt,507681,508338,657,10,N,N,-,-1,-1
GLOVER.txt,507746,508343,597,10,N,N,-,-1,-1
GLOVER.txt,507749,508484,735,10,N,N,-,-1,-1
GLOVER.txt,507858,508489,631,10,N,N,-,-1,-1
GLOVER.txt,508005,508718,713,10,N,N,-,-1,-1
GLOVER.txt,508008,508723,715,10,N,N,-,-1,-1
GLOVER.txt,508073,509001,928,10,N,N,-,-1,-1
GLOVER.txt,508117,509190,1073,10,N,N,-,-1,-1
GLOVER.txt,508120,509523,1403,10,N,N,-,-1,-1
GLOVER.txt,508231,510018,1787,10,N,N,-,-1,-1
GLOVER.txt,508341,510129,1788,10,N,N,-,-1,-1
GLOVER.txt,508344,510300,1956,10,N,N,-,-1,-1
GLOVER.txt,508487,510467,1980,10,N,N,-,-1,-1
GLOVER.txt,508490,510510,2020,10,N,N,-,-1,-1
GLOVER.txt,508721,510538,1817,10,N,N,-,-1,-1
GLOVER.txt,508724,510745,2021,10,N,N,-,-1,-1
GLOVER.txt,509002,510763,1761,10,N,N,-,-1,-1
GLOVER.txt,509193,510886,1693,10,N,N,-,-1,-1
GLOVER.txt,509524,511038,1514,10,N,N,-,-1,-1
GLOVER.txt,510021,511068,1047,10,N,N,-,-1,-1
GLOVER.txt,510132,511106,974,10,N,N,-,-1,-1
GLOVER.txt,510301,511107,806,10,N,N,-,-1,-1
GLOVER.txt,510468,511407,939,10,N,N,-,-1,-1
GLOVER.txt,510513,511602,1089,10,N,N,-,-1,-1
GLOVER.txt,510539,511722,1183,10,N,N,-,-1,-1
GLOVER.txt,510748,511777,1029,10,N,N,-,-1,-1
GLOVER.txt,510764,512095,1331,10,N,N,-,-1,-1
GLOVER.txt,510887,512202,1315,10,N,N,-,-1,-1
GLOVER.txt,511040,512243,1203,10,N,N,-,-1,-1
GLOVER.txt,511069,512338,1269,10,N,N,-,-1,-1
GLOVER.txt,511106,512404,1298,10,N,N,-,-1,-1
GLOVER.txt,511108,512476,1368,10,N,N,-,-1,-1
GLOVER.txt,511408,512563,1155,10,N,N,-,-1,-1
GLOVER.txt,511603,512609,1006,10,N,N,-,-1,-1
GLOVER.txt,511723,512793,1070,10,N,N,-,-1,-1
GLOVER.txt,511778,512950,1172,10,N,N,-,-1,-1
GLOVER.txt,512096,515312,3216,10,N,N,-,-1,-1
GLOVER.txt,512203,516600,4397,10,N,N,-,-1,-1
GLOVER.txt,512244,518122,5878,10,N,N,-,-1,-1
GLOVER.txt,512339,524057,11718,10,N,N,-,-1,-1
GLOVER.txt,512407,525915,13508,10,N,N,-,-1,-1
GLOVER.txt,512477,526494,14017,10,N,N,-,-1,-1
GLOVER.txt,512564,526961,14397,10,N,N,-,-1,-1
GLOVER.txt,512610,526964,14354,10,N,N,-,-1,-1
GLOVER.txt,512794,526969,14175,10,N,N,-,-1,-1
GLOVER.txt,512955,526975,14020,10,N,N,-,-1,-1
GLOVER.txt,515314,526992,11678,10,N,N,-,-1,-1
GLOVER.txt,516600,527021,10421,10,N,N,-,-1,-1
GRONOW.txt,0,599,599,10,N,N,-,-1,-1
GRONOW.txt,127,730,603,10,N,N,-,-1,-1
GRONOW.txt,165,974,809,10,N,N,-,-1,-1
GRONOW.txt,182,1007,825,10,N,N,-,-1,-1
GRONOW.txt,352,1161,809,10,N,N,-,-1,-1
GRONOW.txt,371,1248,877,10,N,N,-,-1,-1
GRONOW.txt,422,1369,947,10,N,N,-,-1,-1
GRONOW.txt,432,1390,958,10,N,N,-,-1,-1
GRONOW.txt,446,1421,975,10,N,N,-,-1,-1
GRONOW.txt,471,1483,1012,10,N,N,-,-1,-1
GRONOW.txt,602,1501,899,10,N,N,-,-1,-1
GRONOW.txt,733,1544,811,10,N,N,-,-1,-1
GRONOW.txt,977,1874,897,10,N,N,-,-1,-1
GRONOW.txt,1010,2100,1090,10,N,N,-,-1,-1
GRONOW.txt,1164,2134,970,10,N,N,-,-1,-1
GRONOW.txt,1253,2152,899,10,N,N,-,-1,-1
GRONOW.txt,1374,2187,813,10,N,N,-,-1,-1
GRONOW.txt,1393,2376,983,10,N,N,-,-1,-1
GRONOW.txt,1424,2916,1492,10,N,N,-,-1,-1
GRONOW.txt,1486,3152,1666,10,N,N,-,-1,-1
GRONOW.txt,1504,3182,1678,10,N,N,-,-1,-1
GRONOW.txt,1545,3212,1667,10,N,N,-,-1,-1
GRONOW.txt,1877,3242,1365,10,N,N,-,-1,-1
GRONOW.txt,2103,3315,1212,10,N,N,-,-1,-1
GRONOW.txt,2137,3521,1384,10,N,N,-,-1,-1
GRONOW.txt,2155,3568,1413,10,N,N,-,-1,-1
GRONOW.txt,2190,3609,1419,10,N,N,-,-1,-1
GRONOW.txt,2381,3647,1266,10,N,N,-,-1,-1
GRONOW.txt,2917,3687,770,10,N,N,-,-1,-1
GRONOW.txt,3153,3714,561,10,N,N,-,-1,-1
GRONOW.txt,3183,3749,566,10,N,N,-,-1,-1
GRONOW.txt,3213,3801,588,10,N,N,-,-1,-1
GRONOW.txt,3243,3966,723,10,N,N,-,-1,-1
GRONOW.txt,3319,4006,687,10,N,N,-,-1,-1
GRONOW.txt,3522,4178,656,10,N,N,-,-1,-1
GRONOW.txt,3569,4266,697,10,N,N,-,-1,-1
GRONOW.txt,3610,4379,769,10,N,N,-,-1,-1
GRONOW.txt,3648,4538,890,10,N,N,-,-1,-1
GRONOW.txt,3688,4585,897,10,N,N,-,-1,-1
GRONOW.txt,3719,5057,1338,10,N,N,-,-1,-1
GRONOW.txt,3752,5540,1788,10,N,N,-,-1,-1
GRONOW.txt,3803,5542,1739,10,N,N,-,-1,-1
GRONOW.txt,3968,6116,2148,10,N,N,-,-1,-1
GRONOW.txt,4008,6181,2173,10,N,N,-,-1,-1
GRONOW.txt,4180,6614,2434,10,N,N,-,-1,-1
GRONOW.txt,4268,7547,3279,10,N,N,-,-1,-1
GRONOW.txt,4381,7698,3317,10,N,N,-,-1,-1
GRONOW.txt,4540,7777,3237,10,N,N,-,-1,-1
GRONOW.txt,4586,7883,3297,10,N,N,-,-1,-1
GRONOW.txt,5062,7991,2929,10,N,N,-,-1,-1
GRONOW.txt,5541,7993,2452,10,N,N,-,-1,-1
GRONOW.txt,5543,8056,2513,10,N,N,-,-1,-1
GRONOW.txt,6117,8108,1991,10,N,N,-,-1,-1
GRONOW.txt,6182,8156,1974,10,N,N,-,-1,-1
GRONOW.txt,6619,8286,1667,10,N,N,-,-1,-1
GRONOW.txt,7548,8496,948,10,N,N,-,-1,-1
GRONOW.txt,7699,8507,808,10,N,N,-,-1,-1
GRONOW.txt,7778,8518,740,10,N,N,-,-1,-1
GRONOW.txt,7884,8576,692,10,N,N,-,-1,-1
GRONOW.txt,7992,8684,692,10,N,N,-,-1,-1
GRONOW.txt,7994,9014,1020,10,N,N,-,-1,-1
GRONOW.txt,8057,9155,1098,10,N,N,-,-1,-1
GRONOW.txt,8113,9296,1183,10,N,N,-,-1,-1
GRONOW.txt,8159,9345,1186,10,N,N,-,-1,-1
GRONOW.txt,8289,9400,1111,10,N,N,-,-1,-1
GRONOW.txt,8497,9512,1015,10,N,N,-,-1,-1
GRONOW.txt,8508,9699,1191,10,N,N,-,-1,-1
GRONOW.txt,8519,9814,1295,10,N,N,-,-1,-1
GRONOW.txt,8580,9884,1304,10,N,N,-,-1,-1
GRONOW.txt,8685,10327,1642,10,N,N,-,-1,-1
GRONOW.txt,9016,10632,1616,10,N,N,-,-1,-1
GRONOW.txt,9156,10674,1518,10,N,N,-,-1,-1
GRONOW.txt,9297,10798,1501,10,N,N,-,-1,-1
GRONOW.txt,9346,11024,1678,10,N,N,-,-1,-1
GRONOW.txt,9401,11086,1685,10,N,N,-,-1,-1
GRONOW.txt,9513,11248,1735,10,N,N,-,-1,-1
GRONOW.txt,9700,11425,1725,10,N,N,-,-1,-1
GRONOW.txt,9817,11469,1652,10,N,N,-,-1,-1
GRONOW.txt,9887,11709,1822,10,N,N,-,-1,-1
GRONOW.txt,10330,11967,1637,10,N,N,-,-1,-1
GRONOW.txt,10635,12335,1700,10,N,N,-,-1,-1
GRONOW.txt,10676,12818,2142,10,N,N,-,-1,-1
GRONOW.txt,10799,12969,2170,10,N,N,-,-1,-1
GRONOW.txt,11025,13052,2027,10,N,N,-,-1,-1
GRONOW.txt,11087,13164,2077,10,N,N,-,-1,-1
GRONOW.txt,11249,13224,1975,10,N,N,-,-1,-1
GRONOW.txt,11430,13383,1953,10,N,N,-,-1,-1
GRONOW.txt,11470,13694,2224,10,N,N,-,-1,-1
GRONOW.txt,11710,13840,2130,10,N,N,-,-1,-1
GRONOW.txt,11968,13920,1952,10,N,N,-,-1,-1
GRONOW.txt,12338,14151,1813,10,N,N,-,-1,-1
GRONOW.txt,12819,14178,1359,10,N,N,-,-1,-1
GRONOW.txt,12970,14657,1687,10,N,N,-,-1,-1
GRONOW.txt,13054,14783,1729,10,N,N,-,-1,-1
GRONOW.txt,13169,14882,1713,10,N,N,-,-1,-1
GRONOW.txt,13225,15065,1840,10,N,N,-,-1,-1
GRONOW.txt,13384,15504,2120,10,N,N,-,-1,-1
GRONOW.txt,13695,15677,1982,10,N,N,-,-1,-1
GRONOW.txt,13841,15804,1963,10,N,N,-,-1,-1
GRONOW.txt,13923,15941,2018,10,N,N,-,-1,-1
GRONOW.txt,14154,16326,2172,10,N,N,-,-1,-1
GRONOW.txt,14179,16566,2387,10,N,N,-,-1,-1
GRONOW.txt,14660,16702,2042,10,N,N,-,-1,-1
GRONOW.txt,14788,16888,2100,10,N,N,-,-1,-1
GRONOW.txt,14883,16983,2100,10,N,N,-,-1,-1
GRONOW.txt,15066,17279,2213,10,N,N,-,-1,-1
GRONOW.txt,15507,17536,2029,10,N,N,-,-1,-1
GRONOW.txt,15678,17652,1974,10,N,N,-,-1,-1
GRONOW.txt,15805,17750,1945,10,N,N,-,-1,-1
GRONOW.txt,15942,18190,2248,10,N,N,-,-1,-1
GRONOW.txt,16329,18219,1890,10,N,N,-,-1,-1
GRONOW.txt,16567,18397,1830,10,N,N,-,-1,-1
GRONOW.txt,16705,18523,1818,10,N,N,-,-1,-1
GRONOW.txt,16889,18653,1764,10,N,N,-,-1,-1
GRONOW.txt,16984,18778,1794,10,N,N,-,-1,-1
GRONOW.txt,17282,18948,1666,10,N,N,-,-1,-1
GRONOW.txt,17538,19232,1694,10,N,N,-,-1,-1
GRONOW.txt,17653,19376,1723,10,N,N,-,-1,-1
GRONOW.txt,17751,19566,1815,10,N,N,-,-1,-1
GRONOW.txt,18195,19982,1787,10,N,N,-,-1,-1
GRONOW.txt,18224,20063,1839,10,N,N,-,-1,-1
GRONOW.txt,18398,20193,1795,10,N,N,-,-1,-1
GRONOW.txt,18524,20341,1817,10,N,N,-,-1,-1
GRONOW.txt,18654,20640,1986,10,N,N,-,-1,-1
GRONOW.txt,18779,20671,1892,10,N,N,-,-1,-1
GRONOW.txt,18949,20916,1967,10,N,N,-,-1,-1
GRONOW.txt,19235,21184,1949,10,N,N,-,-1,-1
GRONOW.txt,19379,21500,2121,10,N,N,-,-1,-1
GRONOW.txt,19567,21593,2026,10,N,N,-,-1,-1
GRONOW.txt,19987,21742,1755,10,N,N,-,-1,-1
GRONOW.txt,20066,21877,1811,10,N,N,-,-1,-1
GRONOW.txt,20194,21903,1709,10,N,N,-,-1,-1
GRONOW.txt,20342,21987,1645,10,N,N,-,-1,-1
GRONOW.txt,20643,22117,1474,10,N,N,-,-1,-1
GRONOW.txt,20672,22217,1545,10,N,N,-,-1,-1
GRONOW.txt,20919,22355,1436,10,N,N,-,-1,-1
GRONOW.txt,21185,22469,1284,10,N,N,-,-1,-1
GRONOW.txt,21501,22749,1248,10,N,N,-,-1,-1
GRONOW.txt,21598,22816,1218,10,N,N,-,-1,-1
GRONOW.txt,21744,23031,1287,10,N,N,-,-1,-1
GRONOW.txt,21878,23233,1355,10,N,N,-,-1,-1
GRONOW.txt,21904,23366,1462,10,N,N,-,-1,-1
GRONOW.txt,21988,23589,1601,10,N,N,-,-1,-1
GRONOW.txt,22118,23684,1566,10,N,N,-,-1,-1
GRONOW.txt,22218,23858,1640,10,N,N,-,-1,-1
GRONOW.txt,22356,23963,1607,10,N,N,-,-1,-1
GRONOW.txt,22472,24130,1658,10,N,N,-,-1,-1
GRONOW.txt,22750,24226,1476,10,N,N,-,-1,-1
GRONOW.txt,22817,24449,1632,10,N,N,-,-1,-1
GRONOW.txt,23032,24816,1784,10,N,N,-,-1,-1
GRONOW.txt,23236,24848,1612,10,N,N,-,-1,-1
GRONOW.txt,23369,24956,1587,10,N,N,-,-1,-1
GRONOW.txt,23590,25160,1570,10,N,N,-,-1,-1
GRONOW.txt,23685,25357,1672,10,N,N,-,-1,-1
GRONOW.txt,23859,25518,1659,10,N,N,-,-1,-1
GRONOW.txt,23964,25759,1795,10,N,N,-,-1,-1
GRONOW.txt,24131,26089,1958,10,N,N,-,-1,-1
GRONOW.txt,24229,26138,1909,10,N,N,-,-1,-1
GRONOW.txt,24452,26309,1857,10,N,N,-,-1,-1
GRONOW.txt,24819,26405,1586,10,N,N,-,-1,-1
GRONOW.txt,24849,26525,1676,10,N,N,-,-1,-1
GRONOW.txt,24957,26608,1651,10,N,N,-,-1,-1
GRONOW.txt,25161,26629,1468,10,N,N,-,-1,-1
GRONOW.txt,25358,26659,1301,10,N,N,-,-1,-1
GRONOW.txt,25519,26897,1378,10,N,N,-,-1,-1
GRONOW.txt,25760,27032,1272,10,N,N,-,-1,-1
GRONOW.txt,26092,27139,1047,10,N,N,-,-1,-1
GRONOW.txt,26139,27388,1249,10,N,N,-,-1,-1
GRONOW.txt,26310,27640,1330,10,N,N,-,-1,-1
GRONOW.txt,26406,27665,1259,10,N,N,-,-1,-1
GRONOW.txt,26526,28008,1482,10,N,N,-,-1,-1
GRONOW.txt,26608,28280,1672,10,N,N,-,-1,-1
GRONOW.txt,26634,28375,1741,10,N,N,-,-1,-1
GRONOW.txt,26662,28458,1796,10,N,N,-,-1,-1
GRONOW.txt,26898,28700,1802,10,N,N,-,-1,-1
GRONOW.txt,27033,28760,1727,10,N,N,-,-1,-1
GRONOW.txt,27140,28939,1799,10,N,N,-,-1,-1
GRONOW.txt,27391,29119,1728,10,N,N,-,-1,-1
GRONOW.txt,27643,29142,1499,10,N,N,-,-1,-1
GRONOW.txt,27666,29546,1880,10,N,N,-,-1,-1
GRONOW.txt,28009,29961,1952,10,N,N,-,-1,-1
GRONOW.txt,28281,30057,1776,10,N,N,-,-1,-1
GRONOW.txt,28376,30229,1853,10,N,N,-,-1,-1
GRONOW.txt,28459,30376,1917,10,N,N,-,-1,-1
GRONOW.txt,28701,30862,2161,10,N,N,-,-1,-1
GRONOW.txt,28761,31128,2367,10,N,N,-,-1,-1
GRONOW.txt,28940,31605,2665,10,N,N,-,-1,-1
GRONOW.txt,29122,31751,2629,10,N,N,-,-1,-1
GRONOW.txt,29143,31886,2743,10,N,N,-,-1,-1
GRONOW.txt,29547,32019,2472,10,N,N,-,-1,-1
GRONOW.txt,29962,32298,2336,10,N,N,-,-1,-1
GRONOW.txt,30060,32350,2290,10,N,N,-,-1,-1
GRONOW.txt,30230,32588,2358,10,N,N,-,-1,-1
GRONOW.txt,30377,32898,2521,10,N,N,-,-1,-1
GRONOW.txt,30863,33057,2194,10,N,N,-,-1,-1
GRONOW.txt,31129,33255,2126,10,N,N,-,-1,-1
GRONOW.txt,31606,33520,1914,10,N,N,-,-1,-1
GRONOW.txt,31752,33582,1830,10,N,N,-,-1,-1
GRONOW.txt,31887,33660,1773,10,N,N,-,-1,-1
GRONOW.txt,32020,33996,1976,10,N,N,-,-1,-1
GRONOW.txt,32301,34021,1720,10,N,N,-,-1,-1
GRONOW.txt,32351,34211,1860,10,N,N,-,-1,-1
GRONOW.txt,32589,34372,1783,10,N,N,-,-1,-1
GRONOW.txt,32900,34549,1649,10,N,N,-,-1,-1
GRONOW.txt,33058,34770,1712,10,N,N,-,-1,-1
GRONOW.txt,33257,34911,1654,10,N,N,-,-1,-1
GRONOW.txt,33521,34935,1414,10,N,N,-,-1,-1
GRONOW.txt,33587,35143,1556,10,N,N,-,-1,-1
GRONOW.txt,33661,35249,1588,10,N,N,-,-1,-1
GRONOW.txt,33997,35471,1474,10,N,N,-,-1,-1
GRONOW.txt,34022,35747,1725,10,N,N,-,-1,-1
GRONOW.txt,34212,36007,1795,10,N,N,-,-1,-1
GRONOW.txt,34373,36087,1714,10,N,N,-,-1,-1
GRONOW.txt,34550,36278,1728,10,N,N,-,-1,-1
GRONOW.txt,34771,36547,1776,10,N,N,-,-1,-1
GRONOW.txt,34916,36888,1972,10,N,N,-,-1,-1
GRONOW.txt,34936,36963,2027,10,N,N,-,-1,-1
GRONOW.txt,35144,37361,2217,10,N,N,-,-1,-1
GRONOW.txt,35250,37413,2163,10,N,N,-,-1,-1
GRONOW.txt,35472,37553,2081,10,N,N,-,-1,-1
GRONOW.txt,35748,37743,1995,10,N,N,-,-1,-1
GRONOW.txt,36008,38027,2019,10,N,N,-,-1,-1
GRONOW.txt,36089,38139,2050,10,N,N,-,-1,-1
GRONOW.txt,36279,38268,1989,10,N,N,-,-1,-1
GRONOW.txt,36549,38417,1868,10,N,N,-,-1,-1
GRONOW.txt,36889,38636,1747,10,N,N,-,-1,-1
GRONOW.txt,36968,38700,1732,10,N,N,-,-1,-1
GRONOW.txt,37364,39090,1726,10,N,N,-,-1,-1
GRONOW.txt,37414,39315,1901,10,N,N,-,-1,-1
GRONOW.txt,37555,39404,1849,10,N,N,-,-1,-1
GRONOW.txt,37744,39703,1959,10,N,N,-,-1,-1
GRONOW.txt,38030,39798,1768,10,N,N,-,-1,-1
GRONOW.txt,38140,39876,1736,10,N,N,-,-1,-1
GRONOW.txt,38269,39917,1648,10,N,N,-,-1,-1
GRONOW.txt,38418,39995,1577,10,N,N,-,-1,-1
GRONOW.txt,38637,40144,1507,10,N,N,-,-1,-1
GRONOW.txt,38701,40259,1558,10,N,N,-,-1,-1
GRONOW.txt,39093,40314,1221,10,N,N,-,-1,-1
GRONOW.txt,39316,40436,1120,10,N,N,-,-1,-1
GRONOW.txt,39405,40631,1226,10,N,N,-,-1,-1
GRONOW.txt,39704,40821,1117,10,N,N,-,-1,-1
GRONOW.txt,39799,41051,1252,10,N,N,-,-1,-1
GRONOW.txt,39879,41184,1305,10,N,N,-,-1,-1
GRONOW.txt,39918,41373,1455,10,N,N,-,-1,-1
GRONOW.txt,39996,41501,1505,10,N,N,-,-1,-1
GRONOW.txt,40145,41742,1597,10,N,N,-,-1,-1
GRONOW.txt,40264,41776,1512,10,N,N,-,-1,-1
GRONOW.txt,40316,41911,1595,10,N,N,-,-1,-1
GRONOW.txt,40437,41972,1535,10,N,N,-,-1,-1
GRONOW.txt,40632,42233,1601,10,N,N,-,-1,-1
GRONOW.txt,40822,42368,1546,10,N,N,-,-1,-1
GRONOW.txt,41052,42445,1393,10,N,N,-,-1,-1
GRONOW.txt,41187,42565,1378,10,N,N,-,-1,-1
GRONOW.txt,41374,42635,1261,10,N,N,-,-1,-1
GRONOW.txt,41502,42677,1175,10,N,N,-,-1,-1
GRONOW.txt,41745,42706,961,10,N,N,-,-1,-1
GRONOW.txt,41777,42875,1098,10,N,N,-,-1,-1
GRONOW.txt,41912,42983,1071,10,N,N,-,-1,-1
GRONOW.txt,41973,43274,1301,10,N,N,-,-1,-1
GRONOW.txt,42234,43441,1207,10,N,N,-,-1,-1
GRONOW.txt,42369,43463,1094,10,N,N,-,-1,-1
GRONOW.txt,42446,43581,1135,10,N,N,-,-1,-1
GRONOW.txt,42567,43606,1039,10,N,N,-,-1,-1
GRONOW.txt,42636,43790,1154,10,N,N,-,-1,-1
GRONOW.txt,42678,44196,1518,10,N,N,-,-1,-1
GRONOW.txt,42707,44506,1799,10,N,N,-,-1,-1
GRONOW.txt,42876,44578,1702,10,N,N,-,-1,-1
GRONOW.txt,42984,44715,1731,10,N,N,-,-1,-1
GRONOW.txt,43275,44854,1579,10,N,N,-,-1,-1
GRONOW.txt,43444,44885,1441,10,N,N,-,-1,-1
GRONOW.txt,43464,44988,1524,10,N,N,-,-1,-1
GRONOW.txt,43586,45042,1456,10,N,N,-,-1,-1
GRONOW.txt,43607,45156,1549,10,N,N,-,-1,-1
GRONOW.txt,43793,45310,1517,10,N,N,-,-1,-1
GRONOW.txt,44197,45444,1247,10,N,N,-,-1,-1
GRONOW.txt,44508,45481,973,10,N,N,-,-1,-1
GRONOW.txt,44579,45592,1013,10,N,N,-,-1,-1
GRONOW.txt,44717,45792,1075,10,N,N,-,-1,-1
GRONOW.txt,44857,45826,969,10,N,N,-,-1,-1
GRONOW.txt,44885,45970,1085,10,N,N,-,-1,-1
GRONOW.txt,44989,46001,1012,10,N,N,-,-1,-1
GRONOW.txt,45043,46316,1273,10,N,N,-,-1,-1
GRONOW.txt,45157,46427,1270,10,N,N,-,-1,-1
GRONOW.txt,45311,46610,1299,10,N,N,-,-1,-1
GRONOW.txt,45445,46734,1289,10,N,N,-,-1,-1
GRONOW.txt,45482,46772,1290,10,N,N,-,-1,-1
GRONOW.txt,45593,46843,1250,10,N,N,-,-1,-1
GRONOW.txt,45795,46910,1115,10,N,N,-,-1,-1
GRONOW.txt,45827,47051,1224,10,N,N,-,-1,-1
GRONOW.txt,45971,47100,1129,10,N,N,-,-1,-1
GRONOW.txt,46002,47271,1269,10,N,N,-,-1,-1
GRONOW.txt,46317,47435,1118,10,N,N,-,-1,-1
GRONOW.txt,46428,47538,1110,10,N,N,-,-1,-1
GRONOW.txt,46611,47580,969,10,N,N,-,-1,-1
GRONOW.txt,46735,47631,896,10,N,N,-,-1,-1
GRONOW.txt,46775,47755,980,10,N,N,-,-1,-1
GRONOW.txt,46844,47789,945,10,N,N,-,-1,-1
GRONOW.txt,46915,47977,1062,10,N,N,-,-1,-1
GRONOW.txt,47052,48258,1206,10,N,N,-,-1,-1
GRONOW.txt,47101,48324,1223,10,N,N,-,-1,-1
GRONOW.txt,47273,48548,1275,10,N,N,-,-1,-1
GRONOW.txt,47436,48609,1173,10,N,N,-,-1,-1
GRONOW.txt,47541,48760,1219,10,N,N,-,-1,-1
GRONOW.txt,47581,48914,1333,10,N,N,-,-1,-1
GRONOW.txt,47633,49126,1493,10,N,N,-,-1,-1
GRONOW.txt,47756,49255,1499,10,N,N,-,-1,-1
GRONOW.txt,47791,49316,1525,10,N,N,-,-1,-1
GRONOW.txt,47978,49534,1556,10,N,N,-,-1,-1
GRONOW.txt,48261,49698,1437,10,N,N,-,-1,-1
GRONOW.txt,48325,49913,1588,10,N,N,-,-1,-1
GRONOW.txt,48549,50045,1496,10,N,N,-,-1,-1
GRONOW.txt,48610,50162,1552,10,N,N,-,-1,-1
GRONOW.txt,48761,50287,1526,10,N,N,-,-1,-1
GRONOW.txt,48915,50491,1576,10,N,N,-,-1,-1
GRONOW.txt,49127,50581,1454,10,N,N,-,-1,-1
GRONOW.txt,49256,50717,1461,10,N,N,-,-1,-1
GRONOW.txt,49317,50819,1502,10,N,N,-,-1,-1
GRONOW.txt,49535,51106,1571,10,N,N,-,-1,-1
GRONOW.txt,49701,51282,1581,10,N,N,-,-1,-1
GRONOW.txt,49914,51464,1550,10,N,N,-,-1,-1
GRONOW.txt,50046,51487,1441,10,N,N,-,-1,-1
GRONOW.txt,50163,51773,1610,10,N,N,-,-1,-1
GRONOW.txt,50290,51854,1564,10,N,N,-,-1,-1
GRONOW.txt,50493,51935,1442,10,N,N,-,-1,-1
GRONOW.txt,50582,52077,1495,10,N,N,-,-1,-1
GRONOW.txt,50718,52214,1496,10,N,N,-,-1,-1
GRONOW.txt,50820,52414,1594,10,N,N,-,-1,-1
GRONOW.txt,51109,52560,1451,10,N,N,-,-1,-1
GRONOW.txt,51283,52709,1426,10,N,N,-,-1,-1
GRONOW.txt,51467,52803,1336,10,N,N,-,-1,-1
GRONOW.txt,51488,53007,1519,10,N,N,-,-1,-1
GRONOW.txt,51774,53076,1302,10,N,N,-,-1,-1
GRONOW.txt,51855,53292,1437,10,N,N,-,-1,-1
GRONOW.txt,51936,53512,1576,10,N,N,-,-1,-1
GRONOW.txt,52078,53678,1600,10,N,N,-,-1,-1
GRONOW.txt,52215,53784,1569,10,N,N,-,-1,-1
GRONOW.txt,52417,53941,1524,10,N,N,-,-1,-1
GRONOW.txt,52561,54146,1585,10,N,N,-,-1,-1
GRONOW.txt,52710,54325,1615,10,N,N,-,-1,-1
GRONOW.txt,52804,54399,1595,10,N,N,-,-1,-1
GRONOW.txt,53008,54619,1611,10,N,N,-,-1,-1
GRONOW.txt,53077,54650,1573,10,N,N,-,-1,-1
GRONOW.txt,53295,54805,1510,10,N,N,-,-1,-1
GRONOW.txt,53513,54945,1432,10,N,N,-,-1,-1
GRONOW.txt,53683,55283,1600,10,N,N,-,-1,-1
GRONOW.txt,53786,55378,1592,10,N,N,-,-1,-1
GRONOW.txt,53942,55484,1542,10,N,N,-,-1,-1
GRONOW.txt,54147,55645,1498,10,N,N,-,-1,-1
GRONOW.txt,54328,55852,1524,10,N,N,-,-1,-1
GRONOW.txt,54400,56027,1627,10,N,N,-,-1,-1
GRONOW.txt,54622,56200,1578,10,N,N,-,-1,-1
GRONOW.txt,54651,56338,1687,10,N,N,-,-1,-1
GRONOW.txt,54806,56479,1673,10,N,N,-,-1,-1
GRONOW.txt,54946,56648,1702,10,N,N,-,-1,-1
GRONOW.txt,55284,56943,1659,10,N,N,-,-1,-1
GRONOW.txt,55379,57038,1659,10,N,N,-,-1,-1
GRONOW.txt,55486,57135,1649,10,N,N,-,-1,-1
GRONOW.txt,55646,57237,1591,10,N,N,-,-1,-1
GRONOW.txt,55853,57659,1806,10,N,N,-,-1,-1
GRONOW.txt,56028,57759,1731,10,N,N,-,-1,-1
GRONOW.txt,56201,57889,1688,10,N,N,-,-1,-1
GRONOW.txt,56339,58107,1768,10,N,N,-,-1,-1
GRONOW.txt,56482,58280,1798,10,N,N,-,-1,-1
GRONOW.txt,56649,58502,1853,10,N,N,-,-1,-1
GRONOW.txt,56946,58691,1745,10,N,N,-,-1,-1
GRONOW.txt,57039,58834,1795,10,N,N,-,-1,-1
GRONOW.txt,57140,58864,1724,10,N,N,-,-1,-1
GRONOW.txt,57239,58968,1729,10,N,N,-,-1,-1
GRONOW.txt,57660,59037,1377,10,N,N,-,-1,-1
GRONOW.txt,57760,59176,1416,10,N,N,-,-1,-1
GRONOW.txt,57890,59313,1423,10,N,N,-,-1,-1
GRONOW.txt,58108,59459,1351,10,N,N,-,-1,-1
GRONOW.txt,58281,59487,1206,10,N,N,-,-1,-1
GRONOW.txt,58503,59610,1107,10,N,N,-,-1,-1
GRONOW.txt,58694,59721,1027,10,N,N,-,-1,-1
GRONOW.txt,58839,59828,989,10,N,N,-,-1,-1
GRONOW.txt,58865,60114,1249,10,N,N,-,-1,-1
GRONOW.txt,58970,60450,1480,10,N,N,-,-1,-1
GRONOW.txt,59040,60496,1456,10,N,N,-,-1,-1
GRONOW.txt,59177,60601,1424,10,N,N,-,-1,-1
GRONOW.txt,59314,60825,1511,10,N,N,-,-1,-1
GRONOW.txt,59462,61051,1589,10,N,N,-,-1,-1
GRONOW.txt,59488,61071,1583,10,N,N,-,-1,-1
GRONOW.txt,59612,61197,1585,10,N,N,-,-1,-1
GRONOW.txt,59722,61325,1603,10,N,N,-,-1,-1
GRONOW.txt,59829,61519,1690,10,N,N,-,-1,-1
GRONOW.txt,60115,61792,1677,10,N,N,-,-1,-1
GRONOW.txt,60451,62136,1685,10,N,N,-,-1,-1
GRONOW.txt,60501,62168,1667,10,N,N,-,-1,-1
GRONOW.txt,60602,62384,1782,10,N,N,-,-1,-1
GRONOW.txt,60826,62465,1639,10,N,N,-,-1,-1
GRONOW.txt,61054,62549,1495,10,N,N,-,-1,-1
GRONOW.txt,61072,62745,1673,10,N,N,-,-1,-1
GRONOW.txt,61198,63053,1855,10,N,N,-,-1,-1
GRONOW.txt,61326,63147,1821,10,N,N,-,-1,-1
GRONOW.txt,61520,63250,1730,10,N,N,-,-1,-1
GRONOW.txt,61793,63296,1503,10,N,N,-,-1,-1
GRONOW.txt,62137,63538,1401,10,N,N,-,-1,-1
GRONOW.txt,62169,63884,1715,10,N,N,-,-1,-1
GRONOW.txt,62387,63945,1558,10,N,N,-,-1,-1
GRONOW.txt,62466,64091,1625,10,N,N,-,-1,-1
GRONOW.txt,62550,64439,1889,10,N,N,-,-1,-1
GRONOW.txt,62746,64642,1896,10,N,N,-,-1,-1
GRONOW.txt,63054,64772,1718,10,N,N,-,-1,-1
GRONOW.txt,63148,64855,1707,10,N,N,-,-1,-1
GRONOW.txt,63251,64872,1621,10,N,N,-,-1,-1
GRONOW.txt,63297,65060,1763,10,N,N,-,-1,-1
GRONOW.txt,63539,65322,1783,10,N,N,-,-1,-1
GRONOW.txt,63889,65449,1560,10,N,N,-,-1,-1
GRONOW.txt,63946,65662,1716,10,N,N,-,-1,-1
GRONOW.txt,64094,65720,1626,10,N,N,-,-1,-1
GRONOW.txt,64440,65734,1294,10,N,N,-,-1,-1
GRONOW.txt,64644,65827,1183,10,N,N,-,-1,-1
GRONOW.txt,64773,65882,1109,10,N,N,-,-1,-1
GRONOW.txt,64858,65975,1117,10,N,N,-,-1,-1
GRONOW.txt,64873,66085,1212,10,N,N,-,-1,-1
GRONOW.txt,65061,66221,1160,10,N,N,-,-1,-1
GRONOW.txt,65323,66305,982,10,N,N,-,-1,-1
GRONOW.txt,65450,66460,1010,10,N,N,-,-1,-1
GRONOW.txt,65663,66472,809,10,N,N,-,-1,-1
GRONOW.txt,65721,66591,870,10,N,N,-,-1,-1
GRONOW.txt,65735,66676,941,10,N,N,-,-1,-1
GRONOW.txt,65828,66899,1071,10,N,N,-,-1,-1
GRONOW.txt,65883,67038,1155,10,N,N,-,-1,-1
GRONOW.txt,65976,67099,1123,10,N,N,-,-1,-1
GRONOW.txt,66086,67264,1178,10,N,N,-,-1,-1
GRONOW.txt,66222,67281,1059,10,N,N,-,-1,-1
GRONOW.txt,66306,67374,1068,10,N,N,-,-1,-1
GRONOW.txt,66463,67418,955,10,N,N,-,-1,-1
GRONOW.txt,66473,67471,998,10,N,N,-,-1,-1
GRONOW.txt,66592,67789,1197,10,N,N,-,-1,-1
GRONOW.txt,66677,67807,1130,10,N,N,-,-1,-1
GRONOW.txt,66900,67967,1067,10,N,N,-,-1,-1
GRONOW.txt,67039,68073,1034,10,N,N,-,-1,-1
GRONOW.txt,67102,68112,1010,10,N,N,-,-1,-1
GRONOW.txt,67267,68243,976,10,N,N,-,-1,-1
GRONOW.txt,67282,68314,1032,10,N,N,-,-1,-1
GRONOW.txt,67375,68448,1073,10,N,N,-,-1,-1
GRONOW.txt,67419,68575,1156,10,N,N,-,-1,-1
GRONOW.txt,67472,68609,1137,10,N,N,-,-1,-1
GRONOW.txt,67792,68660,868,10,N,N,-,-1,-1
GRONOW.txt,67808,68696,888,10,N,N,-,-1,-1
GRONOW.txt,67968,68728,760,10,N,N,-,-1,-1
GRONOW.txt,68074,68755,681,10,N,N,-,-1,-1
GRONOW.txt,68113,68797,684,10,N,N,-,-1,-1
GRONOW.txt,68245,68845,600,10,N,N,-,-1,-1
GRONOW.txt,68315,69046,731,10,N,N,-,-1,-1
GRONOW.txt,68449,69144,695,10,N,N,-,-1,-1
GRONOW.txt,68576,69460,884,10,N,N,-,-1,-1
GRONOW.txt,68610,69479,869,10,N,N,-,-1,-1
GRONOW.txt,68662,69645,983,10,N,N,-,-1,-1
GRONOW.txt,68697,69744,1047,10,N,N,-,-1,-1
GRONOW.txt,68729,69890,1161,10,N,N,-,-1,-1
GRONOW.txt,68756,70053,1297,10,N,N,-,-1,-1
GRONOW.txt,68798,70309,1511,10,N,N,-,-1,-1
GRONOW.txt,68846,70401,1555,10,N,N,-,-1,-1
GRONOW.txt,69047,70428,1381,10,N,N,-,-1,-1
GRONOW.txt,69145,70515,1370,10,N,N,-,-1,-1
GRONOW.txt,69463,70652,1189,10,N,N,-,-1,-1
GRONOW.txt,69480,70877,1397,10,N,N,-,-1,-1
GRONOW.txt,69646,70900,1254,10,N,N,-,-1,-1
GRONOW.txt,69745,71041,1296,10,N,N,-,-1,-1
GRONOW.txt,69891,71183,1292,10,N,N,-,-1,-1
GRONOW.txt,70054,71482,1428,10,N,N,-,-1,-1
GRONOW.txt,70310,71848,1538,10,N,N,-,-1,-1
GRONOW.txt,70404,71990,1586,10,N,N,-,-1,-1
GRONOW.txt,70429,72005,1576,10,N,N,-,-1,-1
GRONOW.txt,70516,72020,1504,10,N,N,-,-1,-1
GRONOW.txt,70653,72069,1416,10,N,N,-,-1,-1
GRONOW.txt,70880,72085,1205,10,N,N,-,-1,-1
GRONOW.txt,70901,72252,1351,10,N,N,-,-1,-1
GRONOW.txt,71042,72394,1352,10,N,N,-,-1,-1
GRONOW.txt,71184,72717,1533,10,N,N,-,-1,-1
GRONOW.txt,71485,72845,1360,10,N,N,-,-1,-1
GRONOW.txt,71849,72921,1072,10,N,N,-,-1,-1
GRONOW.txt,71993,72976,983,10,N,N,-,-1,-1
GRONOW.txt,72006,73004,998,10,N,N,-,-1,-1
GRONOW.txt,72021,73235,1214,10,N,N,-,-1,-1
GRONOW.txt,72070,73282,1212,10,N,N,-,-1,-1
GRONOW.txt,72086,73398,1312,10,N,N,-,-1,-1
GRONOW.txt,72253,73781,1528,10,N,N,-,-1,-1
GRONOW.txt,72395,74257,1862,10,N,N,-,-1,-1
GRONOW.txt,72718,74272,1554,10,N,N,-,-1,-1
GRONOW.txt,72846,74310,1464,10,N,N,-,-1,-1
GRONOW.txt,72922,74623,1701,10,N,N,-,-1,-1
GRONOW.txt,72979,74804,1825,10,N,N,-,-1,-1
GRONOW.txt,73004,74951,1947,10,N,N,-,-1,-1
GRONOW.txt,73236,75089,1853,10,N,N,-,-1,-1
GRONOW.txt,73283,75137,1854,10,N,N,-,-1,-1
GRONOW.txt,73399,75187,1788,10,N,N,-,-1,-1
GRONOW.txt,73782,75210,1428,10,N,N,-,-1,-1
GRONOW.txt,74260,75351,1091,10,N,N,-,-1,-1
GRONOW.txt,74273,75394,1121,10,N,N,-,-1,-1
GRONOW.txt,74311,75802,1491,10,N,N,-,-1,-1
GRONOW.txt,74624,75909,1285,10,N,N,-,-1,-1
GRONOW.txt,74805,76009,1204,10,N,N,-,-1,-1
GRONOW.txt,74952,76198,1246,10,N,N,-,-1,-1
GRONOW.txt,75090,76385,1295,10,N,N,-,-1,-1
GRONOW.txt,75138,76588,1450,10,N,N,-,-1,-1
GRONOW.txt,75190,76702,1512,10,N,N,-,-1,-1
GRONOW.txt,75211,76913,1702,10,N,N,-,-1,-1
GRONOW.txt,75352,77039,1687,10,N,N,-,-1,-1
GRONOW.txt,75395,77099,1704,10,N,N,-,-1,-1
GRONOW.txt,75803,77120,1317,10,N,N,-,-1,-1
GRONOW.txt,75910,77424,1514,10,N,N,-,-1,-1
GRONOW.txt,76010,77678,1668,10,N,N,-,-1,-1
GRONOW.txt,76201,77953,1752,10,N,N,-,-1,-1
GRONOW.txt,76386,78194,1808,10,N,N,-,-1,-1
GRONOW.txt,76589,78445,1856,10,N,N,-,-1,-1
GRONOW.txt,76704,78645,1941,10,N,N,-,-1,-1
GRONOW.txt,76916,78668,1752,10,N,N,-,-1,-1
GRONOW.txt,77044,78734,1690,10,N,N,-,-1,-1
GRONOW.txt,77102,78923,1821,10,N,N,-,-1,-1
GRONOW.txt,77121,79235,2114,10,N,N,-,-1,-1
GRONOW.txt,77427,79369,1942,10,N,N,-,-1,-1
GRONOW.txt,77679,79663,1984,10,N,N,-,-1,-1
GRONOW.txt,77956,79949,1993,10,N,N,-,-1,-1
GRONOW.txt,78195,80299,2104,10,N,N,-,-1,-1
GRONOW.txt,78447,80322,1875,10,N,N,-,-1,-1
GRONOW.txt,78650,80607,1957,10,N,N,-,-1,-1
GRONOW.txt,78669,80928,2259,10,N,N,-,-1,-1
GRONOW.txt,78735,81237,2502,10,N,N,-,-1,-1
GRONOW.txt,78925,81386,2461,10,N,N,-,-1,-1
GRONOW.txt,79238,81619,2381,10,N,N,-,-1,-1
GRONOW.txt,79370,81816,2446,10,N,N,-,-1,-1
GRONOW.txt,79664,82045,2381,10,N,N,-,-1,-1
GRONOW.txt,79952,82072,2120,10,N,N,-,-1,-1
GRONOW.txt,80304,82225,1921,10,N,N,-,-1,-1
GRONOW.txt,80327,82399,2072,10,N,N,-,-1,-1
GRONOW.txt,80608,82425,1817,10,N,N,-,-1,-1
GRONOW.txt,80931,82562,1631,10,N,N,-,-1,-1
GRONOW.txt,81238,82629,1391,10,N,N,-,-1,-1
GRONOW.txt,81387,82786,1399,10,N,N,-,-1,-1
GRONOW.txt,81620,82945,1325,10,N,N,-,-1,-1
GRONOW.txt,81818,83256,1438,10,N,N,-,-1,-1
GRONOW.txt,82046,83432,1386,10,N,N,-,-1,-1
GRONOW.txt,82073,83651,1578,10,N,N,-,-1,-1
GRONOW.txt,82226,83659,1433,10,N,N,-,-1,-1
GRONOW.txt,82402,83788,1386,10,N,N,-,-1,-1
GRONOW.txt,82426,84058,1632,10,N,N,-,-1,-1
GRONOW.txt,82563,84277,1714,10,N,N,-,-1,-1
GRONOW.txt,82630,84432,1802,10,N,N,-,-1,-1
GRONOW.txt,82787,84522,1735,10,N,N,-,-1,-1
GRONOW.txt,82948,84643,1695,10,N,N,-,-1,-1
GRONOW.txt,83259,84802,1543,10,N,N,-,-1,-1
GRONOW.txt,83433,85113,1680,10,N,N,-,-1,-1
GRONOW.txt,83654,85221,1567,10,N,N,-,-1,-1
GRONOW.txt,83660,85335,1675,10,N,N,-,-1,-1
GRONOW.txt,83789,85380,1591,10,N,N,-,-1,-1
GRONOW.txt,84059,85670,1611,10,N,N,-,-1,-1
GRONOW.txt,84278,85838,1560,10,N,N,-,-1,-1
GRONOW.txt,84433,86203,1770,10,N,N,-,-1,-1
GRONOW.txt,84523,86367,1844,10,N,N,-,-1,-1
GRONOW.txt,84644,86641,1997,10,N,N,-,-1,-1
GRONOW.txt,84803,86916,2113,10,N,N,-,-1,-1
GRONOW.txt,85116,87099,1983,10,N,N,-,-1,-1
GRONOW.txt,85222,87202,1980,10,N,N,-,-1,-1
GRONOW.txt,85336,87396,2060,10,N,N,-,-1,-1
GRONOW.txt,85381,87540,2159,10,N,N,-,-1,-1
GRONOW.txt,85671,87824,2153,10,N,N,-,-1,-1
GRONOW.txt,85839,87927,2088,10,N,N,-,-1,-1
GRONOW.txt,86206,88264,2058,10,N,N,-,-1,-1
GRONOW.txt,86368,88332,1964,10,N,N,-,-1,-1
GRONOW.txt,86642,88351,1709,10,N,N,-,-1,-1
GRONOW.txt,86918,88440,1522,10,N,N,-,-1,-1
GRONOW.txt,87104,88559,1455,10,N,N,-,-1,-1
GRONOW.txt,87203,88707,1504,10,N,N,-,-1,-1
GRONOW.txt,87399,88935,1536,10,N,N,-,-1,-1
GRONOW.txt,87541,89062,1521,10,N,N,-,-1,-1
GRONOW.txt,87825,89127,1302,10,N,N,-,-1,-1
GRONOW.txt,87928,89261,1333,10,N,N,-,-1,-1
GRONOW.txt,88265,89351,1086,10,N,N,-,-1,-1
GRONOW.txt,88335,89388,1053,10,N,N,-,-1,-1
GRONOW.txt,88352,89553,1201,10,N,N,-,-1,-1
GRONOW.txt,88441,89690,1249,10,N,N,-,-1,-1
GRONOW.txt,88560,89770,1210,10,N,N,-,-1,-1
GRONOW.txt,88708,90017,1309,10,N,N,-,-1,-1
GRONOW.txt,88936,90182,1246,10,N,N,-,-1,-1
GRONOW.txt,89065,90250,1185,10,N,N,-,-1,-1
GRONOW.txt,89128,90325,1197,10,N,N,-,-1,-1
GRONOW.txt,89263,90400,1137,10,N,N,-,-1,-1
GRONOW.txt,89352,90574,1222,10,N,N,-,-1,-1
GRONOW.txt,89389,90976,1587,10,N,N,-,-1,-1
GRONOW.txt,89554,91202,1648,10,N,N,-,-1,-1
GRONOW.txt,89691,91362,1671,10,N,N,-,-1,-1
GRONOW.txt,89771,91377,1606,10,N,N,-,-1,-1
GRONOW.txt,90018,91849,1831,10,N,N,-,-1,-1
GRONOW.txt,90185,92152,1967,10,N,N,-,-1,-1
GRONOW.txt,90251,92838,2587,10,N,N,-,-1,-1
GRONOW.txt,90326,93174,2848,10,N,N,-,-1,-1
GRONOW.txt,90401,93289,2888,10,N,N,-,-1,-1
GRONOW.txt,90576,93441,2865,10,N,N,-,-1,-1
GRONOW.txt,90979,93714,2735,10,N,N,-,-1,-1
GRONOW.txt,91203,93808,2605,10,N,N,-,-1,-1
GRONOW.txt,91363,93880,2517,10,N,N,-,-1,-1
GRONOW.txt,91378,94038,2660,10,N,N,-,-1,-1
GRONOW.txt,91850,94059,2209,10,N,N,-,-1,-1
GRONOW.txt,92157,94201,2044,10,N,N,-,-1,-1
GRONOW.txt,92841,94574,1733,10,N,N,-,-1,-1
GRONOW.txt,93175,94609,1434,10,N,N,-,-1,-1
GRONOW.txt,93290,94730,1440,10,N,N,-,-1,-1
GRONOW.txt,93442,94851,1409,10,N,N,-,-1,-1
GRONOW.txt,93715,95048,1333,10,N,N,-,-1,-1
GRONOW.txt,93809,95214,1405,10,N,N,-,-1,-1
GRONOW.txt,93885,95425,1540,10,N,N,-,-1,-1
GRONOW.txt,94041,95475,1434,10,N,N,-,-1,-1
GRONOW.txt,94060,95633,1573,10,N,N,-,-1,-1
GRONOW.txt,94202,95805,1603,10,N,N,-,-1,-1
GRONOW.txt,94579,95985,1406,10,N,N,-,-1,-1
GRONOW.txt,94610,96056,1446,10,N,N,-,-1,-1
GRONOW.txt,94732,96113,1381,10,N,N,-,-1,-1
GRONOW.txt,94852,96166,1314,10,N,N,-,-1,-1
GRONOW.txt,95051,96265,1214,10,N,N,-,-1,-1
GRONOW.txt,95215,96480,1265,10,N,N,-,-1,-1
GRONOW.txt,95426,96629,1203,10,N,N,-,-1,-1
GRONOW.txt,95476,96764,1288,10,N,N,-,-1,-1
GRONOW.txt,95635,96848,1213,10,N,N,-,-1,-1
GRONOW.txt,95806,97036,1230,10,N,N,-,-1,-1
GRONOW.txt,95988,97173,1185,10,N,N,-,-1,-1
GRONOW.txt,96057,97230,1173,10,N,N,-,-1,-1
GRONOW.txt,96114,97358,1244,10,N,N,-,-1,-1
GRONOW.txt,96167,97595,1428,10,N,N,-,-1,-1
GRONOW.txt,96266,97706,1440,10,N,N,-,-1,-1
GRONOW.txt,96481,97842,1361,10,N,N,-,-1,-1
GRONOW.txt,96630,98196,1566,10,N,N,-,-1,-1
GRONOW.txt,96765,98454,1689,10,N,N,-,-1,-1
GRONOW.txt,96849,98654,1805,10,N,N,-,-1,-1
GRONOW.txt,97037,98895,1858,10,N,N,-,-1,-1
GRONOW.txt,97178,98933,1755,10,N,N,-,-1,-1
GRONOW.txt,97232,98955,1723,10,N,Y,1437028092146,121457,123204
GRONOW.txt,97359,99462,2103,10,N,Y,1437028092146,121457,123204
GRONOW.txt,97598,99672,2074,10,N,Y,1437028092146,121457,123204
GRONOW.txt,97707,100067,2360,10,N,Y,1437028092146,121457,123204
GRONOW.txt,97843,100103,2260,10,N,Y,1437028092146,121457,123204
GRONOW.txt,98199,100264,2065,10,N,Y,1437028092146,121457,123204
GRONOW.txt,98456,100488,2032,10,N,Y,1437028092146,121457,123204
GRONOW.txt,98655,100610,1955,10,N,Y,1437028092146,121457,123204
GRONOW.txt,98900,100712,1812,10,N,Y,1437028092146,121457,123204
GRONOW.txt,98934,100807,1873,10,N,Y,1437028092146,121457,123204
GRONOW.txt,98956,100978,2022,10,N,Y,1437028092146,121457,123204
GRONOW.txt,99463,101155,1692,10,N,Y,1437028092146,121457,123204
GRONOW.txt,99673,101404,1731,10,N,Y,1437028092146,121457,123204
GRONOW.txt,100070,101477,1407,10,N,N,-,-1,-1
GRONOW.txt,100104,101779,1675,10,N,N,-,-1,-1
GRONOW.txt,100265,101814,1549,10,N,N,-,-1,-1
GRONOW.txt,100489,101980,1491,10,N,N,-,-1,-1
GRONOW.txt,100615,102292,1677,10,N,N,-,-1,-1
GRONOW.txt,100714,102490,1776,10,N,N,-,-1,-1
GRONOW.txt,100808,102587,1779,10,N,N,-,-1,-1
GRONOW.txt,100979,102808,1829,10,N,N,-,-1,-1
GRONOW.txt,101156,102983,1827,10,N,N,-,-1,-1
GRONOW.txt,101405,103003,1598,10,N,N,-,-1,-1
GRONOW.txt,101479,103254,1775,10,N,N,-,-1,-1
GRONOW.txt,101782,103462,1680,10,N,N,-,-1,-1
GRONOW.txt,101815,103525,1710,10,N,N,-,-1,-1
GRONOW.txt,101981,103667,1686,10,N,N,-,-1,-1
GRONOW.txt,102293,103732,1439,10,N,N,-,-1,-1
GRONOW.txt,102491,103813,1322,10,N,N,-,-1,-1
GRONOW.txt,102588,103946,1358,10,N,N,-,-1,-1
GRONOW.txt,102809,104003,1194,10,N,N,-,-1,-1
GRONOW.txt,102986,104361,1375,10,N,N,-,-1,-1
GRONOW.txt,103004,104495,1491,10,N,N,-,-1,-1
GRONOW.txt,103255,104753,1498,10,N,N,-,-1,-1
GRONOW.txt,103463,104878,1415,10,N,N,-,-1,-1
GRONOW.txt,103528,105126,1598,10,N,N,-,-1,-1
GRONOW.txt,103668,105371,1703,10,N,N,-,-1,-1
GRONOW.txt,103733,105512,1779,10,N,N,-,-1,-1
GRONOW.txt,103814,105761,1947,10,N,N,-,-1,-1
GRONOW.txt,103947,105977,2030,10,N,N,-,-1,-1
GRONOW.txt,104008,106209,2201,10,N,N,-,-1,-1
GRONOW.txt,104364,106382,2018,10,N,N,-,-1,-1
GRONOW.txt,104496,106620,2124,10,N,N,-,-1,-1
GRONOW.txt,104754,106843,2089,10,N,N,-,-1,-1
GRONOW.txt,104879,106964,2085,10,N,N,-,-1,-1
GRONOW.txt,105127,107128,2001,10,N,N,-,-1,-1
GRONOW.txt,105373,107494,2121,10,N,N,-,-1,-1
GRONOW.txt,105513,107570,2057,10,N,N,-,-1,-1
GRONOW.txt,105762,107795,2033,10,N,N,-,-1,-1
GRONOW.txt,105980,107938,1958,10,N,N,-,-1,-1
GRONOW.txt,106210,108059,1849,10,N,N,-,-1,-1
GRONOW.txt,106383,108181,1798,10,N,N,-,-1,-1
GRONOW.txt,106621,108342,1721,10,N,N,-,-1,-1
GRONOW.txt,106844,108572,1728,10,N,N,-,-1,-1
GRONOW.txt,106965,108636,1671,10,N,N,-,-1,-1
GRONOW.txt,107129,108919,1790,10,N,N,-,-1,-1
GRONOW.txt,107499,109138,1639,10,N,N,-,-1,-1
GRONOW.txt,107571,109201,1630,10,N,N,-,-1,-1
GRONOW.txt,107798,109309,1511,10,N,N,-,-1,-1
GRONOW.txt,107940,109529,1589,10,N,N,-,-1,-1
GRONOW.txt,108060,109825,1765,10,N,N,-,-1,-1
GRONOW.txt,108183,109895,1712,10,N,N,-,-1,-1
GRONOW.txt,108343,110007,1664,10,N,N,-,-1,-1
GRONOW.txt,108573,110401,1828,10,N,N,-,-1,-1
GRONOW.txt,108639,110640,2001,10,N,N,-,-1,-1
GRONOW.txt,108920,110769,1849,10,N,N,-,-1,-1
GRONOW.txt,109139,110780,1641,10,N,N,-,-1,-1
GRONOW.txt,109204,110841,1637,10,N,N,-,-1,-1
GRONOW.txt,109310,111251,1941,10,N,N,-,-1,-1
GRONOW.txt,109530,111531,2001,10,N,N,-,-1,-1
GRONOW.txt,109828,112026,2198,10,N,N,-,-1,-1
GRONOW.txt,109896,112303,2407,10,N,N,-,-1,-1
GRONOW.txt,110008,112495,2487,10,N,N,-,-1,-1
GRONOW.txt,110402,112773,2371,10,N,N,-,-1,-1
GRONOW.txt,110643,113114,2471,10,N,N,-,-1,-1
GRONOW.txt,110772,113256,2484,10,N,N,-,-1,-1
GRONOW.txt,110781,113479,2698,10,N,N,-,-1,-1
GRONOW.txt,110842,113633,2791,10,N,N,-,-1,-1
GRONOW.txt,111252,113701,2449,10,N,N,-,-1,-1
GRONOW.txt,111532,114009,2477,10,N,N,-,-1,-1
GRONOW.txt,112029,114064,2035,10,N,N,-,-1,-1
GRONOW.txt,112304,114151,1847,10,N,N,-,-1,-1
GRONOW.txt,112496,114185,1689,10,N,N,-,-1,-1
GRONOW.txt,112774,114214,1440,10,N,N,-,-1,-1
GRONOW.txt,113117,114333,1216,10,N,N,-,-1,-1
GRONOW.txt,113257,114486,1229,10,N,N,-,-1,-1
GRONOW.txt,113480,114605,1125,10,N,N,-,-1,-1
GRONOW.txt,113636,114778,1142,10,N,N,-,-1,-1
GRONOW.txt,113702,115132,1430,10,N,N,-,-1,-1
GRONOW.txt,114010,115178,1168,10,N,N,-,-1,-1
GRONOW.txt,114065,115257,1192,10,N,N,-,-1,-1
GRONOW.txt,114156,115340,1184,10,N,N,-,-1,-1
GRONOW.txt,114188,115543,1355,10,N,N,-,-1,-1
GRONOW.txt,114215,115901,1686,10,N,N,-,-1,-1
GRONOW.txt,114334,115932,1598,10,N,N,-,-1,-1
GRONOW.txt,114489,116324,1835,10,N,N,-,-1,-1
GRONOW.txt,114606,116495,1889,10,N,N,-,-1,-1
GRONOW.txt,114779,116989,2210,10,N,N,-,-1,-1
GRONOW.txt,115135,117185,2050,10,N,N,-,-1,-1
GRONOW.txt,115179,117347,2168,10,N,N,-,-1,-1
GRONOW.txt,115258,117519,2261,10,N,N,-,-1,-1
GRONOW.txt,115342,117633,2291,10,N,N,-,-1,-1
GRONOW.txt,115545,117670,2125,10,N,N,-,-1,-1
GRONOW.txt,115906,117953,2047,10,N,N,-,-1,-1
GRONOW.txt,115933,118156,2223,10,N,N,-,-1,-1
GRONOW.txt,116327,118738,2411,10,N,N,-,-1,-1
GRONOW.txt,116498,119001,2503,10,N,N,-,-1,-1
GRONOW.txt,116992,119325,2333,10,N,N,-,-1,-1
GRONOW.txt,117188,119431,2243,10,N,N,-,-1,-1
GRONOW.txt,117348,119506,2158,10,N,N,-,-1,-1
GRONOW.txt,117520,119601,2081,10,N,N,-,-1,-1
GRONOW.txt,117636,119823,2187,10,N,N,-,-1,-1
GRONOW.txt,117671,120011,2340,10,N,N,-,-1,-1
GRONOW.txt,117955,120136,2181,10,N,N,-,-1,-1
GRONOW.txt,118157,120290,2133,10,N,N,-,-1,-1
GRONOW.txt,118741,120384,1643,10,N,N,-,-1,-1
GRONOW.txt,119002,120642,1640,10,N,N,-,-1,-1
GRONOW.txt,119326,120687,1361,10,N,N,-,-1,-1
GRONOW.txt,119434,120781,1347,10,N,N,-,-1,-1
GRONOW.txt,119507,120938,1431,10,N,N,-,-1,-1
GRONOW.txt,119602,121072,1470,10,N,N,-,-1,-1
GRONOW.txt,119824,121223,1399,10,N,N,-,-1,-1
GRONOW.txt,120012,121446,1434,10,N,N,-,-1,-1
GRONOW.txt,120139,121520,1381,10,N,N,-,-1,-1
GRONOW.txt,120292,121792,1500,10,N,N,-,-1,-1
GRONOW.txt,120385,121869,1484,10,N,N,-,-1,-1
GRONOW.txt,120643,122132,1489,10,N,N,-,-1,-1
GRONOW.txt,120688,122260,1572,10,N,N,-,-1,-1
GRONOW.txt,120782,122292,1510,10,N,N,-,-1,-1
GRONOW.txt,120941,122453,1512,10,N,N,-,-1,-1
GRONOW.txt,121075,122615,1540,10,N,N,-,-1,-1
GRONOW.txt,121225,122738,1513,10,N,N,-,-1,-1
GRONOW.txt,121449,122767,1318,10,N,N,-,-1,-1
GRONOW.txt,121521,123031,1510,10,N,N,-,-1,-1
GRONOW.txt,121795,123050,1255,10,N,N,-,-1,-1
GRONOW.txt,121870,123266,1396,10,N,N,-,-1,-1
GRONOW.txt,122133,123388,1255,10,N,N,-,-1,-1
GRONOW.txt,122261,123633,1372,10,N,N,-,-1,-1
GRONOW.txt,122294,123734,1440,10,N,N,-,-1,-1
GRONOW.txt,122454,123792,1338,10,N,N,-,-1,-1
GRONOW.txt,122616,123963,1347,10,N,N,-,-1,-1
GRONOW.txt,122739,124214,1475,10,N,N,-,-1,-1
GRONOW.txt,122768,124256,1488,10,N,N,-,-1,-1
GRONOW.txt,123034,124363,1329,10,N,N,-,-1,-1
GRONOW.txt,123051,124425,1374,10,N,N,-,-1,-1
GRONOW.txt,123267,124454,1187,10,N,N,-,-1,-1
GRONOW.txt,123389,124489,1100,10,N,N,-,-1,-1
GRONOW.txt,123636,124639,1003,10,N,N,-,-1,-1
GRONOW.txt,123736,124660,924,10,N,N,-,-1,-1
GRONOW.txt,123793,124863,1070,10,N,N,-,-1,-1
GRONOW.txt,123964,124986,1022,10,N,N,-,-1,-1
GRONOW.txt,124215,125056,841,10,N,N,-,-1,-1
GRONOW.txt,124257,125212,955,10,N,N,-,-1,-1
GRONOW.txt,124368,125787,1419,10,N,N,-,-1,-1
GRONOW.txt,124428,126025,1597,10,N,N,-,-1,-1
GRONOW.txt,124455,126158,1703,10,N,N,-,-1,-1
GRONOW.txt,124490,126251,1761,10,N,N,-,-1,-1
GRONOW.txt,124640,126405,1765,10,N,N,-,-1,-1
GRONOW.txt,124661,126582,1921,10,N,N,-,-1,-1
GRONOW.txt,124864,126605,1741,10,N,N,-,-1,-1
GRONOW.txt,124989,126907,1918,10,N,N,-,-1,-1
GRONOW.txt,125057,126994,1937,10,N,N,-,-1,-1
GRONOW.txt,125213,127295,2082,10,N,N,-,-1,-1
GRONOW.txt,125790,127657,1867,10,N,N,-,-1,-1
GRONOW.txt,126026,127710,1684,10,N,N,-,-1,-1
GRONOW.txt,126159,127848,1689,10,N,N,-,-1,-1
GRONOW.txt,126252,127983,1731,10,N,N,-,-1,-1
GRONOW.txt,126406,128121,1715,10,N,N,-,-1,-1
GRONOW.txt,126585,128262,1677,10,N,N,-,-1,-1
GRONOW.txt,126606,128585,1979,10,N,N,-,-1,-1
GRONOW.txt,126908,128832,1924,10,N,N,-,-1,-1
GRONOW.txt,126995,128942,1947,10,N,N,-,-1,-1
GRONOW.txt,127296,129283,1987,10,N,N,-,-1,-1
GRONOW.txt,127662,129471,1809,10,N,N,-,-1,-1
GRONOW.txt,127715,129597,1882,10,N,N,-,-1,-1
GRONOW.txt,127849,129671,1822,10,N,N,-,-1,-1
GRONOW.txt,127984,129912,1928,10,N,N,-,-1,-1
GRONOW.txt,128122,130156,2034,10,N,N,-,-1,-1
GRONOW.txt,128264,130350,2086,10,N,N,-,-1,-1
GRONOW.txt,128586,130481,1895,10,N,N,-,-1,-1
GRONOW.txt,128833,130697,1864,10,N,N,-,-1,-1
GRONOW.txt,128943,131089,2146,10,N,N,-,-1,-1
GRONOW.txt,129286,131183,1897,10,N,N,-,-1,-1
GRONOW.txt,129472,131348,1876,10,N,N,-,-1,-1
GRONOW.txt,129598,131401,1803,10,N,N,-,-1,-1
GRONOW.txt,129671,131806,2135,10,N,N,-,-1,-1
GRONOW.txt,129915,131967,2052,10,N,N,-,-1,-1
GRONOW.txt,130157,132151,1994,10,N,N,-,-1,-1
GRONOW.txt,130351,132465,2114,10,N,N,-,-1,-1
GRONOW.txt,130482,132822,2340,10,N,N,-,-1,-1
GRONOW.txt,130698,132964,2266,10,N,N,-,-1,-1
GRONOW.txt,131092,133066,1974,10,N,N,-,-1,-1
GRONOW.txt,131186,133439,2253,10,N,N,-,-1,-1
GRONOW.txt,131349,133522,2173,10,N,N,-,-1,-1
GRONOW.txt,131402,133834,2432,10,N,N,-,-1,-1
GRONOW.txt,131808,134014,2206,10,N,N,-,-1,-1
GRONOW.txt,131968,134113,2145,10,N,N,-,-1,-1
GRONOW.txt,132152,134520,2368,10,N,N,-,-1,-1
GRONOW.txt,132467,134657,2190,10,N,N,-,-1,-1
GRONOW.txt,132825,134719,1894,10,N,N,-,-1,-1
GRONOW.txt,132965,134756,1791,10,N,N,-,-1,-1
GRONOW.txt,133067,134992,1925,10,N,N,-,-1,-1
GRONOW.txt,133441,135150,1709,10,N,N,-,-1,-1
GRONOW.txt,133523,135184,1661,10,N,N,-,-1,-1
GRONOW.txt,133837,135261,1424,10,N,N,-,-1,-1
GRONOW.txt,134017,135371,1354,10,N,N,-,-1,-1
GRONOW.txt,134114,135722,1608,10,N,N,-,-1,-1
GRONOW.txt,134523,135827,1304,10,N,N,-,-1,-1
GRONOW.txt,134662,136352,1690,10,N,N,-,-1,-1
GRONOW.txt,134720,136394,1674,10,N,N,-,-1,-1
GRONOW.txt,134758,136608,1850,10,N,N,-,-1,-1
GRONOW.txt,134993,136639,1646,10,N,N,-,-1,-1
GRONOW.txt,135153,136835,1682,10,N,N,-,-1,-1
GRONOW.txt,135185,136887,1702,10,N,N,-,-1,-1
GRONOW.txt,135262,137042,1780,10,N,N,-,-1,-1
GRONOW.txt,135372,137116,1744,10,N,N,-,-1,-1
GRONOW.txt,135723,137186,1463,10,N,N,-,-1,-1
GRONOW.txt,135828,137246,1418,10,N,N,-,-1,-1
GRONOW.txt,136353,137326,973,10,N,N,-,-1,-1
GRONOW.txt,136395,137405,1010,10,N,N,-,-1,-1
GRONOW.txt,136611,137521,910,10,N,N,-,-1,-1
GRONOW.txt,136640,137743,1103,10,N,N,-,-1,-1
GRONOW.txt,136836,137865,1029,10,N,N,-,-1,-1
GRONOW.txt,136888,137890,1002,10,N,N,-,-1,-1
GRONOW.txt,137043,138053,1010,10,N,N,-,-1,-1
GRONOW.txt,137117,138092,975,10,N,N,-,-1,-1
GRONOW.txt,137187,138367,1180,10,N,N,-,-1,-1
GRONOW.txt,137247,138498,1251,10,N,N,-,-1,-1
GRONOW.txt,137327,138955,1628,10,N,N,-,-1,-1
GRONOW.txt,137407,139092,1685,10,N,N,-,-1,-1
GRONOW.txt,137522,139156,1634,10,N,N,-,-1,-1
GRONOW.txt,137744,139206,1462,10,N,N,-,-1,-1
GRONOW.txt,137866,139306,1440,10,N,N,-,-1,-1
GRONOW.txt,137891,139414,1523,10,N,N,-,-1,-1
GRONOW.txt,138058,139468,1410,10,N,N,-,-1,-1
GRONOW.txt,138095,139672,1577,10,N,N,-,-1,-1
GRONOW.txt,138368,139777,1409,10,N,N,-,-1,-1
GRONOW.txt,138499,139833,1334,10,N,N,-,-1,-1
GRONOW.txt,138956,139856,900,10,N,N,-,-1,-1
GRONOW.txt,139094,139967,873,10,N,N,-,-1,-1
GRONOW.txt,139157,139995,838,10,N,N,-,-1,-1
GRONOW.txt,139207,140114,907,10,N,N,-,-1,-1
GRONOW.txt,139307,140239,932,10,N,N,-,-1,-1
GRONOW.txt,139415,140481,1066,10,N,N,-,-1,-1
GRONOW.txt,139469,140544,1075,10,N,N,-,-1,-1
GRONOW.txt,139673,140697,1024,10,N,N,-,-1,-1
GRONOW.txt,139778,140822,1044,10,N,N,-,-1,-1
GRONOW.txt,139834,141105,1271,10,N,N,-,-1,-1
GRONOW.txt,139857,141220,1363,10,N,N,-,-1,-1
GRONOW.txt,139970,141565,1595,10,N,N,-,-1,-1
GRONOW.txt,139996,141682,1686,10,N,N,-,-1,-1
GRONOW.txt,140115,141874,1759,10,N,N,-,-1,-1
GRONOW.txt,140240,142206,1966,10,N,N,-,-1,-1
GRONOW.txt,140482,142565,2083,10,N,N,-,-1,-1
GRONOW.txt,140546,142732,2186,10,N,N,-,-1,-1
GRONOW.txt,140698,142993,2295,10,N,N,-,-1,-1
GRONOW.txt,140823,143180,2357,10,N,N,-,-1,-1
GRONOW.txt,141106,143202,2096,10,N,N,-,-1,-1
GRONOW.txt,141221,143243,2022,10,N,N,-,-1,-1
GRONOW.txt,141566,143338,1772,10,N,N,-,-1,-1
GRONOW.txt,141683,143602,1919,10,N,N,-,-1,-1
GRONOW.txt,141875,143636,1761,10,N,N,-,-1,-1
GRONOW.txt,142207,143738,1531,10,N,N,-,-1,-1
GRONOW.txt,142566,144042,1476,10,N,N,-,-1,-1
GRONOW.txt,142735,144199,1464,10,N,N,-,-1,-1
GRONOW.txt,142995,144317,1322,10,N,N,-,-1,-1
GRONOW.txt,143183,144337,1154,10,N,N,-,-1,-1
GRONOW.txt,143203,144513,1310,10,N,N,-,-1,-1
GRONOW.txt,143244,144705,1461,10,N,N,-,-1,-1
GRONOW.txt,143339,144799,1460,10,N,N,-,-1,-1
GRONOW.txt,143605,144819,1214,10,N,N,-,-1,-1
GRONOW.txt,143637,144849,1212,10,N,N,-,-1,-1
GRONOW.txt,143739,145152,1413,10,N,N,-,-1,-1
GRONOW.txt,144043,145391,1348,10,N,N,-,-1,-1
GRONOW.txt,144201,145751,1550,10,N,N,-,-1,-1
GRONOW.txt,144320,145972,1652,10,N,N,-,-1,-1
GRONOW.txt,144338,146099,1761,10,N,N,-,-1,-1
GRONOW.txt,144514,146251,1737,10,N,N,-,-1,-1
GRONOW.txt,144708,146377,1669,10,N,N,-,-1,-1
GRONOW.txt,144801,146519,1718,10,N,N,-,-1,-1
GRONOW.txt,144822,146541,1719,10,N,N,-,-1,-1
GRONOW.txt,144852,146628,1776,10,N,N,-,-1,-1
GRONOW.txt,145155,146811,1656,10,N,N,-,-1,-1
GRONOW.txt,145392,147503,2111,10,N,N,-,-1,-1
GRONOW.txt,145753,147540,1787,10,N,N,-,-1,-1
GRONOW.txt,145975,147742,1767,10,N,N,-,-1,-1
GRONOW.txt,146100,147915,1815,10,N,N,-,-1,-1
GRONOW.txt,146252,148047,1795,10,N,N,-,-1,-1
GRONOW.txt,146378,148264,1886,10,N,N,-,-1,-1
GRONOW.txt,146524,148285,1761,10,N,N,-,-1,-1
GRONOW.txt,146542,148465,1923,10,N,N,-,-1,-1
GRONOW.txt,146629,148877,2248,10,N,N,-,-1,-1
GRONOW.txt,146812,149151,2339,10,N,N,-,-1,-1
GRONOW.txt,147504,149690,2186,10,N,N,-,-1,-1
GRONOW.txt,147541,149897,2356,10,N,N,-,-1,-1
GRONOW.txt,147745,149994,2249,10,N,N,-,-1,-1
GRONOW.txt,147916,150336,2420,10,N,N,-,-1,-1
GRONOW.txt,148048,150558,2510,10,N,N,-,-1,-1
GRONOW.txt,148269,151038,2769,10,N,N,-,-1,-1
GRONOW.txt,148286,151064,2778,10,N,N,-,-1,-1
GRONOW.txt,148468,151352,2884,10,N,N,-,-1,-1
GRONOW.txt,148879,151375,2496,10,N,N,-,-1,-1
GRONOW.txt,149152,151473,2321,10,N,N,-,-1,-1
GRONOW.txt,149693,151502,1809,10,N,N,-,-1,-1
GRONOW.txt,149898,151715,1817,10,N,N,-,-1,-1
GRONOW.txt,149995,152070,2075,10,N,N,-,-1,-1
GRONOW.txt,150339,152095,1756,10,N,N,-,-1,-1
GRONOW.txt,150559,152215,1656,10,N,N,-,-1,-1
GRONOW.txt,151041,152355,1314,10,N,N,-,-1,-1
GRONOW.txt,151065,152456,1391,10,N,N,-,-1,-1
GRONOW.txt,151353,153192,1839,10,N,N,-,-1,-1
GRONOW.txt,151376,153309,1933,10,N,N,-,-1,-1
GRONOW.txt,151474,153378,1904,10,N,N,-,-1,-1
GRONOW.txt,151503,153628,2125,10,N,N,-,-1,-1
GRONOW.txt,151720,153792,2072,10,N,N,-,-1,-1
GRONOW.txt,152075,154190,2115,10,N,N,-,-1,-1
GRONOW.txt,152096,154642,2546,10,N,N,-,-1,-1
GRONOW.txt,152216,154786,2570,10,N,N,-,-1,-1
GRONOW.txt,152356,154940,2584,10,N,N,-,-1,-1
GRONOW.txt,152459,154974,2515,10,N,N,-,-1,-1
GRONOW.txt,153193,155006,1813,10,N,N,-,-1,-1
GRONOW.txt,153311,155067,1756,10,N,N,-,-1,-1
GRONOW.txt,153379,155409,2030,10,N,N,-,-1,-1
GRONOW.txt,153629,155736,2107,10,N,N,-,-1,-1
GRONOW.txt,153795,155858,2063,10,N,N,-,-1,-1
GRONOW.txt,154192,156002,1810,10,N,N,-,-1,-1
GRONOW.txt,154644,156161,1517,10,N,N,-,-1,-1
GRONOW.txt,154789,156275,1486,10,N,N,-,-1,-1
GRONOW.txt,154942,156405,1463,10,N,N,-,-1,-1
GRONOW.txt,154975,156656,1681,10,N,N,-,-1,-1
GRONOW.txt,155007,156835,1828,10,N,N,-,-1,-1
GRONOW.txt,155072,156900,1828,10,N,N,-,-1,-1
GRONOW.txt,155410,157327,1917,10,N,N,-,-1,-1
GRONOW.txt,155739,157564,1825,10,N,N,-,-1,-1
GRONOW.txt,155859,157769,1910,10,N,N,-,-1,-1
GRONOW.txt,156003,157784,1781,10,N,N,-,-1,-1
GRONOW.txt,156162,157885,1723,10,N,N,-,-1,-1
GRONOW.txt,156276,158202,1926,10,N,N,-,-1,-1
GRONOW.txt,156407,158344,1937,10,N,N,-,-1,-1
GRONOW.txt,156659,158485,1826,10,N,N,-,-1,-1
GRONOW.txt,156836,158611,1775,10,N,N,-,-1,-1
GRONOW.txt,156901,158808,1907,10,N,N,-,-1,-1
GRONOW.txt,157328,158902,1574,10,N,N,-,-1,-1
GRONOW.txt,157567,159172,1605,10,N,N,-,-1,-1
GRONOW.txt,157772,159477,1705,10,N,N,-,-1,-1
GRONOW.txt,157785,159888,2103,10,N,N,-,-1,-1
GRONOW.txt,157886,159986,2100,10,N,N,-,-1,-1
GRONOW.txt,158203,160139,1936,10,N,N,-,-1,-1
GRONOW.txt,158345,160156,1811,10,N,N,-,-1,-1
GRONOW.txt,158488,160321,1833,10,N,N,-,-1,-1
GRONOW.txt,158612,160390,1778,10,N,N,-,-1,-1
GRONOW.txt,158811,160560,1749,10,N,N,-,-1,-1
GRONOW.txt,158903,160736,1833,10,N,N,-,-1,-1
GRONOW.txt,159173,160857,1684,10,N,N,-,-1,-1
GRONOW.txt,159478,161185,1707,10,N,N,-,-1,-1
GRONOW.txt,159889,161260,1371,10,N,N,-,-1,-1
GRONOW.txt,159987,161471,1484,10,N,N,-,-1,-1
GRONOW.txt,160144,161704,1560,10,N,N,-,-1,-1
GRONOW.txt,160157,161868,1711,10,N,N,-,-1,-1
GRONOW.txt,160323,162080,1757,10,N,N,-,-1,-1
GRONOW.txt,160391,162459,2068,10,N,N,-,-1,-1
GRONOW.txt,160563,162552,1989,10,N,N,-,-1,-1
GRONOW.txt,160737,162671,1934,10,N,N,-,-1,-1
GRONOW.txt,160858,162829,1971,10,N,N,-,-1,-1
GRONOW.txt,161186,162878,1692,10,N,N,-,-1,-1
GRONOW.txt,161261,163000,1739,10,N,N,-,-1,-1
GRONOW.txt,161472,163144,1672,10,N,N,-,-1,-1
GRONOW.txt,161707,163234,1527,10,N,N,-,-1,-1
GRONOW.txt,161873,163536,1663,10,N,N,-,-1,-1
GRONOW.txt,162082,163564,1482,10,N,N,-,-1,-1
GRONOW.txt,162460,163949,1489,10,N,N,-,-1,-1
GRONOW.txt,162553,163966,1413,10,N,N,-,-1,-1
GRONOW.txt,162674,164260,1586,10,N,N,-,-1,-1
GRONOW.txt,162832,164540,1708,10,N,N,-,-1,-1
GRONOW.txt,162880,164643,1763,10,N,N,-,-1,-1
GRONOW.txt,163001,164846,1845,10,N,N,-,-1,-1
GRONOW.txt,163145,165071,1926,10,N,N,-,-1,-1
GRONOW.txt,163236,165221,1985,10,N,N,-,-1,-1
GRONOW.txt,163537,165374,1837,10,N,N,-,-1,-1
GRONOW.txt,163565,165510,1945,10,N,N,-,-1,-1
GRONOW.txt,163952,165698,1746,10,N,N,-,-1,-1
GRONOW.txt,163967,165944,1977,10,N,N,-,-1,-1
GRONOW.txt,164261,166105,1844,10,N,N,-,-1,-1
GRONOW.txt,164541,166568,2027,10,N,N,-,-1,-1
GRONOW.txt,164644,166666,2022,10,N,N,-,-1,-1
GRONOW.txt,164849,166980,2131,10,N,N,-,-1,-1
GRONOW.txt,165072,167050,1978,10,N,N,-,-1,-1
GRONOW.txt,165224,167111,1887,10,N,N,-,-1,-1
GRONOW.txt,165376,167337,1961,10,N,N,-,-1,-1
GRONOW.txt,165511,167458,1947,10,N,N,-,-1,-1
GRONOW.txt,165699,167644,1945,10,N,N,-,-1,-1
GRONOW.txt,165945,167703,1758,10,N,N,-,-1,-1
GRONOW.txt,166108,167785,1677,10,N,N,-,-1,-1
GRONOW.txt,166569,167961,1392,10,N,N,-,-1,-1
GRONOW.txt,166669,168340,1671,10,N,N,-,-1,-1
GRONOW.txt,166981,168389,1408,10,N,N,-,-1,-1
GRONOW.txt,167051,168601,1550,10,N,N,-,-1,-1
GRONOW.txt,167112,169063,1951,10,N,N,-,-1,-1
GRONOW.txt,167339,169079,1740,10,N,N,-,-1,-1
GRONOW.txt,167459,169207,1748,10,N,N,-,-1,-1
GRONOW.txt,167645,169404,1759,10,N,N,-,-1,-1
GRONOW.txt,167704,169531,1827,10,N,N,-,-1,-1
GRONOW.txt,167788,169670,1882,10,N,N,-,-1,-1
GRONOW.txt,167962,169820,1858,10,N,N,-,-1,-1
GRONOW.txt,168342,169939,1597,10,N,N,-,-1,-1
GRONOW.txt,168391,169986,1595,10,N,N,-,-1,-1
GRONOW.txt,168602,170023,1421,10,N,N,-,-1,-1
GRONOW.txt,169066,170075,1009,10,N,N,-,-1,-1
GRONOW.txt,169080,170287,1207,10,N,N,-,-1,-1
GRONOW.txt,169208,170421,1213,10,N,N,-,-1,-1
GRONOW.txt,169405,170686,1281,10,N,N,-,-1,-1
GRONOW.txt,169532,170846,1314,10,N,N,-,-1,-1
GRONOW.txt,169672,171309,1637,10,N,N,-,-1,-1
GRONOW.txt,169822,171690,1868,10,N,N,-,-1,-1
GRONOW.txt,169940,171955,2015,10,Y,N,-,-1,-1
GRONOW.txt,169987,172167,2180,10,Y,N,-,-1,-1
GRONOW.txt,170024,172192,2168,10,Y,N,-,-1,-1
GRONOW.txt,170076,172458,2382,10,Y,N,-,-1,-1
GRONOW.txt,170288,172902,2614,10,Y,N,-,-1,-1
GRONOW.txt,170422,173244,2822,10,Y,N,-,-1,-1
GRONOW.txt,170689,173562,2873,10,Y,N,-,-1,-1
GRONOW.txt,170847,173579,2732,10,Y,N,-,-1,-1
GRONOW.txt,171310,173750,2440,10,N,N,-,-1,-1
GRONOW.txt,171691,173879,2188,10,N,N,-,-1,-1
GRONOW.txt,171956,174043,2087,10,N,N,-,-1,-1
GRONOW.txt,172170,174365,2195,10,N,N,-,-1,-1
GRONOW.txt,172197,174613,2416,10,N,N,-,-1,-1
GRONOW.txt,172460,174779,2319,10,N,N,-,-1,-1
GRONOW.txt,172903,175104,2201,10,N,N,-,-1,-1
GRONOW.txt,173245,175392,2147,10,N,N,-,-1,-1
GRONOW.txt,173565,175469,1904,10,N,N,-,-1,-1
GRONOW.txt,173580,175572,1992,10,N,N,-,-1,-1
GRONOW.txt,173751,175594,1843,10,N,N,-,-1,-1
GRONOW.txt,173880,175736,1856,10,N,N,-,-1,-1
GRONOW.txt,174044,175986,1942,10,N,N,-,-1,-1
GRONOW.txt,174368,176629,2261,10,N,N,-,-1,-1
GRONOW.txt,174614,176744,2130,10,N,N,-,-1,-1
GRONOW.txt,174781,176910,2129,10,N,N,-,-1,-1
GRONOW.txt,175105,177243,2138,10,N,N,-,-1,-1
GRONOW.txt,175392,177302,1910,10,N,N,-,-1,-1
GRONOW.txt,175470,177468,1998,10,N,N,-,-1,-1
GRONOW.txt,175577,177657,2080,10,N,N,-,-1,-1
GRONOW.txt,175599,177917,2318,10,N,N,-,-1,-1
GRONOW.txt,175737,178168,2431,10,N,N,-,-1,-1
GRONOW.txt,175989,178185,2196,10,N,N,-,-1,-1
GRONOW.txt,176632,178414,1782,10,N,N,-,-1,-1
GRONOW.txt,176745,178471,1726,10,N,N,-,-1,-1
GRONOW.txt,176911,178553,1642,10,N,N,-,-1,-1
GRONOW.txt,177244,178575,1331,10,N,N,-,-1,-1
GRONOW.txt,177303,178680,1377,10,N,N,-,-1,-1
GRONOW.txt,177469,178880,1411,10,N,N,-,-1,-1
GRONOW.txt,177659,178899,1240,10,N,N,-,-1,-1
GRONOW.txt,177918,179149,1231,10,N,N,-,-1,-1
GRONOW.txt,178171,179165,994,10,N,N,-,-1,-1
GRONOW.txt,178186,179270,1084,10,N,N,-,-1,-1
GRONOW.txt,178416,179433,1017,10,N,N,-,-1,-1
GRONOW.txt,178472,179483,1011,10,N,N,-,-1,-1
GRONOW.txt,178556,179657,1101,10,N,N,-,-1,-1
GRONOW.txt,178576,179901,1325,10,N,N,-,-1,-1
GRONOW.txt,178681,180038,1357,10,N,N,-,-1,-1
GRONOW.txt,178885,180273,1388,10,N,N,-,-1,-1
GRONOW.txt,178900,180363,1463,10,N,N,-,-1,-1
GRONOW.txt,179152,180437,1285,10,N,N,-,-1,-1
GRONOW.txt,179166,180543,1377,10,N,N,-,-1,-1
GRONOW.txt,179271,180639,1368,10,N,N,-,-1,-1
GRONOW.txt,179434,180835,1401,10,N,N,-,-1,-1
GRONOW.txt,179484,181047,1563,10,N,N,-,-1,-1
GRONOW.txt,179659,181413,1754,10,N,N,-,-1,-1
GRONOW.txt,179902,181458,1556,10,N,N,-,-1,-1
GRONOW.txt,180039,181709,1670,10,N,N,-,-1,-1
GRONOW.txt,180275,181983,1708,10,N,N,-,-1,-1
GRONOW.txt,180364,181989,1625,10,N,N,-,-1,-1
GRONOW.txt,180438,182087,1649,10,N,N,-,-1,-1
GRONOW.txt,180544,182104,1560,10,N,N,-,-1,-1
GRONOW.txt,180642,182200,1558,10,N,N,-,-1,-1
GRONOW.txt,180837,182269,1432,10,N,N,-,-1,-1
GRONOW.txt,181048,182430,1382,10,N,N,-,-1,-1
GRONOW.txt,181414,182625,1211,10,N,N,-,-1,-1
GRONOW.txt,181459,182861,1402,10,N,N,-,-1,-1
GRONOW.txt,181710,183020,1310,10,N,N,-,-1,-1
GRONOW.txt,181984,183200,1216,10,N,N,-,-1,-1
GRONOW.txt,181991,183385,1394,10,N,N,-,-1,-1
GRONOW.txt,182090,183523,1433,10,N,N,-,-1,-1
GRONOW.txt,182105,183601,1496,10,N,N,-,-1,-1
GRONOW.txt,182205,183743,1538,10,N,N,-,-1,-1
GRONOW.txt,182270,183903,1633,10,N,N,-,-1,-1
GRONOW.txt,182433,183951,1518,10,N,N,-,-1,-1
GRONOW.txt,182627,184049,1422,10,N,N,-,-1,-1
GRONOW.txt,182862,184374,1512,10,N,N,-,-1,-1
GRONOW.txt,183023,184573,1550,10,N,N,-,-1,-1
GRONOW.txt,183201,184671,1470,10,N,N,-,-1,-1
GRONOW.txt,183386,185349,1963,10,N,N,-,-1,-1
GRONOW.txt,183524,185519,1995,10,N,N,-,-1,-1
GRONOW.txt,183602,185571,1969,10,N,N,-,-1,-1
GRONOW.txt,183744,185631,1887,10,N,N,-,-1,-1
GRONOW.txt,183904,186122,2218,10,N,N,-,-1,-1
GRONOW.txt,183952,186387,2435,10,N,N,-,-1,-1
GRONOW.txt,184050,186461,2411,10,N,N,-,-1,-1
GRONOW.txt,184375,186609,2234,10,N,N,-,-1,-1
GRONOW.txt,184576,186741,2165,10,N,N,-,-1,-1
GRONOW.txt,184672,186996,2324,10,N,N,-,-1,-1
GRONOW.txt,185350,187212,1862,10,N,N,-,-1,-1
GRONOW.txt,185520,187248,1728,10,N,N,-,-1,-1
GRONOW.txt,185576,187390,1814,10,N,N,-,-1,-1
GRONOW.txt,185631,187496,1865,10,N,N,-,-1,-1
GRONOW.txt,186125,187589,1464,10,N,N,-,-1,-1
GRONOW.txt,186388,187704,1316,10,N,N,-,-1,-1
GRONOW.txt,186462,187774,1312,10,N,N,-,-1,-1
GRONOW.txt,186610,188076,1466,10,N,N,-,-1,-1
GRONOW.txt,186744,188519,1775,10,N,N,-,-1,-1
GRONOW.txt,186997,188664,1667,10,N,N,-,-1,-1
GRONOW.txt,187213,188859,1646,10,N,N,-,-1,-1
GRONOW.txt,187249,188955,1706,10,N,N,-,-1,-1
GRONOW.txt,187393,189108,1715,10,N,N,-,-1,-1
GRONOW.txt,187497,189302,1805,10,N,N,-,-1,-1
GRONOW.txt,187591,189324,1733,10,N,N,-,-1,-1
GRONOW.txt,187705,189544,1839,10,N,N,-,-1,-1
GRONOW.txt,187775,189719,1944,10,N,N,-,-1,-1
GRONOW.txt,188077,189777,1700,10,N,N,-,-1,-1
GRONOW.txt,188522,189860,1338,10,N,N,-,-1,-1
GRONOW.txt,188665,189919,1254,10,N,N,-,-1,-1
GRONOW.txt,188860,190074,1214,10,N,N,-,-1,-1
GRONOW.txt,188958,190188,1230,10,N,N,-,-1,-1
GRONOW.txt,189110,190558,1448,10,N,N,-,-1,-1
GRONOW.txt,189305,190761,1456,10,N,N,-,-1,-1
GRONOW.txt,189325,190890,1565,10,N,N,-,-1,-1
GRONOW.txt,189545,191012,1467,10,N,N,-,-1,-1
GRONOW.txt,189720,191313,1593,10,N,N,-,-1,-1
GRONOW.txt,189778,191482,1704,10,N,N,-,-1,-1
GRONOW.txt,189863,191867,2004,10,N,N,-,-1,-1
GRONOW.txt,189920,192229,2309,10,N,N,-,-1,-1
GRONOW.txt,190075,192318,2243,10,N,N,-,-1,-1
GRONOW.txt,190189,192500,2311,10,N,N,-,-1,-1
GRONOW.txt,190559,192684,2125,10,N,N,-,-1,-1
GRONOW.txt,190763,193022,2259,10,N,N,-,-1,-1
GRONOW.txt,190891,193266,2375,10,N,N,-,-1,-1
GRONOW.txt,191013,193419,2406,10,N,N,-,-1,-1
GRONOW.txt,191316,193719,2403,10,N,N,-,-1,-1
GRONOW.txt,191483,193864,2381,10,N,N,-,-1,-1
GRONOW.txt,191869,194027,2158,10,N,N,-,-1,-1
GRONOW.txt,192232,194062,1830,10,N,N,-,-1,-1
GRONOW.txt,192323,194244,1921,10,N,N,-,-1,-1
GRONOW.txt,192503,194576,2073,10,N,N,-,-1,-1
GRONOW.txt,192685,194621,1936,10,N,N,-,-1,-1
GRONOW.txt,193023,195128,2105,10,N,N,-,-1,-1
GRONOW.txt,193269,195540,2271,10,N,N,-,-1,-1
GRONOW.txt,193421,195788,2367,10,N,N,-,-1,-1
GRONOW.txt,193721,195812,2091,10,N,N,-,-1,-1
GRONOW.txt,193865,195880,2015,10,N,N,-,-1,-1
GRONOW.txt,194032,195997,1965,10,N,N,-,-1,-1
GRONOW.txt,194063,196353,2290,10,N,N,-,-1,-1
GRONOW.txt,194245,196495,2250,10,N,N,-,-1,-1
GRONOW.txt,194577,196732,2155,10,N,N,-,-1,-1
GRONOW.txt,194624,197045,2421,10,N,N,-,-1,-1
GRONOW.txt,195131,197194,2063,10,N,N,-,-1,-1
GRONOW.txt,195543,197456,1913,10,N,N,-,-1,-1
GRONOW.txt,195793,197653,1860,10,N,N,-,-1,-1
GRONOW.txt,195813,197946,2133,10,N,N,-,-1,-1
GRONOW.txt,195882,198298,2416,10,N,N,-,-1,-1
GRONOW.txt,195998,198675,2677,10,N,N,-,-1,-1
GRONOW.txt,196354,198706,2352,10,N,N,-,-1,-1
GRONOW.txt,196498,198746,2248,10,N,N,-,-1,-1
GRONOW.txt,196733,198982,2249,10,N,N,-,-1,-1
GRONOW.txt,197046,199116,2070,10,N,N,-,-1,-1
GRONOW.txt,197196,199403,2207,10,N,N,-,-1,-1
GRONOW.txt,197457,199597,2140,10,N,N,-,-1,-1
GRONOW.txt,197654,199727,2073,10,N,N,-,-1,-1
GRONOW.txt,197949,199848,1899,10,N,N,-,-1,-1
GRONOW.txt,198299,199905,1606,10,N,N,-,-1,-1
GRONOW.txt,198677,200188,1511,10,N,N,-,-1,-1
GRONOW.txt,198708,200202,1494,10,N,N,-,-1,-1
GRONOW.txt,198749,200539,1790,10,N,N,-,-1,-1
GRONOW.txt,198983,200652,1669,10,N,N,-,-1,-1
GRONOW.txt,199121,200707,1586,10,N,N,-,-1,-1
GRONOW.txt,199404,201017,1613,10,N,N,-,-1,-1
GRONOW.txt,199598,201269,1671,10,N,N,-,-1,-1
GRONOW.txt,199730,201431,1701,10,N,N,-,-1,-1
GRONOW.txt,199849,201755,1906,10,N,N,-,-1,-1
GRONOW.txt,199906,201839,1933,10,N,N,-,-1,-1
GRONOW.txt,200191,202062,1871,10,N,N,-,-1,-1
GRONOW.txt,200203,202187,1984,10,N,N,-,-1,-1
GRONOW.txt,200542,202241,1699,10,N,N,-,-1,-1
GRONOW.txt,200653,202419,1766,10,N,N,-,-1,-1
GRONOW.txt,200708,202618,1910,10,N,N,-,-1,-1
GRONOW.txt,201020,202794,1774,10,N,N,-,-1,-1
GRONOW.txt,201270,202971,1701,10,N,N,-,-1,-1
GRONOW.txt,201432,203407,1975,10,N,N,-,-1,-1
GRONOW.txt,201756,203504,1748,10,N,N,-,-1,-1
GRONOW.txt,201842,203634,1792,10,N,N,-,-1,-1
GRONOW.txt,202063,203855,1792,10,N,N,-,-1,-1
GRONOW.txt,202188,204028,1840,10,N,N,-,-1,-1
GRONOW.txt,202242,204107,1865,10,N,N,-,-1,-1
GRONOW.txt,202424,204328,1904,10,N,N,-,-1,-1
GRONOW.txt,202621,204499,1878,10,N,N,-,-1,-1
GRONOW.txt,202795,204614,1819,10,N,N,-,-1,-1
GRONOW.txt,202972,204869,1897,10,N,N,-,-1,-1
GRONOW.txt,203408,205162,1754,10,N,N,-,-1,-1
GRONOW.txt,203505,205297,1792,10,N,N,-,-1,-1
GRONOW.txt,203637,205515,1878,10,N,N,-,-1,-1
GRONOW.txt,203856,205729,1873,10,N,N,-,-1,-1
GRONOW.txt,204029,205884,1855,10,N,N,-,-1,-1
GRONOW.txt,204108,206070,1962,10,N,N,-,-1,-1
GRONOW.txt,204330,206140,1810,10,N,N,-,-1,-1
GRONOW.txt,204500,206310,1810,10,N,N,-,-1,-1
GRONOW.txt,204615,206326,1711,10,N,N,-,-1,-1
GRONOW.txt,204872,206437,1565,10,N,N,-,-1,-1
GRONOW.txt,205163,206667,1504,10,N,N,-,-1,-1
GRONOW.txt,205298,206937,1639,10,N,N,-,-1,-1
GRONOW.txt,205518,207207,1689,10,N,N,-,-1,-1
GRONOW.txt,205730,207341,1611,10,N,N,-,-1,-1
GRONOW.txt,205889,207446,1557,10,N,N,-,-1,-1
GRONOW.txt,206071,207583,1512,10,N,N,-,-1,-1
GRONOW.txt,206141,207720,1579,10,N,N,-,-1,-1
GRONOW.txt,206313,207866,1553,10,N,N,-,-1,-1
GRONOW.txt,206327,208025,1698,10,N,N,-,-1,-1
GRONOW.txt,206438,208375,1937,10,N,N,-,-1,-1
GRONOW.txt,206668,208646,1978,10,N,N,-,-1,-1
GRONOW.txt,206938,209047,2109,10,N,N,-,-1,-1
GRONOW.txt,207209,209305,2096,10,N,N,-,-1,-1
GRONOW.txt,207342,209330,1988,10,N,N,-,-1,-1
GRONOW.txt,207447,209617,2170,10,N,N,-,-1,-1
GRONOW.txt,207584,209837,2253,10,N,N,-,-1,-1
GRONOW.txt,207721,209931,2210,10,N,N,-,-1,-1
GRONOW.txt,207867,210037,2170,10,N,N,-,-1,-1
GRONOW.txt,208028,210081,2053,10,N,N,-,-1,-1
GRONOW.txt,208376,210182,1806,10,N,N,-,-1,-1
GRONOW.txt,208648,210201,1553,10,N,N,-,-1,-1
GRONOW.txt,209048,210293,1245,10,N,N,-,-1,-1
GRONOW.txt,209310,210475,1165,10,N,N,-,-1,-1
GRONOW.txt,209333,210780,1447,10,N,N,-,-1,-1
GRONOW.txt,209618,210980,1362,10,N,N,-,-1,-1
GRONOW.txt,209838,211008,1170,10,N,N,-,-1,-1
GRONOW.txt,209932,211070,1138,10,N,N,-,-1,-1
GRONOW.txt,210039,211122,1083,10,N,N,-,-1,-1
GRONOW.txt,210082,211181,1099,10,N,N,-,-1,-1
GRONOW.txt,210185,211235,1050,10,N,N,-,-1,-1
GRONOW.txt,210202,211348,1146,10,N,N,-,-1,-1
GRONOW.txt,210294,211430,1136,10,N,N,-,-1,-1
GRONOW.txt,210476,211695,1219,10,N,N,-,-1,-1
GRONOW.txt,210781,211788,1007,10,N,N,-,-1,-1
GRONOW.txt,210981,211882,901,10,N,N,-,-1,-1
GRONOW.txt,211009,212254,1245,10,N,N,-,-1,-1
GRONOW.txt,211071,212392,1321,10,N,N,-,-1,-1
GRONOW.txt,211123,212597,1474,10,N,N,-,-1,-1
GRONOW.txt,211182,212656,1474,10,N,N,-,-1,-1
GRONOW.txt,211236,212690,1454,10,N,N,-,-1,-1
GRONOW.txt,211349,212818,1469,10,N,N,-,-1,-1
GRONOW.txt,211433,213263,1830,10,N,N,-,-1,-1
GRONOW.txt,211696,213499,1803,10,N,N,-,-1,-1
GRONOW.txt,211789,213532,1743,10,N,N,-,-1,-1
GRONOW.txt,211884,213637,1753,10,N,N,-,-1,-1
GRONOW.txt,212257,213803,1546,10,Y,N,-,-1,-1
GRONOW.txt,212393,213856,1463,10,N,N,-,-1,-1
GRONOW.txt,212598,213952,1354,10,N,N,-,-1,-1
GRONOW.txt,212661,213980,1319,10,N,N,-,-1,-1
GRONOW.txt,212693,214060,1367,10,N,N,-,-1,-1
GRONOW.txt,212819,214233,1414,10,N,N,-,-1,-1
GRONOW.txt,213266,214335,1069,10,N,N,-,-1,-1
GRONOW.txt,213500,214499,999,10,N,N,-,-1,-1
GRONOW.txt,213533,214610,1077,10,N,N,-,-1,-1
GRONOW.txt,213640,214994,1354,10,Y,N,-,-1,-1
GRONOW.txt,213804,215149,1345,10,Y,N,-,-1,-1
GRONOW.txt,213859,215572,1713,10,Y,N,-,-1,-1
GRONOW.txt,213955,215599,1644,10,Y,N,-,-1,-1
GRONOW.txt,213981,215826,1845,10,Y,N,-,-1,-1
GRONOW.txt,214061,216000,1939,10,Y,N,-,-1,-1
GRONOW.txt,214234,216019,1785,10,Y,N,-,-1,-1
GRONOW.txt,214336,216262,1926,10,Y,N,-,-1,-1
GRONOW.txt,214500,216427,1927,10,Y,N,-,-1,-1
GRONOW.txt,214613,216903,2290,10,Y,N,-,-1,-1
GRONOW.txt,214995,217008,2013,10,N,N,-,-1,-1
GRONOW.txt,215150,217280,2130,10,N,N,-,-1,-1
GRONOW.txt,215575,217299,1724,10,N,N,-,-1,-1
GRONOW.txt,215600,217576,1976,10,N,N,-,-1,-1
GRONOW.txt,215827,217654,1827,10,N,N,-,-1,-1
GRONOW.txt,216005,217691,1686,10,N,N,-,-1,-1
GRONOW.txt,216020,217759,1739,10,N,N,-,-1,-1
GRONOW.txt,216263,217896,1633,10,N,N,-,-1,-1
GRONOW.txt,216430,218054,1624,10,N,N,-,-1,-1
GRONOW.txt,216904,218245,1341,10,N,N,-,-1,-1
GRONOW.txt,217009,218274,1265,10,N,N,-,-1,-1
GRONOW.txt,217283,218497,1214,10,N,N,-,-1,-1
GRONOW.txt,217300,218630,1330,10,N,N,-,-1,-1
GRONOW.txt,217577,218799,1222,10,N,N,-,-1,-1
GRONOW.txt,217655,218901,1246,10,N,N,-,-1,-1
GRONOW.txt,217692,219186,1494,10,N,N,-,-1,-1
GRONOW.txt,217760,219244,1484,10,N,N,-,-1,-1
GRONOW.txt,217897,219464,1567,10,N,N,-,-1,-1
GRONOW.txt,218055,219578,1523,10,N,N,-,-1,-1
GRONOW.txt,218250,219716,1466,10,N,N,-,-1,-1
GRONOW.txt,218275,219887,1612,10,N,N,-,-1,-1
GRONOW.txt,218500,220007,1507,10,N,N,-,-1,-1
GRONOW.txt,218631,220435,1804,10,N,N,-,-1,-1
GRONOW.txt,218800,220573,1773,10,Y,N,-,-1,-1
GRONOW.txt,218904,220803,1899,10,Y,N,-,-1,-1
GRONOW.txt,219187,220939,1752,10,Y,N,-,-1,-1
GRONOW.txt,219249,221034,1785,10,Y,N,-,-1,-1
GRONOW.txt,219465,221152,1687,10,Y,N,-,-1,-1
GRONOW.txt,219579,221309,1730,10,Y,N,-,-1,-1
GRONOW.txt,219717,221404,1687,10,Y,N,-,-1,-1
GRONOW.txt,219890,221620,1730,10,Y,N,-,-1,-1
GRONOW.txt,220008,221790,1782,10,Y,Y,1437471855423,351318,351853
GRONOW.txt,220436,221976,1540,10,N,Y,1437471855423,351318,351853
GRONOW.txt,220576,222321,1745,10,N,Y,1437471855423,351318,351853
GRONOW.txt,220804,222546,1742,10,Y,Y,1437471855423,351318,351853
GRONOW.txt,220940,222685,1745,10,Y,Y,1437471855423,351318,351853
GRONOW.txt,221037,222715,1678,10,Y,Y,1437471855423,351318,351853
GRONOW.txt,221153,223023,1870,10,Y,Y,1437471855423,351318,351853
GRONOW.txt,221310,223372,2062,10,Y,Y,1437471855423,351318,351853
GRONOW.txt,221406,223402,1996,10,Y,Y,1437471855423,351318,351853
GRONOW.txt,221623,223460,1837,10,Y,Y,1437471855423,351318,351853
GRONOW.txt,221791,223636,1845,10,Y,Y,1437471855423,351318,351853
GRONOW.txt,221977,223868,1891,10,Y,Y,1437471855423,351318,351853
GRONOW.txt,222322,223877,1555,10,Y,Y,1437471855423,351318,351853
GRONOW.txt,222549,224048,1499,10,Y,N,-,-1,-1
GRONOW.txt,222690,224191,1501,10,N,N,-,-1,-1
GRONOW.txt,222716,224366,1650,10,N,N,-,-1,-1
GRONOW.txt,223026,224647,1621,10,N,N,-,-1,-1
GRONOW.txt,223375,225144,1769,10,N,N,-,-1,-1
GRONOW.txt,223403,225380,1977,10,N,N,-,-1,-1
GRONOW.txt,223461,225486,2025,10,N,N,-,-1,-1
GRONOW.txt,223637,225902,2265,10,N,N,-,-1,-1
GRONOW.txt,223869,226014,2145,10,N,N,-,-1,-1
GRONOW.txt,223878,226087,2209,10,N,N,-,-1,-1
GRONOW.txt,224049,226399,2350,10,N,N,-,-1,-1
GRONOW.txt,224193,226615,2422,10,N,N,-,-1,-1
GRONOW.txt,224367,226711,2344,10,N,N,-,-1,-1
GRONOW.txt,224648,226795,2147,10,N,N,-,-1,-1
GRONOW.txt,225147,227008,1861,10,N,N,-,-1,-1
GRONOW.txt,225381,227124,1743,10,N,N,-,-1,-1
GRONOW.txt,225487,227501,2014,10,N,N,-,-1,-1
GRONOW.txt,225904,227601,1697,10,N,N,-,-1,-1
GRONOW.txt,226015,227736,1721,10,N,N,-,-1,-1
GRONOW.txt,226092,227805,1713,10,N,N,-,-1,-1
GRONOW.txt,226402,227894,1492,10,N,N,-,-1,-1
GRONOW.txt,226616,227987,1371,10,N,N,-,-1,-1
GRONOW.txt,226713,228138,1425,10,N,N,-,-1,-1
GRONOW.txt,226796,228315,1519,10,N,N,-,-1,-1
GRONOW.txt,227009,228506,1497,10,N,N,-,-1,-1
GRONOW.txt,227125,228632,1507,10,N,N,-,-1,-1
GRONOW.txt,227502,228788,1286,10,N,N,-,-1,-1
GRONOW.txt,227602,228839,1237,10,N,N,-,-1,-1
GRONOW.txt,227737,229060,1323,10,N,N,-,-1,-1
GRONOW.txt,227806,229176,1370,10,N,N,-,-1,-1
GRONOW.txt,227897,229383,1486,10,N,N,-,-1,-1
GRONOW.txt,227988,229467,1479,10,N,N,-,-1,-1
GRONOW.txt,228139,229510,1371,10,N,N,-,-1,-1
GRONOW.txt,228316,229588,1272,10,N,N,-,-1,-1
GRONOW.txt,228509,229733,1224,10,N,N,-,-1,-1
GRONOW.txt,228633,229900,1267,10,N,N,-,-1,-1
GRONOW.txt,228789,230049,1260,10,N,N,-,-1,-1
GRONOW.txt,228840,230086,1246,10,N,N,-,-1,-1
GRONOW.txt,229061,230180,1119,10,N,N,-,-1,-1
GRONOW.txt,229177,230307,1130,10,N,N,-,-1,-1
GRONOW.txt,229384,230426,1042,10,N,N,-,-1,-1
GRONOW.txt,229472,230505,1033,10,N,N,-,-1,-1
GRONOW.txt,229513,230628,1115,10,N,N,-,-1,-1
GRONOW.txt,229589,230941,1352,10,N,N,-,-1,-1
GRONOW.txt,229734,231032,1298,10,N,N,-,-1,-1
GRONOW.txt,229901,231170,1269,10,N,N,-,-1,-1
GRONOW.txt,230052,231300,1248,10,N,N,-,-1,-1
GRONOW.txt,230087,231550,1463,10,N,N,-,-1,-1
GRONOW.txt,230181,231887,1706,10,N,N,-,-1,-1
GRONOW.txt,230308,231945,1637,10,N,N,-,-1,-1
GRONOW.txt,230427,232066,1639,10,N,N,-,-1,-1
GRONOW.txt,230506,232161,1655,10,N,N,-,-1,-1
GRONOW.txt,230629,232285,1656,10,N,N,-,-1,-1
GRONOW.txt,230942,232715,1773,10,N,N,-,-1,-1
GRONOW.txt,231035,232824,1789,10,N,N,-,-1,-1
GRONOW.txt,231171,232907,1736,10,N,N,-,-1,-1
GRONOW.txt,231301,233084,1783,10,N,N,-,-1,-1
GRONOW.txt,231551,233432,1881,10,N,N,-,-1,-1
GRONOW.txt,231888,233664,1776,10,N,N,-,-1,-1
GRONOW.txt,231948,233950,2002,10,N,N,-,-1,-1
GRONOW.txt,232067,234149,2082,10,N,N,-,-1,-1
GRONOW.txt,232162,234283,2121,10,N,N,-,-1,-1
GRONOW.txt,232286,234583,2297,10,N,N,-,-1,-1
GRONOW.txt,232718,234674,1956,10,N,N,-,-1,-1
GRONOW.txt,232825,234774,1949,10,N,N,-,-1,-1
GRONOW.txt,232912,234796,1884,10,N,N,-,-1,-1
GRONOW.txt,233085,235010,1925,10,N,N,-,-1,-1
GRONOW.txt,233433,235311,1878,10,N,N,-,-1,-1
GRONOW.txt,233667,235565,1898,10,N,N,-,-1,-1
GRONOW.txt,233951,235786,1835,10,N,N,-,-1,-1
GRONOW.txt,234150,236163,2013,10,N,N,-,-1,-1
GRONOW.txt,234285,236366,2081,10,N,N,-,-1,-1
GRONOW.txt,234584,236399,1815,10,N,N,-,-1,-1
GRONOW.txt,234675,236697,2022,10,N,N,-,-1,-1
GRONOW.txt,234777,236992,2215,10,N,N,-,-1,-1
GRONOW.txt,234797,237217,2420,10,N,N,-,-1,-1
GRONOW.txt,235011,237470,2459,10,N,N,-,-1,-1
GRONOW.txt,235312,237637,2325,10,N,N,-,-1,-1
GRONOW.txt,235566,237761,2195,10,N,N,-,-1,-1
GRONOW.txt,235787,237774,1987,10,N,N,-,-1,-1
GRONOW.txt,236164,238010,1846,10,N,N,-,-1,-1
GRONOW.txt,236367,238152,1785,10,N,N,-,-1,-1
GRONOW.txt,236404,238271,1867,10,N,N,-,-1,-1
GRONOW.txt,236700,238440,1740,10,N,N,-,-1,-1
GRONOW.txt,236994,238762,1768,10,N,N,-,-1,-1
GRONOW.txt,237218,239089,1871,10,N,N,-,-1,-1
GRONOW.txt,237471,239310,1839,10,N,N,-,-1,-1
GRONOW.txt,237638,239535,1897,10,N,N,-,-1,-1
GRONOW.txt,237762,239861,2099,10,N,N,-,-1,-1
GRONOW.txt,237775,240150,2375,10,N,N,-,-1,-1
GRONOW.txt,238011,240419,2408,10,N,N,-,-1,-1
GRONOW.txt,238153,240612,2459,10,N,N,-,-1,-1
GRONOW.txt,238274,240781,2507,10,N,N,-,-1,-1
GRONOW.txt,238441,241154,2713,10,N,N,-,-1,-1
GRONOW.txt,238765,241252,2487,10,N,N,-,-1,-1
GRONOW.txt,239090,241370,2280,10,N,N,-,-1,-1
GRONOW.txt,239311,241527,2216,10,N,N,-,-1,-1
GRONOW.txt,239536,241592,2056,10,N,N,-,-1,-1
GRONOW.txt,239864,241794,1930,10,N,N,-,-1,-1
GRONOW.txt,240151,242002,1851,10,N,N,-,-1,-1
GRONOW.txt,240420,242284,1864,10,N,N,-,-1,-1
GRONOW.txt,240613,242674,2061,10,N,N,-,-1,-1
GRONOW.txt,240782,243023,2241,10,N,N,-,-1,-1
GRONOW.txt,241157,243187,2030,10,N,N,-,-1,-1
GRONOW.txt,241253,243330,2077,10,N,N,-,-1,-1
GRONOW.txt,241371,243361,1990,10,N,N,-,-1,-1
GRONOW.txt,241528,243667,2139,10,N,N,-,-1,-1
GRONOW.txt,241593,243692,2099,10,N,N,-,-1,-1
GRONOW.txt,241795,243864,2069,10,N,N,-,-1,-1
GRONOW.txt,242004,244318,2314,10,N,N,-,-1,-1
GRONOW.txt,242285,244566,2281,10,N,N,-,-1,-1
GRONOW.txt,242676,244637,1961,10,N,N,-,-1,-1
GRONOW.txt,243026,244672,1646,10,N,N,-,-1,-1
GRONOW.txt,243188,244761,1573,10,N,N,-,-1,-1
GRONOW.txt,243335,245074,1739,10,N,N,-,-1,-1
GRONOW.txt,243364,245181,1817,10,N,N,-,-1,-1
GRONOW.txt,243670,245670,2000,10,N,N,-,-1,-1
GRONOW.txt,243693,245973,2280,10,N,N,-,-1,-1
GRONOW.txt,243866,246352,2486,10,N,N,-,-1,-1
GRONOW.txt,244319,246809,2490,10,N,N,-,-1,-1
GRONOW.txt,244567,246905,2338,10,N,N,-,-1,-1
GRONOW.txt,244638,247032,2394,10,N,N,-,-1,-1
GRONOW.txt,244673,247315,2642,10,N,N,-,-1,-1
GRONOW.txt,244762,247665,2903,10,N,N,-,-1,-1
GRONOW.txt,245075,247777,2702,10,N,N,-,-1,-1
GRONOW.txt,245182,248036,2854,10,N,N,-,-1,-1
GRONOW.txt,245673,248232,2559,10,N,N,-,-1,-1
GRONOW.txt,245975,248306,2331,10,N,N,-,-1,-1
GRONOW.txt,246353,248567,2214,10,N,N,-,-1,-1
GRONOW.txt,246812,248602,1790,10,N,N,-,-1,-1
GRONOW.txt,246906,248963,2057,10,N,N,-,-1,-1
GRONOW.txt,247033,249143,2110,10,N,N,-,-1,-1
GRONOW.txt,247316,249176,1860,10,N,N,-,-1,-1
GRONOW.txt,247666,249269,1603,10,N,N,-,-1,-1
GRONOW.txt,247778,249455,1677,10,N,N,-,-1,-1
GRONOW.txt,248037,249592,1555,10,N,N,-,-1,-1
GRONOW.txt,248233,249687,1454,10,N,N,-,-1,-1
GRONOW.txt,248309,249744,1435,10,N,N,-,-1,-1
GRONOW.txt,248572,250023,1451,10,N,N,-,-1,-1
GRONOW.txt,248603,250227,1624,10,N,N,-,-1,-1
GRONOW.txt,248964,250301,1337,10,N,N,-,-1,-1
GRONOW.txt,249146,250709,1563,10,N,N,-,-1,-1
GRONOW.txt,249177,250909,1732,10,N,N,-,-1,-1
GRONOW.txt,249270,251788,2518,10,N,N,-,-1,-1
GRONOW.txt,249456,251909,2453,10,N,N,-,-1,-1
GRONOW.txt,249593,252031,2438,10,N,N,-,-1,-1
GRONOW.txt,249688,252261,2573,10,N,N,-,-1,-1
GRONOW.txt,249745,252400,2655,10,N,N,-,-1,-1
GRONOW.txt,250024,252518,2494,10,N,N,-,-1,-1
GRONOW.txt,250228,252896,2668,10,N,N,-,-1,-1
GRONOW.txt,250304,253069,2765,10,N,N,-,-1,-1
GRONOW.txt,250710,253149,2439,10,N,N,-,-1,-1
GRONOW.txt,250910,253248,2338,10,N,N,-,-1,-1
GRONOW.txt,251791,253444,1653,10,N,N,-,-1,-1
GRONOW.txt,251910,253655,1745,10,N,N,-,-1,-1
GRONOW.txt,252032,253747,1715,10,N,N,-,-1,-1
GRONOW.txt,252262,253863,1601,10,N,N,-,-1,-1
GRONOW.txt,252403,254036,1633,10,N,N,-,-1,-1
GRONOW.txt,252519,254246,1727,10,N,N,-,-1,-1
GRONOW.txt,252897,254334,1437,10,N,N,-,-1,-1
GRONOW.txt,253070,254524,1454,10,N,N,-,-1,-1
GRONOW.txt,253151,254760,1609,10,N,N,-,-1,-1
GRONOW.txt,253250,255194,1944,10,N,N,-,-1,-1
GRONOW.txt,253445,255446,2001,10,N,N,-,-1,-1
GRONOW.txt,253658,255520,1862,10,N,N,-,-1,-1
GRONOW.txt,253750,255979,2229,10,N,N,-,-1,-1
GRONOW.txt,253864,256249,2385,10,N,N,-,-1,-1
GRONOW.txt,254037,256283,2246,10,N,N,-,-1,-1
GRONOW.txt,254247,256486,2239,10,N,N,-,-1,-1
GRONOW.txt,254335,256691,2356,10,N,N,-,-1,-1
GRONOW.txt,254527,256744,2217,10,N,N,-,-1,-1
GRONOW.txt,254761,257040,2279,10,N,N,-,-1,-1
GRONOW.txt,255195,257259,2064,10,N,N,-,-1,-1
GRONOW.txt,255447,257410,1963,10,N,N,-,-1,-1
GRONOW.txt,255521,257730,2209,10,N,N,-,-1,-1
GRONOW.txt,255981,257923,1942,10,N,N,-,-1,-1
GRONOW.txt,256252,258143,1891,10,N,N,-,-1,-1
GRONOW.txt,256284,258426,2142,10,N,N,-,-1,-1
GRONOW.txt,256487,258637,2150,10,N,N,-,-1,-1
GRONOW.txt,256692,258969,2277,10,N,N,-,-1,-1
GRONOW.txt,256745,259005,2260,10,N,N,-,-1,-1
GRONOW.txt,257041,259225,2184,10,N,N,-,-1,-1
GRONOW.txt,257262,259295,2033,10,N,N,-,-1,-1
GRONOW.txt,257411,259728,2317,10,N,N,-,-1,-1
GRONOW.txt,257731,259876,2145,10,N,N,-,-1,-1
GRONOW.txt,257925,260350,2425,10,N,N,-,-1,-1
GRONOW.txt,258146,260604,2458,10,N,N,-,-1,-1
GRONOW.txt,258427,260766,2339,10,N,N,-,-1,-1
GRONOW.txt,258638,260820,2182,10,N,N,-,-1,-1
GRONOW.txt,258974,260981,2007,10,N,N,-,-1,-1
GRONOW.txt,259006,261171,2165,10,N,N,-,-1,-1
GRONOW.txt,259226,261333,2107,10,N,N,-,-1,-1
GRONOW.txt,259296,261514,2218,10,N,N,-,-1,-1
GRONOW.txt,259729,261730,2001,10,N,N,-,-1,-1
GRONOW.txt,259877,261937,2060,10,N,N,-,-1,-1
GRONOW.txt,260351,262165,1814,10,N,N,-,-1,-1
GRONOW.txt,260605,262209,1604,10,N,N,-,-1,-1
GRONOW.txt,260769,262447,1678,10,N,N,-,-1,-1
GRONOW.txt,260823,262768,1945,10,N,N,-,-1,-1
GRONOW.txt,260982,263026,2044,10,N,N,-,-1,-1
GRONOW.txt,261173,263238,2065,10,N,N,-,-1,-1
GRONOW.txt,261335,263251,1916,10,N,N,-,-1,-1
GRONOW.txt,261515,263390,1875,10,N,N,-,-1,-1
GRONOW.txt,261731,263761,2030,10,N,N,-,-1,-1
GRONOW.txt,261938,264052,2114,10,N,N,-,-1,-1
GRONOW.txt,262168,264121,1953,10,N,N,-,-1,-1
GRONOW.txt,262210,264512,2302,10,N,N,-,-1,-1
GRONOW.txt,262448,264740,2292,10,N,N,-,-1,-1
GRONOW.txt,262769,264892,2123,10,N,N,-,-1,-1
GRONOW.txt,263027,265111,2084,10,N,N,-,-1,-1
GRONOW.txt,263241,265297,2056,10,N,N,-,-1,-1
GRONOW.txt,263252,265310,2058,10,N,N,-,-1,-1
GRONOW.txt,263391,265498,2107,10,N,N,-,-1,-1
GRONOW.txt,263762,265696,1934,10,N,N,-,-1,-1
GRONOW.txt,264054,265779,1725,10,N,N,-,-1,-1
GRONOW.txt,264126,265847,1721,10,N,N,-,-1,-1
GRONOW.txt,264515,266046,1531,10,N,N,-,-1,-1
GRONOW.txt,264741,266372,1631,10,N,N,-,-1,-1
GRONOW.txt,264893,266385,1492,10,N,N,-,-1,-1
GRONOW.txt,265112,266446,1334,10,N,N,-,-1,-1
GRONOW.txt,265300,266619,1319,10,N,N,-,-1,-1
GRONOW.txt,265311,266803,1492,10,N,N,-,-1,-1
GRONOW.txt,265500,266945,1445,10,N,N,-,-1,-1
GRONOW.txt,265697,267066,1369,10,N,N,-,-1,-1
GRONOW.txt,265780,267224,1444,10,N,N,-,-1,-1
GRONOW.txt,265848,267397,1549,10,N,N,-,-1,-1
GRONOW.txt,266048,267476,1428,10,N,N,-,-1,-1
GRONOW.txt,266375,267516,1141,10,N,N,-,-1,-1
GRONOW.txt,266386,267654,1268,10,N,N,-,-1,-1
GRONOW.txt,266447,267832,1385,10,N,N,-,-1,-1
GRONOW.txt,266620,267857,1237,10,N,N,-,-1,-1
GRONOW.txt,266804,267982,1178,10,N,N,-,-1,-1
GRONOW.txt,266946,268257,1311,10,N,N,-,-1,-1
GRONOW.txt,267067,268391,1324,10,N,N,-,-1,-1
GRONOW.txt,267225,268705,1480,10,N,N,-,-1,-1
GRONOW.txt,267399,268859,1460,10,N,N,-,-1,-1
GRONOW.txt,267479,269102,1623,10,N,N,-,-1,-1
GRONOW.txt,267517,269256,1739,10,N,N,-,-1,-1
GRONOW.txt,267655,269523,1868,10,N,N,-,-1,-1
GRONOW.txt,267835,269542,1707,10,N,N,-,-1,-1
GRONOW.txt,267858,269975,2117,10,N,N,-,-1,-1
GRONOW.txt,267984,270173,2189,10,N,N,-,-1,-1
GRONOW.txt,268260,270420,2160,10,N,N,-,-1,-1
GRONOW.txt,268392,270803,2411,10,N,N,-,-1,-1
GRONOW.txt,268706,270880,2174,10,N,N,-,-1,-1
GRONOW.txt,268860,271041,2181,10,N,N,-,-1,-1
GRONOW.txt,269103,271495,2392,10,N,N,-,-1,-1
GRONOW.txt,269257,271531,2274,10,N,N,-,-1,-1
GRONOW.txt,269526,271750,2224,10,N,N,-,-1,-1
GRONOW.txt,269543,272141,2598,10,N,N,-,-1,-1
GRONOW.txt,269978,272439,2461,10,N,N,-,-1,-1
GRONOW.txt,270174,272491,2317,10,N,N,-,-1,-1
GRONOW.txt,270423,272588,2165,10,N,N,-,-1,-1
GRONOW.txt,270806,273011,2205,10,N,N,-,-1,-1
GRONOW.txt,270881,273271,2390,10,N,N,-,-1,-1
GRONOW.txt,271042,273618,2576,10,N,N,-,-1,-1
GRONOW.txt,271498,273803,2305,10,N,N,-,-1,-1
GRONOW.txt,271532,273827,2295,10,N,N,-,-1,-1
GRONOW.txt,271751,274055,2304,10,N,N,-,-1,-1
GRONOW.txt,272142,274189,2047,10,N,N,-,-1,-1
GRONOW.txt,272440,274271,1831,10,N,N,-,-1,-1
GRONOW.txt,272492,274520,2028,10,N,N,-,-1,-1
GRONOW.txt,272589,274813,2224,10,N,N,-,-1,-1
GRONOW.txt,273012,275181,2169,10,N,N,-,-1,-1
GRONOW.txt,273272,275386,2114,10,N,N,-,-1,-1
GRONOW.txt,273620,275559,1939,10,N,N,-,-1,-1
GRONOW.txt,273806,275877,2071,10,N,N,-,-1,-1
GRONOW.txt,273828,275906,2078,10,N,N,-,-1,-1
GRONOW.txt,274056,276003,1947,10,N,N,-,-1,-1
GRONOW.txt,274192,276018,1826,10,N,N,-,-1,-1
GRONOW.txt,274272,276352,2080,10,N,N,-,-1,-1
GRONOW.txt,274521,276629,2108,10,N,N,-,-1,-1
GRONOW.txt,274816,276732,1916,10,N,N,-,-1,-1
GRONOW.txt,275182,276916,1734,10,N,N,-,-1,-1
GRONOW.txt,275387,277006,1619,10,N,N,-,-1,-1
GRONOW.txt,275560,277317,1757,10,N,N,-,-1,-1
GRONOW.txt,275878,277499,1621,10,N,N,-,-1,-1
GRONOW.txt,275907,277616,1709,10,N,N,-,-1,-1
GRONOW.txt,276006,277916,1910,10,N,N,-,-1,-1
GRONOW.txt,276019,278349,2330,10,N,N,-,-1,-1
GRONOW.txt,276354,278609,2255,10,N,N,-,-1,-1
GRONOW.txt,276630,278636,2006,10,N,N,-,-1,-1
GRONOW.txt,276733,278900,2167,10,N,N,-,-1,-1
GRONOW.txt,276919,279208,2289,10,N,N,-,-1,-1
GRONOW.txt,277007,279274,2267,10,N,N,-,-1,-1
GRONOW.txt,277318,279303,1985,10,N,N,-,-1,-1
GRONOW.txt,277500,279551,2051,10,N,N,-,-1,-1
GRONOW.txt,277619,279705,2086,10,N,N,-,-1,-1
GRONOW.txt,277919,279804,1885,10,N,N,-,-1,-1
GRONOW.txt,278350,280339,1989,10,N,N,-,-1,-1
GRONOW.txt,278612,280555,1943,10,N,N,-,-1,-1
GRONOW.txt,278637,280852,2215,10,N,N,-,-1,-1
GRONOW.txt,278901,281050,2149,10,N,N,-,-1,-1
GRONOW.txt,279209,281144,1935,10,N,N,-,-1,-1
GRONOW.txt,279279,281327,2048,10,N,N,-,-1,-1
GRONOW.txt,279304,281561,2257,10,N,N,-,-1,-1
GRONOW.txt,279552,281790,2238,10,N,N,-,-1,-1
GRONOW.txt,279706,282133,2427,10,N,N,-,-1,-1
GRONOW.txt,279805,282651,2846,10,N,N,-,-1,-1
GRONOW.txt,280340,282689,2349,10,N,N,-,-1,-1
GRONOW.txt,280558,282973,2415,10,N,N,-,-1,-1
GRONOW.txt,280853,283050,2197,10,N,N,-,-1,-1
GRONOW.txt,281055,283239,2184,10,N,N,-,-1,-1
GRONOW.txt,281145,283344,2199,10,N,N,-,-1,-1
GRONOW.txt,281328,283487,2159,10,N,N,-,-1,-1
GRONOW.txt,281564,283607,2043,10,N,N,-,-1,-1
GRONOW.txt,281791,283843,2052,10,N,N,-,-1,-1
GRONOW.txt,282134,284259,2125,10,N,N,-,-1,-1
GRONOW.txt,282656,284651,1995,10,N,N,-,-1,-1
GRONOW.txt,282690,284961,2271,10,N,N,-,-1,-1
GRONOW.txt,282975,285229,2254,10,N,N,-,-1,-1
GRONOW.txt,283051,285724,2673,10,N,N,-,-1,-1
GRONOW.txt,283240,285992,2752,10,N,N,-,-1,-1
GRONOW.txt,283345,286075,2730,10,N,N,-,-1,-1
GRONOW.txt,283490,286181,2691,10,N,N,-,-1,-1
GRONOW.txt,283608,286533,2925,10,N,N,-,-1,-1
GRONOW.txt,283844,286556,2712,10,N,N,-,-1,-1
GRONOW.txt,284261,286809,2548,10,N,N,-,-1,-1
GRONOW.txt,284654,287120,2466,10,N,N,-,-1,-1
GRONOW.txt,284963,287426,2463,10,N,N,-,-1,-1
GRONOW.txt,285230,287764,2534,10,N,N,-,-1,-1
GRONOW.txt,285725,287846,2121,10,N,N,-,-1,-1
GRONOW.txt,285993,288019,2026,10,N,N,-,-1,-1
GRONOW.txt,286076,288245,2169,10,N,N,-,-1,-1
GRONOW.txt,286184,288441,2257,10,N,N,-,-1,-1
GRONOW.txt,286536,288712,2176,10,N,N,-,-1,-1
GRONOW.txt,286557,288832,2275,10,N,N,-,-1,-1
GRONOW.txt,286810,289352,2542,10,N,N,-,-1,-1
GRONOW.txt,287121,289382,2261,10,N,N,-,-1,-1
GRONOW.txt,287429,289571,2142,10,N,N,-,-1,-1
GRONOW.txt,287767,289754,1987,10,N,N,-,-1,-1
GRONOW.txt,287847,290111,2264,10,N,N,-,-1,-1
GRONOW.txt,288020,290285,2265,10,N,N,-,-1,-1
GRONOW.txt,288246,290742,2496,10,N,N,-,-1,-1
GRONOW.txt,288443,291180,2737,10,N,N,-,-1,-1
GRONOW.txt,288713,291228,2515,10,N,N,-,-1,-1
GRONOW.txt,288833,291367,2534,10,N,N,-,-1,-1
GRONOW.txt,289353,292019,2666,10,N,N,-,-1,-1
GRONOW.txt,289385,292051,2666,10,N,N,-,-1,-1
GRONOW.txt,289572,292297,2725,10,N,N,-,-1,-1
GRONOW.txt,289755,292605,2850,10,N,N,-,-1,-1
GRONOW.txt,290112,293083,2971,10,N,N,-,-1,-1
GRONOW.txt,290286,293120,2834,10,N,N,-,-1,-1
GRONOW.txt,290743,293445,2702,10,N,N,-,-1,-1
GRONOW.txt,291182,293550,2368,10,N,N,-,-1,-1
GRONOW.txt,291230,294235,3005,10,N,N,-,-1,-1
GRONOW.txt,291370,294768,3398,10,N,N,-,-1,-1
GRONOW.txt,292022,294853,2831,10,N,N,-,-1,-1
GRONOW.txt,292052,295099,3047,10,N,N,-,-1,-1
GRONOW.txt,292298,295427,3129,10,N,N,-,-1,-1
GRONOW.txt,292606,295670,3064,10,N,N,-,-1,-1
GRONOW.txt,293084,295766,2682,10,N,N,-,-1,-1
GRONOW.txt,293121,296224,3103,10,N,N,-,-1,-1
GRONOW.txt,293447,296545,3098,10,N,N,-,-1,-1
GRONOW.txt,293552,296631,3079,10,N,N,-,-1,-1
GRONOW.txt,294237,297028,2791,10,N,N,-,-1,-1
GRONOW.txt,294771,297098,2327,10,N,N,-,-1,-1
GRONOW.txt,294856,297135,2279,10,N,N,-,-1,-1
GRONOW.txt,295100,297476,2376,10,N,N,-,-1,-1
GRONOW.txt,295429,297557,2128,10,N,N,-,-1,-1
GRONOW.txt,295671,297632,1961,10,N,N,-,-1,-1
GRONOW.txt,295769,297877,2108,10,N,N,-,-1,-1
GRONOW.txt,296225,298210,1985,10,N,N,-,-1,-1
GRONOW.txt,296546,298467,1921,10,N,N,-,-1,-1
GRONOW.txt,296634,298562,1928,10,N,N,-,-1,-1
GRONOW.txt,297029,298898,1869,10,N,N,-,-1,-1
GRONOW.txt,297101,299048,1947,10,N,N,-,-1,-1
GRONOW.txt,297136,299074,1938,10,N,N,-,-1,-1
GRONOW.txt,297477,299324,1847,10,N,N,-,-1,-1
GRONOW.txt,297559,299614,2055,10,N,N,-,-1,-1
GRONOW.txt,297633,299783,2150,10,N,N,-,-1,-1
GRONOW.txt,297878,299904,2026,10,N,N,-,-1,-1
GRONOW.txt,298213,299987,1774,10,N,N,-,-1,-1
GRONOW.txt,298469,300242,1773,10,N,N,-,-1,-1
GRONOW.txt,298563,300571,2008,10,N,N,-,-1,-1
GRONOW.txt,298899,300836,1937,10,N,N,-,-1,-1
GRONOW.txt,299051,301031,1980,10,N,N,-,-1,-1
GRONOW.txt,299075,301194,2119,10,N,N,-,-1,-1
GRONOW.txt,299325,301458,2133,10,N,N,-,-1,-1
GRONOW.txt,299615,301664,2049,10,N,N,-,-1,-1
GRONOW.txt,299784,301702,1918,10,N,N,-,-1,-1
GRONOW.txt,299905,301930,2025,10,N,N,-,-1,-1
GRONOW.txt,299988,302034,2046,10,N,N,-,-1,-1
GRONOW.txt,300243,302327,2084,10,N,N,-,-1,-1
GRONOW.txt,300572,302693,2121,10,N,N,-,-1,-1
GRONOW.txt,300837,303005,2168,10,N,N,-,-1,-1
GRONOW.txt,301032,303033,2001,10,N,N,-,-1,-1
GRONOW.txt,301195,303172,1977,10,N,N,-,-1,-1
GRONOW.txt,301460,303319,1859,10,N,N,-,-1,-1
GRONOW.txt,301665,303391,1726,10,N,N,-,-1,-1
GRONOW.txt,301705,303505,1800,10,N,N,-,-1,-1
GRONOW.txt,301931,303948,2017,10,N,N,-,-1,-1
GRONOW.txt,302035,304135,2100,10,N,N,-,-1,-1
GRONOW.txt,302328,304250,1922,10,N,N,-,-1,-1
GRONOW.txt,302694,304519,1825,10,N,N,-,-1,-1
GRONOW.txt,303008,304710,1702,10,N,N,-,-1,-1
GRONOW.txt,303034,305111,2077,10,N,N,-,-1,-1
GRONOW.txt,303173,305197,2024,10,N,N,-,-1,-1
GRONOW.txt,303320,305258,1938,10,N,N,-,-1,-1
GRONOW.txt,303392,305567,2175,10,N,N,-,-1,-1
GRONOW.txt,303507,305935,2428,10,N,N,-,-1,-1
GRONOW.txt,303949,306391,2442,10,N,N,-,-1,-1
GRONOW.txt,304136,306968,2832,10,N,N,-,-1,-1
GRONOW.txt,304252,307161,2909,10,N,N,-,-1,-1
GRONOW.txt,304520,307293,2773,10,N,N,-,-1,-1
GRONOW.txt,304712,307640,2928,10,N,N,-,-1,-1
GRONOW.txt,305112,307670,2558,10,N,N,-,-1,-1
GRONOW.txt,305202,307875,2673,10,N,N,-,-1,-1
GRONOW.txt,305259,308135,2876,10,N,N,-,-1,-1
GRONOW.txt,305568,308435,2867,10,N,N,-,-1,-1
GRONOW.txt,305936,308704,2768,10,N,N,-,-1,-1
GRONOW.txt,306392,308985,2593,10,N,N,-,-1,-1
GRONOW.txt,306969,309195,2226,10,N,N,-,-1,-1
GRONOW.txt,307162,309266,2104,10,N,N,-,-1,-1
GRONOW.txt,307294,309539,2245,10,N,N,-,-1,-1
GRONOW.txt,307643,309594,1951,10,N,N,-,-1,-1
GRONOW.txt,307671,309637,1966,10,N,N,-,-1,-1
GRONOW.txt,307876,309690,1814,10,N,N,-,-1,-1
GRONOW.txt,308136,309835,1699,10,N,N,-,-1,-1
GRONOW.txt,308436,309900,1464,10,N,N,-,-1,-1
GRONOW.txt,308709,310132,1423,10,N,N,-,-1,-1
GRONOW.txt,308988,310156,1168,10,N,N,-,-1,-1
GRONOW.txt,309196,310222,1026,10,N,N,-,-1,-1
GRONOW.txt,309267,310511,1244,10,N,N,-,-1,-1
GRONOW.txt,309540,310620,1080,10,N,N,-,-1,-1
GRONOW.txt,309595,310965,1370,10,N,N,-,-1,-1
GRONOW.txt,309638,311164,1526,10,N,N,-,-1,-1
GRONOW.txt,309692,311433,1741,10,N,N,-,-1,-1
GRONOW.txt,309836,311586,1750,10,N,N,-,-1,-1
GRONOW.txt,309902,311938,2036,10,N,N,-,-1,-1
GRONOW.txt,310133,312255,2122,10,N,N,-,-1,-1
GRONOW.txt,310157,312362,2205,10,N,N,-,-1,-1
GRONOW.txt,310223,312772,2549,10,N,N,-,-1,-1
GRONOW.txt,310512,312946,2434,10,N,N,-,-1,-1
GRONOW.txt,310622,313090,2468,10,N,N,-,-1,-1
GRONOW.txt,310966,313148,2182,10,N,N,-,-1,-1
GRONOW.txt,311167,313446,2279,10,N,N,-,-1,-1
GRONOW.txt,311434,313606,2172,10,N,N,-,-1,-1
GRONOW.txt,311587,313952,2365,10,N,N,-,-1,-1
GRONOW.txt,311941,314046,2105,10,N,N,-,-1,-1
GRONOW.txt,312258,314488,2230,10,N,N,-,-1,-1
GRONOW.txt,312364,314733,2369,10,N,N,-,-1,-1
GRONOW.txt,312775,314756,1981,10,N,N,-,-1,-1
GRONOW.txt,312947,315170,2223,10,N,N,-,-1,-1
GRONOW.txt,313091,315413,2322,10,N,N,-,-1,-1
GRONOW.txt,313150,315691,2541,10,N,N,-,-1,-1
GRONOW.txt,313447,315812,2365,10,N,N,-,-1,-1
GRONOW.txt,313607,315955,2348,10,N,N,-,-1,-1
GRONOW.txt,313953,316161,2208,10,N,N,-,-1,-1
GRONOW.txt,314047,316399,2352,10,N,N,-,-1,-1
GRONOW.txt,314489,316514,2025,10,N,N,-,-1,-1
GRONOW.txt,314736,316704,1968,10,N,N,-,-1,-1
GRONOW.txt,314757,316815,2058,10,N,N,-,-1,-1
GRONOW.txt,315171,317008,1837,10,N,N,-,-1,-1
GRONOW.txt,315414,317411,1997,10,N,N,-,-1,-1
GRONOW.txt,315694,317711,2017,10,N,N,-,-1,-1
GRONOW.txt,315813,317738,1925,10,N,N,-,-1,-1
GRONOW.txt,315956,318114,2158,10,N,N,-,-1,-1
GRONOW.txt,316162,318360,2198,10,N,N,-,-1,-1
GRONOW.txt,316400,318624,2224,10,N,N,-,-1,-1
GRONOW.txt,316515,318952,2437,10,N,N,-,-1,-1
GRONOW.txt,316705,319119,2414,10,N,N,-,-1,-1
GRONOW.txt,316818,319133,2315,10,N,N,-,-1,-1
GRONOW.txt,317009,319358,2349,10,N,N,-,-1,-1
GRONOW.txt,317412,319450,2038,10,N,N,-,-1,-1
GRONOW.txt,317714,319646,1932,10,N,N,-,-1,-1
GRONOW.txt,317739,319928,2189,10,N,N,-,-1,-1
GRONOW.txt,318115,320207,2092,10,N,N,-,-1,-1
GRONOW.txt,318361,320436,2075,10,N,N,-,-1,-1
GRONOW.txt,318625,320570,1945,10,N,N,-,-1,-1
GRONOW.txt,318953,320641,1688,10,N,N,-,-1,-1
GRONOW.txt,319122,320821,1699,10,N,N,-,-1,-1
GRONOW.txt,319134,320875,1741,10,N,N,-,-1,-1
GRONOW.txt,319361,321121,1760,10,N,N,-,-1,-1
GRONOW.txt,319451,321278,1827,10,N,N,-,-1,-1
GRONOW.txt,319647,321499,1852,10,N,N,-,-1,-1
GRONOW.txt,319930,321644,1714,10,N,N,-,-1,-1
GRONOW.txt,320210,321903,1693,10,N,N,-,-1,-1
GRONOW.txt,320437,322029,1592,10,N,N,-,-1,-1
GRONOW.txt,320571,322149,1578,10,N,N,-,-1,-1
GRONOW.txt,320644,322252,1608,10,N,N,-,-1,-1
GRONOW.txt,320822,322665,1843,10,N,N,-,-1,-1
GRONOW.txt,320876,323001,2125,10,N,N,-,-1,-1
GRONOW.txt,321122,323040,1918,10,N,N,-,-1,-1
GRONOW.txt,321281,323123,1842,10,N,N,-,-1,-1
GRONOW.txt,321500,323446,1946,10,N,N,-,-1,-1
GRONOW.txt,321645,323697,2052,10,N,N,-,-1,-1
GRONOW.txt,321904,323956,2052,10,N,N,-,-1,-1
GRONOW.txt,322031,324061,2030,10,N,N,-,-1,-1
GRONOW.txt,322150,324153,2003,10,N,N,-,-1,-1
GRONOW.txt,322255,324185,1930,10,N,N,-,-1,-1
GRONOW.txt,322666,324338,1672,10,N,N,-,-1,-1
GRONOW.txt,323004,324580,1576,10,N,N,-,-1,-1
GRONOW.txt,323041,324662,1621,10,N,N,-,-1,-1
GRONOW.txt,323126,324796,1670,10,N,N,-,-1,-1
GRONOW.txt,323447,324939,1492,10,N,N,-,-1,-1
GRONOW.txt,323698,325063,1365,10,N,N,-,-1,-1
GRONOW.txt,323959,325210,1251,10,N,N,-,-1,-1
GRONOW.txt,324062,325569,1507,10,N,N,-,-1,-1
GRONOW.txt,324154,325652,1498,10,N,N,-,-1,-1
GRONOW.txt,324186,325770,1584,10,N,N,-,-1,-1
GRONOW.txt,324339,325846,1507,10,N,N,-,-1,-1
GRONOW.txt,324581,325917,1336,10,N,N,-,-1,-1
GRONOW.txt,324663,326048,1385,10,N,N,-,-1,-1
GRONOW.txt,324797,326315,1518,10,N,N,-,-1,-1
GRONOW.txt,324941,326420,1479,10,N,N,-,-1,-1
GRONOW.txt,325066,326621,1555,10,N,N,-,-1,-1
GRONOW.txt,325212,326821,1609,10,N,N,-,-1,-1
GRONOW.txt,325572,326919,1347,10,N,N,-,-1,-1
GRONOW.txt,325653,327047,1394,10,N,N,-,-1,-1
GRONOW.txt,325771,327211,1440,10,N,N,-,-1,-1
GRONOW.txt,325847,327382,1535,10,N,N,-,-1,-1
GRONOW.txt,325920,327666,1746,10,N,N,-,-1,-1
GRONOW.txt,326049,327690,1641,10,N,N,-,-1,-1
GRONOW.txt,326317,327852,1535,10,N,N,-,-1,-1
GRONOW.txt,326422,328077,1655,10,N,N,-,-1,-1
GRONOW.txt,326623,328131,1508,10,N,N,-,-1,-1
GRONOW.txt,326824,328263,1439,10,N,N,-,-1,-1
GRONOW.txt,326921,328508,1587,10,N,N,-,-1,-1
GRONOW.txt,327048,328634,1586,10,N,N,-,-1,-1
GRONOW.txt,327212,328685,1473,10,N,N,-,-1,-1
GRONOW.txt,327383,328878,1495,10,N,N,-,-1,-1
GRONOW.txt,327667,328895,1228,10,N,N,-,-1,-1
GRONOW.txt,327691,329006,1315,10,N,N,-,-1,-1
GRONOW.txt,327853,329225,1372,10,N,N,-,-1,-1
GRONOW.txt,328078,329283,1205,10,N,N,-,-1,-1
GRONOW.txt,328134,329409,1275,10,N,N,-,-1,-1
GRONOW.txt,328264,329531,1267,10,N,N,-,-1,-1
GRONOW.txt,328509,329565,1056,10,N,N,-,-1,-1
GRONOW.txt,328635,329668,1033,10,N,N,-,-1,-1
GRONOW.txt,328686,329750,1064,10,N,N,-,-1,-1
GRONOW.txt,328879,330030,1151,10,N,N,-,-1,-1
GRONOW.txt,328895,330225,1330,10,N,N,-,-1,-1
GRONOW.txt,329007,330442,1435,10,N,N,-,-1,-1
GRONOW.txt,329228,330713,1485,10,N,N,-,-1,-1
GRONOW.txt,329284,330885,1601,10,N,N,-,-1,-1
GRONOW.txt,329412,331039,1627,10,N,N,-,-1,-1
GRONOW.txt,329534,331093,1559,10,N,N,-,-1,-1
GRONOW.txt,329566,331265,1699,10,N,N,-,-1,-1
GRONOW.txt,329669,331585,1916,10,N,N,-,-1,-1
GRONOW.txt,329751,331708,1957,10,N,N,-,-1,-1
GRONOW.txt,330031,331862,1831,10,N,N,-,-1,-1
GRONOW.txt,330226,332169,1943,10,N,N,-,-1,-1
GRONOW.txt,330444,332444,2000,10,N,N,-,-1,-1
GRONOW.txt,330714,332578,1864,10,N,N,-,-1,-1
GRONOW.txt,330886,332691,1805,10,N,N,-,-1,-1
GRONOW.txt,331040,332878,1838,10,N,N,-,-1,-1
GRONOW.txt,331094,332948,1854,10,N,N,-,-1,-1
GRONOW.txt,331268,333183,1915,10,N,N,-,-1,-1
GRONOW.txt,331586,333307,1721,10,N,N,-,-1,-1
GRONOW.txt,331709,333486,1777,10,N,N,-,-1,-1
GRONOW.txt,331865,333640,1775,10,N,N,-,-1,-1
GRONOW.txt,332171,333733,1562,10,N,N,-,-1,-1
GRONOW.txt,332445,333953,1508,10,N,N,-,-1,-1
GRONOW.txt,332580,334074,1494,10,N,N,-,-1,-1
GRONOW.txt,332692,334234,1542,10,N,N,-,-1,-1
GRONOW.txt,332883,334513,1630,10,N,N,-,-1,-1
GRONOW.txt,332949,334646,1697,10,N,N,-,-1,-1
GRONOW.txt,333184,334792,1608,10,N,N,-,-1,-1
GRONOW.txt,333308,335117,1809,10,N,N,-,-1,-1
GRONOW.txt,333488,335349,1861,10,N,N,-,-1,-1
GRONOW.txt,333642,335784,2142,10,N,N,-,-1,-1
GRONOW.txt,333734,335944,2210,10,N,N,-,-1,-1
GRONOW.txt,333954,335996,2042,10,N,N,-,-1,-1
GRONOW.txt,334075,336153,2078,10,N,N,-,-1,-1
GRONOW.txt,334235,336261,2026,10,N,N,-,-1,-1
GRONOW.txt,334515,336381,1866,10,N,N,-,-1,-1
GRONOW.txt,334647,336448,1801,10,N,N,-,-1,-1
GRONOW.txt,334793,336506,1713,10,N,N,-,-1,-1
GRONOW.txt,335119,336826,1707,10,N,N,-,-1,-1
GRONOW.txt,335350,337139,1789,10,N,N,-,-1,-1
GRONOW.txt,335785,337325,1540,10,N,N,-,-1,-1
GRONOW.txt,335947,337683,1736,10,N,N,-,-1,-1
GRONOW.txt,335997,337852,1855,10,N,N,-,-1,-1
GRONOW.txt,336154,338050,1896,10,N,N,-,-1,-1
GRONOW.txt,336262,338142,1880,10,N,N,-,-1,-1
GRONOW.txt,336384,338269,1885,10,N,N,-,-1,-1
GRONOW.txt,336449,338471,2022,10,N,N,-,-1,-1
GRONOW.txt,336507,338556,2049,10,N,N,-,-1,-1
GRONOW.txt,336827,338960,2133,10,N,N,-,-1,-1
GRONOW.txt,337142,339190,2048,10,N,N,-,-1,-1
GRONOW.txt,337326,339450,2124,10,N,N,-,-1,-1
GRONOW.txt,337684,339732,2048,10,N,N,-,-1,-1
GRONOW.txt,337853,339824,1971,10,N,N,-,-1,-1
GRONOW.txt,338051,339886,1835,10,N,N,-,-1,-1
GRONOW.txt,338143,339999,1856,10,N,N,-,-1,-1
GRONOW.txt,338270,340326,2056,10,N,N,-,-1,-1
GRONOW.txt,338474,340513,2039,10,N,N,-,-1,-1
GRONOW.txt,338557,340591,2034,10,N,N,-,-1,-1
GRONOW.txt,338961,340963,2002,10,N,N,-,-1,-1
GRONOW.txt,339193,341248,2055,10,N,N,-,-1,-1
GRONOW.txt,339451,341528,2077,10,N,N,-,-1,-1
GRONOW.txt,339733,341600,1867,10,N,N,-,-1,-1
GRONOW.txt,339827,341762,1935,10,N,N,-,-1,-1
GRONOW.txt,339887,341922,2035,10,N,N,-,-1,-1
GRONOW.txt,340000,342207,2207,10,N,N,-,-1,-1
GRONOW.txt,340328,342724,2396,10,N,N,-,-1,-1
GRONOW.txt,340515,343035,2520,10,N,N,-,-1,-1
GRONOW.txt,340594,343066,2472,10,N,N,-,-1,-1
GRONOW.txt,340966,343116,2150,10,N,N,-,-1,-1
GRONOW.txt,341251,343269,2018,10,N,N,-,-1,-1
GRONOW.txt,341529,343447,1918,10,N,N,-,-1,-1
GRONOW.txt,341601,343654,2053,10,N,N,-,-1,-1
GRONOW.txt,341763,343924,2161,10,N,N,-,-1,-1
GRONOW.txt,341923,344212,2289,10,N,N,-,-1,-1
GRONOW.txt,342210,344446,2236,10,N,N,-,-1,-1
GRONOW.txt,342725,344499,1774,10,N,N,-,-1,-1
GRONOW.txt,343036,344590,1554,10,N,N,-,-1,-1
GRONOW.txt,343069,344783,1714,10,N,N,-,-1,-1
GRONOW.txt,343117,344926,1809,10,N,N,-,-1,-1
GRONOW.txt,343272,345020,1748,10,N,N,-,-1,-1
GRONOW.txt,343448,345101,1653,10,N,N,-,-1,-1
GRONOW.txt,343655,345254,1599,10,N,N,-,-1,-1
GRONOW.txt,343925,345448,1523,10,N,N,-,-1,-1
GRONOW.txt,344215,345657,1442,10,N,N,-,-1,-1
GRONOW.txt,344447,345912,1465,10,N,N,-,-1,-1
GRONOW.txt,344500,346135,1635,10,N,N,-,-1,-1
GRONOW.txt,344591,346259,1668,10,N,N,-,-1,-1
GRONOW.txt,344784,346292,1508,10,N,N,-,-1,-1
GRONOW.txt,344928,346452,1524,10,N,N,-,-1,-1
GRONOW.txt,345021,346695,1674,10,N,N,-,-1,-1
GRONOW.txt,345102,346805,1703,10,N,N,-,-1,-1
GRONOW.txt,345255,346834,1579,10,N,N,-,-1,-1
GRONOW.txt,345449,347044,1595,10,N,N,-,-1,-1
GRONOW.txt,345658,347083,1425,10,N,N,-,-1,-1
GRONOW.txt,345913,347218,1305,10,N,N,-,-1,-1
GRONOW.txt,346136,347491,1355,10,N,N,-,-1,-1
GRONOW.txt,346260,347662,1402,10,N,N,-,-1,-1
GRONOW.txt,346295,347786,1491,10,N,N,-,-1,-1
GRONOW.txt,346453,348015,1562,10,N,N,-,-1,-1
GRONOW.txt,346696,348229,1533,10,N,N,-,-1,-1
GRONOW.txt,346808,348380,1572,10,N,N,-,-1,-1
GRONOW.txt,346835,348502,1667,10,N,N,-,-1,-1
GRONOW.txt,347047,348596,1549,10,N,N,-,-1,-1
GRONOW.txt,347084,348793,1709,10,N,N,-,-1,-1
GRONOW.txt,347219,349107,1888,10,N,N,-,-1,-1
GRONOW.txt,347492,349311,1819,10,N,N,-,-1,-1
GRONOW.txt,347663,349511,1848,10,N,N,-,-1,-1
GRONOW.txt,347787,349541,1754,10,N,N,-,-1,-1
GRONOW.txt,348016,349652,1636,10,N,N,-,-1,-1
GRONOW.txt,348232,349738,1506,10,N,N,-,-1,-1
GRONOW.txt,348381,349866,1485,10,N,N,-,-1,-1
GRONOW.txt,348503,350203,1700,10,N,N,-,-1,-1
GRONOW.txt,348597,350266,1669,10,N,N,-,-1,-1
GRONOW.txt,348794,350479,1685,10,N,N,-,-1,-1
GRONOW.txt,349108,350651,1543,10,N,N,-,-1,-1
GRONOW.txt,349312,350765,1453,10,N,N,-,-1,-1
GRONOW.txt,349514,351159,1645,10,N,N,-,-1,-1
GRONOW.txt,349542,351294,1752,10,N,N,-,-1,-1
GRONOW.txt,349653,351450,1797,10,N,N,-,-1,-1
GRONOW.txt,349739,351470,1731,10,N,N,-,-1,-1
GRONOW.txt,349868,351848,1980,10,N,N,-,-1,-1
GRONOW.txt,350206,351895,1689,10,N,N,-,-1,-1
GRONOW.txt,350267,352040,1773,10,N,N,-,-1,-1
GRONOW.txt,350482,352177,1695,10,N,N,-,-1,-1
GRONOW.txt,350652,352378,1726,10,N,N,-,-1,-1
GRONOW.txt,350766,352507,1741,10,N,N,-,-1,-1
GRONOW.txt,351161,352645,1484,10,N,N,-,-1,-1
GRONOW.txt,351295,352788,1493,10,N,N,-,-1,-1
GRONOW.txt,351453,353094,1641,10,N,N,-,-1,-1
GRONOW.txt,351471,353360,1889,10,N,N,-,-1,-1
GRONOW.txt,351849,353482,1633,10,N,N,-,-1,-1
GRONOW.txt,351896,353560,1664,10,N,N,-,-1,-1
GRONOW.txt,352041,353677,1636,10,N,N,-,-1,-1
GRONOW.txt,352178,353741,1563,10,N,N,-,-1,-1
GRONOW.txt,352379,353763,1384,10,N,N,-,-1,-1
GRONOW.txt,352508,353908,1400,10,N,N,-,-1,-1
GRONOW.txt,352646,354156,1510,10,N,N,-,-1,-1
GRONOW.txt,352790,354474,1684,10,N,N,-,-1,-1
GRONOW.txt,353095,354715,1620,10,N,N,-,-1,-1
GRONOW.txt,353361,354876,1515,10,N,N,-,-1,-1
GRONOW.txt,353483,355110,1627,10,N,N,-,-1,-1
GRONOW.txt,353561,355280,1719,10,N,N,-,-1,-1
GRONOW.txt,353680,355345,1665,10,N,N,-,-1,-1
GRONOW.txt,353744,355505,1761,10,N,N,-,-1,-1
GRONOW.txt,353764,355838,2074,10,N,N,-,-1,-1
GRONOW.txt,353909,355971,2062,10,N,N,-,-1,-1
GRONOW.txt,354157,356098,1941,10,N,N,-,-1,-1
GRONOW.txt,354475,356220,1745,10,N,N,-,-1,-1
GRONOW.txt,354718,356241,1523,10,N,N,-,-1,-1
GRONOW.txt,354877,356357,1480,10,N,N,-,-1,-1
GRONOW.txt,355111,356578,1467,10,N,N,-,-1,-1
GRONOW.txt,355281,356894,1613,10,N,N,-,-1,-1
GRONOW.txt,355346,356999,1653,10,N,N,-,-1,-1
GRONOW.txt,355506,357337,1831,10,N,N,-,-1,-1
GRONOW.txt,355840,357485,1645,10,N,N,-,-1,-1
GRONOW.txt,355972,357797,1825,10,N,N,-,-1,-1
GRONOW.txt,356100,358020,1920,10,N,N,-,-1,-1
GRONOW.txt,356223,358220,1997,10,N,N,-,-1,-1
GRONOW.txt,356242,358254,2012,10,N,N,-,-1,-1
GRONOW.txt,356358,358466,2108,10,N,N,-,-1,-1
GRONOW.txt,356580,358758,2178,10,N,N,-,-1,-1
GRONOW.txt,356895,358852,1957,10,N,N,-,-1,-1
GRONOW.txt,357000,359173,2173,10,N,N,-,-1,-1
GRONOW.txt,357338,359448,2110,10,N,N,-,-1,-1
GRONOW.txt,357486,360009,2523,10,N,N,-,-1,-1
GRONOW.txt,357798,360169,2371,10,N,N,-,-1,-1
GRONOW.txt,358021,360552,2531,10,N,N,-,-1,-1
GRONOW.txt,358223,360640,2417,10,N,N,-,-1,-1
GRONOW.txt,358255,360764,2509,10,N,N,-,-1,-1
GRONOW.txt,358467,361014,2547,10,N,N,-,-1,-1
GRONOW.txt,358759,361251,2492,10,N,N,-,-1,-1
GRONOW.txt,358853,361432,2579,10,N,N,-,-1,-1
GRONOW.txt,359174,361673,2499,10,N,N,-,-1,-1
GRONOW.txt,359449,362004,2555,10,N,N,-,-1,-1
GRONOW.txt,360011,362033,2022,10,N,N,-,-1,-1
GRONOW.txt,360170,362229,2059,10,N,N,-,-1,-1
GRONOW.txt,360555,362250,1695,10,N,N,-,-1,-1
GRONOW.txt,360641,362613,1972,10,N,N,-,-1,-1
GRONOW.txt,360766,362800,2034,10,N,N,-,-1,-1
GRONOW.txt,361016,362958,1942,10,N,N,-,-1,-1
GRONOW.txt,361252,362985,1733,10,N,N,-,-1,-1
GRONOW.txt,361433,363142,1709,10,N,N,-,-1,-1
GRONOW.txt,361674,363237,1563,10,N,N,-,-1,-1
GRONOW.txt,362007,363437,1430,10,N,N,-,-1,-1
GRONOW.txt,362034,363564,1530,10,N,N,-,-1,-1
GRONOW.txt,362230,363657,1427,10,N,N,-,-1,-1
GRONOW.txt,362251,363772,1521,10,N,N,-,-1,-1
GRONOW.txt,362614,363893,1279,10,N,N,-,-1,-1
GRONOW.txt,362801,363949,1148,10,N,N,-,-1,-1
GRONOW.txt,362959,364130,1171,10,N,N,-,-1,-1
GRONOW.txt,362986,364226,1240,10,N,N,-,-1,-1
GRONOW.txt,363143,364341,1198,10,N,N,-,-1,-1
GRONOW.txt,363240,364560,1320,10,N,N,-,-1,-1
GRONOW.txt,363438,364754,1316,10,N,N,-,-1,-1
GRONOW.txt,363567,364780,1213,10,N,N,-,-1,-1
GRONOW.txt,363658,364803,1145,10,N,N,-,-1,-1
GRONOW.txt,363773,364883,1110,10,N,N,-,-1,-1
GRONOW.txt,363894,364970,1076,10,N,N,-,-1,-1
GRONOW.txt,363954,365084,1130,10,N,N,-,-1,-1
GRONOW.txt,364131,365325,1194,10,N,N,-,-1,-1
GRONOW.txt,364227,365405,1178,10,N,N,-,-1,-1
GRONOW.txt,364342,365550,1208,10,N,N,-,-1,-1
GRONOW.txt,364561,365630,1069,10,N,N,-,-1,-1
GRONOW.txt,364755,365677,922,10,N,N,-,-1,-1
GRONOW.txt,364783,365899,1116,10,N,N,-,-1,-1
GRONOW.txt,364804,366106,1302,10,N,N,-,-1,-1
GRONOW.txt,364884,366208,1324,10,N,N,-,-1,-1
GRONOW.txt,364972,366228,1256,10,N,N,-,-1,-1
GRONOW.txt,365085,366414,1329,10,N,N,-,-1,-1
GRONOW.txt,365326,366573,1247,10,N,N,-,-1,-1
GRONOW.txt,365406,366936,1530,10,N,N,-,-1,-1
GRONOW.txt,365551,367098,1547,10,N,N,-,-1,-1
GRONOW.txt,365631,367232,1601,10,N,N,-,-1,-1
GRONOW.txt,365678,367449,1771,10,N,N,-,-1,-1
GRONOW.txt,365900,367956,2056,10,N,N,-,-1,-1
GRONOW.txt,366107,368172,2065,10,N,N,-,-1,-1
GRONOW.txt,366211,368438,2227,10,N,N,-,-1,-1
GRONOW.txt,366229,368482,2253,10,N,N,-,-1,-1
GRONOW.txt,366415,368520,2105,10,N,N,-,-1,-1
GRONOW.txt,366574,368805,2231,10,N,N,-,-1,-1
GRONOW.txt,366937,368919,1982,10,N,N,-,-1,-1
GRONOW.txt,367099,369059,1960,10,N,N,-,-1,-1
GRONOW.txt,367237,369210,1973,10,N,N,-,-1,-1
GRONOW.txt,367450,369437,1987,10,N,N,-,-1,-1
GRONOW.txt,367957,369780,1823,10,N,N,-,-1,-1
GRONOW.txt,368174,370110,1936,10,N,N,-,-1,-1
GRONOW.txt,368439,370415,1976,10,N,N,-,-1,-1
GRONOW.txt,368485,370483,1998,10,N,N,-,-1,-1
GRONOW.txt,368521,370513,1992,10,N,N,-,-1,-1
GRONOW.txt,368806,370613,1807,10,N,N,-,-1,-1
GRONOW.txt,368920,370736,1816,10,N,N,-,-1,-1
GRONOW.txt,369060,370822,1762,10,N,N,-,-1,-1
GRONOW.txt,369211,370849,1638,10,N,N,-,-1,-1
GRONOW.txt,369439,370950,1511,10,N,N,-,-1,-1
GRONOW.txt,369782,371221,1439,10,N,N,-,-1,-1
GRONOW.txt,370111,371458,1347,10,N,N,-,-1,-1
GRONOW.txt,370416,371671,1255,10,N,N,-,-1,-1
GRONOW.txt,370486,371807,1321,10,N,N,-,-1,-1
GRONOW.txt,370514,371928,1414,10,N,N,-,-1,-1
GRONOW.txt,370616,371965,1349,10,N,N,-,-1,-1
GRONOW.txt,370737,372016,1279,10,N,N,-,-1,-1
GRONOW.txt,370823,372213,1390,10,N,N,-,-1,-1
GRONOW.txt,370852,372305,1453,10,N,N,-,-1,-1
GRONOW.txt,370952,372457,1505,10,N,N,-,-1,-1
GRONOW.txt,371222,372538,1316,10,N,N,-,-1,-1
GRONOW.txt,371460,372641,1181,10,N,N,-,-1,-1
GRONOW.txt,371674,372818,1144,10,N,N,-,-1,-1
GRONOW.txt,371808,372994,1186,10,N,N,-,-1,-1
GRONOW.txt,371929,373141,1212,10,N,N,-,-1,-1
GRONOW.txt,371968,373470,1502,10,N,N,-,-1,-1
GRONOW.txt,372017,373578,1561,10,N,N,-,-1,-1
GRONOW.txt,372215,373619,1404,10,N,N,-,-1,-1
GRONOW.txt,372306,373868,1562,10,N,N,-,-1,-1
GRONOW.txt,372458,373978,1520,10,N,N,-,-1,-1
GRONOW.txt,372541,374216,1675,10,N,N,-,-1,-1
GRONOW.txt,372642,374463,1821,10,N,N,-,-1,-1
GRONOW.txt,372819,374606,1787,10,N,N,-,-1,-1
GRONOW.txt,372995,374810,1815,10,N,N,-,-1,-1
GRONOW.txt,373142,374967,1825,10,N,N,-,-1,-1
GRONOW.txt,373473,375134,1661,10,N,N,-,-1,-1
GRONOW.txt,373581,375521,1940,10,N,N,-,-1,-1
GRONOW.txt,373620,375700,2080,10,N,N,-,-1,-1
GRONOW.txt,373869,375789,1920,10,N,N,-,-1,-1
GRONOW.txt,373981,375986,2005,10,N,N,-,-1,-1
GRONOW.txt,374219,376189,1970,10,N,N,-,-1,-1
GRONOW.txt,374464,376224,1760,10,N,N,-,-1,-1
GRONOW.txt,374607,376397,1790,10,N,N,-,-1,-1
GRONOW.txt,374811,376419,1608,10,N,N,-,-1,-1
GRONOW.txt,374968,376536,1568,10,N,N,-,-1,-1
GRONOW.txt,375135,376820,1685,10,N,N,-,-1,-1
GRONOW.txt,375522,376924,1402,10,N,N,-,-1,-1
GRONOW.txt,375701,377243,1542,10,N,N,-,-1,-1
GRONOW.txt,375790,377315,1525,10,N,N,-,-1,-1
GRONOW.txt,375987,377526,1539,10,N,N,-,-1,-1
GRONOW.txt,376190,377783,1593,10,N,N,-,-1,-1
GRONOW.txt,376225,378090,1865,10,N,N,-,-1,-1
GRONOW.txt,376400,378543,2143,10,N,N,-,-1,-1
GRONOW.txt,376420,378776,2356,10,N,N,-,-1,-1
GRONOW.txt,376537,378937,2400,10,N,N,-,-1,-1
GRONOW.txt,376821,379018,2197,10,N,N,-,-1,-1
GRONOW.txt,376925,379192,2267,10,N,N,-,-1,-1
GRONOW.txt,377245,379443,2198,10,N,N,-,-1,-1
GRONOW.txt,377320,379464,2144,10,N,N,-,-1,-1
GRONOW.txt,377527,379568,2041,10,N,N,-,-1,-1
GRONOW.txt,377784,379722,1938,10,N,N,-,-1,-1
GRONOW.txt,378091,379936,1845,10,N,N,-,-1,-1
GRONOW.txt,378546,380128,1582,10,N,N,-,-1,-1
GRONOW.txt,378777,380329,1552,10,N,N,-,-1,-1
GRONOW.txt,378938,380545,1607,10,N,N,-,-1,-1
GRONOW.txt,379019,380680,1661,10,N,N,-,-1,-1
GRONOW.txt,379193,380749,1556,10,N,N,-,-1,-1
GRONOW.txt,379446,380961,1515,10,N,N,-,-1,-1
GRONOW.txt,379465,381158,1693,10,N,N,-,-1,-1
GRONOW.txt,379569,381361,1792,10,N,N,-,-1,-1
GRONOW.txt,379723,381717,1994,10,N,N,-,-1,-1
GRONOW.txt,379937,382018,2081,10,N,N,-,-1,-1
GRONOW.txt,380129,382130,2001,10,N,N,-,-1,-1
GRONOW.txt,380330,382437,2107,10,N,N,-,-1,-1
GRONOW.txt,380546,382521,1975,10,N,N,-,-1,-1
GRONOW.txt,380683,383006,2323,10,N,N,-,-1,-1
GRONOW.txt,380750,383215,2465,10,N,N,-,-1,-1
GRONOW.txt,380962,383407,2445,10,N,N,-,-1,-1
GRONOW.txt,381159,383451,2292,10,N,N,-,-1,-1
GRONOW.txt,381364,383558,2194,10,N,N,-,-1,-1
GRONOW.txt,381718,383799,2081,10,N,N,-,-1,-1
GRONOW.txt,382019,384053,2034,10,N,N,-,-1,-1
GRONOW.txt,382131,384175,2044,10,N,N,-,-1,-1
GRONOW.txt,382438,384721,2283,10,N,N,-,-1,-1
GRONOW.txt,382522,384761,2239,10,N,N,-,-1,-1
GRONOW.txt,383007,384815,1808,10,N,N,-,-1,-1
GRONOW.txt,383216,385066,1850,10,N,N,-,-1,-1
GRONOW.txt,383410,385235,1825,10,N,N,-,-1,-1
GRONOW.txt,383453,385340,1887,10,N,N,-,-1,-1
GRONOW.txt,383559,385567,2008,10,N,N,-,-1,-1
GRONOW.txt,383800,385737,1937,10,N,N,-,-1,-1
GRONOW.txt,384056,385857,1801,10,N,N,-,-1,-1
GRONOW.txt,384176,385986,1810,10,N,N,-,-1,-1
GRONOW.txt,384724,386048,1324,10,N,N,-,-1,-1
GRONOW.txt,384762,386080,1318,10,N,N,-,-1,-1
GRONOW.txt,384817,386253,1436,10,N,N,-,-1,-1
GRONOW.txt,385067,386310,1243,10,N,N,-,-1,-1
GRONOW.txt,385236,386548,1312,10,N,N,-,-1,-1
GRONOW.txt,385341,386674,1333,10,N,N,-,-1,-1
GRONOW.txt,385568,386817,1249,10,N,N,-,-1,-1
GRONOW.txt,385738,387011,1273,10,N,N,-,-1,-1
GRONOW.txt,385858,387112,1254,10,N,N,-,-1,-1
GRONOW.txt,385989,387325,1336,10,N,N,-,-1,-1
GRONOW.txt,386051,387361,1310,10,N,N,-,-1,-1
GRONOW.txt,386081,387627,1546,10,N,N,-,-1,-1
GRONOW.txt,386255,387804,1549,10,N,N,-,-1,-1
GRONOW.txt,386311,387977,1666,10,N,N,-,-1,-1
GRONOW.txt,386549,388176,1627,10,N,N,-,-1,-1
GRONOW.txt,386677,388200,1523,10,N,N,-,-1,-1
GRONOW.txt,386818,388556,1738,10,N,N,-,-1,-1
GRONOW.txt,387012,388644,1632,10,N,N,-,-1,-1
GRONOW.txt,387113,388818,1705,10,N,N,-,-1,-1
GRONOW.txt,387326,389002,1676,10,N,N,-,-1,-1
GRONOW.txt,387364,389044,1680,10,N,N,-,-1,-1
GRONOW.txt,387629,389331,1702,10,N,N,-,-1,-1
GRONOW.txt,387807,389636,1829,10,N,N,-,-1,-1
GRONOW.txt,387978,389836,1858,10,N,N,-,-1,-1
GRONOW.txt,388179,389968,1789,10,N,N,-,-1,-1
GRONOW.txt,388201,390046,1845,10,N,N,-,-1,-1
GRONOW.txt,388557,390216,1659,10,N,N,-,-1,-1
GRONOW.txt,388645,390348,1703,10,N,N,-,-1,-1
GRONOW.txt,388819,390553,1734,10,N,N,-,-1,-1
GRONOW.txt,389003,390793,1790,10,N,N,-,-1,-1
GRONOW.txt,389045,390852,1807,10,N,N,-,-1,-1
GRONOW.txt,389332,390889,1557,10,N,N,-,-1,-1
GRONOW.txt,389637,391001,1364,10,N,N,-,-1,-1
GRONOW.txt,389837,391470,1633,10,N,N,-,-1,-1
GRONOW.txt,389969,391762,1793,10,N,N,-,-1,-1
GRONOW.txt,390047,392050,2003,10,N,N,-,-1,-1
GRONOW.txt,390217,392084,1867,10,N,N,-,-1,-1
GRONOW.txt,390349,392283,1934,10,N,N,-,-1,-1
GRONOW.txt,390554,392388,1834,10,N,N,-,-1,-1
GRONOW.txt,390796,392487,1691,10,N,N,-,-1,-1
GRONOW.txt,390855,392864,2009,10,N,N,-,-1,-1
GRONOW.txt,390890,393100,2210,10,N,N,-,-1,-1
GRONOW.txt,391003,393262,2259,10,N,N,-,-1,-1
GRONOW.txt,391471,393606,2135,10,N,N,-,-1,-1
GRONOW.txt,391765,393660,1895,10,N,N,-,-1,-1
GRONOW.txt,392053,393966,1913,10,N,N,-,-1,-1
GRONOW.txt,392085,394001,1916,10,N,N,-,-1,-1
GRONOW.txt,392284,394102,1818,10,N,N,-,-1,-1
GRONOW.txt,392389,394239,1850,10,N,N,-,-1,-1
GRONOW.txt,392488,394393,1905,10,N,N,-,-1,-1
GRONOW.txt,392867,394514,1647,10,N,N,-,-1,-1
GRONOW.txt,393101,394642,1541,10,N,N,-,-1,-1
GRONOW.txt,393263,394811,1548,10,N,N,-,-1,-1
GRONOW.txt,393607,395009,1402,10,N,N,-,-1,-1
GRONOW.txt,393661,395111,1450,10,N,N,-,-1,-1
GRONOW.txt,393969,395234,1265,10,N,N,-,-1,-1
GRONOW.txt,394002,395377,1375,10,N,N,-,-1,-1
GRONOW.txt,394107,395498,1391,10,N,N,-,-1,-1
GRONOW.txt,394240,395562,1322,10,N,N,-,-1,-1
GRONOW.txt,394394,395759,1365,10,N,N,-,-1,-1
GRONOW.txt,394517,395856,1339,10,N,N,-,-1,-1
GRONOW.txt,394643,395902,1259,10,N,N,-,-1,-1
GRONOW.txt,394812,396105,1293,10,N,N,-,-1,-1
GRONOW.txt,395010,396203,1193,10,N,N,-,-1,-1
GRONOW.txt,395112,396340,1228,10,N,N,-,-1,-1
GRONOW.txt,395236,396605,1369,10,N,N,-,-1,-1
GRONOW.txt,395378,396633,1255,10,N,N,-,-1,-1
GRONOW.txt,395500,396753,1253,10,N,N,-,-1,-1
GRONOW.txt,395563,396873,1310,10,N,N,-,-1,-1
GRONOW.txt,395761,397179,1418,10,N,N,-,-1,-1
GRONOW.txt,395861,397258,1397,10,N,N,-,-1,-1
GRONOW.txt,395903,397290,1387,10,N,N,-,-1,-1
GRONOW.txt,396106,397482,1376,10,N,N,-,-1,-1
GRONOW.txt,396204,397579,1375,10,N,N,-,-1,-1
GRONOW.txt,396341,397846,1505,10,N,N,-,-1,-1
GRONOW.txt,396608,397974,1366,10,N,N,-,-1,-1
GRONOW.txt,396634,398153,1519,10,N,N,-,-1,-1
GRONOW.txt,396754,398298,1544,10,N,N,-,-1,-1
GRONOW.txt,396874,398520,1646,10,N,N,-,-1,-1
GRONOW.txt,397180,398820,1640,10,N,N,-,-1,-1
GRONOW.txt,397259,398859,1600,10,N,N,-,-1,-1
GRONOW.txt,397291,399056,1765,10,N,N,-,-1,-1
GRONOW.txt,397483,399191,1708,10,N,N,-,-1,-1
GRONOW.txt,397584,399325,1741,10,N,N,-,-1,-1
GRONOW.txt,397847,399374,1527,10,N,N,-,-1,-1
GRONOW.txt,397975,399656,1681,10,N,N,-,-1,-1
GRONOW.txt,398154,399794,1640,10,N,N,-,-1,-1
GRONOW.txt,398299,399918,1619,10,N,N,-,-1,-1
GRONOW.txt,398522,400124,1602,10,N,N,-,-1,-1
GRONOW.txt,398823,400315,1492,10,N,N,-,-1,-1
GRONOW.txt,398860,400470,1610,10,N,N,-,-1,-1
GRONOW.txt,399057,400519,1462,10,N,N,-,-1,-1
GRONOW.txt,399192,400748,1556,10,N,N,-,-1,-1
GRONOW.txt,399326,401012,1686,10,N,N,-,-1,-1
GRONOW.txt,399375,401026,1651,10,N,N,-,-1,-1
GRONOW.txt,399657,401155,1498,10,N,N,-,-1,-1
GRONOW.txt,399795,401273,1478,10,N,N,-,-1,-1
GRONOW.txt,399919,401419,1500,10,N,N,-,-1,-1
GRONOW.txt,400126,401601,1475,10,N,N,-,-1,-1
GRONOW.txt,400316,401763,1447,10,N,N,-,-1,-1
GRONOW.txt,400473,401890,1417,10,N,N,-,-1,-1
GRONOW.txt,400520,402063,1543,10,N,N,-,-1,-1
GRONOW.txt,400749,402194,1445,10,N,N,-,-1,-1
GRONOW.txt,401015,402564,1549,10,N,N,-,-1,-1
GRONOW.txt,401027,402752,1725,10,N,N,-,-1,-1
GRONOW.txt,401158,402822,1664,10,N,N,-,-1,-1
GRONOW.txt,401274,402948,1674,10,N,N,-,-1,-1
GRONOW.txt,401420,403040,1620,10,N,N,-,-1,-1
GRONOW.txt,401604,403314,1710,10,N,N,-,-1,-1
GRONOW.txt,401764,403516,1752,10,N,N,-,-1,-1
GRONOW.txt,401891,403554,1663,10,N,N,-,-1,-1
GRONOW.txt,402064,403837,1773,10,N,N,-,-1,-1
GRONOW.txt,402195,403972,1777,10,N,N,-,-1,-1
GRONOW.txt,402566,404210,1644,10,N,N,-,-1,-1
GRONOW.txt,402753,404283,1530,10,N,N,-,-1,-1
GRONOW.txt,402823,404413,1590,10,N,N,-,-1,-1
GRONOW.txt,402949,404496,1547,10,N,N,-,-1,-1
GRONOW.txt,403041,404721,1680,10,N,N,-,-1,-1
GRONOW.txt,403316,404859,1543,10,N,N,-,-1,-1
GRONOW.txt,403519,405002,1483,10,N,N,-,-1,-1
GRONOW.txt,403555,405293,1738,10,N,N,-,-1,-1
GRONOW.txt,403838,405938,2100,10,N,N,-,-1,-1
GRONOW.txt,403973,406121,2148,10,N,N,-,-1,-1
GRONOW.txt,404211,406190,1979,10,N,N,-,-1,-1
GRONOW.txt,404284,406324,2040,10,N,N,-,-1,-1
GRONOW.txt,404416,406473,2057,10,N,N,-,-1,-1
GRONOW.txt,404497,406592,2095,10,N,N,-,-1,-1
GRONOW.txt,404723,406690,1967,10,N,N,-,-1,-1
GRONOW.txt,404862,406823,1961,10,N,N,-,-1,-1
GRONOW.txt,405003,407032,2029,10,N,N,-,-1,-1
GRONOW.txt,405294,407230,1936,10,N,N,-,-1,-1
GRONOW.txt,405940,407560,1620,10,N,N,-,-1,-1
GRONOW.txt,406122,407671,1549,10,N,N,-,-1,-1
GRONOW.txt,406191,407799,1608,10,N,N,-,-1,-1
GRONOW.txt,406325,407894,1569,10,N,N,-,-1,-1
GRONOW.txt,406476,408039,1563,10,N,N,-,-1,-1
GRONOW.txt,406593,408072,1479,10,N,N,-,-1,-1
GRONOW.txt,406691,408350,1659,10,N,N,-,-1,-1
GRONOW.txt,406824,408612,1788,10,N,N,-,-1,-1
GRONOW.txt,407033,408815,1782,10,N,N,-,-1,-1
GRONOW.txt,407231,408952,1721,10,N,N,-,-1,-1
GRONOW.txt,407563,409199,1636,10,N,N,-,-1,-1
GRONOW.txt,407672,409241,1569,10,N,N,-,-1,-1
GRONOW.txt,407802,409327,1525,10,N,N,-,-1,-1
GRONOW.txt,407895,409421,1526,10,N,N,-,-1,-1
GRONOW.txt,408042,409481,1439,10,N,N,-,-1,-1
GRONOW.txt,408073,409700,1627,10,N,N,-,-1,-1
GRONOW.txt,408351,409810,1459,10,N,N,-,-1,-1
GRONOW.txt,408613,409989,1376,10,N,N,-,-1,-1
GRONOW.txt,408816,410101,1285,10,N,N,-,-1,-1
GRONOW.txt,408953,410449,1496,10,N,N,-,-1,-1
GRONOW.txt,409200,410765,1565,10,N,N,-,-1,-1
GRONOW.txt,409243,410805,1562,10,N,N,-,-1,-1
GRONOW.txt,409328,410917,1589,10,N,N,-,-1,-1
GRONOW.txt,409422,411125,1703,10,N,N,-,-1,-1
GRONOW.txt,409482,411471,1989,10,N,N,-,-1,-1
GRONOW.txt,409703,411659,1956,10,N,N,-,-1,-1
GRONOW.txt,409811,411971,2160,10,N,N,-,-1,-1
GRONOW.txt,409990,412173,2183,10,N,N,-,-1,-1
GRONOW.txt,410103,412199,2096,10,N,N,-,-1,-1
GRONOW.txt,410452,412228,1776,10,N,N,-,-1,-1
GRONOW.txt,410768,412523,1755,10,N,N,-,-1,-1
GRONOW.txt,410806,412572,1766,10,N,N,-,-1,-1
GRONOW.txt,410918,412853,1935,10,N,N,-,-1,-1
GRONOW.txt,411126,412888,1762,10,N,N,-,-1,-1
GRONOW.txt,411472,412998,1526,10,N,N,-,-1,-1
GRONOW.txt,411662,413103,1441,10,N,N,-,-1,-1
GRONOW.txt,411972,413226,1254,10,N,N,-,-1,-1
GRONOW.txt,412174,413377,1203,10,N,N,-,-1,-1
GRONOW.txt,412200,413589,1389,10,N,N,-,-1,-1
GRONOW.txt,412229,413710,1481,10,N,N,-,-1,-1
GRONOW.txt,412524,413936,1412,10,N,N,-,-1,-1
GRONOW.txt,412573,414070,1497,10,N,N,-,-1,-1
GRONOW.txt,412854,414092,1238,10,N,N,-,-1,-1
GRONOW.txt,412889,414395,1506,10,N,N,-,-1,-1
GRONOW.txt,413000,414551,1551,10,N,N,-,-1,-1
GRONOW.txt,413106,414855,1749,10,N,N,-,-1,-1
GRONOW.txt,413227,414964,1737,10,N,N,-,-1,-1
GRONOW.txt,413378,415024,1646,10,N,N,-,-1,-1
GRONOW.txt,413590,415187,1597,10,N,N,-,-1,-1
GRONOW.txt,413711,415416,1705,10,N,N,-,-1,-1
GRONOW.txt,413937,415567,1630,10,N,N,-,-1,-1
GRONOW.txt,414073,415913,1840,10,N,N,-,-1,-1
GRONOW.txt,414093,416148,2055,10,N,N,-,-1,-1
GRONOW.txt,414396,416273,1877,10,N,N,-,-1,-1
GRONOW.txt,414554,416316,1762,10,N,N,-,-1,-1
GRONOW.txt,414856,416458,1602,10,N,N,-,-1,-1
GRONOW.txt,414965,416686,1721,10,N,N,-,-1,-1
GRONOW.txt,415025,416711,1686,10,N,N,-,-1,-1
GRONOW.txt,415190,416790,1600,10,N,N,-,-1,-1
GRONOW.txt,415417,417094,1677,10,N,N,-,-1,-1
GRONOW.txt,415568,417568,2000,10,N,N,-,-1,-1
GRONOW.txt,415914,417873,1959,10,N,N,-,-1,-1
GRONOW.txt,416149,417914,1765,10,N,N,-,-1,-1
GRONOW.txt,416278,418000,1722,10,N,N,-,-1,-1
GRONOW.txt,416317,418091,1774,10,N,N,-,-1,-1
GRONOW.txt,416459,418423,1964,10,N,N,-,-1,-1
GRONOW.txt,416689,418553,1864,10,N,N,-,-1,-1
GRONOW.txt,416712,418908,2196,10,N,N,-,-1,-1
GRONOW.txt,416791,419001,2210,10,N,N,-,-1,-1
GRONOW.txt,417097,419024,1927,10,N,N,-,-1,-1
GRONOW.txt,417569,419394,1825,10,N,N,-,-1,-1
GRONOW.txt,417876,419629,1753,10,N,N,-,-1,-1
GRONOW.txt,417915,419662,1747,10,N,N,-,-1,-1
GRONOW.txt,418003,419841,1838,10,N,N,-,-1,-1
GRONOW.txt,418092,420012,1920,10,N,N,-,-1,-1
GRONOW.txt,418424,420148,1724,10,N,N,-,-1,-1
GRONOW.txt,418554,420325,1771,10,N,N,-,-1,-1
GRONOW.txt,418909,420594,1685,10,N,N,-,-1,-1
GRONOW.txt,419004,420634,1630,10,N,N,-,-1,-1
GRONOW.txt,419025,420737,1712,10,N,N,-,-1,-1
GRONOW.txt,419395,420764,1369,10,N,N,-,-1,-1
GRONOW.txt,419629,420925,1296,10,N,N,-,-1,-1
GRONOW.txt,419663,421097,1434,10,N,N,-,-1,-1
GRONOW.txt,419842,421389,1547,10,N,N,-,-1,-1
GRONOW.txt,420015,421463,1448,10,N,N,-,-1,-1
GRONOW.txt,420149,421670,1521,10,N,N,-,-1,-1
GRONOW.txt,420326,421949,1623,10,N,N,-,-1,-1
GRONOW.txt,420595,422271,1676,10,N,N,-,-1,-1
GRONOW.txt,420635,422302,1667,10,N,N,-,-1,-1
GRONOW.txt,420740,422476,1736,10,N,N,-,-1,-1
GRONOW.txt,420765,422580,1815,10,N,N,-,-1,-1
GRONOW.txt,420926,422684,1758,10,N,N,-,-1,-1
GRONOW.txt,421098,422742,1644,10,N,N,-,-1,-1
GRONOW.txt,421394,422793,1399,10,N,N,-,-1,-1
GRONOW.txt,421466,422889,1423,10,N,N,-,-1,-1
GRONOW.txt,421672,422972,1300,10,N,N,-,-1,-1
GRONOW.txt,421950,422976,1026,10,N,N,-,-1,-1
GRONOW.txt,422274,423021,747,10,N,N,-,-1,-1
GRONOW.txt,422303,423066,763,10,N,N,-,-1,-1
GRONOW.txt,422477,423118,641,10,N,N,-,-1,-1
GRONOW.txt,422581,423227,646,10,N,N,-,-1,-1
GRONOW.txt,422685,423293,608,10,N,N,-,-1,-1
GRONOW.txt,422743,423365,622,10,N,N,-,-1,-1
GRONOW.txt,422794,423542,748,10,N,N,-,-1,-1
GRONOW.txt,422890,423660,770,10,N,N,-,-1,-1
GRONOW.txt,422973,423792,819,10,N,N,-,-1,-1
GRONOW.txt,422978,423997,1019,10,N,N,-,-1,-1
GRONOW.txt,423022,424159,1137,10,N,N,-,-1,-1
GRONOW.txt,423067,424367,1300,10,N,N,-,-1,-1
GRONOW.txt,423120,424408,1288,10,N,N,-,-1,-1
GRONOW.txt,423228,424539,1311,10,N,N,-,-1,-1
GRONOW.txt,423294,424796,1502,10,N,N,-,-1,-1
GRONOW.txt,423368,424834,1466,10,N,N,-,-1,-1
GRONOW.txt,423543,425044,1501,10,N,Y,1437472966198,394609,395892
GRONOW.txt,423661,425330,1669,10,N,Y,1437472966198,394609,395892
GRONOW.txt,423793,425421,1628,10,N,Y,1437472966198,394609,395892
GRONOW.txt,423998,425614,1616,10,N,Y,1437472966198,394609,395892
GRONOW.txt,424160,425770,1610,10,N,Y,1437472966198,394609,395892
GRONOW.txt,424368,425887,1519,10,N,Y,1437472966198,394609,395892
GRONOW.txt,424409,426071,1662,10,N,Y,1437472966198,394609,395892
GRONOW.txt,424540,426344,1804,10,N,Y,1437472966198,394609,395892
GRONOW.txt,424799,426431,1632,10,N,Y,1437472966198,394609,395892
GRONOW.txt,424835,426539,1704,10,N,Y,1437472966198,394609,395892
GRONOW.txt,425045,426562,1517,10,N,Y,1437472966198,394609,395892
GRONOW.txt,425331,426583,1252,10,N,Y,1437472966198,394609,395892
GRONOW.txt,425424,426685,1261,10,N,Y,1437472966198,394609,395892
GRONOW.txt,425615,426784,1169,10,N,Y,1437472966198,394609,395892
GRONOW.txt,425771,427107,1336,10,N,Y,1437472966198,394609,395892
GRONOW.txt,425888,427165,1277,10,N,N,-,-1,-1
GRONOW.txt,426072,427205,1133,10,N,N,-,-1,-1
GRONOW.txt,426346,427463,1117,10,N,Y,1437470299748,152207,152889
GRONOW.txt,426432,427570,1138,10,N,Y,1437470299748,152207,152889
GRONOW.txt,426540,427665,1125,10,N,Y,1437470299748,152207,152889
GRONOW.txt,426563,427825,1262,10,N,Y,1437470299748,152207,152889
GRONOW.txt,426584,427859,1275,10,N,Y,1437470299748,152207,152889
GRONOW.txt,426686,427983,1297,10,N,Y,1437470299748,152207,152889
GRONOW.txt,426787,428282,1495,10,N,Y,1437470299748,152207,152889
GRONOW.txt,427108,428296,1188,10,Y,Y,1437470299748,152207,152889
GRONOW.txt,427166,428511,1345,10,N,Y,1437470299748,152207,152889
GRONOW.txt,427206,428550,1344,10,N,Y,1437470299748,152207,152889
GRONOW.txt,427464,428726,1262,10,N,Y,1437470299748,152207,152889
GRONOW.txt,427571,428900,1329,10,N,Y,1437470299748,152207,152889
GRONOW.txt,427666,428910,1244,10,N,Y,1437470299748,152207,152889
GRONOW.txt,427826,429008,1182,10,N,Y,1437470299748,152207,152889
GRONOW.txt,427860,429045,1185,10,N,Y,1437470299748,152207,152889
GRONOW.txt,427984,429161,1177,10,Y,Y,1437470299748,152207,152889
GRONOW.txt,428287,429190,903,10,N,Y,1437470299748,152207,152889
GRONOW.txt,428297,429412,1115,10,N,Y,1437470299748,152207,152889
GRONOW.txt,428514,429570,1056,10,N,N,-,-1,-1
GRONOW.txt,428551,429656,1105,10,N,N,-,-1,-1
GRONOW.txt,428727,429807,1080,10,N,N,-,-1,-1
GRONOW.txt,428902,429898,996,10,N,N,-,-1,-1
GRONOW.txt,428911,429955,1044,10,N,N,-,-1,-1
GRONOW.txt,429009,429982,973,10,N,N,-,-1,-1
GRONOW.txt,429046,430066,1020,10,N,N,-,-1,-1
GRONOW.txt,429164,430199,1035,10,N,N,-,-1,-1
GRONOW.txt,429191,430386,1195,10,N,N,-,-1,-1
GRONOW.txt,429414,430407,993,10,N,N,-,-1,-1
GRONOW.txt,429571,430456,885,10,N,N,-,-1,-1
GRONOW.txt,429657,430725,1068,10,N,N,-,-1,-1
GRONOW.txt,429808,430881,1073,10,N,N,-,-1,-1
GRONOW.txt,429899,431108,1209,10,N,N,-,-1,-1
GRONOW.txt,429956,431197,1241,10,N,N,-,-1,-1
GRONOW.txt,429983,431434,1451,10,N,N,-,-1,-1
GRONOW.txt,430067,431447,1380,10,N,N,-,-1,-1
GRONOW.txt,430200,431655,1455,10,N,N,-,-1,-1
GRONOW.txt,430387,431843,1456,10,N,N,-,-1,-1
GRONOW.txt,430410,432263,1853,10,N,N,-,-1,-1
GRONOW.txt,430457,432404,1947,10,N,N,-,-1,-1
GRONOW.txt,430726,432596,1870,10,N,N,-,-1,-1
GRONOW.txt,430882,433013,2131,10,N,N,-,-1,-1
GRONOW.txt,431109,433290,2181,10,N,N,-,-1,-1
GRONOW.txt,431198,433518,2320,10,N,N,-,-1,-1
GRONOW.txt,431437,433557,2120,10,N,N,-,-1,-1
GRONOW.txt,431448,433663,2215,10,N,N,-,-1,-1
GRONOW.txt,431656,433742,2086,10,N,N,-,-1,-1
GRONOW.txt,431845,433837,1992,10,N,N,-,-1,-1
GRONOW.txt,432266,433964,1698,10,N,N,-,-1,-1
GRONOW.txt,432406,434104,1698,10,N,N,-,-1,-1
GRONOW.txt,432597,434282,1685,10,N,N,-,-1,-1
GRONOW.txt,433014,434467,1453,10,N,N,-,-1,-1
GRONOW.txt,433291,434521,1230,10,N,N,-,-1,-1
GRONOW.txt,433521,434552,1031,10,N,N,-,-1,-1
GRONOW.txt,433557,434669,1112,10,N,N,-,-1,-1
GRONOW.txt,433664,434767,1103,10,N,N,-,-1,-1
GRONOW.txt,433743,434913,1170,10,N,N,-,-1,-1
GRONOW.txt,433838,435131,1293,10,N,N,-,-1,-1
GRONOW.txt,433965,435444,1479,10,N,N,-,-1,-1
GRONOW.txt,434105,435553,1448,10,N,N,-,-1,-1
GRONOW.txt,434283,435617,1334,10,N,N,-,-1,-1
GRONOW.txt,434468,435738,1270,10,N,N,-,-1,-1
GRONOW.txt,434524,435823,1299,10,N,N,-,-1,-1
GRONOW.txt,434553,435865,1312,10,N,N,-,-1,-1
GRONOW.txt,434670,436137,1467,10,N,N,-,-1,-1
GRONOW.txt,434770,436176,1406,10,N,N,-,-1,-1
GRONOW.txt,434914,436295,1381,10,N,N,-,-1,-1
GRONOW.txt,435132,436403,1271,10,N,N,-,-1,-1
GRONOW.txt,435445,436473,1028,10,N,N,-,-1,-1
GRONOW.txt,435555,436567,1012,10,N,N,-,-1,-1
GRONOW.txt,435618,436784,1166,10,N,N,-,-1,-1
GRONOW.txt,435739,437095,1356,10,N,N,-,-1,-1
GRONOW.txt,435824,437272,1448,10,N,N,-,-1,-1
GRONOW.txt,435867,437344,1477,10,N,N,-,-1,-1
GRONOW.txt,436140,437441,1301,10,N,N,-,-1,-1
GRONOW.txt,436177,437624,1447,10,N,N,-,-1,-1
GRONOW.txt,436296,437654,1358,10,N,N,-,-1,-1
GRONOW.txt,436404,437710,1306,10,N,N,-,-1,-1
GRONOW.txt,436474,437830,1356,10,N,N,-,-1,-1
GRONOW.txt,436568,437987,1419,10,N,N,-,-1,-1
GRONOW.txt,436787,438012,1225,10,N,N,-,-1,-1
GRONOW.txt,437096,438302,1206,10,N,N,-,-1,-1
GRONOW.txt,437273,438461,1188,10,N,N,-,-1,-1
GRONOW.txt,437345,438495,1150,10,N,N,-,-1,-1
GRONOW.txt,437442,438821,1379,10,N,N,-,-1,-1
GRONOW.txt,437625,438988,1363,10,N,N,-,-1,-1
GRONOW.txt,437656,439196,1540,10,N,N,-,-1,-1
GRONOW.txt,437712,439383,1671,10,N,N,-,-1,-1
GRONOW.txt,437831,439407,1576,10,N,N,-,-1,-1
GRONOW.txt,437988,439491,1503,10,N,N,-,-1,-1
GRONOW.txt,438013,439523,1510,10,N,N,-,-1,-1
GRONOW.txt,438303,439616,1313,10,N,N,-,-1,-1
GRONOW.txt,438464,439650,1186,10,N,N,-,-1,-1
GRONOW.txt,438496,439705,1209,10,N,N,-,-1,-1
GRONOW.txt,438822,439755,933,10,N,N,-,-1,-1
GRONOW.txt,438989,439927,938,10,N,N,-,-1,-1
GRONOW.txt,439197,439979,782,10,N,N,-,-1,-1
GRONOW.txt,439384,440100,716,10,N,N,-,-1,-1
GRONOW.txt,439408,440432,1024,10,N,N,-,-1,-1
GRONOW.txt,439492,440553,1061,10,N,N,-,-1,-1
GRONOW.txt,439524,440612,1088,10,N,N,-,-1,-1
GRONOW.txt,439617,440849,1232,10,N,N,-,-1,-1
GRONOW.txt,439651,440863,1212,10,N,N,-,-1,-1
GRONOW.txt,439706,441089,1383,10,N,N,-,-1,-1
GRONOW.txt,439756,441128,1372,10,N,N,-,-1,-1
GRONOW.txt,439928,441313,1385,10,N,N,-,-1,-1
GRONOW.txt,439980,441672,1692,10,N,N,-,-1,-1
GRONOW.txt,440103,441681,1578,10,N,N,-,-1,-1
GRONOW.txt,440435,441803,1368,10,N,N,-,-1,-1
GRONOW.txt,440554,441934,1380,10,N,N,-,-1,-1
GRONOW.txt,440613,442144,1531,10,N,N,-,-1,-1
GRONOW.txt,440850,442420,1570,10,N,N,-,-1,-1
GRONOW.txt,440864,442714,1850,10,N,N,-,-1,-1
GRONOW.txt,441092,442928,1836,10,N,N,-,-1,-1
GRONOW.txt,441129,443049,1920,10,N,N,-,-1,-1
GRONOW.txt,441314,443385,2071,10,N,N,-,-1,-1
GRONOW.txt,441675,443407,1732,10,N,N,-,-1,-1
GRONOW.txt,441682,443496,1814,10,N,N,-,-1,-1
GRONOW.txt,441804,443695,1891,10,N,N,-,-1,-1
GRONOW.txt,441935,443754,1819,10,N,N,-,-1,-1
GRONOW.txt,442145,443854,1709,10,N,N,-,-1,-1
GRONOW.txt,442423,443981,1558,10,N,N,-,-1,-1
GRONOW.txt,442715,444125,1410,10,N,N,-,-1,-1
GRONOW.txt,442929,444193,1264,10,N,N,-,-1,-1
GRONOW.txt,443050,444293,1243,10,N,N,-,-1,-1
GRONOW.txt,443386,444636,1250,10,N,N,-,-1,-1
GRONOW.txt,443408,444904,1496,10,N,N,-,-1,-1
GRONOW.txt,443497,445087,1590,10,N,N,-,-1,-1
GRONOW.txt,443696,445159,1463,10,N,N,-,-1,-1
GRONOW.txt,443755,445447,1692,10,N,N,-,-1,-1
GRONOW.txt,443855,445574,1719,10,N,N,-,-1,-1
GRONOW.txt,443983,445763,1780,10,N,N,-,-1,-1
GRONOW.txt,444126,446174,2048,10,N,N,-,-1,-1
GRONOW.txt,444194,446273,2079,10,N,N,-,-1,-1
GRONOW.txt,444294,446560,2266,10,N,N,-,-1,-1
GRONOW.txt,444637,446793,2156,10,N,N,-,-1,-1
GRONOW.txt,444907,446962,2055,10,N,N,-,-1,-1
GRONOW.txt,445092,446994,1902,10,N,N,-,-1,-1
GRONOW.txt,445160,447101,1941,10,N,N,-,-1,-1
GRONOW.txt,445448,447259,1811,10,N,N,-,-1,-1
GRONOW.txt,445575,447511,1936,10,N,N,-,-1,-1
GRONOW.txt,445764,447716,1952,10,N,N,-,-1,-1
GRONOW.txt,446175,447926,1751,10,N,N,-,-1,-1
GRONOW.txt,446274,448029,1755,10,N,N,-,-1,-1
GRONOW.txt,446563,448234,1671,10,N,N,-,-1,-1
GRONOW.txt,446794,448425,1631,10,N,N,-,-1,-1
GRONOW.txt,446965,448496,1531,10,N,N,-,-1,-1
GRONOW.txt,446995,448608,1613,10,N,N,-,-1,-1
GRONOW.txt,447102,448746,1644,10,N,N,-,-1,-1
GRONOW.txt,447260,448865,1605,10,N,N,-,-1,-1
GRONOW.txt,447512,448904,1392,10,N,N,-,-1,-1
GRONOW.txt,447717,449027,1310,10,N,N,-,-1,-1
GRONOW.txt,447929,449233,1304,10,N,N,-,-1,-1
GRONOW.txt,448030,449406,1376,10,N,N,-,-1,-1
GRONOW.txt,448235,449462,1227,10,N,N,-,-1,-1
GRONOW.txt,448428,449738,1310,10,N,N,-,-1,-1
GRONOW.txt,448499,450045,1546,10,N,N,-,-1,-1
GRONOW.txt,448609,450083,1474,10,N,N,-,-1,-1
GRONOW.txt,448747,450155,1408,10,N,N,-,-1,-1
GRONOW.txt,448868,450336,1468,10,N,N,-,-1,-1
GRONOW.txt,448904,450481,1577,10,N,N,-,-1,-1
GRONOW.txt,449028,450705,1677,10,N,N,-,-1,-1
GRONOW.txt,449234,450857,1623,10,N,N,-,-1,-1
GRONOW.txt,449406,451086,1680,10,N,N,-,-1,-1
GRONOW.txt,449465,451274,1809,10,N,N,-,-1,-1
GRONOW.txt,449739,451501,1762,10,N,N,-,-1,-1
GRONOW.txt,450046,451790,1744,10,N,N,-,-1,-1
GRONOW.txt,450084,451803,1719,10,N,N,-,-1,-1
GRONOW.txt,450156,451915,1759,10,N,N,-,-1,-1
GRONOW.txt,450337,451951,1614,10,N,N,-,-1,-1
GRONOW.txt,450482,452056,1574,10,N,N,-,-1,-1
GRONOW.txt,450706,452235,1529,10,N,N,-,-1,-1
GRONOW.txt,450858,452317,1459,10,N,N,-,-1,-1
GRONOW.txt,451087,452355,1268,10,N,N,-,-1,-1
GRONOW.txt,451275,452500,1225,10,N,N,-,-1,-1
GRONOW.txt,451504,452756,1252,10,N,N,-,-1,-1
GRONOW.txt,451795,452958,1163,10,N,N,-,-1,-1
GRONOW.txt,451804,453292,1488,10,N,N,-,-1,-1
GRONOW.txt,451916,453313,1397,10,N,N,-,-1,-1
GRONOW.txt,451953,453368,1415,10,N,N,-,-1,-1
GRONOW.txt,452058,453415,1357,10,N,N,-,-1,-1
GRONOW.txt,452236,453455,1219,10,N,N,-,-1,-1
GRONOW.txt,452320,453593,1273,10,N,N,-,-1,-1
GRONOW.txt,452356,453845,1489,10,N,N,-,-1,-1
GRONOW.txt,452501,453981,1480,10,N,N,-,-1,-1
GRONOW.txt,452757,454003,1246,10,N,N,-,-1,-1
GRONOW.txt,452959,454256,1297,10,N,N,-,-1,-1
GRONOW.txt,453295,454447,1152,10,N,N,-,-1,-1
GRONOW.txt,453314,454710,1396,10,N,N,-,-1,-1
GRONOW.txt,453369,455090,1721,10,N,N,-,-1,-1
GRONOW.txt,453416,455141,1725,10,N,N,-,-1,-1
GRONOW.txt,453456,455421,1965,10,N,N,-,-1,-1
GRONOW.txt,453594,455738,2144,10,N,N,-,-1,-1
GRONOW.txt,453846,456065,2219,10,N,N,-,-1,-1
GRONOW.txt,453984,456264,2280,10,N,N,-,-1,-1
GRONOW.txt,454004,456325,2321,10,N,N,-,-1,-1
GRONOW.txt,454257,456494,2237,10,N,N,-,-1,-1
GRONOW.txt,454448,456772,2324,10,N,N,-,-1,-1
GRONOW.txt,454711,456856,2145,10,N,N,-,-1,-1
GRONOW.txt,455095,457075,1980,10,N,N,-,-1,-1
GRONOW.txt,455144,457408,2264,10,N,N,-,-1,-1
GRONOW.txt,455422,457681,2259,10,N,N,-,-1,-1
GRONOW.txt,455739,458182,2443,10,N,N,-,-1,-1
GRONOW.txt,456067,458242,2175,10,N,N,-,-1,-1
GRONOW.txt,456267,458507,2240,10,N,N,-,-1,-1
GRONOW.txt,456326,458645,2319,10,N,N,-,-1,-1
GRONOW.txt,456495,458876,2381,10,N,N,-,-1,-1
GRONOW.txt,456773,459069,2296,10,N,N,-,-1,-1
GRONOW.txt,456857,459208,2351,10,N,N,-,-1,-1
GRONOW.txt,457076,459280,2204,10,N,N,-,-1,-1
GRONOW.txt,457409,459538,2129,10,N,N,-,-1,-1
GRONOW.txt,457682,459962,2280,10,N,N,-,-1,-1
GRONOW.txt,458185,460100,1915,10,N,N,-,-1,-1
GRONOW.txt,458243,460238,1995,10,N,N,-,-1,-1
GRONOW.txt,458510,460279,1769,10,N,N,-,-1,-1
GRONOW.txt,458646,460433,1787,10,N,N,-,-1,-1
GRONOW.txt,458877,460493,1616,10,N,N,-,-1,-1
GRONOW.txt,459070,460578,1508,10,N,N,-,-1,-1
GRONOW.txt,459209,460630,1421,10,N,N,-,-1,-1
GRONOW.txt,459283,460653,1370,10,N,N,-,-1,-1
GRONOW.txt,459540,460749,1209,10,N,N,-,-1,-1
GRONOW.txt,459965,460773,808,10,N,N,-,-1,-1
GRONOW.txt,460101,461081,980,10,N,Y,1437471397525,350644,351290
GRONOW.txt,460239,461249,1010,10,N,Y,1437471397525,350644,351290
GRONOW.txt,460280,461556,1276,10,N,Y,1437471397525,350644,351290
GRONOW.txt,460434,461927,1493,10,Y,Y,1437471397525,350644,351290
GRONOW.txt,460494,461950,1456,10,Y,Y,1437471397525,350644,351290
GRONOW.txt,460579,462181,1602,10,Y,Y,1437471397525,350644,351290
GRONOW.txt,460631,462287,1656,10,Y,Y,1437471397525,350644,351290
GRONOW.txt,460654,462304,1650,10,Y,Y,1437471397525,350644,351290
GRONOW.txt,460752,462504,1752,10,Y,Y,1437471397525,350644,351290
GRONOW.txt,460774,462617,1843,10,Y,Y,1437471397525,350644,351290
GRONOW.txt,461082,462855,1773,10,Y,Y,1437471397525,350644,351290
GRONOW.txt,461250,462904,1654,10,Y,Y,1437471397525,350644,351290
GRONOW.txt,461558,462950,1392,10,Y,Y,1437471397525,350644,351290
GRONOW.txt,461932,463019,1087,10,N,Y,1437471397525,350644,351290
GRONOW.txt,461955,463290,1335,10,N,Y,1437471397525,350644,351290
GRONOW.txt,462182,463408,1226,10,N,Y,1437471397525,350644,351290
GRONOW.txt,462290,463601,1311,10,N,N,-,-1,-1
GRONOW.txt,462305,463645,1340,10,N,N,-,-1,-1
GRONOW.txt,462505,463926,1421,10,N,N,-,-1,-1
GRONOW.txt,462618,464100,1482,10,N,N,-,-1,-1
GRONOW.txt,462856,464182,1326,10,N,N,-,-1,-1
GRONOW.txt,462905,464247,1342,10,N,N,-,-1,-1
GRONOW.txt,462951,464310,1359,10,N,N,-,-1,-1
GRONOW.txt,463020,464610,1590,10,N,N,-,-1,-1
GRONOW.txt,463291,464683,1392,10,N,N,-,-1,-1
GRONOW.txt,463411,464787,1376,10,N,N,-,-1,-1
GRONOW.txt,463602,464917,1315,10,N,N,-,-1,-1
GRONOW.txt,463646,465085,1439,10,N,N,-,-1,-1
GRONOW.txt,463927,465127,1200,10,N,N,-,-1,-1
GRONOW.txt,464101,465212,1111,10,N,N,-,-1,-1
GRONOW.txt,464185,465267,1082,10,N,N,-,-1,-1
GRONOW.txt,464248,465447,1199,10,N,N,-,-1,-1
GRONOW.txt,464311,465560,1249,10,N,N,-,-1,-1
GRONOW.txt,464613,465723,1110,10,N,N,-,-1,-1
GRONOW.txt,464684,465978,1294,10,N,N,-,-1,-1
GRONOW.txt,464788,466284,1496,10,N,N,-,-1,-1
GRONOW.txt,464919,466385,1466,10,N,N,-,-1,-1
GRONOW.txt,465088,466415,1327,10,N,N,-,-1,-1
GRONOW.txt,465129,466747,1618,10,N,N,-,-1,-1
GRONOW.txt,465215,466805,1590,10,N,N,-,-1,-1
GRONOW.txt,465268,467026,1758,10,N,N,-,-1,-1
GRONOW.txt,465448,467216,1768,10,N,N,-,-1,-1
GRONOW.txt,465562,467622,2060,10,N,N,-,-1,-1
GRONOW.txt,465724,467700,1976,10,N,N,-,-1,-1
GRONOW.txt,465979,468184,2205,10,N,N,-,-1,-1
GRONOW.txt,466285,468385,2100,10,N,N,-,-1,-1
GRONOW.txt,466388,468500,2112,10,N,N,-,-1,-1
GRONOW.txt,466416,468649,2233,10,N,N,-,-1,-1
GRONOW.txt,466748,468942,2194,10,N,N,-,-1,-1
GRONOW.txt,466806,469128,2322,10,N,N,-,-1,-1
GRONOW.txt,467029,469335,2306,10,N,N,-,-1,-1
GRONOW.txt,467217,469654,2437,10,N,N,-,-1,-1
GRONOW.txt,467623,469870,2247,10,N,N,-,-1,-1
GRONOW.txt,467701,470043,2342,10,N,N,-,-1,-1
GRONOW.txt,468185,470119,1934,10,N,N,-,-1,-1
GRONOW.txt,468386,470325,1939,10,N,N,-,-1,-1
GRONOW.txt,468501,470375,1874,10,N,N,-,-1,-1
GRONOW.txt,468654,471047,2393,10,N,N,-,-1,-1
GRONOW.txt,468945,471081,2136,10,N,N,-,-1,-1
GRONOW.txt,469129,471167,2038,10,N,N,-,-1,-1
GRONOW.txt,469336,471262,1926,10,N,N,-,-1,-1
GRONOW.txt,469655,471585,1930,10,N,N,-,-1,-1
GRONOW.txt,469873,471655,1782,10,N,N,-,-1,-1
GRONOW.txt,470044,471679,1635,10,N,N,-,-1,-1
GRONOW.txt,470120,471744,1624,10,N,N,-,-1,-1
GRONOW.txt,470326,471914,1588,10,N,N,-,-1,-1
GRONOW.txt,470376,471994,1618,10,N,N,-,-1,-1
GRONOW.txt,471050,472114,1064,10,N,N,-,-1,-1
GRONOW.txt,471082,472191,1109,10,N,N,-,-1,-1
GRONOW.txt,471168,472265,1097,10,N,N,-,-1,-1
GRONOW.txt,471263,472355,1092,10,N,N,-,-1,-1
GRONOW.txt,471587,472384,797,10,N,N,-,-1,-1
GRONOW.txt,471658,472525,867,10,N,N,-,-1,-1
GRONOW.txt,471680,472581,901,10,N,N,-,-1,-1
GRONOW.txt,471745,472618,873,10,N,N,-,-1,-1
GRONOW.txt,471915,472751,836,10,N,N,-,-1,-1
GRONOW.txt,471997,473056,1059,10,N,N,-,-1,-1
GRONOW.txt,472115,473385,1270,10,N,N,-,-1,-1
GRONOW.txt,472193,473531,1338,10,N,N,-,-1,-1
GRONOW.txt,472266,473609,1343,10,N,N,-,-1,-1
GRONOW.txt,472356,473626,1270,10,N,N,-,-1,-1
GRONOW.txt,472385,473824,1439,10,N,N,-,-1,-1
GRONOW.txt,472526,474177,1651,10,N,N,-,-1,-1
GRONOW.txt,472584,474520,1936,10,N,N,-,-1,-1
GRONOW.txt,472619,474583,1964,10,N,N,-,-1,-1
GRONOW.txt,472752,474722,1970,10,N,N,-,-1,-1
GRONOW.txt,473057,474826,1769,10,N,N,-,-1,-1
GRONOW.txt,473388,474945,1557,10,N,N,-,-1,-1
GRONOW.txt,473532,475274,1742,10,N,N,-,-1,-1
GRONOW.txt,473610,475381,1771,10,N,N,-,-1,-1
GRONOW.txt,473627,475565,1938,10,N,N,-,-1,-1
GRONOW.txt,473825,475876,2051,10,N,N,-,-1,-1
GRONOW.txt,474178,475913,1735,10,N,N,-,-1,-1
GRONOW.txt,474521,476034,1513,10,N,N,-,-1,-1
GRONOW.txt,474584,476129,1545,10,N,N,-,-1,-1
GRONOW.txt,474723,476262,1539,10,N,N,-,-1,-1
GRONOW.txt,474827,476283,1456,10,N,N,-,-1,-1
GRONOW.txt,474948,476549,1601,10,N,N,-,-1,-1
GRONOW.txt,475275,476785,1510,10,N,N,-,-1,-1
GRONOW.txt,475386,476967,1581,10,N,N,-,-1,-1
GRONOW.txt,475566,477060,1494,10,N,N,-,-1,-1
GRONOW.txt,475879,477189,1310,10,N,N,-,-1,-1
GRONOW.txt,475914,477274,1360,10,N,N,-,-1,-1
GRONOW.txt,476035,477306,1271,10,N,N,-,-1,-1
GRONOW.txt,476131,477424,1293,10,N,N,-,-1,-1
GRONOW.txt,476263,477584,1321,10,N,N,-,-1,-1
GRONOW.txt,476284,477765,1481,10,N,N,-,-1,-1
GRONOW.txt,476550,478056,1506,10,N,N,-,-1,-1
GRONOW.txt,476786,478155,1369,10,N,N,-,-1,-1
GRONOW.txt,476968,478361,1393,10,N,N,-,-1,-1
GRONOW.txt,477061,478778,1717,10,N,N,-,-1,-1
GRONOW.txt,477190,478999,1809,10,N,N,-,-1,-1
GRONOW.txt,477277,479315,2038,10,N,N,-,-1,-1
GRONOW.txt,477307,479519,2212,10,N,N,-,-1,-1
GRONOW.txt,477426,479733,2307,10,N,N,-,-1,-1
GRONOW.txt,477585,479968,2383,10,N,N,-,-1,-1
GRONOW.txt,477768,479999,2231,10,N,N,-,-1,-1
GRONOW.txt,478057,480203,2146,10,N,N,-,-1,-1
GRONOW.txt,478156,480405,2249,10,N,N,-,-1,-1
GRONOW.txt,478362,480583,2221,10,N,N,-,-1,-1
GRONOW.txt,478783,480710,1927,10,N,N,-,-1,-1
GRONOW.txt,479000,480888,1888,10,N,N,-,-1,-1
GRONOW.txt,479318,480914,1596,10,N,N,-,-1,-1
GRONOW.txt,479521,481002,1481,10,N,N,-,-1,-1
GRONOW.txt,479734,481068,1334,10,N,N,-,-1,-1
GRONOW.txt,479971,481193,1222,10,N,N,-,-1,-1
GRONOW.txt,480000,481316,1316,10,N,N,-,-1,-1
GRONOW.txt,480204,481529,1325,10,N,N,-,-1,-1
GRONOW.txt,480406,481712,1306,10,N,N,-,-1,-1
GRONOW.txt,480584,481737,1153,10,N,N,-,-1,-1
GRONOW.txt,480711,481790,1079,10,N,N,-,-1,-1
GRONOW.txt,480891,482030,1139,10,N,N,-,-1,-1
GRONOW.txt,480915,482240,1325,10,N,N,-,-1,-1
GRONOW.txt,481003,482356,1353,10,N,N,-,-1,-1
GRONOW.txt,481069,482548,1479,10,N,N,-,-1,-1
GRONOW.txt,481194,482700,1506,10,N,N,-,-1,-1
GRONOW.txt,481317,482841,1524,10,N,N,-,-1,-1
GRONOW.txt,481530,482872,1342,10,N,N,-,-1,-1
GRONOW.txt,481715,483036,1321,10,N,N,-,-1,-1
GRONOW.txt,481738,483262,1524,10,N,N,-,-1,-1
GRONOW.txt,481791,483448,1657,10,N,N,-,-1,-1
GRONOW.txt,482031,483577,1546,10,N,N,-,-1,-1
GRONOW.txt,482241,483664,1423,10,N,N,-,-1,-1
GRONOW.txt,482357,483827,1470,10,N,N,-,-1,-1
GRONOW.txt,482550,484028,1478,10,N,N,-,-1,-1
GRONOW.txt,482701,484277,1576,10,N,N,-,-1,-1
GRONOW.txt,482842,484442,1600,10,N,N,-,-1,-1
GRONOW.txt,482873,484646,1773,10,N,N,-,-1,-1
GRONOW.txt,483037,484735,1698,10,N,N,-,-1,-1
GRONOW.txt,483263,484982,1719,10,N,N,-,-1,-1
GRONOW.txt,483449,485109,1660,10,N,N,-,-1,-1
GRONOW.txt,483580,485261,1681,10,N,N,-,-1,-1
GRONOW.txt,483665,485408,1743,10,N,N,-,-1,-1
GRONOW.txt,483829,485627,1798,10,N,N,-,-1,-1
GRONOW.txt,484030,485654,1624,10,N,N,-,-1,-1
GRONOW.txt,484278,485846,1568,10,N,N,-,-1,-1
GRONOW.txt,484444,485934,1490,10,N,N,-,-1,-1
GRONOW.txt,484647,486397,1750,10,N,N,-,-1,-1
GRONOW.txt,484736,486605,1869,10,N,N,-,-1,-1
GRONOW.txt,484983,486707,1724,10,N,N,-,-1,-1
GRONOW.txt,485111,487040,1929,10,N,N,-,-1,-1
GRONOW.txt,485262,487059,1797,10,N,N,-,-1,-1
GRONOW.txt,485413,487457,2044,10,N,N,-,-1,-1
GRONOW.txt,485630,487502,1872,10,N,N,-,-1,-1
GRONOW.txt,485655,487522,1867,10,N,N,-,-1,-1
GRONOW.txt,485847,487727,1880,10,N,N,-,-1,-1
GRONOW.txt,485935,487902,1967,10,N,N,-,-1,-1
GRONOW.txt,486398,487992,1594,10,N,N,-,-1,-1
GRONOW.txt,486606,488197,1591,10,N,N,-,-1,-1
GRONOW.txt,486708,488583,1875,10,N,N,-,-1,-1
GRONOW.txt,487041,488670,1629,10,N,N,-,-1,-1
GRONOW.txt,487060,488766,1706,10,N,N,-,-1,-1
GRONOW.txt,487458,488965,1507,10,N,N,-,-1,-1
GRONOW.txt,487505,489161,1656,10,N,N,-,-1,-1
GRONOW.txt,487523,489436,1913,10,N,N,-,-1,-1
GRONOW.txt,487728,489721,1993,10,N,N,-,-1,-1
GRONOW.txt,487903,489893,1990,10,N,N,-,-1,-1
GRONOW.txt,487993,490041,2048,10,N,N,-,-1,-1
GRONOW.txt,488198,490214,2016,10,N,N,-,-1,-1
GRONOW.txt,488586,490398,1812,10,N,N,-,-1,-1
GRONOW.txt,488671,490582,1911,10,N,N,-,-1,-1
GRONOW.txt,488769,490814,2045,10,N,N,-,-1,-1
GRONOW.txt,488966,491078,2112,10,N,N,-,-1,-1
GRONOW.txt,489164,491229,2065,10,N,N,-,-1,-1
GRONOW.txt,489437,491346,1909,10,N,N,-,-1,-1
GRONOW.txt,489724,491594,1870,10,N,N,-,-1,-1
GRONOW.txt,489894,491679,1785,10,N,N,-,-1,-1
GRONOW.txt,490042,492101,2059,10,N,N,-,-1,-1
GRONOW.txt,490217,492209,1992,10,N,N,-,-1,-1
GRONOW.txt,490399,492222,1823,10,N,N,-,-1,-1
GRONOW.txt,490583,492418,1835,10,N,N,-,-1,-1
GRONOW.txt,490815,492593,1778,10,N,N,-,-1,-1
GRONOW.txt,491079,492773,1694,10,N,N,-,-1,-1
GRONOW.txt,491230,493067,1837,10,N,N,-,-1,-1
GRONOW.txt,491348,493217,1869,10,N,N,-,-1,-1
GRONOW.txt,491595,493366,1771,10,N,N,-,-1,-1
GRONOW.txt,491682,493631,1949,10,N,N,-,-1,-1
GRONOW.txt,492102,493829,1727,10,N,N,-,-1,-1
GRONOW.txt,492212,493967,1755,10,N,N,-,-1,-1
GRONOW.txt,492223,494004,1781,10,N,N,-,-1,-1
GRONOW.txt,492420,494147,1727,10,N,N,-,-1,-1
GRONOW.txt,492594,494303,1709,10,N,N,-,-1,-1
GRONOW.txt,492776,494478,1702,10,N,N,-,-1,-1
GRONOW.txt,493068,494718,1650,10,N,N,-,-1,-1
GRONOW.txt,493218,494777,1559,10,N,N,-,-1,-1
GRONOW.txt,493367,494989,1622,10,N,N,-,-1,-1
GRONOW.txt,493634,495102,1468,10,N,N,-,-1,-1
GRONOW.txt,493830,495235,1405,10,N,N,-,-1,-1
GRONOW.txt,493968,495461,1493,10,N,N,-,-1,-1
GRONOW.txt,494005,495486,1481,10,N,N,-,-1,-1
GRONOW.txt,494148,495648,1500,10,N,N,-,-1,-1
GRONOW.txt,494304,495777,1473,10,N,N,-,-1,-1
GRONOW.txt,494479,495866,1387,10,N,N,-,-1,-1
GRONOW.txt,494721,496054,1333,10,N,N,-,-1,-1
GRONOW.txt,494778,496208,1430,10,N,N,-,-1,-1
GRONOW.txt,494990,496281,1291,10,N,N,-,-1,-1
GRONOW.txt,495103,496435,1332,10,N,N,-,-1,-1
GRONOW.txt,495236,496611,1375,10,N,N,-,-1,-1
GRONOW.txt,495464,496765,1301,10,N,N,-,-1,-1
GRONOW.txt,495487,496799,1312,10,N,N,-,-1,-1
GRONOW.txt,495651,496953,1302,10,N,N,-,-1,-1
GRONOW.txt,495778,497046,1268,10,N,N,-,-1,-1
GRONOW.txt,495867,497300,1433,10,N,N,-,-1,-1
GRONOW.txt,496055,497312,1257,10,N,N,-,-1,-1
GRONOW.txt,496209,497510,1301,10,N,N,-,-1,-1
GRONOW.txt,496284,497782,1498,10,N,N,-,-1,-1
GRONOW.txt,496436,497989,1553,10,N,N,-,-1,-1
GRONOW.txt,496612,498114,1502,10,N,N,-,-1,-1
GRONOW.txt,496768,498298,1530,10,N,N,-,-1,-1
GRONOW.txt,496800,498596,1796,10,N,N,-,-1,-1
GRONOW.txt,496954,498671,1717,10,N,N,-,-1,-1
GRONOW.txt,497047,498797,1750,10,N,N,-,-1,-1
GRONOW.txt,497301,498912,1611,10,N,N,-,-1,-1
GRONOW.txt,497313,499015,1702,10,N,N,-,-1,-1
GRONOW.txt,497511,499228,1717,10,N,N,-,-1,-1
GRONOW.txt,497785,499324,1539,10,N,N,-,-1,-1
GRONOW.txt,497990,499414,1424,10,N,N,-,-1,-1
GRONOW.txt,498115,499434,1319,10,N,N,-,-1,-1
GRONOW.txt,498301,499658,1357,10,N,N,-,-1,-1
GRONOW.txt,498597,499693,1096,10,N,N,-,-1,-1
GRONOW.txt,498674,499940,1266,10,N,N,-,-1,-1
GRONOW.txt,498798,500116,1318,10,N,N,-,-1,-1
GRONOW.txt,498913,500513,1600,10,N,N,-,-1,-1
GRONOW.txt,499018,500609,1591,10,N,N,-,-1,-1
GRONOW.txt,499229,500640,1411,10,N,N,-,-1,-1
GRONOW.txt,499325,500882,1557,10,N,N,-,-1,-1
GRONOW.txt,499415,501071,1656,10,N,N,-,-1,-1
GRONOW.txt,499435,501095,1660,10,N,N,-,-1,-1
GRONOW.txt,499661,501232,1571,10,N,N,-,-1,-1
GRONOW.txt,499694,501497,1803,10,N,N,-,-1,-1
GRONOW.txt,499941,501744,1803,10,N,N,-,-1,-1
GRONOW.txt,500117,502217,2100,10,N,N,-,-1,-1
GRONOW.txt,500516,502347,1831,10,N,N,-,-1,-1
GRONOW.txt,500610,502488,1878,10,N,N,-,-1,-1
GRONOW.txt,500641,502791,2150,10,N,N,-,-1,-1
GRONOW.txt,500883,502862,1979,10,N,N,-,-1,-1
GRONOW.txt,501074,502969,1895,10,N,N,-,-1,-1
GRONOW.txt,501096,503271,2175,10,N,N,-,-1,-1
GRONOW.txt,501233,503471,2238,10,N,N,-,-1,-1
GRONOW.txt,501498,503808,2310,10,N,N,-,-1,-1
GRONOW.txt,501745,504059,2314,10,N,N,-,-1,-1
GRONOW.txt,502220,504297,2077,10,N,N,-,-1,-1
GRONOW.txt,502350,504725,2375,10,N,N,-,-1,-1
GRONOW.txt,502489,504850,2361,10,N,N,-,-1,-1
GRONOW.txt,502792,505005,2213,10,N,N,-,-1,-1
GRONOW.txt,502863,505125,2262,10,N,N,-,-1,-1
GRONOW.txt,502972,505315,2343,10,N,N,-,-1,-1
GRONOW.txt,503272,505433,2161,10,N,N,-,-1,-1
GRONOW.txt,503472,505649,2177,10,N,N,-,-1,-1
GRONOW.txt,503809,505951,2142,10,N,N,-,-1,-1
GRONOW.txt,504060,505988,1928,10,N,N,-,-1,-1
GRONOW.txt,504298,506364,2066,10,N,N,-,-1,-1
GRONOW.txt,504726,506476,1750,10,N,N,-,-1,-1
GRONOW.txt,504853,506518,1665,10,N,N,-,-1,-1
GRONOW.txt,505006,506618,1612,10,N,N,-,-1,-1
GRONOW.txt,505126,506910,1784,10,N,N,-,-1,-1
GRONOW.txt,505316,507123,1807,10,N,N,-,-1,-1
GRONOW.txt,505434,507365,1931,10,N,N,-,-1,-1
GRONOW.txt,505651,507585,1934,10,N,N,-,-1,-1
GRONOW.txt,505954,507745,1791,10,N,N,-,-1,-1
GRONOW.txt,505989,507913,1924,10,N,N,-,-1,-1
GRONOW.txt,506365,508042,1677,10,N,N,-,-1,-1
GRONOW.txt,506477,508155,1678,10,N,N,-,-1,-1
GRONOW.txt,506519,508406,1887,10,N,N,-,-1,-1
GRONOW.txt,506619,508636,2017,10,N,N,-,-1,-1
GRONOW.txt,506911,508784,1873,10,N,N,-,-1,-1
GRONOW.txt,507124,509034,1910,10,N,N,-,-1,-1
GRONOW.txt,507366,509270,1904,10,N,N,-,-1,-1
GRONOW.txt,507586,509364,1778,10,N,N,-,-1,-1
GRONOW.txt,507748,509665,1917,10,N,N,-,-1,-1
GRONOW.txt,507914,509894,1980,10,N,N,-,-1,-1
GRONOW.txt,508043,509959,1916,10,N,N,-,-1,-1
GRONOW.txt,508156,510047,1891,10,N,N,-,-1,-1
GRONOW.txt,508407,510202,1795,10,N,N,-,-1,-1
GRONOW.txt,508637,510472,1835,10,N,N,-,-1,-1
GRONOW.txt,508785,510606,1821,10,N,N,-,-1,-1
GRONOW.txt,509037,510734,1697,10,N,N,-,-1,-1
GRONOW.txt,509273,510799,1526,10,N,N,-,-1,-1
GRONOW.txt,509365,510846,1481,10,N,N,-,-1,-1
GRONOW.txt,509666,510933,1267,10,N,N,-,-1,-1
GRONOW.txt,509895,511088,1193,10,N,N,-,-1,-1
GRONOW.txt,509960,511123,1163,10,N,N,-,-1,-1
GRONOW.txt,510048,511312,1264,10,N,N,-,-1,-1
GRONOW.txt,510203,511562,1359,10,N,N,-,-1,-1
GRONOW.txt,510473,511832,1359,10,N,N,-,-1,-1
GRONOW.txt,510609,512094,1485,10,N,N,-,-1,-1
GRONOW.txt,510735,512187,1452,10,N,N,-,-1,-1
GRONOW.txt,510800,512211,1411,10,N,N,-,-1,-1
GRONOW.txt,510847,512361,1514,10,N,N,-,-1,-1
GRONOW.txt,510934,512468,1534,10,N,N,-,-1,-1
GRONOW.txt,511091,512635,1544,10,N,N,-,-1,-1
GRONOW.txt,511124,512972,1848,10,N,N,-,-1,-1
GRONOW.txt,511313,513158,1845,10,N,N,-,-1,-1
GRONOW.txt,511563,513311,1748,10,N,N,-,-1,-1
GRONOW.txt,511833,513745,1912,10,N,N,-,-1,-1
GRONOW.txt,512095,513995,1900,10,N,N,-,-1,-1
GRONOW.txt,512190,514080,1890,10,N,N,-,-1,-1
GRONOW.txt,512212,514103,1891,10,N,N,-,-1,-1
GRONOW.txt,512364,514128,1764,10,N,N,-,-1,-1
GRONOW.txt,512469,514256,1787,10,N,N,-,-1,-1
GRONOW.txt,512636,514377,1741,10,N,N,-,-1,-1
GRONOW.txt,512973,514697,1724,10,N,N,-,-1,-1
GRONOW.txt,513160,514835,1675,10,N,N,-,-1,-1
GRONOW.txt,513312,515218,1906,10,N,N,-,-1,-1
GRONOW.txt,513746,515374,1628,10,N,N,-,-1,-1
GRONOW.txt,513996,515575,1579,10,N,N,-,-1,-1
GRONOW.txt,514085,515789,1704,10,N,N,-,-1,-1
GRONOW.txt,514104,515880,1776,10,N,N,-,-1,-1
GRONOW.txt,514129,516026,1897,10,N,N,-,-1,-1
GRONOW.txt,514258,516156,1898,10,N,N,-,-1,-1
GRONOW.txt,514378,516190,1812,10,N,N,-,-1,-1
GRONOW.txt,514698,516489,1791,10,N,N,-,-1,-1
GRONOW.txt,514836,516584,1748,10,N,N,-,-1,-1
GRONOW.txt,515221,516698,1477,10,N,N,-,-1,-1
GRONOW.txt,515376,516942,1566,10,N,N,-,-1,-1
GRONOW.txt,515576,517058,1482,10,N,N,-,-1,-1
GRONOW.txt,515791,517138,1347,10,N,N,-,-1,-1
GRONOW.txt,515883,517287,1404,10,N,N,-,-1,-1
GRONOW.txt,516027,517332,1305,10,N,N,-,-1,-1
GRONOW.txt,516159,517487,1328,10,N,N,-,-1,-1
GRONOW.txt,516191,517619,1428,10,N,N,-,-1,-1
GRONOW.txt,516490,517871,1381,10,N,N,-,-1,-1
GRONOW.txt,516585,518053,1468,10,N,N,-,-1,-1
GRONOW.txt,516700,518120,1420,10,N,N,-,-1,-1
GRONOW.txt,516943,518169,1226,10,N,N,-,-1,-1
GRONOW.txt,517059,518285,1226,10,N,N,-,-1,-1
GRONOW.txt,517139,518541,1402,10,N,N,-,-1,-1
GRONOW.txt,517292,518659,1367,10,N,N,-,-1,-1
GRONOW.txt,517333,518758,1425,10,N,N,-,-1,-1
GRONOW.txt,517488,518800,1312,10,N,N,-,-1,-1
GRONOW.txt,517620,518910,1290,10,N,N,-,-1,-1
GRONOW.txt,517872,519139,1267,10,N,N,-,-1,-1
GRONOW.txt,518054,519191,1137,10,N,N,-,-1,-1
GRONOW.txt,518123,519331,1208,10,N,N,-,-1,-1
GRONOW.txt,518170,519420,1250,10,N,N,-,-1,-1
GRONOW.txt,518286,519520,1234,10,N,N,-,-1,-1
GRONOW.txt,518542,519662,1120,10,N,N,-,-1,-1
GRONOW.txt,518661,519819,1158,10,N,N,-,-1,-1
GRONOW.txt,518761,519970,1209,10,N,N,-,-1,-1
GRONOW.txt,518801,520188,1387,10,N,N,-,-1,-1
GRONOW.txt,518912,520377,1465,10,N,N,-,-1,-1
GRONOW.txt,519144,520389,1245,10,N,N,-,-1,-1
GRONOW.txt,519193,520796,1603,10,N,N,-,-1,-1
GRONOW.txt,519332,520833,1501,10,N,N,-,-1,-1
GRONOW.txt,519421,521147,1726,10,N,N,-,-1,-1
GRONOW.txt,519523,521418,1895,10,N,N,-,-1,-1
GRONOW.txt,519663,521715,2052,10,N,N,-,-1,-1
GRONOW.txt,519820,521967,2147,10,N,N,-,-1,-1
GRONOW.txt,519971,521983,2012,10,N,N,-,-1,-1
GRONOW.txt,520190,522044,1854,10,N,N,-,-1,-1
GRONOW.txt,520380,522303,1923,10,N,N,-,-1,-1
GRONOW.txt,520390,522430,2040,10,N,N,-,-1,-1
GRONOW.txt,520797,522547,1750,10,N,N,-,-1,-1
GRONOW.txt,520834,522614,1780,10,N,N,-,-1,-1
GRONOW.txt,521148,522779,1631,10,N,N,-,-1,-1
GRONOW.txt,521419,522984,1565,10,N,N,-,-1,-1
GRONOW.txt,521718,523042,1324,10,N,N,-,-1,-1
GRONOW.txt,521970,523217,1247,10,N,N,-,-1,-1
GRONOW.txt,521984,523476,1492,10,N,N,-,-1,-1
GRONOW.txt,522045,523742,1697,10,N,N,-,-1,-1
GRONOW.txt,522304,523914,1610,10,N,N,-,-1,-1
GRONOW.txt,522435,524061,1626,10,N,N,-,-1,-1
GRONOW.txt,522548,524137,1589,10,N,N,-,-1,-1
GRONOW.txt,522615,524190,1575,10,N,N,-,-1,-1
GRONOW.txt,522780,524401,1621,10,N,N,-,-1,-1
GRONOW.txt,522987,524552,1565,10,N,N,-,-1,-1
GRONOW.txt,523043,524617,1574,10,N,N,-,-1,-1
GRONOW.txt,523218,524920,1702,10,N,N,-,-1,-1
GRONOW.txt,523477,525184,1707,10,N,N,-,-1,-1
GRONOW.txt,523743,525480,1737,10,N,N,-,-1,-1
GRONOW.txt,523917,525532,1615,10,N,N,-,-1,-1
GRONOW.txt,524063,525641,1578,10,N,N,-,-1,-1
GRONOW.txt,524138,525749,1611,10,N,N,-,-1,-1
GRONOW.txt,524191,525817,1626,10,N,N,-,-1,-1
GRONOW.txt,524402,525863,1461,10,N,N,-,-1,-1
GRONOW.txt,524553,525940,1387,10,N,N,-,-1,-1
GRONOW.txt,524618,526101,1483,10,N,N,-,-1,-1
GRONOW.txt,524923,526186,1263,10,N,N,-,-1,-1
GRONOW.txt,525184,526305,1121,10,N,N,-,-1,-1
GRONOW.txt,525481,526330,849,10,N,N,-,-1,-1
GRONOW.txt,525533,526487,954,10,N,N,-,-1,-1
GRONOW.txt,525642,526547,905,10,N,N,-,-1,-1
GRONOW.txt,525750,526678,928,10,N,N,-,-1,-1
GRONOW.txt,525822,526788,966,10,N,N,-,-1,-1
GRONOW.txt,525864,526907,1043,10,N,N,-,-1,-1
GRONOW.txt,525941,527069,1128,10,N,N,-,-1,-1
GRONOW.txt,526102,527137,1035,10,N,N,-,-1,-1
GRONOW.txt,526187,527252,1065,10,N,N,-,-1,-1
GRONOW.txt,526308,527556,1248,10,N,N,-,-1,-1
GRONOW.txt,526331,527561,1230,10,N,N,-,-1,-1
GRONOW.txt,526488,527637,1149,10,N,N,-,-1,-1
GRONOW.txt,526548,527898,1350,10,N,N,-,-1,-1
GRONOW.txt,526680,528076,1396,10,N,N,-,-1,-1
GRONOW.txt,526789,528651,1862,10,N,N,-,-1,-1
GRONOW.txt,526908,528688,1780,10,N,N,-,-1,-1
GRONOW.txt,527072,528854,1782,10,N,N,-,-1,-1
GRONOW.txt,527138,529001,1863,10,N,N,-,-1,-1
GRONOW.txt,527253,529110,1857,10,N,N,-,-1,-1
GRONOW.txt,527557,529254,1697,10,N,N,-,-1,-1
GRONOW.txt,527564,529351,1787,10,N,N,-,-1,-1
GRONOW.txt,527638,529584,1946,10,N,N,-,-1,-1
GRONOW.txt,527899,529705,1806,10,N,N,-,-1,-1
GRONOW.txt,528077,529827,1750,10,N,N,-,-1,-1
GRONOW.txt,528654,529871,1217,10,N,N,-,-1,-1
GRONOW.txt,528689,530014,1325,10,N,N,-,-1,-1
GRONOW.txt,528855,530146,1291,10,N,N,-,-1,-1
GRONOW.txt,529003,530390,1387,10,N,N,-,-1,-1
GRONOW.txt,529111,530487,1376,10,N,N,-,-1,-1
GRONOW.txt,529257,530608,1351,10,N,N,-,-1,-1
GRONOW.txt,529352,531025,1673,10,N,N,-,-1,-1
GRONOW.txt,529585,531052,1467,10,N,N,-,-1,-1
GRONOW.txt,529706,531208,1502,10,N,N,-,-1,-1
GRONOW.txt,529830,531408,1578,10,N,N,-,-1,-1
GRONOW.txt,529872,531608,1736,10,N,N,-,-1,-1
GRONOW.txt,530015,531739,1724,10,N,N,-,-1,-1
GRONOW.txt,530147,531903,1756,10,N,N,-,-1,-1
GRONOW.txt,530391,532154,1763,10,N,N,-,-1,-1
GRONOW.txt,530488,532394,1906,10,N,N,-,-1,-1
GRONOW.txt,530609,532518,1909,10,N,N,-,-1,-1
GRONOW.txt,531028,532543,1515,10,N,N,-,-1,-1
GRONOW.txt,531053,532642,1589,10,N,N,-,-1,-1
GRONOW.txt,531209,533133,1924,10,N,N,-,-1,-1
GRONOW.txt,531409,533453,2044,10,N,N,-,-1,-1
GRONOW.txt,531609,533690,2081,10,N,N,-,-1,-1
GRONOW.txt,531740,533723,1983,10,N,N,-,-1,-1
GRONOW.txt,531906,534222,2316,10,N,N,-,-1,-1
GRONOW.txt,532156,534263,2107,10,N,N,-,-1,-1
GRONOW.txt,532397,534511,2114,10,N,N,-,-1,-1
GRONOW.txt,532519,534636,2117,10,N,N,-,-1,-1
GRONOW.txt,532544,534737,2193,10,N,N,-,-1,-1
GRONOW.txt,532644,534890,2246,10,N,N,-,-1,-1
GRONOW.txt,533134,535042,1908,10,N,N,-,-1,-1
GRONOW.txt,533454,535223,1769,10,N,N,-,-1,-1
GRONOW.txt,533693,535377,1684,10,N,N,-,-1,-1
GRONOW.txt,533724,535698,1974,10,N,N,-,-1,-1
GRONOW.txt,534223,535846,1623,10,N,N,-,-1,-1
GRONOW.txt,534264,535901,1637,10,N,N,-,-1,-1
GRONOW.txt,534512,536098,1586,10,N,N,-,-1,-1
GRONOW.txt,534637,536310,1673,10,N,N,-,-1,-1
GRONOW.txt,534738,536351,1613,10,N,N,-,-1,-1
GRONOW.txt,534891,536485,1594,10,N,N,-,-1,-1
GRONOW.txt,535045,536582,1537,10,N,N,-,-1,-1
GRONOW.txt,535224,536833,1609,10,N,N,-,-1,-1
GRONOW.txt,535378,537105,1727,10,N,N,-,-1,-1
GRONOW.txt,535699,537416,1717,10,N,N,-,-1,-1
GRONOW.txt,535847,537454,1607,10,N,N,-,-1,-1
GRONOW.txt,535904,537538,1634,10,N,N,-,-1,-1
GRONOW.txt,536099,537652,1553,10,N,N,-,-1,-1
GRONOW.txt,536313,537793,1480,10,N,N,-,-1,-1
GRONOW.txt,536352,537963,1611,10,N,N,-,-1,-1
GRONOW.txt,536486,538100,1614,10,N,N,-,-1,-1
GRONOW.txt,536583,538367,1784,10,N,N,-,-1,-1
GRONOW.txt,536834,538466,1632,10,N,N,-,-1,-1
GRONOW.txt,537106,538582,1476,10,N,N,-,-1,-1
GRONOW.txt,537419,538607,1188,10,N,N,-,-1,-1
GRONOW.txt,537455,538712,1257,10,N,N,-,-1,-1
GRONOW.txt,537539,538856,1317,10,N,N,-,-1,-1
GRONOW.txt,537653,538910,1257,10,N,N,-,-1,-1
GRONOW.txt,537795,538995,1200,10,N,N,-,-1,-1
GRONOW.txt,537966,539001,1035,10,N,N,-,-1,-1
GRONOW.txt,538101,539008,907,10,N,N,-,-1,-1
GRONOW.txt,538368,539134,766,10,N,N,-,-1,-1
GRONOW.txt,538467,539189,722,10,N,N,-,-1,-1
GRONOW.txt,538585,539219,634,10,N,N,-,-1,-1
GRONOW.txt,538608,539315,707,10,N,N,-,-1,-1
GRONOW.txt,538713,539335,622,10,N,N,-,-1,-1
GRONOW.txt,538857,539628,771,10,N,N,-,-1,-1
GRONOW.txt,538911,539943,1032,10,N,N,-,-1,-1
GRONOW.txt,538996,539965,969,10,N,N,-,-1,-1
GRONOW.txt,539002,540109,1107,10,N,N,-,-1,-1
GRONOW.txt,539009,540293,1284,10,N,N,-,-1,-1
GRONOW.txt,539135,540402,1267,10,N,N,-,-1,-1
GRONOW.txt,539194,540416,1222,10,N,N,-,-1,-1
GRONOW.txt,539222,540514,1292,10,N,N,-,-1,-1
GRONOW.txt,539318,540571,1253,10,N,N,-,-1,-1
GRONOW.txt,539336,541069,1733,10,N,N,-,-1,-1
GRONOW.txt,539629,541301,1672,10,N,N,-,-1,-1
GRONOW.txt,539946,541520,1574,10,N,N,-,-1,-1
GRONOW.txt,539966,541670,1704,10,N,N,-,-1,-1
GRONOW.txt,540110,542009,1899,10,N,N,-,-1,-1
GRONOW.txt,540294,542114,1820,10,N,N,-,-1,-1
GRONOW.txt,540403,542330,1927,10,N,N,-,-1,-1
GRONOW.txt,540417,542431,2014,10,N,N,-,-1,-1
GRONOW.txt,540517,542462,1945,10,N,N,-,-1,-1
GRONOW.txt,540572,542619,2047,10,N,N,-,-1,-1
GRONOW.txt,541070,542708,1638,10,N,N,-,-1,-1
GRONOW.txt,541303,542826,1523,10,N,N,-,-1,-1
GRONOW.txt,541521,543042,1521,10,N,N,-,-1,-1
GRONOW.txt,541671,543751,2080,10,N,N,-,-1,-1
GRONOW.txt,542010,543805,1795,10,N,N,-,-1,-1
GRONOW.txt,542115,543890,1775,10,N,N,-,-1,-1
GRONOW.txt,542331,544092,1761,10,N,N,-,-1,-1
GRONOW.txt,542434,544347,1913,10,N,N,-,-1,-1
GRONOW.txt,542463,544613,2150,10,N,N,-,-1,-1
GRONOW.txt,542620,544835,2215,10,N,N,-,-1,-1
GRONOW.txt,542709,544937,2228,10,N,N,-,-1,-1
GRONOW.txt,542827,545140,2313,10,N,N,-,-1,-1
GRONOW.txt,543044,545264,2220,10,N,N,-,-1,-1
GRONOW.txt,543754,545369,1615,10,N,N,-,-1,-1
GRONOW.txt,543806,545537,1731,10,N,N,-,-1,-1
GRONOW.txt,543891,545657,1766,10,N,N,-,-1,-1
GRONOW.txt,544093,545715,1622,10,N,N,-,-1,-1
GRONOW.txt,544348,545796,1448,10,N,N,-,-1,-1
GRONOW.txt,544614,545945,1331,10,N,N,-,-1,-1
GRONOW.txt,544836,546124,1288,10,N,N,-,-1,-1
GRONOW.txt,544938,546275,1337,10,N,N,-,-1,-1
GRONOW.txt,545141,546444,1303,10,N,N,-,-1,-1
GRONOW.txt,545265,546508,1243,10,N,N,-,-1,-1
GRONOW.txt,545370,546850,1480,10,N,N,-,-1,-1
GRONOW.txt,545539,547054,1515,10,N,N,-,-1,-1
GRONOW.txt,545660,547447,1787,10,N,N,-,-1,-1
GRONOW.txt,545716,547507,1791,10,N,N,-,-1,-1
GRONOW.txt,545799,547775,1976,10,N,N,-,-1,-1
GRONOW.txt,545946,548008,2062,10,N,N,-,-1,-1
GRONOW.txt,546125,548151,2026,10,N,N,-,-1,-1
GRONOW.txt,546276,548508,2232,10,N,N,-,-1,-1
GRONOW.txt,546445,548530,2085,10,N,N,-,-1,-1
GRONOW.txt,546510,548617,2107,10,N,N,-,-1,-1
GRONOW.txt,546851,548700,1849,10,N,N,-,-1,-1
GRONOW.txt,547055,548746,1691,10,N,N,-,-1,-1
GRONOW.txt,547448,548899,1451,10,N,N,-,-1,-1
GRONOW.txt,547508,548976,1468,10,N,N,-,-1,-1
GRONOW.txt,547778,549086,1308,10,N,N,-,-1,-1
GRONOW.txt,548009,549160,1151,10,N,N,-,-1,-1
GRONOW.txt,548152,549231,1079,10,N,N,-,-1,-1
GRONOW.txt,548511,549370,859,10,N,N,-,-1,-1
GRONOW.txt,548531,549437,906,10,N,N,-,-1,-1
GRONOW.txt,548618,549474,856,10,N,N,-,-1,-1
GRONOW.txt,548701,549654,953,10,N,N,-,-1,-1
GRONOW.txt,548747,550077,1330,10,N,N,-,-1,-1
GRONOW.txt,548901,550237,1336,10,N,N,-,-1,-1
GRONOW.txt,548977,550392,1415,10,N,N,-,-1,-1
GRONOW.txt,549089,550498,1409,10,N,N,-,-1,-1
GRONOW.txt,549165,550521,1356,10,N,N,-,-1,-1
GRONOW.txt,549232,550664,1432,10,N,N,-,-1,-1
GRONOW.txt,549371,550780,1409,10,N,N,-,-1,-1
GRONOW.txt,549440,550998,1558,10,N,N,-,-1,-1
GRONOW.txt,549475,551259,1784,10,N,N,-,-1,-1
GRONOW.txt,549655,551560,1905,10,N,N,-,-1,-1
GRONOW.txt,550078,551905,1827,10,N,N,-,-1,-1
GRONOW.txt,550238,552032,1794,10,N,N,-,-1,-1
GRONOW.txt,550393,552350,1957,10,N,N,-,-1,-1
GRONOW.txt,550501,552514,2013,10,N,N,-,-1,-1
GRONOW.txt,550522,552560,2038,10,N,N,-,-1,-1
GRONOW.txt,550665,552666,2001,10,N,N,-,-1,-1
GRONOW.txt,550781,552696,1915,10,N,N,-,-1,-1
GRONOW.txt,551001,552878,1877,10,N,N,-,-1,-1
GRONOW.txt,551261,553162,1901,10,N,N,-,-1,-1
GRONOW.txt,551561,553518,1957,10,N,N,-,-1,-1
GRONOW.txt,551908,553711,1803,10,N,N,-,-1,-1
GRONOW.txt,552033,553906,1873,10,N,N,-,-1,-1
GRONOW.txt,552351,553976,1625,10,N,N,-,-1,-1
GRONOW.txt,552517,554071,1554,10,N,N,-,-1,-1
GRONOW.txt,552562,554178,1616,10,N,N,-,-1,-1
GRONOW.txt,552669,554390,1721,10,N,N,-,-1,-1
GRONOW.txt,552697,554568,1871,10,N,N,-,-1,-1
GRONOW.txt,552879,554788,1909,10,N,N,-,-1,-1
GRONOW.txt,553163,554858,1695,10,N,N,-,-1,-1
GRONOW.txt,553519,554876,1357,10,N,N,-,-1,-1
GRONOW.txt,553712,554925,1213,10,N,N,-,-1,-1
GRONOW.txt,553907,555096,1189,10,N,N,-,-1,-1
GRONOW.txt,553977,555290,1313,10,N,N,-,-1,-1
GRONOW.txt,554072,555296,1224,10,N,N,-,-1,-1
GRONOW.txt,554179,555363,1184,10,N,N,-,-1,-1
GRONOW.txt,554391,555445,1054,10,N,N,-,-1,-1
GRONOW.txt,554569,555548,979,10,N,N,-,-1,-1
GRONOW.txt,554789,555810,1021,10,N,N,-,-1,-1
GRONOW.txt,554859,555870,1011,10,N,N,-,-1,-1
GRONOW.txt,554879,556002,1123,10,N,N,-,-1,-1
GRONOW.txt,554926,556058,1132,10,N,N,-,-1,-1
GRONOW.txt,555097,556081,984,10,N,N,-,-1,-1
GRONOW.txt,555291,556360,1069,10,N,N,-,-1,-1
GRONOW.txt,555297,556501,1204,10,N,N,-,-1,-1
GRONOW.txt,555364,556550,1186,10,N,N,-,-1,-1
GRONOW.txt,555446,556664,1218,10,N,N,-,-1,-1
GRONOW.txt,555549,556921,1372,10,N,N,-,-1,-1
GRONOW.txt,555811,557272,1461,10,N,N,-,-1,-1
GRONOW.txt,555873,557387,1514,10,N,N,-,-1,-1
GRONOW.txt,556005,557410,1405,10,N,N,-,-1,-1
GRONOW.txt,556059,557602,1543,10,N,N,-,-1,-1
GRONOW.txt,556082,557620,1538,10,N,N,-,-1,-1
GRONOW.txt,556361,557827,1466,10,N,N,-,-1,-1
GRONOW.txt,556504,557879,1375,10,N,N,-,-1,-1
GRONOW.txt,556551,558035,1484,10,N,N,-,-1,-1
GRONOW.txt,556665,558056,1391,10,N,N,-,-1,-1
GRONOW.txt,556922,558530,1608,10,N,N,-,-1,-1
GRONOW.txt,557273,558553,1280,10,N,N,-,-1,-1
GRONOW.txt,557392,558588,1196,10,N,N,-,-1,-1
GRONOW.txt,557411,558673,1262,10,N,N,-,-1,-1
GRONOW.txt,557605,558747,1142,10,N,N,-,-1,-1
GRONOW.txt,557621,558880,1259,10,N,N,-,-1,-1
GRONOW.txt,557828,559055,1227,10,N,N,-,-1,-1
GRONOW.txt,557880,559135,1255,10,N,N,-,-1,-1
GRONOW.txt,558038,559152,1114,10,N,N,-,-1,-1
GRONOW.txt,558057,559381,1324,10,N,N,-,-1,-1
GRONOW.txt,558531,559479,948,10,N,N,-,-1,-1
GRONOW.txt,558554,559789,1235,10,Y,N,-,-1,-1
GRONOW.txt,558589,560015,1426,10,Y,N,-,-1,-1
GRONOW.txt,558675,560235,1560,10,Y,N,-,-1,-1
GRONOW.txt,558748,560405,1657,10,Y,N,-,-1,-1
GRONOW.txt,558883,560751,1868,10,Y,N,-,-1,-1
GRONOW.txt,559060,560777,1717,10,Y,N,-,-1,-1
GRONOW.txt,559138,561007,1869,10,Y,N,-,-1,-1
GRONOW.txt,559153,561334,2181,10,Y,N,-,-1,-1
GRONOW.txt,559382,561412,2030,10,Y,N,-,-1,-1
GRONOW.txt,559480,561456,1976,10,Y,N,-,-1,-1
GRONOW.txt,559790,561594,1804,10,N,N,-,-1,-1
GRONOW.txt,560016,562172,2156,10,N,N,-,-1,-1
GRONOW.txt,560236,562286,2050,10,N,N,-,-1,-1
GRONOW.txt,560408,562432,2024,10,N,N,-,-1,-1
GRONOW.txt,560752,562468,1716,10,N,N,-,-1,-1
GRONOW.txt,560778,562838,2060,10,N,N,-,-1,-1
GRONOW.txt,561008,562909,1901,10,N,N,-,-1,-1
GRONOW.txt,561335,563566,2231,10,N,N,-,-1,-1
GRONOW.txt,561413,563666,2253,10,N,N,-,-1,-1
GRONOW.txt,561457,563675,2218,10,N,N,-,-1,-1
GRONOW.txt,561597,563720,2123,10,N,N,-,-1,-1
GRONOW.txt,562173,563725,1552,10,N,N,-,-1,-1
GRONOW.txt,562289,563744,1455,10,N,N,-,-1,-1
GRONOW.txt,562435,563767,1332,10,N,N,-,-1,-1
GRONOW.txt,562469,563777,1308,10,N,N,-,-1,-1
GRONOW.txt,562839,563798,959,10,N,N,-,-1,-1
GRONOW.txt,562912,563809,897,10,N,N,-,-1,-1
GRONOW.txt,563571,563830,259,10,N,N,-,-1,-1
GRONOW.txt,563669,563834,165,10,N,N,-,-1,-1
GRONOW.txt,563676,563853,177,10,N,N,-,-1,-1
GRONOW.txt,563721,563870,149,10,N,N,-,-1,-1
GRONOW.txt,563726,563882,156,10,N,N,-,-1,-1
GRONOW.txt,563745,563900,155,10,N,N,-,-1,-1
GRONOW.txt,563769,563920,151,10,N,N,-,-1,-1
GRONOW.txt,563778,563963,185,10,N,N,-,-1,-1
GRONOW.txt,563800,563966,166,10,N,N,-,-1,-1
GRONOW.txt,563810,564015,205,10,N,N,-,-1,-1
GRONOW.txt,563833,564036,203,10,N,N,-,-1,-1
GRONOW.txt,563835,564058,223,10,N,N,-,-1,-1
GRONOW.txt,563854,564157,303,10,N,N,-,-1,-1
GRONOW.txt,563871,564174,303,10,N,N,-,-1,-1
GRONOW.txt,563883,564191,308,10,N,N,-,-1,-1
GRONOW.txt,563901,564192,291,10,N,N,-,-1,-1
GRONOW.txt,563921,564193,272,10,N,N,-,-1,-1
GRONOW.txt,563965,564210,245,10,N,N,-,-1,-1
GRONOW.txt,563967,564213,246,10,N,N,-,-1,-1
GRONOW.txt,564018,564255,237,10,N,N,-,-1,-1
GRONOW.txt,564037,564272,235,10,N,N,-,-1,-1
GRONOW.txt,564059,564291,232,10,N,N,-,-1,-1
GRONOW.txt,564158,564308,150,10,N,N,-,-1,-1
GRONOW.txt,564176,564323,147,10,N,N,-,-1,-1
GRONOW.txt,564191,564367,176,10,N,N,-,-1,-1
GRONOW.txt,564192,564414,222,10,N,N,-,-1,-1
GRONOW.txt,564194,564429,235,10,N,N,-,-1,-1
GRONOW.txt,564212,564448,236,10,N,N,-,-1,-1
GRONOW.txt,564213,564468,255,10,N,N,-,-1,-1
GRONOW.txt,564256,564494,238,10,N,N,-,-1,-1
GRONOW.txt,564274,564542,268,10,N,N,-,-1,-1
GRONOW.txt,564292,564568,276,10,N,N,-,-1,-1
GRONOW.txt,564311,564599,288,10,N,N,-,-1,-1
GRONOW.txt,564324,564625,301,10,N,N,-,-1,-1
GRONOW.txt,564370,564675,305,10,N,N,-,-1,-1
GRONOW.txt,564416,564690,274,10,N,N,-,-1,-1
GRONOW.txt,564430,564725,295,10,N,N,-,-1,-1
GRONOW.txt,564450,564791,341,10,N,N,-,-1,-1
GRONOW.txt,564469,564808,339,10,N,N,-,-1,-1
GRONOW.txt,564496,564868,372,10,N,N,-,-1,-1
GRONOW.txt,564543,564890,347,10,N,N,-,-1,-1
GRONOW.txt,564570,564912,342,10,N,N,-,-1,-1
GRONOW.txt,564600,564966,366,10,N,N,-,-1,-1
GRONOW.txt,564628,564969,341,10,N,N,-,-1,-1
GRONOW.txt,564676,564985,309,10,N,N,-,-1,-1
GRONOW.txt,564693,565005,312,10,N,N,-,-1,-1
GRONOW.txt,564726,565040,314,10,N,N,-,-1,-1
GRONOW.txt,564794,565065,271,10,N,N,-,-1,-1
GRONOW.txt,564810,565094,284,10,N,N,-,-1,-1
GRONOW.txt,564870,565126,256,10,N,N,-,-1,-1
GRONOW.txt,564891,565175,284,10,N,N,-,-1,-1
GRONOW.txt,564915,565253,338,10,N,N,-,-1,-1
GRONOW.txt,564966,565272,306,10,N,N,-,-1,-1
GRONOW.txt,564969,565302,333,10,N,N,-,-1,-1
GRONOW.txt,564986,565318,332,10,N,N,-,-1,-1
GRONOW.txt,565007,565335,328,10,N,N,-,-1,-1
GRONOW.txt,565041,565361,320,10,N,N,-,-1,-1
GRONOW.txt,565070,565378,308,10,N,N,-,-1,-1
GRONOW.txt,565099,565392,293,10,N,N,-,-1,-1
GRONOW.txt,565131,565412,281,10,N,N,-,-1,-1
GRONOW.txt,565176,565432,256,10,N,N,-,-1,-1
GRONOW.txt,565254,565456,202,10,N,N,-,-1,-1
GRONOW.txt,565274,565471,197,10,N,N,-,-1,-1
GRONOW.txt,565303,565474,171,10,N,N,-,-1,-1
GRONOW.txt,565320,565499,179,10,N,N,-,-1,-1
GRONOW.txt,565336,565513,177,10,N,N,-,-1,-1
GRONOW.txt,565363,565518,155,10,N,N,-,-1,-1
GRONOW.txt,565379,565561,182,10,N,N,-,-1,-1
GRONOW.txt,565394,565575,181,10,N,N,-,-1,-1
GRONOW.txt,565413,565632,219,10,N,N,-,-1,-1
GRONOW.txt,565434,565652,218,10,N,N,-,-1,-1
GRONOW.txt,565457,565700,243,10,N,N,-,-1,-1
GRONOW.txt,565473,565719,246,10,N,N,-,-1,-1
GRONOW.txt,565474,565729,255,10,N,N,-,-1,-1
GRONOW.txt,565500,565767,267,10,N,N,-,-1,-1
GRONOW.txt,565515,565789,274,10,N,N,-,-1,-1
GRONOW.txt,565518,565834,316,10,N,N,-,-1,-1
GRONOW.txt,565562,565844,282,10,N,N,-,-1,-1
GRONOW.txt,565577,565863,286,10,N,N,-,-1,-1
MASONB.txt,0,1439,1439,10,N,N,-,-1,-1
MASONB.txt,212,1708,1496,10,N,N,-,-1,-1
MASONB.txt,309,1801,1492,10,N,N,-,-1,-1
MASONB.txt,418,1995,1577,10,N,N,-,-1,-1
MASONB.txt,486,2020,1534,10,N,N,-,-1,-1
MASONB.txt,632,2138,1506,10,N,N,-,-1,-1
MASONB.txt,823,2319,1496,10,N,N,-,-1,-1
MASONB.txt,953,2478,1525,10,N,N,-,-1,-1
MASONB.txt,1031,2605,1574,10,N,N,-,-1,-1
MASONB.txt,1242,2658,1416,10,N,N,-,-1,-1
MASONB.txt,1442,2793,1351,10,N,N,-,-1,-1
MASONB.txt,1709,2912,1203,10,N,N,-,-1,-1
MASONB.txt,1804,2995,1191,10,N,N,-,-1,-1
MASONB.txt,1996,3003,1007,10,N,N,-,-1,-1
MASONB.txt,2023,3283,1260,10,N,N,-,-1,-1
MASONB.txt,2139,3304,1165,10,N,N,-,-1,-1
MASONB.txt,2320,3348,1028,10,N,N,-,-1,-1
MASONB.txt,2479,3356,877,10,N,N,-,-1,-1
MASONB.txt,2606,3542,936,10,N,N,-,-1,-1
MASONB.txt,2661,3591,930,10,N,N,-,-1,-1
MASONB.txt,2794,3605,811,10,N,N,-,-1,-1
MASONB.txt,2913,3660,747,10,N,N,-,-1,-1
MASONB.txt,2995,3674,679,10,N,N,-,-1,-1
MASONB.txt,3003,3876,873,10,N,N,-,-1,-1
MASONB.txt,3288,4631,1343,10,N,N,-,-1,-1
MASONB.txt,3309,4647,1338,10,N,N,-,-1,-1
MASONB.txt,3351,4980,1629,10,N,N,-,-1,-1
MASONB.txt,3361,5260,1899,10,N,N,-,-1,-1
MASONB.txt,3547,5404,1857,10,N,N,-,-1,-1
MASONB.txt,3592,5458,1866,10,N,N,-,-1,-1
MASONB.txt,3608,5538,1930,10,N,N,-,-1,-1
MASONB.txt,3660,5614,1954,10,N,N,-,-1,-1
MASONB.txt,3679,5692,2013,10,N,N,-,-1,-1
MASONB.txt,3877,5814,1937,10,N,N,-,-1,-1
MASONB.txt,4636,5885,1249,10,N,N,-,-1,-1
MASONB.txt,4650,6008,1358,10,N,N,-,-1,-1
MASONB.txt,4982,6225,1243,10,N,N,-,-1,-1
MASONB.txt,5265,6238,973,10,N,N,-,-1,-1
MASONB.txt,5405,6459,1054,10,N,N,-,-1,-1
MASONB.txt,5460,6567,1107,10,N,N,-,-1,-1
MASONB.txt,5539,6669,1130,10,N,N,-,-1,-1
MASONB.txt,5617,6772,1155,10,N,N,-,-1,-1
MASONB.txt,5695,6897,1202,10,N,N,-,-1,-1
MASONB.txt,5815,6966,1151,10,N,N,-,-1,-1
MASONB.txt,5888,7087,1199,10,N,N,-,-1,-1
MASONB.txt,6011,7190,1179,10,N,N,-,-1,-1
MASONB.txt,6228,7344,1116,10,N,N,-,-1,-1
MASONB.txt,6241,7361,1120,10,N,N,-,-1,-1
MASONB.txt,6462,7442,980,10,N,N,-,-1,-1
MASONB.txt,6570,7471,901,10,N,N,-,-1,-1
MASONB.txt,6672,7807,1135,10,N,N,-,-1,-1
MASONB.txt,6775,7942,1167,10,N,N,-,-1,-1
MASONB.txt,6900,8000,1100,10,N,N,-,-1,-1
MASONB.txt,6969,8001,1032,10,N,N,-,-1,-1
MASONB.txt,7090,8019,929,10,N,N,-,-1,-1
MASONB.txt,7193,8188,995,10,N,N,-,-1,-1
MASONB.txt,7345,8255,910,10,N,N,-,-1,-1
MASONB.txt,7364,8288,924,10,N,N,-,-1,-1
MASONB.txt,7444,8303,859,10,N,N,-,-1,-1
MASONB.txt,7474,8331,857,10,N,N,-,-1,-1
MASONB.txt,7810,8333,523,10,N,N,-,-1,-1
MASONB.txt,7945,8357,412,10,N,N,-,-1,-1
MASONB.txt,8000,8477,477,10,N,N,-,-1,-1
MASONB.txt,8002,8614,612,10,N,N,-,-1,-1
MASONB.txt,8022,8712,690,10,N,N,-,-1,-1
MASONB.txt,8191,8811,620,10,N,N,-,-1,-1
MASONB.txt,8260,8967,707,10,N,N,-,-1,-1
MASONB.txt,8291,9102,811,10,N,N,-,-1,-1
MASONB.txt,8306,9136,830,10,N,N,-,-1,-1
MASONB.txt,8332,9299,967,10,N,N,-,-1,-1
MASONB.txt,8334,9388,1054,10,N,N,-,-1,-1
MASONB.txt,8360,9407,1047,10,N,N,-,-1,-1
MASONB.txt,8480,9551,1071,10,N,N,-,-1,-1
MASONB.txt,8617,9587,970,10,N,N,-,-1,-1
MASONB.txt,8715,9681,966,10,N,N,-,-1,-1
MASONB.txt,8814,9768,954,10,N,N,-,-1,-1
MASONB.txt,8970,9947,977,10,N,N,-,-1,-1
MASONB.txt,9102,10003,901,10,N,N,-,-1,-1
MASONB.txt,9139,10167,1028,10,N,N,-,-1,-1
MASONB.txt,9302,10329,1027,10,N,N,-,-1,-1
MASONB.txt,9389,10495,1106,10,N,N,-,-1,-1
MASONB.txt,9410,10541,1131,10,N,N,-,-1,-1
MASONB.txt,9554,10556,1002,10,N,N,-,-1,-1
MASONB.txt,9588,11199,1611,10,N,N,-,-1,-1
MASONB.txt,9684,11386,1702,10,N,N,-,-1,-1
MASONB.txt,9769,11414,1645,10,N,N,-,-1,-1
MASONB.txt,9950,11502,1552,10,N,N,-,-1,-1
MASONB.txt,10006,11541,1535,10,N,N,-,-1,-1
MASONB.txt,10170,11567,1397,10,N,N,-,-1,-1
MASONB.txt,10332,11787,1455,10,N,N,-,-1,-1
MASONB.txt,10496,11846,1350,10,N,N,-,-1,-1
MASONB.txt,10544,12047,1503,10,N,N,-,-1,-1
MASONB.txt,10559,12216,1657,10,N,N,-,-1,-1
MASONB.txt,11202,12262,1060,10,N,N,-,-1,-1
MASONB.txt,11391,12418,1027,10,N,N,-,-1,-1
MASONB.txt,11417,12732,1315,10,N,N,-,-1,-1
MASONB.txt,11503,12761,1258,10,N,N,-,-1,-1
MASONB.txt,11544,12880,1336,10,N,N,-,-1,-1
MASONB.txt,11570,13118,1548,10,N,N,-,-1,-1
MASONB.txt,11788,13318,1530,10,N,N,-,-1,-1
MASONB.txt,11847,13385,1538,10,N,N,-,-1,-1
MASONB.txt,12048,13506,1458,10,N,N,-,-1,-1
MASONB.txt,12217,13573,1356,10,N,N,-,-1,-1
MASONB.txt,12263,13726,1463,10,N,N,-,-1,-1
MASONB.txt,12419,13789,1370,10,N,N,-,-1,-1
MASONB.txt,12737,13905,1168,10,N,N,-,-1,-1
MASONB.txt,12764,13964,1200,10,N,Y,1448281888079,98877,102290
MASONB.txt,12882,14120,1238,10,N,Y,1448281888079,98877,102290
MASONB.txt,13119,14298,1179,10,N,Y,1448281888079,98877,102290
MASONB.txt,13320,14367,1047,10,N,Y,1448281888079,98877,102290
MASONB.txt,13387,14396,1009,10,N,Y,1448281888079,98877,102290
MASONB.txt,13507,14400,893,10,N,Y,1448281888079,98877,102290
MASONB.txt,13575,14444,869,10,N,Y,1448281888079,98877,102290
MASONB.txt,13727,14448,721,10,N,Y,1448281888079,98877,102290
MASONB.txt,13790,14601,811,10,N,Y,1448281888079,98877,102290
MASONB.txt,13908,14709,801,10,N,Y,1448281888079,98877,102290
MASONB.txt,13966,14828,862,10,N,Y,1448281888079,98877,102290
MASONB.txt,14121,14921,800,10,N,Y,1448281888079,98877,102290
MASONB.txt,14301,15014,713,10,N,Y,1448281888079,98877,102290
MASONB.txt,14368,15088,720,10,N,Y,1448281888079,98877,102290
MASONB.txt,14397,15219,822,10,N,Y,1437028092146,121457,123204
MASONB.txt,14401,15462,1061,10,N,Y,1437028092146,121457,123204
MASONB.txt,14445,15639,1194,10,N,Y,1437028092146,121457,123204
MASONB.txt,14449,15717,1268,10,N,Y,1437028092146,121457,123204
MASONB.txt,14602,15753,1151,10,N,Y,1437028092146,121457,123204
MASONB.txt,14710,15982,1272,10,N,Y,1437028092146,121457,123204
MASONB.txt,14829,16098,1269,10,N,Y,1437028092146,121457,123204
MASONB.txt,14922,16148,1226,10,N,Y,1437028092146,121457,123204
MASONB.txt,15015,16265,1250,10,N,Y,1437028092146,121457,123204
MASONB.txt,15091,16295,1204,10,N,Y,1437028092146,121457,123204
MASONB.txt,15220,16370,1150,10,N,Y,1437028092146,121457,123204
MASONB.txt,15463,16494,1031,10,N,Y,1437028092146,121457,123204
MASONB.txt,15640,16633,993,10,N,Y,1437028092146,121457,123204
MASONB.txt,15718,16637,919,10,N,Y,1437028092146,121457,123204
MASONB.txt,15754,16647,893,10,N,Y,1437028092146,121457,123204
MASONB.txt,15983,16658,675,10,N,Y,1437028092146,121457,123204
MASONB.txt,16099,16834,735,10,N,Y,1437028092146,121457,123204
MASONB.txt,16149,17032,883,10,N,Y,1437028092146,121457,123204
MASONB.txt,16266,17265,999,10,N,Y,1437028092146,121457,123204
MASONB.txt,16296,17457,1161,10,N,Y,1437028092146,121457,123204
MASONB.txt,16371,17571,1200,10,N,Y,1437028092146,121457,123204
MASONB.txt,16495,17669,1174,10,N,Y,1437028092146,121457,123204
MASONB.txt,16634,17873,1239,10,N,Y,1437028092146,121457,123204
MASONB.txt,16638,18007,1369,10,N,Y,1437028092146,121457,123204
MASONB.txt,16650,18257,1607,10,N,Y,1437028092146,121457,123204
MASONB.txt,16659,18423,1764,10,N,Y,1437028092146,121457,123204
MASONB.txt,16836,18495,1659,10,Y,Y,1437028092146,121457,123204
MASONB.txt,17033,18641,1608,10,Y,Y,1437028092146,121457,123204
MASONB.txt,17266,18696,1430,10,N,Y,1437028092146,121457,123204
MASONB.txt,17459,18884,1425,10,N,Y,1437028092146,121457,123204
MASONB.txt,17574,19011,1437,10,N,Y,1437470299748,152207,152889
MASONB.txt,17670,19066,1396,10,N,Y,1437470299748,152207,152889
MASONB.txt,17875,19143,1268,10,N,Y,1437470299748,152207,152889
MASONB.txt,18008,19512,1504,10,N,Y,1437470299748,152207,152889
MASONB.txt,18258,19677,1419,10,N,Y,1437470299748,152207,152889
MASONB.txt,18426,19830,1404,10,N,Y,1437470299748,152207,152889
MASONB.txt,18496,19942,1446,10,N,Y,1437470299748,152207,152889
MASONB.txt,18642,20137,1495,10,N,Y,1437470299748,152207,152889
MASONB.txt,18697,20355,1658,10,N,Y,1437470299748,152207,152889
MASONB.txt,18887,20447,1560,10,N,Y,1437470299748,152207,152889
MASONB.txt,19013,20637,1624,10,N,Y,1437470299748,152207,152889
MASONB.txt,19067,20652,1585,10,N,Y,1437470299748,152207,152889
MASONB.txt,19144,20770,1626,10,N,Y,1437470299748,152207,152889
MASONB.txt,19513,20906,1393,10,N,Y,1437470299748,152207,152889
MASONB.txt,19680,20924,1244,10,N,Y,1437471855423,351318,351853
MASONB.txt,19831,21032,1201,10,N,Y,1437471855423,351318,351853
MASONB.txt,19943,21307,1364,10,N,Y,1437471855423,351318,351853
MASONB.txt,20138,21548,1410,10,N,Y,1437471855423,351318,351853
MASONB.txt,20358,21687,1329,10,N,Y,1437471855423,351318,351853
MASONB.txt,20448,21702,1254,10,N,Y,1437471855423,351318,351853
MASONB.txt,20640,21783,1143,10,N,Y,1437471855423,351318,351853
MASONB.txt,20653,21811,1158,10,N,Y,1437471855423,351318,351853
MASONB.txt,20773,21977,1204,10,N,Y,1437471855423,351318,351853
MASONB.txt,20907,22096,1189,10,N,Y,1437471855423,351318,351853
MASONB.txt,20925,22106,1181,10,N,Y,1437471855423,351318,351853
MASONB.txt,21033,22155,1122,10,N,Y,1437471855423,351318,351853
MASONB.txt,21310,22198,888,10,N,Y,1448038803075,18895,19670
MASONB.txt,21549,22345,796,10,N,Y,1448038803075,18895,19670
MASONB.txt,21692,22476,784,10,N,Y,1448280297446,84055,84972
MASONB.txt,21705,22567,862,10,N,Y,1448280297446,84055,84972
MASONB.txt,21786,22685,899,10,N,Y,1448280297446,84055,84972
MASONB.txt,21814,22997,1183,10,N,Y,1448280297446,84055,84972
MASONB.txt,21978,23036,1058,10,N,Y,1448280297446,84055,84972
MASONB.txt,22097,23157,1060,10,N,Y,1448280297446,84055,84972
MASONB.txt,22107,23294,1187,10,N,Y,1448280297446,84055,84972
MASONB.txt,22156,23426,1270,10,N,Y,1448280297446,84055,84972
MASONB.txt,22199,23692,1493,10,N,Y,1448280297446,84055,84972
MASONB.txt,22347,23788,1441,10,N,Y,1448280297446,84055,84972
MASONB.txt,22477,23931,1454,10,N,Y,1448280297446,84055,84972
MASONB.txt,22570,24027,1457,10,N,Y,1448280297446,84055,84972
MASONB.txt,22686,24060,1374,10,N,Y,1448280297446,84055,84972
MASONB.txt,22998,24125,1127,10,N,Y,1448280297446,84055,84972
MASONB.txt,23037,24207,1170,10,N,Y,1448280297446,84055,84972
MASONB.txt,23160,24360,1200,10,N,Y,1448280297446,84055,84972
MASONB.txt,23295,24428,1133,10,N,Y,1448280297446,84055,84972
MASONB.txt,23427,24436,1009,10,N,Y,1448280297446,84055,84972
MASONB.txt,23695,24532,837,10,N,Y,1448280297446,84055,84972
MASONB.txt,23790,24594,804,10,N,Y,1448280297446,84055,84972
MASONB.txt,23934,24797,863,10,N,Y,1448280297446,84055,84972
MASONB.txt,24030,24828,798,10,N,Y,1448280297446,84055,84972
MASONB.txt,24061,24903,842,10,N,Y,1448280297446,84055,84972
MASONB.txt,24126,25068,942,10,N,Y,1448280297446,84055,84972
MASONB.txt,24208,25130,922,10,N,Y,1448280297446,84055,84972
MASONB.txt,24363,25268,905,10,N,Y,1448280297446,84055,84972
MASONB.txt,24429,25380,951,10,N,Y,1448280297446,84055,84972
MASONB.txt,24437,25472,1035,10,N,Y,1436867017136,105674,106651
MASONB.txt,24533,25646,1113,10,Y,Y,1436867017136,105674,106651
MASONB.txt,24595,25782,1187,10,Y,Y,1436867017136,105674,106651
MASONB.txt,24798,25878,1080,10,N,Y,1436867017136,105674,106651
MASONB.txt,24829,26019,1190,10,N,Y,1436867017136,105674,106651
MASONB.txt,24904,26181,1277,10,N,Y,1436867017136,105674,106651
MASONB.txt,25069,26252,1183,10,N,Y,1436867017136,105674,106651
MASONB.txt,25131,26422,1291,10,N,Y,1436867017136,105674,106651
MASONB.txt,25271,26516,1245,10,N,Y,1436867017136,105674,106651
MASONB.txt,25383,26756,1373,10,N,Y,1436867017136,105674,106651
MASONB.txt,25473,26847,1374,10,N,Y,1436867017136,105674,106651
MASONB.txt,25647,26863,1216,10,N,Y,1436867017136,105674,106651
MASONB.txt,25783,26906,1123,10,N,Y,1436867017136,105674,106651
MASONB.txt,25879,26934,1055,10,N,Y,1436867017136,105674,106651
MASONB.txt,26020,27099,1079,10,N,Y,1437472966198,394609,395892
MASONB.txt,26182,27169,987,10,N,Y,1437472966198,394609,395892
MASONB.txt,26255,27263,1008,10,N,Y,1437472966198,394609,395892
MASONB.txt,26423,27402,979,10,N,Y,1437472966198,394609,395892
MASONB.txt,26517,27496,979,10,N,Y,1437472966198,394609,395892
MASONB.txt,26757,27551,794,10,N,Y,1437472966198,394609,395892
MASONB.txt,26852,27767,915,10,Y,Y,1437472966198,394609,395892
MASONB.txt,26868,27913,1045,10,Y,Y,1437472966198,394609,395892
MASONB.txt,26909,28116,1207,10,Y,Y,1437472966198,394609,395892
MASONB.txt,26937,28310,1373,10,Y,Y,1437472966198,394609,395892
MASONB.txt,27100,28495,1395,10,Y,Y,1437472966198,394609,395892
MASONB.txt,27170,28914,1744,10,Y,Y,1437472966198,394609,395892
MASONB.txt,27264,28935,1671,10,Y,Y,1437472966198,394609,395892
MASONB.txt,27405,28959,1554,10,Y,Y,1437472966198,394609,395892
MASONB.txt,27497,29177,1680,10,Y,Y,1437472966198,394609,395892
MASONB.txt,27552,29256,1704,10,Y,Y,1437472966198,394609,395892
MASONB.txt,27768,29373,1605,10,Y,Y,1437472966198,394609,395892
MASONB.txt,27914,29555,1641,10,Y,Y,1437472966198,394609,395892
MASONB.txt,28117,29570,1453,10,Y,Y,1437472966198,394609,395892
MASONB.txt,28311,29668,1357,10,Y,Y,1437472966198,394609,395892
MASONB.txt,28496,29697,1201,10,N,Y,1437472966198,394609,395892
MASONB.txt,28916,29840,924,10,N,Y,1437472966198,394609,395892
MASONB.txt,28940,29919,979,10,N,Y,1437472966198,394609,395892
MASONB.txt,28960,30007,1047,10,N,Y,1437472966198,394609,395892
MASONB.txt,29179,30087,908,10,N,Y,1437472966198,394609,395892
MASONB.txt,29259,30238,979,10,N,Y,1448281491382,97818,98860
MASONB.txt,29374,30281,907,10,N,Y,1448281491382,97818,98860
MASONB.txt,29560,30724,1164,10,N,Y,1448281491382,97818,98860
MASONB.txt,29573,30941,1368,10,N,Y,1448281491382,97818,98860
MASONB.txt,29671,31257,1586,10,N,Y,1448281491382,97818,98860
MASONB.txt,29700,31993,2293,10,N,Y,1448281491382,97818,98860
MASONB.txt,29843,32207,2364,10,Y,Y,1448281491382,97818,98860
MASONB.txt,29920,32285,2365,10,Y,Y,1448281491382,97818,98860
MASONB.txt,30008,32454,2446,10,Y,Y,1448281491382,97818,98860
MASONB.txt,30089,32492,2403,10,Y,Y,1448281491382,97818,98860
MASONB.txt,30241,32744,2503,10,Y,Y,1448281491382,97818,98860
MASONB.txt,30282,33150,2868,10,Y,Y,1448281491382,97818,98860
MASONB.txt,30725,33270,2545,10,Y,Y,1448281491382,97818,98860
MASONB.txt,30944,33569,2625,10,Y,Y,1448281491382,97818,98860
MASONB.txt,31258,33694,2436,10,Y,Y,1448281491382,97818,98860
MASONB.txt,31994,33921,1927,10,Y,Y,1448281491382,97818,98860
MASONB.txt,32208,34224,2016,10,Y,Y,1448281491382,97818,98860
MASONB.txt,32286,34469,2183,10,Y,Y,1448281491382,97818,98860
MASONB.txt,32457,34560,2103,10,Y,Y,1448281491382,97818,98860
MASONB.txt,32493,34782,2289,10,Y,Y,1448281491382,97818,98860
MASONB.txt,32745,35019,2274,10,Y,Y,1448281491382,97818,98860
MASONB.txt,33153,35168,2015,10,Y,Y,1448281491382,97818,98860
MASONB.txt,33271,35215,1944,10,Y,Y,1448281491382,97818,98860
MASONB.txt,33570,35697,2127,10,Y,Y,1448281491382,97818,98860
MASONB.txt,33697,35960,2263,10,Y,Y,1448281491382,97818,98860
MASONB.txt,33922,36051,2129,10,Y,Y,1448281491382,97818,98860
MASONB.txt,34227,36088,1861,10,Y,Y,1448281491382,97818,98860
MASONB.txt,34470,36154,1684,10,Y,Y,1448281491382,97818,98860
MASONB.txt,34561,36237,1676,10,Y,Y,1448281491382,97818,98860
MASONB.txt,34783,36482,1699,10,Y,Y,1448281491382,97818,98860
MASONB.txt,35020,36608,1588,10,Y,Y,1448281491382,97818,98860
MASONB.txt,35169,36612,1443,10,Y,Y,1448281491382,97818,98860
MASONB.txt,35216,36682,1466,10,Y,Y,1448281491382,97818,98860
MASONB.txt,35700,36740,1040,10,Y,Y,1448281491382,97818,98860
MASONB.txt,35961,36745,784,10,N,Y,1448281491382,97818,98860
MASONB.txt,36052,36825,773,10,N,Y,1448281491382,97818,98860
MASONB.txt,36089,36899,810,10,N,Y,1448281491382,97818,98860
MASONB.txt,36155,36952,797,10,N,Y,1448281491382,97818,98860
MASONB.txt,36238,37018,780,10,N,Y,1448281491382,97818,98860
MASONB.txt,36485,37138,653,10,N,Y,1448281491382,97818,98860
MASONB.txt,36609,37324,715,10,N,Y,1448281491382,97818,98860
MASONB.txt,36613,37398,785,10,N,Y,1448281491382,97818,98860
MASONB.txt,36683,37612,929,10,N,Y,1448281491382,97818,98860
MASONB.txt,36741,37686,945,10,Y,Y,1448281491382,97818,98860
MASONB.txt,36746,37759,1013,10,Y,Y,1448281491382,97818,98860
MASONB.txt,36826,37841,1015,10,Y,Y,1448281491382,97818,98860
MASONB.txt,36902,37904,1002,10,Y,Y,1448281491382,97818,98860
MASONB.txt,36953,38115,1162,10,Y,Y,1448281491382,97818,98860
MASONB.txt,37020,38125,1105,10,Y,Y,1448281491382,97818,98860
MASONB.txt,37140,38213,1073,10,Y,Y,1448281491382,97818,98860
MASONB.txt,37325,38329,1004,10,Y,Y,1448281491382,97818,98860
MASONB.txt,37401,38335,934,10,Y,Y,1448281491382,97818,98860
MASONB.txt,37613,38366,753,10,N,Y,1448281491382,97818,98860
MASONB.txt,37689,38372,683,10,N,Y,1448281491382,97818,98860
MASONB.txt,37760,38423,663,10,N,Y,1448281491382,97818,98860
MASONB.txt,37844,38718,874,10,N,Y,1448281491382,97818,98860
MASONB.txt,37905,38917,1012,10,N,Y,1448281491382,97818,98860
MASONB.txt,38118,39202,1084,10,N,Y,1448281491382,97818,98860
MASONB.txt,38126,39255,1129,10,N,Y,1448281491382,97818,98860
MASONB.txt,38214,39405,1191,10,N,Y,1448281491382,97818,98860
MASONB.txt,38332,39629,1297,10,Y,Y,1448281491382,97818,98860
MASONB.txt,38336,39938,1602,10,N,Y,1448281491382,97818,98860
MASONB.txt,38369,40047,1678,10,N,Y,1448281491382,97818,98860
MASONB.txt,38373,40201,1828,10,N,Y,1448281491382,97818,98860
MASONB.txt,38425,40225,1800,10,N,Y,1448281491382,97818,98860
MASONB.txt,38721,40573,1852,10,N,Y,1448281491382,97818,98860
MASONB.txt,38918,40685,1767,10,N,Y,1448281491382,97818,98860
MASONB.txt,39203,40741,1538,10,N,N,-,-1,-1
MASONB.txt,39256,40769,1513,10,N,N,-,-1,-1
MASONB.txt,39406,40839,1433,10,N,N,-,-1,-1
MASONB.txt,39630,40956,1326,10,N,Y,1448039533036,21326,21680
MASONB.txt,39939,41037,1098,10,N,Y,1448039533036,21326,21680
MASONB.txt,40048,41092,1044,10,N,Y,1448039533036,21326,21680
MASONB.txt,40202,41233,1031,10,N,Y,1448039533036,21326,21680
MASONB.txt,40226,41398,1172,10,N,Y,1448039533036,21326,21680
MASONB.txt,40578,41449,871,10,N,Y,1448039533036,21326,21680
MASONB.txt,40686,41536,850,10,N,Y,1448039533036,21326,21680
MASONB.txt,40744,41678,934,10,N,Y,1448039533036,21326,21680
MASONB.txt,40772,41749,977,10,N,Y,1448039533036,21326,21680
MASONB.txt,40840,41829,989,10,N,Y,1448039533036,21326,21680
MASONB.txt,40957,41989,1032,10,Y,Y,1448039533036,21326,21680
MASONB.txt,41038,42127,1089,10,Y,Y,1448039533036,21326,21680
MASONB.txt,41092,42231,1139,10,N,Y,1448039533036,21326,21680
MASONB.txt,41234,42452,1218,10,Y,Y,1448039533036,21326,21680
MASONB.txt,41401,42573,1172,10,N,Y,1448039533036,21326,21680
MASONB.txt,41451,43075,1624,10,N,Y,1448039533036,21326,21680
MASONB.txt,41537,43195,1658,10,N,Y,1448039533036,21326,21680
MASONB.txt,41681,43550,1869,10,N,Y,1448039533036,21326,21680
MASONB.txt,41750,43623,1873,10,N,Y,1448039533036,21326,21680
MASONB.txt,41832,43701,1869,10,N,Y,1448039533036,21326,21680
MASONB.txt,41990,43934,1944,10,N,Y,1448039533036,21326,21680
MASONB.txt,42128,44017,1889,10,N,Y,1448039533036,21326,21680
MASONB.txt,42232,44189,1957,10,N,Y,1448039533036,21326,21680
MASONB.txt,42453,44196,1743,10,N,Y,1448039533036,21326,21680
MASONB.txt,42574,44366,1792,10,N,Y,1448039533036,21326,21680
MASONB.txt,43076,44734,1658,10,Y,Y,1448039533036,21326,21680
MASONB.txt,43198,44886,1688,10,Y,Y,1448039533036,21326,21680
MASONB.txt,43553,45032,1479,10,Y,Y,1448039533036,21326,21680
MASONB.txt,43624,45298,1674,10,Y,Y,1448039533036,21326,21680
MASONB.txt,43702,45597,1895,10,Y,Y,1448039533036,21326,21680
MASONB.txt,43936,45631,1695,10,Y,Y,1448039533036,21326,21680
MASONB.txt,44020,46087,2067,10,Y,Y,1448039533036,21326,21680
MASONB.txt,44190,46403,2213,10,Y,Y,1448039533036,21326,21680
MASONB.txt,44197,46430,2233,10,Y,Y,1448039533036,21326,21680
MASONB.txt,44367,46592,2225,10,Y,Y,1448039533036,21326,21680
MASONB.txt,44735,46781,2046,10,N,Y,1448039533036,21326,21680
MASONB.txt,44887,47028,2141,10,N,Y,1448039533036,21326,21680
MASONB.txt,45033,47349,2316,10,N,Y,1448039533036,21326,21680
MASONB.txt,45299,47575,2276,10,N,Y,1448039533036,21326,21680
MASONB.txt,45598,47652,2054,10,N,Y,1448039533036,21326,21680
MASONB.txt,45634,47696,2062,10,N,Y,1448039533036,21326,21680
MASONB.txt,46088,47710,1622,10,N,Y,1448039533036,21326,21680
MASONB.txt,46406,47810,1404,10,N,Y,1448039533036,21326,21680
MASONB.txt,46431,47876,1445,10,N,Y,1448039533036,21326,21680
MASONB.txt,46593,48010,1417,10,N,Y,1448039533036,21326,21680
MASONB.txt,46782,48026,1244,10,N,Y,1448039533036,21326,21680
MASONB.txt,47029,48041,1012,10,N,Y,1448039533036,21326,21680
MASONB.txt,47350,48150,800,10,N,Y,1448039533036,21326,21680
MASONB.txt,47578,48179,601,10,N,Y,1448039533036,21326,21680
MASONB.txt,47653,48450,797,10,N,Y,1448039533036,21326,21680
MASONB.txt,47697,48595,898,10,N,Y,1448039533036,21326,21680
MASONB.txt,47711,48717,1006,10,N,Y,1448039533036,21326,21680
MASONB.txt,47811,49075,1264,10,N,N,-,-1,-1
MASONB.txt,47879,49204,1325,10,N,N,-,-1,-1
MASONB.txt,48011,49374,1363,10,N,N,-,-1,-1
MASONB.txt,48031,49491,1460,10,N,N,-,-1,-1
MASONB.txt,48046,49763,1717,10,N,N,-,-1,-1
MASONB.txt,48153,49990,1837,10,N,N,-,-1,-1
MASONB.txt,48182,50231,2049,10,N,N,-,-1,-1
MASONB.txt,48451,50693,2242,10,Y,N,-,-1,-1
MASONB.txt,48596,50886,2290,10,Y,N,-,-1,-1
MASONB.txt,48718,51111,2393,10,Y,N,-,-1,-1
MASONB.txt,49076,51190,2114,10,Y,N,-,-1,-1
MASONB.txt,49207,51232,2025,10,Y,N,-,-1,-1
MASONB.txt,49375,51901,2526,10,Y,N,-,-1,-1
MASONB.txt,49492,52286,2794,10,Y,N,-,-1,-1
MASONB.txt,49766,52494,2728,10,Y,N,-,-1,-1
MASONB.txt,49991,52569,2578,10,Y,Y,1437472380836,351899,352666
MASONB.txt,50232,52787,2555,10,Y,Y,1437472380836,351899,352666
MASONB.txt,50694,52817,2123,10,Y,Y,1437472380836,351899,352666
MASONB.txt,50887,52857,1970,10,Y,Y,1437472380836,351899,352666
MASONB.txt,51112,52986,1874,10,N,Y,1437472380836,351899,352666
MASONB.txt,51191,53173,1982,10,N,Y,1437472380836,351899,352666
MASONB.txt,51233,53373,2140,10,Y,Y,1437472380836,351899,352666
MASONB.txt,51902,53468,1566,10,N,Y,1437472380836,351899,352666
MASONB.txt,52289,53652,1363,10,N,Y,1437472380836,351899,352666
MASONB.txt,52497,53850,1353,10,N,Y,1437472380836,351899,352666
MASONB.txt,52570,54003,1433,10,N,Y,1437472380836,351899,352666
MASONB.txt,52788,54281,1493,10,N,Y,1437472380836,351899,352666
MASONB.txt,52818,54624,1806,10,Y,Y,1437472380836,351899,352666
MASONB.txt,52859,54782,1923,10,Y,Y,1437472380836,351899,352666
MASONB.txt,52988,54946,1958,10,Y,Y,1437472380836,351899,352666
MASONB.txt,53176,55068,1892,10,Y,Y,1437472380836,351899,352666
MASONB.txt,53374,55156,1782,10,Y,Y,1437472380836,351899,352666
MASONB.txt,53469,55199,1730,10,Y,Y,1437472380836,351899,352666
MASONB.txt,53653,55254,1601,10,Y,Y,1437472380836,351899,352666
MASONB.txt,53851,55413,1562,10,Y,Y,1437472380836,351899,352666
MASONB.txt,54004,55642,1638,10,Y,Y,1437472380836,351899,352666
MASONB.txt,54282,55916,1634,10,Y,Y,1437472380836,351899,352666
MASONB.txt,54627,55982,1355,10,N,Y,1448278279697,58861,59444
MASONB.txt,54783,56010,1227,10,N,Y,1448278279697,58861,59444
MASONB.txt,54947,56405,1458,10,N,Y,1448278279697,58861,59444
MASONB.txt,55069,56692,1623,10,N,Y,1448278279697,58861,59444
MASONB.txt,55157,56776,1619,10,N,Y,1448278279697,58861,59444
MASONB.txt,55200,56853,1653,10,N,Y,1448278279697,58861,59444
MASONB.txt,55256,57026,1770,10,N,Y,1448278279697,58861,59444
MASONB.txt,55414,57207,1793,10,N,Y,1448278279697,58861,59444
MASONB.txt,55643,57367,1724,10,N,Y,1448278279697,58861,59444
MASONB.txt,55921,57435,1514,10,N,N,-,-1,-1
MASONB.txt,55985,57555,1570,10,N,N,-,-1,-1
MASONB.txt,56013,57648,1635,10,N,N,-,-1,-1
MASONB.txt,56407,57881,1474,10,N,N,-,-1,-1
MASONB.txt,56695,58084,1389,10,N,N,-,-1,-1
MASONB.txt,56777,58384,1607,10,N,N,-,-1,-1
MASONB.txt,56854,58435,1581,10,Y,N,-,-1,-1
MASONB.txt,57027,58446,1419,10,Y,N,-,-1,-1
MASONB.txt,57210,58640,1430,10,Y,N,-,-1,-1
MASONB.txt,57368,58848,1480,10,N,N,-,-1,-1
MASONB.txt,57436,58940,1504,10,N,Y,1448277582432,52552,54595
MASONB.txt,57556,59018,1462,10,N,Y,1448277582432,52552,54595
MASONB.txt,57649,59197,1548,10,Y,Y,1448277582432,52552,54595
MASONB.txt,57882,59452,1570,10,N,Y,1448277582432,52552,54595
MASONB.txt,58085,59517,1432,10,N,Y,1448277582432,52552,54595
MASONB.txt,58386,59744,1358,10,N,Y,1448277582432,52552,54595
MASONB.txt,58436,59884,1448,10,N,Y,1448277582432,52552,54595
MASONB.txt,58446,60053,1607,10,N,Y,1448277582432,52552,54595
MASONB.txt,58645,60262,1617,10,N,Y,1448277582432,52552,54595
MASONB.txt,58851,60598,1747,10,N,Y,1448277582432,52552,54595
MASONB.txt,58941,60696,1755,10,N,Y,1448277582432,52552,54595
MASONB.txt,59019,60745,1726,10,N,Y,1448277582432,52552,54595
MASONB.txt,59198,60864,1666,10,N,Y,1448277582432,52552,54595
MASONB.txt,59455,61023,1568,10,N,N,-,-1,-1
MASONB.txt,59519,61226,1707,10,N,N,-,-1,-1
MASONB.txt,59745,61275,1530,10,N,N,-,-1,-1
MASONB.txt,59885,61431,1546,10,N,N,-,-1,-1
MASONB.txt,60054,61689,1635,10,N,N,-,-1,-1
MASONB.txt,60263,61899,1636,10,N,N,-,-1,-1
MASONB.txt,60600,62165,1565,10,N,N,-,-1,-1
MASONB.txt,60699,62324,1625,10,N,N,-,-1,-1
MASONB.txt,60746,62451,1705,10,N,N,-,-1,-1
MASONB.txt,60865,62522,1657,10,N,N,-,-1,-1
MASONB.txt,61024,62587,1563,10,N,N,-,-1,-1
MASONB.txt,61227,62664,1437,10,N,N,-,-1,-1
MASONB.txt,61276,62711,1435,10,N,N,-,-1,-1
MASONB.txt,61432,62850,1418,10,N,N,-,-1,-1
MASONB.txt,61691,62937,1246,10,N,N,-,-1,-1
MASONB.txt,61900,63146,1246,10,N,N,-,-1,-1
MASONB.txt,62166,63425,1259,10,N,N,-,-1,-1
MASONB.txt,62325,63501,1176,10,N,N,-,-1,-1
MASONB.txt,62452,63532,1080,10,N,N,-,-1,-1
MASONB.txt,62523,63637,1114,10,N,N,-,-1,-1
MASONB.txt,62588,63827,1239,10,N,N,-,-1,-1
MASONB.txt,62665,64016,1351,10,N,N,-,-1,-1
MASONB.txt,62712,64157,1445,10,N,N,-,-1,-1
MASONB.txt,62851,64268,1417,10,N,N,-,-1,-1
MASONB.txt,62938,64432,1494,10,N,N,-,-1,-1
MASONB.txt,63148,64727,1579,10,N,N,-,-1,-1
MASONB.txt,63426,64867,1441,10,N,N,-,-1,-1
MASONB.txt,63502,64972,1470,10,N,N,-,-1,-1
MASONB.txt,63533,65375,1842,10,N,N,-,-1,-1
MASONB.txt,63640,65585,1945,10,N,N,-,-1,-1
MASONB.txt,63828,65922,2094,10,N,Y,1437471397525,350644,351290
MASONB.txt,64017,65923,1906,10,N,Y,1437471397525,350644,351290
MASONB.txt,64158,66047,1889,10,N,Y,1437471397525,350644,351290
MASONB.txt,64269,66255,1986,10,N,Y,1437471397525,350644,351290
MASONB.txt,64433,66347,1914,10,Y,Y,1437471397525,350644,351290
MASONB.txt,64730,66462,1732,10,N,Y,1437471397525,350644,351290
MASONB.txt,64868,66616,1748,10,Y,Y,1437471397525,350644,351290
MASONB.txt,64974,66673,1699,10,Y,Y,1437471397525,350644,351290
MASONB.txt,65376,66786,1410,10,Y,Y,1437471397525,350644,351290
MASONB.txt,65588,67004,1416,10,Y,Y,1437471397525,350644,351290
MASONB.txt,65922,67075,1153,10,N,N,-,-1,-1
MASONB.txt,65926,67358,1432,10,N,N,-,-1,-1
MASONB.txt,66049,67375,1326,10,N,N,-,-1,-1
MASONB.txt,66256,67499,1243,10,N,N,-,-1,-1
MASONB.txt,66350,67529,1179,10,N,N,-,-1,-1
MASONB.txt,66463,67689,1226,10,N,Y,1448285913012,108803,110925
MASONB.txt,66617,67762,1145,10,N,Y,1448285913012,108803,110925
MASONB.txt,66674,67867,1193,10,N,Y,1448285913012,108803,110925
MASONB.txt,66787,68014,1227,10,N,Y,1448285913012,108803,110925
MASONB.txt,67005,68152,1147,10,N,Y,1448285913012,108803,110925
MASONB.txt,67076,68328,1252,10,N,Y,1448285913012,108803,110925
MASONB.txt,67363,68401,1038,10,N,Y,1448285913012,108803,110925
MASONB.txt,67380,68553,1173,10,N,Y,1448285913012,108803,110925
MASONB.txt,67502,68672,1170,10,N,Y,1448285913012,108803,110925
MASONB.txt,67532,68680,1148,10,N,Y,1448285913012,108803,110925
MASONB.txt,67690,68689,999,10,N,Y,1448285913012,108803,110925
MASONB.txt,67763,68729,966,10,N,Y,1448285913012,108803,110925
MASONB.txt,67868,68926,1058,10,N,Y,1448285913012,108803,110925
MASONB.txt,68016,69044,1028,10,N,Y,1448285913012,108803,110925
MASONB.txt,68153,69167,1014,10,Y,Y,1448285913012,108803,110925
MASONB.txt,68331,69172,841,10,Y,Y,1448285913012,108803,110925
MASONB.txt,68402,69354,952,10,Y,Y,1448285913012,108803,110925
MASONB.txt,68554,69523,969,10,N,Y,1448285913012,108803,110925
MASONB.txt,68673,69531,858,10,N,Y,1448285913012,108803,110925
MASONB.txt,68682,69623,941,10,Y,Y,1448285913012,108803,110925
MASONB.txt,68690,69754,1064,10,Y,Y,1448285913012,108803,110925
MASONB.txt,68730,69998,1268,10,Y,Y,1448285913012,108803,110925
MASONB.txt,68929,70005,1076,10,N,Y,1448285913012,108803,110925
MASONB.txt,69046,70146,1100,10,N,Y,1437477480340,424837,425856
MASONB.txt,69168,70193,1025,10,N,Y,1437477480340,424837,425856
MASONB.txt,69174,70260,1086,10,N,Y,1437477480340,424837,425856
MASONB.txt,69357,70471,1114,10,N,Y,1437477480340,424837,425856
MASONB.txt,69524,70576,1052,10,N,Y,1437477480340,424837,425856
MASONB.txt,69532,70696,1164,10,Y,Y,1437477480340,424837,425856
MASONB.txt,69624,70770,1146,10,Y,Y,1437477480340,424837,425856
MASONB.txt,69755,71045,1290,10,Y,Y,1437477480340,424837,425856
MASONB.txt,70001,71180,1179,10,Y,Y,1437477480340,424837,425856
MASONB.txt,70006,71231,1225,10,Y,Y,1437477480340,424837,425856
MASONB.txt,70147,71344,1197,10,Y,Y,1437477480340,424837,425856
MASONB.txt,70194,71351,1157,10,Y,Y,1437477480340,424837,425856
MASONB.txt,70262,71513,1251,10,Y,Y,1437477480340,424837,425856
MASONB.txt,70472,71668,1196,10,N,Y,1437477480340,424837,425856
MASONB.txt,70579,71678,1099,10,N,Y,1437477480340,424837,425856
MASONB.txt,70697,71727,1030,10,Y,Y,1437477480340,424837,425856
MASONB.txt,70771,71877,1106,10,Y,Y,1437477480340,424837,425856
MASONB.txt,71046,71895,849,10,Y,Y,1437477480340,424837,425856
MASONB.txt,71183,72042,859,10,Y,Y,1437477480340,424837,425856
MASONB.txt,71232,72103,871,10,Y,Y,1437477480340,424837,425856
MASONB.txt,71347,72266,919,10,Y,Y,1437477480340,424837,425856
MASONB.txt,71352,72281,929,10,Y,Y,1437477480340,424837,425856
MASONB.txt,71516,72288,772,10,Y,Y,1437476486340,221621,222520
MASONB.txt,71669,72370,701,10,Y,Y,1437476486340,221621,222520
MASONB.txt,71679,72399,720,10,Y,Y,1437476486340,221621,222520
MASONB.txt,71728,72551,823,10,N,Y,1437477878183,427206,428439
MASONB.txt,71878,72912,1034,10,N,Y,1437477878183,427206,428439
MASONB.txt,71896,73140,1244,10,N,Y,1437477878183,427206,428439
MASONB.txt,72043,73337,1294,10,N,Y,1437477878183,427206,428439
MASONB.txt,72106,73507,1401,10,N,Y,1437477878183,427206,428439
MASONB.txt,72271,73688,1417,10,N,Y,1437477878183,427206,428439
MASONB.txt,72284,73805,1521,10,N,Y,1437477878183,427206,428439
MASONB.txt,72289,73970,1681,10,N,Y,1437477878183,427206,428439
MASONB.txt,72373,74316,1943,10,N,Y,1437477878183,427206,428439
MASONB.txt,72402,74535,2133,10,N,Y,1437477878183,427206,428439
MASONB.txt,72552,74757,2205,10,N,Y,1437477878183,427206,428439
MASONB.txt,72913,74961,2048,10,N,N,-,-1,-1
MASONB.txt,73141,75219,2078,10,N,N,-,-1,-1
MASONB.txt,73340,75458,2118,10,N,N,-,-1,-1
MASONB.txt,73508,75564,2056,10,N,N,-,-1,-1
MASONB.txt,73689,75575,1886,10,N,N,-,-1,-1
MASONB.txt,73806,75741,1935,10,N,N,-,-1,-1
MASONB.txt,73973,76373,2400,10,N,N,-,-1,-1
MASONB.txt,74317,76610,2293,10,N,N,-,-1,-1
MASONB.txt,74538,76923,2385,10,N,N,-,-1,-1
MASONB.txt,74758,77045,2287,10,N,N,-,-1,-1
MASONB.txt,74962,77377,2415,10,N,N,-,-1,-1
MASONB.txt,75220,77514,2294,10,N,N,-,-1,-1
MASONB.txt,75459,77575,2116,10,N,N,-,-1,-1
MASONB.txt,75565,77685,2120,10,N,N,-,-1,-1
MASONB.txt,75576,77701,2125,10,N,N,-,-1,-1
MASONB.txt,75742,77964,2222,10,N,N,-,-1,-1
MASONB.txt,76373,78545,2172,10,Y,N,-,-1,-1
MASONB.txt,76611,78668,2057,10,N,N,-,-1,-1
MASONB.txt,76924,78798,1874,10,Y,N,-,-1,-1
MASONB.txt,77046,78854,1808,10,Y,N,-,-1,-1
MASONB.txt,77378,79067,1689,10,Y,N,-,-1,-1
MASONB.txt,77515,79176,1661,10,Y,N,-,-1,-1
MASONB.txt,77576,79232,1656,10,Y,N,-,-1,-1
MASONB.txt,77690,79395,1705,10,Y,N,-,-1,-1
MASONB.txt,77702,79668,1966,10,Y,N,-,-1,-1
MASONB.txt,77965,79687,1722,10,Y,N,-,-1,-1
MASONB.txt,78546,80274,1728,10,N,N,-,-1,-1
MASONB.txt,78669,80432,1763,10,N,N,-,-1,-1
MASONB.txt,78799,80647,1848,10,N,N,-,-1,-1
MASONB.txt,78855,80791,1936,10,N,N,-,-1,-1
MASONB.txt,79068,80912,1844,10,N,N,-,-1,-1
MASONB.txt,79177,81327,2150,10,N,N,-,-1,-1
MASONB.txt,79233,81645,2412,10,N,N,-,-1,-1
MASONB.txt,79396,81693,2297,10,N,N,-,-1,-1
MASONB.txt,79671,82187,2516,10,N,N,-,-1,-1
MASONB.txt,79688,82312,2624,10,N,N,-,-1,-1
MASONB.txt,80275,82503,2228,10,N,N,-,-1,-1
MASONB.txt,80435,82508,2073,10,N,N,-,-1,-1
MASONB.txt,80648,82655,2007,10,N,N,-,-1,-1
MASONB.txt,80792,82823,2031,10,N,N,-,-1,-1
MASONB.txt,80913,83229,2316,10,N,N,-,-1,-1
MASONB.txt,81328,83234,1906,10,N,N,-,-1,-1
MASONB.txt,81646,83312,1666,10,N,N,-,-1,-1
MASONB.txt,81694,83513,1819,10,N,N,-,-1,-1
MASONB.txt,82188,83518,1330,10,N,N,-,-1,-1
MASONB.txt,82313,83582,1269,10,N,N,-,-1,-1
MASONB.txt,82504,83633,1129,10,N,N,-,-1,-1
MASONB.txt,82509,83705,1196,10,N,N,-,-1,-1
MASONB.txt,82656,83765,1109,10,N,N,-,-1,-1
MASONB.txt,82824,83856,1032,10,N,N,-,-1,-1
MASONB.txt,83230,83881,651,10,N,N,-,-1,-1
MASONB.txt,83236,83940,704,10,N,N,-,-1,-1
MASONB.txt,83313,84045,732,10,N,N,-,-1,-1
MASONB.txt,83514,84246,732,10,N,Y,1448274893770,25386,26202
MASONB.txt,83519,84565,1046,10,N,Y,1448274893770,25386,26202
MASONB.txt,83583,84714,1131,10,N,Y,1448274893770,25386,26202
MASONB.txt,83634,84831,1197,10,N,Y,1448274893770,25386,26202
MASONB.txt,83708,84948,1240,10,N,Y,1448274893770,25386,26202
MASONB.txt,83766,84985,1219,10,N,Y,1448274893770,25386,26202
MASONB.txt,83859,84992,1133,10,N,Y,1448274893770,25386,26202
MASONB.txt,83882,85118,1236,10,N,Y,1448274893770,25386,26202
MASONB.txt,83943,85312,1369,10,N,Y,1448274893770,25386,26202
MASONB.txt,84048,85469,1421,10,N,Y,1448274893770,25386,26202
MASONB.txt,84247,85581,1334,10,N,Y,1448274893770,25386,26202
MASONB.txt,84566,85690,1124,10,N,Y,1448274893770,25386,26202
MASONB.txt,84715,85846,1131,10,N,Y,1448275407308,26987,29181
MASONB.txt,84832,85854,1022,10,N,Y,1448275407308,26987,29181
MASONB.txt,84949,86154,1205,10,N,Y,1448275407308,26987,29181
MASONB.txt,84988,86163,1175,10,N,Y,1448275407308,26987,29181
MASONB.txt,84993,86277,1284,10,N,Y,1448275407308,26987,29181
MASONB.txt,85119,86303,1184,10,N,Y,1448275407308,26987,29181
MASONB.txt,85313,86398,1085,10,N,Y,1448275407308,26987,29181
MASONB.txt,85470,86446,976,10,N,Y,1448275407308,26987,29181
MASONB.txt,85582,86497,915,10,N,Y,1448275407308,26987,29181
MASONB.txt,85691,86706,1015,10,N,Y,1448275407308,26987,29181
MASONB.txt,85847,86829,982,10,N,Y,1448275407308,26987,29181
MASONB.txt,85855,86972,1117,10,N,Y,1448275407308,26987,29181
MASONB.txt,86156,87088,932,10,N,N,-,-1,-1
MASONB.txt,86168,87274,1106,10,N,N,-,-1,-1
MASONB.txt,86280,87297,1017,10,N,N,-,-1,-1
MASONB.txt,86306,87399,1093,10,N,N,-,-1,-1
MASONB.txt,86399,87443,1044,10,N,N,-,-1,-1
MASONB.txt,86447,87563,1116,10,N,Y,1448275023016,26258,26837
MASONB.txt,86499,87641,1142,10,N,Y,1448275023016,26258,26837
MASONB.txt,86707,87761,1054,10,N,Y,1448275023016,26258,26837
MASONB.txt,86830,87906,1076,10,N,Y,1448275023016,26258,26837
MASONB.txt,86973,88133,1160,10,N,Y,1448275023016,26258,26837
MASONB.txt,87089,88328,1239,10,N,Y,1448275023016,26258,26837
MASONB.txt,87279,88508,1229,10,N,Y,1448281320115,89144,91129
MASONB.txt,87300,88602,1302,10,N,Y,1448281320115,89144,91129
MASONB.txt,87400,88661,1261,10,N,Y,1448281320115,89144,91129
MASONB.txt,87444,88832,1388,10,N,Y,1448281320115,89144,91129
MASONB.txt,87564,88954,1390,10,N,Y,1448281320115,89144,91129
MASONB.txt,87642,89108,1466,10,N,Y,1448281320115,89144,91129
MASONB.txt,87762,89301,1539,10,N,Y,1437490253936,460795,462238
MASONB.txt,87907,89341,1434,10,N,Y,1437490253936,460795,462238
MASONB.txt,88134,89527,1393,10,N,Y,1437490253936,460795,462238
MASONB.txt,88329,89579,1250,10,N,Y,1437490253936,460795,462238
MASONB.txt,88509,89637,1128,10,N,Y,1437490253936,460795,462238
MASONB.txt,88603,89790,1187,10,N,Y,1437490253936,460795,462238
MASONB.txt,88662,89850,1188,10,N,Y,1437490253936,460795,462238
MASONB.txt,88833,89855,1022,10,N,Y,1437490253936,460795,462238
MASONB.txt,88955,89872,917,10,N,Y,1437490253936,460795,462238
MASONB.txt,89109,89877,768,10,N,Y,1437490253936,460795,462238
MASONB.txt,89302,89917,615,10,N,Y,1437490253936,460795,462238
MASONB.txt,89342,89932,590,10,N,Y,1437490253936,460795,462238
MASONB.txt,89529,89949,420,10,N,Y,1437490253936,460795,462238
MASONB.txt,89580,89978,398,10,N,Y,1437490253936,460795,462238
MASONB.txt,89638,89996,358,10,N,Y,1437490253936,460795,462238
MASONB.txt,89791,90012,221,10,N,Y,1437490253936,460795,462238
MASONB.txt,89853,90029,176,10,N,Y,1437490253936,460795,462238
MASONB.txt,89856,90052,196,10,N,Y,1437490253936,460795,462238
MASONB.txt,89875,90070,195,10,N,Y,1437490253936,460795,462238
MASONB.txt,89878,90089,211,10,N,Y,1437490253936,460795,462238
MASONB.txt,89918,90115,197,10,N,Y,1437490253936,460795,462238
MASONB.txt,89933,90366,433,10,N,Y,1437490253936,460795,462238
MASONB.txt,89950,90468,518,10,N,Y,1437490253936,460795,462238
MASONB.txt,89979,90554,575,10,N,Y,1437490253936,460795,462238
MASONB.txt,89997,90598,601,10,N,Y,1437490253936,460795,462238
MASONB.txt,90013,90627,614,10,N,Y,1437490253936,460795,462238
MASONB.txt,90030,90786,756,10,N,Y,1437490253936,460795,462238
MASONB.txt,90053,90911,858,10,N,Y,1437490253936,460795,462238
MASONB.txt,90071,90952,881,10,N,Y,1437490253936,460795,462238
MASONB.txt,90090,91128,1038,10,N,Y,1437490253936,460795,462238
MASONB.txt,90116,91264,1148,10,N,Y,1437490253936,460795,462238
MASONB.txt,90367,91304,937,10,N,Y,1437490253936,460795,462238
MASONB.txt,90469,91420,951,10,N,Y,1437490253936,460795,462238
MASONB.txt,90555,91787,1232,10,N,Y,1437490253936,460795,462238
MASONB.txt,90599,91953,1354,10,N,Y,1437490253936,460795,462238
MASONB.txt,90629,92020,1391,10,N,Y,1437490253936,460795,462238
MASONB.txt,90789,92230,1441,10,N,Y,1437490253936,460795,462238
MASONB.txt,90913,92554,1641,10,N,Y,1437490253936,460795,462238
MASONB.txt,90953,92664,1711,10,N,Y,1437490253936,460795,462238
MASONB.txt,91131,92669,1538,10,N,N,-,-1,-1
MASONB.txt,91265,92750,1485,10,N,N,-,-1,-1
MASONB.txt,91305,93062,1757,10,N,N,-,-1,-1
MASONB.txt,91421,93170,1749,10,N,N,-,-1,-1
MASONB.txt,91788,93218,1430,10,N,N,-,-1,-1
MASONB.txt,91954,93381,1427,10,N,N,-,-1,-1
MASONB.txt,92021,93568,1547,10,N,N,-,-1,-1
MASONB.txt,92231,93745,1514,10,N,N,-,-1,-1
MASONB.txt,92555,94343,1788,10,N,N,-,-1,-1
MASONB.txt,92667,94459,1792,10,N,N,-,-1,-1
MASONB.txt,92670,94464,1794,10,N,N,-,-1,-1
MASONB.txt,92751,94664,1913,10,N,N,-,-1,-1
MASONB.txt,93063,94797,1734,10,N,N,-,-1,-1
MASONB.txt,93171,94986,1815,10,N,N,-,-1,-1
MASONB.txt,93219,95062,1843,10,N,N,-,-1,-1
MASONB.txt,93382,95067,1685,10,N,N,-,-1,-1
MASONB.txt,93569,95163,1594,10,N,N,-,-1,-1
MASONB.txt,93746,95643,1897,10,N,N,-,-1,-1
MASONB.txt,94344,95974,1630,10,N,N,-,-1,-1
MASONB.txt,94462,96337,1875,10,N,N,-,-1,-1
MASONB.txt,94465,96683,2218,10,N,N,-,-1,-1
MASONB.txt,94665,96784,2119,10,N,N,-,-1,-1
MASONB.txt,94800,96933,2133,10,N,N,-,-1,-1
MASONB.txt,94987,97180,2193,10,N,N,-,-1,-1
MASONB.txt,95065,97298,2233,10,N,N,-,-1,-1
MASONB.txt,95068,97324,2256,10,N,N,-,-1,-1
MASONB.txt,95164,97642,2478,10,N,N,-,-1,-1
MASONB.txt,95644,97657,2013,10,N,N,-,-1,-1
MASONB.txt,95975,97749,1774,10,N,N,-,-1,-1
MASONB.txt,96338,97775,1437,10,N,N,-,-1,-1
MASONB.txt,96684,97777,1093,10,N,N,-,-1,-1
MASONB.txt,96785,97861,1076,10,N,Y,1448038101349,15101,17486
MASONB.txt,96936,98184,1248,10,N,Y,1448038101349,15101,17486
MASONB.txt,97181,98313,1132,10,N,Y,1448038101349,15101,17486
MASONB.txt,97301,98364,1063,10,Y,Y,1448038101349,15101,17486
MASONB.txt,97325,98548,1223,10,Y,Y,1448038101349,15101,17486
MASONB.txt,97647,98823,1176,10,Y,Y,1448038101349,15101,17486
MASONB.txt,97662,98867,1205,10,Y,Y,1448038101349,15101,17486
MASONB.txt,97752,98914,1162,10,N,Y,1437475017618,98942,100041
MASONB.txt,97775,99087,1312,10,Y,Y,1437475017618,98942,100041
MASONB.txt,97780,99216,1436,10,Y,Y,1437475017618,98942,100041
MASONB.txt,97862,99411,1549,10,Y,Y,1437475017618,98942,100041
MASONB.txt,98185,99641,1456,10,Y,Y,1437475017618,98942,100041
MASONB.txt,98314,99774,1460,10,Y,Y,1437475017618,98942,100041
MASONB.txt,98367,100014,1647,10,Y,Y,1437475017618,98942,100041
MASONB.txt,98549,100128,1579,10,Y,Y,1437475017618,98942,100041
MASONB.txt,98824,100270,1446,10,N,Y,1437475017618,98942,100041
MASONB.txt,98870,100396,1526,10,N,Y,1437475017618,98942,100041
MASONB.txt,98915,100525,1610,10,N,Y,1437475017618,98942,100041
MASONB.txt,99088,100694,1606,10,Y,Y,1437475017618,98942,100041
MASONB.txt,99217,100867,1650,10,Y,Y,1437475017618,98942,100041
MASONB.txt,99412,101111,1699,10,Y,Y,1437475017618,98942,100041
MASONB.txt,99642,101395,1753,10,Y,Y,1437475017618,98942,100041
MASONB.txt,99775,101545,1770,10,Y,Y,1437475017618,98942,100041
MASONB.txt,100017,101676,1659,10,N,Y,1437475017618,98942,100041
MASONB.txt,100129,101844,1715,10,N,Y,1437475017618,98942,100041
MASONB.txt,100271,101927,1656,10,N,Y,1437475017618,98942,100041
MASONB.txt,100397,102008,1611,10,N,Y,1437475017618,98942,100041
MASONB.txt,100527,102096,1569,10,N,Y,1437475017618,98942,100041
MASONB.txt,100695,102288,1593,10,N,Y,1437475017618,98942,100041
MASONB.txt,100868,102404,1536,10,N,Y,1437475017618,98942,100041
MASONB.txt,101112,102421,1309,10,N,Y,1437475017618,98942,100041
MASONB.txt,101396,102437,1041,10,N,Y,1437475017618,98942,100041
MASONB.txt,101548,102521,973,10,N,Y,1437475017618,98942,100041
MASONB.txt,101677,102548,871,10,N,Y,1437475017618,98942,100041
MASONB.txt,101847,102636,789,10,N,Y,1437475017618,98942,100041
MASONB.txt,101930,102706,776,10,N,Y,1437475017618,98942,100041
MASONB.txt,102008,102773,765,10,N,Y,1437475017618,98942,100041
MASONB.txt,102097,102930,833,10,N,Y,1437475017618,98942,100041
MASONB.txt,102289,103022,733,10,N,Y,1437475017618,98942,100041
MASONB.txt,102409,103234,825,10,N,Y,1448279813455,71525,72226
MASONB.txt,102426,103286,860,10,N,Y,1448279813455,71525,72226
MASONB.txt,102440,103405,965,10,N,Y,1448279813455,71525,72226
MASONB.txt,102524,103519,995,10,N,Y,1448279813455,71525,72226
MASONB.txt,102551,103782,1231,10,N,Y,1448279813455,71525,72226
MASONB.txt,102637,103969,1332,10,N,Y,1448279813455,71525,72226
MASONB.txt,102707,104191,1484,10,N,Y,1448279813455,71525,72226
MASONB.txt,102774,104231,1457,10,N,Y,1448279813455,71525,72226
MASONB.txt,102931,104355,1424,10,N,Y,1448279813455,71525,72226
MASONB.txt,103024,104626,1602,10,N,Y,1448279813455,71525,72226
MASONB.txt,103235,104687,1452,10,N,Y,1448279813455,71525,72226
MASONB.txt,103287,104868,1581,10,N,Y,1448279813455,71525,72226
MASONB.txt,103408,104933,1525,10,N,Y,1448279813455,71525,72226
MASONB.txt,103520,105342,1822,10,N,Y,1448279813455,71525,72226
MASONB.txt,103784,105440,1656,10,N,Y,1448279813455,71525,72226
MASONB.txt,103972,105689,1717,10,N,Y,1448279813455,71525,72226
MASONB.txt,104192,105866,1674,10,N,Y,1448279813455,71525,72226
MASONB.txt,104232,105910,1678,10,N,Y,1448279813455,71525,72226
MASONB.txt,104356,106112,1756,10,N,Y,1448279813455,71525,72226
MASONB.txt,104627,106188,1561,10,N,Y,1448279813455,71525,72226
MASONB.txt,104688,106628,1940,10,N,Y,1448279813455,71525,72226
MASONB.txt,104869,106771,1902,10,Y,Y,1448279813455,71525,72226
MASONB.txt,104934,106862,1928,10,Y,Y,1448279813455,71525,72226
MASONB.txt,105343,106867,1524,10,Y,Y,1448279813455,71525,72226
MASONB.txt,105442,106992,1550,10,Y,Y,1448279813455,71525,72226
MASONB.txt,105691,107181,1490,10,N,Y,1448279813455,71525,72226
MASONB.txt,105867,107271,1404,10,N,Y,1448279813455,71525,72226
MASONB.txt,105911,107421,1510,10,N,Y,1448279813455,71525,72226
MASONB.txt,106115,107642,1527,10,N,Y,1448279813455,71525,72226
MASONB.txt,106191,107739,1548,10,N,Y,1448279813455,71525,72226
MASONB.txt,106629,107905,1276,10,N,Y,1448279813455,71525,72226
MASONB.txt,106772,107939,1167,10,N,Y,1448279813455,71525,72226
MASONB.txt,106863,108215,1352,10,Y,Y,1448279813455,71525,72226
MASONB.txt,106868,108276,1408,10,Y,Y,1448279813455,71525,72226
MASONB.txt,106993,108422,1429,10,Y,Y,1448279813455,71525,72226
MASONB.txt,107182,108574,1392,10,Y,Y,1448279813455,71525,72226
MASONB.txt,107273,108580,1307,10,Y,Y,1448279813455,71525,72226
MASONB.txt,107424,108642,1218,10,Y,Y,1448279813455,71525,72226
MASONB.txt,107643,108659,1016,10,Y,Y,1448279813455,71525,72226
MASONB.txt,107741,108753,1012,10,Y,Y,1448279813455,71525,72226
MASONB.txt,107906,108780,874,10,N,Y,1448279813455,71525,72226
MASONB.txt,107940,108840,900,10,N,Y,1448039370049,20775,21297
MASONB.txt,108216,109081,865,10,N,Y,1448039370049,20775,21297
MASONB.txt,108277,109245,968,10,N,Y,1448039370049,20775,21297
MASONB.txt,108423,109308,885,10,N,Y,1448039370049,20775,21297
MASONB.txt,108575,109363,788,10,N,Y,1448039370049,20775,21297
MASONB.txt,108581,109464,883,10,N,Y,1448039370049,20775,21297
MASONB.txt,108647,109569,922,10,N,Y,1448039370049,20775,21297
MASONB.txt,108664,109698,1034,10,N,Y,1448039370049,20775,21297
MASONB.txt,108756,109825,1069,10,N,Y,1448039370049,20775,21297
MASONB.txt,108783,109886,1103,10,N,Y,1448039370049,20775,21297
MASONB.txt,108842,110013,1171,10,N,Y,1448039370049,20775,21297
MASONB.txt,109082,110144,1062,10,N,Y,1448039370049,20775,21297
MASONB.txt,109246,110273,1027,10,N,Y,1448039370049,20775,21297
MASONB.txt,109311,110419,1108,10,N,Y,1448039370049,20775,21297
MASONB.txt,109365,110568,1203,10,N,Y,1448039370049,20775,21297
MASONB.txt,109467,110772,1305,10,Y,Y,1448039370049,20775,21297
MASONB.txt,109570,111007,1437,10,Y,Y,1448039370049,20775,21297
MASONB.txt,109699,111186,1487,10,Y,Y,1448039370049,20775,21297
MASONB.txt,109828,111245,1417,10,Y,Y,1448039370049,20775,21297
MASONB.txt,109888,111280,1392,10,Y,Y,1448039370049,20775,21297
MASONB.txt,110015,111285,1270,10,Y,Y,1448039370049,20775,21297
MASONB.txt,110147,111385,1238,10,Y,Y,1448039370049,20775,21297
MASONB.txt,110274,111389,1115,10,Y,Y,1448039370049,20775,21297
MASONB.txt,110420,111431,1011,10,N,Y,1448039370049,20775,21297
MASONB.txt,110569,111435,866,10,N,Y,1448039370049,20775,21297
MASONB.txt,110773,111479,706,10,N,Y,1448039370049,20775,21297
MASONB.txt,111010,111484,474,10,N,Y,1448311594480,155711,156312
MASONB.txt,111187,111575,388,10,N,Y,1448311594480,155711,156312
MASONB.txt,111246,111691,445,10,N,Y,1448311594480,155711,156312
MASONB.txt,111281,111735,454,10,N,Y,1448311594480,155711,156312
MASONB.txt,111286,111908,622,10,N,Y,1448311594480,155711,156312
MASONB.txt,111386,112010,624,10,N,Y,1448311594480,155711,156312
MASONB.txt,111390,112133,743,10,N,Y,1448311594480,155711,156312
MASONB.txt,111432,112276,844,10,N,Y,1448311594480,155711,156312
MASONB.txt,111437,112467,1030,10,N,Y,1448311594480,155711,156312
MASONB.txt,111480,112629,1149,10,Y,Y,1448311594480,155711,156312
MASONB.txt,111485,112773,1288,10,Y,Y,1448311594480,155711,156312
MASONB.txt,111578,112848,1270,10,Y,Y,1448311594480,155711,156312
MASONB.txt,111692,113149,1457,10,Y,Y,1448311594480,155711,156312
MASONB.txt,111736,113233,1497,10,Y,Y,1448311594480,155711,156312
MASONB.txt,111909,113290,1381,10,Y,Y,1448311594480,155711,156312
MASONB.txt,112011,113472,1461,10,Y,Y,1448311594480,155711,156312
MASONB.txt,112136,113573,1437,10,Y,Y,1448312844411,173573,174472
MASONB.txt,112277,113647,1370,10,Y,Y,1448312844411,173573,174472
MASONB.txt,112468,113701,1233,10,Y,Y,1448312844411,173573,174472
MASONB.txt,112632,113881,1249,10,N,Y,1448312844411,173573,174472
MASONB.txt,112774,113897,1123,10,N,Y,1448312844411,173573,174472
MASONB.txt,112849,114009,1160,10,N,Y,1448312844411,173573,174472
MASONB.txt,113150,114038,888,10,N,Y,1448312844411,173573,174472
MASONB.txt,113234,114447,1213,10,N,Y,1448312844411,173573,174472
MASONB.txt,113293,114561,1268,10,N,Y,1448323072174,227638,227786
MASONB.txt,113473,114726,1253,10,N,Y,1448281071558,89330,89524
MASONB.txt,113576,114947,1371,10,N,Y,1448281071558,89330,89524
MASONB.txt,113648,115072,1424,10,N,Y,1448281071558,89330,89524
MASONB.txt,113703,115173,1470,10,N,Y,1448281071558,89330,89524
MASONB.txt,113886,115302,1416,10,N,Y,1448281071558,89330,89524
MASONB.txt,113900,115383,1483,10,N,Y,1448281071558,89330,89524
MASONB.txt,114010,115525,1515,10,N,Y,1448281071558,89330,89524
MASONB.txt,114041,115648,1607,10,N,Y,1448281071558,89330,89524
MASONB.txt,114448,115709,1261,10,N,Y,1448281071558,89330,89524
MASONB.txt,114564,115840,1276,10,N,Y,1448281071558,89330,89524
MASONB.txt,114727,115948,1221,10,N,Y,1448281071558,89330,89524
MASONB.txt,114949,116010,1061,10,N,Y,1448281071558,89330,89524
MASONB.txt,115073,116209,1136,10,N,Y,1448281071558,89330,89524
MASONB.txt,115174,116250,1076,10,N,Y,1448281071558,89330,89524
MASONB.txt,115303,116370,1067,10,N,Y,1448281071558,89330,89524
MASONB.txt,115386,116585,1199,10,N,Y,1448281071558,89330,89524
MASONB.txt,115526,116800,1274,10,N,Y,1448281071558,89330,89524
MASONB.txt,115649,117000,1351,10,N,Y,1448281071558,89330,89524
MASONB.txt,115710,117113,1403,10,Y,Y,1448281071558,89330,89524
MASONB.txt,115841,117138,1297,10,Y,Y,1448281071558,89330,89524
MASONB.txt,115949,117245,1296,10,Y,Y,1448281071558,89330,89524
MASONB.txt,116011,117413,1402,10,Y,Y,1448281071558,89330,89524
MASONB.txt,116210,117501,1291,10,Y,Y,1448281071558,89330,89524
MASONB.txt,116252,117664,1412,10,Y,Y,1448281071558,89330,89524
MASONB.txt,116371,117884,1513,10,Y,Y,1448281071558,89330,89524
MASONB.txt,116586,118049,1463,10,Y,Y,1448281071558,89330,89524
MASONB.txt,116801,118130,1329,10,Y,Y,1448281071558,89330,89524
MASONB.txt,117002,118218,1216,10,Y,Y,1448281071558,89330,89524
MASONB.txt,117114,118257,1143,10,Y,Y,1448281071558,89330,89524
MASONB.txt,117141,118372,1231,10,Y,Y,1448281071558,89330,89524
MASONB.txt,117246,118490,1244,10,Y,Y,1448281071558,89330,89524
MASONB.txt,117414,118602,1188,10,Y,Y,1448281071558,89330,89524
MASONB.txt,117502,119011,1509,10,Y,Y,1448281071558,89330,89524
MASONB.txt,117665,119157,1492,10,Y,Y,1448281071558,89330,89524
MASONB.txt,117885,119214,1329,10,Y,Y,1448281071558,89330,89524
MASONB.txt,118050,119314,1264,10,Y,Y,1448281071558,89330,89524
MASONB.txt,118131,119461,1330,10,Y,Y,1448281071558,89330,89524
MASONB.txt,118219,119906,1687,10,Y,Y,1448281071558,89330,89524
MASONB.txt,118258,120107,1849,10,Y,Y,1448281071558,89330,89524
MASONB.txt,118373,120140,1767,10,N,Y,1448281071558,89330,89524
MASONB.txt,118491,120322,1831,10,N,Y,1448281071558,89330,89524
MASONB.txt,118603,120672,2069,10,N,Y,1448281071558,89330,89524
MASONB.txt,119012,120808,1796,10,N,Y,1448281071558,89330,89524
MASONB.txt,119158,120909,1751,10,N,Y,1448281071558,89330,89524
MASONB.txt,119215,121014,1799,10,N,Y,1448281071558,89330,89524
MASONB.txt,119315,121135,1820,10,N,Y,1448281071558,89330,89524
MASONB.txt,119462,121195,1733,10,N,Y,1448281071558,89330,89524
MASONB.txt,119907,121322,1415,10,N,Y,1448281071558,89330,89524
MASONB.txt,120108,121388,1280,10,N,Y,1448281071558,89330,89524
MASONB.txt,120141,121414,1273,10,N,Y,1448281071558,89330,89524
MASONB.txt,120325,121561,1236,10,N,Y,1448311366799,143137,146264
MASONB.txt,120675,121960,1285,10,N,Y,1448311366799,143137,146264
MASONB.txt,120809,122006,1197,10,N,Y,1448311366799,143137,146264
MASONB.txt,120910,122254,1344,10,N,Y,1448311366799,143137,146264
MASONB.txt,121015,122418,1403,10,N,Y,1448311366799,143137,146264
MASONB.txt,121138,122591,1453,10,N,Y,1448311366799,143137,146264
MASONB.txt,121196,122808,1612,10,N,Y,1448311366799,143137,146264
MASONB.txt,121323,122888,1565,10,N,Y,1448311366799,143137,146264
MASONB.txt,121390,123127,1737,10,N,Y,1448311366799,143137,146264
MASONB.txt,121415,123165,1750,10,N,Y,1448311366799,143137,146264
MASONB.txt,121562,123308,1746,10,N,Y,1448311366799,143137,146264
MASONB.txt,121961,123440,1479,10,N,Y,1448311366799,143137,146264
MASONB.txt,122007,123455,1448,10,N,Y,1448311366799,143137,146264
MASONB.txt,122255,123507,1252,10,N,Y,1448311366799,143137,146264
MASONB.txt,122419,123534,1115,10,N,Y,1448311366799,143137,146264
MASONB.txt,122592,123778,1186,10,N,Y,1448311366799,143137,146264
MASONB.txt,122809,123896,1087,10,N,Y,1448311366799,143137,146264
MASONB.txt,122889,124218,1329,10,N,Y,1448311366799,143137,146264
MASONB.txt,123132,124305,1173,10,N,Y,1448311366799,143137,146264
MASONB.txt,123166,124451,1285,10,N,Y,1448311366799,143137,146264
MASONB.txt,123309,124628,1319,10,N,Y,1448311366799,143137,146264
MASONB.txt,123445,124832,1387,10,N,N,-,-1,-1
MASONB.txt,123460,124857,1397,10,N,N,-,-1,-1
MASONB.txt,123510,125307,1797,10,N,N,-,-1,-1
MASONB.txt,123537,125393,1856,10,N,N,-,-1,-1
MASONB.txt,123779,125421,1642,10,N,N,-,-1,-1
MASONB.txt,123897,125598,1701,10,N,N,-,-1,-1
MASONB.txt,124219,125758,1539,10,N,N,-,-1,-1
MASONB.txt,124306,126128,1822,10,N,N,-,-1,-1
MASONB.txt,124452,126272,1820,10,N,N,-,-1,-1
MASONB.txt,124629,126301,1672,10,N,N,-,-1,-1
MASONB.txt,124835,126475,1640,10,N,N,-,-1,-1
MASONB.txt,124858,126551,1693,10,N,N,-,-1,-1
MASONB.txt,125310,126700,1390,10,N,N,-,-1,-1
MASONB.txt,125394,126729,1335,10,N,N,-,-1,-1
MASONB.txt,125422,127425,2003,10,N,N,-,-1,-1
MASONB.txt,125599,127468,1869,10,N,N,-,-1,-1
MASONB.txt,125759,127556,1797,10,N,N,-,-1,-1
MASONB.txt,126129,127674,1545,10,N,N,-,-1,-1
MASONB.txt,126273,127762,1489,10,N,N,-,-1,-1
MASONB.txt,126302,127982,1680,10,N,N,-,-1,-1
MASONB.txt,126476,128137,1661,10,N,N,-,-1,-1
MASONB.txt,126552,128264,1712,10,N,N,-,-1,-1
MASONB.txt,126708,128382,1674,10,N,N,-,-1,-1
MASONB.txt,126730,128470,1740,10,N,N,-,-1,-1
MASONB.txt,127426,128565,1139,10,N,N,-,-1,-1
MASONB.txt,127469,128712,1243,10,N,N,-,-1,-1
MASONB.txt,127557,128748,1191,10,N,N,-,-1,-1
MASONB.txt,127677,128781,1104,10,N,N,-,-1,-1
MASONB.txt,127763,128964,1201,10,N,N,-,-1,-1
MASONB.txt,127983,129153,1170,10,N,N,-,-1,-1
MASONB.txt,128138,129345,1207,10,N,N,-,-1,-1
MASONB.txt,128265,129419,1154,10,N,N,-,-1,-1
MASONB.txt,128383,129468,1085,10,N,N,-,-1,-1
MASONB.txt,128471,129612,1141,10,N,N,-,-1,-1
MASONB.txt,128566,129775,1209,10,N,N,-,-1,-1
MASONB.txt,128713,130001,1288,10,Y,N,-,-1,-1
MASONB.txt,128751,130149,1398,10,Y,N,-,-1,-1
MASONB.txt,128784,130301,1517,10,Y,N,-,-1,-1
MASONB.txt,128965,130464,1499,10,Y,N,-,-1,-1
MASONB.txt,129154,130523,1369,10,Y,N,-,-1,-1
MASONB.txt,129347,130662,1315,10,Y,N,-,-1,-1
MASONB.txt,129420,130745,1325,10,Y,N,-,-1,-1
MASONB.txt,129469,130965,1496,10,Y,N,-,-1,-1
MASONB.txt,129613,131150,1537,10,Y,N,-,-1,-1
MASONB.txt,129776,131312,1536,10,Y,N,-,-1,-1
MASONB.txt,130002,131446,1444,10,Y,N,-,-1,-1
MASONB.txt,130150,131485,1335,10,Y,N,-,-1,-1
MASONB.txt,130302,131709,1407,10,Y,N,-,-1,-1
MASONB.txt,130466,131860,1394,10,N,N,-,-1,-1
MASONB.txt,130525,131989,1464,10,N,N,-,-1,-1
MASONB.txt,130663,132141,1478,10,N,N,-,-1,-1
MASONB.txt,130746,132290,1544,10,N,N,-,-1,-1
MASONB.txt,130966,132398,1432,10,N,N,-,-1,-1
MASONB.txt,131151,132480,1329,10,N,N,-,-1,-1
MASONB.txt,131313,132612,1299,10,N,N,-,-1,-1
MASONB.txt,131447,132654,1207,10,N,N,-,-1,-1
MASONB.txt,131486,132801,1315,10,N,N,-,-1,-1
MASONB.txt,131710,132939,1229,10,N,N,-,-1,-1
MASONB.txt,131861,133132,1271,10,N,N,-,-1,-1
MASONB.txt,131990,133244,1254,10,N,N,-,-1,-1
MASONB.txt,132142,133414,1272,10,N,N,-,-1,-1
MASONB.txt,132291,133591,1300,10,N,N,-,-1,-1
MASONB.txt,132399,133629,1230,10,N,N,-,-1,-1
MASONB.txt,132481,133842,1361,10,N,N,-,-1,-1
MASONB.txt,132613,133967,1354,10,N,N,-,-1,-1
MASONB.txt,132655,134311,1656,10,N,N,-,-1,-1
MASONB.txt,132803,134452,1649,10,N,N,-,-1,-1
MASONB.txt,132940,134589,1649,10,N,N,-,-1,-1
MASONB.txt,133134,134625,1491,10,N,N,-,-1,-1
MASONB.txt,133245,134967,1722,10,N,N,-,-1,-1
MASONB.txt,133415,135083,1668,10,N,N,-,-1,-1
MASONB.txt,133592,135279,1687,10,N,N,-,-1,-1
MASONB.txt,133630,135358,1728,10,N,N,-,-1,-1
MASONB.txt,133843,135474,1631,10,N,N,-,-1,-1
MASONB.txt,133968,135898,1930,10,N,N,-,-1,-1
MASONB.txt,134314,136110,1796,10,N,N,-,-1,-1
MASONB.txt,134453,136380,1927,10,N,N,-,-1,-1
MASONB.txt,134590,136534,1944,10,N,N,-,-1,-1
MASONB.txt,134626,136582,1956,10,N,N,-,-1,-1
MASONB.txt,134968,136785,1817,10,N,N,-,-1,-1
MASONB.txt,135086,136801,1715,10,N,N,-,-1,-1
MASONB.txt,135280,136907,1627,10,N,N,-,-1,-1
MASONB.txt,135359,136934,1575,10,N,N,-,-1,-1
MASONB.txt,135475,137019,1544,10,N,N,-,-1,-1
MASONB.txt,135899,137288,1389,10,N,N,-,-1,-1
MASONB.txt,136113,137512,1399,10,N,Y,1448277167610,40886,47737
MASONB.txt,136383,137744,1361,10,N,Y,1448277167610,40886,47737
MASONB.txt,136537,137845,1308,10,N,Y,1448277167610,40886,47737
MASONB.txt,136583,138044,1461,10,N,Y,1448277167610,40886,47737
MASONB.txt,136790,138161,1371,10,N,Y,1448277167610,40886,47737
MASONB.txt,136806,138224,1418,10,N,Y,1448277167610,40886,47737
MASONB.txt,136910,138388,1478,10,N,Y,1448277167610,40886,47737
MASONB.txt,136937,138619,1682,10,N,Y,1448277167610,40886,47737
MASONB.txt,137020,138782,1762,10,Y,Y,1448277167610,40886,47737
MASONB.txt,137289,138944,1655,10,Y,Y,1448277167610,40886,47737
MASONB.txt,137513,139103,1590,10,Y,Y,1448277167610,40886,47737
MASONB.txt,137745,139272,1527,10,Y,Y,1448277167610,40886,47737
MASONB.txt,137846,139369,1523,10,Y,Y,1448277167610,40886,47737
MASONB.txt,138045,139688,1643,10,Y,Y,1448277167610,40886,47737
MASONB.txt,138162,139823,1661,10,Y,Y,1448277167610,40886,47737
MASONB.txt,138225,140012,1787,10,Y,Y,1448277167610,40886,47737
MASONB.txt,138389,140079,1690,10,Y,Y,1448277167610,40886,47737
MASONB.txt,138622,140159,1537,10,Y,Y,1448277167610,40886,47737
MASONB.txt,138785,140371,1586,10,N,Y,1448277167610,40886,47737
MASONB.txt,138945,140517,1572,10,N,Y,1448277167610,40886,47737
MASONB.txt,139106,140623,1517,10,Y,Y,1448277167610,40886,47737
MASONB.txt,139273,140708,1435,10,Y,Y,1448277167610,40886,47737
MASONB.txt,139372,140783,1411,10,Y,Y,1448277167610,40886,47737
MASONB.txt,139689,140917,1228,10,N,Y,1448277167610,40886,47737
MASONB.txt,139824,141027,1203,10,N,Y,1448277167610,40886,47737
MASONB.txt,140013,141044,1031,10,N,Y,1448277167610,40886,47737
MASONB.txt,140082,141131,1049,10,N,Y,1448277167610,40886,47737
MASONB.txt,140160,141158,998,10,N,Y,1448277167610,40886,47737
MASONB.txt,140372,141268,896,10,N,Y,1448277167610,40886,47737
MASONB.txt,140518,141383,865,10,N,Y,1448277167610,40886,47737
MASONB.txt,140624,141478,854,10,N,Y,1448277167610,40886,47737
MASONB.txt,140709,141658,949,10,N,Y,1448277167610,40886,47737
MASONB.txt,140784,141670,886,10,N,Y,1448277167610,40886,47737
MASONB.txt,140918,141746,828,10,N,Y,1448277167610,40886,47737
MASONB.txt,141032,141862,830,10,N,Y,1448277167610,40886,47737
MASONB.txt,141047,141971,924,10,N,Y,1448277167610,40886,47737
MASONB.txt,141134,142214,1080,10,N,Y,1448277167610,40886,47737
MASONB.txt,141161,142588,1427,10,N,Y,1448277167610,40886,47737
MASONB.txt,141269,142722,1453,10,N,Y,1448277167610,40886,47737
MASONB.txt,141384,142862,1478,10,N,Y,1448277167610,40886,47737
MASONB.txt,141479,143007,1528,10,N,N,-,-1,-1
MASONB.txt,141659,143114,1455,10,N,N,-,-1,-1
MASONB.txt,141671,143249,1578,10,N,Y,1448311811907,157566,161100
MASONB.txt,141747,143472,1725,10,N,Y,1448311811907,157566,161100
MASONB.txt,141863,143568,1705,10,N,Y,1448311811907,157566,161100
MASONB.txt,141972,143726,1754,10,N,Y,1448311811907,157566,161100
MASONB.txt,142215,143738,1523,10,N,Y,1448311811907,157566,161100
MASONB.txt,142589,143795,1206,10,N,Y,1448311811907,157566,161100
MASONB.txt,142723,143833,1110,10,N,Y,1448311811907,157566,161100
MASONB.txt,142864,143839,975,10,N,Y,1448311811907,157566,161100
MASONB.txt,143008,143852,844,10,N,Y,1448311811907,157566,161100
MASONB.txt,143115,143879,764,10,N,Y,1448311811907,157566,161100
MASONB.txt,143250,143906,656,10,N,Y,1448311811907,157566,161100
MASONB.txt,143473,143919,446,10,N,Y,1448311811907,157566,161100
MASONB.txt,143569,143926,357,10,N,Y,1448311811907,157566,161100
MASONB.txt,143729,143966,237,10,N,Y,1448311811907,157566,161100
MASONB.txt,143739,144076,337,10,N,Y,1448311811907,157566,161100
MASONB.txt,143796,144083,287,10,N,Y,1448311811907,157566,161100
MASONB.txt,143834,144099,265,10,N,Y,1448311811907,157566,161100
MASONB.txt,143840,144112,272,10,N,Y,1448311811907,157566,161100
MASONB.txt,143853,144119,266,10,N,Y,1448311811907,157566,161100
MASONB.txt,143880,144149,269,10,N,Y,1448311811907,157566,161100
MASONB.txt,143907,144166,259,10,N,Y,1448311811907,157566,161100
MASONB.txt,143922,144177,255,10,N,Y,1448311811907,157566,161100
MASONB.txt,143927,144197,270,10,N,Y,1448311811907,157566,161100
MASONB.txt,143969,144332,363,10,N,Y,1448311811907,157566,161100
MASONB.txt,144079,144372,293,10,N,Y,1448311811907,157566,161100
MASONB.txt,144084,144459,375,10,N,Y,1448311811907,157566,161100
MASONB.txt,144099,144565,466,10,N,Y,1448311811907,157566,161100
MASONB.txt,144115,144780,665,10,N,Y,1448311811907,157566,161100
MASONB.txt,144120,144945,825,10,N,Y,1448311811907,157566,161100
MASONB.txt,144150,145169,1019,10,N,Y,1448311811907,157566,161100
MASONB.txt,144167,145257,1090,10,Y,Y,1448311811907,157566,161100
MASONB.txt,144178,145294,1116,10,Y,Y,1448311811907,157566,161100
MASONB.txt,144197,145395,1198,10,Y,Y,1448311811907,157566,161100
MASONB.txt,144333,145564,1231,10,Y,Y,1448311811907,157566,161100
MASONB.txt,144373,145616,1243,10,Y,Y,1448311811907,157566,161100
MASONB.txt,144461,145819,1358,10,Y,Y,1448311811907,157566,161100
MASONB.txt,144566,145947,1381,10,Y,Y,1448311811907,157566,161100
MASONB.txt,144781,146054,1273,10,Y,Y,1448311811907,157566,161100
MASONB.txt,144946,146249,1303,10,Y,Y,1448311811907,157566,161100
MASONB.txt,145172,146465,1293,10,N,Y,1448311811907,157566,161100
MASONB.txt,145258,146615,1357,10,N,Y,1448311811907,157566,161100
MASONB.txt,145296,146714,1418,10,N,Y,1448311811907,157566,161100
MASONB.txt,145396,146739,1343,10,N,Y,1448311811907,157566,161100
MASONB.txt,145565,146797,1232,10,N,Y,1448311811907,157566,161100
MASONB.txt,145617,146860,1243,10,Y,Y,1448311811907,157566,161100
MASONB.txt,145820,147047,1227,10,N,Y,1448311811907,157566,161100
MASONB.txt,145948,147280,1332,10,N,Y,1448311811907,157566,161100
MASONB.txt,146055,147368,1313,10,N,Y,1448311811907,157566,161100
MASONB.txt,146250,147398,1148,10,N,Y,1448311811907,157566,161100
MASONB.txt,146467,147416,949,10,N,N,-,-1,-1
MASONB.txt,146616,147524,908,10,N,N,-,-1,-1
MASONB.txt,146715,147551,836,10,N,N,-,-1,-1
MASONB.txt,146740,147686,946,10,N,N,-,-1,-1
MASONB.txt,146798,147805,1007,10,N,N,-,-1,-1
MASONB.txt,146861,147973,1112,10,N,N,-,-1,-1
MASONB.txt,147048,148316,1268,10,N,N,-,-1,-1
MASONB.txt,147282,148580,1298,10,N,N,-,-1,-1
MASONB.txt,147373,148862,1489,10,Y,N,-,-1,-1
MASONB.txt,147403,148932,1529,10,Y,N,-,-1,-1
MASONB.txt,147419,149131,1712,10,Y,N,-,-1,-1
MASONB.txt,147527,149276,1749,10,Y,N,-,-1,-1
MASONB.txt,147554,149461,1907,10,Y,N,-,-1,-1
MASONB.txt,147687,149559,1872,10,Y,N,-,-1,-1
MASONB.txt,147807,149840,2033,10,Y,N,-,-1,-1
MASONB.txt,147974,150056,2082,10,Y,N,-,-1,-1
MASONB.txt,148319,150196,1877,10,N,N,-,-1,-1
MASONB.txt,148580,150328,1748,10,N,N,-,-1,-1
MASONB.txt,148863,150432,1569,10,N,N,-,-1,-1
MASONB.txt,148934,150565,1631,10,N,N,-,-1,-1
MASONB.txt,149132,150630,1498,10,N,N,-,-1,-1
MASONB.txt,149277,150886,1609,10,Y,N,-,-1,-1
MASONB.txt,149462,151238,1776,10,Y,N,-,-1,-1
MASONB.txt,149560,151289,1729,10,Y,N,-,-1,-1
MASONB.txt,149841,151423,1582,10,Y,N,-,-1,-1
MASONB.txt,150057,152029,1972,10,Y,N,-,-1,-1
MASONB.txt,150197,152224,2027,10,Y,N,-,-1,-1
MASONB.txt,150329,152346,2017,10,Y,N,-,-1,-1
MASONB.txt,150435,152547,2112,10,Y,N,-,-1,-1
MASONB.txt,150567,152673,2106,10,Y,N,-,-1,-1
MASONB.txt,150632,152853,2221,10,Y,N,-,-1,-1
MASONB.txt,150887,152858,1971,10,Y,N,-,-1,-1
MASONB.txt,151239,153044,1805,10,Y,N,-,-1,-1
MASONB.txt,151292,153213,1921,10,Y,N,-,-1,-1
MASONB.txt,151425,153311,1886,10,Y,N,-,-1,-1
MASONB.txt,152032,153457,1425,10,N,N,-,-1,-1
MASONB.txt,152227,153602,1375,10,N,N,-,-1,-1
MASONB.txt,152347,153765,1418,10,N,N,-,-1,-1
MASONB.txt,152548,153981,1433,10,N,N,-,-1,-1
MASONB.txt,152674,154343,1669,10,N,N,-,-1,-1
MASONB.txt,152856,154889,2033,10,N,N,-,-1,-1
MASONB.txt,152859,154974,2115,10,N,N,-,-1,-1
MASONB.txt,153046,155078,2032,10,N,N,-,-1,-1
MASONB.txt,153214,155115,1901,10,N,N,-,-1,-1
MASONB.txt,153314,155255,1941,10,N,N,-,-1,-1
MASONB.txt,153460,155364,1904,10,N,N,-,-1,-1
MASONB.txt,153603,155469,1866,10,N,N,-,-1,-1
MASONB.txt,153767,155684,1917,10,N,N,-,-1,-1
MASONB.txt,153982,155748,1766,10,N,Y,1448285563397,102964,108476
MASONB.txt,154344,156325,1981,10,Y,Y,1448285563397,102964,108476
MASONB.txt,154890,156341,1451,10,Y,Y,1448285563397,102964,108476
MASONB.txt,154975,156436,1461,10,N,Y,1448285563397,102964,108476
MASONB.txt,155079,156514,1435,10,N,Y,1448285563397,102964,108476
MASONB.txt,155116,156609,1493,10,N,Y,1448285563397,102964,108476
MASONB.txt,155256,156681,1425,10,N,Y,1448285563397,102964,108476
MASONB.txt,155367,156730,1363,10,N,Y,1448285563397,102964,108476
MASONB.txt,155470,157021,1551,10,N,Y,1448285563397,102964,108476
MASONB.txt,155687,157149,1462,10,N,Y,1448285563397,102964,108476
MASONB.txt,155750,157268,1518,10,N,Y,1448285563397,102964,108476
MASONB.txt,156330,157355,1025,10,N,N,-,-1,-1
MASONB.txt,156346,157459,1113,10,N,N,-,-1,-1
MASONB.txt,156439,157539,1100,10,N,N,-,-1,-1
MASONB.txt,156515,157581,1066,10,N,Y,1448037533268,13930,15031
MASONB.txt,156610,157699,1089,10,N,Y,1448037533268,13930,15031
MASONB.txt,156682,157787,1105,10,N,Y,1448037533268,13930,15031
MASONB.txt,156731,158076,1345,10,N,Y,1448037533268,13930,15031
MASONB.txt,157022,158362,1340,10,N,Y,1448037533268,13930,15031
MASONB.txt,157150,158470,1320,10,N,Y,1448037533268,13930,15031
MASONB.txt,157269,158537,1268,10,N,Y,1448037533268,13930,15031
MASONB.txt,157356,158687,1331,10,N,Y,1448037533268,13930,15031
MASONB.txt,157460,158808,1348,10,N,Y,1448037533268,13930,15031
MASONB.txt,157540,159192,1652,10,N,Y,1448037533268,13930,15031
MASONB.txt,157582,159218,1636,10,N,Y,1448037533268,13930,15031
MASONB.txt,157700,159347,1647,10,N,Y,1448037533268,13930,15031
MASONB.txt,157788,159660,1872,10,N,Y,1448037533268,13930,15031
MASONB.txt,158077,159900,1823,10,N,Y,1448037533268,13930,15031
MASONB.txt,158363,160016,1653,10,N,Y,1448037533268,13930,15031
MASONB.txt,158471,160085,1614,10,N,Y,1448037533268,13930,15031
MASONB.txt,158539,160138,1599,10,N,Y,1448037533268,13930,15031
MASONB.txt,158690,160409,1719,10,N,Y,1448037533268,13930,15031
MASONB.txt,158810,160513,1703,10,N,Y,1448037533268,13930,15031
MASONB.txt,159193,160671,1478,10,N,Y,1448037533268,13930,15031
MASONB.txt,159219,160713,1494,10,N,Y,1448037533268,13930,15031
MASONB.txt,159348,160923,1575,10,N,Y,1448037533268,13930,15031
MASONB.txt,159661,161185,1524,10,N,Y,1448037533268,13930,15031
MASONB.txt,159901,161310,1409,10,N,Y,1448037533268,13930,15031
MASONB.txt,160017,161409,1392,10,N,Y,1448037533268,13930,15031
MASONB.txt,160086,161457,1371,10,N,Y,1448037533268,13930,15031
MASONB.txt,160139,161656,1517,10,N,Y,1448037533268,13930,15031
MASONB.txt,160410,161724,1314,10,N,Y,1448037533268,13930,15031
MASONB.txt,160514,161763,1249,10,N,Y,1448037533268,13930,15031
MASONB.txt,160672,161832,1160,10,N,Y,1448037533268,13930,15031
MASONB.txt,160718,162007,1289,10,N,Y,1448037533268,13930,15031
MASONB.txt,160924,162130,1206,10,N,Y,1448037533268,13930,15031
MASONB.txt,161188,162151,963,10,N,N,-,-1,-1
MASONB.txt,161312,162201,889,10,N,N,-,-1,-1
MASONB.txt,161410,162257,847,10,N,N,-,-1,-1
MASONB.txt,161460,162284,824,10,N,N,-,-1,-1
MASONB.txt,161657,162320,663,10,N,N,-,-1,-1
MASONB.txt,161727,162394,667,10,N,N,-,-1,-1
MASONB.txt,161766,162439,673,10,N,N,-,-1,-1
MASONB.txt,161832,162519,687,10,N,N,-,-1,-1
MASONB.txt,162012,162544,532,10,N,N,-,-1,-1
MASONB.txt,162135,162646,511,10,N,N,-,-1,-1
MASONB.txt,162151,162903,752,10,N,N,-,-1,-1
MASONB.txt,162201,163001,800,10,N,N,-,-1,-1
MASONB.txt,162257,163066,809,10,N,N,-,-1,-1
MASONB.txt,162284,163154,870,10,N,N,-,-1,-1
MASONB.txt,162320,163328,1008,10,N,N,-,-1,-1
MASONB.txt,162394,163382,988,10,N,N,-,-1,-1
MASONB.txt,162444,163601,1157,10,Y,N,-,-1,-1
MASONB.txt,162522,163813,1291,10,Y,N,-,-1,-1
MASONB.txt,162547,163965,1418,10,Y,N,-,-1,-1
MASONB.txt,162647,164194,1547,10,Y,N,-,-1,-1
MASONB.txt,162904,164414,1510,10,Y,N,-,-1,-1
MASONB.txt,163002,164540,1538,10,Y,N,-,-1,-1
MASONB.txt,163068,164556,1488,10,Y,N,-,-1,-1
MASONB.txt,163155,164697,1542,10,Y,N,-,-1,-1
MASONB.txt,163329,164721,1392,10,N,N,-,-1,-1
MASONB.txt,163384,164964,1580,10,N,N,-,-1,-1
MASONB.txt,163602,164979,1377,10,N,N,-,-1,-1
MASONB.txt,163816,165046,1230,10,N,N,-,-1,-1
MASONB.txt,163966,165133,1167,10,N,N,-,-1,-1
MASONB.txt,164197,165228,1031,10,N,N,-,-1,-1
MASONB.txt,164417,165243,826,10,N,N,-,-1,-1
MASONB.txt,164543,165319,776,10,N,N,-,-1,-1
MASONB.txt,164559,165432,873,10,N,N,-,-1,-1
MASONB.txt,164702,165557,855,10,N,N,-,-1,-1
MASONB.txt,164724,165611,887,10,N,N,-,-1,-1
MASONB.txt,164967,165760,793,10,N,N,-,-1,-1
MASONB.txt,164982,166053,1071,10,N,N,-,-1,-1
MASONB.txt,165048,166089,1041,10,N,N,-,-1,-1
MASONB.txt,165135,166108,973,10,N,N,-,-1,-1
MASONB.txt,165231,166144,913,10,N,N,-,-1,-1
MASONB.txt,165246,166168,922,10,N,N,-,-1,-1
MASONB.txt,165322,166424,1102,10,N,N,-,-1,-1
MASONB.txt,165433,166543,1110,10,N,N,-,-1,-1
MASONB.txt,165558,166703,1145,10,N,N,-,-1,-1
MASONB.txt,165612,166987,1375,10,N,N,-,-1,-1
MASONB.txt,165762,167185,1423,10,N,N,-,-1,-1
MASONB.txt,166058,167273,1215,10,N,N,-,-1,-1
MASONB.txt,166090,167478,1388,10,N,N,-,-1,-1
MASONB.txt,166111,167572,1461,10,N,N,-,-1,-1
MASONB.txt,166147,167640,1493,10,N,N,-,-1,-1
MASONB.txt,166171,167756,1585,10,N,N,-,-1,-1
MASONB.txt,166427,167772,1345,10,N,N,-,-1,-1
MASONB.txt,166544,167811,1267,10,N,N,-,-1,-1
MASONB.txt,166706,168336,1630,10,N,N,-,-1,-1
MASONB.txt,166988,168411,1423,10,N,N,-,-1,-1
MASONB.txt,167186,168737,1551,10,N,N,-,-1,-1
MASONB.txt,167275,168833,1558,10,N,N,-,-1,-1
MASONB.txt,167479,169158,1679,10,N,N,-,-1,-1
MASONB.txt,167573,169227,1654,10,N,N,-,-1,-1
MASONB.txt,167641,169261,1620,10,N,N,-,-1,-1
MASONB.txt,167757,169466,1709,10,N,N,-,-1,-1
MASONB.txt,167777,169716,1939,10,N,N,-,-1,-1
MASONB.txt,167814,169728,1914,10,N,N,-,-1,-1
MASONB.txt,168337,169748,1411,10,N,N,-,-1,-1
MASONB.txt,168412,169917,1505,10,N,N,-,-1,-1
MASONB.txt,168738,169942,1204,10,N,N,-,-1,-1
MASONB.txt,168834,170058,1224,10,N,N,-,-1,-1
MASONB.txt,169159,170240,1081,10,N,N,-,-1,-1
MASONB.txt,169228,170287,1059,10,N,N,-,-1,-1
MASONB.txt,169262,170470,1208,10,N,N,-,-1,-1
MASONB.txt,169467,170616,1149,10,N,N,-,-1,-1
MASONB.txt,169721,170765,1044,10,N,N,-,-1,-1
MASONB.txt,169729,171205,1476,10,N,N,-,-1,-1
MASONB.txt,169751,171340,1589,10,N,N,-,-1,-1
MASONB.txt,169920,171602,1682,10,N,N,-,-1,-1
MASONB.txt,169945,171699,1754,10,N,N,-,-1,-1
MASONB.txt,170059,171849,1790,10,N,N,-,-1,-1
MASONB.txt,170241,171941,1700,10,N,N,-,-1,-1
MASONB.txt,170288,172044,1756,10,N,N,-,-1,-1
MASONB.txt,170471,172185,1714,10,N,N,-,-1,-1
MASONB.txt,170617,172352,1735,10,N,N,-,-1,-1
MASONB.txt,170766,172479,1713,10,N,Y,1448316079788,183824,184995
MASONB.txt,171206,172622,1416,10,N,Y,1448316079788,183824,184995
MASONB.txt,171341,172680,1339,10,N,Y,1448316079788,183824,184995
MASONB.txt,171605,172829,1224,10,N,Y,1448316079788,183824,184995
MASONB.txt,171702,173036,1334,10,N,Y,1448316079788,183824,184995
MASONB.txt,171850,173133,1283,10,N,Y,1448316079788,183824,184995
MASONB.txt,171942,173364,1422,10,N,Y,1448316079788,183824,184995
MASONB.txt,172045,173547,1502,10,N,Y,1448316079788,183824,184995
MASONB.txt,172186,173569,1383,10,N,Y,1448316079788,183824,184995
MASONB.txt,172353,173963,1610,10,Y,Y,1448039123601,19678,19935
MASONB.txt,172480,174062,1582,10,Y,Y,1448039123601,19678,19935
MASONB.txt,172624,174144,1520,10,Y,Y,1448039123601,19678,19935
MASONB.txt,172680,174332,1652,10,Y,Y,1448039123601,19678,19935
MASONB.txt,172830,174505,1675,10,Y,Y,1448039123601,19678,19935
MASONB.txt,173037,174565,1528,10,Y,Y,1448039123601,19678,19935
MASONB.txt,173134,174708,1574,10,Y,Y,1448039123601,19678,19935
MASONB.txt,173365,174797,1432,10,N,Y,1448039123601,19678,19935
MASONB.txt,173552,175029,1477,10,Y,Y,1448039123601,19678,19935
MASONB.txt,173570,175118,1548,10,Y,Y,1448039123601,19678,19935
MASONB.txt,173964,175224,1260,10,Y,Y,1448039123601,19678,19935
MASONB.txt,174063,175323,1260,10,N,Y,1448039123601,19678,19935
MASONB.txt,174145,175487,1342,10,N,Y,1448039123601,19678,19935
MASONB.txt,174333,175514,1181,10,N,Y,1448039123601,19678,19935
MASONB.txt,174508,175664,1156,10,N,Y,1448315575026,182236,182361
MASONB.txt,174566,175724,1158,10,N,Y,1448315575026,182236,182361
MASONB.txt,174709,175802,1093,10,N,Y,1448315575026,182236,182361
MASONB.txt,174798,176065,1267,10,N,Y,1448315575026,182236,182361
MASONB.txt,175032,176552,1520,10,N,Y,1448315575026,182236,182361
MASONB.txt,175119,176777,1658,10,Y,Y,1448274783410,21836,25159
MASONB.txt,175225,176871,1646,10,Y,Y,1448274783410,21836,25159
MASONB.txt,175324,177105,1781,10,Y,Y,1448274783410,21836,25159
MASONB.txt,175488,177204,1716,10,Y,Y,1448274783410,21836,25159
MASONB.txt,175515,177323,1808,10,Y,Y,1448274783410,21836,25159
MASONB.txt,175665,177502,1837,10,Y,Y,1448274783410,21836,25159
MASONB.txt,175725,177707,1982,10,Y,Y,1448274783410,21836,25159
MASONB.txt,175803,177820,2017,10,Y,Y,1448274783410,21836,25159
MASONB.txt,176066,177928,1862,10,Y,Y,1448274783410,21836,25159
MASONB.txt,176555,178192,1637,10,Y,Y,1448274783410,21836,25159
MASONB.txt,176778,178460,1682,10,Y,Y,1448274783410,21836,25159
MASONB.txt,176872,178514,1642,10,Y,Y,1448287490368,120754,123385
MASONB.txt,177106,178834,1728,10,Y,Y,1448287490368,120754,123385
MASONB.txt,177205,178862,1657,10,Y,Y,1448287490368,120754,123385
MASONB.txt,177324,178880,1556,10,Y,Y,1448287490368,120754,123385
MASONB.txt,177503,178997,1494,10,Y,Y,1448287490368,120754,123385
MASONB.txt,177710,179024,1314,10,N,Y,1448287490368,120754,123385
MASONB.txt,177821,179148,1327,10,N,Y,1448279089520,67624,69991
MASONB.txt,177929,179224,1295,10,N,Y,1448279089520,67624,69991
MASONB.txt,178193,179250,1057,10,N,Y,1448279089520,67624,69991
MASONB.txt,178461,179341,880,10,N,Y,1448279089520,67624,69991
MASONB.txt,178515,179483,968,10,N,Y,1448279089520,67624,69991
MASONB.txt,178835,179585,750,10,N,Y,1448279089520,67624,69991
MASONB.txt,178867,179593,726,10,N,Y,1448279089520,67624,69991
MASONB.txt,178885,179719,834,10,N,Y,1448279089520,67624,69991
MASONB.txt,179000,179844,844,10,N,Y,1448279089520,67624,69991
MASONB.txt,179027,179955,928,10,N,Y,1448279089520,67624,69991
MASONB.txt,179150,180133,983,10,N,Y,1448279089520,67624,69991
MASONB.txt,179227,180206,979,10,N,Y,1448279089520,67624,69991
MASONB.txt,179251,180357,1106,10,Y,Y,1448279089520,67624,69991
MASONB.txt,179342,180437,1095,10,Y,Y,1448280673594,87462,88501
MASONB.txt,179485,180634,1149,10,Y,Y,1448280673594,87462,88501
MASONB.txt,179586,180806,1220,10,Y,Y,1448280673594,87462,88501
MASONB.txt,179594,181138,1544,10,Y,Y,1448280673594,87462,88501
MASONB.txt,179720,181265,1545,10,N,Y,1448280673594,87462,88501
MASONB.txt,179845,181574,1729,10,Y,Y,1448280884746,88496,89294
MASONB.txt,179956,181770,1814,10,Y,Y,1448280884746,88496,89294
MASONB.txt,180134,181889,1755,10,Y,Y,1448280884746,88496,89294
MASONB.txt,180207,182066,1859,10,Y,Y,1448280884746,88496,89294
MASONB.txt,180358,182068,1710,10,Y,Y,1448280884746,88496,89294
MASONB.txt,180438,182235,1797,10,Y,Y,1448280884746,88496,89294
MASONB.txt,180635,182363,1728,10,Y,Y,1448280884746,88496,89294
MASONB.txt,180807,182561,1754,10,Y,Y,1448280884746,88496,89294
MASONB.txt,181139,182690,1551,10,N,Y,1448280884746,88496,89294
MASONB.txt,181266,182805,1539,10,Y,Y,1448280884746,88496,89294
MASONB.txt,181575,182989,1414,10,N,Y,1448280884746,88496,89294
MASONB.txt,181771,183224,1453,10,N,Y,1448280884746,88496,89294
MASONB.txt,181890,183367,1477,10,N,Y,1448280884746,88496,89294
MASONB.txt,182067,183524,1457,10,N,Y,1448313482895,176553,176862
MASONB.txt,182070,183683,1613,10,N,Y,1448313482895,176553,176862
MASONB.txt,182236,183782,1546,10,N,Y,1448313482895,176553,176862
MASONB.txt,182366,183803,1437,10,N,Y,1448322979449,227304,227638
MASONB.txt,182562,183905,1343,10,N,Y,1448286451685,111065,112127
MASONB.txt,182693,184020,1327,10,N,Y,1448286451685,111065,112127
MASONB.txt,182806,184258,1452,10,N,Y,1448286451685,111065,112127
MASONB.txt,182990,184348,1358,10,N,Y,1448286451685,111065,112127
MASONB.txt,183227,184476,1249,10,N,Y,1448286451685,111065,112127
MASONB.txt,183370,184644,1274,10,N,Y,1448286451685,111065,112127
MASONB.txt,183527,184794,1267,10,N,Y,1448286451685,111065,112127
MASONB.txt,183684,184846,1162,10,N,Y,1448286451685,111065,112127
MASONB.txt,183783,185000,1217,10,N,Y,1448286451685,111065,112127
MASONB.txt,183804,185158,1354,10,N,Y,1448286451685,111065,112127
MASONB.txt,183906,185176,1270,10,N,Y,1448286451685,111065,112127
MASONB.txt,184021,185197,1176,10,N,Y,1448286451685,111065,112127
MASONB.txt,184259,185244,985,10,N,Y,1448286451685,111065,112127
MASONB.txt,184349,185266,917,10,N,Y,1448286451685,111065,112127
MASONB.txt,184477,185268,791,10,N,Y,1448286451685,111065,112127
MASONB.txt,184645,185386,741,10,N,Y,1448286451685,111065,112127
MASONB.txt,184796,185508,712,10,N,Y,1448286451685,111065,112127
MASONB.txt,184847,185572,725,10,N,Y,1448286451685,111065,112127
MASONB.txt,185001,185661,660,10,N,N,-,-1,-1
MASONB.txt,185163,185747,584,10,N,N,-,-1,-1
MASONB.txt,185177,186023,846,10,N,N,-,-1,-1
MASONB.txt,185200,186306,1106,10,N,N,-,-1,-1
MASONB.txt,185247,186457,1210,10,N,N,-,-1,-1
MASONB.txt,185266,186646,1380,10,N,N,-,-1,-1
MASONB.txt,185271,186825,1554,10,Y,N,-,-1,-1
MASONB.txt,185387,187007,1620,10,Y,N,-,-1,-1
MASONB.txt,185509,187027,1518,10,Y,N,-,-1,-1
MASONB.txt,185573,187268,1695,10,Y,N,-,-1,-1
MASONB.txt,185662,187446,1784,10,Y,N,-,-1,-1
MASONB.txt,185748,187586,1838,10,Y,N,-,-1,-1
MASONB.txt,186024,187726,1702,10,Y,N,-,-1,-1
MASONB.txt,186307,187875,1568,10,Y,N,-,-1,-1
MASONB.txt,186459,188106,1647,10,Y,N,-,-1,-1
MASONB.txt,186647,188256,1609,10,Y,N,-,-1,-1
MASONB.txt,186826,188378,1552,10,N,N,-,-1,-1
MASONB.txt,187010,188530,1520,10,N,N,-,-1,-1
MASONB.txt,187028,188765,1737,10,N,N,-,-1,-1
MASONB.txt,187270,189057,1787,10,N,N,-,-1,-1
MASONB.txt,187447,189526,2079,10,N,N,-,-1,-1
MASONB.txt,187588,189729,2141,10,N,N,-,-1,-1
MASONB.txt,187727,189843,2116,10,N,N,-,-1,-1
MASONB.txt,187876,189851,1975,10,N,N,-,-1,-1
MASONB.txt,188107,190007,1900,10,N,N,-,-1,-1
MASONB.txt,188257,190145,1888,10,N,N,-,-1,-1
MASONB.txt,188379,190248,1869,10,N,N,-,-1,-1
MASONB.txt,188531,190360,1829,10,N,N,-,-1,-1
MASONB.txt,188766,190491,1725,10,N,N,-,-1,-1
MASONB.txt,189058,190956,1898,10,N,N,-,-1,-1
MASONB.txt,189527,191117,1590,10,N,N,-,-1,-1
MASONB.txt,189730,191319,1589,10,N,N,-,-1,-1
MASONB.txt,189844,191371,1527,10,N,N,-,-1,-1
MASONB.txt,189851,191376,1525,10,N,N,-,-1,-1
MASONB.txt,190010,191397,1387,10,N,N,-,-1,-1
MASONB.txt,190146,191632,1486,10,N,N,-,-1,-1
MASONB.txt,190249,191637,1388,10,N,N,-,-1,-1
MASONB.txt,190361,191659,1298,10,N,N,-,-1,-1
MASONB.txt,190492,191939,1447,10,N,N,-,-1,-1
MASONB.txt,190957,192049,1092,10,N,N,-,-1,-1
MASONB.txt,191118,192054,936,10,N,N,-,-1,-1
MASONB.txt,191320,192163,843,10,N,N,-,-1,-1
MASONB.txt,191374,192178,804,10,N,N,-,-1,-1
MASONB.txt,191377,192183,806,10,N,N,-,-1,-1
MASONB.txt,191398,192350,952,10,N,N,-,-1,-1
MASONB.txt,191635,192356,721,10,N,N,-,-1,-1
MASONB.txt,191638,192362,724,10,N,N,-,-1,-1
MASONB.txt,191660,192366,706,10,N,N,-,-1,-1
MASONB.txt,191940,192482,542,10,N,N,-,-1,-1
MASONB.txt,192052,192487,435,10,N,N,-,-1,-1
MASONB.txt,192055,192523,468,10,N,N,-,-1,-1
MASONB.txt,192164,192528,364,10,N,N,-,-1,-1
MASONB.txt,192181,192577,396,10,N,N,-,-1,-1
MASONB.txt,192184,192582,398,10,N,N,-,-1,-1
MASONB.txt,192351,192601,250,10,N,N,-,-1,-1
MASONB.txt,192357,192606,249,10,N,N,-,-1,-1
MASONB.txt,192363,192639,276,10,N,N,-,-1,-1
MASONB.txt,192367,192645,278,10,N,N,-,-1,-1
MASONB.txt,192485,192722,237,10,N,N,-,-1,-1
MASONB.txt,192488,192728,240,10,N,N,-,-1,-1
MASONB.txt,192526,192791,265,10,N,N,-,-1,-1
MASONB.txt,192529,192808,279,10,N,N,-,-1,-1
MASONB.txt,192580,192814,234,10,N,N,-,-1,-1
MASONB.txt,192583,192845,262,10,N,N,-,-1,-1
MASONB.txt,192604,192853,249,10,N,N,-,-1,-1
MASONB.txt,192607,192923,316,10,N,N,-,-1,-1
MASONB.txt,192642,192930,288,10,N,N,-,-1,-1
MASONB.txt,192646,192950,304,10,N,N,-,-1,-1
MASONB.txt,192725,192992,267,10,N,N,-,-1,-1
MASONB.txt,192729,192998,269,10,N,N,-,-1,-1
MASONB.txt,192792,193058,266,10,N,N,-,-1,-1
MASONB.txt,192811,193064,253,10,N,N,-,-1,-1
MASONB.txt,192815,193190,375,10,N,N,-,-1,-1
MASONB.txt,192846,193213,367,10,N,N,-,-1,-1
MASONB.txt,192854,193223,369,10,N,N,-,-1,-1
MASONB.txt,192925,193250,325,10,N,N,-,-1,-1
MASONB.txt,192931,193256,325,10,N,N,-,-1,-1
MASONB.txt,192951,193332,381,10,N,N,-,-1,-1
MASONB.txt,192995,193338,343,10,N,N,-,-1,-1
MASONB.txt,192999,193395,396,10,N,N,-,-1,-1
MASONB.txt,193061,193414,353,10,N,N,-,-1,-1
MASONB.txt,193065,193537,472,10,N,N,-,-1,-1
MASONB.txt,193193,193543,350,10,N,N,-,-1,-1
MASONB.txt,193214,193671,457,10,N,N,-,-1,-1
MASONB.txt,193224,193678,454,10,N,N,-,-1,-1
MASONB.txt,193253,193756,503,10,N,N,-,-1,-1
MASONB.txt,193257,193762,505,10,N,N,-,-1,-1
MASONB.txt,193335,193855,520,10,N,N,-,-1,-1
MASONB.txt,193339,193913,574,10,N,N,-,-1,-1
MASONB.txt,193396,193919,523,10,N,N,-,-1,-1
MASONB.txt,193415,193943,528,10,N,N,-,-1,-1
MASONB.txt,193540,194009,469,10,N,N,-,-1,-1
MASONB.txt,193544,194015,471,10,N,N,-,-1,-1
MASONB.txt,193674,194068,394,10,N,N,-,-1,-1
MASONB.txt,193679,194083,404,10,N,N,-,-1,-1
MASONB.txt,193759,194089,330,10,N,N,-,-1,-1
MASONB.txt,193763,194116,353,10,N,N,-,-1,-1
MASONB.txt,193856,194122,266,10,N,N,-,-1,-1
MASONB.txt,193916,194144,228,10,N,N,-,-1,-1
MASONB.txt,193920,194151,231,10,N,N,-,-1,-1
MASONB.txt,193944,194195,251,10,N,N,-,-1,-1
MASONB.txt,194012,194201,189,10,N,N,-,-1,-1
MASONB.txt,194016,194281,265,10,N,N,-,-1,-1
MASONB.txt,194069,194287,218,10,N,N,-,-1,-1
MASONB.txt,194086,194314,228,10,N,N,-,-1,-1
MASONB.txt,194090,194320,230,10,N,N,-,-1,-1
MASONB.txt,194119,194520,401,10,N,N,-,-1,-1
MASONB.txt,194123,194575,452,10,N,N,-,-1,-1
MASONB.txt,194145,194682,537,10,N,N,-,-1,-1
MASONB.txt,194152,194688,536,10,N,N,-,-1,-1
MASONB.txt,194198,194841,643,10,N,N,-,-1,-1
MASONB.txt,194202,194847,645,10,N,N,-,-1,-1
MASONB.txt,194284,194997,713,10,N,N,-,-1,-1
MASONB.txt,194288,195002,714,10,N,N,-,-1,-1
MASONB.txt,194317,195008,691,10,N,N,-,-1,-1
MASONB.txt,194321,195166,845,10,N,N,-,-1,-1
MASONB.txt,194521,195198,677,10,N,N,-,-1,-1
MASONB.txt,194576,195258,682,10,N,N,-,-1,-1
MASONB.txt,194685,195264,579,10,N,N,-,-1,-1
MASONB.txt,194689,195291,602,10,N,N,-,-1,-1
MASONB.txt,194844,195297,453,10,N,N,-,-1,-1
MASONB.txt,194848,195319,471,10,N,N,-,-1,-1
MASONB.txt,194998,195387,389,10,N,N,-,-1,-1
MASONB.txt,195005,195393,388,10,N,N,-,-1,-1
MASONB.txt,195009,195476,467,10,N,N,-,-1,-1
MASONB.txt,195171,195485,314,10,N,N,-,-1,-1
MASONB.txt,195198,195512,314,10,N,N,-,-1,-1
MASONB.txt,195261,195518,257,10,N,N,-,-1,-1
MASONB.txt,195265,195542,277,10,N,N,-,-1,-1
MASONB.txt,195294,195550,256,10,N,N,-,-1,-1
MASONB.txt,195298,195556,258,10,N,N,-,-1,-1
MASONB.txt,195320,195610,290,10,N,N,-,-1,-1
MASONB.txt,195390,195616,226,10,N,N,-,-1,-1
MASONB.txt,195394,195685,291,10,N,N,-,-1,-1
MASONB.txt,195482,195691,209,10,N,N,-,-1,-1
MASONB.txt,195486,195812,326,10,N,N,-,-1,-1
MASONB.txt,195515,195818,303,10,N,N,-,-1,-1
MASONB.txt,195519,195893,374,10,N,N,-,-1,-1
MASONB.txt,195543,195899,356,10,N,N,-,-1,-1
MASONB.txt,195553,195943,390,10,N,N,-,-1,-1
MASONB.txt,195557,195949,392,10,N,N,-,-1,-1
MASONB.txt,195613,195995,382,10,N,N,-,-1,-1
MASONB.txt,195617,196001,384,10,N,N,-,-1,-1
MASONB.txt,195688,196036,348,10,N,N,-,-1,-1
MASONB.txt,195692,196058,366,10,N,N,-,-1,-1
MASONB.txt,195815,196104,289,10,N,N,-,-1,-1
MASONB.txt,195819,196161,342,10,N,N,-,-1,-1
MASONB.txt,195896,196254,358,10,N,N,-,-1,-1
MASONB.txt,195900,196546,646,10,N,N,-,-1,-1
MASONB.txt,195946,196572,626,10,N,N,-,-1,-1
MASONB.txt,195950,197106,1156,10,N,N,-,-1,-1
MASONB.txt,195998,197258,1260,10,N,N,-,-1,-1
MASONB.txt,196002,197749,1747,10,Y,N,-,-1,-1
MASONB.txt,196037,197915,1878,10,Y,N,-,-1,-1
MASONB.txt,196059,198162,2103,10,Y,N,-,-1,-1
MASONB.txt,196107,198312,2205,10,Y,N,-,-1,-1
MASONB.txt,196162,198814,2652,10,Y,N,-,-1,-1
MASONB.txt,196255,199029,2774,10,Y,N,-,-1,-1
MASONB.txt,196549,199176,2627,10,Y,N,-,-1,-1
MASONB.txt,196573,199668,3095,10,Y,N,-,-1,-1
MASONB.txt,197107,199813,2706,10,Y,N,-,-1,-1
MASONB.txt,197259,200262,3003,10,Y,N,-,-1,-1
MASONB.txt,197750,200394,2644,10,Y,N,-,-1,-1
MASONB.txt,197916,200565,2649,10,Y,N,-,-1,-1
MASONB.txt,198165,201181,3016,10,Y,N,-,-1,-1
MASONB.txt,198315,201450,3135,10,Y,N,-,-1,-1
MASONB.txt,198815,201638,2823,10,Y,N,-,-1,-1
MASONB.txt,199030,201752,2722,10,Y,N,-,-1,-1
MASONB.txt,199177,201920,2743,10,Y,N,-,-1,-1
MASONB.txt,199669,202204,2535,10,Y,N,-,-1,-1
MASONB.txt,199814,202423,2609,10,Y,N,-,-1,-1
MASONB.txt,200263,202452,2189,10,Y,N,-,-1,-1
MASONB.txt,200395,202815,2420,10,Y,N,-,-1,-1
MASONB.txt,200568,203033,2465,10,Y,N,-,-1,-1
MASONB.txt,201182,203566,2384,10,N,N,-,-1,-1
MASONB.txt,201451,203732,2281,10,Y,N,-,-1,-1
MASONB.txt,201639,203876,2237,10,Y,N,-,-1,-1
MASONB.txt,201753,204177,2424,10,Y,N,-,-1,-1
MASONB.txt,201921,204328,2407,10,Y,N,-,-1,-1
MASONB.txt,202205,204463,2258,10,Y,N,-,-1,-1
MASONB.txt,202428,204581,2153,10,Y,N,-,-1,-1
MASONB.txt,202455,204735,2280,10,Y,N,-,-1,-1
MASONB.txt,202818,204886,2068,10,Y,N,-,-1,-1
MASONB.txt,203034,205316,2282,10,Y,N,-,-1,-1
MASONB.txt,203567,205509,1942,10,Y,N,-,-1,-1
MASONB.txt,203733,205562,1829,10,N,N,-,-1,-1
MASONB.txt,203877,205768,1891,10,N,N,-,-1,-1
MASONB.txt,204180,205939,1759,10,N,N,-,-1,-1
MASONB.txt,204329,206054,1725,10,N,N,-,-1,-1
MASONB.txt,204464,206345,1881,10,N,N,-,-1,-1
MASONB.txt,204582,206376,1794,10,N,N,-,-1,-1
MASONB.txt,204736,206392,1656,10,N,N,-,-1,-1
MASONB.txt,204887,206428,1541,10,N,N,-,-1,-1
MASONB.txt,205317,206442,1125,10,N,N,-,-1,-1
MASONB.txt,205510,206475,965,10,N,N,-,-1,-1
MASONB.txt,205565,206524,959,10,N,N,-,-1,-1
MASONB.txt,205769,206672,903,10,N,Y,1448357582358,234204,234401
MASONB.txt,205941,206743,802,10,N,Y,1448357582358,234204,234401
MASONB.txt,206055,206948,893,10,N,Y,1448357582358,234204,234401
MASONB.txt,206350,207170,820,10,N,Y,1448357582358,234204,234401
MASONB.txt,206381,207314,933,10,N,Y,1448357582358,234204,234401
MASONB.txt,206395,207359,964,10,N,Y,1448357582358,234204,234401
MASONB.txt,206429,207560,1131,10,N,Y,1448357582358,234204,234401
MASONB.txt,206445,207723,1278,10,N,Y,1448357582358,234204,234401
MASONB.txt,206478,207827,1349,10,N,Y,1448357582358,234204,234401
MASONB.txt,206525,208042,1517,10,Y,Y,1448357582358,234204,234401
MASONB.txt,206673,208121,1448,10,Y,Y,1448357582358,234204,234401
MASONB.txt,206744,208161,1417,10,Y,Y,1448357582358,234204,234401
MASONB.txt,206949,208488,1539,10,Y,Y,1448357582358,234204,234401
MASONB.txt,207171,208640,1469,10,Y,Y,1448357582358,234204,234401
MASONB.txt,207315,208940,1625,10,Y,Y,1448357582358,234204,234401
MASONB.txt,207360,209079,1719,10,Y,Y,1448357582358,234204,234401
MASONB.txt,207561,209247,1686,10,Y,Y,1448357582358,234204,234401
MASONB.txt,207724,209624,1900,10,Y,Y,1448357582358,234204,234401
MASONB.txt,207829,210016,2187,10,Y,Y,1448357582358,234204,234401
MASONB.txt,208043,210222,2179,10,Y,Y,1448322514970,220165,221397
MASONB.txt,208122,210236,2114,10,Y,Y,1448322514970,220165,221397
MASONB.txt,208162,210264,2102,10,Y,Y,1448322514970,220165,221397
MASONB.txt,208491,210322,1831,10,Y,Y,1448322514970,220165,221397
MASONB.txt,208641,210685,2044,10,Y,Y,1448322514970,220165,221397
MASONB.txt,208941,210777,1836,10,Y,Y,1448322514970,220165,221397
MASONB.txt,209080,210791,1711,10,Y,Y,1448322514970,220165,221397
MASONB.txt,209248,210833,1585,10,Y,Y,1448322514970,220165,221397
MASONB.txt,209625,211090,1465,10,Y,Y,1448322514970,220165,221397
MASONB.txt,210016,211289,1273,10,N,Y,1448322514970,220165,221397
MASONB.txt,210223,211412,1189,10,N,Y,1448322514970,220165,221397
MASONB.txt,210239,211651,1412,10,N,Y,1448322514970,220165,221397
MASONB.txt,210265,211730,1465,10,N,Y,1448322514970,220165,221397
MASONB.txt,210323,211906,1583,10,N,Y,1448322514970,220165,221397
MASONB.txt,210688,212079,1391,10,N,Y,1448314503640,180207,180355
MASONB.txt,210778,212192,1414,10,N,Y,1448314503640,180207,180355
MASONB.txt,210792,212206,1414,10,N,Y,1448314503640,180207,180355
MASONB.txt,210834,212336,1502,10,N,Y,1448314503640,180207,180355
MASONB.txt,211091,212470,1379,10,N,Y,1448314503640,180207,180355
MASONB.txt,211290,212665,1375,10,N,Y,1448314503640,180207,180355
MASONB.txt,211413,212771,1358,10,N,Y,1448314503640,180207,180355
MASONB.txt,211652,212973,1321,10,N,Y,1448314503640,180207,180355
MASONB.txt,211731,213030,1299,10,N,Y,1448314503640,180207,180355
MASONB.txt,211907,213117,1210,10,N,Y,1448314503640,180207,180355
MASONB.txt,212080,213570,1490,10,Y,Y,1448314503640,180207,180355
MASONB.txt,212193,213578,1385,10,Y,Y,1448314503640,180207,180355
MASONB.txt,212207,213770,1563,10,Y,Y,1448314503640,180207,180355
MASONB.txt,212338,213777,1439,10,Y,Y,1448314503640,180207,180355
MASONB.txt,212471,213910,1439,10,N,Y,1448314503640,180207,180355
MASONB.txt,212666,214024,1358,10,N,Y,1448314503640,180207,180355
MASONB.txt,212773,214055,1282,10,N,Y,1448314402792,179959,180202
MASONB.txt,212976,214072,1096,10,N,Y,1448314402792,179959,180202
MASONB.txt,213032,214092,1060,10,N,Y,1448314402792,179959,180202
MASONB.txt,213118,214116,998,10,N,Y,1448314402792,179959,180202
MASONB.txt,213571,214155,584,10,N,Y,1448314402792,179959,180202
MASONB.txt,213579,214199,620,10,N,Y,1448314402792,179959,180202
MASONB.txt,213773,214313,540,10,N,Y,1448314402792,179959,180202
MASONB.txt,213778,214430,652,10,N,Y,1448314402792,179959,180202
MASONB.txt,213911,214636,725,10,N,Y,1448314402792,179959,180202
MASONB.txt,214029,214689,660,10,N,N,-,-1,-1
MASONB.txt,214060,214876,816,10,N,N,-,-1,-1
MASONB.txt,214075,215098,1023,10,N,N,-,-1,-1
MASONB.txt,214095,215260,1165,10,N,N,-,-1,-1
MASONB.txt,214119,215424,1305,10,N,N,-,-1,-1
MASONB.txt,214156,215571,1415,10,N,N,-,-1,-1
MASONB.txt,214200,215630,1430,10,N,N,-,-1,-1
MASONB.txt,214314,215904,1590,10,N,N,-,-1,-1
MASONB.txt,214431,215932,1501,10,N,N,-,-1,-1
MASONB.txt,214637,216069,1432,10,N,N,-,-1,-1
MASONB.txt,214690,216199,1509,10,N,N,-,-1,-1
MASONB.txt,214877,216659,1782,10,N,N,-,-1,-1
MASONB.txt,215099,216932,1833,10,N,N,-,-1,-1
MASONB.txt,215261,218251,2990,10,N,N,-,-1,-1
MASONB.txt,215425,218357,2932,10,N,N,-,-1,-1
MASONB.txt,215573,218612,3039,10,N,N,-,-1,-1
MASONB.txt,215632,218886,3254,10,N,N,-,-1,-1
MASONB.txt,215905,219078,3173,10,N,N,-,-1,-1
MASONB.txt,215933,219230,3297,10,N,N,-,-1,-1
MASONB.txt,216070,219334,3264,10,N,Y,1448276340407,30017,39003
MASONB.txt,216200,219546,3346,10,N,Y,1448276340407,30017,39003
MASONB.txt,216660,219672,3012,10,N,Y,1448276340407,30017,39003
MASONB.txt,216933,219937,3004,10,N,Y,1448276340407,30017,39003
MASONB.txt,218252,220059,1807,10,N,Y,1448276340407,30017,39003
MASONB.txt,218358,220146,1788,10,N,Y,1448276340407,30017,39003
MASONB.txt,218613,220189,1576,10,N,Y,1448282044001,101941,102395
MASONB.txt,218887,220306,1419,10,N,Y,1448282044001,101941,102395
MASONB.txt,219079,220419,1340,10,N,Y,1448282044001,101941,102395
MASONB.txt,219233,220581,1348,10,N,Y,1448282044001,101941,102395
MASONB.txt,219335,220876,1541,10,Y,Y,1448282044001,101941,102395
MASONB.txt,219548,221050,1502,10,Y,Y,1448282044001,101941,102395
MASONB.txt,219674,221178,1504,10,N,Y,1448282044001,101941,102395
MASONB.txt,219938,221328,1390,10,Y,Y,1448282044001,101941,102395
MASONB.txt,220060,221421,1361,10,Y,Y,1448282044001,101941,102395
MASONB.txt,220149,221527,1378,10,Y,Y,1448282044001,101941,102395
MASONB.txt,220190,221559,1369,10,Y,Y,1448282044001,101941,102395
MASONB.txt,220307,221577,1270,10,Y,Y,1448282044001,101941,102395
MASONB.txt,220420,221621,1201,10,Y,Y,1448282044001,101941,102395
MASONB.txt,220582,221646,1064,10,Y,Y,1448282044001,101941,102395
MASONB.txt,220877,221711,834,10,N,Y,1448282044001,101941,102395
MASONB.txt,221051,221920,869,10,N,Y,1448282044001,101941,102395
MASONB.txt,221179,222068,889,10,N,Y,1448282044001,101941,102395
MASONB.txt,221329,222179,850,10,N,Y,1448282044001,101941,102395
MASONB.txt,221424,222269,845,10,N,Y,1448287306770,114686,120152
MASONB.txt,221535,222412,877,10,N,Y,1448287306770,114686,120152
MASONB.txt,221564,222586,1022,10,N,Y,1448287306770,114686,120152
MASONB.txt,221580,222852,1272,10,N,Y,1448287306770,114686,120152
MASONB.txt,221624,223042,1418,10,N,Y,1448287306770,114686,120152
MASONB.txt,221649,223375,1726,10,Y,Y,1448287306770,114686,120152
MASONB.txt,221713,223494,1781,10,Y,Y,1448287306770,114686,120152
MASONB.txt,221921,223713,1792,10,Y,Y,1448287306770,114686,120152
MASONB.txt,222069,223957,1888,10,Y,Y,1448287306770,114686,120152
MASONB.txt,222180,224031,1851,10,Y,Y,1448287306770,114686,120152
MASONB.txt,222270,224250,1980,10,Y,Y,1448287306770,114686,120152
MASONB.txt,222413,224315,1902,10,Y,Y,1448287306770,114686,120152
MASONB.txt,222587,224389,1802,10,Y,Y,1448287306770,114686,120152
MASONB.txt,222854,224482,1628,10,Y,Y,1448287306770,114686,120152
MASONB.txt,223044,224702,1658,10,Y,N,-,-1,-1
MASONB.txt,223376,224848,1472,10,Y,N,-,-1,-1
MASONB.txt,223495,225021,1526,10,Y,N,-,-1,-1
MASONB.txt,223714,225030,1316,10,Y,N,-,-1,-1
MASONB.txt,223959,225240,1281,10,N,N,-,-1,-1
MASONB.txt,224032,225421,1389,10,Y,N,-,-1,-1
MASONB.txt,224251,225652,1401,10,N,N,-,-1,-1
MASONB.txt,224315,225902,1587,10,N,N,-,-1,-1
MASONB.txt,224392,226078,1686,10,N,N,-,-1,-1
MASONB.txt,224483,226251,1768,10,N,N,-,-1,-1
MASONB.txt,224704,226394,1690,10,N,N,-,-1,-1
MASONB.txt,224849,226624,1775,10,N,N,-,-1,-1
MASONB.txt,225022,226662,1640,10,N,N,-,-1,-1
MASONB.txt,225031,226681,1650,10,N,N,-,-1,-1
MASONB.txt,225241,226741,1500,10,N,N,-,-1,-1
MASONB.txt,225424,226765,1341,10,N,N,-,-1,-1
MASONB.txt,225655,226856,1201,10,N,N,-,-1,-1
MASONB.txt,225903,226967,1064,10,N,N,-,-1,-1
MASONB.txt,226079,227045,966,10,N,N,-,-1,-1
MASONB.txt,226252,227096,844,10,N,N,-,-1,-1
MASONB.txt,226395,227393,998,10,N,Y,1448314192885,179720,179950
MASONB.txt,226624,227637,1013,10,N,Y,1448314192885,179720,179950
MASONB.txt,226667,227791,1124,10,N,Y,1448322273366,219239,219544
MASONB.txt,226686,227858,1172,10,N,Y,1448322273366,219239,219544
MASONB.txt,226744,227875,1131,10,N,Y,1448322273366,219239,219544
MASONB.txt,226768,227964,1196,10,N,Y,1448322273366,219239,219544
MASONB.txt,226857,228056,1199,10,N,Y,1448322273366,219239,219544
MASONB.txt,226968,228162,1194,10,N,Y,1448322273366,219239,219544
MASONB.txt,227046,228313,1267,10,N,Y,1448322273366,219239,219544
MASONB.txt,227097,228429,1332,10,N,Y,1448322273366,219239,219544
MASONB.txt,227394,228499,1105,10,N,Y,1448322273366,219239,219544
MASONB.txt,227640,228698,1058,10,N,Y,1448322273366,219239,219544
MASONB.txt,227792,228821,1029,10,N,N,-,-1,-1
MASONB.txt,227859,228928,1069,10,N,N,-,-1,-1
MASONB.txt,227876,229017,1141,10,N,N,-,-1,-1
MASONB.txt,227965,229108,1143,10,N,N,-,-1,-1
MASONB.txt,228057,229200,1143,10,N,N,-,-1,-1
MASONB.txt,228163,229252,1089,10,N,N,-,-1,-1
MASONB.txt,228316,229322,1006,10,N,N,-,-1,-1
MASONB.txt,228430,229477,1047,10,N,N,-,-1,-1
MASONB.txt,228501,229592,1091,10,N,N,-,-1,-1
MASONB.txt,228699,229880,1181,10,N,N,-,-1,-1
MASONB.txt,228822,229970,1148,10,N,N,-,-1,-1
MASONB.txt,228930,230090,1160,10,N,N,-,-1,-1
MASONB.txt,229020,230222,1202,10,N,N,-,-1,-1
MASONB.txt,229109,230271,1162,10,N,Y,1448321627053,211159,212725
MASONB.txt,229201,230538,1337,10,N,Y,1448321627053,211159,212725
MASONB.txt,229253,230664,1411,10,N,Y,1448278147591,54631,55869
MASONB.txt,229323,230893,1570,10,N,Y,1448278147591,54631,55869
MASONB.txt,229480,231010,1530,10,N,Y,1448278147591,54631,55869
MASONB.txt,229593,231022,1429,10,N,Y,1448278147591,54631,55869
MASONB.txt,229881,231139,1258,10,N,Y,1448278147591,54631,55869
MASONB.txt,229971,231171,1200,10,N,Y,1448278147591,54631,55869
MASONB.txt,230091,231267,1176,10,N,Y,1448278147591,54631,55869
MASONB.txt,230225,231362,1137,10,N,Y,1448278147591,54631,55869
MASONB.txt,230272,231475,1203,10,N,Y,1448278147591,54631,55869
MASONB.txt,230539,231674,1135,10,N,Y,1448278147591,54631,55869
MASONB.txt,230665,231823,1158,10,N,Y,1448278147591,54631,55869
MASONB.txt,230894,231931,1037,10,N,Y,1448278147591,54631,55869
MASONB.txt,231011,232082,1071,10,Y,Y,1448278147591,54631,55869
MASONB.txt,231023,232203,1180,10,Y,Y,1448278147591,54631,55869
MASONB.txt,231140,232568,1428,10,Y,Y,1448286880729,112151,113274
MASONB.txt,231174,232743,1569,10,Y,Y,1448286880729,112151,113274
MASONB.txt,231268,232844,1576,10,Y,Y,1448286880729,112151,113274
MASONB.txt,231364,232959,1595,10,Y,Y,1448286880729,112151,113274
MASONB.txt,231476,233030,1554,10,Y,Y,1448286880729,112151,113274
MASONB.txt,231675,233170,1495,10,Y,Y,1448286880729,112151,113274
MASONB.txt,231824,233273,1449,10,Y,Y,1448286880729,112151,113274
MASONB.txt,231933,233539,1606,10,Y,Y,1448286880729,112151,113274
MASONB.txt,232083,233678,1595,10,Y,Y,1448286880729,112151,113274
MASONB.txt,232204,234051,1847,10,Y,Y,1448286880729,112151,113274
MASONB.txt,232569,234199,1630,10,Y,Y,1448286880729,112151,113274
MASONB.txt,232744,234365,1621,10,Y,Y,1448325046337,230539,231128
MASONB.txt,232845,234403,1558,10,Y,Y,1448325046337,230539,231128
MASONB.txt,232960,234585,1625,10,Y,Y,1448325046337,230539,231128
MASONB.txt,233033,234675,1642,10,Y,Y,1448325046337,230539,231128
MASONB.txt,233171,234694,1523,10,Y,Y,1448325046337,230539,231128
MASONB.txt,233274,234714,1440,10,Y,Y,1448325046337,230539,231128
MASONB.txt,233542,234736,1194,10,N,Y,1448325046337,230539,231128
MASONB.txt,233679,234960,1281,10,N,Y,1448325046337,230539,231128
MASONB.txt,234052,235099,1047,10,N,Y,1448325046337,230539,231128
MASONB.txt,234202,235282,1080,10,N,Y,1448325046337,230539,231128
MASONB.txt,234366,235584,1218,10,N,Y,1448325046337,230539,231128
MASONB.txt,234406,235698,1292,10,N,Y,1448315841759,183531,183799
MASONB.txt,234588,236059,1471,10,N,Y,1448315841759,183531,183799
MASONB.txt,234676,236200,1524,10,N,Y,1448315841759,183531,183799
MASONB.txt,234697,236447,1750,10,N,Y,1448315841759,183531,183799
MASONB.txt,234717,236521,1804,10,N,Y,1448315841759,183531,183799
MASONB.txt,234739,236588,1849,10,N,Y,1448315841759,183531,183799
MASONB.txt,234961,236947,1986,10,N,Y,1448315841759,183531,183799
MASONB.txt,235100,237025,1925,10,N,Y,1448315841759,183531,183799
MASONB.txt,235283,237196,1913,10,N,Y,1448315841759,183531,183799
MASONB.txt,235585,237390,1805,10,N,Y,1448315841759,183531,183799
MASONB.txt,235701,237406,1705,10,N,Y,1448315841759,183531,183799
MASONB.txt,236060,237438,1378,10,N,N,-,-1,-1
MASONB.txt,236201,237467,1266,10,N,N,-,-1,-1
MASONB.txt,236450,237560,1110,10,N,N,-,-1,-1
MASONB.txt,236522,237687,1165,10,N,N,-,-1,-1
MASONB.txt,236589,237786,1197,10,N,N,-,-1,-1
MASONB.txt,236950,238027,1077,10,N,N,-,-1,-1
MASONB.txt,237026,238047,1021,10,N,N,-,-1,-1
MASONB.txt,237197,238152,955,10,N,N,-,-1,-1
MASONB.txt,237395,238225,830,10,N,N,-,-1,-1
MASONB.txt,237409,238454,1045,10,Y,N,-,-1,-1
MASONB.txt,237443,238621,1178,10,Y,Y,1448360140810,268069,269800
MASONB.txt,237470,238849,1379,10,Y,Y,1448360140810,268069,269800
MASONB.txt,237561,238996,1435,10,Y,Y,1448360140810,268069,269800
MASONB.txt,237688,239057,1369,10,Y,Y,1448360140810,268069,269800
MASONB.txt,237787,239323,1536,10,Y,Y,1448360140810,268069,269800
MASONB.txt,238028,239466,1438,10,Y,Y,1448360140810,268069,269800
MASONB.txt,238048,239531,1483,10,Y,Y,1448360140810,268069,269800
MASONB.txt,238153,239590,1437,10,Y,Y,1448360140810,268069,269800
MASONB.txt,238226,240019,1793,10,Y,Y,1448360140810,268069,269800
MASONB.txt,238455,240068,1613,10,Y,Y,1448360140810,268069,269800
MASONB.txt,238623,240105,1482,10,Y,Y,1448360140810,268069,269800
MASONB.txt,238850,240151,1301,10,Y,Y,1448360140810,268069,269800
MASONB.txt,238998,240232,1234,10,N,Y,1448360140810,268069,269800
MASONB.txt,239059,240406,1347,10,N,Y,1448360140810,268069,269800
MASONB.txt,239324,240518,1194,10,N,Y,1448360140810,268069,269800
MASONB.txt,239467,240752,1285,10,Y,Y,1448360140810,268069,269800
MASONB.txt,239532,240881,1349,10,Y,Y,1448360140810,268069,269800
MASONB.txt,239591,240922,1331,10,Y,Y,1448360140810,268069,269800
MASONB.txt,240020,241070,1050,10,N,Y,1448360140810,268069,269800
MASONB.txt,240073,241072,999,10,N,Y,1448366290289,275380,275651
MASONB.txt,240108,241177,1069,10,N,Y,1448366290289,275380,275651
MASONB.txt,240152,241400,1248,10,N,Y,1448366290289,275380,275651
MASONB.txt,240234,241598,1364,10,N,Y,1448366290289,275380,275651
MASONB.txt,240407,241615,1208,10,N,Y,1448366290289,275380,275651
MASONB.txt,240519,241636,1117,10,N,Y,1448366290289,275380,275651
MASONB.txt,240753,241689,936,10,N,Y,1448366290289,275380,275651
MASONB.txt,240882,241713,831,10,N,Y,1448366290289,275380,275651
MASONB.txt,240925,241794,869,10,N,N,-,-1,-1
MASONB.txt,241071,241876,805,10,N,N,-,-1,-1
MASONB.txt,241073,241979,906,10,N,N,-,-1,-1
MASONB.txt,241178,242063,885,10,N,N,-,-1,-1
MASONB.txt,241401,242214,813,10,N,N,-,-1,-1
MASONB.txt,241603,242391,788,10,N,N,-,-1,-1
MASONB.txt,241616,242520,904,10,N,N,-,-1,-1
MASONB.txt,241639,242583,944,10,N,N,-,-1,-1
MASONB.txt,241692,242712,1020,10,N,N,-,-1,-1
MASONB.txt,241716,242972,1256,10,N,N,-,-1,-1
MASONB.txt,241795,243144,1349,10,N,N,-,-1,-1
MASONB.txt,241877,243248,1371,10,N,N,-,-1,-1
MASONB.txt,241980,243395,1415,10,N,N,-,-1,-1
MASONB.txt,242064,243559,1495,10,N,N,-,-1,-1
MASONB.txt,242215,243908,1693,10,Y,N,-,-1,-1
MASONB.txt,242392,244011,1619,10,Y,N,-,-1,-1
MASONB.txt,242521,244149,1628,10,Y,N,-,-1,-1
MASONB.txt,242584,244325,1741,10,Y,N,-,-1,-1
MASONB.txt,242713,244521,1808,10,Y,N,-,-1,-1
MASONB.txt,242973,244664,1691,10,Y,N,-,-1,-1
MASONB.txt,243145,244961,1816,10,Y,N,-,-1,-1
MASONB.txt,243250,245007,1757,10,N,N,-,-1,-1
MASONB.txt,243398,245130,1732,10,N,N,-,-1,-1
MASONB.txt,243560,245333,1773,10,N,N,-,-1,-1
MASONB.txt,243911,245546,1635,10,N,N,-,-1,-1
MASONB.txt,244012,245630,1618,10,N,N,-,-1,-1
MASONB.txt,244150,245648,1498,10,N,N,-,-1,-1
MASONB.txt,244326,245758,1432,10,N,N,-,-1,-1
MASONB.txt,244522,245782,1260,10,N,N,-,-1,-1
MASONB.txt,244667,245921,1254,10,N,N,-,-1,-1
MASONB.txt,244964,246015,1051,10,N,N,-,-1,-1
MASONB.txt,245008,246260,1252,10,N,N,-,-1,-1
MASONB.txt,245131,246427,1296,10,N,N,-,-1,-1
MASONB.txt,245334,246458,1124,10,N,N,-,-1,-1
MASONB.txt,245548,246626,1078,10,N,N,-,-1,-1
MASONB.txt,245635,246662,1027,10,N,N,-,-1,-1
MASONB.txt,245653,246766,1113,10,N,N,-,-1,-1
MASONB.txt,245761,246847,1086,10,N,N,-,-1,-1
MASONB.txt,245785,246864,1079,10,N,N,-,-1,-1
MASONB.txt,245922,247023,1101,10,N,N,-,-1,-1
MASONB.txt,246016,247126,1110,10,N,Y,1448367229258,278623,278697
MASONB.txt,246261,247311,1050,10,N,Y,1448367229258,278623,278697
MASONB.txt,246428,247373,945,10,N,Y,1448367229258,278623,278697
MASONB.txt,246459,247513,1054,10,N,Y,1448367229258,278623,278697
MASONB.txt,246627,247612,985,10,N,Y,1448367229258,278623,278697
MASONB.txt,246663,247749,1086,10,N,Y,1448367229258,278623,278697
MASONB.txt,246767,247899,1132,10,N,Y,1448367229258,278623,278697
MASONB.txt,246852,247957,1105,10,N,Y,1448367229258,278623,278697
MASONB.txt,246867,248198,1331,10,N,Y,1448367229258,278623,278697
MASONB.txt,247024,248302,1278,10,N,Y,1448367229258,278623,278697
MASONB.txt,247127,248517,1390,10,N,Y,1448367229258,278623,278697
MASONB.txt,247312,248772,1460,10,N,Y,1448367229258,278623,278697
MASONB.txt,247374,248890,1516,10,N,Y,1448367229258,278623,278697
MASONB.txt,247514,249067,1553,10,N,Y,1448367229258,278623,278697
MASONB.txt,247613,249193,1580,10,N,Y,1448367229258,278623,278697
MASONB.txt,247750,249274,1524,10,Y,Y,1448367229258,278623,278697
MASONB.txt,247900,249364,1464,10,Y,Y,1448367229258,278623,278697
MASONB.txt,247958,249577,1619,10,Y,Y,1448367229258,278623,278697
MASONB.txt,248199,249629,1430,10,Y,Y,1448367229258,278623,278697
MASONB.txt,248304,249785,1481,10,Y,Y,1448367229258,278623,278697
MASONB.txt,248518,249969,1451,10,Y,Y,1448367229258,278623,278697
MASONB.txt,248773,250111,1338,10,N,Y,1448367229258,278623,278697
MASONB.txt,248891,250166,1275,10,N,Y,1448367229258,278623,278697
MASONB.txt,249068,250292,1224,10,N,Y,1448367229258,278623,278697
MASONB.txt,249194,250616,1422,10,N,Y,1448367229258,278623,278697
MASONB.txt,249277,250685,1408,10,N,N,-,-1,-1
MASONB.txt,249365,250773,1408,10,N,N,-,-1,-1
MASONB.txt,249578,250940,1362,10,N,N,-,-1,-1
MASONB.txt,249630,251177,1547,10,N,N,-,-1,-1
MASONB.txt,249788,251284,1496,10,N,N,-,-1,-1
MASONB.txt,249970,251381,1411,10,N,N,-,-1,-1
MASONB.txt,250112,251447,1335,10,N,N,-,-1,-1
MASONB.txt,250167,251523,1356,10,N,N,-,-1,-1
MASONB.txt,250293,251683,1390,10,N,N,-,-1,-1
MASONB.txt,250619,251706,1087,10,N,N,-,-1,-1
MASONB.txt,250686,251784,1098,10,N,N,-,-1,-1
MASONB.txt,250776,251813,1037,10,N,N,-,-1,-1
MASONB.txt,250941,251900,959,10,N,N,-,-1,-1
MASONB.txt,251180,251935,755,10,N,N,-,-1,-1
MASONB.txt,251285,252024,739,10,N,N,-,-1,-1
MASONB.txt,251382,252214,832,10,N,N,-,-1,-1
MASONB.txt,251448,252290,842,10,N,N,-,-1,-1
MASONB.txt,251524,252321,797,10,N,N,-,-1,-1
MASONB.txt,251688,252505,817,10,N,N,-,-1,-1
MASONB.txt,251707,252720,1013,10,N,N,-,-1,-1
MASONB.txt,251787,252828,1041,10,N,N,-,-1,-1
MASONB.txt,251816,252926,1110,10,N,N,-,-1,-1
MASONB.txt,251901,253015,1114,10,N,N,-,-1,-1
MASONB.txt,251936,253064,1128,10,N,N,-,-1,-1
MASONB.txt,252025,253129,1104,10,N,N,-,-1,-1
MASONB.txt,252215,253277,1062,10,N,N,-,-1,-1
MASONB.txt,252291,253367,1076,10,N,N,-,-1,-1
MASONB.txt,252322,253413,1091,10,N,N,-,-1,-1
MASONB.txt,252506,253434,928,10,N,N,-,-1,-1
MASONB.txt,252721,253490,769,10,N,N,-,-1,-1
MASONB.txt,252829,253572,743,10,N,N,-,-1,-1
MASONB.txt,252927,253748,821,10,N,N,-,-1,-1
MASONB.txt,253016,253868,852,10,N,N,-,-1,-1
MASONB.txt,253065,253957,892,10,N,N,-,-1,-1
MASONB.txt,253130,254046,916,10,N,N,-,-1,-1
MASONB.txt,253278,254258,980,10,N,N,-,-1,-1
MASONB.txt,253368,254365,997,10,N,N,-,-1,-1
MASONB.txt,253414,254590,1176,10,N,N,-,-1,-1
MASONB.txt,253435,254793,1358,10,N,N,-,-1,-1
MASONB.txt,253491,254811,1320,10,N,N,-,-1,-1
MASONB.txt,253573,254891,1318,10,N,N,-,-1,-1
MASONB.txt,253751,254919,1168,10,N,N,-,-1,-1
MASONB.txt,253869,255018,1149,10,N,N,-,-1,-1
MASONB.txt,253958,255171,1213,10,N,N,-,-1,-1
MASONB.txt,254049,255363,1314,10,N,N,-,-1,-1
MASONB.txt,254261,255511,1250,10,N,N,-,-1,-1
MASONB.txt,254366,255589,1223,10,N,N,-,-1,-1
MASONB.txt,254593,255740,1147,10,N,N,-,-1,-1
MASONB.txt,254798,255838,1040,10,N,N,-,-1,-1
MASONB.txt,254816,255956,1140,10,N,N,-,-1,-1
MASONB.txt,254894,256164,1270,10,N,N,-,-1,-1
MASONB.txt,254922,256398,1476,10,N,N,-,-1,-1
MASONB.txt,255019,256528,1509,10,N,N,-,-1,-1
MASONB.txt,255173,256660,1487,10,N,N,-,-1,-1
MASONB.txt,255364,256762,1398,10,N,N,-,-1,-1
MASONB.txt,255512,256974,1462,10,N,N,-,-1,-1
MASONB.txt,255592,257041,1449,10,N,N,-,-1,-1
MASONB.txt,255741,257332,1591,10,N,N,-,-1,-1
MASONB.txt,255839,257433,1594,10,N,N,-,-1,-1
MASONB.txt,255957,257584,1627,10,N,N,-,-1,-1
MASONB.txt,256165,257702,1537,10,N,N,-,-1,-1
MASONB.txt,256401,257799,1398,10,N,N,-,-1,-1
MASONB.txt,256529,257825,1296,10,N,N,-,-1,-1
MASONB.txt,256661,257927,1266,10,N,N,-,-1,-1
MASONB.txt,256763,258005,1242,10,N,N,-,-1,-1
MASONB.txt,256975,258425,1450,10,N,N,-,-1,-1
MASONB.txt,257042,258522,1480,10,N,N,-,-1,-1
MASONB.txt,257335,258812,1477,10,N,N,-,-1,-1
MASONB.txt,257434,259109,1675,10,N,N,-,-1,-1
MASONB.txt,257586,259228,1642,10,N,N,-,-1,-1
MASONB.txt,257703,259314,1611,10,N,N,-,-1,-1
MASONB.txt,257804,259591,1787,10,N,N,-,-1,-1
MASONB.txt,257828,259715,1887,10,N,N,-,-1,-1
MASONB.txt,257928,259839,1911,10,N,N,-,-1,-1
MASONB.txt,258006,259938,1932,10,N,N,-,-1,-1
MASONB.txt,258426,260117,1691,10,N,N,-,-1,-1
MASONB.txt,258523,260203,1680,10,N,N,-,-1,-1
MASONB.txt,258813,260289,1476,10,N,N,-,-1,-1
MASONB.txt,259112,260449,1337,10,N,N,-,-1,-1
MASONB.txt,259229,260601,1372,10,N,N,-,-1,-1
MASONB.txt,259314,260684,1370,10,N,N,-,-1,-1
MASONB.txt,259592,260690,1098,10,N,N,-,-1,-1
MASONB.txt,259716,260854,1138,10,N,N,-,-1,-1
MASONB.txt,259840,260909,1069,10,N,N,-,-1,-1
MASONB.txt,259939,260949,1010,10,N,N,-,-1,-1
MASONB.txt,260118,261029,911,10,N,N,-,-1,-1
MASONB.txt,260204,261054,850,10,N,N,-,-1,-1
MASONB.txt,260291,261241,950,10,N,N,-,-1,-1
MASONB.txt,260450,261403,953,10,N,N,-,-1,-1
MASONB.txt,260603,261442,839,10,N,N,-,-1,-1
MASONB.txt,260684,261465,781,10,N,N,-,-1,-1
MASONB.txt,260691,261620,929,10,N,N,-,-1,-1
MASONB.txt,260855,261743,888,10,N,N,-,-1,-1
MASONB.txt,260912,261817,905,10,N,N,-,-1,-1
MASONB.txt,260950,261836,886,10,N,N,-,-1,-1
MASONB.txt,261030,262102,1072,10,N,N,-,-1,-1
MASONB.txt,261057,262119,1062,10,N,N,-,-1,-1
MASONB.txt,261242,262254,1012,10,N,N,-,-1,-1
MASONB.txt,261404,262282,878,10,N,N,-,-1,-1
MASONB.txt,261443,262390,947,10,N,N,-,-1,-1
MASONB.txt,261466,262626,1160,10,N,N,-,-1,-1
MASONB.txt,261621,262797,1176,10,N,N,-,-1,-1
MASONB.txt,261744,262832,1088,10,N,Y,1448393918391,289044,290517
MASONB.txt,261822,262900,1078,10,N,Y,1448393918391,289044,290517
MASONB.txt,261839,263081,1242,10,N,Y,1448393918391,289044,290517
MASONB.txt,262107,263142,1035,10,N,Y,1448393918391,289044,290517
MASONB.txt,262122,263289,1167,10,N,Y,1448393918391,289044,290517
MASONB.txt,262257,263400,1143,10,N,Y,1448393918391,289044,290517
MASONB.txt,262285,263423,1138,10,N,Y,1448393918391,289044,290517
MASONB.txt,262391,263496,1105,10,N,Y,1448393918391,289044,290517
MASONB.txt,262627,263573,946,10,N,Y,1448393918391,289044,290517
MASONB.txt,262800,263635,835,10,N,Y,1448393918391,289044,290517
MASONB.txt,262833,263733,900,10,N,Y,1448393918391,289044,290517
MASONB.txt,262901,263850,949,10,N,Y,1448393918391,289044,290517
MASONB.txt,263084,263955,871,10,N,N,-,-1,-1
MASONB.txt,263144,264051,907,10,N,N,-,-1,-1
MASONB.txt,263290,264161,871,10,N,N,-,-1,-1
MASONB.txt,263401,264381,980,10,N,N,-,-1,-1
MASONB.txt,263424,264449,1025,10,N,N,-,-1,-1
MASONB.txt,263497,264662,1165,10,N,N,-,-1,-1
MASONB.txt,263574,264818,1244,10,Y,N,-,-1,-1
MASONB.txt,263636,264963,1327,10,Y,N,-,-1,-1
MASONB.txt,263734,265042,1308,10,Y,N,-,-1,-1
MASONB.txt,263851,265166,1315,10,Y,N,-,-1,-1
MASONB.txt,263957,265206,1249,10,Y,N,-,-1,-1
MASONB.txt,264052,265357,1305,10,N,N,-,-1,-1
MASONB.txt,264162,265424,1262,10,N,N,-,-1,-1
MASONB.txt,264382,265545,1163,10,N,N,-,-1,-1
MASONB.txt,264451,265701,1250,10,N,Y,1448369133400,279084,280004
MASONB.txt,264663,265782,1119,10,N,Y,1448369133400,279084,280004
MASONB.txt,264820,265790,970,10,N,Y,1448369133400,279084,280004
MASONB.txt,264964,265904,940,10,N,Y,1448314706721,180385,181191
MASONB.txt,265045,266213,1168,10,N,Y,1448314706721,180385,181191
MASONB.txt,265168,266306,1138,10,N,Y,1448314706721,180385,181191
MASONB.txt,265209,266403,1194,10,N,Y,1448314706721,180385,181191
MASONB.txt,265360,266468,1108,10,N,Y,1448314706721,180385,181191
MASONB.txt,265425,266654,1229,10,N,Y,1448314706721,180385,181191
MASONB.txt,265548,266738,1190,10,N,Y,1448314706721,180385,181191
MASONB.txt,265702,267121,1419,10,N,Y,1448314706721,180385,181191
MASONB.txt,265783,267348,1565,10,N,Y,1448314706721,180385,181191
MASONB.txt,265791,267455,1664,10,N,Y,1448314706721,180385,181191
MASONB.txt,265905,267459,1554,10,N,Y,1448314706721,180385,181191
MASONB.txt,266214,267575,1361,10,N,Y,1448314706721,180385,181191
MASONB.txt,266306,267734,1428,10,N,Y,1448314706721,180385,181191
MASONB.txt,266404,267834,1430,10,N,Y,1448314706721,180385,181191
MASONB.txt,266469,268054,1585,10,N,Y,1448314706721,180385,181191
MASONB.txt,266655,268227,1572,10,N,Y,1448314706721,180385,181191
MASONB.txt,266739,268451,1712,10,N,Y,1448314706721,180385,181191
MASONB.txt,267123,268686,1563,10,N,Y,1448366107348,271942,274308
MASONB.txt,267349,268821,1472,10,N,Y,1448366107348,271942,274308
MASONB.txt,267458,269191,1733,10,N,Y,1448366107348,271942,274308
MASONB.txt,267460,269406,1946,10,N,Y,1448366107348,271942,274308
MASONB.txt,267576,269433,1857,10,N,Y,1448366107348,271942,274308
MASONB.txt,267735,269522,1787,10,N,Y,1448366107348,271942,274308
MASONB.txt,267836,269806,1970,10,N,Y,1448366107348,271942,274308
MASONB.txt,268055,269959,1904,10,N,Y,1448366107348,271942,274308
MASONB.txt,268228,270212,1984,10,N,Y,1448366107348,271942,274308
MASONB.txt,268452,270311,1859,10,N,Y,1448366107348,271942,274308
MASONB.txt,268687,270382,1695,10,N,Y,1448366107348,271942,274308
MASONB.txt,268822,270645,1823,10,N,Y,1448366107348,271942,274308
MASONB.txt,269192,270695,1503,10,N,Y,1448366107348,271942,274308
MASONB.txt,269409,271140,1731,10,N,Y,1448366107348,271942,274308
MASONB.txt,269434,271281,1847,10,N,Y,1448366107348,271942,274308
MASONB.txt,269523,271419,1896,10,Y,Y,1448366107348,271942,274308
MASONB.txt,269807,271577,1770,10,Y,Y,1448396118064,295199,297352
MASONB.txt,269960,271725,1765,10,Y,Y,1448396118064,295199,297352
MASONB.txt,270215,271743,1528,10,Y,Y,1448396118064,295199,297352
MASONB.txt,270312,271893,1581,10,Y,Y,1448396118064,295199,297352
MASONB.txt,270383,271927,1544,10,Y,Y,1448396118064,295199,297352
MASONB.txt,270646,272078,1432,10,Y,Y,1448322095209,213778,214023
MASONB.txt,270696,272149,1453,10,Y,Y,1448322095209,213778,214023
MASONB.txt,271141,272386,1245,10,Y,Y,1448322095209,213778,214023
MASONB.txt,271283,272630,1347,10,Y,Y,1448322095209,213778,214023
MASONB.txt,271420,272710,1290,10,N,Y,1448322095209,213778,214023
MASONB.txt,271578,272794,1216,10,N,Y,1448322095209,213778,214023
MASONB.txt,271730,272905,1175,10,N,Y,1448322095209,213778,214023
MASONB.txt,271748,272973,1225,10,N,Y,1448322095209,213778,214023
MASONB.txt,271896,273069,1173,10,N,Y,1448322095209,213778,214023
MASONB.txt,271930,273121,1191,10,N,Y,1448322095209,213778,214023
MASONB.txt,272079,273208,1129,10,N,Y,1448322095209,213778,214023
MASONB.txt,272150,273374,1224,10,N,Y,1448322095209,213778,214023
MASONB.txt,272387,273404,1017,10,N,Y,1448322095209,213778,214023
MASONB.txt,272631,273504,873,10,N,Y,1448322095209,213778,214023
MASONB.txt,272711,273639,928,10,N,Y,1448322095209,213778,214023
MASONB.txt,272796,273748,952,10,N,Y,1448322095209,213778,214023
MASONB.txt,272906,273796,890,10,N,Y,1448322095209,213778,214023
MASONB.txt,272974,273851,877,10,N,Y,1448322095209,213778,214023
MASONB.txt,273070,273940,870,10,N,Y,1448322095209,213778,214023
MASONB.txt,273124,274131,1007,10,N,Y,1448322095209,213778,214023
MASONB.txt,273209,274654,1445,10,Y,Y,1448322095209,213778,214023
MASONB.txt,273375,274831,1456,10,Y,Y,1448322095209,213778,214023
MASONB.txt,273405,275064,1659,10,Y,Y,1448322095209,213778,214023
MASONB.txt,273505,275103,1598,10,Y,Y,1448322095209,213778,214023
MASONB.txt,273640,275379,1739,10,Y,Y,1448322095209,213778,214023
MASONB.txt,273749,275527,1778,10,Y,Y,1448322095209,213778,214023
MASONB.txt,273797,275658,1861,10,Y,Y,1448322095209,213778,214023
MASONB.txt,273852,275892,2040,10,Y,Y,1448357159811,231190,232925
MASONB.txt,273941,276139,2198,10,Y,Y,1448357159811,231190,232925
MASONB.txt,274132,276433,2301,10,Y,Y,1448357159811,231190,232925
MASONB.txt,274655,276579,1924,10,N,Y,1448357159811,231190,232925
MASONB.txt,274832,276707,1875,10,N,Y,1448357159811,231190,232925
MASONB.txt,275065,277052,1987,10,N,Y,1448357159811,231190,232925
MASONB.txt,275104,277150,2046,10,Y,Y,1448357159811,231190,232925
MASONB.txt,275382,277274,1892,10,Y,Y,1448357159811,231190,232925
MASONB.txt,275528,277455,1927,10,Y,Y,1448357159811,231190,232925
MASONB.txt,275661,277556,1895,10,Y,Y,1448357159811,231190,232925
MASONB.txt,275893,277617,1724,10,N,Y,1448313123004,175370,176057
MASONB.txt,276140,277794,1654,10,N,Y,1448313123004,175370,176057
MASONB.txt,276434,277834,1400,10,N,Y,1448313123004,175370,176057
MASONB.txt,276580,278011,1431,10,N,Y,1448313123004,175370,176057
MASONB.txt,276710,278030,1320,10,N,N,-,-1,-1
MASONB.txt,277055,278179,1124,10,N,N,-,-1,-1
MASONB.txt,277151,278202,1051,10,N,N,-,-1,-1
MASONB.txt,277275,278348,1073,10,N,Y,1448366492754,275659,275884
MASONB.txt,277458,278593,1135,10,N,Y,1448287094676,113323,113870
MASONB.txt,277557,278635,1078,10,N,Y,1448287094676,113323,113870
MASONB.txt,277618,278702,1084,10,N,Y,1448287094676,113323,113870
MASONB.txt,277795,278930,1135,10,N,Y,1448287094676,113323,113870
MASONB.txt,277835,279079,1244,10,N,Y,1448287094676,113323,113870
MASONB.txt,278016,279184,1168,10,N,Y,1448287094676,113323,113870
MASONB.txt,278033,279260,1227,10,N,Y,1448287094676,113323,113870
MASONB.txt,278182,279281,1099,10,N,Y,1448287094676,113323,113870
MASONB.txt,278205,279629,1424,10,N,Y,1448287094676,113323,113870
MASONB.txt,278351,279777,1426,10,N,Y,1448287094676,113323,113870
MASONB.txt,278594,279877,1283,10,N,Y,1448313674408,176614,178600
MASONB.txt,278636,280019,1383,10,Y,Y,1448313674408,176614,178600
MASONB.txt,278704,280094,1390,10,Y,Y,1448313674408,176614,178600
MASONB.txt,278931,280304,1373,10,Y,Y,1448313674408,176614,178600
MASONB.txt,279081,280394,1313,10,N,Y,1448313674408,176614,178600
MASONB.txt,279185,280497,1312,10,N,Y,1448313674408,176614,178600
MASONB.txt,279262,280781,1519,10,N,Y,1448313674408,176614,178600
MASONB.txt,279282,281075,1793,10,N,Y,1448313674408,176614,178600
MASONB.txt,279631,281438,1807,10,N,Y,1448313674408,176614,178600
MASONB.txt,279778,281632,1854,10,N,Y,1448313674408,176614,178600
MASONB.txt,279878,281817,1939,10,N,Y,1448313674408,176614,178600
MASONB.txt,280020,282140,2120,10,N,Y,1448394636895,292272,293963
MASONB.txt,280095,282513,2418,10,N,Y,1448359878707,265791,267089
MASONB.txt,280305,282575,2270,10,N,Y,1448359878707,265791,267089
MASONB.txt,280397,282744,2347,10,N,Y,1448359878707,265791,267089
MASONB.txt,280500,283078,2578,10,N,Y,1448359878707,265791,267089
MASONB.txt,280782,283573,2791,10,N,Y,1448359878707,265791,267089
MASONB.txt,281077,283774,2697,10,N,Y,1448359878707,265791,267089
MASONB.txt,281439,283812,2373,10,N,Y,1448359878707,265791,267089
MASONB.txt,281635,283855,2220,10,N,Y,1448359878707,265791,267089
MASONB.txt,281819,283917,2098,10,N,Y,1448359878707,265791,267089
MASONB.txt,282142,284002,1860,10,Y,Y,1448359878707,265791,267089
MASONB.txt,282514,284135,1621,10,Y,Y,1448359878707,265791,267089
MASONB.txt,282576,284202,1626,10,Y,Y,1448357431466,233540,233770
MASONB.txt,282745,284389,1644,10,Y,Y,1448357431466,233540,233770
MASONB.txt,283081,284461,1380,10,Y,Y,1448357431466,233540,233770
MASONB.txt,283574,284536,962,10,N,Y,1448357431466,233540,233770
MASONB.txt,283776,284612,836,10,N,Y,1448357431466,233540,233770
MASONB.txt,283813,284709,896,10,N,Y,1448357431466,233540,233770
MASONB.txt,283856,284826,970,10,N,Y,1448357431466,233540,233770
MASONB.txt,283918,284884,966,10,N,Y,1448357431466,233540,233770
MASONB.txt,284005,285048,1043,10,N,Y,1448357431466,233540,233770
MASONB.txt,284138,285320,1182,10,Y,Y,1448357431466,233540,233770
MASONB.txt,284203,285440,1237,10,Y,Y,1448357431466,233540,233770
MASONB.txt,284390,285539,1149,10,N,Y,1448357431466,233540,233770
MASONB.txt,284464,285742,1278,10,N,Y,1448357431466,233540,233770
MASONB.txt,284537,285802,1265,10,N,Y,1448357431466,233540,233770
MASONB.txt,284615,285852,1237,10,N,N,-,-1,-1
MASONB.txt,284710,285874,1164,10,N,N,-,-1,-1
MASONB.txt,284827,285960,1133,10,N,N,-,-1,-1
MASONB.txt,284885,286115,1230,10,N,N,-,-1,-1
MASONB.txt,285050,286229,1179,10,N,N,-,-1,-1
MASONB.txt,285321,286317,996,10,N,N,-,-1,-1
MASONB.txt,285443,286456,1013,10,N,N,-,-1,-1
MASONB.txt,285540,286655,1115,10,N,N,-,-1,-1
MASONB.txt,285743,286793,1050,10,N,N,-,-1,-1
MASONB.txt,285805,286984,1179,10,N,N,-,-1,-1
MASONB.txt,285853,287304,1451,10,N,N,-,-1,-1
MASONB.txt,285875,287325,1450,10,N,N,-,-1,-1
MASONB.txt,285961,287360,1399,10,N,N,-,-1,-1
MASONB.txt,286116,287420,1304,10,N,N,-,-1,-1
MASONB.txt,286232,287479,1247,10,N,N,-,-1,-1
MASONB.txt,286318,287625,1307,10,N,N,-,-1,-1
MASONB.txt,286457,287645,1188,10,N,N,-,-1,-1
MASONB.txt,286656,287712,1056,10,N,N,-,-1,-1
MASONB.txt,286794,287737,943,10,N,N,-,-1,-1
MASONB.txt,286985,287821,836,10,N,Y,1448368866047,278997,279078
MASONB.txt,287305,287945,640,10,N,Y,1448368866047,278997,279078
MASONB.txt,287326,287996,670,10,N,Y,1448368866047,278997,279078
MASONB.txt,287363,288170,807,10,N,Y,1448368866047,278997,279078
MASONB.txt,287422,288272,850,10,N,Y,1448368866047,278997,279078
MASONB.txt,287482,288410,928,10,N,Y,1448368866047,278997,279078
MASONB.txt,287630,288526,896,10,N,Y,1448368866047,278997,279078
MASONB.txt,287650,288697,1047,10,N,Y,1448368866047,278997,279078
MASONB.txt,287715,288902,1187,10,N,Y,1448368866047,278997,279078
MASONB.txt,287740,289018,1278,10,N,Y,1448368866047,278997,279078
MASONB.txt,287822,289093,1271,10,N,Y,1448316411409,206556,208475
MASONB.txt,287948,289233,1285,10,N,Y,1448316411409,206556,208475
MASONB.txt,287997,289311,1314,10,N,Y,1448316411409,206556,208475
MASONB.txt,288171,289498,1327,10,N,Y,1448316411409,206556,208475
MASONB.txt,288273,289667,1394,10,N,Y,1448316411409,206556,208475
MASONB.txt,288411,289753,1342,10,N,Y,1448316411409,206556,208475
MASONB.txt,288527,289903,1376,10,N,Y,1448316411409,206556,208475
MASONB.txt,288698,289922,1224,10,N,Y,1448316411409,206556,208475
MASONB.txt,288903,290088,1185,10,N,Y,1448316411409,206556,208475
MASONB.txt,289021,290352,1331,10,N,Y,1448316411409,206556,208475
MASONB.txt,289094,290428,1334,10,N,Y,1448316411409,206556,208475
MASONB.txt,289234,290558,1324,10,N,Y,1448316411409,206556,208475
MASONB.txt,289312,290576,1264,10,N,Y,1448316411409,206556,208475
MASONB.txt,289499,290696,1197,10,N,Y,1448316411409,206556,208475
MASONB.txt,289668,290723,1055,10,N,Y,1448316411409,206556,208475
MASONB.txt,289754,290848,1094,10,N,Y,1448316411409,206556,208475
MASONB.txt,289904,290973,1069,10,N,Y,1448316411409,206556,208475
MASONB.txt,289923,291056,1133,10,N,Y,1448316411409,206556,208475
MASONB.txt,290089,291091,1002,10,N,Y,1448316411409,206556,208475
MASONB.txt,290353,291096,743,10,N,Y,1448316411409,206556,208475
MASONB.txt,290429,291160,731,10,N,Y,1448316411409,206556,208475
MASONB.txt,290563,291164,601,10,N,Y,1448394918930,293978,294297
MASONB.txt,290581,291178,597,10,N,Y,1448394918930,293978,294297
MASONB.txt,290699,291229,530,10,N,Y,1448394918930,293978,294297
MASONB.txt,290726,291260,534,10,N,Y,1448394918930,293978,294297
MASONB.txt,290850,291275,425,10,N,Y,1448394918930,293978,294297
MASONB.txt,290975,291292,317,10,N,Y,1448394918930,293978,294297
MASONB.txt,291059,291371,312,10,N,Y,1448394918930,293978,294297
MASONB.txt,291093,291376,283,10,N,Y,1448394918930,293978,294297
MASONB.txt,291097,291420,323,10,N,Y,1448394918930,293978,294297
MASONB.txt,291161,291443,282,10,N,Y,1448394918930,293978,294297
MASONB.txt,291165,291549,384,10,N,Y,1448394918930,293978,294297
MASONB.txt,291181,291685,504,10,N,Y,1448394918930,293978,294297
MASONB.txt,291231,291756,525,10,N,Y,1448394918930,293978,294297
MASONB.txt,291263,291812,549,10,N,Y,1448394918930,293978,294297
MASONB.txt,291276,291909,633,10,N,Y,1448394918930,293978,294297
MASONB.txt,291295,292125,830,10,N,Y,1448394918930,293978,294297
MASONB.txt,291373,292203,830,10,N,Y,1448394918930,293978,294297
MASONB.txt,291377,292318,941,10,N,Y,1448312968013,174511,175025
MASONB.txt,291425,292539,1114,10,N,Y,1448312968013,174511,175025
MASONB.txt,291446,292633,1187,10,N,Y,1448312968013,174511,175025
MASONB.txt,291550,292678,1128,10,N,Y,1448312968013,174511,175025
MASONB.txt,291686,292758,1072,10,N,Y,1448312968013,174511,175025
MASONB.txt,291758,292780,1022,10,N,Y,1448312968013,174511,175025
MASONB.txt,291813,292791,978,10,N,Y,1448312968013,174511,175025
MASONB.txt,291910,292834,924,10,N,Y,1448312968013,174511,175025
MASONB.txt,292126,292871,745,10,N,Y,1448312968013,174511,175025
MASONB.txt,292206,292916,710,10,N,Y,1448312968013,174511,175025
MASONB.txt,292319,292931,612,10,N,Y,1448312968013,174511,175025
MASONB.txt,292540,292965,425,10,N,Y,1448312968013,174511,175025
MASONB.txt,292636,292974,338,10,N,Y,1448312968013,174511,175025
MASONB.txt,292681,293016,335,10,N,Y,1448312968013,174511,175025
MASONB.txt,292761,293119,358,10,N,Y,1448312968013,174511,175025
MASONB.txt,292781,293159,378,10,N,Y,1448312968013,174511,175025
MASONB.txt,292793,293275,482,10,N,Y,1448312968013,174511,175025
MASONB.txt,292836,293465,629,10,N,Y,1448312968013,174511,175025
MASONB.txt,292873,293651,778,10,N,Y,1448312968013,174511,175025
MASONB.txt,292918,293818,900,10,N,Y,1448312968013,174511,175025
MASONB.txt,292934,293910,976,10,N,Y,1448312968013,174511,175025
MASONB.txt,292966,293972,1006,10,N,Y,1448312968013,174511,175025
MASONB.txt,292976,294054,1078,10,N,Y,1448312968013,174511,175025
MASONB.txt,293019,294110,1091,10,N,Y,1448312968013,174511,175025
MASONB.txt,293120,294221,1101,10,N,Y,1448312968013,174511,175025
MASONB.txt,293160,294302,1142,10,N,Y,1448312968013,174511,175025
MASONB.txt,293276,294390,1114,10,N,Y,1448312968013,174511,175025
MASONB.txt,293467,294454,987,10,N,Y,1448312968013,174511,175025
MASONB.txt,293652,294578,926,10,N,Y,1448312968013,174511,175025
MASONB.txt,293819,294774,955,10,N,Y,1448312968013,174511,175025
MASONB.txt,293911,294933,1022,10,N,Y,1448312968013,174511,175025
MASONB.txt,293975,295049,1074,10,N,Y,1448367094347,278355,278591
MASONB.txt,294055,295188,1133,10,N,Y,1448367094347,278355,278591
MASONB.txt,294111,295453,1342,10,N,Y,1448312128598,172353,173027
MASONB.txt,294223,295638,1415,10,N,Y,1448312128598,172353,173027
MASONB.txt,294305,295721,1416,10,N,Y,1448312128598,172353,173027
MASONB.txt,294391,295834,1443,10,N,Y,1448312128598,172353,173027
MASONB.txt,294455,295908,1453,10,N,Y,1448312128598,172353,173027
MASONB.txt,294579,295914,1335,10,N,Y,1448312128598,172353,173027
MASONB.txt,294775,296301,1526,10,N,Y,1448312128598,172353,173027
MASONB.txt,294934,296498,1564,10,Y,Y,1448312128598,172353,173027
MASONB.txt,295052,296762,1710,10,Y,Y,1448312128598,172353,173027
MASONB.txt,295191,296996,1805,10,Y,Y,1448312128598,172353,173027
MASONB.txt,295454,297033,1579,10,Y,Y,1448312128598,172353,173027
MASONB.txt,295639,297141,1502,10,Y,Y,1448312128598,172353,173027
MASONB.txt,295723,297414,1691,10,Y,Y,1448312128598,172353,173027
MASONB.txt,295835,297690,1855,10,Y,Y,1448312128598,172353,173027
MASONB.txt,295910,298060,2150,10,Y,Y,1448312128598,172353,173027
MASONB.txt,295915,298065,2150,10,Y,Y,1448312128598,172353,173027
MASONB.txt,296302,298169,1867,10,Y,Y,1448312128598,172353,173027
MASONB.txt,296499,298432,1933,10,Y,Y,1448312128598,172353,173027
MASONB.txt,296765,298503,1738,10,Y,Y,1448312128598,172353,173027
MASONB.txt,296997,298632,1635,10,Y,Y,1448312128598,172353,173027
MASONB.txt,297034,298781,1747,10,Y,Y,1448312128598,172353,173027
MASONB.txt,297142,298871,1729,10,Y,Y,1448312128598,172353,173027
MASONB.txt,297417,298941,1524,10,N,Y,1448360754961,270225,271673
MASONB.txt,297693,298975,1282,10,N,Y,1448360754961,270225,271673
MASONB.txt,298061,299066,1005,10,N,Y,1448360754961,270225,271673
MASONB.txt,298067,299157,1090,10,N,Y,1448360754961,270225,271673
MASONB.txt,298170,299499,1329,10,N,Y,1448360754961,270225,271673
MASONB.txt,298433,299568,1135,10,N,Y,1448360754961,270225,271673
MASONB.txt,298504,299600,1096,10,N,Y,1448360754961,270225,271673
MASONB.txt,298635,299695,1060,10,N,Y,1448360754961,270225,271673
MASONB.txt,298782,299784,1002,10,N,Y,1448360754961,270225,271673
MASONB.txt,298872,299942,1070,10,N,Y,1448360754961,270225,271673
MASONB.txt,298942,300083,1141,10,N,Y,1448360754961,270225,271673
MASONB.txt,298978,300145,1167,10,N,Y,1448360754961,270225,271673
MASONB.txt,299067,300158,1091,10,N,Y,1448360754961,270225,271673
MASONB.txt,299158,300203,1045,10,N,Y,1448369582981,281838,282369
MASONB.txt,299500,300274,774,10,N,Y,1448369582981,281838,282369
MASONB.txt,299569,300357,788,10,N,Y,1448369582981,281838,282369
MASONB.txt,299603,300400,797,10,N,Y,1448369582981,281838,282369
MASONB.txt,299696,300411,715,10,N,Y,1448369582981,281838,282369
MASONB.txt,299786,300425,639,10,N,Y,1448369582981,281838,282369
MASONB.txt,299943,300449,506,10,N,Y,1448369582981,281838,282369
MASONB.txt,300084,300492,408,10,N,Y,1448369582981,281838,282369
MASONB.txt,300148,300584,436,10,N,Y,1448369582981,281838,282369
MASONB.txt,300161,300603,442,10,N,Y,1448369582981,281838,282369
MASONB.txt,300206,300886,680,10,N,Y,1448369582981,281838,282369
MASONB.txt,300276,300975,699,10,N,Y,1448369582981,281838,282369
MASONB.txt,300359,301145,786,10,N,Y,1448369582981,281838,282369
MASONB.txt,300402,301211,809,10,N,Y,1448369582981,281838,282369
MASONB.txt,300413,301343,930,10,N,Y,1448369582981,281838,282369
MASONB.txt,300428,301450,1022,10,N,Y,1448369582981,281838,282369
MASONB.txt,300452,301532,1080,10,N,Y,1448369582981,281838,282369
MASONB.txt,300495,301623,1128,10,N,Y,1448369582981,281838,282369
MASONB.txt,300585,301745,1160,10,N,Y,1448369582981,281838,282369
MASONB.txt,300604,301910,1306,10,N,Y,1448369582981,281838,282369
MASONB.txt,300887,302328,1441,10,N,Y,1448369582981,281838,282369
MASONB.txt,300976,302418,1442,10,N,Y,1448369582981,281838,282369
MASONB.txt,301146,302527,1381,10,N,Y,1448369582981,281838,282369
MASONB.txt,301212,302598,1386,10,N,Y,1448369582981,281838,282369
MASONB.txt,301344,302624,1280,10,N,Y,1448357702814,234410,234585
MASONB.txt,301451,302721,1270,10,N,Y,1448357702814,234410,234585
MASONB.txt,301533,302769,1236,10,N,Y,1448358538400,238461,240031
MASONB.txt,301624,302826,1202,10,N,Y,1448358538400,238461,240031
MASONB.txt,301746,302841,1095,10,N,Y,1448358538400,238461,240031
MASONB.txt,301911,302895,984,10,N,Y,1448358538400,238461,240031
MASONB.txt,302329,302976,647,10,N,Y,1448358538400,238461,240031
MASONB.txt,302419,303095,676,10,N,Y,1448358538400,238461,240031
MASONB.txt,302530,303274,744,10,N,Y,1448358538400,238461,240031
MASONB.txt,302599,303331,732,10,N,Y,1448358538400,238461,240031
MASONB.txt,302627,303356,729,10,N,Y,1448358538400,238461,240031
MASONB.txt,302724,303847,1123,10,N,Y,1448358538400,238461,240031
MASONB.txt,302770,303887,1117,10,N,Y,1448358538400,238461,240031
MASONB.txt,302831,303918,1087,10,N,N,-,-1,-1
MASONB.txt,302844,303923,1079,10,N,N,-,-1,-1
MASONB.txt,302898,303960,1062,10,N,N,-,-1,-1
MASONB.txt,302976,303965,989,10,N,N,-,-1,-1
MASONB.txt,303096,304000,904,10,N,N,-,-1,-1
MASONB.txt,303275,304005,730,10,N,N,-,-1,-1
MASONB.txt,303332,304043,711,10,N,N,-,-1,-1
MASONB.txt,303357,304128,771,10,N,N,-,-1,-1
MASONB.txt,303849,304224,375,10,N,N,-,-1,-1
MASONB.txt,303888,304342,454,10,N,N,-,-1,-1
MASONB.txt,303921,304431,510,10,N,N,-,-1,-1
MASONB.txt,303924,304520,596,10,N,N,-,-1,-1
MASONB.txt,303963,304683,720,10,N,N,-,-1,-1
MASONB.txt,303966,304867,901,10,N,N,-,-1,-1
MASONB.txt,304003,305119,1116,10,N,N,-,-1,-1
MASONB.txt,304006,305345,1339,10,N,N,-,-1,-1
MASONB.txt,304046,305381,1335,10,N,N,-,-1,-1
MASONB.txt,304129,305437,1308,10,Y,Y,1448368573498,278931,279027
MASONB.txt,304227,305638,1411,10,N,Y,1448368573498,278931,279027
MASONB.txt,304343,305873,1530,10,Y,Y,1448368573498,278931,279027
MASONB.txt,304432,306011,1579,10,Y,Y,1448368573498,278931,279027
MASONB.txt,304521,306136,1615,10,Y,Y,1448368573498,278931,279027
MASONB.txt,304684,306163,1479,10,N,Y,1448368573498,278931,279027
MASONB.txt,304868,306283,1415,10,N,Y,1448368573498,278931,279027
MASONB.txt,305120,306492,1372,10,N,Y,1448368573498,278931,279027
MASONB.txt,305348,306682,1334,10,Y,Y,1448368573498,278931,279027
MASONB.txt,305382,306788,1406,10,N,Y,1448368573498,278931,279027
MASONB.txt,305438,307066,1628,10,N,Y,1448368573498,278931,279027
MASONB.txt,305639,307415,1776,10,N,Y,1448368573498,278931,279027
MASONB.txt,305874,307503,1629,10,N,Y,1448368573498,278931,279027
MASONB.txt,306012,307596,1584,10,N,Y,1448368573498,278931,279027
MASONB.txt,306139,307621,1482,10,N,Y,1448368573498,278931,279027
MASONB.txt,306164,307641,1477,10,N,Y,1448368573498,278931,279027
MASONB.txt,306284,307681,1397,10,N,Y,1448368573498,278931,279027
MASONB.txt,306493,307711,1218,10,N,Y,1448368573498,278931,279027
MASONB.txt,306683,308544,1861,10,N,Y,1448368573498,278931,279027
MASONB.txt,306789,308689,1900,10,N,Y,1448368573498,278931,279027
MASONB.txt,307069,308847,1778,10,N,Y,1448368573498,278931,279027
MASONB.txt,307418,309014,1596,10,N,Y,1448368573498,278931,279027
MASONB.txt,307504,309286,1782,10,N,Y,1448368573498,278931,279027
MASONB.txt,307601,309427,1826,10,N,Y,1448396898923,302722,302823
MASONB.txt,307622,309485,1863,10,N,Y,1448396898923,302722,302823
MASONB.txt,307644,309521,1877,10,N,Y,1448396898923,302722,302823
MASONB.txt,307684,309769,2085,10,N,Y,1448396898923,302722,302823
MASONB.txt,307714,309866,2152,10,N,Y,1448396898923,302722,302823
MASONB.txt,308545,310168,1623,10,N,Y,1448396898923,302722,302823
MASONB.txt,308690,310445,1755,10,N,Y,1448396898923,302722,302823
MASONB.txt,308848,310534,1686,10,N,Y,1448394436678,290724,292129
MASONB.txt,309015,310623,1608,10,N,Y,1448394436678,290724,292129
MASONB.txt,309287,310856,1569,10,N,Y,1448394436678,290724,292129
MASONB.txt,309428,311147,1719,10,N,Y,1448394436678,290724,292129
MASONB.txt,309488,311260,1772,10,N,Y,1448394436678,290724,292129
MASONB.txt,309522,311357,1835,10,N,Y,1448394436678,290724,292129
MASONB.txt,309770,311441,1671,10,N,Y,1448394436678,290724,292129
MASONB.txt,309867,311507,1640,10,N,Y,1448394436678,290724,292129
MASONB.txt,310169,311608,1439,10,N,Y,1448394436678,290724,292129
MASONB.txt,310446,311905,1459,10,N,Y,1448394436678,290724,292129
MASONB.txt,310535,312125,1590,10,N,Y,1448394436678,290724,292129
MASONB.txt,310624,312387,1763,10,N,N,-,-1,-1
MASONB.txt,310857,312486,1629,10,N,N,-,-1,-1
MASONB.txt,311148,312666,1518,10,N,Y,1448658415366,316309,316420
MASONB.txt,311261,312718,1457,10,N,Y,1448658415366,316309,316420
MASONB.txt,311359,312765,1406,10,N,Y,1448658415366,316309,316420
MASONB.txt,311442,312853,1411,10,N,Y,1448658415366,316309,316420
MASONB.txt,311508,312898,1390,10,N,Y,1448658415366,316309,316420
MASONB.txt,311609,312927,1318,10,N,Y,1448658415366,316309,316420
MASONB.txt,311906,312979,1073,10,N,Y,1448658415366,316309,316420
MASONB.txt,312126,313026,900,10,N,Y,1448658415366,316309,316420
MASONB.txt,312388,313058,670,10,N,Y,1448658415366,316309,316420
MASONB.txt,312487,313096,609,10,N,Y,1448658415366,316309,316420
MASONB.txt,312669,313144,475,10,N,Y,1448658415366,316309,316420
MASONB.txt,312720,313181,461,10,N,Y,1448658415366,316309,316420
MASONB.txt,312767,313222,455,10,N,Y,1448658415366,316309,316420
MASONB.txt,312855,313265,410,10,N,Y,1448658415366,316309,316420
MASONB.txt,312901,313337,436,10,N,Y,1448658415366,316309,316420
MASONB.txt,312930,313695,765,10,N,Y,1448658415366,316309,316420
MASONB.txt,312982,314063,1081,10,N,Y,1448658415366,316309,316420
MASONB.txt,313029,314185,1156,10,N,Y,1448658415366,316309,316420
MASONB.txt,313061,314354,1293,10,N,Y,1448658415366,316309,316420
MASONB.txt,313099,314496,1397,10,N,Y,1448658415366,316309,316420
MASONB.txt,313147,314573,1426,10,N,Y,1448658415366,316309,316420
MASONB.txt,313184,314791,1607,10,N,Y,1448658415366,316309,316420
MASONB.txt,313225,314890,1665,10,N,Y,1448658415366,316309,316420
MASONB.txt,313268,315125,1857,10,N,Y,1448658415366,316309,316420
MASONB.txt,313340,315329,1989,10,N,Y,1448658415366,316309,316420
MASONB.txt,313696,315350,1654,10,N,N,-,-1,-1
MASONB.txt,314064,315819,1755,10,N,N,-,-1,-1
MASONB.txt,314186,316236,2050,10,N,N,-,-1,-1
MASONB.txt,314355,316308,1953,10,N,N,-,-1,-1
MASONB.txt,314499,316423,1924,10,N,Y,1448357928644,234586,234661
MASONB.txt,314574,316489,1915,10,N,Y,1448369361055,281280,281814
MASONB.txt,314792,316679,1887,10,N,Y,1448369361055,281280,281814
MASONB.txt,314891,316757,1866,10,N,Y,1448369361055,281280,281814
MASONB.txt,315126,316817,1691,10,N,Y,1448369361055,281280,281814
MASONB.txt,315330,317033,1703,10,N,Y,1448369361055,281280,281814
MASONB.txt,315351,317341,1990,10,N,Y,1448369361055,281280,281814
MASONB.txt,315820,317455,1635,10,N,Y,1448369361055,281280,281814
MASONB.txt,316237,317510,1273,10,N,Y,1448369361055,281280,281814
MASONB.txt,316311,317785,1474,10,N,Y,1448369361055,281280,281814
MASONB.txt,316424,318076,1652,10,N,Y,1448369361055,281280,281814
MASONB.txt,316490,318471,1981,10,Y,Y,1448369361055,281280,281814
MASONB.txt,316681,318668,1987,10,Y,Y,1448393552252,287738,288962
MASONB.txt,316758,318796,2038,10,Y,Y,1448393552252,287738,288962
MASONB.txt,316818,318981,2163,10,Y,Y,1448393552252,287738,288962
MASONB.txt,317034,319172,2138,10,N,Y,1448395383674,294308,294925
MASONB.txt,317344,319361,2017,10,N,Y,1448395383674,294308,294925
MASONB.txt,317458,319417,1959,10,N,Y,1448395383674,294308,294925
MASONB.txt,317511,319582,2071,10,N,Y,1448395383674,294308,294925
MASONB.txt,317786,320314,2528,10,N,Y,1448395383674,294308,294925
MASONB.txt,318077,320398,2321,10,N,Y,1448395383674,294308,294925
MASONB.txt,318472,320718,2246,10,N,Y,1448395383674,294308,294925
MASONB.txt,318669,321288,2619,10,N,Y,1448395383674,294308,294925
MASONB.txt,318797,321372,2575,10,N,Y,1448395383674,294308,294925
MASONB.txt,318982,321543,2561,10,N,Y,1448395383674,294308,294925
MASONB.txt,319173,321629,2456,10,N,Y,1448395383674,294308,294925
MASONB.txt,319362,321741,2379,10,N,Y,1448395383674,294308,294925
MASONB.txt,319418,321878,2460,10,N,Y,1448395383674,294308,294925
MASONB.txt,319583,322057,2474,10,N,Y,1448395383674,294308,294925
MASONB.txt,320315,322217,1902,10,N,N,-,-1,-1
MASONB.txt,320401,322422,2021,10,N,N,-,-1,-1
MASONB.txt,320719,322713,1994,10,N,N,-,-1,-1
MASONB.txt,321289,323110,1821,10,N,Y,1448658612805,316427,316672
MASONB.txt,321375,323278,1903,10,N,Y,1448658612805,316427,316672
MASONB.txt,321544,323372,1828,10,N,Y,1448658612805,316427,316672
MASONB.txt,321630,323493,1863,10,N,Y,1448658612805,316427,316672
MASONB.txt,321742,323637,1895,10,N,Y,1448658612805,316427,316672
MASONB.txt,321879,323747,1868,10,N,Y,1448658612805,316427,316672
MASONB.txt,322058,324057,1999,10,Y,Y,1448658612805,316427,316672
MASONB.txt,322218,324238,2020,10,Y,Y,1448658612805,316427,316672
MASONB.txt,322423,324325,1902,10,Y,Y,1448658612805,316427,316672
MASONB.txt,322716,324593,1877,10,Y,Y,1448359079273,247104,249268
MASONB.txt,323111,324784,1673,10,N,Y,1448359079273,247104,249268
MASONB.txt,323279,324895,1616,10,N,Y,1448359079273,247104,249268
MASONB.txt,323373,325051,1678,10,N,Y,1448359079273,247104,249268
MASONB.txt,323494,325174,1680,10,N,Y,1448359079273,247104,249268
MASONB.txt,323639,325428,1789,10,N,Y,1448359079273,247104,249268
MASONB.txt,323748,325513,1765,10,N,Y,1448359079273,247104,249268
MASONB.txt,324058,325633,1575,10,N,Y,1448359079273,247104,249268
MASONB.txt,324239,325774,1535,10,N,Y,1448359079273,247104,249268
MASONB.txt,324327,326006,1679,10,N,Y,1448359079273,247104,249268
MASONB.txt,324594,326482,1888,10,N,Y,1448359079273,247104,249268
MASONB.txt,324785,326584,1799,10,N,Y,1448359079273,247104,249268
MASONB.txt,324896,326679,1783,10,N,Y,1448359079273,247104,249268
MASONB.txt,325052,326977,1925,10,N,Y,1448358806100,240524,240915
MASONB.txt,325175,326998,1823,10,N,Y,1448358806100,240524,240915
MASONB.txt,325431,327034,1603,10,N,Y,1448358806100,240524,240915
MASONB.txt,325514,327298,1784,10,N,Y,1448358806100,240524,240915
MASONB.txt,325636,327381,1745,10,N,Y,1448358806100,240524,240915
MASONB.txt,325775,327532,1757,10,N,Y,1448358806100,240524,240915
MASONB.txt,326008,327662,1654,10,N,Y,1448358806100,240524,240915
MASONB.txt,326483,327820,1337,10,N,Y,1448358806100,240524,240915
MASONB.txt,326585,328015,1430,10,N,Y,1448358806100,240524,240915
MASONB.txt,326680,328284,1604,10,N,Y,1448358806100,240524,240915
MASONB.txt,326980,328503,1523,10,N,Y,1448922458482,377161,378772
MASONB.txt,326999,328841,1842,10,N,Y,1448922458482,377161,378772
MASONB.txt,327036,329121,2085,10,N,Y,1448922458482,377161,378772
MASONB.txt,327299,329202,1903,10,N,Y,1448922458482,377161,378772
MASONB.txt,327382,329254,1872,10,N,Y,1448922458482,377161,378772
MASONB.txt,327533,329401,1868,10,N,Y,1461670558474,533968,535655
MASONB.txt,327663,329474,1811,10,N,Y,1461670558474,533968,535655
MASONB.txt,327823,329543,1720,10,N,Y,1461670558474,533968,535655
MASONB.txt,328016,329766,1750,10,N,Y,1461670558474,533968,535655
MASONB.txt,328285,330084,1799,10,N,Y,1461670558474,533968,535655
MASONB.txt,328504,330405,1901,10,N,Y,1461670558474,533968,535655
MASONB.txt,328842,330866,2024,10,N,Y,1461670558474,533968,535655
MASONB.txt,329122,331035,1913,10,Y,Y,1461670558474,533968,535655
MASONB.txt,329203,331132,1929,10,Y,Y,1461670558474,533968,535655
MASONB.txt,329257,331415,2158,10,N,Y,1461670558474,533968,535655
MASONB.txt,329404,331561,2157,10,N,Y,1461670558474,533968,535655
MASONB.txt,329475,331723,2248,10,N,Y,1461670558474,533968,535655
MASONB.txt,329544,331795,2251,10,N,Y,1448397400459,310446,310619
MASONB.txt,329767,331898,2131,10,N,Y,1448397400459,310446,310619
MASONB.txt,330085,332014,1929,10,N,Y,1448397400459,310446,310619
MASONB.txt,330408,332285,1877,10,N,Y,1448397400459,310446,310619
MASONB.txt,330867,332624,1757,10,N,Y,1448397400459,310446,310619
MASONB.txt,331036,332739,1703,10,N,Y,1448397400459,310446,310619
MASONB.txt,331133,333052,1919,10,N,Y,1448397400459,310446,310619
MASONB.txt,331416,333074,1658,10,N,Y,1448397400459,310446,310619
MASONB.txt,331562,333135,1573,10,N,Y,1448659006435,318991,319718
MASONB.txt,331726,333233,1507,10,N,Y,1448659006435,318991,319718
MASONB.txt,331796,333348,1552,10,N,Y,1448659006435,318991,319718
MASONB.txt,331899,333391,1492,10,N,Y,1448659006435,318991,319718
MASONB.txt,332015,333455,1440,10,N,Y,1448659006435,318991,319718
MASONB.txt,332286,333679,1393,10,N,Y,1448659006435,318991,319718
MASONB.txt,332625,333819,1194,10,N,Y,1448659006435,318991,319718
MASONB.txt,332740,334075,1335,10,N,Y,1448659006435,318991,319718
MASONB.txt,333055,334265,1210,10,N,Y,1448659006435,318991,319718
MASONB.txt,333075,334277,1202,10,N,Y,1448659006435,318991,319718
MASONB.txt,333136,334290,1154,10,N,Y,1448835650796,347315,347685
MASONB.txt,333234,334614,1380,10,N,Y,1448835650796,347315,347685
MASONB.txt,333349,334951,1602,10,Y,Y,1448835650796,347315,347685
MASONB.txt,333394,335040,1646,10,N,Y,1448835650796,347315,347685
MASONB.txt,333457,335141,1684,10,Y,Y,1448706202822,330411,331016
MASONB.txt,333680,335164,1484,10,Y,Y,1448706202822,330411,331016
MASONB.txt,333820,335184,1364,10,N,Y,1448706202822,330411,331016
MASONB.txt,334076,335202,1126,10,N,Y,1448706202822,330411,331016
MASONB.txt,334266,335242,976,10,N,Y,1448706202822,330411,331016
MASONB.txt,334278,335302,1024,10,N,Y,1448706202822,330411,331016
MASONB.txt,334291,335356,1065,10,N,Y,1448706202822,330411,331016
MASONB.txt,334615,335391,776,10,N,Y,1448706202822,330411,331016
MASONB.txt,334952,335427,475,10,N,Y,1448706202822,330411,331016
MASONB.txt,335041,335489,448,10,N,Y,1448706202822,330411,331016
MASONB.txt,335144,335537,393,10,N,Y,1448706202822,330411,331016
MASONB.txt,335165,335589,424,10,N,Y,1448706202822,330411,331016
MASONB.txt,335187,335604,417,10,N,Y,1448706202822,330411,331016
MASONB.txt,335203,335626,423,10,N,Y,1448706202822,330411,331016
MASONB.txt,335245,335641,396,10,N,Y,1448706202822,330411,331016
MASONB.txt,335303,335689,386,10,N,Y,1448706202822,330411,331016
MASONB.txt,335359,335730,371,10,N,Y,1448706202822,330411,331016
MASONB.txt,335392,335743,351,10,N,Y,1448706202822,330411,331016
MASONB.txt,335430,335776,346,10,N,Y,1448706202822,330411,331016
MASONB.txt,335492,335852,360,10,N,Y,1448706202822,330411,331016
MASONB.txt,335540,335888,348,10,N,Y,1448706202822,330411,331016
MASONB.txt,335590,335910,320,10,N,Y,1448706202822,330411,331016
MASONB.txt,335605,336002,397,10,N,Y,1448706202822,330411,331016
MASONB.txt,335629,336027,398,10,N,Y,1448706202822,330411,331016
MASONB.txt,335644,336039,395,10,N,Y,1448706202822,330411,331016
MASONB.txt,335690,336053,363,10,N,Y,1448706202822,330411,331016
MASONB.txt,335731,336055,324,10,N,Y,1448706202822,330411,331016
MASONB.txt,335744,336063,319,10,N,Y,1448706202822,330411,331016
MASONB.txt,335779,336078,299,10,N,Y,1448706202822,330411,331016
MASONB.txt,335853,336123,270,10,N,Y,1448706202822,330411,331016
MASONB.txt,335889,336143,254,10,N,Y,1448706202822,330411,331016
MASONB.txt,335913,336159,246,10,N,Y,1448706202822,330411,331016
MASONB.txt,336005,336175,170,10,N,Y,1448706202822,330411,331016
MASONB.txt,336028,336216,188,10,N,Y,1448706202822,330411,331016
MASONB.txt,336040,336220,180,10,N,Y,1448706202822,330411,331016
MASONB.txt,336054,336222,168,10,N,Y,1448706202822,330411,331016
MASONB.txt,336055,336234,179,10,N,Y,1448706202822,330411,331016
MASONB.txt,336064,336373,309,10,N,Y,1448706202822,330411,331016
MASONB.txt,336079,336575,496,10,N,Y,1448706202822,330411,331016
MASONB.txt,336126,336760,634,10,N,Y,1448706202822,330411,331016
MASONB.txt,336144,336877,733,10,N,Y,1448706202822,330411,331016
MASONB.txt,336162,336937,775,10,N,Y,1448706202822,330411,331016
MASONB.txt,336176,336991,815,10,N,Y,1448706202822,330411,331016
MASONB.txt,336217,337043,826,10,N,Y,1448706202822,330411,331016
MASONB.txt,336221,337116,895,10,N,Y,1448706202822,330411,331016
MASONB.txt,336222,337164,942,10,N,Y,1448706202822,330411,331016
MASONB.txt,336237,337274,1037,10,N,Y,1448706202822,330411,331016
MASONB.txt,336374,337328,954,10,N,Y,1461670707714,535735,535836
MASONB.txt,336578,337382,804,10,N,Y,1461670707714,535735,535836
MASONB.txt,336762,337435,673,10,N,Y,1461670707714,535735,535836
MASONB.txt,336878,337487,609,10,N,Y,1461670707714,535735,535836
MASONB.txt,336940,337518,578,10,N,Y,1461670707714,535735,535836
MASONB.txt,336994,337651,657,10,N,Y,1461670707714,535735,535836
MASONB.txt,337046,337720,674,10,N,Y,1461670707714,535735,535836
MASONB.txt,337119,337794,675,10,N,Y,1461670707714,535735,535836
MASONB.txt,337167,338114,947,10,N,Y,1461670707714,535735,535836
MASONB.txt,337277,338364,1087,10,N,Y,1461670707714,535735,535836
MASONB.txt,337331,338620,1289,10,N,Y,1461670707714,535735,535836
MASONB.txt,337384,338757,1373,10,N,Y,1461670707714,535735,535836
MASONB.txt,337437,338835,1398,10,N,Y,1461670707714,535735,535836
MASONB.txt,337490,338912,1422,10,N,Y,1461670707714,535735,535836
MASONB.txt,337521,339090,1569,10,N,Y,1448658303622,312507,313648
MASONB.txt,337654,339177,1523,10,N,Y,1448658303622,312507,313648
MASONB.txt,337722,339244,1522,10,N,Y,1448658303622,312507,313648
MASONB.txt,337797,339325,1528,10,N,Y,1448658303622,312507,313648
MASONB.txt,338116,339447,1331,10,N,Y,1448658303622,312507,313648
MASONB.txt,338366,339605,1239,10,N,Y,1448658303622,312507,313648
MASONB.txt,338623,339825,1202,10,N,Y,1448658303622,312507,313648
MASONB.txt,338758,339944,1186,10,N,Y,1448658303622,312507,313648
MASONB.txt,338836,340137,1301,10,N,Y,1448658303622,312507,313648
MASONB.txt,338913,340295,1382,10,N,Y,1448658303622,312507,313648
MASONB.txt,339092,340397,1305,10,N,Y,1448658303622,312507,313648
MASONB.txt,339178,340516,1338,10,N,Y,1448835524328,346857,347270
MASONB.txt,339245,340626,1381,10,N,Y,1448835524328,346857,347270
MASONB.txt,339326,340782,1456,10,N,Y,1448835524328,346857,347270
MASONB.txt,339448,340878,1430,10,N,Y,1448835524328,346857,347270
MASONB.txt,339607,341100,1493,10,N,Y,1448835524328,346857,347270
MASONB.txt,339826,341145,1319,10,N,Y,1448919978818,348008,348718
MASONB.txt,339945,341298,1353,10,N,Y,1448919978818,348008,348718
MASONB.txt,340138,341405,1267,10,N,Y,1448919978818,348008,348718
MASONB.txt,340296,341476,1180,10,Y,Y,1448919978818,348008,348718
MASONB.txt,340398,341504,1106,10,Y,Y,1448919978818,348008,348718
MASONB.txt,340517,341582,1065,10,N,Y,1448919978818,348008,348718
MASONB.txt,340627,341722,1095,10,Y,Y,1448919978818,348008,348718
MASONB.txt,340784,341818,1034,10,N,Y,1448919978818,348008,348718
MASONB.txt,340881,341838,957,10,N,Y,1448919978818,348008,348718
MASONB.txt,341103,341852,749,10,N,Y,1448919978818,348008,348718
MASONB.txt,341146,341911,765,10,N,Y,1448919978818,348008,348718
MASONB.txt,341299,341988,689,10,N,Y,1448919978818,348008,348718
MASONB.txt,341406,342033,627,10,N,Y,1448919978818,348008,348718
MASONB.txt,341479,342089,610,10,N,Y,1448919978818,348008,348718
MASONB.txt,341504,342108,604,10,N,Y,1448919978818,348008,348718
MASONB.txt,341585,342376,791,10,N,Y,1448919978818,348008,348718
MASONB.txt,341724,342496,772,10,N,Y,1448919978818,348008,348718
MASONB.txt,341821,342580,759,10,N,Y,1448919978818,348008,348718
MASONB.txt,341839,342687,848,10,N,Y,1448919978818,348008,348718
MASONB.txt,341853,342718,865,10,N,Y,1448919978818,348008,348718
MASONB.txt,341914,342834,920,10,N,Y,1448919978818,348008,348718
MASONB.txt,341990,342862,872,10,N,Y,1448919978818,348008,348718
MASONB.txt,342034,342912,878,10,N,Y,1448919978818,348008,348718
MASONB.txt,342092,342931,839,10,N,Y,1448919978818,348008,348718
MASONB.txt,342109,342943,834,10,N,Y,1448919978818,348008,348718
MASONB.txt,342378,342972,594,10,N,Y,1448919978818,348008,348718
MASONB.txt,342497,342977,480,10,N,Y,1448919978818,348008,348718
MASONB.txt,342583,343023,440,10,N,Y,1448919978818,348008,348718
MASONB.txt,342692,343039,347,10,N,N,-,-1,-1
MASONB.txt,342719,343072,353,10,N,N,-,-1,-1
MASONB.txt,342839,343080,241,10,N,N,-,-1,-1
MASONB.txt,342867,343118,251,10,N,N,-,-1,-1
MASONB.txt,342915,343128,213,10,N,N,-,-1,-1
MASONB.txt,342932,343141,209,10,N,N,-,-1,-1
MASONB.txt,342946,343162,216,10,N,N,-,-1,-1
MASONB.txt,342972,343173,201,10,N,N,-,-1,-1
MASONB.txt,342980,343214,234,10,N,N,-,-1,-1
MASONB.txt,343024,343236,212,10,N,N,-,-1,-1
MASONB.txt,343040,343246,206,10,N,N,-,-1,-1
MASONB.txt,343073,343269,196,10,N,N,-,-1,-1
MASONB.txt,343083,343310,227,10,N,N,-,-1,-1
MASONB.txt,343121,343337,216,10,N,N,-,-1,-1
MASONB.txt,343129,343351,222,10,N,N,-,-1,-1
MASONB.txt,343142,343422,280,10,N,N,-,-1,-1
MASONB.txt,343163,343443,280,10,N,N,-,-1,-1
MASONB.txt,343176,343457,281,10,N,N,-,-1,-1
MASONB.txt,343215,343480,265,10,N,N,-,-1,-1
MASONB.txt,343237,343526,289,10,N,N,-,-1,-1
MASONB.txt,343249,343556,307,10,N,N,-,-1,-1
MASONB.txt,343272,343600,328,10,N,N,-,-1,-1
MASONB.txt,343313,343638,325,10,N,N,-,-1,-1
MASONB.txt,343338,343648,310,10,N,N,-,-1,-1
MASONB.txt,343351,343671,320,10,N,N,-,-1,-1
MASONB.txt,343423,343713,290,10,N,N,-,-1,-1
MASONB.txt,343443,343735,292,10,N,N,-,-1,-1
MASONB.txt,343458,343764,306,10,N,N,-,-1,-1
MASONB.txt,343481,343833,352,10,N,N,-,-1,-1
MASONB.txt,343527,343865,338,10,N,N,-,-1,-1
MASONB.txt,343557,343933,376,10,N,N,-,-1,-1
MASONB.txt,343601,343945,344,10,N,N,-,-1,-1
MASONB.txt,343641,343974,333,10,N,N,-,-1,-1
MASONB.txt,343649,344003,354,10,N,N,-,-1,-1
MASONB.txt,343672,344031,359,10,N,N,-,-1,-1
MASONB.txt,343714,344062,348,10,N,N,-,-1,-1
MASONB.txt,343736,344084,348,10,N,N,-,-1,-1
MASONB.txt,343765,344114,349,10,N,N,-,-1,-1
MASONB.txt,343834,344123,289,10,N,N,-,-1,-1
MASONB.txt,343866,344153,287,10,N,N,-,-1,-1
MASONB.txt,343934,344172,238,10,N,N,-,-1,-1
MASONB.txt,343946,344209,263,10,N,N,-,-1,-1
MASONB.txt,343979,344254,275,10,N,N,-,-1,-1
MASONB.txt,344006,344270,264,10,N,N,-,-1,-1
MASONB.txt,344034,344280,246,10,N,N,-,-1,-1
MASONB.txt,344062,344297,235,10,N,N,-,-1,-1
MASONB.txt,344084,344331,247,10,N,N,-,-1,-1
MASONB.txt,344115,344374,259,10,N,N,-,-1,-1
MASONB.txt,344126,344414,288,10,N,N,-,-1,-1
MASONB.txt,344153,344463,310,10,N,N,-,-1,-1
MASONB.txt,344172,344496,324,10,N,N,-,-1,-1
MASONB.txt,344210,344517,307,10,N,N,-,-1,-1
MASONB.txt,344255,344556,301,10,N,N,-,-1,-1
MASONB.txt,344270,344579,309,10,N,N,-,-1,-1
MASONB.txt,344283,344599,316,10,N,N,-,-1,-1
MASONB.txt,344298,344613,315,10,N,N,-,-1,-1
MASONB.txt,344334,344631,297,10,N,N,-,-1,-1
MASONB.txt,344374,344633,259,10,N,N,-,-1,-1
MASONB.txt,344414,344680,266,10,N,N,-,-1,-1
MASONB.txt,344464,344692,228,10,N,N,-,-1,-1
MASONB.txt,344497,344713,216,10,N,N,-,-1,-1
MASONB.txt,344517,344775,258,10,N,N,-,-1,-1
MASONB.txt,344559,344799,240,10,N,N,-,-1,-1
MASONB.txt,344582,344851,269,10,N,N,-,-1,-1
MASONB.txt,344599,344859,260,10,N,N,-,-1,-1
MASONB.txt,344614,344890,276,10,N,N,-,-1,-1
MASONB.txt,344632,344910,278,10,N,N,-,-1,-1
MASONB.txt,344633,344950,317,10,N,N,-,-1,-1
MASONB.txt,344680,345206,526,10,N,N,-,-1,-1
MASONB.txt,344693,345238,545,10,N,N,-,-1,-1
MASONB.txt,344713,345313,600,10,N,N,-,-1,-1
MASONB.txt,344778,345358,580,10,N,N,-,-1,-1
MASONB.txt,344799,345430,631,10,N,N,-,-1,-1
MASONB.txt,344851,345489,638,10,N,N,-,-1,-1
MASONB.txt,344862,345540,678,10,N,N,-,-1,-1
MASONB.txt,344891,345660,769,10,N,N,-,-1,-1
MASONB.txt,344913,345693,780,10,N,N,-,-1,-1
MASONB.txt,344950,345966,1016,10,N,Y,1448659731374,325101,325630
MASONB.txt,345211,346100,889,10,N,Y,1448659731374,325101,325630
MASONB.txt,345239,346241,1002,10,N,Y,1448659731374,325101,325630
MASONB.txt,345316,346279,963,10,N,Y,1448659731374,325101,325630
MASONB.txt,345361,346344,983,10,N,Y,1448659731374,325101,325630
MASONB.txt,345433,346406,973,10,N,Y,1448659731374,325101,325630
MASONB.txt,345492,346459,967,10,N,Y,1448659731374,325101,325630
MASONB.txt,345543,346513,970,10,N,Y,1448659731374,325101,325630
MASONB.txt,345661,346542,881,10,N,Y,1448659731374,325101,325630
MASONB.txt,345694,346568,874,10,N,Y,1448659731374,325101,325630
MASONB.txt,345967,346619,652,10,N,Y,1448659731374,325101,325630
MASONB.txt,346101,346694,593,10,N,Y,1448659731374,325101,325630
MASONB.txt,346242,346767,525,10,N,Y,1448659731374,325101,325630
MASONB.txt,346280,346856,576,10,N,Y,1448659731374,325101,325630
MASONB.txt,346347,347074,727,10,N,Y,1462037372440,554649,554769
MASONB.txt,346409,347186,777,10,N,Y,1462037372440,554649,554769
MASONB.txt,346462,347314,852,10,N,Y,1462037372440,554649,554769
MASONB.txt,346516,347384,868,10,N,Y,1448923016815,381625,382381
MASONB.txt,346545,347510,965,10,N,Y,1448923016815,381625,382381
MASONB.txt,346571,347694,1123,10,N,Y,1448923016815,381625,382381
MASONB.txt,346622,348001,1379,10,N,Y,1448923016815,381625,382381
MASONB.txt,346697,348149,1452,10,N,Y,1461790554025,550059,551049
MASONB.txt,346770,348244,1474,10,N,Y,1461790554025,550059,551049
MASONB.txt,346859,348477,1618,10,Y,Y,1461790554025,550059,551049
MASONB.txt,347077,348725,1648,10,N,Y,1461790554025,550059,551049
MASONB.txt,347187,348859,1672,10,Y,Y,1461790554025,550059,551049
MASONB.txt,347315,348908,1593,10,N,Y,1461790554025,550059,551049
MASONB.txt,347385,349005,1620,10,Y,Y,1461790554025,550059,551049
MASONB.txt,347511,349030,1519,10,Y,Y,1461790554025,550059,551049
MASONB.txt,347695,349408,1713,10,Y,Y,1461790554025,550059,551049
MASONB.txt,348004,349674,1670,10,Y,Y,1461790554025,550059,551049
MASONB.txt,348150,349825,1675,10,Y,Y,1461790554025,550059,551049
MASONB.txt,348246,349831,1585,10,Y,Y,1461790554025,550059,551049
MASONB.txt,348478,349866,1388,10,Y,Y,1461790554025,550059,551049
MASONB.txt,348728,350038,1310,10,N,Y,1448835409437,345709,346338
MASONB.txt,348860,350142,1282,10,N,Y,1448835409437,345709,346338
MASONB.txt,348911,350399,1488,10,N,Y,1448835409437,345709,346338
MASONB.txt,349010,350699,1689,10,N,Y,1448835409437,345709,346338
MASONB.txt,349031,350733,1702,10,N,Y,1448835409437,345709,346338
MASONB.txt,349409,350783,1374,10,N,Y,1448835409437,345709,346338
MASONB.txt,349675,350879,1204,10,N,Y,1448835409437,345709,346338
MASONB.txt,349826,350955,1129,10,N,Y,1448835409437,345709,346338
MASONB.txt,349832,351060,1228,10,N,Y,1448835409437,345709,346338
MASONB.txt,349869,351235,1366,10,N,N,-,-1,-1
MASONB.txt,350039,351335,1296,10,N,N,-,-1,-1
MASONB.txt,350143,351554,1411,10,N,N,-,-1,-1
MASONB.txt,350399,351632,1233,10,N,N,-,-1,-1
MASONB.txt,350700,351921,1221,10,N,N,-,-1,-1
MASONB.txt,350734,352057,1323,10,N,N,-,-1,-1
MASONB.txt,350786,352110,1324,10,N,N,-,-1,-1
MASONB.txt,350882,352442,1560,10,N,N,-,-1,-1
MASONB.txt,350956,352737,1781,10,N,N,-,-1,-1
MASONB.txt,351063,352905,1842,10,N,N,-,-1,-1
MASONB.txt,351236,352935,1699,10,N,N,-,-1,-1
MASONB.txt,351336,352954,1618,10,N,N,-,-1,-1
MASONB.txt,351555,352958,1403,10,N,N,-,-1,-1
MASONB.txt,351633,353197,1564,10,N,N,-,-1,-1
MASONB.txt,351922,353231,1309,10,N,N,-,-1,-1
MASONB.txt,352058,353641,1583,10,N,N,-,-1,-1
MASONB.txt,352111,353839,1728,10,N,N,-,-1,-1
MASONB.txt,352443,354292,1849,10,Y,N,-,-1,-1
MASONB.txt,352740,354429,1689,10,N,N,-,-1,-1
MASONB.txt,352910,354659,1749,10,N,N,-,-1,-1
MASONB.txt,352936,354684,1748,10,N,N,-,-1,-1
MASONB.txt,352957,354835,1878,10,N,N,-,-1,-1
MASONB.txt,352958,354842,1884,10,N,N,-,-1,-1
MASONB.txt,353200,354871,1671,10,N,N,-,-1,-1
MASONB.txt,353234,355020,1786,10,N,N,-,-1,-1
MASONB.txt,353642,355107,1465,10,N,N,-,-1,-1
MASONB.txt,353840,355372,1532,10,N,N,-,-1,-1
MASONB.txt,354293,355563,1270,10,N,N,-,-1,-1
MASONB.txt,354430,355668,1238,10,N,N,-,-1,-1
MASONB.txt,354662,355826,1164,10,N,N,-,-1,-1
MASONB.txt,354685,356081,1396,10,N,N,-,-1,-1
MASONB.txt,354840,356204,1364,10,N,N,-,-1,-1
MASONB.txt,354850,356429,1579,10,N,N,-,-1,-1
MASONB.txt,354874,356609,1735,10,N,N,-,-1,-1
MASONB.txt,355021,356775,1754,10,N,N,-,-1,-1
MASONB.txt,355108,356920,1812,10,N,N,-,-1,-1
MASONB.txt,355373,357014,1641,10,N,N,-,-1,-1
MASONB.txt,355564,357317,1753,10,N,N,-,-1,-1
MASONB.txt,355669,357446,1777,10,N,N,-,-1,-1
MASONB.txt,355828,357527,1699,10,N,N,-,-1,-1
MASONB.txt,356083,357590,1507,10,N,N,-,-1,-1
MASONB.txt,356206,357830,1624,10,N,N,-,-1,-1
MASONB.txt,356430,358197,1767,10,N,Y,1448659532009,324326,325031
MASONB.txt,356610,358310,1700,10,N,Y,1448659532009,324326,325031
MASONB.txt,356777,358433,1656,10,N,Y,1448659532009,324326,325031
MASONB.txt,356921,358674,1753,10,N,Y,1448659532009,324326,325031
MASONB.txt,357017,358744,1727,10,N,Y,1448659532009,324326,325031
MASONB.txt,357318,358771,1453,10,N,Y,1448659532009,324326,325031
MASONB.txt,357447,358854,1407,10,N,Y,1448659532009,324326,325031
MASONB.txt,357528,358867,1339,10,N,Y,1448659532009,324326,325031
MASONB.txt,357591,359048,1457,10,N,Y,1448659532009,324326,325031
MASONB.txt,357832,359458,1626,10,N,Y,1448659532009,324326,325031
MASONB.txt,358198,359587,1389,10,N,N,-,-1,-1
MASONB.txt,358311,359870,1559,10,N,N,-,-1,-1
MASONB.txt,358436,360159,1723,10,N,N,-,-1,-1
MASONB.txt,358677,360237,1560,10,N,N,-,-1,-1
MASONB.txt,358745,360261,1516,10,N,N,-,-1,-1
MASONB.txt,358772,360409,1637,10,N,N,-,-1,-1
MASONB.txt,358855,360504,1649,10,N,N,-,-1,-1
MASONB.txt,358868,360626,1758,10,N,N,-,-1,-1
MASONB.txt,359049,360864,1815,10,N,N,-,-1,-1
MASONB.txt,359459,360957,1498,10,N,N,-,-1,-1
MASONB.txt,359588,361056,1468,10,N,N,-,-1,-1
MASONB.txt,359871,361179,1308,10,N,N,-,-1,-1
MASONB.txt,360160,361287,1127,10,N,N,-,-1,-1
MASONB.txt,360238,361491,1253,10,N,N,-,-1,-1
MASONB.txt,360262,361618,1356,10,N,N,-,-1,-1
MASONB.txt,360410,361933,1523,10,Y,N,-,-1,-1
MASONB.txt,360505,362198,1693,10,Y,N,-,-1,-1
MASONB.txt,360627,362257,1630,10,Y,N,-,-1,-1
MASONB.txt,360865,362457,1592,10,Y,N,-,-1,-1
MASONB.txt,360960,362875,1915,10,Y,N,-,-1,-1
MASONB.txt,361057,362909,1852,10,Y,N,-,-1,-1
MASONB.txt,361180,363108,1928,10,Y,N,-,-1,-1
MASONB.txt,361288,363340,2052,10,Y,Y,1448707430181,333075,333132
MASONB.txt,361492,363544,2052,10,Y,Y,1448707430181,333075,333132
MASONB.txt,361619,363770,2151,10,Y,Y,1448707430181,333075,333132
MASONB.txt,361934,363890,1956,10,Y,Y,1448707430181,333075,333132
MASONB.txt,362199,364284,2085,10,Y,Y,1448707430181,333075,333132
MASONB.txt,362258,364645,2387,10,Y,Y,1448707430181,333075,333132
MASONB.txt,362459,364852,2393,10,Y,Y,1448707430181,333075,333132
MASONB.txt,362878,364868,1990,10,Y,Y,1448707430181,333075,333132
MASONB.txt,362910,364950,2040,10,Y,Y,1448707430181,333075,333132
MASONB.txt,363109,365119,2010,10,N,Y,1448707430181,333075,333132
MASONB.txt,363341,365236,1895,10,N,Y,1448707430181,333075,333132
MASONB.txt,363547,365316,1769,10,N,Y,1448707430181,333075,333132
MASONB.txt,363771,365387,1616,10,N,Y,1448707430181,333075,333132
MASONB.txt,363891,365532,1641,10,N,Y,1448707430181,333075,333132
MASONB.txt,364285,365684,1399,10,N,Y,1448707430181,333075,333132
MASONB.txt,364646,365975,1329,10,N,Y,1448707430181,333075,333132
MASONB.txt,364857,366165,1308,10,N,Y,1461682939139,540732,541471
MASONB.txt,364869,366237,1368,10,N,Y,1461682939139,540732,541471
MASONB.txt,364951,366363,1412,10,N,Y,1461682939139,540732,541471
MASONB.txt,365120,366427,1307,10,N,Y,1461682939139,540732,541471
MASONB.txt,365237,366490,1253,10,N,Y,1461682939139,540732,541471
MASONB.txt,365317,366561,1244,10,N,Y,1461682939139,540732,541471
MASONB.txt,365388,366762,1374,10,N,Y,1461682939139,540732,541471
MASONB.txt,365533,366843,1310,10,N,Y,1461682939139,540732,541471
MASONB.txt,365685,366921,1236,10,N,Y,1461682939139,540732,541471
MASONB.txt,365978,367052,1074,10,N,N,-,-1,-1
MASONB.txt,366167,367140,973,10,N,N,-,-1,-1
MASONB.txt,366238,367499,1261,10,N,Y,1462038377036,558101,558326
MASONB.txt,366364,367806,1442,10,N,Y,1462038377036,558101,558326
MASONB.txt,366428,368240,1812,10,N,Y,1462038377036,558101,558326
MASONB.txt,366491,368572,2081,10,Y,Y,1462038377036,558101,558326
MASONB.txt,366564,368922,2358,10,Y,Y,1462038377036,558101,558326
MASONB.txt,366763,368948,2185,10,Y,Y,1462038377036,558101,558326
MASONB.txt,366846,369017,2171,10,Y,Y,1462038377036,558101,558326
MASONB.txt,366922,369097,2175,10,Y,Y,1462038377036,558101,558326
MASONB.txt,367053,369144,2091,10,Y,Y,1462038377036,558101,558326
MASONB.txt,367141,369152,2011,10,Y,Y,1462038377036,558101,558326
MASONB.txt,367500,369338,1838,10,Y,Y,1462038377036,558101,558326
MASONB.txt,367807,369353,1546,10,Y,Y,1462038377036,558101,558326
MASONB.txt,368241,369388,1147,10,N,Y,1462038377036,558101,558326
MASONB.txt,368575,369468,893,10,N,N,-,-1,-1
MASONB.txt,368923,369548,625,10,N,N,-,-1,-1
MASONB.txt,368949,369671,722,10,N,N,-,-1,-1
MASONB.txt,369018,369761,743,10,N,N,-,-1,-1
MASONB.txt,369098,370141,1043,10,N,N,-,-1,-1
MASONB.txt,369145,370263,1118,10,N,N,-,-1,-1
MASONB.txt,369153,370553,1400,10,N,N,-,-1,-1
MASONB.txt,369341,370576,1235,10,N,N,-,-1,-1
MASONB.txt,369354,370605,1251,10,N,N,-,-1,-1
MASONB.txt,369389,370625,1236,10,N,N,-,-1,-1
MASONB.txt,369469,370663,1194,10,N,N,-,-1,-1
MASONB.txt,369549,370683,1134,10,N,N,-,-1,-1
MASONB.txt,369672,370778,1106,10,N,N,-,-1,-1
MASONB.txt,369762,370923,1161,10,N,N,-,-1,-1
MASONB.txt,370142,370952,810,10,N,N,-,-1,-1
MASONB.txt,370264,371023,759,10,N,Y,1462038250768,556311,558014
MASONB.txt,370554,371130,576,10,N,Y,1462038250768,556311,558014
MASONB.txt,370581,371272,691,10,N,Y,1462038250768,556311,558014
MASONB.txt,370610,371417,807,10,N,Y,1462038250768,556311,558014
MASONB.txt,370628,371558,930,10,N,Y,1462038250768,556311,558014
MASONB.txt,370666,371725,1059,10,N,Y,1462038250768,556311,558014
MASONB.txt,370686,371930,1244,10,N,Y,1462038250768,556311,558014
MASONB.txt,370779,372154,1375,10,N,Y,1462038250768,556311,558014
MASONB.txt,370924,372344,1420,10,N,Y,1462038250768,556311,558014
MASONB.txt,370953,372385,1432,10,Y,Y,1462038250768,556311,558014
MASONB.txt,371024,372506,1482,10,Y,Y,1462038250768,556311,558014
MASONB.txt,371131,372621,1490,10,Y,Y,1462038250768,556311,558014
MASONB.txt,371273,372910,1637,10,N,Y,1448919849796,347699,347997
MASONB.txt,371419,373068,1649,10,N,N,-,-1,-1
MASONB.txt,371559,373233,1674,10,N,N,-,-1,-1
MASONB.txt,371726,373320,1594,10,Y,N,-,-1,-1
MASONB.txt,371931,373374,1443,10,Y,N,-,-1,-1
MASONB.txt,372155,373472,1317,10,Y,Y,1448709547508,338621,338870
MASONB.txt,372344,373553,1209,10,Y,Y,1448709547508,338621,338870
MASONB.txt,372390,373681,1291,10,N,Y,1448709547508,338621,338870
MASONB.txt,372507,373846,1339,10,Y,Y,1448709547508,338621,338870
MASONB.txt,372622,373971,1349,10,Y,Y,1448709547508,338621,338870
MASONB.txt,372911,374079,1168,10,Y,Y,1448709547508,338621,338870
MASONB.txt,373071,374212,1141,10,Y,Y,1448709547508,338621,338870
MASONB.txt,373234,374305,1071,10,Y,Y,1448709547508,338621,338870
MASONB.txt,373321,374656,1335,10,Y,Y,1448709547508,338621,338870
MASONB.txt,373375,374747,1372,10,Y,Y,1448709547508,338621,338870
MASONB.txt,373473,375066,1593,10,Y,Y,1448709547508,338621,338870
MASONB.txt,373558,375085,1527,10,Y,Y,1448709547508,338621,338870
MASONB.txt,373683,375201,1518,10,Y,Y,1448709547508,338621,338870
MASONB.txt,373847,375316,1469,10,Y,Y,1448709547508,338621,338870
MASONB.txt,373972,375371,1399,10,Y,Y,1448709547508,338621,338870
MASONB.txt,374080,375429,1349,10,Y,Y,1448709547508,338621,338870
MASONB.txt,374215,375595,1380,10,Y,Y,1448709547508,338621,338870
MASONB.txt,374306,375697,1391,10,Y,Y,1448709547508,338621,338870
MASONB.txt,374657,375790,1133,10,Y,N,-,-1,-1
MASONB.txt,374748,375831,1083,10,Y,N,-,-1,-1
MASONB.txt,375067,375950,883,10,Y,N,-,-1,-1
MASONB.txt,375086,376078,992,10,Y,N,-,-1,-1
MASONB.txt,375204,376200,996,10,Y,N,-,-1,-1
MASONB.txt,375317,376431,1114,10,Y,N,-,-1,-1
MASONB.txt,375372,376586,1214,10,Y,N,-,-1,-1
MASONB.txt,375434,376685,1251,10,Y,N,-,-1,-1
MASONB.txt,375596,376797,1201,10,Y,N,-,-1,-1
MASONB.txt,375698,377004,1306,10,Y,N,-,-1,-1
MASONB.txt,375791,377123,1332,10,N,N,-,-1,-1
MASONB.txt,375832,377270,1438,10,N,Y,1448709670572,338913,339172
MASONB.txt,375951,377382,1431,10,N,Y,1448709670572,338913,339172
MASONB.txt,376079,377515,1436,10,N,Y,1448709670572,338913,339172
MASONB.txt,376201,377666,1465,10,N,Y,1448709670572,338913,339172
MASONB.txt,376432,377736,1304,10,N,Y,1448709670572,338913,339172
MASONB.txt,376588,377858,1270,10,N,Y,1448709670572,338913,339172
MASONB.txt,376686,377878,1192,10,N,Y,1448709670572,338913,339172
MASONB.txt,376798,377889,1091,10,N,Y,1448709670572,338913,339172
MASONB.txt,377005,378011,1006,10,N,Y,1448709670572,338913,339172
MASONB.txt,377123,378066,943,10,N,Y,1448709670572,338913,339172
MASONB.txt,377271,378281,1010,10,N,Y,1448709670572,338913,339172
MASONB.txt,377383,378422,1039,10,N,Y,1448709670572,338913,339172
MASONB.txt,377516,378649,1133,10,N,Y,1448709670572,338913,339172
MASONB.txt,377668,378840,1172,10,N,Y,1448709670572,338913,339172
MASONB.txt,377737,378864,1127,10,N,Y,1448709670572,338913,339172
MASONB.txt,377858,378872,1014,10,N,Y,1448709670572,338913,339172
MASONB.txt,377881,378908,1027,10,N,Y,1448709670572,338913,339172
MASONB.txt,377890,379092,1202,10,N,Y,1448709670572,338913,339172
MASONB.txt,378012,379433,1421,10,N,Y,1448709670572,338913,339172
MASONB.txt,378067,379517,1450,10,N,Y,1448709670572,338913,339172
MASONB.txt,378282,379629,1347,10,N,Y,1448709670572,338913,339172
MASONB.txt,378425,379799,1374,10,N,Y,1448709670572,338913,339172
MASONB.txt,378650,380141,1491,10,N,Y,1448709670572,338913,339172
MASONB.txt,378843,380339,1496,10,N,N,-,-1,-1
MASONB.txt,378865,380575,1710,10,N,N,-,-1,-1
MASONB.txt,378873,380717,1844,10,N,N,-,-1,-1
MASONB.txt,378909,380777,1868,10,N,Y,1449009694213,473488,474410
MASONB.txt,379093,380971,1878,10,N,Y,1449009694213,473488,474410
MASONB.txt,379434,380989,1555,10,N,Y,1449009694213,473488,474410
MASONB.txt,379518,381233,1715,10,Y,Y,1449009694213,473488,474410
MASONB.txt,379630,381458,1828,10,Y,Y,1449009694213,473488,474410
MASONB.txt,379800,381590,1790,10,Y,Y,1449009694213,473488,474410
MASONB.txt,380144,381769,1625,10,Y,Y,1448706327916,331732,332605
MASONB.txt,380340,381809,1469,10,Y,Y,1448706327916,331732,332605
MASONB.txt,380577,382014,1437,10,Y,Y,1448706327916,331732,332605
MASONB.txt,380720,382397,1677,10,Y,Y,1448706327916,331732,332605
MASONB.txt,380779,382659,1880,10,Y,Y,1448706327916,331732,332605
MASONB.txt,380973,382745,1772,10,Y,Y,1448706327916,331732,332605
MASONB.txt,380990,383042,2052,10,Y,Y,1448706327916,331732,332605
MASONB.txt,381235,383071,1836,10,Y,Y,1448706327916,331732,332605
MASONB.txt,381459,383114,1655,10,Y,Y,1448706327916,331732,332605
MASONB.txt,381591,383169,1578,10,Y,Y,1448706327916,331732,332605
MASONB.txt,381772,383212,1440,10,Y,Y,1448706327916,331732,332605
MASONB.txt,381810,383408,1598,10,Y,Y,1448706327916,331732,332605
MASONB.txt,382015,383692,1677,10,Y,Y,1448706327916,331732,332605
MASONB.txt,382400,383775,1375,10,N,N,-,-1,-1
MASONB.txt,382660,383913,1253,10,Y,N,-,-1,-1
MASONB.txt,382746,383990,1244,10,Y,N,-,-1,-1
MASONB.txt,383043,384213,1170,10,Y,N,-,-1,-1
MASONB.txt,383072,384316,1244,10,Y,N,-,-1,-1
MASONB.txt,383115,384406,1291,10,Y,N,-,-1,-1
MASONB.txt,383170,384444,1274,10,Y,N,-,-1,-1
MASONB.txt,383214,384481,1267,10,Y,N,-,-1,-1
MASONB.txt,383411,384555,1144,10,Y,N,-,-1,-1
MASONB.txt,383693,384635,942,10,Y,N,-,-1,-1
MASONB.txt,383778,384746,968,10,Y,N,-,-1,-1
MASONB.txt,383914,384751,837,10,N,N,-,-1,-1
MASONB.txt,383991,384810,819,10,N,N,-,-1,-1
MASONB.txt,384215,384913,698,10,N,N,-,-1,-1
MASONB.txt,384317,384984,667,10,N,N,-,-1,-1
MASONB.txt,384407,385066,659,10,N,N,-,-1,-1
MASONB.txt,384447,385169,722,10,N,N,-,-1,-1
MASONB.txt,384482,385439,957,10,N,N,-,-1,-1
MASONB.txt,384556,385583,1027,10,N,N,-,-1,-1
MASONB.txt,384637,385652,1015,10,N,N,-,-1,-1
MASONB.txt,384747,385725,978,10,N,N,-,-1,-1
MASONB.txt,384753,385777,1024,10,N,N,-,-1,-1
MASONB.txt,384811,385872,1061,10,N,N,-,-1,-1
MASONB.txt,384914,386124,1210,10,N,N,-,-1,-1
MASONB.txt,384985,386230,1245,10,N,N,-,-1,-1
MASONB.txt,385068,386385,1317,10,N,N,-,-1,-1
MASONB.txt,385170,386524,1354,10,N,N,-,-1,-1
MASONB.txt,385442,386528,1086,10,N,N,-,-1,-1
MASONB.txt,385584,386574,990,10,N,N,-,-1,-1
MASONB.txt,385655,386759,1104,10,N,N,-,-1,-1
MASONB.txt,385726,386796,1070,10,N,N,-,-1,-1
MASONB.txt,385778,386972,1194,10,N,N,-,-1,-1
MASONB.txt,385873,387065,1192,10,N,N,-,-1,-1
MASONB.txt,386125,387112,987,10,N,N,-,-1,-1
MASONB.txt,386231,387202,971,10,N,N,-,-1,-1
MASONB.txt,386386,387350,964,10,N,N,-,-1,-1
MASONB.txt,386527,387451,924,10,N,N,-,-1,-1
MASONB.txt,386529,387538,1009,10,N,N,-,-1,-1
MASONB.txt,386575,387662,1087,10,N,N,-,-1,-1
MASONB.txt,386760,387680,920,10,N,N,-,-1,-1
MASONB.txt,386797,387700,903,10,N,N,-,-1,-1
MASONB.txt,386973,387705,732,10,N,N,-,-1,-1
MASONB.txt,387066,387848,782,10,N,N,-,-1,-1
MASONB.txt,387113,388039,926,10,N,N,-,-1,-1
MASONB.txt,387203,388119,916,10,N,N,-,-1,-1
MASONB.txt,387351,388162,811,10,N,N,-,-1,-1
MASONB.txt,387453,388204,751,10,N,N,-,-1,-1
MASONB.txt,387539,388350,811,10,N,N,-,-1,-1
MASONB.txt,387663,388776,1113,10,N,N,-,-1,-1
MASONB.txt,387681,388806,1125,10,N,N,-,-1,-1
MASONB.txt,387701,388964,1263,10,N,N,-,-1,-1
MASONB.txt,387706,389135,1429,10,N,N,-,-1,-1
MASONB.txt,387849,389398,1549,10,N,N,-,-1,-1
MASONB.txt,388040,389520,1480,10,N,N,-,-1,-1
MASONB.txt,388120,389674,1554,10,N,N,-,-1,-1
MASONB.txt,388163,389686,1523,10,N,N,-,-1,-1
MASONB.txt,388205,389822,1617,10,N,N,-,-1,-1
MASONB.txt,388351,389950,1599,10,N,N,-,-1,-1
MASONB.txt,388777,390042,1265,10,N,N,-,-1,-1
MASONB.txt,388807,390189,1382,10,N,N,-,-1,-1
MASONB.txt,388965,390361,1396,10,N,N,-,-1,-1
MASONB.txt,389138,390558,1420,10,N,N,-,-1,-1
MASONB.txt,389399,390698,1299,10,N,N,-,-1,-1
MASONB.txt,389521,390821,1300,10,N,N,-,-1,-1
MASONB.txt,389677,391051,1374,10,N,N,-,-1,-1
MASONB.txt,389687,391178,1491,10,Y,N,-,-1,-1
MASONB.txt,389823,391235,1412,10,Y,N,-,-1,-1
MASONB.txt,389951,391442,1491,10,Y,N,-,-1,-1
MASONB.txt,390043,391707,1664,10,Y,N,-,-1,-1
MASONB.txt,390190,391732,1542,10,Y,N,-,-1,-1
MASONB.txt,390362,392049,1687,10,Y,N,-,-1,-1
MASONB.txt,390559,392183,1624,10,Y,N,-,-1,-1
MASONB.txt,390699,392361,1662,10,Y,N,-,-1,-1
MASONB.txt,390822,392554,1732,10,Y,N,-,-1,-1
MASONB.txt,391052,392835,1783,10,Y,N,-,-1,-1
MASONB.txt,391179,393174,1995,10,Y,N,-,-1,-1
MASONB.txt,391236,393348,2112,10,Y,N,-,-1,-1
MASONB.txt,391444,393613,2169,10,Y,N,-,-1,-1
MASONB.txt,391712,393747,2035,10,Y,N,-,-1,-1
MASONB.txt,391733,394137,2404,10,Y,N,-,-1,-1
MASONB.txt,392050,394377,2327,10,Y,N,-,-1,-1
MASONB.txt,392186,394421,2235,10,Y,N,-,-1,-1
MASONB.txt,392362,394541,2179,10,Y,N,-,-1,-1
MASONB.txt,392555,394602,2047,10,N,N,-,-1,-1
MASONB.txt,392838,394653,1815,10,N,N,-,-1,-1
MASONB.txt,393175,394814,1639,10,N,N,-,-1,-1
MASONB.txt,393349,394869,1520,10,N,N,-,-1,-1
MASONB.txt,393614,394946,1332,10,N,N,-,-1,-1
MASONB.txt,393750,395064,1314,10,N,N,-,-1,-1
MASONB.txt,394140,395126,986,10,N,N,-,-1,-1
MASONB.txt,394380,395220,840,10,N,N,-,-1,-1
MASONB.txt,394422,395329,907,10,N,N,-,-1,-1
MASONB.txt,394543,395381,838,10,N,N,-,-1,-1
MASONB.txt,394604,395428,824,10,N,N,-,-1,-1
MASONB.txt,394653,395470,817,10,N,N,-,-1,-1
MASONB.txt,394816,395562,746,10,N,N,-,-1,-1
MASONB.txt,394871,395587,716,10,N,N,-,-1,-1
MASONB.txt,394948,395649,701,10,N,N,-,-1,-1
MASONB.txt,395066,395704,638,10,N,N,-,-1,-1
MASONB.txt,395128,395768,640,10,N,N,-,-1,-1
MASONB.txt,395222,395816,594,10,N,N,-,-1,-1
MASONB.txt,395331,395877,546,10,N,N,-,-1,-1
MASONB.txt,395383,395933,550,10,N,N,-,-1,-1
MASONB.txt,395430,396019,589,10,N,N,-,-1,-1
MASONB.txt,395472,396078,606,10,N,N,-,-1,-1
MASONB.txt,395567,396120,553,10,N,N,-,-1,-1
MASONB.txt,395588,396190,602,10,N,N,-,-1,-1
MASONB.txt,395649,396236,587,10,N,N,-,-1,-1
MASONB.txt,395707,396350,643,10,N,N,-,-1,-1
MASONB.txt,395768,396435,667,10,N,N,-,-1,-1
MASONB.txt,395819,396477,658,10,N,N,-,-1,-1
MASONB.txt,395880,396531,651,10,N,N,-,-1,-1
MASONB.txt,395933,396593,660,10,N,N,-,-1,-1
MASONB.txt,396021,396699,678,10,N,N,-,-1,-1
MASONB.txt,396078,396834,756,10,N,N,-,-1,-1
MASONB.txt,396123,396853,730,10,N,N,-,-1,-1
MASONB.txt,396190,396922,732,10,N,N,-,-1,-1
MASONB.txt,396236,396968,732,10,N,N,-,-1,-1
MASONB.txt,396350,397059,709,10,N,N,-,-1,-1
MASONB.txt,396435,397158,723,10,N,N,-,-1,-1
MASONB.txt,396477,397203,726,10,N,N,-,-1,-1
MASONB.txt,396531,397321,790,10,N,N,-,-1,-1
MASONB.txt,396593,397336,743,10,N,N,-,-1,-1
MASONB.txt,396699,397343,644,10,N,N,-,-1,-1
MASONB.txt,396837,397356,519,10,N,N,-,-1,-1
MASONB.txt,396854,397393,539,10,N,N,-,-1,-1
MASONB.txt,396923,397400,477,10,N,N,-,-1,-1
MASONB.txt,396969,397410,441,10,N,N,-,-1,-1
MASONB.txt,397060,397423,363,10,N,N,-,-1,-1
MASONB.txt,397159,397557,398,10,N,N,-,-1,-1
MASONB.txt,397203,397569,366,10,N,N,-,-1,-1
MASONB.txt,397322,397603,281,10,N,N,-,-1,-1
MASONB.txt,397337,397623,286,10,N,N,-,-1,-1
MASONB.txt,397346,397706,360,10,N,N,-,-1,-1
MASONB.txt,397357,397717,360,10,N,N,-,-1,-1
MASONB.txt,397394,397762,368,10,N,N,-,-1,-1
MASONB.txt,397401,397786,385,10,N,N,-,-1,-1
MASONB.txt,397413,397795,382,10,N,N,-,-1,-1
MASONB.txt,397424,397828,404,10,N,N,-,-1,-1
MASONB.txt,397558,397888,330,10,N,N,-,-1,-1
MASONB.txt,397572,397925,353,10,N,N,-,-1,-1
MASONB.txt,397604,397943,339,10,N,N,-,-1,-1
MASONB.txt,397626,398057,431,10,N,N,-,-1,-1
MASONB.txt,397707,398156,449,10,N,N,-,-1,-1
MASONB.txt,397720,398158,438,10,N,N,-,-1,-1
MASONB.txt,397763,398223,460,10,N,N,-,-1,-1
MASONB.txt,397787,398293,506,10,N,N,-,-1,-1
MASONB.txt,397798,398387,589,10,N,N,-,-1,-1
MASONB.txt,397829,398460,631,10,N,N,-,-1,-1
MASONB.txt,397889,398490,601,10,N,N,-,-1,-1
MASONB.txt,397926,398514,588,10,N,N,-,-1,-1
MASONB.txt,397944,398550,606,10,N,N,-,-1,-1
MASONB.txt,398058,398587,529,10,N,N,-,-1,-1
MASONB.txt,398157,398667,510,10,N,N,-,-1,-1
MASONB.txt,398158,398802,644,10,N,N,-,-1,-1
MASONB.txt,398225,398876,651,10,N,N,-,-1,-1
MASONB.txt,398293,399060,767,10,N,N,-,-1,-1
MASONB.txt,398388,399267,879,10,N,N,-,-1,-1
MASONB.txt,398461,399495,1034,10,N,N,-,-1,-1
MASONB.txt,398491,399575,1084,10,N,N,-,-1,-1
MASONB.txt,398517,399670,1153,10,N,N,-,-1,-1
MASONB.txt,398551,399700,1149,10,N,N,-,-1,-1
MASONB.txt,398588,399803,1215,10,N,N,-,-1,-1
MASONB.txt,398670,399885,1215,10,N,N,-,-1,-1
MASONB.txt,398803,400005,1202,10,N,N,-,-1,-1
MASONB.txt,398876,400055,1179,10,N,N,-,-1,-1
MASONB.txt,399061,400147,1086,10,N,N,-,-1,-1
MASONB.txt,399268,400224,956,10,N,N,-,-1,-1
MASONB.txt,399496,400386,890,10,N,N,-,-1,-1
MASONB.txt,399577,400620,1043,10,Y,N,-,-1,-1
MASONB.txt,399671,400678,1007,10,Y,N,-,-1,-1
MASONB.txt,399702,400708,1006,10,Y,N,-,-1,-1
MASONB.txt,399804,400902,1098,10,Y,N,-,-1,-1
MASONB.txt,399887,401175,1288,10,Y,N,-,-1,-1
MASONB.txt,400008,401211,1203,10,Y,N,-,-1,-1
MASONB.txt,400056,401500,1444,10,Y,N,-,-1,-1
MASONB.txt,400148,401625,1477,10,Y,N,-,-1,-1
MASONB.txt,400225,401852,1627,10,Y,N,-,-1,-1
MASONB.txt,400387,401998,1611,10,Y,N,-,-1,-1
MASONB.txt,400623,402073,1450,10,Y,N,-,-1,-1
MASONB.txt,400678,402363,1685,10,Y,N,-,-1,-1
MASONB.txt,400711,402470,1759,10,Y,N,-,-1,-1
MASONB.txt,400904,402565,1661,10,Y,N,-,-1,-1
MASONB.txt,401176,402636,1460,10,Y,N,-,-1,-1
MASONB.txt,401212,402731,1519,10,Y,N,-,-1,-1
MASONB.txt,401501,402905,1404,10,N,N,-,-1,-1
MASONB.txt,401626,403042,1416,10,N,N,-,-1,-1
MASONB.txt,401853,403127,1274,10,N,N,-,-1,-1
MASONB.txt,402001,403295,1294,10,N,N,-,-1,-1
MASONB.txt,402074,403378,1304,10,N,N,-,-1,-1
MASONB.txt,402364,403494,1130,10,N,N,-,-1,-1
MASONB.txt,402473,403652,1179,10,N,N,-,-1,-1
MASONB.txt,402566,403713,1147,10,N,N,-,-1,-1
MASONB.txt,402638,403769,1131,10,N,N,-,-1,-1
MASONB.txt,402732,403996,1264,10,N,N,-,-1,-1
MASONB.txt,402906,404114,1208,10,N,N,-,-1,-1
MASONB.txt,403043,404327,1284,10,N,N,-,-1,-1
MASONB.txt,403128,404388,1260,10,N,N,-,-1,-1
MASONB.txt,403296,404589,1293,10,N,N,-,-1,-1
MASONB.txt,403379,404698,1319,10,N,N,-,-1,-1
MASONB.txt,403495,404943,1448,10,N,N,-,-1,-1
MASONB.txt,403653,405197,1544,10,N,N,-,-1,-1
MASONB.txt,403714,405359,1645,10,Y,N,-,-1,-1
MASONB.txt,403770,405488,1718,10,Y,N,-,-1,-1
MASONB.txt,403997,405573,1576,10,Y,N,-,-1,-1
MASONB.txt,404115,405719,1604,10,Y,N,-,-1,-1
MASONB.txt,404328,406052,1724,10,Y,N,-,-1,-1
MASONB.txt,404389,406093,1704,10,Y,N,-,-1,-1
MASONB.txt,404592,406247,1655,10,Y,N,-,-1,-1
MASONB.txt,404699,406269,1570,10,Y,N,-,-1,-1
MASONB.txt,404944,406562,1618,10,Y,N,-,-1,-1
MASONB.txt,405198,406591,1393,10,Y,N,-,-1,-1
MASONB.txt,405360,406745,1385,10,Y,N,-,-1,-1
MASONB.txt,405491,406766,1275,10,N,N,-,-1,-1
MASONB.txt,405574,406795,1221,10,N,N,-,-1,-1
MASONB.txt,405720,406877,1157,10,N,N,-,-1,-1
MASONB.txt,406053,407085,1032,10,N,N,-,-1,-1
MASONB.txt,406094,407279,1185,10,N,N,-,-1,-1
MASONB.txt,406248,407412,1164,10,N,N,-,-1,-1
MASONB.txt,406270,407413,1143,10,N,N,-,-1,-1
MASONB.txt,406563,407529,966,10,N,N,-,-1,-1
MASONB.txt,406592,407534,942,10,N,N,-,-1,-1
MASONB.txt,406748,407831,1083,10,N,N,-,-1,-1
MASONB.txt,406767,408010,1243,10,N,N,-,-1,-1
MASONB.txt,406796,408178,1382,10,Y,N,-,-1,-1
MASONB.txt,406878,408260,1382,10,Y,N,-,-1,-1
MASONB.txt,407086,408295,1209,10,Y,N,-,-1,-1
MASONB.txt,407280,408350,1070,10,Y,N,-,-1,-1
MASONB.txt,407412,408458,1046,10,N,N,-,-1,-1
MASONB.txt,407414,408574,1160,10,Y,N,-,-1,-1
MASONB.txt,407530,408786,1256,10,Y,N,-,-1,-1
MASONB.txt,407535,408820,1285,10,Y,N,-,-1,-1
MASONB.txt,407832,408882,1050,10,N,N,-,-1,-1
MASONB.txt,408013,408994,981,10,N,N,-,-1,-1
MASONB.txt,408179,409096,917,10,N,N,-,-1,-1
MASONB.txt,408262,409202,940,10,N,N,-,-1,-1
MASONB.txt,408297,409318,1021,10,N,N,-,-1,-1
MASONB.txt,408352,409419,1067,10,N,N,-,-1,-1
MASONB.txt,408459,409520,1061,10,N,N,-,-1,-1
MASONB.txt,408575,409681,1106,10,N,N,-,-1,-1
MASONB.txt,408787,409739,952,10,N,N,-,-1,-1
MASONB.txt,408821,410055,1234,10,N,N,-,-1,-1
MASONB.txt,408883,410179,1296,10,N,N,-,-1,-1
MASONB.txt,408995,410310,1315,10,N,N,-,-1,-1
MASONB.txt,409097,410367,1270,10,N,N,-,-1,-1
MASONB.txt,409204,410457,1253,10,N,N,-,-1,-1
MASONB.txt,409319,410510,1191,10,N,N,-,-1,-1
MASONB.txt,409420,410610,1190,10,N,N,-,-1,-1
MASONB.txt,409520,410704,1184,10,N,N,-,-1,-1
MASONB.txt,409682,410769,1087,10,N,N,-,-1,-1
MASONB.txt,409740,411009,1269,10,Y,N,-,-1,-1
MASONB.txt,410056,411171,1115,10,Y,N,-,-1,-1
MASONB.txt,410180,411283,1103,10,Y,N,-,-1,-1
MASONB.txt,410313,411382,1069,10,Y,N,-,-1,-1
MASONB.txt,410369,411471,1102,10,Y,N,-,-1,-1
MASONB.txt,410458,411668,1210,10,Y,N,-,-1,-1
MASONB.txt,410511,411869,1358,10,Y,N,-,-1,-1
MASONB.txt,410611,411991,1380,10,Y,N,-,-1,-1
MASONB.txt,410705,412118,1413,10,Y,N,-,-1,-1
MASONB.txt,410770,412233,1463,10,Y,N,-,-1,-1
MASONB.txt,411011,412382,1371,10,N,N,-,-1,-1
MASONB.txt,411172,412459,1287,10,N,N,-,-1,-1
MASONB.txt,411284,412498,1214,10,N,N,-,-1,-1
MASONB.txt,411384,412603,1219,10,N,N,-,-1,-1
MASONB.txt,411472,412726,1254,10,N,N,-,-1,-1
MASONB.txt,411669,412885,1216,10,N,N,-,-1,-1
MASONB.txt,411870,412906,1036,10,N,N,-,-1,-1
MASONB.txt,411993,413018,1025,10,N,N,-,-1,-1
MASONB.txt,412120,413096,976,10,N,N,-,-1,-1
MASONB.txt,412234,413175,941,10,N,N,-,-1,-1
MASONB.txt,412383,413521,1138,10,N,N,-,-1,-1
MASONB.txt,412462,413712,1250,10,N,N,-,-1,-1
MASONB.txt,412499,413915,1416,10,N,N,-,-1,-1
MASONB.txt,412604,413991,1387,10,N,N,-,-1,-1
MASONB.txt,412727,414000,1273,10,N,N,-,-1,-1
MASONB.txt,412888,414039,1151,10,N,N,-,-1,-1
MASONB.txt,412907,414121,1214,10,N,N,-,-1,-1
MASONB.txt,413019,414161,1142,10,N,N,-,-1,-1
MASONB.txt,413097,414192,1095,10,N,N,-,-1,-1
MASONB.txt,413176,414204,1028,10,N,N,-,-1,-1
MASONB.txt,413523,414212,689,10,N,N,-,-1,-1
MASONB.txt,413714,414253,539,10,N,N,-,-1,-1
MASONB.txt,413916,414288,372,10,N,N,-,-1,-1
MASONB.txt,413992,414299,307,10,N,N,-,-1,-1
MASONB.txt,414003,414354,351,10,N,N,-,-1,-1
MASONB.txt,414040,414424,384,10,N,N,-,-1,-1
MASONB.txt,414121,414435,314,10,N,N,-,-1,-1
MASONB.txt,414162,414492,330,10,N,N,-,-1,-1
MASONB.txt,414193,414512,319,10,N,N,-,-1,-1
MASONB.txt,414205,414525,320,10,N,N,-,-1,-1
MASONB.txt,414212,414553,341,10,N,N,-,-1,-1
MASONB.txt,414256,414575,319,10,N,N,-,-1,-1
MASONB.txt,414289,414577,288,10,N,N,-,-1,-1
MASONB.txt,414300,414625,325,10,N,N,-,-1,-1
MASONB.txt,414355,414635,280,10,N,N,-,-1,-1
MASONB.txt,414425,414656,231,10,N,N,-,-1,-1
MASONB.txt,414438,414682,244,10,N,N,-,-1,-1
MASONB.txt,414495,414691,196,10,N,N,-,-1,-1
MASONB.txt,414515,414693,178,10,N,N,-,-1,-1
MASONB.txt,414526,414695,169,10,N,N,-,-1,-1
MASONB.txt,414553,414775,222,10,N,N,-,-1,-1
MASONB.txt,414576,414799,223,10,N,N,-,-1,-1
MASONB.txt,414578,414838,260,10,N,N,-,-1,-1
MASONB.txt,414626,414879,253,10,N,N,-,-1,-1
MASONB.txt,414638,414930,292,10,N,N,-,-1,-1
MASONB.txt,414657,414943,286,10,N,N,-,-1,-1
MASONB.txt,414683,415086,403,10,N,N,-,-1,-1
MASONB.txt,414692,415247,555,10,N,N,-,-1,-1
MASONB.txt,414694,415269,575,10,N,N,-,-1,-1
MASONB.txt,414696,415325,629,10,N,N,-,-1,-1
MASONB.txt,414778,415339,561,10,N,N,-,-1,-1
MASONB.txt,414800,415400,600,10,N,N,-,-1,-1
MASONB.txt,414839,415416,577,10,N,N,-,-1,-1
MASONB.txt,414879,415475,596,10,N,N,-,-1,-1
MASONB.txt,414930,415490,560,10,N,N,-,-1,-1
MASONB.txt,414946,415518,572,10,N,N,-,-1,-1
MASONB.txt,415086,415542,456,10,N,N,-,-1,-1
MASONB.txt,415247,415554,307,10,N,N,-,-1,-1
MASONB.txt,415272,415562,290,10,N,N,-,-1,-1
MASONB.txt,415325,415631,306,10,N,N,-,-1,-1
MASONB.txt,415340,415652,312,10,N,N,-,-1,-1
MASONB.txt,415400,415671,271,10,N,N,-,-1,-1
MASONB.txt,415417,415879,462,10,N,N,-,-1,-1
MASONB.txt,415475,415945,470,10,N,N,-,-1,-1
MASONB.txt,415491,416266,775,10,N,N,-,-1,-1
MASONB.txt,415519,416275,756,10,N,N,-,-1,-1
MASONB.txt,415542,416300,758,10,N,N,-,-1,-1
MASONB.txt,415555,416441,886,10,N,N,-,-1,-1
MASONB.txt,415565,416569,1004,10,N,N,-,-1,-1
MASONB.txt,415632,416656,1024,10,N,N,-,-1,-1
MASONB.txt,415652,416768,1116,10,N,N,-,-1,-1
MASONB.txt,415672,416960,1288,10,N,N,-,-1,-1
MASONB.txt,415880,417013,1133,10,N,N,-,-1,-1
MASONB.txt,415946,417166,1220,10,N,N,-,-1,-1
MASONB.txt,416269,417307,1038,10,N,N,-,-1,-1
MASONB.txt,416276,417415,1139,10,N,N,-,-1,-1
MASONB.txt,416301,417504,1203,10,N,N,-,-1,-1
MASONB.txt,416442,417541,1099,10,N,N,-,-1,-1
MASONB.txt,416569,417875,1306,10,N,N,-,-1,-1
MASONB.txt,416657,417989,1332,10,N,N,-,-1,-1
MASONB.txt,416771,418089,1318,10,N,N,-,-1,-1
MASONB.txt,416961,418298,1337,10,Y,N,-,-1,-1
MASONB.txt,417014,418450,1436,10,Y,N,-,-1,-1
MASONB.txt,417167,418521,1354,10,N,N,-,-1,-1
MASONB.txt,417308,418686,1378,10,N,N,-,-1,-1
MASONB.txt,417416,418873,1457,10,Y,N,-,-1,-1
MASONB.txt,417505,419007,1502,10,Y,N,-,-1,-1
MASONB.txt,417542,419065,1523,10,Y,N,-,-1,-1
MASONB.txt,417876,419152,1276,10,Y,N,-,-1,-1
MASONB.txt,417990,419434,1444,10,Y,N,-,-1,-1
MASONB.txt,418092,419451,1359,10,Y,N,-,-1,-1
MASONB.txt,418299,419583,1284,10,Y,N,-,-1,-1
MASONB.txt,418451,419670,1219,10,Y,N,-,-1,-1
MASONB.txt,418522,419766,1244,10,Y,N,-,-1,-1
MASONB.txt,418687,419803,1116,10,Y,N,-,-1,-1
MASONB.txt,418874,419861,987,10,Y,N,-,-1,-1
MASONB.txt,419008,419989,981,10,N,N,-,-1,-1
MASONB.txt,419066,420089,1023,10,N,N,-,-1,-1
MASONB.txt,419153,420232,1079,10,N,N,-,-1,-1
MASONB.txt,419435,420333,898,10,N,N,-,-1,-1
MASONB.txt,419452,420599,1147,10,N,N,-,-1,-1
MASONB.txt,419584,420694,1110,10,N,N,-,-1,-1
MASONB.txt,419671,420848,1177,10,N,N,-,-1,-1
MASONB.txt,419769,421092,1323,10,N,N,-,-1,-1
MASONB.txt,419804,421223,1419,10,N,N,-,-1,-1
MASONB.txt,419862,421362,1500,10,N,N,-,-1,-1
MASONB.txt,419990,421496,1506,10,N,N,-,-1,-1
MASONB.txt,420090,421526,1436,10,N,N,-,-1,-1
MASONB.txt,420235,421867,1632,10,N,N,-,-1,-1
MASONB.txt,420334,421890,1556,10,N,N,-,-1,-1
MASONB.txt,420600,422023,1423,10,N,N,-,-1,-1
MASONB.txt,420695,422202,1507,10,Y,N,-,-1,-1
MASONB.txt,420851,422254,1403,10,N,N,-,-1,-1
MASONB.txt,421093,422373,1280,10,N,N,-,-1,-1
MASONB.txt,421224,422458,1234,10,N,N,-,-1,-1
MASONB.txt,421365,422553,1188,10,Y,N,-,-1,-1
MASONB.txt,421497,422599,1102,10,Y,N,-,-1,-1
MASONB.txt,421527,422673,1146,10,Y,N,-,-1,-1
MASONB.txt,421868,422767,899,10,Y,N,-,-1,-1
MASONB.txt,421891,422826,935,10,Y,N,-,-1,-1
MASONB.txt,422024,422997,973,10,Y,N,-,-1,-1
MASONB.txt,422203,423216,1013,10,Y,N,-,-1,-1
MASONB.txt,422255,423312,1057,10,Y,N,-,-1,-1
MASONB.txt,422376,423366,990,10,Y,N,-,-1,-1
MASONB.txt,422459,423604,1145,10,Y,N,-,-1,-1
MASONB.txt,422554,423692,1138,10,Y,N,-,-1,-1
MASONB.txt,422600,423774,1174,10,N,N,-,-1,-1
MASONB.txt,422674,423861,1187,10,N,N,-,-1,-1
MASONB.txt,422768,424030,1262,10,N,N,-,-1,-1
MASONB.txt,422827,424146,1319,10,N,N,-,-1,-1
MASONB.txt,422999,424217,1218,10,N,N,-,-1,-1
MASONB.txt,423217,424286,1069,10,Y,N,-,-1,-1
MASONB.txt,423313,424370,1057,10,Y,N,-,-1,-1
MASONB.txt,423368,424549,1181,10,Y,N,-,-1,-1
MASONB.txt,423605,424743,1138,10,N,N,-,-1,-1
MASONB.txt,423694,424917,1223,10,Y,N,-,-1,-1
MASONB.txt,423775,424967,1192,10,Y,N,-,-1,-1
MASONB.txt,423862,425133,1271,10,N,N,-,-1,-1
MASONB.txt,424031,425265,1234,10,N,N,-,-1,-1
MASONB.txt,424147,425376,1229,10,N,N,-,-1,-1
MASONB.txt,424218,425590,1372,10,N,N,-,-1,-1
MASONB.txt,424289,425840,1551,10,N,N,-,-1,-1
MASONB.txt,424371,425972,1601,10,N,N,-,-1,-1
MASONB.txt,424552,426062,1510,10,N,N,-,-1,-1
MASONB.txt,424746,426109,1363,10,N,N,-,-1,-1
MASONB.txt,424918,426274,1356,10,N,N,-,-1,-1
MASONB.txt,424968,426469,1501,10,N,N,-,-1,-1
MASONB.txt,425135,426720,1585,10,N,N,-,-1,-1
MASONB.txt,425266,426884,1618,10,Y,N,-,-1,-1
MASONB.txt,425377,427016,1639,10,Y,N,-,-1,-1
MASONB.txt,425591,427030,1439,10,N,N,-,-1,-1
MASONB.txt,425841,427058,1217,10,Y,N,-,-1,-1
MASONB.txt,425973,427121,1148,10,Y,N,-,-1,-1
MASONB.txt,426063,427167,1104,10,N,N,-,-1,-1
MASONB.txt,426110,427208,1098,10,N,N,-,-1,-1
MASONB.txt,426275,427437,1162,10,N,N,-,-1,-1
MASONB.txt,426471,427590,1119,10,N,N,-,-1,-1
MASONB.txt,426721,427807,1086,10,N,N,-,-1,-1
MASONB.txt,426887,427983,1096,10,N,N,-,-1,-1
MASONB.txt,427017,428151,1134,10,N,N,-,-1,-1
MASONB.txt,427031,428306,1275,10,N,N,-,-1,-1
MASONB.txt,427059,428338,1279,10,N,N,-,-1,-1
MASONB.txt,427122,428481,1359,10,N,N,-,-1,-1
MASONB.txt,427168,428589,1421,10,N,N,-,-1,-1
MASONB.txt,427209,428812,1603,10,N,N,-,-1,-1
MASONB.txt,427438,428909,1471,10,N,N,-,-1,-1
MASONB.txt,427591,429054,1463,10,N,N,-,-1,-1
MASONB.txt,427808,429241,1433,10,N,N,-,-1,-1
MASONB.txt,427984,429540,1556,10,N,N,-,-1,-1
MASONB.txt,428153,429593,1440,10,N,N,-,-1,-1
MASONB.txt,428309,429950,1641,10,Y,N,-,-1,-1
MASONB.txt,428339,430069,1730,10,Y,N,-,-1,-1
MASONB.txt,428482,430259,1777,10,Y,N,-,-1,-1
MASONB.txt,428590,430364,1774,10,Y,N,-,-1,-1
MASONB.txt,428813,430389,1576,10,N,N,-,-1,-1
MASONB.txt,428910,430507,1597,10,N,N,-,-1,-1
MASONB.txt,429055,430615,1560,10,Y,N,-,-1,-1
MASONB.txt,429242,430732,1490,10,Y,N,-,-1,-1
MASONB.txt,429541,431002,1461,10,Y,N,-,-1,-1
MASONB.txt,429594,431115,1521,10,Y,N,-,-1,-1
MASONB.txt,429951,431160,1209,10,Y,N,-,-1,-1
MASONB.txt,430070,431257,1187,10,Y,N,-,-1,-1
MASONB.txt,430260,431425,1165,10,Y,N,-,-1,-1
MASONB.txt,430365,431485,1120,10,Y,N,-,-1,-1
MASONB.txt,430390,431568,1178,10,Y,N,-,-1,-1
MASONB.txt,430510,431574,1064,10,N,N,-,-1,-1
MASONB.txt,430616,431704,1088,10,N,N,-,-1,-1
MASONB.txt,430733,431790,1057,10,N,N,-,-1,-1
MASONB.txt,431003,431952,949,10,N,N,-,-1,-1
MASONB.txt,431116,432063,947,10,N,N,-,-1,-1
MASONB.txt,431161,432135,974,10,N,N,-,-1,-1
MASONB.txt,431259,432146,887,10,N,N,-,-1,-1
MASONB.txt,431426,432361,935,10,N,N,-,-1,-1
MASONB.txt,431486,432381,895,10,N,N,-,-1,-1
MASONB.txt,431569,432551,982,10,N,N,-,-1,-1
MASONB.txt,431576,432695,1119,10,N,N,-,-1,-1
MASONB.txt,431706,433026,1320,10,N,N,-,-1,-1
MASONB.txt,431791,433231,1440,10,N,N,-,-1,-1
MASONB.txt,431953,433282,1329,10,N,N,-,-1,-1
MASONB.txt,432064,433428,1364,10,N,N,-,-1,-1
MASONB.txt,432138,433520,1382,10,N,N,-,-1,-1
MASONB.txt,432147,433706,1559,10,Y,N,-,-1,-1
MASONB.txt,432364,433833,1469,10,N,N,-,-1,-1
MASONB.txt,432382,434055,1673,10,N,N,-,-1,-1
MASONB.txt,432552,434111,1559,10,N,N,-,-1,-1
MASONB.txt,432696,434128,1432,10,N,N,-,-1,-1
MASONB.txt,433027,434416,1389,10,N,N,-,-1,-1
MASONB.txt,433232,434447,1215,10,N,N,-,-1,-1
MASONB.txt,433283,434568,1285,10,N,N,-,-1,-1
MASONB.txt,433429,434641,1212,10,N,N,-,-1,-1
MASONB.txt,433521,434792,1271,10,N,N,-,-1,-1
MASONB.txt,433707,434881,1174,10,N,N,-,-1,-1
MASONB.txt,433834,434972,1138,10,N,N,-,-1,-1
MASONB.txt,434056,435123,1067,10,N,N,-,-1,-1
MASONB.txt,434112,435201,1089,10,N,N,-,-1,-1
MASONB.txt,434129,435318,1189,10,N,N,-,-1,-1
MASONB.txt,434417,435413,996,10,N,N,-,-1,-1
MASONB.txt,434448,435470,1022,10,N,N,-,-1,-1
MASONB.txt,434569,435564,995,10,N,N,-,-1,-1
MASONB.txt,434642,435663,1021,10,Y,N,-,-1,-1
MASONB.txt,434794,435824,1030,10,Y,N,-,-1,-1
MASONB.txt,434882,435863,981,10,Y,N,-,-1,-1
MASONB.txt,434973,435922,949,10,Y,N,-,-1,-1
MASONB.txt,435124,436078,954,10,Y,N,-,-1,-1
MASONB.txt,435202,436237,1035,10,Y,N,-,-1,-1
MASONB.txt,435319,436308,989,10,Y,N,-,-1,-1
MASONB.txt,435414,436425,1011,10,Y,N,-,-1,-1
MASONB.txt,435473,436616,1143,10,Y,N,-,-1,-1
MASONB.txt,435565,436743,1178,10,Y,N,-,-1,-1
MASONB.txt,435664,436778,1114,10,Y,N,-,-1,-1
MASONB.txt,435825,436926,1101,10,N,N,-,-1,-1
MASONB.txt,435864,437104,1240,10,N,N,-,-1,-1
MASONB.txt,435923,437268,1345,10,N,N,-,-1,-1
MASONB.txt,436079,437675,1596,10,N,N,-,-1,-1
MASONB.txt,436238,438093,1855,10,N,N,-,-1,-1
MASONB.txt,436309,438209,1900,10,N,N,-,-1,-1
MASONB.txt,436428,438256,1828,10,N,N,-,-1,-1
MASONB.txt,436617,438399,1782,10,N,N,-,-1,-1
MASONB.txt,436744,438427,1683,10,N,N,-,-1,-1
MASONB.txt,436780,438724,1944,10,N,N,-,-1,-1
MASONB.txt,436927,438833,1906,10,N,N,-,-1,-1
MASONB.txt,437105,438957,1852,10,N,N,-,-1,-1
MASONB.txt,437269,439427,2158,10,N,N,-,-1,-1
MASONB.txt,437676,439567,1891,10,N,N,-,-1,-1
MASONB.txt,438096,439671,1575,10,N,N,-,-1,-1
MASONB.txt,438210,439765,1555,10,N,N,-,-1,-1
MASONB.txt,438257,439910,1653,10,N,N,-,-1,-1
MASONB.txt,438400,440038,1638,10,N,N,-,-1,-1
MASONB.txt,438428,440482,2054,10,N,N,-,-1,-1
MASONB.txt,438725,440566,1841,10,N,N,-,-1,-1
MASONB.txt,438834,440908,2074,10,N,N,-,-1,-1
MASONB.txt,438958,441137,2179,10,N,N,-,-1,-1
MASONB.txt,439428,441211,1783,10,N,N,-,-1,-1
MASONB.txt,439569,441280,1711,10,N,N,-,-1,-1
MASONB.txt,439672,441318,1646,10,N,N,-,-1,-1
MASONB.txt,439766,441368,1602,10,N,N,-,-1,-1
MASONB.txt,439911,441491,1580,10,N,N,-,-1,-1
MASONB.txt,440039,441606,1567,10,N,N,-,-1,-1
MASONB.txt,440485,441721,1236,10,N,N,-,-1,-1
MASONB.txt,440567,441964,1397,10,Y,N,-,-1,-1
MASONB.txt,440909,442067,1158,10,Y,N,-,-1,-1
MASONB.txt,441138,442252,1114,10,Y,N,-,-1,-1
MASONB.txt,441212,442339,1127,10,Y,N,-,-1,-1
MASONB.txt,441283,442468,1185,10,Y,N,-,-1,-1
MASONB.txt,441319,442762,1443,10,Y,N,-,-1,-1
MASONB.txt,441369,442939,1570,10,Y,N,-,-1,-1
MASONB.txt,441492,443141,1649,10,Y,N,-,-1,-1
MASONB.txt,441607,443448,1841,10,N,N,-,-1,-1
MASONB.txt,441722,443535,1813,10,N,N,-,-1,-1
MASONB.txt,441965,443775,1810,10,N,N,-,-1,-1
MASONB.txt,442068,444002,1934,10,N,N,-,-1,-1
MASONB.txt,442255,444292,2037,10,N,N,-,-1,-1
MASONB.txt,442340,444406,2066,10,N,N,-,-1,-1
MASONB.txt,442470,444479,2009,10,N,N,-,-1,-1
MASONB.txt,442763,444556,1793,10,N,N,-,-1,-1
MASONB.txt,442940,444800,1860,10,N,N,-,-1,-1
MASONB.txt,443142,445006,1864,10,N,N,-,-1,-1
MASONB.txt,443449,445156,1707,10,N,N,-,-1,-1
MASONB.txt,443536,445301,1765,10,N,N,-,-1,-1
MASONB.txt,443776,445794,2018,10,N,N,-,-1,-1
MASONB.txt,444003,445892,1889,10,N,N,-,-1,-1
MASONB.txt,444293,445903,1610,10,N,N,-,-1,-1
MASONB.txt,444409,445938,1529,10,N,N,-,-1,-1
MASONB.txt,444480,445988,1508,10,N,N,-,-1,-1
MASONB.txt,444557,446042,1485,10,N,N,-,-1,-1
MASONB.txt,444801,446064,1263,10,N,N,-,-1,-1
MASONB.txt,445007,446097,1090,10,N,N,-,-1,-1
MASONB.txt,445158,446264,1106,10,N,N,-,-1,-1
MASONB.txt,445302,446331,1029,10,N,N,-,-1,-1
MASONB.txt,445797,446385,588,10,N,N,-,-1,-1
MASONB.txt,445893,446390,497,10,N,N,-,-1,-1
MASONB.txt,445904,446454,550,10,N,N,-,-1,-1
MASONB.txt,445939,446518,579,10,N,N,-,-1,-1
MASONB.txt,445989,446652,663,10,N,N,-,-1,-1
MASONB.txt,446043,446842,799,10,N,N,-,-1,-1
MASONB.txt,446066,447020,954,10,N,N,-,-1,-1
MASONB.txt,446102,447473,1371,10,N,N,-,-1,-1
MASONB.txt,446266,447639,1373,10,N,N,-,-1,-1
MASONB.txt,446333,447777,1444,10,N,N,-,-1,-1
MASONB.txt,446387,447879,1492,10,N,N,-,-1,-1
MASONB.txt,446391,448050,1659,10,Y,N,-,-1,-1
MASONB.txt,446456,448051,1595,10,Y,N,-,-1,-1
MASONB.txt,446519,448059,1540,10,N,N,-,-1,-1
MASONB.txt,446653,448128,1475,10,N,N,-,-1,-1
MASONB.txt,446843,448337,1494,10,N,N,-,-1,-1
MASONB.txt,447021,448418,1397,10,N,N,-,-1,-1
MASONB.txt,447474,448436,962,10,N,N,-,-1,-1
MASONB.txt,447641,448494,853,10,N,N,-,-1,-1
MASONB.txt,447778,448542,764,10,N,N,-,-1,-1
MASONB.txt,447880,448730,850,10,N,N,-,-1,-1
MASONB.txt,448050,448816,766,10,N,N,-,-1,-1
MASONB.txt,448054,448973,919,10,N,N,-,-1,-1
MASONB.txt,448060,448983,923,10,N,N,-,-1,-1
MASONB.txt,448129,449004,875,10,N,N,-,-1,-1
MASONB.txt,448340,449018,678,10,N,N,-,-1,-1
MASONB.txt,448419,449060,641,10,N,N,-,-1,-1
MASONB.txt,448437,449073,636,10,N,N,-,-1,-1
MASONB.txt,448495,449085,590,10,N,N,-,-1,-1
MASONB.txt,448543,449136,593,10,N,N,-,-1,-1
MASONB.txt,448731,449159,428,10,N,N,-,-1,-1
MASONB.txt,448817,449168,351,10,N,N,-,-1,-1
MASONB.txt,448973,449217,244,10,N,N,-,-1,-1
MASONB.txt,448986,449245,259,10,N,N,-,-1,-1
MASONB.txt,449005,449258,253,10,N,N,-,-1,-1
MASONB.txt,449021,449372,351,10,N,N,-,-1,-1
MASONB.txt,449061,449508,447,10,N,N,-,-1,-1
MASONB.txt,449076,449516,440,10,N,N,-,-1,-1
MASONB.txt,449086,449528,442,10,N,N,-,-1,-1
MASONB.txt,449139,449571,432,10,N,N,-,-1,-1
MASONB.txt,449160,449595,435,10,N,N,-,-1,-1
MASONB.txt,449171,449635,464,10,N,N,-,-1,-1
MASONB.txt,449218,449657,439,10,N,N,-,-1,-1
MASONB.txt,449248,449682,434,10,N,N,-,-1,-1
MASONB.txt,449259,449734,475,10,N,N,-,-1,-1
MASONB.txt,449373,449738,365,10,N,N,-,-1,-1
MASONB.txt,449508,449745,237,10,N,N,-,-1,-1
MASONB.txt,449519,449795,276,10,N,N,-,-1,-1
MASONB.txt,449529,449869,340,10,N,N,-,-1,-1
MASONB.txt,449572,449889,317,10,N,N,-,-1,-1
MASONB.txt,449598,449956,358,10,N,N,-,-1,-1
MASONB.txt,449636,449974,338,10,N,N,-,-1,-1
MASONB.txt,449662,449987,325,10,N,N,-,-1,-1
MASONB.txt,449683,450036,353,10,N,N,-,-1,-1
MASONB.txt,449735,450050,315,10,N,N,-,-1,-1
MASONB.txt,449739,450092,353,10,N,N,-,-1,-1
MASONB.txt,449748,450108,360,10,N,N,-,-1,-1
MASONB.txt,449798,450302,504,10,N,N,-,-1,-1
MASONB.txt,449870,450304,434,10,N,N,-,-1,-1
MASONB.txt,449892,450420,528,10,N,N,-,-1,-1
MASONB.txt,449957,450425,468,10,N,N,-,-1,-1
MASONB.txt,449977,450523,546,10,N,N,-,-1,-1
MASONB.txt,449988,450755,767,10,N,N,-,-1,-1
MASONB.txt,450039,450841,802,10,N,N,-,-1,-1
MASONB.txt,450051,451060,1009,10,N,N,-,-1,-1
MASONB.txt,450093,451203,1110,10,N,N,-,-1,-1
MASONB.txt,450111,451257,1146,10,N,N,-,-1,-1
MASONB.txt,450303,451426,1123,10,N,N,-,-1,-1
MASONB.txt,450304,451513,1209,10,N,N,-,-1,-1
MASONB.txt,450421,451543,1122,10,N,N,-,-1,-1
MASONB.txt,450427,451561,1134,10,N,N,-,-1,-1
MASONB.txt,450524,451574,1050,10,N,N,-,-1,-1
MASONB.txt,450756,451850,1094,10,N,N,-,-1,-1
MASONB.txt,450842,451901,1059,10,N,N,-,-1,-1
MASONB.txt,451061,452027,966,10,N,N,-,-1,-1
MASONB.txt,451204,452338,1134,10,N,N,-,-1,-1
MASONB.txt,451260,452447,1187,10,N,N,-,-1,-1
MASONB.txt,451429,452523,1094,10,N,N,-,-1,-1
MASONB.txt,451518,452633,1115,10,N,N,-,-1,-1
MASONB.txt,451546,452735,1189,10,N,N,-,-1,-1
MASONB.txt,451562,452807,1245,10,N,N,-,-1,-1
MASONB.txt,451575,452981,1406,10,N,N,-,-1,-1
MASONB.txt,451851,453075,1224,10,N,N,-,-1,-1
MASONB.txt,451902,453196,1294,10,N,N,-,-1,-1
MASONB.txt,452028,453549,1521,10,N,N,-,-1,-1
MASONB.txt,452339,453714,1375,10,N,N,-,-1,-1
MASONB.txt,452450,453778,1328,10,N,N,-,-1,-1
MASONB.txt,452524,453811,1287,10,N,N,-,-1,-1
MASONB.txt,452634,453951,1317,10,N,N,-,-1,-1
MASONB.txt,452736,454045,1309,10,N,N,-,-1,-1
MASONB.txt,452808,454149,1341,10,N,N,-,-1,-1
MASONB.txt,452982,454226,1244,10,N,N,-,-1,-1
MASONB.txt,453076,454321,1245,10,N,N,-,-1,-1
MASONB.txt,453197,454431,1234,10,N,N,-,-1,-1
MASONB.txt,453552,454523,971,10,N,N,-,-1,-1
MASONB.txt,453716,454748,1032,10,N,N,-,-1,-1
MASONB.txt,453779,454935,1156,10,N,N,-,-1,-1
MASONB.txt,453812,455003,1191,10,N,N,-,-1,-1
MASONB.txt,453952,455177,1225,10,N,N,-,-1,-1
MASONB.txt,454046,455275,1229,10,N,N,-,-1,-1
MASONB.txt,454150,455422,1272,10,N,N,-,-1,-1
MASONB.txt,454227,455659,1432,10,N,N,-,-1,-1
MASONB.txt,454323,455671,1348,10,N,N,-,-1,-1
MASONB.txt,454432,455725,1293,10,N,N,-,-1,-1
MASONB.txt,454524,455869,1345,10,N,N,-,-1,-1
MASONB.txt,454749,455992,1243,10,N,N,-,-1,-1
MASONB.txt,454938,456073,1135,10,N,N,-,-1,-1
MASONB.txt,455005,456186,1181,10,N,N,-,-1,-1
MASONB.txt,455178,456238,1060,10,N,N,-,-1,-1
MASONB.txt,455278,456354,1076,10,N,N,-,-1,-1
MASONB.txt,455423,456541,1118,10,N,N,-,-1,-1
MASONB.txt,455660,456669,1009,10,N,N,-,-1,-1
MASONB.txt,455672,456874,1202,10,N,N,-,-1,-1
MASONB.txt,455726,457070,1344,10,N,N,-,-1,-1
MASONB.txt,455870,457195,1325,10,N,N,-,-1,-1
MASONB.txt,455995,457464,1469,10,N,N,-,-1,-1
MASONB.txt,456074,457634,1560,10,N,N,-,-1,-1
MASONB.txt,456187,457665,1478,10,N,N,-,-1,-1
MASONB.txt,456239,457690,1451,10,N,N,-,-1,-1
MASONB.txt,456355,457878,1523,10,N,N,-,-1,-1
MASONB.txt,456542,457900,1358,10,N,N,-,-1,-1
MASONB.txt,456670,457943,1273,10,N,N,-,-1,-1
MASONB.txt,456877,458038,1161,10,N,N,-,-1,-1
MASONB.txt,457073,458186,1113,10,N,N,-,-1,-1
MASONB.txt,457198,458383,1185,10,N,N,-,-1,-1
MASONB.txt,457465,458500,1035,10,N,N,-,-1,-1
MASONB.txt,457637,458619,982,10,N,N,-,-1,-1
MASONB.txt,457670,458663,993,10,N,N,-,-1,-1
MASONB.txt,457691,458733,1042,10,N,N,-,-1,-1
MASONB.txt,457879,458775,896,10,N,N,-,-1,-1
MASONB.txt,457901,458854,953,10,N,N,-,-1,-1
MASONB.txt,457945,458930,985,10,N,N,-,-1,-1
MASONB.txt,458039,458943,904,10,N,N,-,-1,-1
MASONB.txt,458189,459014,825,10,N,N,-,-1,-1
MASONB.txt,458386,459061,675,10,N,N,-,-1,-1
MASONB.txt,458503,459115,612,10,N,N,-,-1,-1
MASONB.txt,458619,459152,533,10,N,N,-,-1,-1
MASONB.txt,458663,459260,597,10,N,N,-,-1,-1
MASONB.txt,458733,459317,584,10,N,N,-,-1,-1
MASONB.txt,458775,459389,614,10,N,N,-,-1,-1
MASONB.txt,458854,459473,619,10,N,N,-,-1,-1
MASONB.txt,458930,459508,578,10,N,N,-,-1,-1
MASONB.txt,458946,459592,646,10,N,N,-,-1,-1
MASONB.txt,459014,459630,616,10,N,N,-,-1,-1
MASONB.txt,459061,459714,653,10,N,N,-,-1,-1
MASONB.txt,459116,459763,647,10,N,N,-,-1,-1
MASONB.txt,459152,459806,654,10,N,N,-,-1,-1
MASONB.txt,459260,459913,653,10,N,N,-,-1,-1
MASONB.txt,459317,459952,635,10,N,N,-,-1,-1
MASONB.txt,459389,460024,635,10,N,N,-,-1,-1
MASONB.txt,459476,460116,640,10,N,N,-,-1,-1
MASONB.txt,459511,460161,650,10,N,N,-,-1,-1
MASONB.txt,459594,460286,692,10,N,N,-,-1,-1
MASONB.txt,459632,460365,733,10,N,N,-,-1,-1
MASONB.txt,459716,460415,699,10,N,N,-,-1,-1
MASONB.txt,459765,460498,733,10,N,N,-,-1,-1
MASONB.txt,459809,460545,736,10,N,N,-,-1,-1
MASONB.txt,459915,460563,648,10,N,N,-,-1,-1
MASONB.txt,459955,460632,677,10,N,N,-,-1,-1
MASONB.txt,460024,460761,737,10,N,N,-,-1,-1
MASONB.txt,460118,460819,701,10,N,N,-,-1,-1
MASONB.txt,460163,460875,712,10,N,N,-,-1,-1
MASONB.txt,460288,460909,621,10,N,N,-,-1,-1
MASONB.txt,460367,461002,635,10,N,N,-,-1,-1
MASONB.txt,460417,461087,670,10,N,N,-,-1,-1
MASONB.txt,460500,461171,671,10,N,N,-,-1,-1
MASONB.txt,460547,461189,642,10,N,N,-,-1,-1
MASONB.txt,460564,461236,672,10,N,N,-,-1,-1
MASONB.txt,460634,461264,630,10,N,N,-,-1,-1
MASONB.txt,460763,461343,580,10,N,N,-,-1,-1
MASONB.txt,460821,461365,544,10,N,N,-,-1,-1
MASONB.txt,460877,461369,492,10,N,N,-,-1,-1
MASONB.txt,460912,461495,583,10,N,N,-,-1,-1
MASONB.txt,461005,461629,624,10,N,N,-,-1,-1
MASONB.txt,461088,461820,732,10,N,N,-,-1,-1
MASONB.txt,461174,461925,751,10,N,N,-,-1,-1
MASONB.txt,461192,461942,750,10,N,N,-,-1,-1
MASONB.txt,461237,462090,853,10,N,N,-,-1,-1
MASONB.txt,461265,462106,841,10,N,N,-,-1,-1
MASONB.txt,461344,462277,933,10,N,N,-,-1,-1
MASONB.txt,461366,462370,1004,10,N,N,-,-1,-1
MASONB.txt,461370,462396,1026,10,N,N,-,-1,-1
MASONB.txt,461498,462523,1025,10,N,N,-,-1,-1
MASONB.txt,461630,462574,944,10,N,N,-,-1,-1
MASONB.txt,461821,462602,781,10,N,N,-,-1,-1
MASONB.txt,461930,462626,696,10,N,N,-,-1,-1
MASONB.txt,461947,462681,734,10,N,N,-,-1,-1
MASONB.txt,462093,462724,631,10,N,N,-,-1,-1
MASONB.txt,462109,462736,627,10,N,N,-,-1,-1
MASONB.txt,462278,462789,511,10,N,N,-,-1,-1
MASONB.txt,462375,462903,528,10,N,N,-,-1,-1
MASONB.txt,462399,462978,579,10,N,N,-,-1,-1
MASONB.txt,462526,463134,608,10,N,N,-,-1,-1
MASONB.txt,462577,463271,694,10,N,N,-,-1,-1
MASONB.txt,462603,463302,699,10,N,N,-,-1,-1
MASONB.txt,462629,463418,789,10,N,N,-,-1,-1
MASONB.txt,462684,463500,816,10,N,N,-,-1,-1
MASONB.txt,462724,463577,853,10,N,N,-,-1,-1
MASONB.txt,462739,463634,895,10,N,N,-,-1,-1
MASONB.txt,462792,463653,861,10,N,N,-,-1,-1
MASONB.txt,462904,463962,1058,10,Y,N,-,-1,-1
MASONB.txt,462981,464101,1120,10,Y,N,-,-1,-1
MASONB.txt,463137,464171,1034,10,N,N,-,-1,-1
MASONB.txt,463272,464194,922,10,N,N,-,-1,-1
MASONB.txt,463303,464327,1024,10,N,N,-,-1,-1
MASONB.txt,463419,464543,1124,10,N,N,-,-1,-1
MASONB.txt,463501,464627,1126,10,N,N,-,-1,-1
MASONB.txt,463579,464777,1198,10,N,N,-,-1,-1
MASONB.txt,463635,464987,1352,10,N,N,-,-1,-1
MASONB.txt,463654,465184,1530,10,N,N,-,-1,-1
MASONB.txt,463965,465286,1321,10,N,N,-,-1,-1
MASONB.txt,464102,465404,1302,10,N,N,-,-1,-1
MASONB.txt,464176,465785,1609,10,N,N,-,-1,-1
MASONB.txt,464195,465919,1724,10,N,N,-,-1,-1
MASONB.txt,464329,466135,1806,10,N,N,-,-1,-1
MASONB.txt,464544,466251,1707,10,N,N,-,-1,-1
MASONB.txt,464628,466297,1669,10,Y,N,-,-1,-1
MASONB.txt,464778,466343,1565,10,Y,N,-,-1,-1
MASONB.txt,464988,466362,1374,10,Y,N,-,-1,-1
MASONB.txt,465185,466373,1188,10,N,N,-,-1,-1
MASONB.txt,465287,466385,1098,10,N,N,-,-1,-1
MASONB.txt,465405,466427,1022,10,N,N,-,-1,-1
MASONB.txt,465786,466490,704,10,N,N,-,-1,-1
MASONB.txt,465920,466529,609,10,N,N,-,-1,-1
MASONB.txt,466137,466646,509,10,N,N,-,-1,-1
MASONB.txt,466253,466703,450,10,N,N,-,-1,-1
MASONB.txt,466299,466854,555,10,N,N,-,-1,-1
MASONB.txt,466345,467082,737,10,N,N,-,-1,-1
MASONB.txt,466364,467174,810,10,N,N,-,-1,-1
MASONB.txt,466375,467315,940,10,N,N,-,-1,-1
MASONB.txt,466387,467366,979,10,N,N,-,-1,-1
MASONB.txt,466429,467557,1128,10,N,N,-,-1,-1
MASONB.txt,466490,467640,1150,10,N,N,-,-1,-1
MASONB.txt,466532,467790,1258,10,N,N,-,-1,-1
MASONB.txt,466647,467959,1312,10,N,N,-,-1,-1
MASONB.txt,466704,468087,1383,10,N,N,-,-1,-1
MASONB.txt,466855,468115,1260,10,N,N,-,-1,-1
MASONB.txt,467083,468163,1080,10,N,N,-,-1,-1
MASONB.txt,467175,468186,1011,10,N,N,-,-1,-1
MASONB.txt,467316,468215,899,10,N,N,-,-1,-1
MASONB.txt,467367,468244,877,10,N,N,-,-1,-1
MASONB.txt,467558,468287,729,10,N,N,-,-1,-1
MASONB.txt,467641,468360,719,10,N,N,-,-1,-1
MASONB.txt,467791,468400,609,10,N,N,-,-1,-1
MASONB.txt,467961,468408,447,10,N,N,-,-1,-1
MASONB.txt,468090,468429,339,10,N,N,-,-1,-1
MASONB.txt,468118,468430,312,10,N,N,-,-1,-1
MASONB.txt,468164,468716,552,10,N,N,-,-1,-1
MASONB.txt,468189,468846,657,10,N,N,-,-1,-1
MASONB.txt,468218,469020,802,10,N,N,-,-1,-1
MASONB.txt,468245,469197,952,10,N,N,-,-1,-1
MASONB.txt,468288,469499,1211,10,N,N,-,-1,-1
MASONB.txt,468361,469623,1262,10,N,N,-,-1,-1
MASONB.txt,468401,469692,1291,10,N,N,-,-1,-1
MASONB.txt,468411,469860,1449,10,N,N,-,-1,-1
MASONB.txt,468429,469872,1443,10,N,N,-,-1,-1
MASONB.txt,468431,469988,1557,10,N,N,-,-1,-1
MASONB.txt,468717,470062,1345,10,Y,N,-,-1,-1
MASONB.txt,468847,470090,1243,10,Y,N,-,-1,-1
MASONB.txt,469021,470094,1073,10,N,N,-,-1,-1
MASONB.txt,469198,470104,906,10,N,N,-,-1,-1
MASONB.txt,469500,470421,921,10,N,N,-,-1,-1
MASONB.txt,469624,470612,988,10,N,N,-,-1,-1
MASONB.txt,469693,470698,1005,10,N,N,-,-1,-1
MASONB.txt,469861,470751,890,10,N,N,-,-1,-1
MASONB.txt,469873,470943,1070,10,N,N,-,-1,-1
MASONB.txt,469989,471055,1066,10,N,N,-,-1,-1
MASONB.txt,470063,471087,1024,10,N,N,-,-1,-1
MASONB.txt,470091,471094,1003,10,N,N,-,-1,-1
MASONB.txt,470095,471098,1003,10,N,N,-,-1,-1
MASONB.txt,470107,471317,1210,10,N,Y,1461790279048,549743,550180
MASONB.txt,470422,471368,946,10,N,Y,1461790279048,549743,550180
MASONB.txt,470613,471473,860,10,N,Y,1461790279048,549743,550180
MASONB.txt,470699,471590,891,10,N,Y,1461790279048,549743,550180
MASONB.txt,470752,471747,995,10,N,Y,1461790279048,549743,550180
MASONB.txt,470948,471775,827,10,N,Y,1461790279048,549743,550180
MASONB.txt,471058,471858,800,10,N,Y,1461790279048,549743,550180
MASONB.txt,471090,471928,838,10,N,Y,1461790279048,549743,550180
MASONB.txt,471095,472002,907,10,N,Y,1461790279048,549743,550180
MASONB.txt,471099,472235,1136,10,N,Y,1461790279048,549743,550180
MASONB.txt,471318,472321,1003,10,N,Y,1461790279048,549743,550180
MASONB.txt,471369,472396,1027,10,N,Y,1461790279048,549743,550180
MASONB.txt,471475,472610,1135,10,Y,Y,1461790279048,549743,550180
MASONB.txt,471591,472747,1156,10,Y,Y,1461790279048,549743,550180
MASONB.txt,471748,472801,1053,10,Y,Y,1461790279048,549743,550180
MASONB.txt,471776,472916,1140,10,Y,Y,1461790279048,549743,550180
MASONB.txt,471859,473028,1169,10,Y,Y,1461790279048,549743,550180
MASONB.txt,471929,473201,1272,10,N,Y,1461790279048,549743,550180
MASONB.txt,472004,473434,1430,10,N,Y,1461790279048,549743,550180
MASONB.txt,472236,473487,1251,10,N,Y,1461790279048,549743,550180
MASONB.txt,472323,473611,1288,10,N,Y,1461790279048,549743,550180
MASONB.txt,472397,473661,1264,10,N,Y,1461790279048,549743,550180
MASONB.txt,472611,473733,1122,10,N,Y,1461790279048,549743,550180
MASONB.txt,472750,473787,1037,10,N,Y,1448921338450,367291,368573
MASONB.txt,472802,474038,1236,10,N,Y,1448921338450,367291,368573
MASONB.txt,472919,474137,1218,10,N,Y,1448835299579,341107,342636
MASONB.txt,473029,474259,1230,10,N,Y,1448835299579,341107,342636
MASONB.txt,473202,474334,1132,10,N,Y,1448835299579,341107,342636
MASONB.txt,473435,474456,1021,10,N,Y,1448835299579,341107,342636
MASONB.txt,473488,474473,985,10,N,Y,1448835299579,341107,342636
MASONB.txt,473612,474507,895,10,N,Y,1448835299579,341107,342636
MASONB.txt,473662,474537,875,10,N,Y,1448835299579,341107,342636
MASONB.txt,473736,474588,852,10,N,Y,1448835299579,341107,342636
MASONB.txt,473788,474685,897,10,N,Y,1448835299579,341107,342636
MASONB.txt,474039,474776,737,10,N,Y,1448835299579,341107,342636
MASONB.txt,474138,474905,767,10,N,Y,1448835299579,341107,342636
MASONB.txt,474260,475056,796,10,Y,Y,1448835299579,341107,342636
MASONB.txt,474335,475300,965,10,N,Y,1448835299579,341107,342636
MASONB.txt,474461,475378,917,10,N,N,-,-1,-1
MASONB.txt,474478,475621,1143,10,N,N,-,-1,-1
MASONB.txt,474510,475880,1370,10,N,N,-,-1,-1
MASONB.txt,474540,476040,1500,10,Y,N,-,-1,-1
MASONB.txt,474589,476205,1616,10,Y,N,-,-1,-1
MASONB.txt,474686,476335,1649,10,Y,N,-,-1,-1
MASONB.txt,474778,476500,1722,10,Y,N,-,-1,-1
MASONB.txt,474907,476640,1733,10,Y,N,-,-1,-1
MASONB.txt,475057,476873,1816,10,Y,N,-,-1,-1
MASONB.txt,475301,476995,1694,10,Y,N,-,-1,-1
MASONB.txt,475379,477287,1908,10,Y,N,-,-1,-1
MASONB.txt,475622,477447,1825,10,Y,N,-,-1,-1
MASONB.txt,475882,477569,1687,10,Y,N,-,-1,-1
MASONB.txt,476041,477743,1702,10,Y,N,-,-1,-1
MASONB.txt,476206,477820,1614,10,N,N,-,-1,-1
MASONB.txt,476336,477936,1600,10,N,N,-,-1,-1
MASONB.txt,476502,478165,1663,10,Y,N,-,-1,-1
MASONB.txt,476643,478644,2001,10,N,N,-,-1,-1
MASONB.txt,476874,478822,1948,10,N,N,-,-1,-1
MASONB.txt,476996,479016,2020,10,N,N,-,-1,-1
MASONB.txt,477290,479078,1788,10,N,N,-,-1,-1
MASONB.txt,477450,479125,1675,10,N,N,-,-1,-1
MASONB.txt,477571,479156,1585,10,N,N,-,-1,-1
MASONB.txt,477744,479241,1497,10,N,N,-,-1,-1
MASONB.txt,477821,479312,1491,10,N,N,-,-1,-1
MASONB.txt,477937,479350,1413,10,N,N,-,-1,-1
MASONB.txt,478166,479374,1208,10,N,N,-,-1,-1
MASONB.txt,478647,479408,761,10,N,N,-,-1,-1
MASONB.txt,478823,479471,648,10,N,N,-,-1,-1
MASONB.txt,479017,479497,480,10,N,N,-,-1,-1
MASONB.txt,479081,479529,448,10,N,N,-,-1,-1
MASONB.txt,479128,479555,427,10,N,N,-,-1,-1
MASONB.txt,479157,479724,567,10,N,N,-,-1,-1
MASONB.txt,479242,479751,509,10,N,N,-,-1,-1
MASONB.txt,479314,479969,655,10,N,N,-,-1,-1
MASONB.txt,479351,480028,677,10,N,N,-,-1,-1
MASONB.txt,479375,480070,695,10,Y,N,-,-1,-1
MASONB.txt,479411,480357,946,10,Y,N,-,-1,-1
MASONB.txt,479474,480700,1226,10,Y,N,-,-1,-1
MASONB.txt,479500,480755,1255,10,Y,N,-,-1,-1
MASONB.txt,479532,481229,1697,10,Y,N,-,-1,-1
MASONB.txt,479558,481321,1763,10,Y,N,-,-1,-1
MASONB.txt,479725,481492,1767,10,Y,N,-,-1,-1
MASONB.txt,479752,481667,1915,10,Y,N,-,-1,-1
MASONB.txt,479970,481912,1942,10,Y,N,-,-1,-1
MASONB.txt,480029,481999,1970,10,Y,N,-,-1,-1
MASONB.txt,480073,482077,2004,10,Y,N,-,-1,-1
MASONB.txt,480358,482142,1784,10,Y,N,-,-1,-1
MASONB.txt,480703,482154,1451,10,N,N,-,-1,-1
MASONB.txt,480756,482221,1465,10,N,N,-,-1,-1
MASONB.txt,481230,482259,1029,10,N,N,-,-1,-1
MASONB.txt,481322,482288,966,10,N,N,-,-1,-1
MASONB.txt,481493,482366,873,10,N,N,-,-1,-1
MASONB.txt,481668,482383,715,10,N,N,-,-1,-1
MASONB.txt,481913,482391,478,10,N,N,-,-1,-1
MASONB.txt,482002,482423,421,10,N,N,-,-1,-1
MASONB.txt,482078,482459,381,10,N,N,-,-1,-1
MASONB.txt,482145,482500,355,10,N,N,-,-1,-1
MASONB.txt,482155,482566,411,10,N,N,-,-1,-1
MASONB.txt,482222,482647,425,10,N,N,-,-1,-1
MASONB.txt,482262,482673,411,10,N,N,-,-1,-1
MASONB.txt,482289,482683,394,10,N,N,-,-1,-1
MASONB.txt,482367,482745,378,10,N,N,-,-1,-1
MASONB.txt,482384,482770,386,10,N,N,-,-1,-1
MASONB.txt,482394,482810,416,10,N,N,-,-1,-1
MASONB.txt,482423,482821,398,10,N,N,-,-1,-1
MASONB.txt,482462,482847,385,10,N,N,-,-1,-1
MASONB.txt,482501,482848,347,10,N,N,-,-1,-1
MASONB.txt,482567,482860,293,10,N,N,-,-1,-1
MASONB.txt,482648,482901,253,10,N,N,-,-1,-1
MASONB.txt,482674,482906,232,10,N,N,-,-1,-1
MASONB.txt,482686,482916,230,10,N,N,-,-1,-1
MASONB.txt,482746,482930,184,10,N,N,-,-1,-1
MASONB.txt,482771,482931,160,10,N,N,-,-1,-1
MASONB.txt,482811,482974,163,10,N,N,-,-1,-1
MASONB.txt,482822,482979,157,10,N,N,-,-1,-1
MASONB.txt,482847,483044,197,10,N,N,-,-1,-1
MASONB.txt,482849,483049,200,10,N,N,-,-1,-1
MASONB.txt,482863,483077,214,10,N,N,-,-1,-1
MASONB.txt,482902,483175,273,10,N,N,-,-1,-1
MASONB.txt,482907,483201,294,10,N,N,-,-1,-1
MASONB.txt,482917,483245,328,10,N,N,-,-1,-1
MASONB.txt,482930,483312,382,10,N,N,-,-1,-1
MASONB.txt,482932,483327,395,10,N,N,-,-1,-1
MASONB.txt,482975,483495,520,10,N,N,-,-1,-1
MASONB.txt,482980,483506,526,10,N,N,-,-1,-1
MASONB.txt,483045,483515,470,10,N,N,-,-1,-1
MASONB.txt,483050,483570,520,10,N,N,-,-1,-1
MASONB.txt,483078,483606,528,10,N,N,-,-1,-1
MASONB.txt,483176,483618,442,10,N,N,-,-1,-1
MASONB.txt,483204,483628,424,10,N,N,-,-1,-1
MASONB.txt,483246,483643,397,10,N,N,-,-1,-1
MASONB.txt,483313,483685,372,10,N,N,-,-1,-1
MASONB.txt,483328,483711,383,10,N,N,-,-1,-1
MASONB.txt,483497,483815,318,10,N,N,-,-1,-1
MASONB.txt,483507,484297,790,10,N,N,-,-1,-1
MASONB.txt,483516,484360,844,10,N,N,-,-1,-1
MASONB.txt,483571,484626,1055,10,N,N,-,-1,-1
MASONB.txt,483608,484755,1147,10,N,N,-,-1,-1
MASONB.txt,483619,484876,1257,10,N,N,-,-1,-1
MASONB.txt,483629,485176,1547,10,N,N,-,-1,-1
MASONB.txt,483646,485345,1699,10,N,N,-,-1,-1
MASONB.txt,483690,485391,1701,10,N,N,-,-1,-1
MASONB.txt,483714,485484,1770,10,N,N,-,-1,-1
MASONB.txt,483816,485671,1855,10,N,N,-,-1,-1
MASONB.txt,484298,485881,1583,10,N,N,-,-1,-1
MASONB.txt,484361,485915,1554,10,N,N,-,-1,-1
MASONB.txt,484627,486152,1525,10,N,N,-,-1,-1
MASONB.txt,484758,486275,1517,10,N,N,-,-1,-1
MASONB.txt,484878,486301,1423,10,N,N,-,-1,-1
MASONB.txt,485177,486315,1138,10,N,N,-,-1,-1
MASONB.txt,485346,486328,982,10,N,N,-,-1,-1
MASONB.txt,485392,486446,1054,10,N,N,-,-1,-1
MASONB.txt,485485,486589,1104,10,N,N,-,-1,-1
MASONB.txt,485672,486652,980,10,N,N,-,-1,-1
MASONB.txt,485884,486996,1112,10,N,N,-,-1,-1
MASONB.txt,485916,487312,1396,10,N,N,-,-1,-1
MASONB.txt,486153,487477,1324,10,N,N,-,-1,-1
MASONB.txt,486277,487918,1641,10,N,N,-,-1,-1
MASONB.txt,486304,488080,1776,10,N,N,-,-1,-1
MASONB.txt,486315,488093,1778,10,N,N,-,-1,-1
MASONB.txt,486329,488143,1814,10,N,N,-,-1,-1
MASONB.txt,486449,488152,1703,10,N,N,-,-1,-1
MASONB.txt,486590,488201,1611,10,N,N,-,-1,-1
MASONB.txt,486653,488229,1576,10,N,N,-,-1,-1
MASONB.txt,486997,488237,1240,10,N,N,-,-1,-1
MASONB.txt,487313,488239,926,10,N,N,-,-1,-1
MASONB.txt,487478,488240,762,10,N,N,-,-1,-1
MASONB.txt,487919,488254,335,10,N,N,-,-1,-1
MASONB.txt,488081,488317,236,10,N,N,-,-1,-1
MASONB.txt,488096,488366,270,10,N,N,-,-1,-1
MASONB.txt,488144,488413,269,10,N,N,-,-1,-1
MASONB.txt,488153,488442,289,10,N,N,-,-1,-1
MASONB.txt,488202,488450,248,10,N,N,-,-1,-1
MASONB.txt,488230,488454,224,10,N,N,-,-1,-1
MASONB.txt,488237,488548,311,10,N,N,-,-1,-1
MASONB.txt,488239,488559,320,10,N,N,-,-1,-1
MASONB.txt,488241,488602,361,10,N,N,-,-1,-1
MASONB.txt,488257,488609,352,10,N,N,-,-1,-1
MASONB.txt,488320,488685,365,10,N,N,-,-1,-1
MASONB.txt,488367,488707,340,10,N,N,-,-1,-1
MASONB.txt,488414,488743,329,10,N,N,-,-1,-1
MASONB.txt,488443,488768,325,10,N,N,-,-1,-1
MASONB.txt,488453,488853,400,10,N,N,-,-1,-1
MASONB.txt,488454,488894,440,10,N,N,-,-1,-1
MASONB.txt,488549,488936,387,10,N,N,-,-1,-1
MASONB.txt,488562,489009,447,10,N,N,-,-1,-1
MASONB.txt,488603,489055,452,10,N,N,-,-1,-1
MASONB.txt,488610,489070,460,10,N,N,-,-1,-1
MASONB.txt,488686,489090,404,10,N,N,-,-1,-1
MASONB.txt,488710,489140,430,10,N,N,-,-1,-1
MASONB.txt,488744,489171,427,10,N,N,-,-1,-1
MASONB.txt,488771,489183,412,10,N,N,-,-1,-1
MASONB.txt,488856,489247,391,10,N,N,-,-1,-1
MASONB.txt,488895,489327,432,10,N,N,-,-1,-1
MASONB.txt,488937,489345,408,10,N,N,-,-1,-1
MASONB.txt,489010,489384,374,10,N,N,-,-1,-1
MASONB.txt,489056,489406,350,10,N,N,-,-1,-1
MASONB.txt,489070,489449,379,10,N,N,-,-1,-1
MASONB.txt,489093,489467,374,10,N,N,-,-1,-1
MASONB.txt,489143,489469,326,10,N,N,-,-1,-1
MASONB.txt,489174,489479,305,10,N,N,-,-1,-1
MASONB.txt,489186,489599,413,10,N,N,-,-1,-1
MASONB.txt,489250,489718,468,10,N,N,-,-1,-1
MASONB.txt,489328,489770,442,10,N,N,-,-1,-1
MASONB.txt,489348,489783,435,10,N,N,-,-1,-1
MASONB.txt,489385,489785,400,10,N,N,-,-1,-1
MASONB.txt,489409,489789,380,10,N,N,-,-1,-1
MASONB.txt,489450,489796,346,10,N,N,-,-1,-1
MASONB.txt,489468,489903,435,10,N,N,-,-1,-1
MASONB.txt,489469,489923,454,10,N,N,-,-1,-1
MASONB.txt,489481,489946,465,10,N,N,-,-1,-1
MASONB.txt,489600,489994,394,10,N,N,-,-1,-1
MASONB.txt,489721,490090,369,10,N,N,-,-1,-1
MASONB.txt,489771,490335,564,10,N,N,-,-1,-1
MASONB.txt,489784,490501,717,10,N,N,-,-1,-1
MASONB.txt,489786,490628,842,10,N,N,-,-1,-1
MASONB.txt,489789,490972,1183,10,Y,N,-,-1,-1
MASONB.txt,489798,491162,1364,10,Y,N,-,-1,-1
MASONB.txt,489906,491438,1532,10,Y,N,-,-1,-1
MASONB.txt,489924,491632,1708,10,Y,N,-,-1,-1
MASONB.txt,489949,491859,1910,10,Y,N,-,-1,-1
MASONB.txt,489995,492180,2185,10,Y,N,-,-1,-1
MASONB.txt,490091,492488,2397,10,Y,N,-,-1,-1
MASONB.txt,490336,492656,2320,10,Y,N,-,-1,-1
MASONB.txt,490502,492726,2224,10,Y,N,-,-1,-1
MASONB.txt,490629,492910,2281,10,N,N,-,-1,-1
MASONB.txt,490972,493287,2315,10,N,N,-,-1,-1
MASONB.txt,491162,493440,2278,10,N,N,-,-1,-1
MASONB.txt,491439,493617,2178,10,N,N,-,-1,-1
MASONB.txt,491633,493777,2144,10,N,N,-,-1,-1
MASONB.txt,491861,493792,1931,10,N,N,-,-1,-1
MASONB.txt,492182,493904,1722,10,N,N,-,-1,-1
MASONB.txt,492489,494102,1613,10,N,N,-,-1,-1
MASONB.txt,492657,494306,1649,10,N,N,-,-1,-1
MASONB.txt,492728,494391,1663,10,N,N,-,-1,-1
MASONB.txt,492911,494482,1571,10,Y,N,-,-1,-1
MASONB.txt,493288,494661,1373,10,Y,N,-,-1,-1
MASONB.txt,493443,494750,1307,10,Y,N,-,-1,-1
MASONB.txt,493618,494825,1207,10,Y,N,-,-1,-1
MASONB.txt,493778,494948,1170,10,Y,N,-,-1,-1
MASONB.txt,493793,495050,1257,10,Y,N,-,-1,-1
MASONB.txt,493905,495109,1204,10,Y,N,-,-1,-1
MASONB.txt,494103,495153,1050,10,Y,N,-,-1,-1
MASONB.txt,494307,495334,1027,10,Y,N,-,-1,-1
MASONB.txt,494392,495491,1099,10,Y,N,-,-1,-1
MASONB.txt,494483,495615,1132,10,Y,N,-,-1,-1
MASONB.txt,494664,495711,1047,10,Y,N,-,-1,-1
MASONB.txt,494751,495803,1052,10,Y,N,-,-1,-1
MASONB.txt,494826,495994,1168,10,Y,N,-,-1,-1
MASONB.txt,494949,496006,1057,10,Y,N,-,-1,-1
MASONB.txt,495051,496109,1058,10,Y,N,-,-1,-1
MASONB.txt,495110,496177,1067,10,N,N,-,-1,-1
MASONB.txt,495155,496329,1174,10,N,N,-,-1,-1
MASONB.txt,495335,496616,1281,10,N,N,-,-1,-1
MASONB.txt,495492,496729,1237,10,N,N,-,-1,-1
MASONB.txt,495616,496842,1226,10,N,N,-,-1,-1
MASONB.txt,495712,496983,1271,10,N,N,-,-1,-1
MASONB.txt,495804,497284,1480,10,N,N,-,-1,-1
MASONB.txt,495997,497477,1480,10,N,N,-,-1,-1
MASONB.txt,496007,497683,1676,10,N,N,-,-1,-1
MASONB.txt,496110,498012,1902,10,N,N,-,-1,-1
MASONB.txt,496179,498192,2013,10,N,N,-,-1,-1
MASONB.txt,496330,498266,1936,10,N,N,-,-1,-1
MASONB.txt,496617,498353,1736,10,N,N,-,-1,-1
MASONB.txt,496730,498519,1789,10,N,N,-,-1,-1
MASONB.txt,496843,498548,1705,10,N,N,-,-1,-1
MASONB.txt,496986,498638,1652,10,N,N,-,-1,-1
MASONB.txt,497285,498686,1401,10,N,N,-,-1,-1
MASONB.txt,497478,498704,1226,10,N,N,-,-1,-1
MASONB.txt,497684,498784,1100,10,N,N,-,-1,-1
MASONB.txt,498013,498857,844,10,N,N,-,-1,-1
MASONB.txt,498193,498889,696,10,N,N,-,-1,-1
MASONB.txt,498267,498900,633,10,N,N,-,-1,-1
MASONB.txt,498354,498953,599,10,N,N,-,-1,-1
MASONB.txt,498522,499078,556,10,N,N,-,-1,-1
MASONB.txt,498549,499216,667,10,N,N,-,-1,-1
MASONB.txt,498639,499238,599,10,N,N,-,-1,-1
MASONB.txt,498688,499289,601,10,N,N,-,-1,-1
MASONB.txt,498705,499300,595,10,N,N,-,-1,-1
MASONB.txt,498785,499501,716,10,N,N,-,-1,-1
MASONB.txt,498858,499799,941,10,N,N,-,-1,-1
MASONB.txt,498892,500002,1110,10,N,N,-,-1,-1
MASONB.txt,498902,500064,1162,10,N,N,-,-1,-1
MASONB.txt,498956,500258,1302,10,N,N,-,-1,-1
MASONB.txt,499079,500286,1207,10,N,N,-,-1,-1
MASONB.txt,499219,500352,1133,10,N,N,-,-1,-1
MASONB.txt,499239,500452,1213,10,N,N,-,-1,-1
MASONB.txt,499290,500638,1348,10,N,N,-,-1,-1
MASONB.txt,499303,500895,1592,10,Y,N,-,-1,-1
MASONB.txt,499502,501047,1545,10,Y,N,-,-1,-1
MASONB.txt,499800,501204,1404,10,Y,N,-,-1,-1
MASONB.txt,500003,501322,1319,10,Y,N,-,-1,-1
MASONB.txt,500065,501488,1423,10,Y,N,-,-1,-1
MASONB.txt,500259,501859,1600,10,N,N,-,-1,-1
MASONB.txt,500287,502002,1715,10,N,N,-,-1,-1
MASONB.txt,500353,502337,1984,10,Y,N,-,-1,-1
MASONB.txt,500454,502447,1993,10,Y,N,-,-1,-1
MASONB.txt,500639,502604,1965,10,Y,N,-,-1,-1
MASONB.txt,500896,502674,1778,10,N,N,-,-1,-1
MASONB.txt,501048,502772,1724,10,N,N,-,-1,-1
MASONB.txt,501205,502911,1706,10,N,N,-,-1,-1
MASONB.txt,501323,503088,1765,10,N,N,-,-1,-1
MASONB.txt,501489,503134,1645,10,N,N,-,-1,-1
MASONB.txt,501861,503363,1502,10,N,N,-,-1,-1
MASONB.txt,502003,503538,1535,10,N,N,-,-1,-1
MASONB.txt,502340,503761,1421,10,N,N,-,-1,-1
MASONB.txt,502448,503890,1442,10,N,N,-,-1,-1
MASONB.txt,502607,504094,1487,10,N,N,-,-1,-1
MASONB.txt,502675,504324,1649,10,N,N,-,-1,-1
MASONB.txt,502773,504355,1582,10,N,N,-,-1,-1
MASONB.txt,502913,504545,1632,10,N,N,-,-1,-1
MASONB.txt,503089,504628,1539,10,N,N,-,-1,-1
MASONB.txt,503135,504798,1663,10,N,N,-,-1,-1
MASONB.txt,503364,505121,1757,10,N,N,-,-1,-1
MASONB.txt,503539,505205,1666,10,N,N,-,-1,-1
MASONB.txt,503762,505315,1553,10,N,N,-,-1,-1
MASONB.txt,503891,505397,1506,10,N,N,-,-1,-1
MASONB.txt,504095,505603,1508,10,N,N,-,-1,-1
MASONB.txt,504325,505723,1398,10,N,N,-,-1,-1
MASONB.txt,504356,505838,1482,10,N,N,-,-1,-1
MASONB.txt,504546,506100,1554,10,N,N,-,-1,-1
MASONB.txt,504629,506231,1602,10,N,N,-,-1,-1
MASONB.txt,504799,506302,1503,10,N,N,-,-1,-1
MASONB.txt,505124,506339,1215,10,N,N,-,-1,-1
MASONB.txt,505206,506602,1396,10,Y,N,-,-1,-1
MASONB.txt,505317,506650,1333,10,Y,N,-,-1,-1
MASONB.txt,505398,506737,1339,10,Y,N,-,-1,-1
MASONB.txt,505604,506760,1156,10,N,N,-,-1,-1
MASONB.txt,505724,506783,1059,10,N,N,-,-1,-1
MASONB.txt,505839,507056,1217,10,N,N,-,-1,-1
MASONB.txt,506101,507210,1109,10,N,N,-,-1,-1
MASONB.txt,506232,507351,1119,10,N,N,-,-1,-1
MASONB.txt,506303,507525,1222,10,N,N,-,-1,-1
MASONB.txt,506342,507612,1270,10,N,N,-,-1,-1
MASONB.txt,506603,507637,1034,10,N,N,-,-1,-1
MASONB.txt,506651,507658,1007,10,N,N,-,-1,-1
MASONB.txt,506738,507809,1071,10,N,N,-,-1,-1
MASONB.txt,506761,507950,1189,10,N,N,-,-1,-1
MASONB.txt,506784,508068,1284,10,N,N,-,-1,-1
MASONB.txt,507057,508098,1041,10,N,N,-,-1,-1
MASONB.txt,507211,508195,984,10,N,N,-,-1,-1
MASONB.txt,507352,508226,874,10,N,N,-,-1,-1
MASONB.txt,507526,508272,746,10,N,N,-,-1,-1
MASONB.txt,507615,508748,1133,10,N,N,-,-1,-1
MASONB.txt,507638,508815,1177,10,N,N,-,-1,-1
MASONB.txt,507659,508858,1199,10,N,N,-,-1,-1
MASONB.txt,507810,508976,1166,10,N,N,-,-1,-1
MASONB.txt,507951,509055,1104,10,N,N,-,-1,-1
MASONB.txt,508069,509083,1014,10,N,N,-,-1,-1
MASONB.txt,508099,509182,1083,10,N,N,-,-1,-1
MASONB.txt,508196,509320,1124,10,N,N,-,-1,-1
MASONB.txt,508229,509338,1109,10,N,N,-,-1,-1
MASONB.txt,508274,509388,1114,10,N,N,-,-1,-1
MASONB.txt,508751,509479,728,10,N,N,-,-1,-1
MASONB.txt,508818,509572,754,10,N,N,-,-1,-1
MASONB.txt,508858,509621,763,10,N,N,-,-1,-1
MASONB.txt,508979,509812,833,10,N,N,-,-1,-1
MASONB.txt,509057,509851,794,10,N,N,-,-1,-1
MASONB.txt,509085,509900,815,10,N,N,-,-1,-1
MASONB.txt,509185,509913,728,10,N,N,-,-1,-1
MASONB.txt,509321,510011,690,10,N,N,-,-1,-1
MASONB.txt,509341,510061,720,10,N,N,-,-1,-1
MASONB.txt,509391,510068,677,10,N,N,-,-1,-1
MASONB.txt,509480,510135,655,10,N,N,-,-1,-1
MASONB.txt,509575,510169,594,10,N,N,-,-1,-1
MASONB.txt,509624,510235,611,10,N,N,-,-1,-1
MASONB.txt,509815,510293,478,10,N,N,-,-1,-1
MASONB.txt,509854,510337,483,10,N,N,-,-1,-1
MASONB.txt,509901,510359,458,10,N,N,-,-1,-1
MASONB.txt,509916,510411,495,10,N,N,-,-1,-1
MASONB.txt,510014,510435,421,10,N,N,-,-1,-1
MASONB.txt,510062,510487,425,10,N,N,-,-1,-1
MASONB.txt,510071,510532,461,10,N,N,-,-1,-1
MASONB.txt,510138,510616,478,10,N,N,-,-1,-1
MASONB.txt,510172,510669,497,10,N,N,-,-1,-1
MASONB.txt,510238,510684,446,10,N,N,-,-1,-1
MASONB.txt,510294,510711,417,10,N,N,-,-1,-1
MASONB.txt,510338,510775,437,10,N,N,-,-1,-1
MASONB.txt,510362,510883,521,10,N,N,-,-1,-1
MASONB.txt,510412,510920,508,10,N,N,-,-1,-1
MASONB.txt,510438,510980,542,10,N,N,-,-1,-1
MASONB.txt,510490,511027,537,10,N,N,-,-1,-1
MASONB.txt,510535,511107,572,10,N,N,-,-1,-1
MASONB.txt,510619,511153,534,10,N,N,-,-1,-1
MASONB.txt,510672,511225,553,10,N,N,-,-1,-1
MASONB.txt,510685,511319,634,10,N,N,-,-1,-1
MASONB.txt,510714,511344,630,10,N,N,-,-1,-1
MASONB.txt,510777,511372,595,10,N,N,-,-1,-1
MASONB.txt,510884,511575,691,10,N,N,-,-1,-1
MASONB.txt,510921,511610,689,10,N,N,-,-1,-1
MASONB.txt,510981,511857,876,10,N,N,-,-1,-1
MASONB.txt,511028,511914,886,10,N,N,-,-1,-1
MASONB.txt,511108,512144,1036,10,N,N,-,-1,-1
MASONB.txt,511154,512290,1136,10,N,N,-,-1,-1
MASONB.txt,511226,512338,1112,10,N,N,-,-1,-1
MASONB.txt,511320,512406,1086,10,N,N,-,-1,-1
MASONB.txt,511345,512479,1134,10,N,N,-,-1,-1
MASONB.txt,511373,512535,1162,10,N,N,-,-1,-1
MASONB.txt,511578,512629,1051,10,N,N,-,-1,-1
MASONB.txt,511611,512630,1019,10,N,N,-,-1,-1
MASONB.txt,511858,512657,799,10,N,N,-,-1,-1
MASONB.txt,511915,512803,888,10,N,N,-,-1,-1
MASONB.txt,512145,513214,1069,10,N,N,-,-1,-1
MASONB.txt,512291,513314,1023,10,N,N,-,-1,-1
MASONB.txt,512339,513324,985,10,N,N,-,-1,-1
MASONB.txt,512407,513695,1288,10,N,N,-,-1,-1
MASONB.txt,512480,513812,1332,10,N,N,-,-1,-1
MASONB.txt,512536,513902,1366,10,N,N,-,-1,-1
MASONB.txt,512629,514143,1514,10,N,N,-,-1,-1
MASONB.txt,512631,514194,1563,10,N,N,-,-1,-1
MASONB.txt,512658,514247,1589,10,N,N,-,-1,-1
MASONB.txt,512804,514544,1740,10,N,N,-,-1,-1
MASONB.txt,513215,514838,1623,10,N,N,-,-1,-1
MASONB.txt,513317,514894,1577,10,N,N,-,-1,-1
MASONB.txt,513325,515040,1715,10,N,N,-,-1,-1
MASONB.txt,513697,515115,1418,10,N,N,-,-1,-1
MASONB.txt,513814,515215,1401,10,N,N,-,-1,-1
MASONB.txt,513903,515318,1415,10,N,N,-,-1,-1
MASONB.txt,514144,515694,1550,10,Y,N,-,-1,-1
MASONB.txt,514196,515788,1592,10,Y,N,-,-1,-1
MASONB.txt,514248,515984,1736,10,Y,N,-,-1,-1
MASONB.txt,514547,516152,1605,10,N,N,-,-1,-1
MASONB.txt,514839,516464,1625,10,N,N,-,-1,-1
MASONB.txt,514895,516556,1661,10,N,N,-,-1,-1
MASONB.txt,515041,516749,1708,10,Y,N,-,-1,-1
MASONB.txt,515116,516813,1697,10,Y,N,-,-1,-1
MASONB.txt,515216,516969,1753,10,Y,N,-,-1,-1
MASONB.txt,515319,517127,1808,10,Y,N,-,-1,-1
MASONB.txt,515695,517139,1444,10,Y,N,-,-1,-1
MASONB.txt,515789,517303,1514,10,Y,N,-,-1,-1
MASONB.txt,515985,517328,1343,10,Y,N,-,-1,-1
MASONB.txt,516153,517356,1203,10,Y,N,-,-1,-1
MASONB.txt,516465,517404,939,10,Y,N,-,-1,-1
MASONB.txt,516557,517479,922,10,Y,N,-,-1,-1
MASONB.txt,516750,517624,874,10,N,N,-,-1,-1
MASONB.txt,516814,517767,953,10,Y,N,-,-1,-1
MASONB.txt,516970,518011,1041,10,Y,N,-,-1,-1
MASONB.txt,517128,518269,1141,10,Y,N,-,-1,-1
MASONB.txt,517140,518415,1275,10,Y,N,-,-1,-1
MASONB.txt,517304,518506,1202,10,Y,N,-,-1,-1
MASONB.txt,517329,518581,1252,10,Y,N,-,-1,-1
MASONB.txt,517359,518627,1268,10,Y,N,-,-1,-1
MASONB.txt,517405,518731,1326,10,Y,N,-,-1,-1
MASONB.txt,517481,518802,1321,10,Y,N,-,-1,-1
MASONB.txt,517625,518966,1341,10,Y,N,-,-1,-1
MASONB.txt,517768,519082,1314,10,Y,N,-,-1,-1
MASONB.txt,518012,519123,1111,10,Y,N,-,-1,-1
MASONB.txt,518270,519401,1131,10,Y,N,-,-1,-1
MASONB.txt,518416,519423,1007,10,Y,N,-,-1,-1
MASONB.txt,518507,519491,984,10,N,N,-,-1,-1
MASONB.txt,518582,519651,1069,10,Y,N,-,-1,-1
MASONB.txt,518628,519809,1181,10,Y,N,-,-1,-1
MASONB.txt,518732,519821,1089,10,N,N,-,-1,-1
MASONB.txt,518804,519854,1050,10,N,N,-,-1,-1
MASONB.txt,518967,519932,965,10,N,N,-,-1,-1
MASONB.txt,519083,520015,932,10,N,N,-,-1,-1
MASONB.txt,519125,520167,1042,10,N,N,-,-1,-1
MASONB.txt,519402,520383,981,10,N,N,-,-1,-1
MASONB.txt,519424,520418,994,10,N,N,-,-1,-1
MASONB.txt,519492,520573,1081,10,N,N,-,-1,-1
MASONB.txt,519652,520585,933,10,N,N,-,-1,-1
MASONB.txt,519810,520739,929,10,N,N,-,-1,-1
MASONB.txt,519822,520882,1060,10,N,N,-,-1,-1
MASONB.txt,519856,520911,1055,10,N,N,-,-1,-1
MASONB.txt,519933,521004,1071,10,N,N,-,-1,-1
MASONB.txt,520016,521020,1004,10,N,N,-,-1,-1
MASONB.txt,520168,521087,919,10,N,N,-,-1,-1
MASONB.txt,520384,521267,883,10,N,N,-,-1,-1
MASONB.txt,520419,521282,863,10,N,N,-,-1,-1
MASONB.txt,520574,521436,862,10,N,N,-,-1,-1
MASONB.txt,520586,521453,867,10,N,N,-,-1,-1
MASONB.txt,520740,521624,884,10,N,N,-,-1,-1
MASONB.txt,520883,521771,888,10,N,N,-,-1,-1
MASONB.txt,520913,521793,880,10,N,N,-,-1,-1
MASONB.txt,521005,522032,1027,10,N,N,-,-1,-1
MASONB.txt,521021,522054,1033,10,N,N,-,-1,-1
MASONB.txt,521088,522164,1076,10,N,N,-,-1,-1
MASONB.txt,521268,522276,1008,10,Y,N,-,-1,-1
MASONB.txt,521284,522461,1177,10,Y,N,-,-1,-1
MASONB.txt,521439,522495,1056,10,Y,N,-,-1,-1
MASONB.txt,521454,522624,1170,10,Y,N,-,-1,-1
MASONB.txt,521626,522765,1139,10,Y,N,-,-1,-1
MASONB.txt,521772,522970,1198,10,Y,N,-,-1,-1
MASONB.txt,521794,523170,1376,10,Y,N,-,-1,-1
MASONB.txt,522033,523245,1212,10,Y,N,-,-1,-1
MASONB.txt,522055,523297,1242,10,Y,N,-,-1,-1
MASONB.txt,522165,523363,1198,10,Y,N,-,-1,-1
MASONB.txt,522277,523404,1127,10,Y,N,-,-1,-1
MASONB.txt,522462,523463,1001,10,Y,N,-,-1,-1
MASONB.txt,522496,523567,1071,10,Y,N,-,-1,-1
MASONB.txt,522625,523914,1289,10,Y,N,-,-1,-1
MASONB.txt,522767,523952,1185,10,Y,N,-,-1,-1
MASONB.txt,522971,524075,1104,10,Y,N,-,-1,-1
MASONB.txt,523171,524402,1231,10,Y,N,-,-1,-1
MASONB.txt,523246,524498,1252,10,Y,N,-,-1,-1
MASONB.txt,523298,524530,1232,10,Y,N,-,-1,-1
MASONB.txt,523364,524557,1193,10,N,N,-,-1,-1
MASONB.txt,523405,524693,1288,10,Y,N,-,-1,-1
MASONB.txt,523464,524741,1277,10,Y,N,-,-1,-1
MASONB.txt,523570,524885,1315,10,Y,N,-,-1,-1
MASONB.txt,523915,525030,1115,10,Y,N,-,-1,-1
MASONB.txt,523953,525063,1110,10,Y,N,-,-1,-1
MASONB.txt,524077,525100,1023,10,Y,N,-,-1,-1
MASONB.txt,524403,525229,826,10,N,N,-,-1,-1
MASONB.txt,524499,525371,872,10,N,N,-,-1,-1
MASONB.txt,524531,525480,949,10,N,N,-,-1,-1
MASONB.txt,524558,525538,980,10,N,N,-,-1,-1
MASONB.txt,524694,525651,957,10,N,N,-,-1,-1
MASONB.txt,524742,525981,1239,10,N,N,-,-1,-1
MASONB.txt,524886,526428,1542,10,N,N,-,-1,-1
MASONB.txt,525031,526446,1415,10,N,N,-,-1,-1
MASONB.txt,525064,526535,1471,10,N,N,-,-1,-1
MASONB.txt,525101,526539,1438,10,N,N,-,-1,-1
MASONB.txt,525230,526545,1315,10,N,N,-,-1,-1
MASONB.txt,525372,526570,1198,10,N,N,-,-1,-1
MASONB.txt,525483,526628,1145,10,N,N,-,-1,-1
MASONB.txt,525539,526741,1202,10,N,N,-,-1,-1
MASONB.txt,525652,526882,1230,10,N,N,-,-1,-1
MASONB.txt,525982,527034,1052,10,N,N,-,-1,-1
MASONB.txt,526433,527044,611,10,N,N,-,-1,-1
MASONB.txt,526451,527062,611,10,N,N,-,-1,-1
MASONB.txt,526536,527147,611,10,N,N,-,-1,-1
MASONB.txt,526540,527301,761,10,N,N,-,-1,-1
MASONB.txt,526548,527435,887,10,N,N,-,-1,-1
MASONB.txt,526573,527552,979,10,N,N,-,-1,-1
MASONB.txt,526630,527648,1018,10,N,N,-,-1,-1
MASONB.txt,526742,527696,954,10,N,N,-,-1,-1
MASONB.txt,526883,527976,1093,10,N,N,-,-1,-1
MASONB.txt,527035,528086,1051,10,N,N,-,-1,-1
MASONB.txt,527045,528345,1300,10,N,N,-,-1,-1
MASONB.txt,527063,528423,1360,10,N,Y,1448923619461,471131,472718
MASONB.txt,527148,528450,1302,10,N,Y,1448923619461,471131,472718
MASONB.txt,527302,528542,1240,10,N,Y,1448923619461,471131,472718
MASONB.txt,527436,528593,1157,10,N,Y,1448923619461,471131,472718
MASONB.txt,527553,528899,1346,10,N,Y,1448923619461,471131,472718
MASONB.txt,527649,528965,1316,10,N,Y,1448923619461,471131,472718
MASONB.txt,527697,529101,1404,10,N,Y,1448923619461,471131,472718
MASONB.txt,527978,529202,1224,10,N,Y,1448923619461,471131,472718
MASONB.txt,528087,529275,1188,10,N,Y,1448923619461,471131,472718
MASONB.txt,528347,529334,987,10,N,Y,1448923619461,471131,472718
MASONB.txt,528424,529410,986,10,N,Y,1448923619461,471131,472718
MASONB.txt,528451,529609,1158,10,N,Y,1448923619461,471131,472718
MASONB.txt,528543,529613,1070,10,N,Y,1448923619461,471131,472718
MASONB.txt,528594,529711,1117,10,N,Y,1448923619461,471131,472718
MASONB.txt,528900,529792,892,10,N,Y,1448923619461,471131,472718
MASONB.txt,528966,529955,989,10,N,Y,1448923619461,471131,472718
MASONB.txt,529102,530035,933,10,N,Y,1448923619461,471131,472718
MASONB.txt,529205,530151,946,10,N,Y,1448923619461,471131,472718
MASONB.txt,529278,530218,940,10,N,N,-,-1,-1
MASONB.txt,529335,530383,1048,10,N,N,-,-1,-1
MASONB.txt,529411,530449,1038,10,N,N,-,-1,-1
MASONB.txt,529612,530496,884,10,N,N,-,-1,-1
MASONB.txt,529614,530733,1119,10,N,N,-,-1,-1
MASONB.txt,529714,531009,1295,10,N,N,-,-1,-1
MASONB.txt,529793,531077,1284,10,N,N,-,-1,-1
MASONB.txt,529956,531234,1278,10,N,N,-,-1,-1
MASONB.txt,530036,531359,1323,10,N,N,-,-1,-1
MASONB.txt,530152,531797,1645,10,N,N,-,-1,-1
MASONB.txt,530219,532086,1867,10,N,N,-,-1,-1
MASONB.txt,530385,532284,1899,10,N,N,-,-1,-1
MASONB.txt,530450,532624,2174,10,Y,N,-,-1,-1
MASONB.txt,530497,532907,2410,10,Y,N,-,-1,-1
MASONB.txt,530734,532992,2258,10,Y,N,-,-1,-1
MASONB.txt,531010,533011,2001,10,Y,N,-,-1,-1
MASONB.txt,531078,533079,2001,10,Y,N,-,-1,-1
MASONB.txt,531237,533095,1858,10,Y,N,-,-1,-1
MASONB.txt,531361,533120,1759,10,Y,N,-,-1,-1
MASONB.txt,531799,533261,1462,10,Y,Y,1448709266671,335017,336316
MASONB.txt,532087,533524,1437,10,N,Y,1448709266671,335017,336316
MASONB.txt,532285,533580,1295,10,N,Y,1448709266671,335017,336316
MASONB.txt,532625,533655,1030,10,N,Y,1448709266671,335017,336316
MASONB.txt,532910,533794,884,10,N,Y,1448709266671,335017,336316
MASONB.txt,532997,533887,890,10,N,Y,1448709266671,335017,336316
MASONB.txt,533016,533967,951,10,N,Y,1448709266671,335017,336316
MASONB.txt,533080,534035,955,10,N,Y,1448397303768,308560,309010
MASONB.txt,533098,534132,1034,10,N,Y,1448397303768,308560,309010
MASONB.txt,533123,534232,1109,10,N,Y,1448397303768,308560,309010
MASONB.txt,533262,534323,1061,10,N,Y,1448397303768,308560,309010
MASONB.txt,533525,534439,914,10,N,Y,1448397303768,308560,309010
MASONB.txt,533581,534577,996,10,N,Y,1448397303768,308560,309010
MASONB.txt,533656,535241,1585,10,N,Y,1448397303768,308560,309010
MASONB.txt,533796,535336,1540,10,N,Y,1448397303768,308560,309010
MASONB.txt,533888,535411,1523,10,N,Y,1448397303768,308560,309010
MASONB.txt,533970,535476,1506,10,N,Y,1448397303768,308560,309010
MASONB.txt,534036,535554,1518,10,N,Y,1448397303768,308560,309010
MASONB.txt,534133,535734,1601,10,N,Y,1448397303768,308560,309010
MASONB.txt,534233,535838,1605,10,N,Y,1448658878157,317802,318970
MASONB.txt,534324,535925,1601,10,N,Y,1448658878157,317802,318970
MASONB.txt,534440,535988,1548,10,N,Y,1448658878157,317802,318970
MASONB.txt,534578,536032,1454,10,N,Y,1448658878157,317802,318970
MASONB.txt,535244,536268,1024,10,N,Y,1448658878157,317802,318970
MASONB.txt,535337,536422,1085,10,N,Y,1448658878157,317802,318970
MASONB.txt,535412,536507,1095,10,N,Y,1448658878157,317802,318970
MASONB.txt,535477,536640,1163,10,N,Y,1448658878157,317802,318970
MASONB.txt,535556,536765,1209,10,N,Y,1448658878157,317802,318970
MASONB.txt,535735,536836,1101,10,N,Y,1448658878157,317802,318970
MASONB.txt,535841,536934,1093,10,N,Y,1461791817263,551075,551983
MASONB.txt,535926,537283,1357,10,N,Y,1461791817263,551075,551983
MASONB.txt,535991,537424,1433,10,N,Y,1461791817263,551075,551983
MASONB.txt,536033,537540,1507,10,N,Y,1461791817263,551075,551983
MASONB.txt,536269,537710,1441,10,N,Y,1461791817263,551075,551983
MASONB.txt,536424,537833,1409,10,N,Y,1461791817263,551075,551983
MASONB.txt,536508,537971,1463,10,Y,Y,1461791817263,551075,551983
MASONB.txt,536641,538011,1370,10,N,Y,1461791817263,551075,551983
MASONB.txt,536766,538052,1286,10,N,Y,1461791817263,551075,551983
MASONB.txt,536837,538168,1331,10,Y,Y,1461791817263,551075,551983
MASONB.txt,536935,538286,1351,10,N,Y,1461791817263,551075,551983
MASONB.txt,537284,538363,1079,10,N,Y,1461791817263,551075,551983
MASONB.txt,537425,538449,1024,10,N,Y,1461791817263,551075,551983
MASONB.txt,537541,538511,970,10,N,Y,1461791817263,551075,551983
MASONB.txt,537711,538673,962,10,N,Y,1461791817263,551075,551983
MASONB.txt,537834,538690,856,10,N,Y,1461791817263,551075,551983
MASONB.txt,537972,538886,914,10,N,Y,1461791817263,551075,551983
MASONB.txt,538012,538911,899,10,N,Y,1461791817263,551075,551983
MASONB.txt,538053,538998,945,10,N,Y,1461791817263,551075,551983
MASONB.txt,538169,539085,916,10,N,Y,1461791817263,551075,551983
MASONB.txt,538289,539237,948,10,N,Y,1461791817263,551075,551983
MASONB.txt,538364,539326,962,10,N,Y,1461791817263,551075,551983
MASONB.txt,538450,539411,961,10,N,Y,1461791817263,551075,551983
MASONB.txt,538512,539484,972,10,N,Y,1461791817263,551075,551983
MASONB.txt,538678,539601,923,10,N,Y,1449009488129,472748,472913
MASONB.txt,538695,539722,1027,10,N,Y,1449009488129,472748,472913
MASONB.txt,538889,539837,948,10,N,Y,1449009488129,472748,472913
MASONB.txt,538914,540022,1108,10,N,Y,1449009488129,472748,472913
MASONB.txt,538999,540146,1147,10,N,Y,1449009488129,472748,472913
MASONB.txt,539086,540303,1217,10,N,Y,1449009488129,472748,472913
MASONB.txt,539238,540375,1137,10,N,Y,1449009488129,472748,472913
MASONB.txt,539327,540471,1144,10,N,Y,1449009488129,472748,472913
MASONB.txt,539412,540595,1183,10,N,Y,1449009488129,472748,472913
MASONB.txt,539485,540731,1246,10,N,Y,1448707642133,333165,333450
MASONB.txt,539604,540876,1272,10,N,Y,1448709417506,337306,338419
MASONB.txt,539723,540996,1273,10,N,Y,1448709417506,337306,338419
MASONB.txt,539838,541088,1250,10,N,Y,1448709417506,337306,338419
MASONB.txt,540023,541197,1174,10,N,Y,1448709417506,337306,338419
MASONB.txt,540147,541337,1190,10,N,Y,1448709417506,337306,338419
MASONB.txt,540305,541486,1181,10,N,Y,1448709417506,337306,338419
MASONB.txt,540376,541587,1211,10,N,Y,1448709417506,337306,338419
MASONB.txt,540472,541608,1136,10,N,Y,1448709417506,337306,338419
MASONB.txt,540596,541657,1061,10,N,Y,1448709417506,337306,338419
MASONB.txt,540733,541675,942,10,N,Y,1448709417506,337306,338419
MASONB.txt,540877,541688,811,10,N,Y,1448709417506,337306,338419
MASONB.txt,540997,541752,755,10,N,Y,1448709417506,337306,338419
MASONB.txt,541089,541840,751,10,N,Y,1448709417506,337306,338419
MASONB.txt,541198,541845,647,10,N,Y,1448709417506,337306,338419
MASONB.txt,541338,541927,589,10,N,Y,1448709417506,337306,338419
MASONB.txt,541488,541932,444,10,N,N,-,-1,-1
MASONB.txt,541595,542022,427,10,N,N,-,-1,-1
MASONB.txt,541613,542027,414,10,N,N,-,-1,-1
MASONB.txt,541662,542121,459,10,N,N,-,-1,-1
MASONB.txt,541676,542126,450,10,N,N,-,-1,-1
MASONB.txt,541694,542210,516,10,N,N,-,-1,-1
MASONB.txt,541753,542215,462,10,N,N,-,-1,-1
MASONB.txt,541843,542311,468,10,N,N,-,-1,-1
MASONB.txt,541846,542317,471,10,N,N,-,-1,-1
MASONB.txt,541930,542424,494,10,N,N,-,-1,-1
MASONB.txt,541933,542429,496,10,N,N,-,-1,-1
MASONB.txt,542025,542518,493,10,N,N,-,-1,-1
MASONB.txt,542028,542523,495,10,N,N,-,-1,-1
MASONB.txt,542124,542602,478,10,N,N,-,-1,-1
MASONB.txt,542127,542608,481,10,N,N,-,-1,-1
MASONB.txt,542213,542688,475,10,N,N,-,-1,-1
MASONB.txt,542216,542694,478,10,N,N,-,-1,-1
MASONB.txt,542314,542776,462,10,N,N,-,-1,-1
MASONB.txt,542318,542873,555,10,N,N,-,-1,-1
MASONB.txt,542427,542981,554,10,N,N,-,-1,-1
MASONB.txt,542430,542999,569,10,N,N,-,-1,-1
MASONB.txt,542521,543005,484,10,N,N,-,-1,-1
MASONB.txt,542524,543092,568,10,N,N,-,-1,-1
MASONB.txt,542605,543098,493,10,N,N,-,-1,-1
MASONB.txt,542609,543184,575,10,N,N,-,-1,-1
MASONB.txt,542691,543190,499,10,N,N,-,-1,-1
MASONB.txt,542695,543271,576,10,N,N,-,-1,-1
MASONB.txt,542777,543277,500,10,N,N,-,-1,-1
MASONB.txt,542876,543348,472,10,N,N,-,-1,-1
MASONB.txt,542986,543354,368,10,N,N,-,-1,-1
MASONB.txt,543002,543463,461,10,N,N,-,-1,-1
MASONB.txt,543006,543546,540,10,N,N,-,-1,-1
MASONB.txt,543095,543695,600,10,N,Y,1448397101672,305423,307582
MASONB.txt,543099,543825,726,10,N,Y,1448397101672,305423,307582
MASONB.txt,543187,543886,699,10,N,Y,1448397101672,305423,307582
MASONB.txt,543191,543988,797,10,N,Y,1448397101672,305423,307582
MASONB.txt,543274,544089,815,10,N,Y,1448397101672,305423,307582
MASONB.txt,543278,544158,880,10,N,Y,1448397101672,305423,307582
MASONB.txt,543351,544618,1267,10,N,Y,1448397101672,305423,307582
MASONB.txt,543355,544671,1316,10,N,Y,1448397101672,305423,307582
MASONB.txt,543466,544825,1359,10,N,Y,1448397101672,305423,307582
MASONB.txt,543547,544841,1294,10,N,Y,1448397101672,305423,307582
MASONB.txt,543696,544858,1162,10,N,Y,1448397101672,305423,307582
MASONB.txt,543827,544965,1138,10,N,Y,1448397101672,305423,307582
MASONB.txt,543888,545002,1114,10,N,Y,1448397101672,305423,307582
MASONB.txt,543989,545054,1065,10,N,Y,1448659394533,323638,324307
MASONB.txt,544090,545247,1157,10,N,Y,1448659394533,323638,324307
MASONB.txt,544159,545401,1242,10,N,Y,1448659394533,323638,324307
MASONB.txt,544619,545567,948,10,N,Y,1448659394533,323638,324307
MASONB.txt,544672,545676,1004,10,N,Y,1448659394533,323638,324307
MASONB.txt,544826,545773,947,10,N,Y,1448659394533,323638,324307
MASONB.txt,544842,546070,1228,10,N,Y,1448659394533,323638,324307
MASONB.txt,544859,546209,1350,10,N,Y,1448659394533,323638,324307
MASONB.txt,544966,546389,1423,10,N,Y,1448659394533,323638,324307
MASONB.txt,545003,546446,1443,10,N,Y,1448659394533,323638,324307
MASONB.txt,545055,546492,1437,10,N,Y,1448659394533,323638,324307
MASONB.txt,545250,546531,1281,10,N,N,-,-1,-1
MASONB.txt,545402,546612,1210,10,N,N,-,-1,-1
MASONB.txt,545568,546637,1069,10,N,N,-,-1,-1
MASONB.txt,545678,546714,1036,10,N,Y,1448920293515,357836,358190
MASONB.txt,545774,546845,1071,10,N,Y,1448920293515,357836,358190
MASONB.txt,546073,547048,975,10,N,Y,1448920293515,357836,358190
MASONB.txt,546212,547187,975,10,N,Y,1448920293515,357836,358190
MASONB.txt,546392,547375,983,10,N,Y,1448920293515,357836,358190
MASONB.txt,546447,547472,1025,10,N,Y,1448920293515,357836,358190
MASONB.txt,546495,547707,1212,10,N,Y,1448920293515,357836,358190
MASONB.txt,546536,547979,1443,10,N,Y,1448920293515,357836,358190
MASONB.txt,546615,548115,1500,10,N,Y,1448920293515,357836,358190
MASONB.txt,546640,548123,1483,10,N,Y,1448920293515,357836,358190
MASONB.txt,546715,548184,1469,10,N,Y,1448920293515,357836,358190
MASONB.txt,546846,548241,1395,10,N,Y,1448920293515,357836,358190
MASONB.txt,547049,548406,1357,10,N,Y,1448920293515,357836,358190
MASONB.txt,547188,548544,1356,10,N,Y,1448920293515,357836,358190
MASONB.txt,547378,548613,1235,10,N,Y,1448920293515,357836,358190
MASONB.txt,547473,548763,1290,10,N,Y,1448920293515,357836,358190
MASONB.txt,547708,548918,1210,10,N,Y,1448920293515,357836,358190
MASONB.txt,547982,549146,1164,10,N,Y,1448920293515,357836,358190
MASONB.txt,548116,549250,1134,10,N,Y,1448920293515,357836,358190
MASONB.txt,548124,549345,1221,10,N,Y,1448920293515,357836,358190
MASONB.txt,548185,549528,1343,10,Y,Y,1448920293515,357836,358190
MASONB.txt,548242,549677,1435,10,Y,Y,1448920293515,357836,358190
MASONB.txt,548407,549690,1283,10,Y,Y,1448920293515,357836,358190
MASONB.txt,548545,549719,1174,10,N,Y,1448920293515,357836,358190
MASONB.txt,548614,549732,1118,10,N,Y,1448920293515,357836,358190
MASONB.txt,548765,549783,1018,10,N,Y,1448659261066,322714,323579
MASONB.txt,548919,549829,910,10,N,Y,1448659261066,322714,323579
MASONB.txt,549147,550058,911,10,N,Y,1448659261066,322714,323579
MASONB.txt,549251,550194,943,10,N,Y,1448660077114,325649,326955
MASONB.txt,549348,550368,1020,10,N,Y,1448660077114,325649,326955
MASONB.txt,549529,550498,969,10,Y,Y,1448660077114,325649,326955
MASONB.txt,549680,550600,920,10,Y,Y,1448660077114,325649,326955
MASONB.txt,549693,550833,1140,10,Y,Y,1448660077114,325649,326955
MASONB.txt,549720,551074,1354,10,Y,Y,1448660077114,325649,326955
MASONB.txt,549735,551222,1487,10,Y,Y,1448660077114,325649,326955
MASONB.txt,549784,551346,1562,10,Y,Y,1448660077114,325649,326955
MASONB.txt,549830,551355,1525,10,Y,Y,1448660077114,325649,326955
MASONB.txt,550059,551407,1348,10,Y,Y,1448660077114,325649,326955
MASONB.txt,550195,551527,1332,10,Y,Y,1448660077114,325649,326955
MASONB.txt,550369,551690,1321,10,Y,Y,1448660077114,325649,326955
MASONB.txt,550499,551831,1332,10,Y,Y,1448660077114,325649,326955
MASONB.txt,550601,551919,1318,10,Y,Y,1448660077114,325649,326955
MASONB.txt,550834,552121,1287,10,Y,Y,1448660077114,325649,326955
MASONB.txt,551077,552242,1165,10,N,Y,1461779662782,546686,549591
MASONB.txt,551223,552357,1134,10,N,Y,1461779662782,546686,549591
MASONB.txt,551347,552472,1125,10,N,Y,1461779662782,546686,549591
MASONB.txt,551356,552603,1247,10,N,Y,1461779662782,546686,549591
MASONB.txt,551408,552614,1206,10,N,Y,1461779662782,546686,549591
MASONB.txt,551530,552720,1190,10,N,Y,1461779662782,546686,549591
MASONB.txt,551691,552857,1166,10,N,Y,1461779662782,546686,549591
MASONB.txt,551832,553011,1179,10,N,Y,1461779662782,546686,549591
MASONB.txt,551920,553077,1157,10,N,Y,1461779662782,546686,549591
MASONB.txt,552124,553082,958,10,N,Y,1461671039271,535897,538614
MASONB.txt,552244,553194,950,10,N,Y,1461671039271,535897,538614
MASONB.txt,552358,553365,1007,10,N,Y,1461671039271,535897,538614
MASONB.txt,552473,553381,908,10,N,Y,1461671039271,535897,538614
MASONB.txt,552604,553496,892,10,N,Y,1461671039271,535897,538614
MASONB.txt,552615,553671,1056,10,N,Y,1461671039271,535897,538614
MASONB.txt,552721,553791,1070,10,N,Y,1461671039271,535897,538614
MASONB.txt,552858,554047,1189,10,N,Y,1461671039271,535897,538614
MASONB.txt,553012,554187,1175,10,N,Y,1461671039271,535897,538614
MASONB.txt,553078,554340,1262,10,N,Y,1461671039271,535897,538614
MASONB.txt,553083,554436,1353,10,N,Y,1461671039271,535897,538614
MASONB.txt,553197,554536,1339,10,N,Y,1461671039271,535897,538614
MASONB.txt,553370,554648,1278,10,N,N,-,-1,-1
MASONB.txt,553386,554773,1387,10,N,Y,1461777612954,544164,545194
MASONB.txt,553499,554799,1300,10,N,Y,1461777612954,544164,545194
MASONB.txt,553672,554839,1167,10,N,Y,1461777612954,544164,545194
MASONB.txt,553792,554924,1132,10,N,Y,1461777612954,544164,545194
MASONB.txt,554048,555050,1002,10,N,Y,1461777612954,544164,545194
MASONB.txt,554189,555093,904,10,N,Y,1461777612954,544164,545194
MASONB.txt,554341,555185,844,10,N,Y,1461777612954,544164,545194
MASONB.txt,554437,555264,827,10,N,Y,1461777612954,544164,545194
MASONB.txt,554537,555358,821,10,N,Y,1461777612954,544164,545194
MASONB.txt,554651,555752,1101,10,N,Y,1461777612954,544164,545194
MASONB.txt,554778,555940,1162,10,N,Y,1448920858487,363333,364839
MASONB.txt,554800,556310,1510,10,Y,Y,1448920858487,363333,364839
MASONB.txt,554840,556425,1585,10,Y,Y,1448396682588,302572,302721
MASONB.txt,554925,556652,1727,10,Y,Y,1448396682588,302572,302721
MASONB.txt,555052,556834,1782,10,Y,Y,1448396682588,302572,302721
MASONB.txt,555094,556850,1756,10,Y,Y,1448396682588,302572,302721
MASONB.txt,555186,557217,2031,10,Y,Y,1448396682588,302572,302721
MASONB.txt,555265,557292,2027,10,Y,Y,1448396682588,302572,302721
MASONB.txt,555359,557467,2108,10,Y,Y,1448396682588,302572,302721
MASONB.txt,555753,557741,1988,10,N,Y,1448396682588,302572,302721
MASONB.txt,555941,558008,2067,10,N,Y,1448396682588,302572,302721
MASONB.txt,556311,558095,1784,10,N,Y,1448396682588,302572,302721
MASONB.txt,556427,558247,1820,10,N,Y,1448396682588,302572,302721
MASONB.txt,556653,558326,1673,10,N,Y,1448396682588,302572,302721
MASONB.txt,556837,558327,1490,10,N,Y,1448396682588,302572,302721
MASONB.txt,556851,558524,1673,10,N,Y,1448396682588,302572,302721
MASONB.txt,557218,558774,1556,10,N,Y,1448396682588,302572,302721
MASONB.txt,557294,558800,1506,10,N,Y,1448396682588,302572,302721
MASONB.txt,557468,558810,1342,10,N,Y,1448396682588,302572,302721
MASONB.txt,557744,558877,1133,10,N,Y,1448396682588,302572,302721
MASONB.txt,558009,558934,925,10,N,Y,1448396682588,302572,302721
MASONB.txt,558098,559019,921,10,N,Y,1461777193721,543550,543984
MASONB.txt,558248,559177,929,10,N,Y,1461777193721,543550,543984
MASONB.txt,558326,559340,1014,10,N,N,-,-1,-1
MASONB.txt,558328,559435,1107,10,N,N,-,-1,-1
MASONB.txt,558525,559619,1094,10,N,N,-,-1,-1
MASONB.txt,558775,559870,1095,10,N,N,-,-1,-1
MASONB.txt,558801,559887,1086,10,N,N,-,-1,-1
MASONB.txt,558811,560016,1205,10,N,N,-,-1,-1
MASONB.txt,558879,560042,1163,10,N,N,-,-1,-1
MASONB.txt,558937,560251,1314,10,N,N,-,-1,-1
MASONB.txt,559020,560353,1333,10,N,N,-,-1,-1
MASONB.txt,559178,560488,1310,10,N,N,-,-1,-1
MASONB.txt,559341,560514,1173,10,N,N,-,-1,-1
MASONB.txt,559436,560616,1180,10,N,N,-,-1,-1
MASONB.txt,559620,560674,1054,10,N,N,-,-1,-1
MASONB.txt,559875,560682,807,10,N,N,-,-1,-1
MASONB.txt,559892,560686,794,10,N,N,-,-1,-1
MASONB.txt,560019,560700,681,10,N,N,-,-1,-1
MASONB.txt,560045,560777,732,10,N,N,-,-1,-1
MASONB.txt,560252,560785,533,10,N,N,-,-1,-1
MASONB.txt,560354,560790,436,10,N,N,-,-1,-1
MASONB.txt,560493,560808,315,10,N,N,-,-1,-1
MASONB.txt,560517,560864,347,10,N,N,-,-1,-1
MASONB.txt,560617,560872,255,10,N,N,-,-1,-1
MASONB.txt,560677,560876,199,10,N,N,-,-1,-1
MASONB.txt,560683,560894,211,10,N,N,-,-1,-1
MASONB.txt,560687,560986,299,10,N,N,-,-1,-1
MASONB.txt,560701,560989,288,10,N,N,-,-1,-1
MASONB.txt,560780,561000,220,10,N,N,-,-1,-1
MASONB.txt,560786,561057,271,10,N,N,-,-1,-1
MASONB.txt,560791,561065,274,10,N,N,-,-1,-1
MASONB.txt,560809,561069,260,10,N,N,-,-1,-1
MASONB.txt,560867,561116,249,10,N,N,-,-1,-1
MASONB.txt,560873,561215,342,10,N,N,-,-1,-1
MASONB.txt,560877,561347,470,10,N,N,-,-1,-1
MASONB.txt,560895,561425,530,10,N,N,-,-1,-1
MASONB.txt,560987,561536,549,10,N,N,-,-1,-1
MASONB.txt,560990,561666,676,10,N,N,-,-1,-1
MASONB.txt,561001,561880,879,10,N,N,-,-1,-1
MASONB.txt,561060,562088,1028,10,N,N,-,-1,-1
MASONB.txt,561066,562168,1102,10,N,N,-,-1,-1
MASONB.txt,561070,562257,1187,10,N,N,-,-1,-1
MASONB.txt,561119,562282,1163,10,N,N,-,-1,-1
MASONB.txt,561216,562393,1177,10,Y,N,-,-1,-1
MASONB.txt,561348,562506,1158,10,Y,N,-,-1,-1
MASONB.txt,561427,562671,1244,10,N,N,-,-1,-1
MASONB.txt,561537,562728,1191,10,Y,N,-,-1,-1
MASONB.txt,561667,562935,1268,10,N,N,-,-1,-1
MASONB.txt,561881,562993,1112,10,N,N,-,-1,-1
MASONB.txt,562089,563056,967,10,Y,N,-,-1,-1
MASONB.txt,562169,563128,959,10,N,N,-,-1,-1
MASONB.txt,562262,563155,893,10,N,N,-,-1,-1
MASONB.txt,562283,563321,1038,10,N,N,-,-1,-1
MASONB.txt,562394,563417,1023,10,Y,N,-,-1,-1
MASONB.txt,562507,563506,999,10,Y,N,-,-1,-1
MASONB.txt,562672,563664,992,10,N,N,-,-1,-1
MASONB.txt,562729,563765,1036,10,N,N,-,-1,-1
MASONB.txt,562936,563872,936,10,N,N,-,-1,-1
MASONB.txt,562994,563959,965,10,N,N,-,-1,-1
MASONB.txt,563057,564048,991,10,N,N,-,-1,-1
MASONB.txt,563129,564140,1011,10,N,N,-,-1,-1
MASONB.txt,563156,564191,1035,10,N,N,-,-1,-1
MASONB.txt,563321,564281,960,10,N,N,-,-1,-1
MASONB.txt,563418,564388,970,10,N,N,-,-1,-1
MASONB.txt,563509,564489,980,10,Y,N,-,-1,-1
MASONB.txt,563665,564561,896,10,Y,N,-,-1,-1
MASONB.txt,563768,564613,845,10,Y,N,-,-1,-1
MASONB.txt,563875,564718,843,10,Y,N,-,-1,-1
MASONB.txt,563960,564791,831,10,Y,N,-,-1,-1
MASONB.txt,564049,564866,817,10,Y,N,-,-1,-1
MASONB.txt,564143,564980,837,10,Y,N,-,-1,-1
MASONB.txt,564192,565023,831,10,Y,N,-,-1,-1
MASONB.txt,564282,565205,923,10,Y,N,-,-1,-1
MASONB.txt,564390,565255,865,10,Y,N,-,-1,-1
MASONB.txt,564490,565372,882,10,N,N,-,-1,-1
MASONB.txt,564562,565462,900,10,N,N,-,-1,-1
MASONB.txt,564614,565684,1070,10,N,N,-,-1,-1
MASONB.txt,564719,565898,1179,10,N,N,-,-1,-1
MASONB.txt,564794,565949,1155,10,Y,N,-,-1,-1
MASONB.txt,564867,566022,1155,10,Y,N,-,-1,-1
MASONB.txt,564981,566191,1210,10,Y,N,-,-1,-1
MASONB.txt,565024,566207,1183,10,Y,N,-,-1,-1
MASONB.txt,565208,566359,1151,10,N,N,-,-1,-1
MASONB.txt,565256,566390,1134,10,N,N,-,-1,-1
MASONB.txt,565373,566505,1132,10,N,N,-,-1,-1
MASONB.txt,565465,566606,1141,10,N,N,-,-1,-1
MASONB.txt,565687,566684,997,10,N,N,-,-1,-1
MASONB.txt,565899,566881,982,10,N,N,-,-1,-1
MASONB.txt,565950,566993,1043,10,N,N,-,-1,-1
MASONB.txt,566025,567117,1092,10,N,N,-,-1,-1
MASONB.txt,566196,567274,1078,10,N,N,-,-1,-1
MASONB.txt,566210,567340,1130,10,N,N,-,-1,-1
MASONB.txt,566362,567486,1124,10,N,N,-,-1,-1
MASONB.txt,566393,567513,1120,10,N,N,-,-1,-1
MASONB.txt,566506,567753,1247,10,N,N,-,-1,-1
MASONB.txt,566607,567824,1217,10,N,N,-,-1,-1
MASONB.txt,566685,567919,1234,10,N,N,-,-1,-1
MASONB.txt,566882,567967,1085,10,N,N,-,-1,-1
MASONB.txt,566994,568052,1058,10,N,N,-,-1,-1
MASONB.txt,567118,568322,1204,10,N,N,-,-1,-1
MASONB.txt,567275,568427,1152,10,N,N,-,-1,-1
MASONB.txt,567342,568630,1288,10,N,N,-,-1,-1
MASONB.txt,567489,568802,1313,10,N,N,-,-1,-1
MASONB.txt,567514,568894,1380,10,N,N,-,-1,-1
MASONB.txt,567756,569294,1538,10,N,N,-,-1,-1
MASONB.txt,567825,569387,1562,10,N,N,-,-1,-1
MASONB.txt,567920,569622,1702,10,N,N,-,-1,-1
MASONB.txt,567968,569671,1703,10,N,N,-,-1,-1
MASONB.txt,568053,569876,1823,10,Y,N,-,-1,-1
MASONB.txt,568323,569973,1650,10,N,N,-,-1,-1
MASONB.txt,568429,570045,1616,10,N,N,-,-1,-1
MASONB.txt,568631,570235,1604,10,N,N,-,-1,-1
MASONB.txt,568804,570366,1562,10,N,N,-,-1,-1
MASONB.txt,568895,570548,1653,10,Y,N,-,-1,-1
MASONB.txt,569295,570728,1433,10,Y,N,-,-1,-1
MASONB.txt,569388,570892,1504,10,Y,N,-,-1,-1
MASONB.txt,569625,570967,1342,10,N,N,-,-1,-1
MASONB.txt,569672,571080,1408,10,N,N,-,-1,-1
MASONB.txt,569878,571241,1363,10,Y,N,-,-1,-1
MASONB.txt,569976,571294,1318,10,N,N,-,-1,-1
MASONB.txt,570046,571377,1331,10,N,N,-,-1,-1
MASONB.txt,570236,571521,1285,10,N,N,-,-1,-1
MASONB.txt,570367,571628,1261,10,N,N,-,-1,-1
MASONB.txt,570550,571641,1091,10,N,N,-,-1,-1
MEMMUS.txt,0,7939,7939,10,Y,N,-,-1,-1
MEMMUS.txt,1231,8570,7339,10,Y,N,-,-1,-1
MEMMUS.txt,1903,8805,6902,10,Y,N,-,-1,-1
MEMMUS.txt,1905,8885,6980,10,Y,N,-,-1,-1
MEMMUS.txt,4661,9235,4574,10,Y,N,-,-1,-1
MEMMUS.txt,5856,9716,3860,10,Y,N,-,-1,-1
MEMMUS.txt,6567,9773,3206,10,N,N,-,-1,-1
MEMMUS.txt,6634,9973,3339,10,N,N,-,-1,-1
MEMMUS.txt,6641,9975,3334,10,N,N,-,-1,-1
MEMMUS.txt,6643,10845,4202,10,Y,N,-,-1,-1
MEMMUS.txt,7940,11007,3067,10,N,N,-,-1,-1
MEMMUS.txt,8571,11028,2457,10,N,N,-,-1,-1
MEMMUS.txt,8806,11275,2469,10,N,N,-,-1,-1
MEMMUS.txt,8888,11289,2401,10,N,N,-,-1,-1
MEMMUS.txt,9236,11397,2161,10,N,N,-,-1,-1
MEMMUS.txt,9717,11429,1712,10,N,N,-,-1,-1
MEMMUS.txt,9776,11460,1684,10,N,N,-,-1,-1
MEMMUS.txt,9974,11557,1583,10,N,N,-,-1,-1
MEMMUS.txt,9976,11581,1605,10,N,N,-,-1,-1
MEMMUS.txt,10846,11584,738,10,N,N,-,-1,-1
MEMMUS.txt,11008,11611,603,10,N,N,-,-1,-1
MEMMUS.txt,11029,11613,584,10,N,N,-,-1,-1
MEMMUS.txt,11276,11620,344,10,N,N,-,-1,-1
MEMMUS.txt,11290,11622,332,10,N,N,-,-1,-1
MEMMUS.txt,11398,11642,244,10,N,N,-,-1,-1
MEMMUS.txt,11430,11644,214,10,N,N,-,-1,-1
MEMMUS.txt,11461,11648,187,10,N,N,-,-1,-1
MEMMUS.txt,11558,11683,125,10,N,N,-,-1,-1
MEMMUS.txt,11581,12665,1084,10,Y,N,-,-1,-1
MEMMUS.txt,11585,12891,1306,10,N,N,-,-1,-1
MEMMUS.txt,11612,13127,1515,10,Y,N,-,-1,-1
MEMMUS.txt,11614,13243,1629,10,Y,N,-,-1,-1
MEMMUS.txt,11621,13500,1879,10,Y,N,-,-1,-1
MEMMUS.txt,11623,13559,1936,10,Y,N,-,-1,-1
MEMMUS.txt,11643,13746,2103,10,Y,N,-,-1,-1
MEMMUS.txt,11645,13834,2189,10,Y,N,-,-1,-1
MEMMUS.txt,11648,14031,2383,10,Y,N,-,-1,-1
MEMMUS.txt,11684,14208,2524,10,Y,N,-,-1,-1
MEMMUS.txt,12668,14354,1686,10,Y,N,-,-1,-1
MEMMUS.txt,12892,14689,1797,10,Y,N,-,-1,-1
MEMMUS.txt,13130,14807,1677,10,Y,N,-,-1,-1
MEMMUS.txt,13244,14994,1750,10,Y,N,-,-1,-1
MEMMUS.txt,13501,15148,1647,10,Y,N,-,-1,-1
MEMMUS.txt,13560,15356,1796,10,Y,N,-,-1,-1
MEMMUS.txt,13747,15708,1961,10,Y,N,-,-1,-1
MEMMUS.txt,13837,15818,1981,10,Y,N,-,-1,-1
MEMMUS.txt,14034,15937,1903,10,Y,N,-,-1,-1
MEMMUS.txt,14209,15949,1740,10,Y,N,-,-1,-1
MEMMUS.txt,14359,16033,1674,10,Y,N,-,-1,-1
MEMMUS.txt,14692,16041,1349,10,Y,N,-,-1,-1
MEMMUS.txt,14808,16124,1316,10,Y,N,-,-1,-1
MEMMUS.txt,14997,16302,1305,10,Y,N,-,-1,-1
MEMMUS.txt,15149,16371,1222,10,Y,N,-,-1,-1
MEMMUS.txt,15357,16406,1049,10,N,N,-,-1,-1
MEMMUS.txt,15710,16596,886,10,N,N,-,-1,-1
MEMMUS.txt,15821,16679,858,10,N,N,-,-1,-1
MEMMUS.txt,15938,16745,807,10,N,N,-,-1,-1
MEMMUS.txt,15950,16831,881,10,N,N,-,-1,-1
MEMMUS.txt,16034,16968,934,10,Y,N,-,-1,-1
MEMMUS.txt,16042,17037,995,10,Y,N,-,-1,-1
MEMMUS.txt,16126,17212,1086,10,Y,N,-,-1,-1
MEMMUS.txt,16303,17267,964,10,Y,N,-,-1,-1
MEMMUS.txt,16372,17353,981,10,Y,N,-,-1,-1
MEMMUS.txt,16409,17465,1056,10,Y,N,-,-1,-1
MEMMUS.txt,16597,17541,944,10,Y,N,-,-1,-1
MEMMUS.txt,16680,17655,975,10,Y,N,-,-1,-1
MEMMUS.txt,16746,17772,1026,10,Y,N,-,-1,-1
MEMMUS.txt,16834,18205,1371,10,Y,N,-,-1,-1
MEMMUS.txt,16969,18258,1289,10,Y,N,-,-1,-1
MEMMUS.txt,17042,18367,1325,10,Y,Y,1437476486340,221621,222520
MEMMUS.txt,17213,18455,1242,10,Y,Y,1437476486340,221621,222520
MEMMUS.txt,17268,18530,1262,10,Y,Y,1437476486340,221621,222520
MEMMUS.txt,17354,18576,1222,10,N,Y,1437476486340,221621,222520
MEMMUS.txt,17466,18676,1210,10,N,Y,1437476486340,221621,222520
MEMMUS.txt,17542,18787,1245,10,N,Y,1437476486340,221621,222520
MEMMUS.txt,17656,18840,1184,10,N,Y,1437476486340,221621,222520
MEMMUS.txt,17773,18866,1093,10,N,Y,1437476486340,221621,222520
MEMMUS.txt,18206,18891,685,10,N,Y,1437476486340,221621,222520
MEMMUS.txt,18259,19003,744,10,N,Y,1437476486340,221621,222520
MEMMUS.txt,18368,19182,814,10,N,Y,1437476486340,221621,222520
MEMMUS.txt,18456,19363,907,10,N,Y,1437476486340,221621,222520
MEMMUS.txt,18531,19503,972,10,N,Y,1437476486340,221621,222520
MEMMUS.txt,18577,19679,1102,10,N,Y,1437476486340,221621,222520
MEMMUS.txt,18677,19822,1145,10,N,Y,1437476486340,221621,222520
MEMMUS.txt,18788,19875,1087,10,N,Y,1437476486340,221621,222520
MEMMUS.txt,18841,19941,1100,10,N,Y,1437476486340,221621,222520
MEMMUS.txt,18867,20053,1186,10,N,N,-,-1,-1
MEMMUS.txt,18894,20085,1191,10,Y,N,-,-1,-1
MEMMUS.txt,19004,20117,1113,10,Y,N,-,-1,-1
MEMMUS.txt,19185,20157,972,10,Y,N,-,-1,-1
MEMMUS.txt,19364,20220,856,10,N,N,-,-1,-1
MEMMUS.txt,19506,20269,763,10,N,N,-,-1,-1
MEMMUS.txt,19682,20343,661,10,N,N,-,-1,-1
MEMMUS.txt,19823,20382,559,10,N,N,-,-1,-1
MEMMUS.txt,19876,20486,610,10,N,N,-,-1,-1
MEMMUS.txt,19942,20542,600,10,N,N,-,-1,-1
MEMMUS.txt,20054,20577,523,10,N,N,-,-1,-1
MEMMUS.txt,20086,20748,662,10,Y,N,-,-1,-1
MEMMUS.txt,20118,20893,775,10,Y,N,-,-1,-1
MEMMUS.txt,20158,20991,833,10,Y,N,-,-1,-1
MEMMUS.txt,20221,21041,820,10,Y,N,-,-1,-1
MEMMUS.txt,20270,21294,1024,10,Y,N,-,-1,-1
MEMMUS.txt,20344,21452,1108,10,Y,N,-,-1,-1
MEMMUS.txt,20383,21670,1287,10,Y,N,-,-1,-1
MEMMUS.txt,20488,21756,1268,10,Y,N,-,-1,-1
MEMMUS.txt,20543,21908,1365,10,Y,N,-,-1,-1
MEMMUS.txt,20580,21965,1385,10,Y,N,-,-1,-1
MEMMUS.txt,20749,22057,1308,10,Y,N,-,-1,-1
MEMMUS.txt,20896,22129,1233,10,Y,N,-,-1,-1
MEMMUS.txt,20993,22284,1291,10,Y,N,-,-1,-1
MEMMUS.txt,21044,22360,1316,10,Y,Y,1448037533268,13930,15031
MEMMUS.txt,21295,22511,1216,10,N,Y,1448037533268,13930,15031
MEMMUS.txt,21457,22656,1199,10,N,Y,1448037533268,13930,15031
MEMMUS.txt,21672,22800,1128,10,N,Y,1448037533268,13930,15031
MEMMUS.txt,21757,22849,1092,10,N,Y,1448037533268,13930,15031
MEMMUS.txt,21909,22934,1025,10,N,Y,1448037533268,13930,15031
MEMMUS.txt,21968,23008,1040,10,N,Y,1448037533268,13930,15031
MEMMUS.txt,22059,23056,997,10,N,Y,1448037533268,13930,15031
MEMMUS.txt,22130,23198,1068,10,Y,Y,1448037533268,13930,15031
MEMMUS.txt,22287,23410,1123,10,Y,Y,1448037533268,13930,15031
MEMMUS.txt,22361,23503,1142,10,Y,Y,1448037533268,13930,15031
MEMMUS.txt,22513,23567,1054,10,Y,Y,1448037533268,13930,15031
MEMMUS.txt,22658,23710,1052,10,Y,Y,1448037533268,13930,15031
MEMMUS.txt,22801,23827,1026,10,Y,Y,1448037533268,13930,15031
MEMMUS.txt,22852,23918,1066,10,Y,Y,1448314861876,180438,180657
MEMMUS.txt,22935,24033,1098,10,Y,Y,1448314861876,180438,180657
MEMMUS.txt,23011,24180,1169,10,Y,Y,1448314861876,180438,180657
MEMMUS.txt,23058,24283,1225,10,Y,Y,1448314861876,180438,180657
MEMMUS.txt,23200,24412,1212,10,Y,Y,1448285913012,108803,110925
MEMMUS.txt,23411,24645,1234,10,N,Y,1448285913012,108803,110925
MEMMUS.txt,23504,24851,1347,10,Y,Y,1448285913012,108803,110925
MEMMUS.txt,23569,25099,1530,10,N,Y,1448285913012,108803,110925
MEMMUS.txt,23712,25385,1673,10,N,Y,1448285913012,108803,110925
MEMMUS.txt,23828,25485,1657,10,N,Y,1448285913012,108803,110925
MEMMUS.txt,23921,25732,1811,10,N,Y,1448285913012,108803,110925
MEMMUS.txt,24034,25922,1888,10,Y,Y,1448039533036,21326,21680
MEMMUS.txt,24181,25958,1777,10,Y,Y,1448039533036,21326,21680
MEMMUS.txt,24288,26032,1744,10,Y,Y,1448039533036,21326,21680
MEMMUS.txt,24413,26097,1684,10,Y,Y,1448039533036,21326,21680
MEMMUS.txt,24646,26246,1600,10,N,Y,1448039533036,21326,21680
MEMMUS.txt,24852,26359,1507,10,N,Y,1448039533036,21326,21680
MEMMUS.txt,25100,26436,1336,10,N,Y,1448039533036,21326,21680
MEMMUS.txt,25386,26591,1205,10,Y,Y,1448039533036,21326,21680
MEMMUS.txt,25486,26981,1495,10,Y,Y,1448039533036,21326,21680
MEMMUS.txt,25735,27320,1585,10,Y,Y,1448039533036,21326,21680
MEMMUS.txt,25923,27487,1564,10,Y,Y,1448039533036,21326,21680
MEMMUS.txt,25959,27551,1592,10,Y,Y,1448039533036,21326,21680
MEMMUS.txt,26034,27678,1644,10,Y,Y,1448039533036,21326,21680
MEMMUS.txt,26098,27929,1831,10,Y,Y,1448039533036,21326,21680
MEMMUS.txt,26247,28104,1857,10,Y,Y,1448039533036,21326,21680
MEMMUS.txt,26362,28241,1879,10,Y,N,-,-1,-1
MEMMUS.txt,26437,28434,1997,10,Y,N,-,-1,-1
MEMMUS.txt,26592,28558,1966,10,Y,N,-,-1,-1
MEMMUS.txt,26984,28634,1650,10,N,N,-,-1,-1
MEMMUS.txt,27321,28744,1423,10,N,N,-,-1,-1
MEMMUS.txt,27488,28840,1352,10,Y,N,-,-1,-1
MEMMUS.txt,27554,28995,1441,10,N,Y,1448278279697,58861,59444
MEMMUS.txt,27679,29220,1541,10,Y,Y,1448278279697,58861,59444
MEMMUS.txt,27930,29498,1568,10,Y,Y,1448278279697,58861,59444
MEMMUS.txt,28106,29644,1538,10,Y,Y,1448278279697,58861,59444
MEMMUS.txt,28244,29732,1488,10,Y,Y,1448278279697,58861,59444
MEMMUS.txt,28435,29934,1499,10,Y,Y,1448278279697,58861,59444
MEMMUS.txt,28559,30016,1457,10,Y,Y,1448278279697,58861,59444
MEMMUS.txt,28635,30105,1470,10,Y,Y,1448278279697,58861,59444
MEMMUS.txt,28745,30380,1635,10,Y,Y,1448278279697,58861,59444
MEMMUS.txt,28843,30543,1700,10,Y,Y,1448278279697,58861,59444
MEMMUS.txt,28996,30609,1613,10,Y,Y,1448278279697,58861,59444
MEMMUS.txt,29223,30683,1460,10,Y,Y,1448278279697,58861,59444
MEMMUS.txt,29500,30791,1291,10,Y,Y,1448278279697,58861,59444
MEMMUS.txt,29646,30949,1303,10,Y,Y,1448278279697,58861,59444
MEMMUS.txt,29735,31063,1328,10,Y,N,-,-1,-1
MEMMUS.txt,29937,31149,1212,10,Y,N,-,-1,-1
MEMMUS.txt,30017,31292,1275,10,Y,N,-,-1,-1
MEMMUS.txt,30106,31554,1448,10,Y,N,-,-1,-1
MEMMUS.txt,30381,31772,1391,10,Y,Y,1448276340407,30017,39003
MEMMUS.txt,30544,31973,1429,10,Y,Y,1448276340407,30017,39003
MEMMUS.txt,30612,32065,1453,10,Y,Y,1448276340407,30017,39003
MEMMUS.txt,30684,32169,1485,10,Y,Y,1448276340407,30017,39003
MEMMUS.txt,30792,32386,1594,10,Y,Y,1448276340407,30017,39003
MEMMUS.txt,30950,32541,1591,10,N,Y,1448276340407,30017,39003
MEMMUS.txt,31064,32671,1607,10,N,Y,1448276340407,30017,39003
MEMMUS.txt,31152,32893,1741,10,Y,Y,1448276340407,30017,39003
MEMMUS.txt,31294,32997,1703,10,Y,Y,1448276340407,30017,39003
MEMMUS.txt,31557,33127,1570,10,Y,Y,1448276340407,30017,39003
MEMMUS.txt,31773,33485,1712,10,Y,Y,1448276340407,30017,39003
MEMMUS.txt,31974,33573,1599,10,Y,Y,1448276340407,30017,39003
MEMMUS.txt,32068,33643,1575,10,Y,Y,1448276340407,30017,39003
MEMMUS.txt,32170,33818,1648,10,Y,Y,1448279941918,72406,72905
MEMMUS.txt,32387,33855,1468,10,Y,Y,1448279941918,72406,72905
MEMMUS.txt,32542,34025,1483,10,Y,Y,1448279941918,72406,72905
MEMMUS.txt,32672,34195,1523,10,Y,Y,1448279941918,72406,72905
MEMMUS.txt,32898,34424,1526,10,Y,Y,1448279941918,72406,72905
MEMMUS.txt,32998,34512,1514,10,Y,Y,1448279941918,72406,72905
MEMMUS.txt,33128,34767,1639,10,Y,Y,1448279941918,72406,72905
MEMMUS.txt,33486,34919,1433,10,N,Y,1448279941918,72406,72905
MEMMUS.txt,33574,35006,1432,10,N,Y,1448279941918,72406,72905
MEMMUS.txt,33646,35145,1499,10,N,Y,1448279941918,72406,72905
MEMMUS.txt,33819,35287,1468,10,N,Y,1448279941918,72406,72905
MEMMUS.txt,33856,35385,1529,10,N,Y,1448279941918,72406,72905
MEMMUS.txt,34026,35463,1437,10,N,Y,1448286880729,112151,113274
MEMMUS.txt,34196,35776,1580,10,N,Y,1448286880729,112151,113274
MEMMUS.txt,34425,36002,1577,10,N,Y,1448286880729,112151,113274
MEMMUS.txt,34515,36051,1536,10,N,Y,1448286880729,112151,113274
MEMMUS.txt,34768,36139,1371,10,N,Y,1437477878183,427206,428439
MEMMUS.txt,34920,36208,1288,10,N,Y,1437477878183,427206,428439
MEMMUS.txt,35007,36282,1275,10,N,Y,1437477878183,427206,428439
MEMMUS.txt,35146,36580,1434,10,N,Y,1437477878183,427206,428439
MEMMUS.txt,35288,36659,1371,10,N,Y,1437477878183,427206,428439
MEMMUS.txt,35386,36955,1569,10,N,Y,1437477878183,427206,428439
MEMMUS.txt,35466,37207,1741,10,Y,Y,1437477878183,427206,428439
MEMMUS.txt,35777,37431,1654,10,Y,Y,1437477878183,427206,428439
MEMMUS.txt,36003,37573,1570,10,Y,Y,1437477878183,427206,428439
MEMMUS.txt,36054,37845,1791,10,Y,Y,1437477878183,427206,428439
MEMMUS.txt,36140,37961,1821,10,Y,Y,1437477878183,427206,428439
MEMMUS.txt,36211,38122,1911,10,Y,Y,1437477878183,427206,428439
MEMMUS.txt,36283,38277,1994,10,Y,Y,1437477878183,427206,428439
MEMMUS.txt,36581,38338,1757,10,Y,Y,1437477878183,427206,428439
MEMMUS.txt,36662,38378,1716,10,Y,Y,1437477878183,427206,428439
MEMMUS.txt,36956,38427,1471,10,N,Y,1437477878183,427206,428439
MEMMUS.txt,37208,38541,1333,10,N,Y,1437477878183,427206,428439
MEMMUS.txt,37434,38764,1330,10,N,N,-,-1,-1
MEMMUS.txt,37576,39026,1450,10,N,N,-,-1,-1
MEMMUS.txt,37846,39118,1272,10,N,N,-,-1,-1
MEMMUS.txt,37962,39122,1160,10,N,N,-,-1,-1
MEMMUS.txt,38123,39217,1094,10,N,N,-,-1,-1
MEMMUS.txt,38280,39278,998,10,N,N,-,-1,-1
MEMMUS.txt,38339,39399,1060,10,N,N,-,-1,-1
MEMMUS.txt,38379,39501,1122,10,N,N,-,-1,-1
MEMMUS.txt,38428,39568,1140,10,N,N,-,-1,-1
MEMMUS.txt,38546,39659,1113,10,N,N,-,-1,-1
MEMMUS.txt,38767,39747,980,10,N,N,-,-1,-1
MEMMUS.txt,39027,40099,1072,10,Y,N,-,-1,-1
MEMMUS.txt,39119,40261,1142,10,Y,N,-,-1,-1
MEMMUS.txt,39123,40398,1275,10,Y,N,-,-1,-1
MEMMUS.txt,39218,40575,1357,10,Y,N,-,-1,-1
MEMMUS.txt,39279,40636,1357,10,Y,N,-,-1,-1
MEMMUS.txt,39400,40742,1342,10,Y,N,-,-1,-1
MEMMUS.txt,39502,41051,1549,10,Y,N,-,-1,-1
MEMMUS.txt,39569,41132,1563,10,Y,N,-,-1,-1
MEMMUS.txt,39660,41287,1627,10,Y,N,-,-1,-1
MEMMUS.txt,39750,41517,1767,10,Y,N,-,-1,-1
MEMMUS.txt,40100,41684,1584,10,N,N,-,-1,-1
MEMMUS.txt,40262,41862,1600,10,Y,N,-,-1,-1
MEMMUS.txt,40399,41984,1585,10,Y,N,-,-1,-1
MEMMUS.txt,40576,42154,1578,10,N,N,-,-1,-1
MEMMUS.txt,40639,42327,1688,10,N,N,-,-1,-1
MEMMUS.txt,40745,42476,1731,10,N,N,-,-1,-1
MEMMUS.txt,41052,42585,1533,10,Y,N,-,-1,-1
MEMMUS.txt,41133,42709,1576,10,Y,N,-,-1,-1
MEMMUS.txt,41288,42779,1491,10,Y,N,-,-1,-1
MEMMUS.txt,41520,42993,1473,10,Y,N,-,-1,-1
MEMMUS.txt,41687,43128,1441,10,Y,N,-,-1,-1
MEMMUS.txt,41863,43271,1408,10,Y,N,-,-1,-1
MEMMUS.txt,41985,43476,1491,10,Y,N,-,-1,-1
MEMMUS.txt,42157,43521,1364,10,Y,N,-,-1,-1
MEMMUS.txt,42330,43573,1243,10,Y,N,-,-1,-1
MEMMUS.txt,42477,43693,1216,10,N,N,-,-1,-1
MEMMUS.txt,42586,43807,1221,10,N,N,-,-1,-1
MEMMUS.txt,42710,43868,1158,10,N,N,-,-1,-1
MEMMUS.txt,42784,44114,1330,10,N,N,-,-1,-1
MEMMUS.txt,42995,44285,1290,10,N,N,-,-1,-1
MEMMUS.txt,43129,44362,1233,10,Y,N,-,-1,-1
MEMMUS.txt,43272,44444,1172,10,Y,N,-,-1,-1
MEMMUS.txt,43477,44644,1167,10,N,N,-,-1,-1
MEMMUS.txt,43524,44803,1279,10,N,N,-,-1,-1
MEMMUS.txt,43574,44964,1390,10,Y,N,-,-1,-1
MEMMUS.txt,43694,45087,1393,10,Y,N,-,-1,-1
MEMMUS.txt,43808,45263,1455,10,Y,N,-,-1,-1
MEMMUS.txt,43871,45365,1494,10,Y,N,-,-1,-1
MEMMUS.txt,44115,45524,1409,10,Y,N,-,-1,-1
MEMMUS.txt,44286,45590,1304,10,Y,N,-,-1,-1
MEMMUS.txt,44363,45619,1256,10,Y,N,-,-1,-1
MEMMUS.txt,44445,45725,1280,10,Y,N,-,-1,-1
MEMMUS.txt,44645,45786,1141,10,Y,N,-,-1,-1
MEMMUS.txt,44804,45927,1123,10,Y,N,-,-1,-1
MEMMUS.txt,44965,46067,1102,10,Y,N,-,-1,-1
MEMMUS.txt,45090,46139,1049,10,Y,Y,1448393386565,284140,284575
MEMMUS.txt,45264,46170,906,10,N,Y,1448393386565,284140,284575
MEMMUS.txt,45367,46300,933,10,N,Y,1448393386565,284140,284575
MEMMUS.txt,45527,46368,841,10,N,Y,1448393386565,284140,284575
MEMMUS.txt,45591,46460,869,10,N,Y,1448393386565,284140,284575
MEMMUS.txt,45624,46494,870,10,N,Y,1448393386565,284140,284575
MEMMUS.txt,45726,46544,818,10,N,Y,1448393386565,284140,284575
MEMMUS.txt,45787,46599,812,10,N,Y,1448313800274,179025,179317
MEMMUS.txt,45930,46704,774,10,N,Y,1448313800274,179025,179317
MEMMUS.txt,46070,46757,687,10,N,Y,1448313800274,179025,179317
MEMMUS.txt,46140,46928,788,10,N,Y,1448313800274,179025,179317
MEMMUS.txt,46171,47044,873,10,N,Y,1448313800274,179025,179317
MEMMUS.txt,46301,47146,845,10,N,Y,1448313800274,179025,179317
MEMMUS.txt,46369,47251,882,10,N,Y,1448313800274,179025,179317
MEMMUS.txt,46461,47352,891,10,N,Y,1448313800274,179025,179317
MEMMUS.txt,46496,47382,886,10,N,Y,1448313800274,179025,179317
MEMMUS.txt,46547,47399,852,10,N,Y,1448313800274,179025,179317
MEMMUS.txt,46600,47552,952,10,N,Y,1448313800274,179025,179317
MEMMUS.txt,46705,47620,915,10,N,Y,1448313800274,179025,179317
MEMMUS.txt,46758,47747,989,10,N,Y,1448313800274,179025,179317
MEMMUS.txt,46929,47883,954,10,N,Y,1448323254416,230223,230526
MEMMUS.txt,47045,48036,991,10,N,Y,1448323254416,230223,230526
MEMMUS.txt,47147,48243,1096,10,N,Y,1448323254416,230223,230526
MEMMUS.txt,47254,48396,1142,10,N,Y,1448323254416,230223,230526
MEMMUS.txt,47353,48514,1161,10,Y,Y,1448323254416,230223,230526
MEMMUS.txt,47383,48708,1325,10,Y,Y,1448323254416,230223,230526
MEMMUS.txt,47400,48850,1450,10,Y,Y,1448323254416,230223,230526
MEMMUS.txt,47554,49027,1473,10,Y,Y,1448323254416,230223,230526
MEMMUS.txt,47623,49144,1521,10,Y,N,-,-1,-1
MEMMUS.txt,47748,49285,1537,10,Y,N,-,-1,-1
MEMMUS.txt,47884,49411,1527,10,Y,N,-,-1,-1
MEMMUS.txt,48037,49654,1617,10,Y,N,-,-1,-1
MEMMUS.txt,48244,49994,1750,10,Y,N,-,-1,-1
MEMMUS.txt,48397,50225,1828,10,Y,N,-,-1,-1
MEMMUS.txt,48515,50311,1796,10,Y,N,-,-1,-1
MEMMUS.txt,48711,50517,1806,10,Y,N,-,-1,-1
MEMMUS.txt,48851,50596,1745,10,Y,N,-,-1,-1
MEMMUS.txt,49028,50792,1764,10,Y,N,-,-1,-1
MEMMUS.txt,49147,50900,1753,10,Y,N,-,-1,-1
MEMMUS.txt,49286,50999,1713,10,Y,N,-,-1,-1
MEMMUS.txt,49414,51089,1675,10,Y,N,-,-1,-1
MEMMUS.txt,49655,51438,1783,10,Y,N,-,-1,-1
MEMMUS.txt,49997,51567,1570,10,Y,N,-,-1,-1
MEMMUS.txt,50226,51742,1516,10,Y,N,-,-1,-1
MEMMUS.txt,50314,51963,1649,10,Y,N,-,-1,-1
MEMMUS.txt,50518,52269,1751,10,Y,N,-,-1,-1
MEMMUS.txt,50599,52487,1888,10,Y,N,-,-1,-1
MEMMUS.txt,50794,52565,1771,10,Y,N,-,-1,-1
MEMMUS.txt,50901,53201,2300,10,N,N,-,-1,-1
MEMMUS.txt,51000,53347,2347,10,N,Y,1448275407308,26987,29181
MEMMUS.txt,51090,53440,2350,10,Y,Y,1448275407308,26987,29181
MEMMUS.txt,51439,53557,2118,10,Y,Y,1448275407308,26987,29181
MEMMUS.txt,51568,53689,2121,10,Y,Y,1448275407308,26987,29181
MEMMUS.txt,51743,53758,2015,10,Y,Y,1448275407308,26987,29181
MEMMUS.txt,51966,53872,1906,10,Y,Y,1448275407308,26987,29181
MEMMUS.txt,52270,54067,1797,10,Y,Y,1448275407308,26987,29181
MEMMUS.txt,52489,54121,1632,10,Y,Y,1448275407308,26987,29181
MEMMUS.txt,52570,54181,1611,10,Y,Y,1448275407308,26987,29181
MEMMUS.txt,53204,54488,1284,10,Y,Y,1448275407308,26987,29181
MEMMUS.txt,53349,54642,1293,10,Y,Y,1448275407308,26987,29181
MEMMUS.txt,53443,54686,1243,10,Y,Y,1448275407308,26987,29181
MEMMUS.txt,53558,54821,1263,10,Y,Y,1448275407308,26987,29181
MEMMUS.txt,53692,54904,1212,10,Y,Y,1448275407308,26987,29181
MEMMUS.txt,53759,54973,1214,10,Y,Y,1448275407308,26987,29181
MEMMUS.txt,53873,55295,1422,10,Y,Y,1448275407308,26987,29181
MEMMUS.txt,54068,55531,1463,10,Y,N,-,-1,-1
MEMMUS.txt,54122,55679,1557,10,Y,N,-,-1,-1
MEMMUS.txt,54184,55752,1568,10,N,N,-,-1,-1
MEMMUS.txt,54491,55811,1320,10,N,N,-,-1,-1
MEMMUS.txt,54643,55894,1251,10,N,N,-,-1,-1
MEMMUS.txt,54689,56124,1435,10,N,N,-,-1,-1
MEMMUS.txt,54823,56265,1442,10,N,N,-,-1,-1
MEMMUS.txt,54905,56377,1472,10,N,N,-,-1,-1
MEMMUS.txt,54974,56561,1587,10,N,N,-,-1,-1
MEMMUS.txt,55296,56783,1487,10,N,N,-,-1,-1
MEMMUS.txt,55534,56829,1295,10,Y,N,-,-1,-1
MEMMUS.txt,55680,57155,1475,10,Y,N,-,-1,-1
MEMMUS.txt,55753,57391,1638,10,Y,N,-,-1,-1
MEMMUS.txt,55812,57572,1760,10,Y,N,-,-1,-1
MEMMUS.txt,55897,57708,1811,10,Y,N,-,-1,-1
MEMMUS.txt,56127,58153,2026,10,Y,N,-,-1,-1
MEMMUS.txt,56266,58278,2012,10,Y,N,-,-1,-1
MEMMUS.txt,56378,58445,2067,10,Y,N,-,-1,-1
MEMMUS.txt,56564,58563,1999,10,Y,N,-,-1,-1
MEMMUS.txt,56784,58611,1827,10,Y,N,-,-1,-1
MEMMUS.txt,56830,58683,1853,10,Y,N,-,-1,-1
MEMMUS.txt,57158,58802,1644,10,Y,N,-,-1,-1
MEMMUS.txt,57392,58859,1467,10,Y,N,-,-1,-1
MEMMUS.txt,57575,58950,1375,10,Y,N,-,-1,-1
MEMMUS.txt,57710,59108,1398,10,Y,N,-,-1,-1
MEMMUS.txt,58154,59260,1106,10,N,N,-,-1,-1
MEMMUS.txt,58281,59439,1158,10,N,N,-,-1,-1
MEMMUS.txt,58446,59603,1157,10,N,N,-,-1,-1
MEMMUS.txt,58564,59731,1167,10,N,N,-,-1,-1
MEMMUS.txt,58612,59964,1352,10,Y,N,-,-1,-1
MEMMUS.txt,58686,60024,1338,10,Y,N,-,-1,-1
MEMMUS.txt,58803,60135,1332,10,Y,N,-,-1,-1
MEMMUS.txt,58862,60332,1470,10,Y,N,-,-1,-1
MEMMUS.txt,58951,60519,1568,10,Y,N,-,-1,-1
MEMMUS.txt,59109,60689,1580,10,Y,N,-,-1,-1
MEMMUS.txt,59263,61005,1742,10,Y,N,-,-1,-1
MEMMUS.txt,59440,61138,1698,10,Y,N,-,-1,-1
MEMMUS.txt,59606,61308,1702,10,Y,N,-,-1,-1
MEMMUS.txt,59732,61480,1748,10,Y,N,-,-1,-1
MEMMUS.txt,59966,61715,1749,10,Y,N,-,-1,-1
MEMMUS.txt,60025,61907,1882,10,Y,N,-,-1,-1
MEMMUS.txt,60138,62114,1976,10,Y,N,-,-1,-1
MEMMUS.txt,60333,62295,1962,10,Y,N,-,-1,-1
MEMMUS.txt,60522,62430,1908,10,Y,N,-,-1,-1
MEMMUS.txt,60690,62574,1884,10,Y,N,-,-1,-1
MEMMUS.txt,61006,62616,1610,10,Y,N,-,-1,-1
MEMMUS.txt,61139,62679,1540,10,Y,N,-,-1,-1
MEMMUS.txt,61309,62778,1469,10,Y,N,-,-1,-1
MEMMUS.txt,61483,63031,1548,10,Y,N,-,-1,-1
MEMMUS.txt,61718,63059,1341,10,Y,N,-,-1,-1
MEMMUS.txt,61908,63296,1388,10,Y,N,-,-1,-1
MEMMUS.txt,62115,63316,1201,10,Y,N,-,-1,-1
MEMMUS.txt,62300,63469,1169,10,N,N,-,-1,-1
MEMMUS.txt,62431,63575,1144,10,N,N,-,-1,-1
MEMMUS.txt,62577,63653,1076,10,N,N,-,-1,-1
MEMMUS.txt,62617,63795,1178,10,N,N,-,-1,-1
MEMMUS.txt,62680,63978,1298,10,Y,N,-,-1,-1
MEMMUS.txt,62779,64094,1315,10,Y,N,-,-1,-1
MEMMUS.txt,63032,64147,1115,10,Y,N,-,-1,-1
MEMMUS.txt,63062,64299,1237,10,Y,N,-,-1,-1
MEMMUS.txt,63297,64462,1165,10,Y,N,-,-1,-1
MEMMUS.txt,63317,64541,1224,10,Y,N,-,-1,-1
MEMMUS.txt,63472,64855,1383,10,Y,Y,1448275023016,26258,26837
MEMMUS.txt,63578,64961,1383,10,Y,Y,1448275023016,26258,26837
MEMMUS.txt,63654,65142,1488,10,Y,Y,1448275023016,26258,26837
MEMMUS.txt,63796,65359,1563,10,Y,Y,1448275023016,26258,26837
MEMMUS.txt,63979,65444,1465,10,Y,Y,1448275023016,26258,26837
MEMMUS.txt,64095,65646,1551,10,Y,Y,1448275023016,26258,26837
MEMMUS.txt,64148,65707,1559,10,Y,Y,1448275023016,26258,26837
MEMMUS.txt,64300,65783,1483,10,Y,Y,1448275023016,26258,26837
MEMMUS.txt,64464,65856,1392,10,Y,Y,1448275023016,26258,26837
MEMMUS.txt,64544,66249,1705,10,Y,Y,1448275023016,26258,26837
MEMMUS.txt,64856,66372,1516,10,N,Y,1448275023016,26258,26837
MEMMUS.txt,64962,66447,1485,10,N,Y,1448275023016,26258,26837
MEMMUS.txt,65147,66659,1512,10,N,N,-,-1,-1
MEMMUS.txt,65360,66720,1360,10,N,N,-,-1,-1
MEMMUS.txt,65446,66882,1436,10,N,N,-,-1,-1
MEMMUS.txt,65649,67038,1389,10,N,N,-,-1,-1
MEMMUS.txt,65708,67212,1504,10,N,N,-,-1,-1
MEMMUS.txt,65785,67281,1496,10,N,N,-,-1,-1
MEMMUS.txt,65857,67429,1572,10,N,Y,1448311811907,157566,161100
MEMMUS.txt,66250,67645,1395,10,N,Y,1448311811907,157566,161100
MEMMUS.txt,66373,67692,1319,10,N,Y,1448311811907,157566,161100
MEMMUS.txt,66449,67758,1309,10,Y,Y,1448278425221,65586,65914
MEMMUS.txt,66660,67983,1323,10,N,Y,1448278425221,65586,65914
MEMMUS.txt,66723,68060,1337,10,N,Y,1448278425221,65586,65914
MEMMUS.txt,66883,68153,1270,10,N,Y,1448278425221,65586,65914
MEMMUS.txt,67039,68314,1275,10,Y,Y,1448278425221,65586,65914
MEMMUS.txt,67213,69008,1795,10,Y,Y,1448278425221,65586,65914
MEMMUS.txt,67284,69123,1839,10,Y,Y,1448278425221,65586,65914
MEMMUS.txt,67430,69223,1793,10,Y,Y,1448278425221,65586,65914
MEMMUS.txt,67647,69502,1855,10,Y,Y,1448278425221,65586,65914
MEMMUS.txt,67694,69673,1979,10,Y,Y,1448278425221,65586,65914
MEMMUS.txt,67759,69771,2012,10,N,Y,1448278425221,65586,65914
MEMMUS.txt,67984,69901,1917,10,N,Y,1448278425221,65586,65914
MEMMUS.txt,68065,70080,2015,10,N,Y,1448278425221,65586,65914
MEMMUS.txt,68155,70236,2081,10,N,Y,1448278425221,65586,65914
MEMMUS.txt,68317,70328,2011,10,N,Y,1448322095209,213778,214023
MEMMUS.txt,69011,70497,1486,10,N,Y,1448322095209,213778,214023
MEMMUS.txt,69124,70577,1453,10,N,Y,1448322095209,213778,214023
MEMMUS.txt,69224,70662,1438,10,N,Y,1448322095209,213778,214023
MEMMUS.txt,69507,70813,1306,10,N,Y,1448322095209,213778,214023
MEMMUS.txt,69674,71040,1366,10,N,Y,1448322095209,213778,214023
MEMMUS.txt,69774,71176,1402,10,N,Y,1448322095209,213778,214023
MEMMUS.txt,69902,71447,1545,10,N,Y,1448322095209,213778,214023
MEMMUS.txt,70083,71585,1502,10,N,Y,1448322095209,213778,214023
MEMMUS.txt,70237,71643,1406,10,N,Y,1448322095209,213778,214023
MEMMUS.txt,70329,71746,1417,10,N,Y,1448322095209,213778,214023
MEMMUS.txt,70498,71930,1432,10,N,Y,1448322095209,213778,214023
MEMMUS.txt,70580,72026,1446,10,N,N,-,-1,-1
MEMMUS.txt,70663,72179,1516,10,N,N,-,-1,-1
MEMMUS.txt,70816,72347,1531,10,N,N,-,-1,-1
MEMMUS.txt,71041,72540,1499,10,N,N,-,-1,-1
MEMMUS.txt,71177,72685,1508,10,Y,Y,1448314192885,179720,179950
MEMMUS.txt,71450,72801,1351,10,N,Y,1448314192885,179720,179950
MEMMUS.txt,71586,72843,1257,10,N,Y,1448314192885,179720,179950
MEMMUS.txt,71644,72978,1334,10,N,Y,1448314192885,179720,179950
MEMMUS.txt,71747,73115,1368,10,N,Y,1448314192885,179720,179950
MEMMUS.txt,71931,73266,1335,10,N,Y,1448314192885,179720,179950
MEMMUS.txt,72027,73317,1290,10,N,Y,1448314192885,179720,179950
MEMMUS.txt,72180,73404,1224,10,N,Y,1448314192885,179720,179950
MEMMUS.txt,72348,73425,1077,10,N,Y,1448314192885,179720,179950
MEMMUS.txt,72543,73474,931,10,N,Y,1448314192885,179720,179950
MEMMUS.txt,72686,73565,879,10,N,Y,1448314192885,179720,179950
MEMMUS.txt,72804,73607,803,10,N,Y,1448314192885,179720,179950
MEMMUS.txt,72844,73645,801,10,N,Y,1448314192885,179720,179950
MEMMUS.txt,72979,73704,725,10,N,Y,1448314192885,179720,179950
MEMMUS.txt,73118,73885,767,10,N,N,-,-1,-1
MEMMUS.txt,73267,74040,773,10,N,N,-,-1,-1
MEMMUS.txt,73318,74201,883,10,N,N,-,-1,-1
MEMMUS.txt,73405,74337,932,10,N,N,-,-1,-1
MEMMUS.txt,73427,74385,958,10,N,N,-,-1,-1
MEMMUS.txt,73476,74657,1181,10,N,N,-,-1,-1
MEMMUS.txt,73566,74879,1313,10,N,N,-,-1,-1
MEMMUS.txt,73608,74986,1378,10,N,N,-,-1,-1
MEMMUS.txt,73646,75301,1655,10,N,N,-,-1,-1
MEMMUS.txt,73705,75434,1729,10,N,N,-,-1,-1
MEMMUS.txt,73888,75511,1623,10,N,N,-,-1,-1
MEMMUS.txt,74043,75652,1609,10,N,N,-,-1,-1
MEMMUS.txt,74202,75851,1649,10,N,N,-,-1,-1
MEMMUS.txt,74338,75953,1615,10,N,N,-,-1,-1
MEMMUS.txt,74388,76006,1618,10,N,N,-,-1,-1
MEMMUS.txt,74659,76209,1550,10,N,N,-,-1,-1
MEMMUS.txt,74880,76297,1417,10,N,N,-,-1,-1
MEMMUS.txt,74989,76623,1634,10,N,Y,1448395538701,294934,295016
MEMMUS.txt,75302,76748,1446,10,N,Y,1448395538701,294934,295016
MEMMUS.txt,75437,76809,1372,10,N,Y,1448395538701,294934,295016
MEMMUS.txt,75512,76897,1385,10,N,Y,1448395538701,294934,295016
MEMMUS.txt,75653,76999,1346,10,N,Y,1448395538701,294934,295016
MEMMUS.txt,75852,77124,1272,10,N,Y,1448395538701,294934,295016
MEMMUS.txt,75956,77343,1387,10,N,Y,1448395538701,294934,295016
MEMMUS.txt,76007,77547,1540,10,N,Y,1448395538701,294934,295016
MEMMUS.txt,76210,77710,1500,10,N,Y,1448395538701,294934,295016
MEMMUS.txt,76300,77917,1617,10,N,Y,1448395538701,294934,295016
MEMMUS.txt,76624,78103,1479,10,N,Y,1448395538701,294934,295016
MEMMUS.txt,76749,78257,1508,10,N,Y,1448395538701,294934,295016
MEMMUS.txt,76810,78388,1578,10,N,Y,1448395538701,294934,295016
MEMMUS.txt,76900,78573,1673,10,N,N,-,-1,-1
MEMMUS.txt,77000,78710,1710,10,N,N,-,-1,-1
MEMMUS.txt,77125,78751,1626,10,N,N,-,-1,-1
MEMMUS.txt,77344,78825,1481,10,N,N,-,-1,-1
MEMMUS.txt,77548,78850,1302,10,N,N,-,-1,-1
MEMMUS.txt,77713,78884,1171,10,N,N,-,-1,-1
MEMMUS.txt,77918,79044,1126,10,N,N,-,-1,-1
MEMMUS.txt,78104,79127,1023,10,N,N,-,-1,-1
MEMMUS.txt,78260,79280,1020,10,N,N,-,-1,-1
MEMMUS.txt,78391,79332,941,10,N,N,-,-1,-1
MEMMUS.txt,78574,79439,865,10,N,N,-,-1,-1
MEMMUS.txt,78711,79493,782,10,N,N,-,-1,-1
MEMMUS.txt,78752,79603,851,10,N,N,-,-1,-1
MEMMUS.txt,78826,79822,996,10,N,N,-,-1,-1
MEMMUS.txt,78851,79913,1062,10,N,N,-,-1,-1
MEMMUS.txt,78885,80227,1342,10,N,N,-,-1,-1
MEMMUS.txt,79045,80289,1244,10,N,N,-,-1,-1
MEMMUS.txt,79128,80521,1393,10,N,N,-,-1,-1
MEMMUS.txt,79281,80674,1393,10,N,N,-,-1,-1
MEMMUS.txt,79334,80831,1497,10,N,N,-,-1,-1
MEMMUS.txt,79440,80898,1458,10,N,N,-,-1,-1
MEMMUS.txt,79494,81158,1664,10,N,N,-,-1,-1
MEMMUS.txt,79606,81402,1796,10,N,N,-,-1,-1
MEMMUS.txt,79823,81905,2082,10,Y,N,-,-1,-1
MEMMUS.txt,79916,82055,2139,10,Y,Y,1448322273366,219239,219544
MEMMUS.txt,80228,82123,1895,10,Y,Y,1448322273366,219239,219544
MEMMUS.txt,80290,82286,1996,10,Y,Y,1448322273366,219239,219544
MEMMUS.txt,80522,82322,1800,10,Y,Y,1448322273366,219239,219544
MEMMUS.txt,80677,82432,1755,10,Y,Y,1448322273366,219239,219544
MEMMUS.txt,80832,82497,1665,10,Y,Y,1448322273366,219239,219544
MEMMUS.txt,80899,82706,1807,10,Y,Y,1448322273366,219239,219544
MEMMUS.txt,81161,82827,1666,10,Y,Y,1448322273366,219239,219544
MEMMUS.txt,81407,82959,1552,10,Y,Y,1448322273366,219239,219544
MEMMUS.txt,81908,83114,1206,10,Y,Y,1448322273366,219239,219544
MEMMUS.txt,82056,83221,1165,10,Y,Y,1448322273366,219239,219544
MEMMUS.txt,82126,83299,1173,10,Y,Y,1448322273366,219239,219544
MEMMUS.txt,82287,83306,1019,10,Y,Y,1448322273366,219239,219544
MEMMUS.txt,82323,83394,1071,10,Y,Y,1448322273366,219239,219544
MEMMUS.txt,82433,83607,1174,10,Y,Y,1448322273366,219239,219544
MEMMUS.txt,82500,83688,1188,10,Y,N,-,-1,-1
MEMMUS.txt,82707,83729,1022,10,Y,N,-,-1,-1
MEMMUS.txt,82828,83891,1063,10,N,Y,1448325046337,230539,231128
MEMMUS.txt,82960,84103,1143,10,N,Y,1448325046337,230539,231128
MEMMUS.txt,83115,84148,1033,10,N,Y,1448325046337,230539,231128
MEMMUS.txt,83222,84252,1030,10,Y,Y,1448325046337,230539,231128
MEMMUS.txt,83300,84285,985,10,Y,Y,1448325046337,230539,231128
MEMMUS.txt,83307,84352,1045,10,Y,Y,1448325046337,230539,231128
MEMMUS.txt,83395,84507,1112,10,Y,Y,1448325046337,230539,231128
MEMMUS.txt,83608,84896,1288,10,N,Y,1448325046337,230539,231128
MEMMUS.txt,83689,85053,1364,10,Y,Y,1448325046337,230539,231128
MEMMUS.txt,83732,85219,1487,10,Y,Y,1448325046337,230539,231128
MEMMUS.txt,83892,85302,1410,10,Y,Y,1448325046337,230539,231128
MEMMUS.txt,84104,85368,1264,10,Y,Y,1448325046337,230539,231128
MEMMUS.txt,84149,85732,1583,10,Y,Y,1448325046337,230539,231128
MEMMUS.txt,84253,85796,1543,10,N,Y,1448325046337,230539,231128
MEMMUS.txt,84286,86139,1853,10,N,Y,1448325046337,230539,231128
MEMMUS.txt,84355,86359,2004,10,N,Y,1448393918391,289044,290517
MEMMUS.txt,84508,86582,2074,10,N,Y,1448393918391,289044,290517
MEMMUS.txt,84898,86736,1838,10,N,Y,1448316411409,206556,208475
MEMMUS.txt,85056,87176,2120,10,Y,Y,1448316411409,206556,208475
MEMMUS.txt,85220,87331,2111,10,Y,Y,1448316411409,206556,208475
MEMMUS.txt,85305,87437,2132,10,Y,Y,1448316411409,206556,208475
MEMMUS.txt,85369,87493,2124,10,Y,Y,1448316411409,206556,208475
MEMMUS.txt,85733,87630,1897,10,Y,Y,1448316411409,206556,208475
MEMMUS.txt,85799,87773,1974,10,Y,Y,1448316411409,206556,208475
MEMMUS.txt,86140,88040,1900,10,Y,Y,1448316411409,206556,208475
MEMMUS.txt,86362,88244,1882,10,Y,Y,1448316411409,206556,208475
MEMMUS.txt,86585,88485,1900,10,Y,Y,1448316411409,206556,208475
MEMMUS.txt,86737,88545,1808,10,Y,Y,1448316411409,206556,208475
MEMMUS.txt,87177,88781,1604,10,Y,Y,1448316411409,206556,208475
MEMMUS.txt,87332,88845,1513,10,Y,Y,1448316411409,206556,208475
MEMMUS.txt,87438,88921,1483,10,Y,N,-,-1,-1
MEMMUS.txt,87496,89087,1591,10,Y,N,-,-1,-1
MEMMUS.txt,87631,89114,1483,10,Y,N,-,-1,-1
MEMMUS.txt,87776,89294,1518,10,Y,N,-,-1,-1
MEMMUS.txt,88041,89422,1381,10,Y,N,-,-1,-1
MEMMUS.txt,88246,89672,1426,10,Y,N,-,-1,-1
MEMMUS.txt,88488,89698,1210,10,Y,N,-,-1,-1
MEMMUS.txt,88546,89721,1175,10,Y,N,-,-1,-1
MEMMUS.txt,88783,89733,950,10,Y,N,-,-1,-1
MEMMUS.txt,88848,89778,930,10,Y,N,-,-1,-1
MEMMUS.txt,88924,89900,976,10,Y,N,-,-1,-1
MEMMUS.txt,89088,89992,904,10,Y,N,-,-1,-1
MEMMUS.txt,89117,90052,935,10,Y,N,-,-1,-1
MEMMUS.txt,89295,90103,808,10,N,N,-,-1,-1
MEMMUS.txt,89423,90124,701,10,N,N,-,-1,-1
MEMMUS.txt,89677,90125,448,10,N,N,-,-1,-1
MEMMUS.txt,89701,90160,459,10,N,N,-,-1,-1
MEMMUS.txt,89726,90192,466,10,N,N,-,-1,-1
MEMMUS.txt,89738,90210,472,10,N,N,-,-1,-1
MEMMUS.txt,89778,90215,437,10,N,N,-,-1,-1
MEMMUS.txt,89900,90249,349,10,N,N,-,-1,-1
MEMMUS.txt,89997,90300,303,10,N,N,-,-1,-1
MEMMUS.txt,90053,90319,266,10,N,N,-,-1,-1
MEMMUS.txt,90104,90358,254,10,N,N,-,-1,-1
MEMMUS.txt,90124,90382,258,10,N,N,-,-1,-1
MEMMUS.txt,90126,90479,353,10,N,N,-,-1,-1
MEMMUS.txt,90162,90528,366,10,N,N,-,-1,-1
MEMMUS.txt,90193,90847,654,10,N,N,-,-1,-1
MEMMUS.txt,90211,90980,769,10,N,N,-,-1,-1
MEMMUS.txt,90216,91062,846,10,N,N,-,-1,-1
MEMMUS.txt,90250,91140,890,10,N,N,-,-1,-1
MEMMUS.txt,90301,91202,901,10,N,N,-,-1,-1
MEMMUS.txt,90324,91257,933,10,N,N,-,-1,-1
MEMMUS.txt,90360,91382,1022,10,N,N,-,-1,-1
MEMMUS.txt,90385,91484,1099,10,N,N,-,-1,-1
MEMMUS.txt,90481,91539,1058,10,N,N,-,-1,-1
MEMMUS.txt,90530,91703,1173,10,N,N,-,-1,-1
MEMMUS.txt,90848,91846,998,10,N,N,-,-1,-1
MEMMUS.txt,90982,91920,938,10,N,N,-,-1,-1
MEMMUS.txt,91063,91952,889,10,N,N,-,-1,-1
MEMMUS.txt,91141,92036,895,10,N,N,-,-1,-1
MEMMUS.txt,91203,92098,895,10,N,N,-,-1,-1
MEMMUS.txt,91260,92227,967,10,N,N,-,-1,-1
MEMMUS.txt,91383,92297,914,10,N,N,-,-1,-1
MEMMUS.txt,91485,92449,964,10,N,N,-,-1,-1
MEMMUS.txt,91542,92785,1243,10,N,N,-,-1,-1
MEMMUS.txt,91706,92839,1133,10,N,N,-,-1,-1
MEMMUS.txt,91847,92924,1077,10,N,N,-,-1,-1
MEMMUS.txt,91922,93036,1114,10,N,N,-,-1,-1
MEMMUS.txt,91953,93187,1234,10,N,N,-,-1,-1
MEMMUS.txt,92037,93293,1256,10,N,N,-,-1,-1
MEMMUS.txt,92100,93331,1231,10,N,N,-,-1,-1
MEMMUS.txt,92229,93497,1268,10,N,N,-,-1,-1
MEMMUS.txt,92300,93599,1299,10,Y,N,-,-1,-1
MEMMUS.txt,92450,93872,1422,10,Y,N,-,-1,-1
MEMMUS.txt,92786,94001,1215,10,Y,N,-,-1,-1
MEMMUS.txt,92840,94079,1239,10,Y,N,-,-1,-1
MEMMUS.txt,92925,94171,1246,10,Y,N,-,-1,-1
MEMMUS.txt,93038,94438,1400,10,Y,N,-,-1,-1
MEMMUS.txt,93188,94693,1505,10,Y,N,-,-1,-1
MEMMUS.txt,93296,94944,1648,10,Y,Y,1437471855423,351318,351853
MEMMUS.txt,93332,95112,1780,10,Y,Y,1437471855423,351318,351853
MEMMUS.txt,93498,95395,1897,10,Y,Y,1437471855423,351318,351853
MEMMUS.txt,93600,95830,2230,10,Y,Y,1437471855423,351318,351853
MEMMUS.txt,93875,95939,2064,10,Y,Y,1437471855423,351318,351853
MEMMUS.txt,94002,96043,2041,10,Y,Y,1437471855423,351318,351853
MEMMUS.txt,94080,96130,2050,10,Y,Y,1437471855423,351318,351853
MEMMUS.txt,94172,96269,2097,10,Y,Y,1437471855423,351318,351853
MEMMUS.txt,94439,96330,1891,10,Y,Y,1437471855423,351318,351853
MEMMUS.txt,94696,96533,1837,10,Y,Y,1437471855423,351318,351853
MEMMUS.txt,94945,96631,1686,10,Y,Y,1437471855423,351318,351853
MEMMUS.txt,95113,96689,1576,10,Y,Y,1437471855423,351318,351853
MEMMUS.txt,95397,96810,1413,10,Y,Y,1437471855423,351318,351853
MEMMUS.txt,95832,97008,1176,10,N,Y,1437471855423,351318,351853
MEMMUS.txt,95940,97076,1136,10,N,Y,1437471855423,351318,351853
MEMMUS.txt,96044,97137,1093,10,N,Y,1437471855423,351318,351853
MEMMUS.txt,96131,97384,1253,10,N,Y,1437471855423,351318,351853
MEMMUS.txt,96271,97461,1190,10,N,Y,1437471855423,351318,351853
MEMMUS.txt,96333,97686,1353,10,N,Y,1437471855423,351318,351853
MEMMUS.txt,96534,97799,1265,10,N,Y,1437471855423,351318,351853
MEMMUS.txt,96632,97892,1260,10,Y,Y,1448316079788,183824,184995
MEMMUS.txt,96691,98222,1531,10,Y,Y,1448316079788,183824,184995
MEMMUS.txt,96811,98387,1576,10,Y,Y,1448316079788,183824,184995
MEMMUS.txt,97009,98562,1553,10,Y,Y,1448316079788,183824,184995
MEMMUS.txt,97077,98848,1771,10,Y,Y,1448316079788,183824,184995
MEMMUS.txt,97140,98982,1842,10,Y,Y,1448316079788,183824,184995
MEMMUS.txt,97386,99120,1734,10,N,Y,1448316079788,183824,184995
MEMMUS.txt,97462,99238,1776,10,N,N,-,-1,-1
MEMMUS.txt,97687,99540,1853,10,N,N,-,-1,-1
MEMMUS.txt,97800,99592,1792,10,N,N,-,-1,-1
MEMMUS.txt,97895,99642,1747,10,Y,N,-,-1,-1
MEMMUS.txt,98225,99866,1641,10,Y,N,-,-1,-1
MEMMUS.txt,98388,100007,1619,10,Y,N,-,-1,-1
MEMMUS.txt,98563,100186,1623,10,Y,N,-,-1,-1
MEMMUS.txt,98849,100288,1439,10,Y,N,-,-1,-1
MEMMUS.txt,98983,100447,1464,10,Y,N,-,-1,-1
MEMMUS.txt,99123,100611,1488,10,Y,N,-,-1,-1
MEMMUS.txt,99239,100726,1487,10,Y,N,-,-1,-1
MEMMUS.txt,99541,100834,1293,10,Y,N,-,-1,-1
MEMMUS.txt,99593,100974,1381,10,Y,N,-,-1,-1
MEMMUS.txt,99643,101208,1565,10,Y,N,-,-1,-1
MEMMUS.txt,99867,101487,1620,10,Y,N,-,-1,-1
MEMMUS.txt,100009,101565,1556,10,Y,N,-,-1,-1
MEMMUS.txt,100187,101636,1449,10,Y,N,-,-1,-1
MEMMUS.txt,100291,101766,1475,10,Y,N,-,-1,-1
MEMMUS.txt,100448,101816,1368,10,Y,N,-,-1,-1
MEMMUS.txt,100614,102194,1580,10,N,N,-,-1,-1
MEMMUS.txt,100727,102207,1480,10,N,N,-,-1,-1
MEMMUS.txt,100835,102398,1563,10,N,N,-,-1,-1
MEMMUS.txt,100977,102610,1633,10,N,N,-,-1,-1
MEMMUS.txt,101209,102871,1662,10,N,N,-,-1,-1
MEMMUS.txt,101490,103028,1538,10,N,N,-,-1,-1
MEMMUS.txt,101570,103137,1567,10,N,N,-,-1,-1
MEMMUS.txt,101638,103353,1715,10,N,N,-,-1,-1
MEMMUS.txt,101767,103472,1705,10,N,N,-,-1,-1
MEMMUS.txt,101819,103559,1740,10,N,N,-,-1,-1
MEMMUS.txt,102196,103618,1422,10,N,N,-,-1,-1
MEMMUS.txt,102208,103880,1672,10,N,N,-,-1,-1
MEMMUS.txt,102401,104042,1641,10,N,N,-,-1,-1
MEMMUS.txt,102613,104110,1497,10,N,N,-,-1,-1
MEMMUS.txt,102872,104209,1337,10,N,N,-,-1,-1
MEMMUS.txt,103029,104392,1363,10,N,N,-,-1,-1
MEMMUS.txt,103140,104533,1393,10,N,N,-,-1,-1
MEMMUS.txt,103354,104759,1405,10,Y,N,-,-1,-1
MEMMUS.txt,103473,104825,1352,10,Y,N,-,-1,-1
MEMMUS.txt,103560,104892,1332,10,Y,N,-,-1,-1
MEMMUS.txt,103621,105034,1413,10,Y,N,-,-1,-1
MEMMUS.txt,103881,105279,1398,10,Y,N,-,-1,-1
MEMMUS.txt,104043,105354,1311,10,N,N,-,-1,-1
MEMMUS.txt,104111,105527,1416,10,Y,N,-,-1,-1
MEMMUS.txt,104211,105754,1543,10,Y,N,-,-1,-1
MEMMUS.txt,104393,105810,1417,10,Y,N,-,-1,-1
MEMMUS.txt,104536,106046,1510,10,Y,N,-,-1,-1
MEMMUS.txt,104760,106158,1398,10,Y,N,-,-1,-1
MEMMUS.txt,104826,106347,1521,10,Y,N,-,-1,-1
MEMMUS.txt,104893,106492,1599,10,Y,N,-,-1,-1
MEMMUS.txt,105035,106864,1829,10,Y,N,-,-1,-1
MEMMUS.txt,105282,107011,1729,10,Y,N,-,-1,-1
MEMMUS.txt,105355,107071,1716,10,Y,N,-,-1,-1
MEMMUS.txt,105528,107251,1723,10,Y,N,-,-1,-1
MEMMUS.txt,105756,107391,1635,10,Y,N,-,-1,-1
MEMMUS.txt,105811,107608,1797,10,Y,N,-,-1,-1
MEMMUS.txt,106047,107947,1900,10,Y,N,-,-1,-1
MEMMUS.txt,106161,108042,1881,10,N,N,-,-1,-1
MEMMUS.txt,106349,108154,1805,10,Y,N,-,-1,-1
MEMMUS.txt,106494,108357,1863,10,N,N,-,-1,-1
MEMMUS.txt,106865,108609,1744,10,Y,N,-,-1,-1
MEMMUS.txt,107012,108730,1718,10,Y,N,-,-1,-1
MEMMUS.txt,107072,109032,1960,10,Y,N,-,-1,-1
MEMMUS.txt,107254,109175,1921,10,Y,N,-,-1,-1
MEMMUS.txt,107396,109350,1954,10,Y,N,-,-1,-1
MEMMUS.txt,107611,109542,1931,10,Y,Y,1448039370049,20775,21297
MEMMUS.txt,107950,109727,1777,10,N,Y,1448039370049,20775,21297
MEMMUS.txt,108044,109840,1796,10,N,Y,1448039370049,20775,21297
MEMMUS.txt,108155,110018,1863,10,N,Y,1448039370049,20775,21297
MEMMUS.txt,108358,110080,1722,10,N,Y,1448039370049,20775,21297
MEMMUS.txt,108612,110186,1574,10,N,Y,1448039370049,20775,21297
MEMMUS.txt,108731,110233,1502,10,N,Y,1448039370049,20775,21297
MEMMUS.txt,109033,110237,1204,10,N,Y,1448039370049,20775,21297
MEMMUS.txt,109176,110263,1087,10,N,Y,1448039370049,20775,21297
MEMMUS.txt,109351,110421,1070,10,N,Y,1448039370049,20775,21297
MEMMUS.txt,109543,110505,962,10,N,Y,1448039370049,20775,21297
MEMMUS.txt,109730,110576,846,10,N,Y,1448039370049,20775,21297
MEMMUS.txt,109841,110750,909,10,N,Y,1448039370049,20775,21297
MEMMUS.txt,110020,110876,856,10,N,Y,1448039370049,20775,21297
MEMMUS.txt,110081,111184,1103,10,Y,Y,1448039370049,20775,21297
MEMMUS.txt,110187,111276,1089,10,Y,Y,1448039370049,20775,21297
MEMMUS.txt,110234,111353,1119,10,Y,Y,1448039370049,20775,21297
MEMMUS.txt,110238,111463,1225,10,Y,Y,1448039370049,20775,21297
MEMMUS.txt,110264,111505,1241,10,Y,Y,1448039370049,20775,21297
MEMMUS.txt,110424,111696,1272,10,Y,N,-,-1,-1
MEMMUS.txt,110508,111753,1245,10,N,N,-,-1,-1
MEMMUS.txt,110577,111971,1394,10,N,N,-,-1,-1
MEMMUS.txt,110751,112180,1429,10,N,N,-,-1,-1
MEMMUS.txt,110879,112307,1428,10,N,N,-,-1,-1
MEMMUS.txt,111185,112471,1286,10,N,N,-,-1,-1
MEMMUS.txt,111277,112627,1350,10,N,N,-,-1,-1
MEMMUS.txt,111354,112730,1376,10,N,N,-,-1,-1
MEMMUS.txt,111464,112858,1394,10,N,N,-,-1,-1
MEMMUS.txt,111506,112961,1455,10,N,N,-,-1,-1
MEMMUS.txt,111697,113097,1400,10,N,N,-,-1,-1
MEMMUS.txt,111758,113199,1441,10,N,N,-,-1,-1
MEMMUS.txt,111973,113277,1304,10,N,N,-,-1,-1
MEMMUS.txt,112183,113322,1139,10,N,N,-,-1,-1
MEMMUS.txt,112308,113385,1077,10,N,N,-,-1,-1
MEMMUS.txt,112472,113433,961,10,N,N,-,-1,-1
MEMMUS.txt,112629,113629,1000,10,N,N,-,-1,-1
MEMMUS.txt,112733,113721,988,10,N,N,-,-1,-1
MEMMUS.txt,112859,113803,944,10,N,N,-,-1,-1
MEMMUS.txt,112964,113835,871,10,N,N,-,-1,-1
MEMMUS.txt,113103,113902,799,10,N,N,-,-1,-1
MEMMUS.txt,113201,114109,908,10,N,N,-,-1,-1
MEMMUS.txt,113278,114295,1017,10,N,N,-,-1,-1
MEMMUS.txt,113327,114444,1117,10,Y,N,-,-1,-1
MEMMUS.txt,113387,114555,1168,10,Y,N,-,-1,-1
MEMMUS.txt,113436,114653,1217,10,Y,N,-,-1,-1
MEMMUS.txt,113630,114772,1142,10,N,N,-,-1,-1
MEMMUS.txt,113722,114867,1145,10,N,N,-,-1,-1
MEMMUS.txt,113805,115085,1280,10,N,N,-,-1,-1
MEMMUS.txt,113838,115260,1422,10,N,N,-,-1,-1
MEMMUS.txt,113903,115483,1580,10,N,N,-,-1,-1
MEMMUS.txt,114112,115548,1436,10,N,N,-,-1,-1
MEMMUS.txt,114296,116685,2389,10,N,N,-,-1,-1
MEMMUS.txt,114446,116912,2466,10,N,Y,1448315360596,182069,182233
MEMMUS.txt,114556,117063,2507,10,N,Y,1448315360596,182069,182233
MEMMUS.txt,114654,117084,2430,10,N,Y,1448315360596,182069,182233
MEMMUS.txt,114777,117177,2400,10,N,Y,1448315360596,182069,182233
MEMMUS.txt,114868,117263,2395,10,N,Y,1448315360596,182069,182233
MEMMUS.txt,115086,117381,2295,10,N,Y,1448315360596,182069,182233
MEMMUS.txt,115261,117629,2368,10,Y,Y,1448315360596,182069,182233
MEMMUS.txt,115484,117673,2189,10,Y,Y,1448315360596,182069,182233
MEMMUS.txt,115553,117931,2378,10,Y,Y,1448313994373,179347,179715
MEMMUS.txt,116688,118090,1402,10,Y,Y,1448313994373,179347,179715
MEMMUS.txt,116915,118214,1299,10,Y,Y,1448313994373,179347,179715
MEMMUS.txt,117064,118328,1264,10,Y,Y,1448313994373,179347,179715
MEMMUS.txt,117085,118445,1360,10,Y,Y,1448313994373,179347,179715
MEMMUS.txt,117180,118588,1408,10,Y,Y,1448313994373,179347,179715
MEMMUS.txt,117264,118809,1545,10,Y,Y,1448313994373,179347,179715
MEMMUS.txt,117382,118888,1506,10,Y,Y,1448313994373,179347,179715
MEMMUS.txt,117630,119133,1503,10,Y,Y,1448313994373,179347,179715
MEMMUS.txt,117676,119254,1578,10,Y,Y,1448313994373,179347,179715
MEMMUS.txt,117934,119393,1459,10,Y,Y,1448313994373,179347,179715
MEMMUS.txt,118091,119527,1436,10,Y,Y,1448313994373,179347,179715
MEMMUS.txt,118216,119752,1536,10,Y,Y,1448313994373,179347,179715
MEMMUS.txt,118329,119920,1591,10,Y,Y,1448280884746,88496,89294
MEMMUS.txt,118450,120186,1736,10,Y,Y,1448280884746,88496,89294
MEMMUS.txt,118589,120320,1731,10,Y,Y,1448280884746,88496,89294
MEMMUS.txt,118815,120355,1540,10,N,Y,1448280884746,88496,89294
MEMMUS.txt,118889,120475,1586,10,N,Y,1448280884746,88496,89294
MEMMUS.txt,119134,120533,1399,10,N,Y,1448280884746,88496,89294
MEMMUS.txt,119256,120595,1339,10,N,Y,1448280884746,88496,89294
MEMMUS.txt,119394,120898,1504,10,Y,Y,1448280884746,88496,89294
MEMMUS.txt,119528,120967,1439,10,Y,Y,1448280884746,88496,89294
MEMMUS.txt,119755,121077,1322,10,Y,Y,1448280884746,88496,89294
MEMMUS.txt,119921,121240,1319,10,Y,Y,1448280884746,88496,89294
MEMMUS.txt,120187,121449,1262,10,Y,Y,1448280884746,88496,89294
MEMMUS.txt,120322,121541,1219,10,Y,Y,1448280884746,88496,89294
MEMMUS.txt,120358,121786,1428,10,Y,Y,1448360140810,268069,269800
MEMMUS.txt,120478,121916,1438,10,Y,Y,1448360140810,268069,269800
MEMMUS.txt,120534,122027,1493,10,Y,Y,1448360140810,268069,269800
MEMMUS.txt,120596,122291,1695,10,Y,Y,1448360140810,268069,269800
MEMMUS.txt,120899,122541,1642,10,Y,Y,1448360140810,268069,269800
MEMMUS.txt,120972,122779,1807,10,Y,Y,1448360140810,268069,269800
MEMMUS.txt,121078,122897,1819,10,Y,Y,1448360140810,268069,269800
MEMMUS.txt,121241,123025,1784,10,Y,Y,1448360140810,268069,269800
MEMMUS.txt,121450,123134,1684,10,Y,Y,1448360140810,268069,269800
MEMMUS.txt,121542,123283,1741,10,Y,Y,1448360140810,268069,269800
MEMMUS.txt,121787,123454,1667,10,Y,Y,1448360140810,268069,269800
MEMMUS.txt,121918,123532,1614,10,Y,Y,1448360140810,268069,269800
MEMMUS.txt,122030,123788,1758,10,Y,Y,1448360140810,268069,269800
MEMMUS.txt,122292,123872,1580,10,Y,N,-,-1,-1
MEMMUS.txt,122542,124002,1460,10,Y,N,-,-1,-1
MEMMUS.txt,122780,124154,1374,10,Y,N,-,-1,-1
MEMMUS.txt,122900,124267,1367,10,Y,N,-,-1,-1
MEMMUS.txt,123027,124320,1293,10,Y,N,-,-1,-1
MEMMUS.txt,123135,124506,1371,10,Y,N,-,-1,-1
MEMMUS.txt,123284,124662,1378,10,Y,N,-,-1,-1
MEMMUS.txt,123457,124709,1252,10,Y,N,-,-1,-1
MEMMUS.txt,123533,124873,1340,10,Y,N,-,-1,-1
MEMMUS.txt,123789,125065,1276,10,N,N,-,-1,-1
MEMMUS.txt,123877,125132,1255,10,Y,N,-,-1,-1
MEMMUS.txt,124003,125277,1274,10,Y,N,-,-1,-1
MEMMUS.txt,124157,125408,1251,10,Y,N,-,-1,-1
MEMMUS.txt,124268,125531,1263,10,Y,N,-,-1,-1
MEMMUS.txt,124321,125603,1282,10,Y,N,-,-1,-1
MEMMUS.txt,124507,125674,1167,10,Y,N,-,-1,-1
MEMMUS.txt,124663,125911,1248,10,Y,N,-,-1,-1
MEMMUS.txt,124710,126062,1352,10,Y,N,-,-1,-1
MEMMUS.txt,124876,126103,1227,10,Y,N,-,-1,-1
MEMMUS.txt,125066,126170,1104,10,Y,N,-,-1,-1
MEMMUS.txt,125133,126258,1125,10,N,N,-,-1,-1
MEMMUS.txt,125278,126466,1188,10,N,N,-,-1,-1
MEMMUS.txt,125411,126697,1286,10,N,N,-,-1,-1
MEMMUS.txt,125532,126743,1211,10,N,N,-,-1,-1
MEMMUS.txt,125604,126918,1314,10,N,N,-,-1,-1
MEMMUS.txt,125675,126967,1292,10,N,N,-,-1,-1
MEMMUS.txt,125912,127119,1207,10,N,N,-,-1,-1
MEMMUS.txt,126063,127174,1111,10,N,N,-,-1,-1
MEMMUS.txt,126106,127371,1265,10,N,N,-,-1,-1
MEMMUS.txt,126173,127446,1273,10,N,N,-,-1,-1
MEMMUS.txt,126259,127513,1254,10,N,N,-,-1,-1
MEMMUS.txt,126467,127677,1210,10,Y,N,-,-1,-1
MEMMUS.txt,126698,127770,1072,10,Y,N,-,-1,-1
MEMMUS.txt,126749,127860,1111,10,Y,N,-,-1,-1
MEMMUS.txt,126919,127934,1015,10,Y,N,-,-1,-1
MEMMUS.txt,126970,128097,1127,10,Y,N,-,-1,-1
MEMMUS.txt,127120,128306,1186,10,Y,N,-,-1,-1
MEMMUS.txt,127175,128465,1290,10,Y,N,-,-1,-1
MEMMUS.txt,127372,128739,1367,10,Y,N,-,-1,-1
MEMMUS.txt,127449,129112,1663,10,Y,N,-,-1,-1
MEMMUS.txt,127514,129353,1839,10,Y,N,-,-1,-1
MEMMUS.txt,127679,129478,1799,10,Y,N,-,-1,-1
MEMMUS.txt,127772,129815,2043,10,Y,N,-,-1,-1
MEMMUS.txt,127861,129897,2036,10,Y,N,-,-1,-1
MEMMUS.txt,127937,130053,2116,10,Y,N,-,-1,-1
MEMMUS.txt,128098,130263,2165,10,Y,N,-,-1,-1
MEMMUS.txt,128307,130720,2413,10,Y,N,-,-1,-1
MEMMUS.txt,128467,130794,2327,10,Y,N,-,-1,-1
MEMMUS.txt,128742,130887,2145,10,Y,N,-,-1,-1
MEMMUS.txt,129115,131064,1949,10,Y,N,-,-1,-1
MEMMUS.txt,129354,131322,1968,10,Y,N,-,-1,-1
MEMMUS.txt,129481,131397,1916,10,Y,N,-,-1,-1
MEMMUS.txt,129816,131532,1716,10,Y,N,-,-1,-1
MEMMUS.txt,129898,131677,1779,10,Y,N,-,-1,-1
MEMMUS.txt,130054,131791,1737,10,Y,N,-,-1,-1
MEMMUS.txt,130266,131914,1648,10,N,N,-,-1,-1
MEMMUS.txt,130723,132017,1294,10,N,N,-,-1,-1
MEMMUS.txt,130795,132102,1307,10,N,N,-,-1,-1
MEMMUS.txt,130888,132280,1392,10,N,N,-,-1,-1
MEMMUS.txt,131065,132311,1246,10,N,N,-,-1,-1
MEMMUS.txt,131323,132482,1159,10,N,N,-,-1,-1
MEMMUS.txt,131400,132603,1203,10,N,N,-,-1,-1
MEMMUS.txt,131534,132705,1171,10,Y,N,-,-1,-1
MEMMUS.txt,131679,132939,1260,10,Y,N,-,-1,-1
MEMMUS.txt,131792,133008,1216,10,Y,N,-,-1,-1
MEMMUS.txt,131917,133182,1265,10,Y,N,-,-1,-1
MEMMUS.txt,132018,133472,1454,10,Y,N,-,-1,-1
MEMMUS.txt,132107,133550,1443,10,Y,N,-,-1,-1
MEMMUS.txt,132283,133664,1381,10,Y,N,-,-1,-1
MEMMUS.txt,132312,133855,1543,10,Y,N,-,-1,-1
MEMMUS.txt,132483,134262,1779,10,Y,N,-,-1,-1
MEMMUS.txt,132604,134403,1799,10,Y,Y,1448277167610,40886,47737
MEMMUS.txt,132707,134506,1799,10,N,Y,1448277167610,40886,47737
MEMMUS.txt,132941,134695,1754,10,Y,Y,1448277167610,40886,47737
MEMMUS.txt,133011,134775,1764,10,Y,Y,1448277167610,40886,47737
MEMMUS.txt,133183,134886,1703,10,Y,Y,1448277167610,40886,47737
MEMMUS.txt,133474,134950,1476,10,Y,Y,1448277167610,40886,47737
MEMMUS.txt,133555,135077,1522,10,Y,Y,1448277167610,40886,47737
MEMMUS.txt,133667,135262,1595,10,Y,Y,1448277167610,40886,47737
MEMMUS.txt,133857,135353,1496,10,Y,Y,1448277167610,40886,47737
MEMMUS.txt,134265,135510,1245,10,Y,Y,1448277167610,40886,47737
MEMMUS.txt,134405,135800,1395,10,Y,Y,1448277167610,40886,47737
MEMMUS.txt,134507,135871,1364,10,Y,Y,1448277167610,40886,47737
MEMMUS.txt,134696,135914,1218,10,N,Y,1448277167610,40886,47737
MEMMUS.txt,134777,136066,1289,10,N,Y,1448277167610,40886,47737
MEMMUS.txt,134887,136246,1359,10,N,Y,1448277167610,40886,47737
MEMMUS.txt,134951,136321,1370,10,Y,Y,1448277167610,40886,47737
MEMMUS.txt,135080,136766,1686,10,Y,Y,1448312844411,173573,174472
MEMMUS.txt,135264,136807,1543,10,Y,Y,1448312844411,173573,174472
MEMMUS.txt,135354,136945,1591,10,Y,Y,1448310549245,137491,141408
MEMMUS.txt,135511,137097,1586,10,Y,Y,1448310549245,137491,141408
MEMMUS.txt,135801,137367,1566,10,Y,Y,1448310549245,137491,141408
MEMMUS.txt,135874,137541,1667,10,Y,Y,1448310549245,137491,141408
MEMMUS.txt,135916,137588,1672,10,Y,Y,1448310549245,137491,141408
MEMMUS.txt,136067,137932,1865,10,Y,Y,1448310549245,137491,141408
MEMMUS.txt,136248,138261,2013,10,Y,Y,1448310549245,137491,141408
MEMMUS.txt,136322,138362,2040,10,Y,Y,1448310549245,137491,141408
MEMMUS.txt,136767,138427,1660,10,Y,Y,1448310549245,137491,141408
MEMMUS.txt,136810,138496,1686,10,Y,Y,1448310549245,137491,141408
MEMMUS.txt,136946,138710,1764,10,Y,Y,1448310549245,137491,141408
MEMMUS.txt,137098,139079,1981,10,Y,Y,1448310549245,137491,141408
MEMMUS.txt,137368,139287,1919,10,Y,Y,1448310549245,137491,141408
MEMMUS.txt,137542,139438,1896,10,Y,Y,1448310549245,137491,141408
MEMMUS.txt,137589,139487,1898,10,Y,Y,1448366107348,271942,274308
MEMMUS.txt,137935,139602,1667,10,N,Y,1448366107348,271942,274308
MEMMUS.txt,138264,139832,1568,10,Y,Y,1448366107348,271942,274308
MEMMUS.txt,138363,140002,1639,10,Y,Y,1448366107348,271942,274308
MEMMUS.txt,138428,140183,1755,10,Y,Y,1448366107348,271942,274308
MEMMUS.txt,138497,140248,1751,10,Y,Y,1448366107348,271942,274308
MEMMUS.txt,138711,140451,1740,10,Y,Y,1448366107348,271942,274308
MEMMUS.txt,139082,140562,1480,10,Y,N,-,-1,-1
MEMMUS.txt,139288,140634,1346,10,Y,N,-,-1,-1
MEMMUS.txt,139439,140907,1468,10,Y,N,-,-1,-1
MEMMUS.txt,139489,141041,1552,10,Y,N,-,-1,-1
MEMMUS.txt,139605,141083,1478,10,Y,N,-,-1,-1
MEMMUS.txt,139833,141273,1440,10,Y,N,-,-1,-1
MEMMUS.txt,140003,141943,1940,10,Y,N,-,-1,-1
MEMMUS.txt,140186,142035,1849,10,Y,N,-,-1,-1
MEMMUS.txt,140249,142154,1905,10,Y,N,-,-1,-1
MEMMUS.txt,140452,142371,1919,10,N,N,-,-1,-1
MEMMUS.txt,140564,142503,1939,10,Y,N,-,-1,-1
MEMMUS.txt,140635,142677,2042,10,Y,N,-,-1,-1
MEMMUS.txt,140908,142796,1888,10,Y,N,-,-1,-1
MEMMUS.txt,141042,142926,1884,10,Y,N,-,-1,-1
MEMMUS.txt,141084,143103,2019,10,Y,N,-,-1,-1
MEMMUS.txt,141278,143367,2089,10,Y,N,-,-1,-1
MEMMUS.txt,141946,143502,1556,10,Y,N,-,-1,-1
MEMMUS.txt,142037,143593,1556,10,Y,N,-,-1,-1
MEMMUS.txt,142155,143750,1595,10,Y,N,-,-1,-1
MEMMUS.txt,142374,143870,1496,10,Y,N,-,-1,-1
MEMMUS.txt,142504,144022,1518,10,Y,N,-,-1,-1
MEMMUS.txt,142678,144326,1648,10,Y,N,-,-1,-1
MEMMUS.txt,142799,144449,1650,10,Y,N,-,-1,-1
MEMMUS.txt,142927,144582,1655,10,Y,N,-,-1,-1
MEMMUS.txt,143106,144691,1585,10,Y,N,-,-1,-1
MEMMUS.txt,143368,144791,1423,10,Y,N,-,-1,-1
MEMMUS.txt,143503,144918,1415,10,Y,N,-,-1,-1
MEMMUS.txt,143596,145170,1574,10,Y,N,-,-1,-1
MEMMUS.txt,143751,145219,1468,10,Y,N,-,-1,-1
MEMMUS.txt,143873,145463,1590,10,Y,N,-,-1,-1
MEMMUS.txt,144023,145495,1472,10,Y,N,-,-1,-1
MEMMUS.txt,144329,145587,1258,10,Y,N,-,-1,-1
MEMMUS.txt,144450,145765,1315,10,N,N,-,-1,-1
MEMMUS.txt,144585,145926,1341,10,N,N,-,-1,-1
MEMMUS.txt,144692,146056,1364,10,N,N,-,-1,-1
MEMMUS.txt,144792,146186,1394,10,N,N,-,-1,-1
MEMMUS.txt,144919,146232,1313,10,N,N,-,-1,-1
MEMMUS.txt,145171,146334,1163,10,N,N,-,-1,-1
MEMMUS.txt,145222,146542,1320,10,N,N,-,-1,-1
MEMMUS.txt,145464,146606,1142,10,N,N,-,-1,-1
MEMMUS.txt,145496,146804,1308,10,N,N,-,-1,-1
MEMMUS.txt,145588,146914,1326,10,N,N,-,-1,-1
MEMMUS.txt,145767,147000,1233,10,N,N,-,-1,-1
MEMMUS.txt,145929,147145,1216,10,N,N,-,-1,-1
MEMMUS.txt,146057,147242,1185,10,N,N,-,-1,-1
MEMMUS.txt,146187,147494,1307,10,N,N,-,-1,-1
MEMMUS.txt,146233,147609,1376,10,N,N,-,-1,-1
MEMMUS.txt,146335,147735,1400,10,N,N,-,-1,-1
MEMMUS.txt,146544,147814,1270,10,N,N,-,-1,-1
MEMMUS.txt,146609,147874,1265,10,N,N,-,-1,-1
MEMMUS.txt,146805,147925,1120,10,N,N,-,-1,-1
MEMMUS.txt,146917,148110,1193,10,N,N,-,-1,-1
MEMMUS.txt,147001,148338,1337,10,N,N,-,-1,-1
MEMMUS.txt,147146,148444,1298,10,N,N,-,-1,-1
MEMMUS.txt,147245,148687,1442,10,N,N,-,-1,-1
MEMMUS.txt,147495,148821,1326,10,N,N,-,-1,-1
MEMMUS.txt,147610,149038,1428,10,Y,N,-,-1,-1
MEMMUS.txt,147738,149230,1492,10,Y,N,-,-1,-1
MEMMUS.txt,147815,149398,1583,10,Y,N,-,-1,-1
MEMMUS.txt,147876,149476,1600,10,Y,N,-,-1,-1
MEMMUS.txt,147928,149592,1664,10,Y,N,-,-1,-1
MEMMUS.txt,148112,149702,1590,10,Y,N,-,-1,-1
MEMMUS.txt,148339,149805,1466,10,Y,N,-,-1,-1
MEMMUS.txt,148445,149967,1522,10,Y,N,-,-1,-1
MEMMUS.txt,148690,150238,1548,10,Y,N,-,-1,-1
MEMMUS.txt,148824,150467,1643,10,Y,N,-,-1,-1
MEMMUS.txt,149039,150556,1517,10,Y,N,-,-1,-1
MEMMUS.txt,149231,150687,1456,10,Y,N,-,-1,-1
MEMMUS.txt,149399,150942,1543,10,Y,N,-,-1,-1
MEMMUS.txt,149477,151089,1612,10,Y,N,-,-1,-1
MEMMUS.txt,149593,151170,1577,10,Y,N,-,-1,-1
MEMMUS.txt,149703,151313,1610,10,Y,N,-,-1,-1
MEMMUS.txt,149806,151470,1664,10,Y,N,-,-1,-1
MEMMUS.txt,149968,151527,1559,10,Y,N,-,-1,-1
MEMMUS.txt,150241,151637,1396,10,Y,N,-,-1,-1
MEMMUS.txt,150470,151707,1237,10,Y,N,-,-1,-1
MEMMUS.txt,150557,151886,1329,10,Y,N,-,-1,-1
MEMMUS.txt,150688,152036,1348,10,Y,N,-,-1,-1
MEMMUS.txt,150945,152155,1210,10,Y,N,-,-1,-1
MEMMUS.txt,151094,152272,1178,10,Y,N,-,-1,-1
MEMMUS.txt,151171,152436,1265,10,N,N,-,-1,-1
MEMMUS.txt,151314,152650,1336,10,N,N,-,-1,-1
MEMMUS.txt,151471,152734,1263,10,N,N,-,-1,-1
MEMMUS.txt,151530,152795,1265,10,N,N,-,-1,-1
MEMMUS.txt,151638,152899,1261,10,N,N,-,-1,-1
MEMMUS.txt,151709,153101,1392,10,N,N,-,-1,-1
MEMMUS.txt,151889,153273,1384,10,N,N,-,-1,-1
MEMMUS.txt,152037,153447,1410,10,Y,N,-,-1,-1
MEMMUS.txt,152156,153587,1431,10,Y,N,-,-1,-1
MEMMUS.txt,152273,153746,1473,10,Y,N,-,-1,-1
MEMMUS.txt,152437,153843,1406,10,Y,N,-,-1,-1
MEMMUS.txt,152651,153928,1277,10,Y,N,-,-1,-1
MEMMUS.txt,152735,154130,1395,10,Y,Y,1448287094676,113323,113870
MEMMUS.txt,152798,154463,1665,10,Y,Y,1448287094676,113323,113870
MEMMUS.txt,152900,154509,1609,10,Y,Y,1448287094676,113323,113870
MEMMUS.txt,153102,154620,1518,10,Y,Y,1448287094676,113323,113870
MEMMUS.txt,153274,154730,1456,10,Y,Y,1448287094676,113323,113870
MEMMUS.txt,153448,154779,1331,10,Y,Y,1448287094676,113323,113870
MEMMUS.txt,153589,154889,1300,10,Y,Y,1448287094676,113323,113870
MEMMUS.txt,153747,154983,1236,10,Y,Y,1448287094676,113323,113870
MEMMUS.txt,153844,155051,1207,10,N,Y,1448287094676,113323,113870
MEMMUS.txt,153929,155191,1262,10,Y,Y,1448287094676,113323,113870
MEMMUS.txt,154131,155375,1244,10,Y,Y,1448287094676,113323,113870
MEMMUS.txt,154466,155487,1021,10,Y,N,-,-1,-1
MEMMUS.txt,154511,155652,1141,10,Y,N,-,-1,-1
MEMMUS.txt,154621,155831,1210,10,Y,N,-,-1,-1
MEMMUS.txt,154731,156157,1426,10,Y,N,-,-1,-1
MEMMUS.txt,154781,156330,1549,10,Y,N,-,-1,-1
MEMMUS.txt,154892,156476,1584,10,Y,N,-,-1,-1
MEMMUS.txt,154985,156571,1586,10,Y,N,-,-1,-1
MEMMUS.txt,155052,156657,1605,10,Y,N,-,-1,-1
MEMMUS.txt,155192,156855,1663,10,Y,N,-,-1,-1
MEMMUS.txt,155376,156914,1538,10,Y,N,-,-1,-1
MEMMUS.txt,155490,157119,1629,10,Y,N,-,-1,-1
MEMMUS.txt,155653,157378,1725,10,N,N,-,-1,-1
MEMMUS.txt,155832,157510,1678,10,N,N,-,-1,-1
MEMMUS.txt,156158,157615,1457,10,N,N,-,-1,-1
MEMMUS.txt,156331,157739,1408,10,N,N,-,-1,-1
MEMMUS.txt,156478,157874,1396,10,N,N,-,-1,-1
MEMMUS.txt,156574,158030,1456,10,N,N,-,-1,-1
MEMMUS.txt,156658,158173,1515,10,N,N,-,-1,-1
MEMMUS.txt,156856,158297,1441,10,N,N,-,-1,-1
MEMMUS.txt,156917,158468,1551,10,N,N,-,-1,-1
MEMMUS.txt,157120,158633,1513,10,N,N,-,-1,-1
MEMMUS.txt,157379,158773,1394,10,N,N,-,-1,-1
MEMMUS.txt,157513,158858,1345,10,Y,N,-,-1,-1
MEMMUS.txt,157616,159087,1471,10,N,N,-,-1,-1
MEMMUS.txt,157740,159226,1486,10,N,N,-,-1,-1
MEMMUS.txt,157877,159340,1463,10,N,N,-,-1,-1
MEMMUS.txt,158031,159458,1427,10,Y,N,-,-1,-1
MEMMUS.txt,158174,159865,1691,10,Y,N,-,-1,-1
MEMMUS.txt,158300,159937,1637,10,Y,N,-,-1,-1
MEMMUS.txt,158469,160068,1599,10,Y,N,-,-1,-1
MEMMUS.txt,158636,160112,1476,10,N,N,-,-1,-1
MEMMUS.txt,158775,160192,1417,10,N,N,-,-1,-1
MEMMUS.txt,158859,160344,1485,10,N,N,-,-1,-1
MEMMUS.txt,159090,160584,1494,10,N,N,-,-1,-1
MEMMUS.txt,159227,160972,1745,10,Y,N,-,-1,-1
MEMMUS.txt,159341,161489,2148,10,N,N,-,-1,-1
MEMMUS.txt,159461,161643,2182,10,Y,N,-,-1,-1
MEMMUS.txt,159866,161776,1910,10,Y,N,-,-1,-1
MEMMUS.txt,159938,161779,1841,10,Y,N,-,-1,-1
MEMMUS.txt,160069,161803,1734,10,Y,N,-,-1,-1
MEMMUS.txt,160114,161975,1861,10,N,N,-,-1,-1
MEMMUS.txt,160195,162226,2031,10,Y,N,-,-1,-1
MEMMUS.txt,160345,162302,1957,10,Y,N,-,-1,-1
MEMMUS.txt,160589,162430,1841,10,Y,N,-,-1,-1
MEMMUS.txt,160975,162635,1660,10,Y,N,-,-1,-1
MEMMUS.txt,161492,162976,1484,10,N,N,-,-1,-1
MEMMUS.txt,161644,163111,1467,10,Y,N,-,-1,-1
MEMMUS.txt,161777,163310,1533,10,Y,N,-,-1,-1
MEMMUS.txt,161780,163431,1651,10,Y,N,-,-1,-1
MEMMUS.txt,161803,163595,1792,10,Y,N,-,-1,-1
MEMMUS.txt,161976,163945,1969,10,Y,N,-,-1,-1
MEMMUS.txt,162227,164085,1858,10,Y,N,-,-1,-1
MEMMUS.txt,162304,164257,1953,10,Y,N,-,-1,-1
MEMMUS.txt,162433,164398,1965,10,Y,N,-,-1,-1
MEMMUS.txt,162636,164603,1967,10,Y,N,-,-1,-1
MEMMUS.txt,162977,164745,1768,10,N,N,-,-1,-1
MEMMUS.txt,163114,164892,1778,10,N,N,-,-1,-1
MEMMUS.txt,163311,164950,1639,10,N,N,-,-1,-1
MEMMUS.txt,163432,165191,1759,10,N,N,-,-1,-1
MEMMUS.txt,163596,165247,1651,10,N,N,-,-1,-1
MEMMUS.txt,163946,165443,1497,10,N,N,-,-1,-1
MEMMUS.txt,164086,165794,1708,10,Y,N,-,-1,-1
MEMMUS.txt,164258,165906,1648,10,Y,N,-,-1,-1
MEMMUS.txt,164401,166038,1637,10,N,N,-,-1,-1
MEMMUS.txt,164604,166073,1469,10,N,N,-,-1,-1
MEMMUS.txt,164746,166208,1462,10,N,N,-,-1,-1
MEMMUS.txt,164893,166330,1437,10,N,Y,1448366492754,275659,275884
MEMMUS.txt,164953,166611,1658,10,N,Y,1448366492754,275659,275884
MEMMUS.txt,165192,166676,1484,10,N,Y,1448366492754,275659,275884
MEMMUS.txt,165254,166806,1552,10,N,Y,1448366492754,275659,275884
MEMMUS.txt,165446,166892,1446,10,N,Y,1448366492754,275659,275884
MEMMUS.txt,165797,167005,1208,10,N,Y,1448366492754,275659,275884
MEMMUS.txt,165907,167214,1307,10,N,Y,1448366492754,275659,275884
MEMMUS.txt,166039,167320,1281,10,N,Y,1448366492754,275659,275884
MEMMUS.txt,166076,167588,1512,10,N,Y,1448366492754,275659,275884
MEMMUS.txt,166209,167799,1590,10,Y,Y,1448366492754,275659,275884
MEMMUS.txt,166331,168046,1715,10,Y,Y,1448366492754,275659,275884
MEMMUS.txt,166612,168342,1730,10,Y,Y,1448366492754,275659,275884
MEMMUS.txt,166677,168451,1774,10,N,Y,1448366492754,275659,275884
MEMMUS.txt,166809,168549,1740,10,Y,Y,1448366973491,278203,278343
MEMMUS.txt,166893,168602,1709,10,Y,Y,1448366973491,278203,278343
MEMMUS.txt,167008,168671,1663,10,Y,Y,1448366973491,278203,278343
MEMMUS.txt,167217,168872,1655,10,Y,Y,1448366973491,278203,278343
MEMMUS.txt,167323,168975,1652,10,Y,Y,1448366973491,278203,278343
MEMMUS.txt,167589,169058,1469,10,Y,Y,1448366973491,278203,278343
MEMMUS.txt,167800,169298,1498,10,Y,Y,1448366973491,278203,278343
MEMMUS.txt,168049,169366,1317,10,Y,Y,1448366973491,278203,278343
MEMMUS.txt,168343,169442,1099,10,Y,Y,1448366973491,278203,278343
MEMMUS.txt,168452,169684,1232,10,Y,Y,1448366973491,278203,278343
MEMMUS.txt,168550,170046,1496,10,Y,N,-,-1,-1
MEMMUS.txt,168605,170355,1750,10,Y,N,-,-1,-1
MEMMUS.txt,168672,170483,1811,10,Y,N,-,-1,-1
MEMMUS.txt,168874,170548,1674,10,Y,N,-,-1,-1
MEMMUS.txt,168978,170727,1749,10,Y,N,-,-1,-1
MEMMUS.txt,169061,170873,1812,10,Y,N,-,-1,-1
MEMMUS.txt,169299,170996,1697,10,Y,N,-,-1,-1
MEMMUS.txt,169367,171070,1703,10,Y,N,-,-1,-1
MEMMUS.txt,169443,171185,1742,10,Y,N,-,-1,-1
MEMMUS.txt,169685,171421,1736,10,Y,N,-,-1,-1
MEMMUS.txt,170047,171640,1593,10,N,N,-,-1,-1
MEMMUS.txt,170356,171850,1494,10,Y,N,-,-1,-1
MEMMUS.txt,170484,171987,1503,10,Y,N,-,-1,-1
MEMMUS.txt,170550,172182,1632,10,Y,N,-,-1,-1
MEMMUS.txt,170730,172331,1601,10,Y,N,-,-1,-1
MEMMUS.txt,170876,172552,1676,10,Y,N,-,-1,-1
MEMMUS.txt,170997,172749,1752,10,Y,N,-,-1,-1
MEMMUS.txt,171071,172922,1851,10,Y,N,-,-1,-1
MEMMUS.txt,171188,172995,1807,10,Y,N,-,-1,-1
MEMMUS.txt,171422,173111,1689,10,Y,N,-,-1,-1
MEMMUS.txt,171643,173245,1602,10,Y,N,-,-1,-1
MEMMUS.txt,171851,173488,1637,10,Y,N,-,-1,-1
MEMMUS.txt,171988,173498,1510,10,N,N,-,-1,-1
MEMMUS.txt,172183,173694,1511,10,N,N,-,-1,-1
MEMMUS.txt,172332,173799,1467,10,N,N,-,-1,-1
MEMMUS.txt,172553,174063,1510,10,N,N,-,-1,-1
MEMMUS.txt,172752,174245,1493,10,N,N,-,-1,-1
MEMMUS.txt,172924,174450,1526,10,N,N,-,-1,-1
MEMMUS.txt,172998,174533,1535,10,N,N,-,-1,-1
MEMMUS.txt,173112,174681,1569,10,Y,N,-,-1,-1
MEMMUS.txt,173246,174801,1555,10,Y,N,-,-1,-1
MEMMUS.txt,173491,175044,1553,10,N,N,-,-1,-1
MEMMUS.txt,173499,175144,1645,10,N,N,-,-1,-1
MEMMUS.txt,173695,175485,1790,10,Y,N,-,-1,-1
MEMMUS.txt,173800,175660,1860,10,Y,N,-,-1,-1
MEMMUS.txt,174066,175761,1695,10,Y,N,-,-1,-1
MEMMUS.txt,174246,175895,1649,10,N,N,-,-1,-1
MEMMUS.txt,174451,176140,1689,10,Y,N,-,-1,-1
MEMMUS.txt,174534,176316,1782,10,Y,N,-,-1,-1
MEMMUS.txt,174682,176473,1791,10,Y,N,-,-1,-1
MEMMUS.txt,174802,176573,1771,10,N,N,-,-1,-1
MEMMUS.txt,175047,176713,1666,10,Y,N,-,-1,-1
MEMMUS.txt,175145,176904,1759,10,Y,N,-,-1,-1
MEMMUS.txt,175488,177202,1714,10,Y,N,-,-1,-1
MEMMUS.txt,175661,177297,1636,10,Y,N,-,-1,-1
MEMMUS.txt,175762,177660,1898,10,Y,N,-,-1,-1
MEMMUS.txt,175898,177778,1880,10,Y,N,-,-1,-1
MEMMUS.txt,176143,177975,1832,10,Y,N,-,-1,-1
MEMMUS.txt,176317,178058,1741,10,Y,N,-,-1,-1
MEMMUS.txt,176474,178122,1648,10,Y,N,-,-1,-1
MEMMUS.txt,176576,178214,1638,10,Y,N,-,-1,-1
MEMMUS.txt,176715,178332,1617,10,Y,N,-,-1,-1
MEMMUS.txt,176906,178527,1621,10,Y,N,-,-1,-1
MEMMUS.txt,177203,178609,1406,10,Y,N,-,-1,-1
MEMMUS.txt,177303,179727,2424,10,Y,N,-,-1,-1
MEMMUS.txt,177662,179868,2206,10,Y,N,-,-1,-1
MEMMUS.txt,177779,180245,2466,10,Y,N,-,-1,-1
MEMMUS.txt,177976,180446,2470,10,Y,N,-,-1,-1
MEMMUS.txt,178059,180672,2613,10,N,N,-,-1,-1
MEMMUS.txt,178123,180884,2761,10,N,N,-,-1,-1
MEMMUS.txt,178217,180995,2778,10,N,N,-,-1,-1
MEMMUS.txt,178335,181063,2728,10,N,N,-,-1,-1
MEMMUS.txt,178530,181380,2850,10,N,N,-,-1,-1
MEMMUS.txt,178614,181466,2852,10,N,Y,1448038101349,15101,17486
MEMMUS.txt,179730,181921,2191,10,N,Y,1448038101349,15101,17486
MEMMUS.txt,179870,181975,2105,10,N,Y,1448038101349,15101,17486
MEMMUS.txt,180248,182150,1902,10,Y,Y,1448038101349,15101,17486
MEMMUS.txt,180447,182213,1766,10,N,Y,1448038101349,15101,17486
MEMMUS.txt,180675,182375,1700,10,N,Y,1448038101349,15101,17486
MEMMUS.txt,180885,182550,1665,10,Y,Y,1448038101349,15101,17486
MEMMUS.txt,180997,182641,1644,10,Y,Y,1448038101349,15101,17486
MEMMUS.txt,181064,182787,1723,10,Y,Y,1448038101349,15101,17486
MEMMUS.txt,181383,183006,1623,10,Y,Y,1448038101349,15101,17486
MEMMUS.txt,181467,183096,1629,10,Y,Y,1448038101349,15101,17486
MEMMUS.txt,181922,183304,1382,10,Y,Y,1448038101349,15101,17486
MEMMUS.txt,181976,183509,1533,10,Y,Y,1448038101349,15101,17486
MEMMUS.txt,182153,183651,1498,10,N,Y,1448279620157,70041,71486
MEMMUS.txt,182214,183737,1523,10,N,Y,1448279620157,70041,71486
MEMMUS.txt,182378,183833,1455,10,N,Y,1448279620157,70041,71486
MEMMUS.txt,182551,183911,1360,10,N,Y,1448279620157,70041,71486
MEMMUS.txt,182644,184070,1426,10,N,Y,1448279620157,70041,71486
MEMMUS.txt,182788,184152,1364,10,N,Y,1448279620157,70041,71486
MEMMUS.txt,183007,184366,1359,10,N,Y,1448279620157,70041,71486
MEMMUS.txt,183097,184519,1422,10,N,Y,1448279620157,70041,71486
MEMMUS.txt,183307,184558,1251,10,N,Y,1448279620157,70041,71486
MEMMUS.txt,183510,184600,1090,10,N,Y,1448279620157,70041,71486
MEMMUS.txt,183652,184725,1073,10,N,Y,1448279620157,70041,71486
MEMMUS.txt,183738,184837,1099,10,N,Y,1448279620157,70041,71486
MEMMUS.txt,183834,184870,1036,10,N,Y,1448279620157,70041,71486
MEMMUS.txt,183912,184977,1065,10,N,Y,1448279620157,70041,71486
MEMMUS.txt,184071,185065,994,10,N,N,-,-1,-1
MEMMUS.txt,184154,185183,1029,10,N,Y,1448396118064,295199,297352
MEMMUS.txt,184367,185300,933,10,N,Y,1448396118064,295199,297352
MEMMUS.txt,184520,185421,901,10,N,Y,1448396118064,295199,297352
MEMMUS.txt,184561,185525,964,10,N,Y,1448396118064,295199,297352
MEMMUS.txt,184601,185793,1192,10,N,Y,1448396118064,295199,297352
MEMMUS.txt,184726,185857,1131,10,N,Y,1448396118064,295199,297352
MEMMUS.txt,184838,185952,1114,10,N,Y,1448396118064,295199,297352
MEMMUS.txt,184871,186007,1136,10,N,Y,1448396118064,295199,297352
MEMMUS.txt,184978,186171,1193,10,N,Y,1448396118064,295199,297352
MEMMUS.txt,185068,186262,1194,10,N,Y,1448396118064,295199,297352
MEMMUS.txt,185184,186362,1178,10,N,Y,1448278147591,54631,55869
MEMMUS.txt,185302,186464,1162,10,N,Y,1448278147591,54631,55869
MEMMUS.txt,185422,186675,1253,10,N,Y,1448278147591,54631,55869
MEMMUS.txt,185526,186938,1412,10,N,Y,1448278147591,54631,55869
MEMMUS.txt,185794,187001,1207,10,Y,Y,1448278147591,54631,55869
MEMMUS.txt,185858,187140,1282,10,Y,Y,1448278147591,54631,55869
MEMMUS.txt,185955,187325,1370,10,Y,Y,1448278147591,54631,55869
MEMMUS.txt,186008,187438,1430,10,Y,Y,1448278147591,54631,55869
MEMMUS.txt,186172,187533,1361,10,Y,Y,1448278147591,54631,55869
MEMMUS.txt,186265,187811,1546,10,Y,Y,1448278147591,54631,55869
MEMMUS.txt,186363,187847,1484,10,Y,Y,1448278147591,54631,55869
MEMMUS.txt,186465,187921,1456,10,Y,Y,1448278147591,54631,55869
MEMMUS.txt,186676,188050,1374,10,Y,Y,1448278147591,54631,55869
MEMMUS.txt,186939,188214,1275,10,Y,Y,1448278147591,54631,55869
MEMMUS.txt,187004,188419,1415,10,Y,N,-,-1,-1
MEMMUS.txt,187148,188500,1352,10,Y,N,-,-1,-1
MEMMUS.txt,187326,188686,1360,10,Y,N,-,-1,-1
MEMMUS.txt,187439,188747,1308,10,Y,N,-,-1,-1
MEMMUS.txt,187536,188827,1291,10,Y,N,-,-1,-1
MEMMUS.txt,187812,188898,1086,10,Y,N,-,-1,-1
MEMMUS.txt,187850,189052,1202,10,Y,N,-,-1,-1
MEMMUS.txt,187922,189138,1216,10,Y,N,-,-1,-1
MEMMUS.txt,188051,189317,1266,10,Y,N,-,-1,-1
MEMMUS.txt,188217,189360,1143,10,N,N,-,-1,-1
MEMMUS.txt,188420,189490,1070,10,N,N,-,-1,-1
MEMMUS.txt,188501,189670,1169,10,N,N,-,-1,-1
MEMMUS.txt,188687,189804,1117,10,N,N,-,-1,-1
MEMMUS.txt,188748,190122,1374,10,N,N,-,-1,-1
MEMMUS.txt,188828,190241,1413,10,N,N,-,-1,-1
MEMMUS.txt,188901,190305,1404,10,N,N,-,-1,-1
MEMMUS.txt,189053,190349,1296,10,N,N,-,-1,-1
MEMMUS.txt,189139,190472,1333,10,N,N,-,-1,-1
MEMMUS.txt,189318,190535,1217,10,N,N,-,-1,-1
MEMMUS.txt,189361,190577,1216,10,N,N,-,-1,-1
MEMMUS.txt,189493,190696,1203,10,N,Y,1448315841759,183531,183799
MEMMUS.txt,189673,190847,1174,10,Y,Y,1448315841759,183531,183799
MEMMUS.txt,189805,190906,1101,10,Y,Y,1448315841759,183531,183799
MEMMUS.txt,190123,191025,902,10,Y,Y,1448315841759,183531,183799
MEMMUS.txt,190243,191183,940,10,N,Y,1448315841759,183531,183799
MEMMUS.txt,190306,191226,920,10,N,Y,1448315841759,183531,183799
MEMMUS.txt,190350,191300,950,10,N,Y,1448315841759,183531,183799
MEMMUS.txt,190473,191453,980,10,N,Y,1448315841759,183531,183799
MEMMUS.txt,190536,191547,1011,10,N,Y,1437472380836,351899,352666
MEMMUS.txt,190580,191775,1195,10,N,Y,1437472380836,351899,352666
MEMMUS.txt,190697,191952,1255,10,N,Y,1437472380836,351899,352666
MEMMUS.txt,190848,192002,1154,10,N,Y,1437472380836,351899,352666
MEMMUS.txt,190907,192192,1285,10,Y,Y,1437472380836,351899,352666
MEMMUS.txt,191028,192295,1267,10,Y,Y,1437472380836,351899,352666
MEMMUS.txt,191184,192427,1243,10,Y,Y,1437472380836,351899,352666
MEMMUS.txt,191227,192544,1317,10,Y,Y,1437472380836,351899,352666
MEMMUS.txt,191301,192785,1484,10,Y,Y,1437472380836,351899,352666
MEMMUS.txt,191456,192926,1470,10,Y,Y,1437472380836,351899,352666
MEMMUS.txt,191549,193138,1589,10,Y,Y,1437472380836,351899,352666
MEMMUS.txt,191776,193384,1608,10,Y,Y,1437472380836,351899,352666
MEMMUS.txt,191953,193430,1477,10,Y,Y,1448358276684,234999,235995
MEMMUS.txt,192003,193599,1596,10,Y,Y,1448358276684,234999,235995
MEMMUS.txt,192193,193777,1584,10,Y,Y,1448358276684,234999,235995
MEMMUS.txt,192296,193880,1584,10,Y,Y,1448358276684,234999,235995
MEMMUS.txt,192430,194007,1577,10,Y,Y,1448358276684,234999,235995
MEMMUS.txt,192545,194192,1647,10,Y,Y,1448358276684,234999,235995
MEMMUS.txt,192786,194226,1440,10,N,Y,1448358276684,234999,235995
MEMMUS.txt,192929,194372,1443,10,Y,Y,1448359440819,262798,263079
MEMMUS.txt,193139,194493,1354,10,N,Y,1448359440819,262798,263079
MEMMUS.txt,193385,194576,1191,10,Y,Y,1448359440819,262798,263079
MEMMUS.txt,193433,194766,1333,10,Y,Y,1448359440819,262798,263079
MEMMUS.txt,193600,194862,1262,10,Y,Y,1448359440819,262798,263079
MEMMUS.txt,193778,195017,1239,10,Y,Y,1448359440819,262798,263079
MEMMUS.txt,193883,195174,1291,10,Y,N,-,-1,-1
MEMMUS.txt,194008,195486,1478,10,Y,Y,1448279089520,67624,69991
MEMMUS.txt,194193,195642,1449,10,Y,Y,1448279089520,67624,69991
MEMMUS.txt,194229,195783,1554,10,Y,Y,1448279089520,67624,69991
MEMMUS.txt,194373,195886,1513,10,Y,Y,1448279089520,67624,69991
MEMMUS.txt,194494,196209,1715,10,Y,Y,1448279089520,67624,69991
MEMMUS.txt,194577,196251,1674,10,Y,Y,1448279089520,67624,69991
MEMMUS.txt,194767,196361,1594,10,Y,Y,1448279089520,67624,69991
MEMMUS.txt,194865,196497,1632,10,Y,Y,1448279089520,67624,69991
MEMMUS.txt,195018,196841,1823,10,Y,Y,1448279089520,67624,69991
MEMMUS.txt,195175,197030,1855,10,Y,Y,1448279089520,67624,69991
MEMMUS.txt,195489,197102,1613,10,Y,Y,1448279089520,67624,69991
MEMMUS.txt,195643,197202,1559,10,Y,Y,1448279089520,67624,69991
MEMMUS.txt,195786,197320,1534,10,Y,Y,1448394636895,292272,293963
MEMMUS.txt,195887,197549,1662,10,Y,Y,1448394636895,292272,293963
MEMMUS.txt,196210,197699,1489,10,Y,Y,1448394636895,292272,293963
MEMMUS.txt,196252,197837,1585,10,Y,Y,1448394636895,292272,293963
MEMMUS.txt,196362,197956,1594,10,Y,Y,1448394636895,292272,293963
MEMMUS.txt,196500,198170,1670,10,Y,Y,1448394636895,292272,293963
MEMMUS.txt,196842,198346,1504,10,N,Y,1448394636895,292272,293963
MEMMUS.txt,197031,198567,1536,10,N,Y,1448394636895,292272,293963
MEMMUS.txt,197103,198664,1561,10,N,Y,1448394636895,292272,293963
MEMMUS.txt,197205,198759,1554,10,N,Y,1448274783410,21836,25159
MEMMUS.txt,197321,198853,1532,10,N,Y,1448274783410,21836,25159
MEMMUS.txt,197550,199051,1501,10,N,Y,1448274783410,21836,25159
MEMMUS.txt,197700,199175,1475,10,N,Y,1448274783410,21836,25159
MEMMUS.txt,197838,199386,1548,10,N,Y,1448274783410,21836,25159
MEMMUS.txt,197959,199533,1574,10,N,Y,1448274783410,21836,25159
MEMMUS.txt,198171,199775,1604,10,N,Y,1448274783410,21836,25159
MEMMUS.txt,198349,199855,1506,10,N,Y,1448274783410,21836,25159
MEMMUS.txt,198568,200083,1515,10,N,Y,1448274783410,21836,25159
MEMMUS.txt,198667,200220,1553,10,N,Y,1448274783410,21836,25159
MEMMUS.txt,198761,200315,1554,10,N,Y,1448274783410,21836,25159
MEMMUS.txt,198855,200575,1720,10,N,Y,1448274783410,21836,25159
MEMMUS.txt,199052,200822,1770,10,N,Y,1448274783410,21836,25159
MEMMUS.txt,199176,200881,1705,10,N,Y,1448316586529,210063,210674
MEMMUS.txt,199389,201062,1673,10,N,Y,1448316586529,210063,210674
MEMMUS.txt,199534,201156,1622,10,N,Y,1448316586529,210063,210674
MEMMUS.txt,199776,201385,1609,10,N,Y,1448316586529,210063,210674
MEMMUS.txt,199858,201505,1647,10,N,Y,1448316586529,210063,210674
MEMMUS.txt,200086,201560,1474,10,N,Y,1448316586529,210063,210674
MEMMUS.txt,200221,201678,1457,10,Y,Y,1448316586529,210063,210674
MEMMUS.txt,200317,201818,1501,10,Y,Y,1448316586529,210063,210674
MEMMUS.txt,200576,201998,1422,10,Y,Y,1448316586529,210063,210674
MEMMUS.txt,200824,202113,1289,10,N,Y,1448357582358,234204,234401
MEMMUS.txt,200884,202324,1440,10,Y,Y,1448357582358,234204,234401
MEMMUS.txt,201064,202421,1357,10,Y,Y,1448357582358,234204,234401
MEMMUS.txt,201159,202557,1398,10,Y,Y,1448357582358,234204,234401
MEMMUS.txt,201387,202620,1233,10,Y,Y,1448357582358,234204,234401
MEMMUS.txt,201506,202963,1457,10,Y,Y,1448357582358,234204,234401
MEMMUS.txt,201563,203111,1548,10,Y,Y,1448357582358,234204,234401
MEMMUS.txt,201679,203182,1503,10,Y,Y,1448357582358,234204,234401
MEMMUS.txt,201819,203278,1459,10,Y,Y,1448357582358,234204,234401
MEMMUS.txt,202000,203390,1390,10,N,Y,1448357582358,234204,234401
MEMMUS.txt,202114,203649,1535,10,Y,Y,1448357582358,234204,234401
MEMMUS.txt,202325,203830,1505,10,N,Y,1448357582358,234204,234401
MEMMUS.txt,202422,204005,1583,10,N,Y,1448357582358,234204,234401
MEMMUS.txt,202558,204116,1558,10,N,Y,1448321627053,211159,212725
MEMMUS.txt,202623,204196,1573,10,N,Y,1448321627053,211159,212725
MEMMUS.txt,202964,204314,1350,10,N,Y,1448321627053,211159,212725
MEMMUS.txt,203112,204473,1361,10,N,Y,1448321627053,211159,212725
MEMMUS.txt,203183,204677,1494,10,Y,Y,1448321627053,211159,212725
MEMMUS.txt,203279,204833,1554,10,Y,Y,1448321627053,211159,212725
MEMMUS.txt,203391,204972,1581,10,Y,Y,1448321627053,211159,212725
MEMMUS.txt,203650,205063,1413,10,Y,Y,1448321627053,211159,212725
MEMMUS.txt,203831,205188,1357,10,Y,Y,1448321627053,211159,212725
MEMMUS.txt,204007,205242,1235,10,Y,Y,1448321627053,211159,212725
MEMMUS.txt,204117,205304,1187,10,Y,N,-,-1,-1
MEMMUS.txt,204199,205531,1332,10,Y,N,-,-1,-1
MEMMUS.txt,204315,205660,1345,10,Y,N,-,-1,-1
MEMMUS.txt,204475,205881,1406,10,Y,N,-,-1,-1
MEMMUS.txt,204678,206031,1353,10,N,Y,1437477480340,424837,425856
MEMMUS.txt,204836,206158,1322,10,N,Y,1437477480340,424837,425856
MEMMUS.txt,204973,206199,1226,10,N,Y,1437477480340,424837,425856
MEMMUS.txt,205065,206558,1493,10,Y,Y,1437477480340,424837,425856
MEMMUS.txt,205189,206724,1535,10,Y,Y,1437477480340,424837,425856
MEMMUS.txt,205243,206895,1652,10,Y,Y,1437477480340,424837,425856
MEMMUS.txt,205307,206994,1687,10,Y,Y,1437477480340,424837,425856
MEMMUS.txt,205532,207024,1492,10,N,Y,1437477480340,424837,425856
MEMMUS.txt,205661,207125,1464,10,N,Y,1437477480340,424837,425856
MEMMUS.txt,205882,207153,1271,10,Y,Y,1437477480340,424837,425856
MEMMUS.txt,206032,207160,1128,10,Y,Y,1437477480340,424837,425856
MEMMUS.txt,206159,207175,1016,10,N,Y,1437477480340,424837,425856
MEMMUS.txt,206200,207189,989,10,N,Y,1437477480340,424837,425856
MEMMUS.txt,206559,207231,672,10,N,Y,1437477480340,424837,425856
MEMMUS.txt,206727,207281,554,10,N,Y,1437477480340,424837,425856
MEMMUS.txt,206896,207293,397,10,N,Y,1448322713112,221941,223038
MEMMUS.txt,206997,207335,338,10,N,Y,1448322713112,221941,223038
MEMMUS.txt,207025,207359,334,10,N,Y,1448322713112,221941,223038
MEMMUS.txt,207126,207387,261,10,N,Y,1448322713112,221941,223038
MEMMUS.txt,207156,207416,260,10,N,Y,1448322713112,221941,223038
MEMMUS.txt,207161,207429,268,10,N,Y,1448322713112,221941,223038
MEMMUS.txt,207176,207434,258,10,N,Y,1448322713112,221941,223038
MEMMUS.txt,207190,207586,396,10,N,Y,1448322713112,221941,223038
MEMMUS.txt,207234,207676,442,10,N,Y,1448322713112,221941,223038
MEMMUS.txt,207283,207728,445,10,N,Y,1448322713112,221941,223038
MEMMUS.txt,207294,207740,446,10,N,Y,1448322713112,221941,223038
MEMMUS.txt,207338,207749,411,10,N,Y,1448322713112,221941,223038
MEMMUS.txt,207360,207831,471,10,N,Y,1448322713112,221941,223038
MEMMUS.txt,207390,207907,517,10,N,Y,1448322713112,221941,223038
MEMMUS.txt,207417,207947,530,10,N,Y,1448322713112,221941,223038
MEMMUS.txt,207430,207955,525,10,N,Y,1448322713112,221941,223038
MEMMUS.txt,207436,207964,528,10,N,Y,1448322713112,221941,223038
MEMMUS.txt,207587,208021,434,10,N,Y,1448322713112,221941,223038
MEMMUS.txt,207679,208038,359,10,N,Y,1448322713112,221941,223038
MEMMUS.txt,207730,208052,322,10,N,Y,1448322713112,221941,223038
MEMMUS.txt,207741,208065,324,10,N,Y,1448322713112,221941,223038
MEMMUS.txt,207750,208107,357,10,N,Y,1448322713112,221941,223038
MEMMUS.txt,207832,208114,282,10,N,Y,1448322713112,221941,223038
MEMMUS.txt,207910,208143,233,10,N,Y,1448322713112,221941,223038
MEMMUS.txt,207948,208197,249,10,N,Y,1448322713112,221941,223038
MEMMUS.txt,207957,208227,270,10,N,Y,1448322713112,221941,223038
MEMMUS.txt,207965,208242,277,10,N,Y,1448322713112,221941,223038
MEMMUS.txt,208022,208257,235,10,N,Y,1448322713112,221941,223038
MEMMUS.txt,208039,208276,237,10,N,Y,1448322713112,221941,223038
MEMMUS.txt,208054,208297,243,10,N,Y,1448322713112,221941,223038
MEMMUS.txt,208066,208351,285,10,N,Y,1448322713112,221941,223038
MEMMUS.txt,208110,208365,255,10,N,Y,1448322713112,221941,223038
MEMMUS.txt,208115,208377,262,10,N,Y,1448322713112,221941,223038
MEMMUS.txt,208144,208391,247,10,N,Y,1448322713112,221941,223038
MEMMUS.txt,208200,208403,203,10,N,Y,1448322713112,221941,223038
MEMMUS.txt,208228,208427,199,10,N,Y,1448322713112,221941,223038
MEMMUS.txt,208244,208512,268,10,N,Y,1448322713112,221941,223038
MEMMUS.txt,208258,208527,269,10,N,Y,1448322713112,221941,223038
MEMMUS.txt,208277,208532,255,10,N,Y,1448322713112,221941,223038
MEMMUS.txt,208298,208547,249,10,N,Y,1448322713112,221941,223038
MEMMUS.txt,208354,208579,225,10,N,Y,1448322713112,221941,223038
MEMMUS.txt,208366,208698,332,10,N,Y,1448322713112,221941,223038
MEMMUS.txt,208378,208718,340,10,N,Y,1448322713112,221941,223038
MEMMUS.txt,208392,208725,333,10,N,Y,1448322713112,221941,223038
MEMMUS.txt,208404,208740,336,10,N,Y,1448322713112,221941,223038
MEMMUS.txt,208428,208761,333,10,N,Y,1448322713112,221941,223038
MEMMUS.txt,208515,208775,260,10,N,Y,1448322713112,221941,223038
MEMMUS.txt,208528,208796,268,10,N,Y,1448322713112,221941,223038
MEMMUS.txt,208535,208811,276,10,N,Y,1448322713112,221941,223038
MEMMUS.txt,208548,208855,307,10,N,Y,1448322713112,221941,223038
MEMMUS.txt,208581,208929,348,10,N,Y,1448322713112,221941,223038
MEMMUS.txt,208701,208934,233,10,N,Y,1448322713112,221941,223038
MEMMUS.txt,208719,208940,221,10,N,Y,1448322713112,221941,223038
MEMMUS.txt,208728,208994,266,10,N,Y,1448322713112,221941,223038
MEMMUS.txt,208741,209169,428,10,N,Y,1448322713112,221941,223038
MEMMUS.txt,208764,209244,480,10,N,Y,1448322713112,221941,223038
MEMMUS.txt,208776,209393,617,10,N,Y,1448322713112,221941,223038
MEMMUS.txt,208799,209525,726,10,N,Y,1448322713112,221941,223038
MEMMUS.txt,208812,209676,864,10,N,Y,1448322713112,221941,223038
MEMMUS.txt,208856,209787,931,10,N,Y,1448322713112,221941,223038
MEMMUS.txt,208930,209910,980,10,N,Y,1448322713112,221941,223038
MEMMUS.txt,208936,210214,1278,10,N,Y,1448322713112,221941,223038
MEMMUS.txt,208941,210314,1373,10,N,Y,1448322713112,221941,223038
MEMMUS.txt,209000,210438,1438,10,N,Y,1448322713112,221941,223038
MEMMUS.txt,209170,210673,1503,10,N,Y,1448322713112,221941,223038
MEMMUS.txt,209247,210854,1607,10,Y,Y,1448322713112,221941,223038
MEMMUS.txt,209394,210878,1484,10,Y,Y,1448322713112,221941,223038
MEMMUS.txt,209528,211009,1481,10,Y,N,-,-1,-1
MEMMUS.txt,209677,211059,1382,10,Y,N,-,-1,-1
MEMMUS.txt,209788,211201,1413,10,Y,N,-,-1,-1
MEMMUS.txt,209911,211417,1506,10,Y,N,-,-1,-1
MEMMUS.txt,210217,211548,1331,10,Y,N,-,-1,-1
MEMMUS.txt,210315,211719,1404,10,Y,N,-,-1,-1
MEMMUS.txt,210439,211867,1428,10,Y,N,-,-1,-1
MEMMUS.txt,210676,211978,1302,10,N,N,-,-1,-1
MEMMUS.txt,210855,212025,1170,10,N,N,-,-1,-1
MEMMUS.txt,210879,212111,1232,10,Y,N,-,-1,-1
MEMMUS.txt,211010,212192,1182,10,Y,N,-,-1,-1
MEMMUS.txt,211060,212297,1237,10,N,N,-,-1,-1
MEMMUS.txt,211204,212459,1255,10,N,N,-,-1,-1
MEMMUS.txt,211418,212653,1235,10,N,N,-,-1,-1
MEMMUS.txt,211549,212782,1233,10,Y,N,-,-1,-1
MEMMUS.txt,211720,213032,1312,10,Y,N,-,-1,-1
MEMMUS.txt,211872,213468,1596,10,Y,N,-,-1,-1
MEMMUS.txt,211979,213683,1704,10,Y,N,-,-1,-1
MEMMUS.txt,212027,213808,1781,10,Y,N,-,-1,-1
MEMMUS.txt,212112,213947,1835,10,Y,N,-,-1,-1
MEMMUS.txt,212193,214034,1841,10,Y,N,-,-1,-1
MEMMUS.txt,212298,214093,1795,10,Y,N,-,-1,-1
MEMMUS.txt,212462,214252,1790,10,Y,N,-,-1,-1
MEMMUS.txt,212654,214358,1704,10,Y,Y,1437028092146,121457,123204
MEMMUS.txt,212784,214533,1749,10,Y,Y,1437028092146,121457,123204
MEMMUS.txt,213034,214875,1841,10,Y,Y,1437028092146,121457,123204
MEMMUS.txt,213469,214990,1521,10,N,Y,1437028092146,121457,123204
MEMMUS.txt,213685,215088,1403,10,N,Y,1437028092146,121457,123204
MEMMUS.txt,213811,215179,1368,10,N,Y,1437028092146,121457,123204
MEMMUS.txt,213949,215320,1371,10,N,Y,1437028092146,121457,123204
MEMMUS.txt,214036,215481,1445,10,N,Y,1437028092146,121457,123204
MEMMUS.txt,214094,215548,1454,10,N,Y,1437028092146,121457,123204
MEMMUS.txt,214255,215724,1469,10,N,Y,1437028092146,121457,123204
MEMMUS.txt,214359,215892,1533,10,N,Y,1437028092146,121457,123204
MEMMUS.txt,214534,216029,1495,10,N,Y,1437028092146,121457,123204
MEMMUS.txt,214878,216187,1309,10,N,N,-,-1,-1
MEMMUS.txt,214991,216256,1265,10,N,N,-,-1,-1
MEMMUS.txt,215089,216410,1321,10,N,N,-,-1,-1
MEMMUS.txt,215179,216618,1439,10,N,N,-,-1,-1
MEMMUS.txt,215321,216706,1385,10,N,N,-,-1,-1
MEMMUS.txt,215483,216759,1276,10,N,N,-,-1,-1
MEMMUS.txt,215549,216774,1225,10,N,N,-,-1,-1
MEMMUS.txt,215725,216960,1235,10,N,N,-,-1,-1
MEMMUS.txt,215893,217152,1259,10,N,N,-,-1,-1
MEMMUS.txt,216030,217258,1228,10,N,N,-,-1,-1
MEMMUS.txt,216190,217400,1210,10,N,N,-,-1,-1
MEMMUS.txt,216257,217505,1248,10,N,N,-,-1,-1
MEMMUS.txt,216411,217694,1283,10,N,N,-,-1,-1
MEMMUS.txt,216619,217807,1188,10,N,N,-,-1,-1
MEMMUS.txt,216707,217856,1149,10,N,N,-,-1,-1
MEMMUS.txt,216762,218264,1502,10,Y,N,-,-1,-1
MEMMUS.txt,216775,218387,1612,10,Y,N,-,-1,-1
MEMMUS.txt,216961,218604,1643,10,Y,N,-,-1,-1
MEMMUS.txt,217154,218681,1527,10,Y,N,-,-1,-1
MEMMUS.txt,217259,218829,1570,10,Y,N,-,-1,-1
MEMMUS.txt,217401,218983,1582,10,Y,N,-,-1,-1
MEMMUS.txt,217506,219124,1618,10,Y,N,-,-1,-1
MEMMUS.txt,217695,219219,1524,10,Y,N,-,-1,-1
MEMMUS.txt,217812,219451,1639,10,Y,N,-,-1,-1
MEMMUS.txt,217859,219504,1645,10,Y,N,-,-1,-1
MEMMUS.txt,218267,219746,1479,10,N,N,-,-1,-1
MEMMUS.txt,218388,219882,1494,10,N,N,-,-1,-1
MEMMUS.txt,218605,220018,1413,10,N,N,-,-1,-1
MEMMUS.txt,218682,220077,1395,10,N,N,-,-1,-1
MEMMUS.txt,218830,220260,1430,10,N,N,-,-1,-1
MEMMUS.txt,218984,220308,1324,10,N,N,-,-1,-1
MEMMUS.txt,219127,220539,1412,10,N,N,-,-1,-1
MEMMUS.txt,219221,220948,1727,10,N,N,-,-1,-1
MEMMUS.txt,219452,220982,1530,10,N,N,-,-1,-1
MEMMUS.txt,219506,221084,1578,10,N,N,-,-1,-1
MEMMUS.txt,219747,221203,1456,10,N,N,-,-1,-1
MEMMUS.txt,219885,221505,1620,10,N,N,-,-1,-1
MEMMUS.txt,220021,221608,1587,10,Y,N,-,-1,-1
MEMMUS.txt,220078,221697,1619,10,Y,N,-,-1,-1
MEMMUS.txt,220263,222100,1837,10,Y,N,-,-1,-1
MEMMUS.txt,220310,222194,1884,10,Y,N,-,-1,-1
MEMMUS.txt,220541,222279,1738,10,Y,N,-,-1,-1
MEMMUS.txt,220949,222381,1432,10,Y,N,-,-1,-1
MEMMUS.txt,220985,222539,1554,10,Y,N,-,-1,-1
MEMMUS.txt,221085,222568,1483,10,Y,N,-,-1,-1
MEMMUS.txt,221204,222604,1400,10,Y,N,-,-1,-1
MEMMUS.txt,221508,222797,1289,10,Y,N,-,-1,-1
MEMMUS.txt,221609,222921,1312,10,Y,N,-,-1,-1
MEMMUS.txt,221698,223033,1335,10,Y,N,-,-1,-1
MEMMUS.txt,222101,223245,1144,10,Y,N,-,-1,-1
MEMMUS.txt,222195,223380,1185,10,Y,N,-,-1,-1
MEMMUS.txt,222280,223420,1140,10,Y,N,-,-1,-1
MEMMUS.txt,222382,223495,1113,10,Y,N,-,-1,-1
MEMMUS.txt,222540,223533,993,10,Y,N,-,-1,-1
MEMMUS.txt,222569,223685,1116,10,Y,N,-,-1,-1
MEMMUS.txt,222607,223851,1244,10,Y,N,-,-1,-1
MEMMUS.txt,222798,223963,1165,10,N,N,-,-1,-1
MEMMUS.txt,222924,224066,1142,10,N,Y,1448357431466,233540,233770
MEMMUS.txt,223034,224142,1108,10,N,Y,1448357431466,233540,233770
MEMMUS.txt,223246,224261,1015,10,N,Y,1448357431466,233540,233770
MEMMUS.txt,223381,224459,1078,10,N,Y,1448357431466,233540,233770
MEMMUS.txt,223423,224490,1067,10,N,Y,1448357431466,233540,233770
MEMMUS.txt,223498,224585,1087,10,N,Y,1448357431466,233540,233770
MEMMUS.txt,223534,224719,1185,10,N,Y,1448357431466,233540,233770
MEMMUS.txt,223686,224820,1134,10,N,Y,1448357431466,233540,233770
MEMMUS.txt,223857,224898,1041,10,N,Y,1448357431466,233540,233770
MEMMUS.txt,223966,225048,1082,10,N,Y,1448357431466,233540,233770
MEMMUS.txt,224067,225219,1152,10,N,Y,1448357431466,233540,233770
MEMMUS.txt,224143,225268,1125,10,N,Y,1448357431466,233540,233770
MEMMUS.txt,224262,225437,1175,10,N,Y,1448357431466,233540,233770
MEMMUS.txt,224460,225528,1068,10,N,Y,1448357431466,233540,233770
MEMMUS.txt,224492,225588,1096,10,N,Y,1437490253936,460795,462238
MEMMUS.txt,224586,225682,1096,10,N,Y,1437490253936,460795,462238
MEMMUS.txt,224720,225836,1116,10,N,Y,1437490253936,460795,462238
MEMMUS.txt,224821,225902,1081,10,N,Y,1437490253936,460795,462238
MEMMUS.txt,224898,225989,1091,10,N,Y,1437490253936,460795,462238
MEMMUS.txt,225051,226130,1079,10,N,Y,1437490253936,460795,462238
MEMMUS.txt,225220,226242,1022,10,N,Y,1437490253936,460795,462238
MEMMUS.txt,225270,226368,1098,10,N,Y,1437490253936,460795,462238
MEMMUS.txt,225438,226454,1016,10,N,Y,1437490253936,460795,462238
MEMMUS.txt,225531,226584,1053,10,N,Y,1437490253936,460795,462238
MEMMUS.txt,225589,226665,1076,10,N,Y,1437490253936,460795,462238
MEMMUS.txt,225683,226841,1158,10,N,Y,1437490253936,460795,462238
MEMMUS.txt,225839,226916,1077,10,N,Y,1437490253936,460795,462238
MEMMUS.txt,225903,227043,1140,10,N,Y,1437490253936,460795,462238
MEMMUS.txt,225990,227137,1147,10,N,Y,1437490253936,460795,462238
MEMMUS.txt,226133,227359,1226,10,N,Y,1448314402792,179959,180202
MEMMUS.txt,226243,227533,1290,10,N,Y,1448314402792,179959,180202
MEMMUS.txt,226369,227782,1413,10,N,Y,1448314402792,179959,180202
MEMMUS.txt,226456,228050,1594,10,N,Y,1448314402792,179959,180202
MEMMUS.txt,226585,228174,1589,10,N,Y,1448314402792,179959,180202
MEMMUS.txt,226668,228365,1697,10,N,Y,1448314402792,179959,180202
MEMMUS.txt,226842,228514,1672,10,N,Y,1448314402792,179959,180202
MEMMUS.txt,226917,228682,1765,10,N,Y,1448314402792,179959,180202
MEMMUS.txt,227044,228839,1795,10,N,Y,1448314402792,179959,180202
MEMMUS.txt,227138,228902,1764,10,N,Y,1448314402792,179959,180202
MEMMUS.txt,227360,229065,1705,10,N,Y,1448314402792,179959,180202
MEMMUS.txt,227534,229244,1710,10,N,Y,1448314402792,179959,180202
MEMMUS.txt,227783,229404,1621,10,N,Y,1448314402792,179959,180202
MEMMUS.txt,228053,229480,1427,10,N,Y,1448314402792,179959,180202
MEMMUS.txt,228177,229674,1497,10,N,Y,1448314402792,179959,180202
MEMMUS.txt,228366,229821,1455,10,N,Y,1448314402792,179959,180202
MEMMUS.txt,228515,229978,1463,10,N,Y,1448314402792,179959,180202
MEMMUS.txt,228685,230123,1438,10,N,Y,1448314402792,179959,180202
MEMMUS.txt,228842,230197,1355,10,N,N,-,-1,-1
MEMMUS.txt,228903,230262,1359,10,N,N,-,-1,-1
MEMMUS.txt,229066,230355,1289,10,N,N,-,-1,-1
MEMMUS.txt,229245,230489,1244,10,N,N,-,-1,-1
MEMMUS.txt,229406,230610,1204,10,N,N,-,-1,-1
MEMMUS.txt,229481,230815,1334,10,N,N,-,-1,-1
MEMMUS.txt,229675,231026,1351,10,N,N,-,-1,-1
MEMMUS.txt,229824,231088,1264,10,N,N,-,-1,-1
MEMMUS.txt,229981,231194,1213,10,N,N,-,-1,-1
MEMMUS.txt,230124,231370,1246,10,N,N,-,-1,-1
MEMMUS.txt,230198,231499,1301,10,N,N,-,-1,-1
MEMMUS.txt,230263,231621,1358,10,Y,N,-,-1,-1
MEMMUS.txt,230356,231668,1312,10,Y,N,-,-1,-1
MEMMUS.txt,230492,232114,1622,10,Y,N,-,-1,-1
MEMMUS.txt,230611,232255,1644,10,Y,N,-,-1,-1
MEMMUS.txt,230818,232419,1601,10,Y,N,-,-1,-1
MEMMUS.txt,231027,232608,1581,10,Y,N,-,-1,-1
MEMMUS.txt,231091,232889,1798,10,Y,N,-,-1,-1
MEMMUS.txt,231197,232918,1721,10,Y,N,-,-1,-1
MEMMUS.txt,231371,232987,1616,10,Y,N,-,-1,-1
MEMMUS.txt,231500,233097,1597,10,Y,N,-,-1,-1
MEMMUS.txt,231622,233300,1678,10,N,N,-,-1,-1
MEMMUS.txt,231671,233418,1747,10,N,N,-,-1,-1
MEMMUS.txt,232115,233575,1460,10,N,N,-,-1,-1
MEMMUS.txt,232258,233765,1507,10,N,N,-,-1,-1
MEMMUS.txt,232424,233844,1420,10,N,N,-,-1,-1
MEMMUS.txt,232609,233882,1273,10,N,N,-,-1,-1
MEMMUS.txt,232890,234046,1156,10,N,N,-,-1,-1
MEMMUS.txt,232919,234176,1257,10,N,N,-,-1,-1
MEMMUS.txt,232988,234274,1286,10,N,N,-,-1,-1
MEMMUS.txt,233098,234428,1330,10,N,N,-,-1,-1
MEMMUS.txt,233301,234629,1328,10,N,N,-,-1,-1
MEMMUS.txt,233421,234884,1463,10,N,N,-,-1,-1
MEMMUS.txt,233576,234945,1369,10,N,N,-,-1,-1
MEMMUS.txt,233766,235153,1387,10,N,N,-,-1,-1
MEMMUS.txt,233849,235237,1388,10,N,N,-,-1,-1
MEMMUS.txt,233885,235435,1550,10,N,N,-,-1,-1
MEMMUS.txt,234047,235521,1474,10,N,N,-,-1,-1
MEMMUS.txt,234177,235615,1438,10,N,N,-,-1,-1
MEMMUS.txt,234275,235735,1460,10,N,N,-,-1,-1
MEMMUS.txt,234429,235966,1537,10,N,N,-,-1,-1
MEMMUS.txt,234632,236096,1464,10,N,N,-,-1,-1
MEMMUS.txt,234885,236444,1559,10,N,N,-,-1,-1
MEMMUS.txt,234946,236629,1683,10,N,N,-,-1,-1
MEMMUS.txt,235154,236707,1553,10,N,N,-,-1,-1
MEMMUS.txt,235240,236783,1543,10,N,N,-,-1,-1
MEMMUS.txt,235437,236894,1457,10,N,N,-,-1,-1
MEMMUS.txt,235524,237087,1563,10,N,N,-,-1,-1
MEMMUS.txt,235616,237355,1739,10,N,N,-,-1,-1
MEMMUS.txt,235738,237666,1928,10,N,N,-,-1,-1
MEMMUS.txt,235968,237837,1869,10,N,N,-,-1,-1
MEMMUS.txt,236097,238009,1912,10,N,N,-,-1,-1
MEMMUS.txt,236445,238437,1992,10,N,N,-,-1,-1
MEMMUS.txt,236630,238956,2326,10,N,N,-,-1,-1
MEMMUS.txt,236708,239035,2327,10,N,N,-,-1,-1
MEMMUS.txt,236786,239285,2499,10,N,N,-,-1,-1
MEMMUS.txt,236897,239571,2674,10,N,N,-,-1,-1
MEMMUS.txt,237089,239636,2547,10,N,N,-,-1,-1
MEMMUS.txt,237358,239736,2378,10,N,N,-,-1,-1
MEMMUS.txt,237667,239978,2311,10,N,N,-,-1,-1
MEMMUS.txt,237840,240035,2195,10,N,N,-,-1,-1
MEMMUS.txt,238010,240139,2129,10,N,N,-,-1,-1
MEMMUS.txt,238438,240321,1883,10,N,N,-,-1,-1
MEMMUS.txt,238957,240418,1461,10,N,N,-,-1,-1
MEMMUS.txt,239036,240648,1612,10,N,Y,1448282044001,101941,102395
MEMMUS.txt,239290,240753,1463,10,N,Y,1448282044001,101941,102395
MEMMUS.txt,239572,240945,1373,10,N,Y,1448282044001,101941,102395
MEMMUS.txt,239639,241246,1607,10,Y,Y,1448282044001,101941,102395
MEMMUS.txt,239737,241352,1615,10,Y,Y,1448282044001,101941,102395
MEMMUS.txt,239979,241430,1451,10,Y,Y,1448282044001,101941,102395
MEMMUS.txt,240036,241628,1592,10,Y,Y,1448282044001,101941,102395
MEMMUS.txt,240140,241797,1657,10,Y,Y,1448282044001,101941,102395
MEMMUS.txt,240322,241854,1532,10,Y,Y,1448282044001,101941,102395
MEMMUS.txt,240420,242011,1591,10,Y,Y,1448282044001,101941,102395
MEMMUS.txt,240649,242163,1514,10,Y,Y,1448282044001,101941,102395
MEMMUS.txt,240756,242312,1556,10,Y,Y,1448282044001,101941,102395
MEMMUS.txt,240946,242455,1509,10,Y,Y,1448282044001,101941,102395
MEMMUS.txt,241249,242514,1265,10,N,Y,1448282044001,101941,102395
MEMMUS.txt,241353,242571,1218,10,N,Y,1448282044001,101941,102395
MEMMUS.txt,241432,242868,1436,10,N,N,-,-1,-1
MEMMUS.txt,241629,243006,1377,10,N,N,-,-1,-1
MEMMUS.txt,241798,243209,1411,10,N,N,-,-1,-1
MEMMUS.txt,241856,243385,1529,10,N,N,-,-1,-1
MEMMUS.txt,242012,243513,1501,10,N,Y,1448281071558,89330,89524
MEMMUS.txt,242165,243630,1465,10,N,Y,1448281071558,89330,89524
MEMMUS.txt,242313,243908,1595,10,N,Y,1448281071558,89330,89524
MEMMUS.txt,242458,243980,1522,10,N,Y,1448281071558,89330,89524
MEMMUS.txt,242515,244043,1528,10,Y,Y,1448281071558,89330,89524
MEMMUS.txt,242572,244104,1532,10,Y,Y,1448281071558,89330,89524
MEMMUS.txt,242870,244249,1379,10,Y,Y,1448279813455,71525,72226
MEMMUS.txt,243009,244453,1444,10,Y,Y,1448279813455,71525,72226
MEMMUS.txt,243212,244646,1434,10,Y,Y,1448279813455,71525,72226
MEMMUS.txt,243388,244830,1442,10,N,Y,1448279813455,71525,72226
MEMMUS.txt,243514,244964,1450,10,Y,Y,1448279813455,71525,72226
MEMMUS.txt,243631,245065,1434,10,Y,Y,1448279813455,71525,72226
MEMMUS.txt,243911,245331,1420,10,N,Y,1448279813455,71525,72226
MEMMUS.txt,243981,245449,1468,10,Y,Y,1437470299748,152207,152889
MEMMUS.txt,244045,245601,1556,10,Y,Y,1437470299748,152207,152889
MEMMUS.txt,244107,245741,1634,10,Y,Y,1437470299748,152207,152889
MEMMUS.txt,244250,245864,1614,10,Y,Y,1437470299748,152207,152889
MEMMUS.txt,244456,245990,1534,10,Y,Y,1437470299748,152207,152889
MEMMUS.txt,244647,246123,1476,10,Y,Y,1437470299748,152207,152889
MEMMUS.txt,244831,246226,1395,10,N,Y,1437470299748,152207,152889
MEMMUS.txt,244965,246391,1426,10,N,Y,1437470299748,152207,152889
MEMMUS.txt,245068,246456,1388,10,N,Y,1437470299748,152207,152889
MEMMUS.txt,245334,246498,1164,10,N,Y,1437470299748,152207,152889
MEMMUS.txt,245450,246549,1099,10,N,Y,1437470299748,152207,152889
MEMMUS.txt,245604,246678,1074,10,N,Y,1437470299748,152207,152889
MEMMUS.txt,245743,246942,1199,10,N,Y,1437470299748,152207,152889
MEMMUS.txt,245865,247133,1268,10,N,Y,1437470299748,152207,152889
MEMMUS.txt,245991,247289,1298,10,N,Y,1437470299748,152207,152889
MEMMUS.txt,246126,247473,1347,10,N,Y,1437470299748,152207,152889
MEMMUS.txt,246227,247559,1332,10,N,Y,1437470299748,152207,152889
MEMMUS.txt,246392,247697,1305,10,N,N,-,-1,-1
MEMMUS.txt,246457,247969,1512,10,Y,Y,1448312968013,174511,175025
MEMMUS.txt,246499,248216,1717,10,Y,Y,1448312968013,174511,175025
MEMMUS.txt,246550,248338,1788,10,Y,Y,1448312968013,174511,175025
MEMMUS.txt,246681,248499,1818,10,Y,Y,1448312968013,174511,175025
MEMMUS.txt,246943,248717,1774,10,Y,Y,1448312968013,174511,175025
MEMMUS.txt,247134,249120,1986,10,Y,Y,1448312968013,174511,175025
MEMMUS.txt,247291,249222,1931,10,Y,Y,1448312968013,174511,175025
MEMMUS.txt,247474,249431,1957,10,Y,Y,1448312968013,174511,175025
MEMMUS.txt,247560,249654,2094,10,Y,Y,1448312968013,174511,175025
MEMMUS.txt,247700,249789,2089,10,Y,Y,1448312968013,174511,175025
MEMMUS.txt,247970,249955,1985,10,Y,Y,1448312968013,174511,175025
MEMMUS.txt,248219,250149,1930,10,Y,Y,1448312968013,174511,175025
MEMMUS.txt,248339,250264,1925,10,Y,Y,1448312968013,174511,175025
MEMMUS.txt,248500,250412,1912,10,Y,Y,1448287490368,120754,123385
MEMMUS.txt,248718,250447,1729,10,Y,Y,1448287490368,120754,123385
MEMMUS.txt,249123,250547,1424,10,Y,Y,1448287490368,120754,123385
MEMMUS.txt,249225,250618,1393,10,Y,Y,1448287490368,120754,123385
MEMMUS.txt,249432,250765,1333,10,Y,Y,1448287490368,120754,123385
MEMMUS.txt,249655,250886,1231,10,Y,Y,1448287490368,120754,123385
MEMMUS.txt,249790,251241,1451,10,Y,Y,1448287490368,120754,123385
MEMMUS.txt,249957,251306,1349,10,Y,Y,1448287490368,120754,123385
MEMMUS.txt,250150,251388,1238,10,Y,Y,1448287490368,120754,123385
MEMMUS.txt,250267,251481,1214,10,Y,Y,1448287490368,120754,123385
MEMMUS.txt,250413,251625,1212,10,Y,Y,1448287490368,120754,123385
MEMMUS.txt,250448,251993,1545,10,Y,Y,1448287490368,120754,123385
MEMMUS.txt,250548,252075,1527,10,Y,Y,1448287490368,120754,123385
MEMMUS.txt,250619,252249,1630,10,Y,Y,1448287490368,120754,123385
MEMMUS.txt,250767,252418,1651,10,Y,Y,1448287490368,120754,123385
MEMMUS.txt,250889,252608,1719,10,Y,Y,1448287490368,120754,123385
MEMMUS.txt,251242,252903,1661,10,N,Y,1448287490368,120754,123385
MEMMUS.txt,251307,252947,1640,10,N,Y,1448287490368,120754,123385
MEMMUS.txt,251389,253073,1684,10,N,Y,1448287490368,120754,123385
MEMMUS.txt,251482,253281,1799,10,N,Y,1448311594480,155711,156312
MEMMUS.txt,251628,253426,1798,10,N,Y,1448311594480,155711,156312
MEMMUS.txt,251996,253564,1568,10,N,Y,1448311594480,155711,156312
MEMMUS.txt,252076,253833,1757,10,N,Y,1448311594480,155711,156312
MEMMUS.txt,252250,254083,1833,10,N,Y,1448311594480,155711,156312
MEMMUS.txt,252421,254100,1679,10,N,Y,1448311594480,155711,156312
MEMMUS.txt,252611,254119,1508,10,N,Y,1448311594480,155711,156312
MEMMUS.txt,252904,254122,1218,10,N,Y,1448311594480,155711,156312
MEMMUS.txt,252948,254184,1236,10,N,Y,1448311594480,155711,156312
MEMMUS.txt,253076,254337,1261,10,N,Y,1448311594480,155711,156312
MEMMUS.txt,253284,254457,1173,10,N,Y,1448311594480,155711,156312
MEMMUS.txt,253429,254615,1186,10,N,Y,1448311594480,155711,156312
MEMMUS.txt,253567,254777,1210,10,N,Y,1448311594480,155711,156312
MEMMUS.txt,253834,254819,985,10,N,Y,1448311594480,155711,156312
MEMMUS.txt,254084,254857,773,10,N,Y,1448311594480,155711,156312
MEMMUS.txt,254101,254950,849,10,N,Y,1448311594480,155711,156312
MEMMUS.txt,254120,255124,1004,10,N,Y,1448311594480,155711,156312
MEMMUS.txt,254123,255342,1219,10,N,Y,1448311594480,155711,156312
MEMMUS.txt,254187,255510,1323,10,N,Y,1448311594480,155711,156312
MEMMUS.txt,254338,255589,1251,10,N,N,-,-1,-1
MEMMUS.txt,254458,255692,1234,10,Y,N,-,-1,-1
MEMMUS.txt,254618,255857,1239,10,Y,N,-,-1,-1
MEMMUS.txt,254778,255949,1171,10,Y,N,-,-1,-1
MEMMUS.txt,254820,256116,1296,10,Y,N,-,-1,-1
MEMMUS.txt,254858,256182,1324,10,Y,N,-,-1,-1
MEMMUS.txt,254951,256360,1409,10,Y,N,-,-1,-1
MEMMUS.txt,255126,256471,1345,10,Y,N,-,-1,-1
MEMMUS.txt,255345,256582,1237,10,Y,N,-,-1,-1
MEMMUS.txt,255511,257022,1511,10,Y,N,-,-1,-1
MEMMUS.txt,255590,257148,1558,10,Y,N,-,-1,-1
MEMMUS.txt,255693,257268,1575,10,Y,N,-,-1,-1
MEMMUS.txt,255858,257384,1526,10,Y,N,-,-1,-1
MEMMUS.txt,255950,257434,1484,10,Y,N,-,-1,-1
MEMMUS.txt,256117,257654,1537,10,Y,N,-,-1,-1
MEMMUS.txt,256185,257856,1671,10,Y,Y,1448313123004,175370,176057
MEMMUS.txt,256361,258075,1714,10,Y,Y,1448313123004,175370,176057
MEMMUS.txt,256472,258226,1754,10,N,Y,1448313123004,175370,176057
MEMMUS.txt,256587,258397,1810,10,N,Y,1448313123004,175370,176057
MEMMUS.txt,257025,258552,1527,10,N,Y,1448313123004,175370,176057
MEMMUS.txt,257149,258749,1600,10,N,Y,1448313123004,175370,176057
MEMMUS.txt,257269,258962,1693,10,Y,Y,1448357159811,231190,232925
MEMMUS.txt,257385,259117,1732,10,Y,Y,1448357159811,231190,232925
MEMMUS.txt,257435,259247,1812,10,Y,Y,1448357159811,231190,232925
MEMMUS.txt,257655,259594,1939,10,Y,Y,1448357159811,231190,232925
MEMMUS.txt,257857,259740,1883,10,Y,Y,1448357159811,231190,232925
MEMMUS.txt,258077,259876,1799,10,Y,Y,1448357159811,231190,232925
MEMMUS.txt,258227,260004,1777,10,Y,Y,1448357159811,231190,232925
MEMMUS.txt,258400,260138,1738,10,Y,Y,1448357159811,231190,232925
MEMMUS.txt,258553,260197,1644,10,Y,Y,1448357159811,231190,232925
MEMMUS.txt,258752,260335,1583,10,N,Y,1448038803075,18895,19670
MEMMUS.txt,258963,260453,1490,10,N,Y,1448038803075,18895,19670
MEMMUS.txt,259119,260692,1573,10,N,Y,1448038803075,18895,19670
MEMMUS.txt,259248,260805,1557,10,N,Y,1448038803075,18895,19670
MEMMUS.txt,259595,260839,1244,10,N,Y,1448038803075,18895,19670
MEMMUS.txt,259743,260920,1177,10,N,Y,1448038803075,18895,19670
MEMMUS.txt,259878,261075,1197,10,N,Y,1448038803075,18895,19670
MEMMUS.txt,260005,261231,1226,10,N,Y,1448038803075,18895,19670
MEMMUS.txt,260139,261352,1213,10,N,Y,1448038803075,18895,19670
MEMMUS.txt,260200,261469,1269,10,N,Y,1448038803075,18895,19670
MEMMUS.txt,260337,261550,1213,10,N,Y,1448038803075,18895,19670
MEMMUS.txt,260454,261652,1198,10,Y,Y,1448038803075,18895,19670
MEMMUS.txt,260693,261772,1079,10,Y,Y,1448038803075,18895,19670
MEMMUS.txt,260806,261930,1124,10,Y,Y,1448038803075,18895,19670
MEMMUS.txt,260842,262130,1288,10,Y,Y,1448038803075,18895,19670
MEMMUS.txt,260921,262179,1258,10,Y,Y,1448038803075,18895,19670
MEMMUS.txt,261076,262240,1164,10,Y,Y,1448280297446,84055,84972
MEMMUS.txt,261234,262354,1120,10,Y,Y,1448280297446,84055,84972
MEMMUS.txt,261353,262501,1148,10,Y,Y,1448280297446,84055,84972
MEMMUS.txt,261470,262645,1175,10,Y,Y,1448280297446,84055,84972
MEMMUS.txt,261552,262955,1403,10,Y,Y,1448280297446,84055,84972
MEMMUS.txt,261653,263114,1461,10,Y,Y,1448280297446,84055,84972
MEMMUS.txt,261775,263217,1442,10,Y,Y,1448280673594,87462,88501
MEMMUS.txt,261931,263292,1361,10,N,Y,1448280673594,87462,88501
MEMMUS.txt,262131,263598,1467,10,Y,Y,1448280673594,87462,88501
MEMMUS.txt,262182,263735,1553,10,Y,Y,1448280673594,87462,88501
MEMMUS.txt,262241,263817,1576,10,Y,Y,1448280673594,87462,88501
MEMMUS.txt,262355,264045,1690,10,Y,Y,1448280673594,87462,88501
MEMMUS.txt,262503,264146,1643,10,Y,Y,1448280673594,87462,88501
MEMMUS.txt,262648,264366,1718,10,Y,Y,1448280673594,87462,88501
MEMMUS.txt,262956,264524,1568,10,Y,Y,1448280673594,87462,88501
MEMMUS.txt,263116,264732,1616,10,Y,Y,1448280673594,87462,88501
MEMMUS.txt,263218,264792,1574,10,Y,Y,1448280673594,87462,88501
MEMMUS.txt,263293,264946,1653,10,Y,Y,1448280673594,87462,88501
MEMMUS.txt,263601,265065,1464,10,N,Y,1448280673594,87462,88501
MEMMUS.txt,263736,265279,1543,10,N,Y,1448280673594,87462,88501
MEMMUS.txt,263818,265524,1706,10,N,Y,1448280673594,87462,88501
MEMMUS.txt,264046,265689,1643,10,N,Y,1448280673594,87462,88501
MEMMUS.txt,264147,265849,1702,10,N,Y,1448280673594,87462,88501
MEMMUS.txt,264367,265958,1591,10,N,Y,1448280673594,87462,88501
MEMMUS.txt,264525,266051,1526,10,N,Y,1448280673594,87462,88501
MEMMUS.txt,264733,266213,1480,10,N,Y,1448280673594,87462,88501
MEMMUS.txt,264795,266351,1556,10,N,N,-,-1,-1
MEMMUS.txt,264951,266572,1621,10,N,Y,1448315012079,181380,182053
MEMMUS.txt,265066,266740,1674,10,N,Y,1448315012079,181380,182053
MEMMUS.txt,265280,266810,1530,10,N,Y,1448315012079,181380,182053
MEMMUS.txt,265526,266929,1403,10,Y,Y,1448315012079,181380,182053
MEMMUS.txt,265692,267006,1314,10,Y,Y,1448315012079,181380,182053
MEMMUS.txt,265850,267077,1227,10,Y,Y,1448315012079,181380,182053
MEMMUS.txt,265959,267480,1521,10,Y,Y,1448315012079,181380,182053
MEMMUS.txt,266054,267589,1535,10,Y,Y,1448315012079,181380,182053
MEMMUS.txt,266214,267713,1499,10,Y,Y,1448315012079,181380,182053
MEMMUS.txt,266356,267894,1538,10,Y,Y,1448315012079,181380,182053
MEMMUS.txt,266573,268019,1446,10,Y,Y,1448315012079,181380,182053
MEMMUS.txt,266741,268080,1339,10,Y,Y,1448315012079,181380,182053
MEMMUS.txt,266811,268212,1401,10,Y,Y,1448315012079,181380,182053
MEMMUS.txt,266930,268302,1372,10,N,Y,1448315012079,181380,182053
MEMMUS.txt,267007,268511,1504,10,N,Y,1448315012079,181380,182053
MEMMUS.txt,267080,268663,1583,10,N,N,-,-1,-1
MEMMUS.txt,267481,268821,1340,10,N,N,-,-1,-1
MEMMUS.txt,267590,268958,1368,10,N,N,-,-1,-1
MEMMUS.txt,267716,269468,1752,10,N,N,-,-1,-1
MEMMUS.txt,267895,269532,1637,10,N,N,-,-1,-1
MEMMUS.txt,268020,269574,1554,10,N,N,-,-1,-1
MEMMUS.txt,268081,269679,1598,10,N,N,-,-1,-1
MEMMUS.txt,268215,269809,1594,10,N,N,-,-1,-1
MEMMUS.txt,268303,269923,1620,10,N,N,-,-1,-1
MEMMUS.txt,268512,270061,1549,10,N,N,-,-1,-1
MEMMUS.txt,268664,270275,1611,10,N,N,-,-1,-1
MEMMUS.txt,268822,270345,1523,10,N,N,-,-1,-1
MEMMUS.txt,268961,270433,1472,10,N,N,-,-1,-1
MEMMUS.txt,269471,270481,1010,10,N,N,-,-1,-1
MEMMUS.txt,269533,270630,1097,10,N,N,-,-1,-1
MEMMUS.txt,269575,270774,1199,10,N,N,-,-1,-1
MEMMUS.txt,269680,270853,1173,10,N,N,-,-1,-1
MEMMUS.txt,269812,270986,1174,10,N,N,-,-1,-1
MEMMUS.txt,269926,271058,1132,10,N,N,-,-1,-1
MEMMUS.txt,270062,271127,1065,10,N,N,-,-1,-1
MEMMUS.txt,270278,271317,1039,10,N,N,-,-1,-1
MEMMUS.txt,270346,271508,1162,10,N,N,-,-1,-1
MEMMUS.txt,270434,271677,1243,10,N,N,-,-1,-1
MEMMUS.txt,270482,271877,1395,10,N,N,-,-1,-1
MEMMUS.txt,270631,272029,1398,10,N,N,-,-1,-1
MEMMUS.txt,270775,272211,1436,10,N,N,-,-1,-1
MEMMUS.txt,270856,272386,1530,10,Y,N,-,-1,-1
MEMMUS.txt,270987,272715,1728,10,N,N,-,-1,-1
MEMMUS.txt,271059,272836,1777,10,Y,N,-,-1,-1
MEMMUS.txt,271130,272987,1857,10,Y,N,-,-1,-1
MEMMUS.txt,271319,273169,1850,10,Y,N,-,-1,-1
MEMMUS.txt,271509,273241,1732,10,Y,N,-,-1,-1
MEMMUS.txt,271680,273527,1847,10,Y,N,-,-1,-1
MEMMUS.txt,271878,273621,1743,10,Y,N,-,-1,-1
MEMMUS.txt,272034,273734,1700,10,Y,N,-,-1,-1
MEMMUS.txt,272213,273788,1575,10,Y,N,-,-1,-1
MEMMUS.txt,272387,273864,1477,10,N,N,-,-1,-1
MEMMUS.txt,272716,273966,1250,10,N,N,-,-1,-1
MEMMUS.txt,272837,274071,1234,10,N,N,-,-1,-1
MEMMUS.txt,272992,274105,1113,10,N,N,-,-1,-1
MEMMUS.txt,273172,274148,976,10,N,N,-,-1,-1
MEMMUS.txt,273242,274204,962,10,N,N,-,-1,-1
MEMMUS.txt,273528,274258,730,10,N,N,-,-1,-1
MEMMUS.txt,273622,274355,733,10,N,N,-,-1,-1
MEMMUS.txt,273737,274811,1074,10,N,N,-,-1,-1
MEMMUS.txt,273791,274928,1137,10,N,N,-,-1,-1
MEMMUS.txt,273865,275097,1232,10,N,N,-,-1,-1
MEMMUS.txt,273967,275236,1269,10,N,N,-,-1,-1
MEMMUS.txt,274073,275359,1286,10,N,N,-,-1,-1
MEMMUS.txt,274106,275606,1500,10,N,N,-,-1,-1
MEMMUS.txt,274149,275696,1547,10,N,N,-,-1,-1
MEMMUS.txt,274205,275997,1792,10,N,N,-,-1,-1
MEMMUS.txt,274259,276170,1911,10,N,N,-,-1,-1
MEMMUS.txt,274360,276264,1904,10,N,N,-,-1,-1
MEMMUS.txt,274814,276314,1500,10,N,N,-,-1,-1
MEMMUS.txt,274929,276536,1607,10,Y,Y,1448323072174,227638,227786
MEMMUS.txt,275099,276789,1690,10,Y,Y,1448323072174,227638,227786
MEMMUS.txt,275238,276953,1715,10,Y,Y,1448323072174,227638,227786
MEMMUS.txt,275360,277172,1812,10,Y,Y,1448323072174,227638,227786
MEMMUS.txt,275611,277383,1772,10,Y,Y,1448323072174,227638,227786
MEMMUS.txt,275699,277483,1784,10,N,Y,1448323072174,227638,227786
MEMMUS.txt,275998,277541,1543,10,N,Y,1448323072174,227638,227786
MEMMUS.txt,276171,277684,1513,10,N,Y,1448323072174,227638,227786
MEMMUS.txt,276265,277788,1523,10,N,Y,1448323072174,227638,227786
MEMMUS.txt,276317,277975,1658,10,N,Y,1448323072174,227638,227786
MEMMUS.txt,276537,278023,1486,10,N,Y,1448323072174,227638,227786
MEMMUS.txt,276790,278240,1450,10,N,Y,1448323072174,227638,227786
MEMMUS.txt,276954,278300,1346,10,N,Y,1448323072174,227638,227786
MEMMUS.txt,277173,278463,1290,10,N,Y,1448323072174,227638,227786
MEMMUS.txt,277384,278626,1242,10,N,Y,1448323072174,227638,227786
MEMMUS.txt,277486,278771,1285,10,N,Y,1448323072174,227638,227786
MEMMUS.txt,277542,278942,1400,10,N,Y,1448323072174,227638,227786
MEMMUS.txt,277685,279001,1316,10,N,Y,1448323072174,227638,227786
MEMMUS.txt,277789,279141,1352,10,N,Y,1448323072174,227638,227786
MEMMUS.txt,277976,279229,1253,10,N,Y,1448323072174,227638,227786
MEMMUS.txt,278024,279369,1345,10,N,Y,1448323072174,227638,227786
MEMMUS.txt,278243,279509,1266,10,N,N,-,-1,-1
MEMMUS.txt,278301,279608,1307,10,N,N,-,-1,-1
MEMMUS.txt,278464,279746,1282,10,N,N,-,-1,-1
MEMMUS.txt,278627,279805,1178,10,N,N,-,-1,-1
MEMMUS.txt,278774,279892,1118,10,N,N,-,-1,-1
MEMMUS.txt,278943,280105,1162,10,N,N,-,-1,-1
MEMMUS.txt,279002,280237,1235,10,N,N,-,-1,-1
MEMMUS.txt,279142,280507,1365,10,N,N,-,-1,-1
MEMMUS.txt,279230,280662,1432,10,N,N,-,-1,-1
MEMMUS.txt,279370,280879,1509,10,N,N,-,-1,-1
MEMMUS.txt,279510,281000,1490,10,N,N,-,-1,-1
MEMMUS.txt,279609,281166,1557,10,N,N,-,-1,-1
MEMMUS.txt,279747,281270,1523,10,N,N,-,-1,-1
MEMMUS.txt,279806,281389,1583,10,N,N,-,-1,-1
MEMMUS.txt,279897,281481,1584,10,N,N,-,-1,-1
MEMMUS.txt,280107,281647,1540,10,N,Y,1448367094347,278355,278591
MEMMUS.txt,280238,281792,1554,10,N,Y,1448367094347,278355,278591
MEMMUS.txt,280508,281889,1381,10,Y,Y,1448367094347,278355,278591
MEMMUS.txt,280663,282136,1473,10,Y,Y,1448367094347,278355,278591
MEMMUS.txt,280881,282351,1470,10,Y,Y,1448367094347,278355,278591
MEMMUS.txt,281001,282414,1413,10,Y,Y,1448367094347,278355,278591
MEMMUS.txt,281167,282513,1346,10,Y,Y,1448367094347,278355,278591
MEMMUS.txt,281271,282688,1417,10,Y,Y,1448367094347,278355,278591
MEMMUS.txt,281390,282869,1479,10,Y,Y,1448367094347,278355,278591
MEMMUS.txt,281484,283155,1671,10,Y,Y,1448367094347,278355,278591
MEMMUS.txt,281648,283411,1763,10,Y,Y,1448367094347,278355,278591
MEMMUS.txt,281793,283512,1719,10,Y,Y,1448367094347,278355,278591
MEMMUS.txt,281890,283744,1854,10,Y,Y,1448367094347,278355,278591
MEMMUS.txt,282139,283852,1713,10,Y,Y,1448367094347,278355,278591
MEMMUS.txt,282352,284066,1714,10,Y,Y,1448367094347,278355,278591
MEMMUS.txt,282415,284387,1972,10,Y,Y,1448367094347,278355,278591
MEMMUS.txt,282516,284547,2031,10,Y,N,-,-1,-1
MEMMUS.txt,282689,284717,2028,10,Y,N,-,-1,-1
MEMMUS.txt,282870,285001,2131,10,Y,N,-,-1,-1
MEMMUS.txt,283158,285153,1995,10,Y,N,-,-1,-1
MEMMUS.txt,283412,285297,1885,10,Y,N,-,-1,-1
MEMMUS.txt,283513,285427,1914,10,Y,N,-,-1,-1
MEMMUS.txt,283747,285662,1915,10,Y,N,-,-1,-1
MEMMUS.txt,283853,285756,1903,10,Y,N,-,-1,-1
MEMMUS.txt,284069,286023,1954,10,Y,N,-,-1,-1
MEMMUS.txt,284388,286136,1748,10,Y,N,-,-1,-1
MEMMUS.txt,284550,286407,1857,10,Y,N,-,-1,-1
MEMMUS.txt,284718,286742,2024,10,Y,N,-,-1,-1
MEMMUS.txt,285004,287077,2073,10,Y,N,-,-1,-1
MEMMUS.txt,285154,287159,2005,10,Y,N,-,-1,-1
MEMMUS.txt,285298,287378,2080,10,N,N,-,-1,-1
MEMMUS.txt,285430,287549,2119,10,Y,N,-,-1,-1
MEMMUS.txt,285663,287604,1941,10,N,N,-,-1,-1
MEMMUS.txt,285757,287715,1958,10,Y,N,-,-1,-1
MEMMUS.txt,286024,287921,1897,10,Y,N,-,-1,-1
MEMMUS.txt,286137,288093,1956,10,Y,N,-,-1,-1
MEMMUS.txt,286410,288126,1716,10,N,N,-,-1,-1
MEMMUS.txt,286743,288322,1579,10,N,N,-,-1,-1
MEMMUS.txt,287082,288513,1431,10,N,N,-,-1,-1
MEMMUS.txt,287160,288790,1630,10,N,N,-,-1,-1
MEMMUS.txt,287379,288940,1561,10,N,N,-,-1,-1
MEMMUS.txt,287550,288993,1443,10,N,N,-,-1,-1
MEMMUS.txt,287605,289119,1514,10,N,N,-,-1,-1
MEMMUS.txt,287716,289164,1448,10,N,N,-,-1,-1
MEMMUS.txt,287922,289362,1440,10,N,N,-,-1,-1
MEMMUS.txt,288094,289486,1392,10,N,N,-,-1,-1
MEMMUS.txt,288129,289588,1459,10,N,N,-,-1,-1
MEMMUS.txt,288323,289736,1413,10,N,N,-,-1,-1
MEMMUS.txt,288518,289877,1359,10,N,N,-,-1,-1
MEMMUS.txt,288791,290013,1222,10,N,N,-,-1,-1
MEMMUS.txt,288943,290117,1174,10,N,N,-,-1,-1
MEMMUS.txt,288994,290238,1244,10,N,N,-,-1,-1
MEMMUS.txt,289120,290391,1271,10,N,N,-,-1,-1
MEMMUS.txt,289166,290551,1385,10,N,N,-,-1,-1
MEMMUS.txt,289363,290720,1357,10,N,N,-,-1,-1
MEMMUS.txt,289488,290837,1349,10,N,N,-,-1,-1
MEMMUS.txt,289589,291038,1449,10,N,N,-,-1,-1
MEMMUS.txt,289739,291059,1320,10,N,N,-,-1,-1
MEMMUS.txt,289879,291082,1203,10,N,N,-,-1,-1
MEMMUS.txt,290014,291174,1160,10,N,N,-,-1,-1
MEMMUS.txt,290118,291515,1397,10,N,N,-,-1,-1
MEMMUS.txt,290241,291533,1292,10,N,N,-,-1,-1
MEMMUS.txt,290392,291603,1211,10,N,N,-,-1,-1
MEMMUS.txt,290552,291803,1251,10,N,N,-,-1,-1
MEMMUS.txt,290721,291968,1247,10,N,N,-,-1,-1
MEMMUS.txt,290838,292355,1517,10,N,N,-,-1,-1
MEMMUS.txt,291039,292656,1617,10,Y,N,-,-1,-1
MEMMUS.txt,291060,292704,1644,10,Y,N,-,-1,-1
MEMMUS.txt,291083,292901,1818,10,Y,N,-,-1,-1
MEMMUS.txt,291177,293077,1900,10,Y,N,-,-1,-1
MEMMUS.txt,291516,293163,1647,10,Y,N,-,-1,-1
MEMMUS.txt,291534,293243,1709,10,Y,N,-,-1,-1
MEMMUS.txt,291604,293312,1708,10,Y,N,-,-1,-1
MEMMUS.txt,291806,293419,1613,10,N,N,-,-1,-1
MEMMUS.txt,291969,293556,1587,10,N,N,-,-1,-1
MEMMUS.txt,292358,293713,1355,10,N,N,-,-1,-1
MEMMUS.txt,292657,293816,1159,10,N,N,-,-1,-1
MEMMUS.txt,292705,293917,1212,10,N,N,-,-1,-1
MEMMUS.txt,292904,293971,1067,10,N,N,-,-1,-1
MEMMUS.txt,293080,294154,1074,10,N,N,-,-1,-1
MEMMUS.txt,293164,294370,1206,10,N,N,-,-1,-1
MEMMUS.txt,293246,294550,1304,10,N,N,-,-1,-1
MEMMUS.txt,293313,294721,1408,10,N,N,-,-1,-1
MEMMUS.txt,293420,294886,1466,10,N,N,-,-1,-1
MEMMUS.txt,293559,295060,1501,10,N,N,-,-1,-1
MEMMUS.txt,293716,295172,1456,10,N,N,-,-1,-1
MEMMUS.txt,293817,295240,1423,10,N,N,-,-1,-1
MEMMUS.txt,293918,295248,1330,10,N,N,-,-1,-1
MEMMUS.txt,293972,295404,1432,10,N,N,-,-1,-1
MEMMUS.txt,294159,295547,1388,10,N,N,-,-1,-1
MEMMUS.txt,294373,295598,1225,10,N,N,-,-1,-1
MEMMUS.txt,294551,295606,1055,10,N,N,-,-1,-1
MEMMUS.txt,294724,295819,1095,10,N,N,-,-1,-1
MEMMUS.txt,294889,295947,1058,10,N,N,-,-1,-1
MEMMUS.txt,295063,296042,979,10,N,N,-,-1,-1
MEMMUS.txt,295173,296215,1042,10,N,N,-,-1,-1
MEMMUS.txt,295243,296304,1061,10,N,N,-,-1,-1
MEMMUS.txt,295249,296427,1178,10,N,N,-,-1,-1
MEMMUS.txt,295407,296611,1204,10,N,N,-,-1,-1
MEMMUS.txt,295550,296749,1199,10,N,N,-,-1,-1
MEMMUS.txt,295604,296890,1286,10,Y,N,-,-1,-1
MEMMUS.txt,295611,296945,1334,10,Y,N,-,-1,-1
MEMMUS.txt,295820,296997,1177,10,N,N,-,-1,-1
MEMMUS.txt,295948,297049,1101,10,N,N,-,-1,-1
MEMMUS.txt,296043,297175,1132,10,N,N,-,-1,-1
MEMMUS.txt,296218,297225,1007,10,N,N,-,-1,-1
MEMMUS.txt,296305,297336,1031,10,N,N,-,-1,-1
MEMMUS.txt,296428,297473,1045,10,N,N,-,-1,-1
MEMMUS.txt,296612,297575,963,10,N,N,-,-1,-1
MEMMUS.txt,296752,297636,884,10,N,N,-,-1,-1
MEMMUS.txt,296892,297722,830,10,N,N,-,-1,-1
MEMMUS.txt,296946,297837,891,10,N,N,-,-1,-1
MEMMUS.txt,296998,297919,921,10,N,N,-,-1,-1
MEMMUS.txt,297050,298036,986,10,N,N,-,-1,-1
MEMMUS.txt,297176,298131,955,10,N,N,-,-1,-1
MEMMUS.txt,297228,298181,953,10,N,N,-,-1,-1
MEMMUS.txt,297337,298302,965,10,N,N,-,-1,-1
MEMMUS.txt,297474,298462,988,10,N,N,-,-1,-1
MEMMUS.txt,297576,298571,995,10,N,N,-,-1,-1
MEMMUS.txt,297637,298647,1010,10,N,N,-,-1,-1
MEMMUS.txt,297723,298757,1034,10,N,N,-,-1,-1
MEMMUS.txt,297838,298865,1027,10,N,N,-,-1,-1
MEMMUS.txt,297922,298937,1015,10,N,N,-,-1,-1
MEMMUS.txt,298037,299096,1059,10,N,N,-,-1,-1
MEMMUS.txt,298132,299312,1180,10,Y,N,-,-1,-1
MEMMUS.txt,298182,299488,1306,10,Y,N,-,-1,-1
MEMMUS.txt,298303,299594,1291,10,N,N,-,-1,-1
MEMMUS.txt,298465,299728,1263,10,N,N,-,-1,-1
MEMMUS.txt,298572,299904,1332,10,N,N,-,-1,-1
MEMMUS.txt,298650,300350,1700,10,N,N,-,-1,-1
MEMMUS.txt,298758,300407,1649,10,N,N,-,-1,-1
MEMMUS.txt,298866,300518,1652,10,N,N,-,-1,-1
MEMMUS.txt,298938,300653,1715,10,N,N,-,-1,-1
MEMMUS.txt,299099,300801,1702,10,N,N,-,-1,-1
MEMMUS.txt,299313,300895,1582,10,N,N,-,-1,-1
MEMMUS.txt,299489,301058,1569,10,N,N,-,-1,-1
MEMMUS.txt,299597,301196,1599,10,N,N,-,-1,-1
MEMMUS.txt,299731,301313,1582,10,N,N,-,-1,-1
MEMMUS.txt,299909,301388,1479,10,N,N,-,-1,-1
MEMMUS.txt,300351,301502,1151,10,N,N,-,-1,-1
MEMMUS.txt,300410,301559,1149,10,N,N,-,-1,-1
MEMMUS.txt,300519,301697,1178,10,N,N,-,-1,-1
MEMMUS.txt,300654,301801,1147,10,N,N,-,-1,-1
MEMMUS.txt,300802,301854,1052,10,N,N,-,-1,-1
MEMMUS.txt,300896,301975,1079,10,N,N,-,-1,-1
MEMMUS.txt,301059,302069,1010,10,N,N,-,-1,-1
MEMMUS.txt,301197,302116,919,10,N,N,-,-1,-1
MEMMUS.txt,301314,302333,1019,10,N,N,-,-1,-1
MEMMUS.txt,301389,302426,1037,10,N,N,-,-1,-1
MEMMUS.txt,301503,302508,1005,10,N,N,-,-1,-1
MEMMUS.txt,301561,302613,1052,10,N,N,-,-1,-1
MEMMUS.txt,301698,302712,1014,10,N,N,-,-1,-1
MEMMUS.txt,301803,302787,984,10,N,N,-,-1,-1
MEMMUS.txt,301855,302875,1020,10,N,N,-,-1,-1
MEMMUS.txt,301976,302922,946,10,N,N,-,-1,-1
MEMMUS.txt,302070,303095,1025,10,N,N,-,-1,-1
MEMMUS.txt,302117,303163,1046,10,N,N,-,-1,-1
MEMMUS.txt,302335,303344,1009,10,N,N,-,-1,-1
MEMMUS.txt,302427,303432,1005,10,N,N,-,-1,-1
MEMMUS.txt,302509,303503,994,10,N,N,-,-1,-1
MEMMUS.txt,302614,303733,1119,10,N,N,-,-1,-1
MEMMUS.txt,302714,303796,1082,10,N,N,-,-1,-1
MEMMUS.txt,302788,303842,1054,10,N,N,-,-1,-1
MEMMUS.txt,302876,303947,1071,10,N,N,-,-1,-1
MEMMUS.txt,302923,304099,1176,10,N,Y,1448281888079,98877,102290
MEMMUS.txt,303096,304265,1169,10,N,Y,1448281888079,98877,102290
MEMMUS.txt,303165,304310,1145,10,N,Y,1448281888079,98877,102290
MEMMUS.txt,303345,304412,1067,10,N,Y,1448281888079,98877,102290
MEMMUS.txt,303433,304530,1097,10,N,Y,1448281888079,98877,102290
MEMMUS.txt,303504,304587,1083,10,N,Y,1448281888079,98877,102290
MEMMUS.txt,303734,304682,948,10,N,Y,1448281888079,98877,102290
MEMMUS.txt,303797,304755,958,10,N,Y,1448281888079,98877,102290
MEMMUS.txt,303843,304832,989,10,N,Y,1448281888079,98877,102290
MEMMUS.txt,303950,304893,943,10,N,Y,1448281888079,98877,102290
MEMMUS.txt,304100,304921,821,10,N,Y,1448281888079,98877,102290
MEMMUS.txt,304266,304987,721,10,N,Y,1448281888079,98877,102290
MEMMUS.txt,304311,305115,804,10,N,Y,1448281888079,98877,102290
MEMMUS.txt,304414,305190,776,10,N,Y,1448281888079,98877,102290
MEMMUS.txt,304531,305265,734,10,N,Y,1448281888079,98877,102290
MEMMUS.txt,304590,305406,816,10,N,Y,1448368866047,278997,279078
MEMMUS.txt,304683,305605,922,10,N,Y,1448368866047,278997,279078
MEMMUS.txt,304758,305761,1003,10,N,Y,1448368866047,278997,279078
MEMMUS.txt,304833,305847,1014,10,N,Y,1448368866047,278997,279078
MEMMUS.txt,304895,305950,1055,10,N,Y,1448368866047,278997,279078
MEMMUS.txt,304922,306074,1152,10,N,Y,1448368866047,278997,279078
MEMMUS.txt,304989,306192,1203,10,N,Y,1448368866047,278997,279078
MEMMUS.txt,305116,306258,1142,10,N,Y,1448368866047,278997,279078
MEMMUS.txt,305191,306431,1240,10,N,Y,1448368866047,278997,279078
MEMMUS.txt,305266,306619,1353,10,N,Y,1448368866047,278997,279078
MEMMUS.txt,305409,306848,1439,10,N,Y,1448368866047,278997,279078
MEMMUS.txt,305606,306904,1298,10,N,Y,1448368866047,278997,279078
MEMMUS.txt,305762,307136,1374,10,N,Y,1448368866047,278997,279078
MEMMUS.txt,305848,307408,1560,10,N,N,-,-1,-1
MEMMUS.txt,305953,307546,1593,10,N,N,-,-1,-1
MEMMUS.txt,306075,307766,1691,10,N,N,-,-1,-1
MEMMUS.txt,306193,307932,1739,10,N,N,-,-1,-1
MEMMUS.txt,306259,308078,1819,10,N,N,-,-1,-1
MEMMUS.txt,306434,308204,1770,10,N,N,-,-1,-1
MEMMUS.txt,306620,308381,1761,10,N,N,-,-1,-1
MEMMUS.txt,306849,308533,1684,10,N,N,-,-1,-1
MEMMUS.txt,306905,308655,1750,10,N,N,-,-1,-1
MEMMUS.txt,307137,308823,1686,10,N,N,-,-1,-1
MEMMUS.txt,307409,308971,1562,10,N,N,-,-1,-1
MEMMUS.txt,307551,309093,1542,10,N,N,-,-1,-1
MEMMUS.txt,307769,309202,1433,10,N,N,-,-1,-1
MEMMUS.txt,307933,309375,1442,10,N,N,-,-1,-1
MEMMUS.txt,308080,309475,1395,10,N,N,-,-1,-1
MEMMUS.txt,308205,309570,1365,10,N,N,-,-1,-1
MEMMUS.txt,308384,309878,1494,10,N,N,-,-1,-1
MEMMUS.txt,308534,310037,1503,10,N,N,-,-1,-1
MEMMUS.txt,308658,310267,1609,10,N,N,-,-1,-1
MEMMUS.txt,308824,310567,1743,10,N,N,-,-1,-1
MEMMUS.txt,308972,310650,1678,10,N,N,-,-1,-1
MEMMUS.txt,309094,310756,1662,10,N,N,-,-1,-1
MEMMUS.txt,309205,310826,1621,10,N,N,-,-1,-1
MEMMUS.txt,309376,310926,1550,10,N,N,-,-1,-1
MEMMUS.txt,309478,311124,1646,10,N,N,-,-1,-1
MEMMUS.txt,309571,311258,1687,10,N,N,-,-1,-1
MEMMUS.txt,309881,311478,1597,10,N,N,-,-1,-1
MEMMUS.txt,310038,311694,1656,10,N,N,-,-1,-1
MEMMUS.txt,310268,311723,1455,10,N,N,-,-1,-1
MEMMUS.txt,310570,312193,1623,10,Y,N,-,-1,-1
MEMMUS.txt,310651,312272,1621,10,Y,N,-,-1,-1
MEMMUS.txt,310757,312307,1550,10,Y,N,-,-1,-1
MEMMUS.txt,310829,312519,1690,10,Y,N,-,-1,-1
MEMMUS.txt,310927,312703,1776,10,Y,N,-,-1,-1
MEMMUS.txt,311125,312924,1799,10,Y,N,-,-1,-1
MEMMUS.txt,311261,313575,2314,10,Y,N,-,-1,-1
MEMMUS.txt,311479,313657,2178,10,Y,N,-,-1,-1
MEMMUS.txt,311695,313746,2051,10,Y,N,-,-1,-1
MEMMUS.txt,311726,313879,2153,10,Y,N,-,-1,-1
MEMMUS.txt,312196,313994,1798,10,N,N,-,-1,-1
MEMMUS.txt,312273,314194,1921,10,N,N,-,-1,-1
MEMMUS.txt,312310,314384,2074,10,N,N,-,-1,-1
MEMMUS.txt,312520,314528,2008,10,N,N,-,-1,-1
MEMMUS.txt,312704,314644,1940,10,N,N,-,-1,-1
MEMMUS.txt,312926,314707,1781,10,N,N,-,-1,-1
MEMMUS.txt,313576,314855,1279,10,Y,N,-,-1,-1
MEMMUS.txt,313658,315018,1360,10,Y,N,-,-1,-1
MEMMUS.txt,313747,315176,1429,10,Y,N,-,-1,-1
MEMMUS.txt,313880,315312,1432,10,Y,N,-,-1,-1
MEMMUS.txt,313997,315530,1533,10,Y,N,-,-1,-1
MEMMUS.txt,314195,315699,1504,10,Y,N,-,-1,-1
MEMMUS.txt,314387,315899,1512,10,Y,N,-,-1,-1
MEMMUS.txt,314529,316020,1491,10,Y,N,-,-1,-1
MEMMUS.txt,314647,316189,1542,10,N,N,-,-1,-1
MEMMUS.txt,314708,316566,1858,10,N,N,-,-1,-1
MEMMUS.txt,314856,316683,1827,10,N,N,-,-1,-1
MEMMUS.txt,315019,316874,1855,10,N,N,-,-1,-1
MEMMUS.txt,315179,317038,1859,10,N,N,-,-1,-1
MEMMUS.txt,315314,317172,1858,10,N,N,-,-1,-1
MEMMUS.txt,315531,317363,1832,10,N,N,-,-1,-1
MEMMUS.txt,315702,317497,1795,10,N,N,-,-1,-1
MEMMUS.txt,315900,317772,1872,10,N,N,-,-1,-1
MEMMUS.txt,316022,317905,1883,10,N,N,-,-1,-1
MEMMUS.txt,316190,318009,1819,10,N,N,-,-1,-1
MEMMUS.txt,316567,318072,1505,10,N,N,-,-1,-1
MEMMUS.txt,316686,318198,1512,10,N,N,-,-1,-1
MEMMUS.txt,316875,318456,1581,10,N,N,-,-1,-1
MEMMUS.txt,317039,318573,1534,10,N,N,-,-1,-1
MEMMUS.txt,317173,318740,1567,10,N,N,-,-1,-1
MEMMUS.txt,317366,318897,1531,10,N,N,-,-1,-1
MEMMUS.txt,317498,319182,1684,10,N,N,-,-1,-1
MEMMUS.txt,317773,319324,1551,10,N,N,-,-1,-1
MEMMUS.txt,317907,319423,1516,10,N,N,-,-1,-1
MEMMUS.txt,318010,319544,1534,10,N,N,-,-1,-1
MEMMUS.txt,318075,319654,1579,10,N,N,-,-1,-1
MEMMUS.txt,318199,319866,1667,10,N,N,-,-1,-1
MEMMUS.txt,318457,320043,1586,10,N,N,-,-1,-1
MEMMUS.txt,318574,320131,1557,10,N,N,-,-1,-1
MEMMUS.txt,318743,320307,1564,10,N,N,-,-1,-1
MEMMUS.txt,318898,320495,1597,10,N,N,-,-1,-1
MEMMUS.txt,319185,320580,1395,10,N,N,-,-1,-1
MEMMUS.txt,319326,320708,1382,10,N,N,-,-1,-1
MEMMUS.txt,319424,320821,1397,10,N,N,-,-1,-1
MEMMUS.txt,319545,320913,1368,10,N,N,-,-1,-1
MEMMUS.txt,319655,321062,1407,10,N,N,-,-1,-1
MEMMUS.txt,319867,321145,1278,10,N,N,-,-1,-1
MEMMUS.txt,320046,321195,1149,10,N,N,-,-1,-1
MEMMUS.txt,320133,321257,1124,10,N,N,-,-1,-1
MEMMUS.txt,320310,321335,1025,10,N,N,-,-1,-1
MEMMUS.txt,320496,321442,946,10,N,N,-,-1,-1
MEMMUS.txt,320582,321572,990,10,N,N,-,-1,-1
MEMMUS.txt,320709,321653,944,10,N,N,-,-1,-1
MEMMUS.txt,320822,321963,1141,10,N,N,-,-1,-1
MEMMUS.txt,320914,322206,1292,10,N,N,-,-1,-1
MEMMUS.txt,321063,322312,1249,10,N,N,-,-1,-1
MEMMUS.txt,321146,322414,1268,10,N,N,-,-1,-1
MEMMUS.txt,321198,322555,1357,10,N,N,-,-1,-1
MEMMUS.txt,321258,322760,1502,10,N,N,-,-1,-1
MEMMUS.txt,321337,323069,1732,10,N,N,-,-1,-1
MEMMUS.txt,321443,323264,1821,10,N,N,-,-1,-1
MEMMUS.txt,321574,323420,1846,10,N,N,-,-1,-1
MEMMUS.txt,321656,323509,1853,10,N,N,-,-1,-1
MEMMUS.txt,321966,323784,1818,10,N,N,-,-1,-1
MEMMUS.txt,322207,323830,1623,10,N,N,-,-1,-1
MEMMUS.txt,322313,323907,1594,10,N,N,-,-1,-1
MEMMUS.txt,322415,323994,1579,10,N,N,-,-1,-1
MEMMUS.txt,322556,324131,1575,10,N,N,-,-1,-1
MEMMUS.txt,322763,324260,1497,10,N,N,-,-1,-1
MEMMUS.txt,323072,324370,1298,10,N,N,-,-1,-1
MEMMUS.txt,323265,324533,1268,10,N,N,-,-1,-1
MEMMUS.txt,323421,324831,1410,10,N,N,-,-1,-1
MEMMUS.txt,323510,324923,1413,10,N,N,-,-1,-1
MEMMUS.txt,323785,325465,1680,10,N,N,-,-1,-1
MEMMUS.txt,323831,325661,1830,10,N,N,-,-1,-1
MEMMUS.txt,323910,325856,1946,10,Y,N,-,-1,-1
MEMMUS.txt,323995,326101,2106,10,Y,N,-,-1,-1
MEMMUS.txt,324132,326323,2191,10,Y,N,-,-1,-1
MEMMUS.txt,324261,326474,2213,10,Y,N,-,-1,-1
MEMMUS.txt,324371,326486,2115,10,Y,N,-,-1,-1
MEMMUS.txt,324536,326557,2021,10,Y,N,-,-1,-1
MEMMUS.txt,324833,326713,1880,10,Y,N,-,-1,-1
MEMMUS.txt,324926,326928,2002,10,Y,N,-,-1,-1
MEMMUS.txt,325468,327233,1765,10,Y,N,-,-1,-1
MEMMUS.txt,325663,327369,1706,10,Y,N,-,-1,-1
MEMMUS.txt,325858,327726,1868,10,Y,N,-,-1,-1
MEMMUS.txt,326102,327917,1815,10,Y,N,-,-1,-1
MEMMUS.txt,326326,328169,1843,10,Y,N,-,-1,-1
MEMMUS.txt,326475,328355,1880,10,Y,N,-,-1,-1
MEMMUS.txt,326487,328439,1952,10,Y,N,-,-1,-1
MEMMUS.txt,326558,328590,2032,10,Y,N,-,-1,-1
MEMMUS.txt,326716,328646,1930,10,N,N,-,-1,-1
MEMMUS.txt,326929,328878,1949,10,N,N,-,-1,-1
MEMMUS.txt,327236,329002,1766,10,N,N,-,-1,-1
MEMMUS.txt,327370,329204,1834,10,N,N,-,-1,-1
MEMMUS.txt,327727,329298,1571,10,N,N,-,-1,-1
MEMMUS.txt,327918,329420,1502,10,N,N,-,-1,-1
MEMMUS.txt,328172,329508,1336,10,N,N,-,-1,-1
MEMMUS.txt,328357,329604,1247,10,N,N,-,-1,-1
MEMMUS.txt,328442,329772,1330,10,N,N,-,-1,-1
MEMMUS.txt,328591,329833,1242,10,N,N,-,-1,-1
MEMMUS.txt,328649,329940,1291,10,N,N,-,-1,-1
MEMMUS.txt,328879,330043,1164,10,N,N,-,-1,-1
MEMMUS.txt,329003,330270,1267,10,Y,N,-,-1,-1
MEMMUS.txt,329205,330443,1238,10,Y,N,-,-1,-1
MEMMUS.txt,329301,330514,1213,10,Y,N,-,-1,-1
MEMMUS.txt,329423,330631,1208,10,Y,N,-,-1,-1
MEMMUS.txt,329510,330762,1252,10,Y,N,-,-1,-1
MEMMUS.txt,329606,331324,1718,10,Y,N,-,-1,-1
MEMMUS.txt,329773,331544,1771,10,Y,Y,1448280423373,85694,86154
MEMMUS.txt,329835,331820,1985,10,Y,Y,1448280423373,85694,86154
MEMMUS.txt,329943,332126,2183,10,Y,Y,1448280423373,85694,86154
MEMMUS.txt,330046,332212,2166,10,Y,Y,1448280423373,85694,86154
MEMMUS.txt,330271,332275,2004,10,Y,Y,1448280423373,85694,86154
MEMMUS.txt,330446,332347,1901,10,Y,Y,1448280423373,85694,86154
MEMMUS.txt,330515,332531,2016,10,Y,Y,1448280423373,85694,86154
MEMMUS.txt,330632,332635,2003,10,Y,Y,1448280423373,85694,86154
MEMMUS.txt,330767,332729,1962,10,Y,Y,1448280423373,85694,86154
MEMMUS.txt,331327,332818,1491,10,Y,Y,1448280423373,85694,86154
MEMMUS.txt,331545,332958,1413,10,Y,Y,1448280423373,85694,86154
MEMMUS.txt,331821,333052,1231,10,Y,Y,1448280423373,85694,86154
MEMMUS.txt,332127,333169,1042,10,Y,Y,1448280423373,85694,86154
MEMMUS.txt,332214,333201,987,10,N,Y,1448280423373,85694,86154
MEMMUS.txt,332276,333363,1087,10,N,Y,1448280423373,85694,86154
MEMMUS.txt,332349,333551,1202,10,N,Y,1448280423373,85694,86154
MEMMUS.txt,332532,333703,1171,10,N,Y,1437475017618,98942,100041
MEMMUS.txt,332636,333750,1114,10,N,Y,1437475017618,98942,100041
MEMMUS.txt,332730,333785,1055,10,N,Y,1437475017618,98942,100041
MEMMUS.txt,332819,333853,1034,10,N,Y,1437475017618,98942,100041
MEMMUS.txt,332961,334004,1043,10,N,Y,1437475017618,98942,100041
MEMMUS.txt,333055,334128,1073,10,N,Y,1437475017618,98942,100041
MEMMUS.txt,333172,334320,1148,10,N,Y,1437475017618,98942,100041
MEMMUS.txt,333202,334426,1224,10,N,Y,1437475017618,98942,100041
MEMMUS.txt,333364,334631,1267,10,Y,Y,1437475017618,98942,100041
MEMMUS.txt,333554,334699,1145,10,N,Y,1437475017618,98942,100041
MEMMUS.txt,333704,334752,1048,10,N,Y,1437475017618,98942,100041
MEMMUS.txt,333751,334897,1146,10,N,Y,1437475017618,98942,100041
MEMMUS.txt,333790,335036,1246,10,N,Y,1437475017618,98942,100041
MEMMUS.txt,333854,335076,1222,10,N,Y,1437475017618,98942,100041
MEMMUS.txt,334007,335225,1218,10,N,N,-,-1,-1
MEMMUS.txt,334129,335315,1186,10,N,N,-,-1,-1
MEMMUS.txt,334321,335494,1173,10,N,N,-,-1,-1
MEMMUS.txt,334427,335634,1207,10,N,N,-,-1,-1
MEMMUS.txt,334633,335692,1059,10,N,N,-,-1,-1
MEMMUS.txt,334700,335772,1072,10,N,N,-,-1,-1
MEMMUS.txt,334755,336247,1492,10,N,N,-,-1,-1
MEMMUS.txt,334898,336468,1570,10,N,N,-,-1,-1
MEMMUS.txt,335038,336652,1614,10,Y,Y,1448313482895,176553,176862
MEMMUS.txt,335079,336739,1660,10,Y,Y,1448313482895,176553,176862
MEMMUS.txt,335226,336879,1653,10,Y,Y,1448313482895,176553,176862
MEMMUS.txt,335317,337065,1748,10,Y,Y,1448038356234,18463,18881
MEMMUS.txt,335497,337259,1762,10,Y,Y,1448038356234,18463,18881
MEMMUS.txt,335635,337439,1804,10,Y,Y,1448038356234,18463,18881
MEMMUS.txt,335693,337498,1805,10,Y,Y,1448038356234,18463,18881
MEMMUS.txt,335773,337767,1994,10,Y,Y,1448038356234,18463,18881
MEMMUS.txt,336250,338021,1771,10,Y,Y,1448038356234,18463,18881
MEMMUS.txt,336471,338110,1639,10,Y,Y,1448038356234,18463,18881
MEMMUS.txt,336654,338257,1603,10,N,Y,1448038356234,18463,18881
MEMMUS.txt,336740,338332,1592,10,N,Y,1448038356234,18463,18881
MEMMUS.txt,336882,338372,1490,10,N,Y,1448038356234,18463,18881
MEMMUS.txt,337066,338491,1425,10,N,Y,1448038356234,18463,18881
MEMMUS.txt,337260,338759,1499,10,N,Y,1448038356234,18463,18881
MEMMUS.txt,337440,338869,1429,10,N,Y,1448038356234,18463,18881
MEMMUS.txt,337501,338974,1473,10,N,N,-,-1,-1
MEMMUS.txt,337768,339162,1394,10,N,N,-,-1,-1
MEMMUS.txt,338023,339248,1225,10,N,N,-,-1,-1
MEMMUS.txt,338112,339355,1243,10,N,N,-,-1,-1
MEMMUS.txt,338258,339451,1193,10,N,N,-,-1,-1
MEMMUS.txt,338333,339562,1229,10,N,N,-,-1,-1
MEMMUS.txt,338375,339678,1303,10,N,N,-,-1,-1
MEMMUS.txt,338492,339711,1219,10,N,N,-,-1,-1
MEMMUS.txt,338762,339755,993,10,N,N,-,-1,-1
MEMMUS.txt,338870,339763,893,10,N,N,-,-1,-1
MEMMUS.txt,338977,339875,898,10,N,N,-,-1,-1
MEMMUS.txt,339163,339998,835,10,N,N,-,-1,-1
MEMMUS.txt,339250,340029,779,10,N,N,-,-1,-1
MEMMUS.txt,339356,340047,691,10,N,N,-,-1,-1
MEMMUS.txt,339452,340101,649,10,N,N,-,-1,-1
MEMMUS.txt,339563,340299,736,10,N,N,-,-1,-1
MEMMUS.txt,339679,340395,716,10,N,N,-,-1,-1
MEMMUS.txt,339712,340586,874,10,N,N,-,-1,-1
MEMMUS.txt,339757,340675,918,10,N,N,-,-1,-1
MEMMUS.txt,339768,340793,1025,10,N,N,-,-1,-1
MEMMUS.txt,339878,340932,1054,10,N,N,-,-1,-1
MEMMUS.txt,339999,341102,1103,10,N,Y,1448359878707,265791,267089
MEMMUS.txt,340030,341280,1250,10,N,Y,1448359878707,265791,267089
MEMMUS.txt,340048,341573,1525,10,Y,Y,1448359878707,265791,267089
MEMMUS.txt,340104,341674,1570,10,Y,Y,1448359878707,265791,267089
MEMMUS.txt,340300,341743,1443,10,Y,Y,1448359878707,265791,267089
MEMMUS.txt,340396,341998,1602,10,Y,Y,1448359878707,265791,267089
MEMMUS.txt,340587,342162,1575,10,N,Y,1448359878707,265791,267089
MEMMUS.txt,340677,342293,1616,10,Y,Y,1448359878707,265791,267089
MEMMUS.txt,340794,342462,1668,10,Y,Y,1448359878707,265791,267089
MEMMUS.txt,340935,342699,1764,10,N,Y,1448359878707,265791,267089
MEMMUS.txt,341103,342811,1708,10,N,Y,1448359878707,265791,267089
MEMMUS.txt,341281,342925,1644,10,N,Y,1448359878707,265791,267089
MEMMUS.txt,341574,343177,1603,10,N,Y,1448359878707,265791,267089
MEMMUS.txt,341675,343303,1628,10,N,Y,1448359878707,265791,267089
MEMMUS.txt,341744,343373,1629,10,N,N,-,-1,-1
MEMMUS.txt,342001,343556,1555,10,N,N,-,-1,-1
MEMMUS.txt,342163,343738,1575,10,N,N,-,-1,-1
MEMMUS.txt,342296,343849,1553,10,N,N,-,-1,-1
MEMMUS.txt,342463,344122,1659,10,N,N,-,-1,-1
MEMMUS.txt,342700,344261,1561,10,N,N,-,-1,-1
MEMMUS.txt,342814,344623,1809,10,N,N,-,-1,-1
MEMMUS.txt,342926,344725,1799,10,N,N,-,-1,-1
MEMMUS.txt,343180,344860,1680,10,N,N,-,-1,-1
MEMMUS.txt,343304,344999,1695,10,N,N,-,-1,-1
MEMMUS.txt,343374,345389,2015,10,Y,N,-,-1,-1
MEMMUS.txt,343559,345615,2056,10,Y,N,-,-1,-1
MEMMUS.txt,343739,345776,2037,10,Y,N,-,-1,-1
MEMMUS.txt,343850,345931,2081,10,Y,Y,1448315575026,182236,182361
MEMMUS.txt,344125,345958,1833,10,Y,Y,1448315575026,182236,182361
MEMMUS.txt,344262,346085,1823,10,Y,Y,1448315575026,182236,182361
MEMMUS.txt,344624,346314,1690,10,Y,Y,1448315575026,182236,182361
MEMMUS.txt,344726,346436,1710,10,Y,Y,1448315575026,182236,182361
MEMMUS.txt,344861,346578,1717,10,Y,Y,1448315575026,182236,182361
MEMMUS.txt,345002,346620,1618,10,N,Y,1448315575026,182236,182361
MEMMUS.txt,345390,346810,1420,10,N,Y,1448315575026,182236,182361
MEMMUS.txt,345616,346932,1316,10,N,Y,1448315575026,182236,182361
MEMMUS.txt,345779,346934,1155,10,N,Y,1448315575026,182236,182361
MEMMUS.txt,345932,346940,1008,10,N,Y,1448315575026,182236,182361
MEMMUS.txt,345959,347077,1118,10,N,Y,1448315575026,182236,182361
MEMMUS.txt,346086,347130,1044,10,N,Y,1448315575026,182236,182361
MEMMUS.txt,346315,347192,877,10,N,Y,1448315575026,182236,182361
MEMMUS.txt,346437,347235,798,10,N,Y,1448315575026,182236,182361
MEMMUS.txt,346579,347413,834,10,N,Y,1448315575026,182236,182361
MEMMUS.txt,346621,347530,909,10,N,Y,1448315575026,182236,182361
MEMMUS.txt,346811,347658,847,10,N,Y,1448315575026,182236,182361
MEMMUS.txt,346933,347703,770,10,N,Y,1448315575026,182236,182361
MEMMUS.txt,346935,347751,816,10,N,Y,1448315575026,182236,182361
MEMMUS.txt,346941,347872,931,10,Y,Y,1448315575026,182236,182361
MEMMUS.txt,347078,348031,953,10,Y,Y,1448315575026,182236,182361
MEMMUS.txt,347131,348073,942,10,Y,Y,1448315575026,182236,182361
MEMMUS.txt,347193,348412,1219,10,Y,Y,1448315575026,182236,182361
MEMMUS.txt,347240,348491,1251,10,Y,N,-,-1,-1
MEMMUS.txt,347414,348617,1203,10,N,N,-,-1,-1
MEMMUS.txt,347533,348767,1234,10,Y,N,-,-1,-1
MEMMUS.txt,347659,348870,1211,10,Y,N,-,-1,-1
MEMMUS.txt,347704,348912,1208,10,N,N,-,-1,-1
MEMMUS.txt,347752,349050,1298,10,N,N,-,-1,-1
MEMMUS.txt,347873,349175,1302,10,N,N,-,-1,-1
MEMMUS.txt,348032,349296,1264,10,N,N,-,-1,-1
MEMMUS.txt,348074,349352,1278,10,N,N,-,-1,-1
MEMMUS.txt,348413,349632,1219,10,N,N,-,-1,-1
MEMMUS.txt,348494,349720,1226,10,N,N,-,-1,-1
MEMMUS.txt,348618,349893,1275,10,N,N,-,-1,-1
MEMMUS.txt,348770,349954,1184,10,N,N,-,-1,-1
MEMMUS.txt,348871,349956,1085,10,N,N,-,-1,-1
MEMMUS.txt,348913,350035,1122,10,N,N,-,-1,-1
MEMMUS.txt,349051,350176,1125,10,N,N,-,-1,-1
MEMMUS.txt,349178,350301,1123,10,N,N,-,-1,-1
MEMMUS.txt,349297,350488,1191,10,N,N,-,-1,-1
MEMMUS.txt,349353,350620,1267,10,N,N,-,-1,-1
MEMMUS.txt,349633,350903,1270,10,N,N,-,-1,-1
MEMMUS.txt,349723,351005,1282,10,N,N,-,-1,-1
MEMMUS.txt,349894,351054,1160,10,N,N,-,-1,-1
MEMMUS.txt,349955,351186,1231,10,N,N,-,-1,-1
MEMMUS.txt,349956,351314,1358,10,N,N,-,-1,-1
MEMMUS.txt,350038,351424,1386,10,N,N,-,-1,-1
MEMMUS.txt,350177,351550,1373,10,N,N,-,-1,-1
MEMMUS.txt,350302,351672,1370,10,N,N,-,-1,-1
MEMMUS.txt,350489,351825,1336,10,N,N,-,-1,-1
MEMMUS.txt,350623,351993,1370,10,N,N,-,-1,-1
MEMMUS.txt,350904,352071,1167,10,N,N,-,-1,-1
MEMMUS.txt,351006,352151,1145,10,N,N,-,-1,-1
MEMMUS.txt,351057,352336,1279,10,N,N,-,-1,-1
MEMMUS.txt,351187,352388,1201,10,N,N,-,-1,-1
MEMMUS.txt,351315,352620,1305,10,N,N,-,-1,-1
MEMMUS.txt,351425,352723,1298,10,N,N,-,-1,-1
MEMMUS.txt,351551,352946,1395,10,N,N,-,-1,-1
MEMMUS.txt,351675,353040,1365,10,N,N,-,-1,-1
MEMMUS.txt,351826,353287,1461,10,N,N,-,-1,-1
MEMMUS.txt,351994,353442,1448,10,N,N,-,-1,-1
MEMMUS.txt,352072,353643,1571,10,N,N,-,-1,-1
MEMMUS.txt,352152,353853,1701,10,N,N,-,-1,-1
MEMMUS.txt,352339,354070,1731,10,N,N,-,-1,-1
MEMMUS.txt,352389,354176,1787,10,N,N,-,-1,-1
MEMMUS.txt,352621,354466,1845,10,Y,N,-,-1,-1
MEMMUS.txt,352726,354603,1877,10,Y,N,-,-1,-1
MEMMUS.txt,352947,354715,1768,10,Y,N,-,-1,-1
MEMMUS.txt,353043,354996,1953,10,Y,N,-,-1,-1
MEMMUS.txt,353288,355182,1894,10,Y,N,-,-1,-1
MEMMUS.txt,353445,355245,1800,10,N,N,-,-1,-1
MEMMUS.txt,353644,355470,1826,10,N,N,-,-1,-1
MEMMUS.txt,353856,355517,1661,10,N,N,-,-1,-1
MEMMUS.txt,354071,355609,1538,10,N,N,-,-1,-1
MEMMUS.txt,354179,355774,1595,10,N,N,-,-1,-1
MEMMUS.txt,354467,355972,1505,10,N,N,-,-1,-1
MEMMUS.txt,354605,356140,1535,10,N,N,-,-1,-1
MEMMUS.txt,354716,356229,1513,10,N,N,-,-1,-1
MEMMUS.txt,354999,356456,1457,10,N,N,-,-1,-1
MEMMUS.txt,355183,356589,1406,10,N,N,-,-1,-1
MEMMUS.txt,355248,356704,1456,10,Y,N,-,-1,-1
MEMMUS.txt,355471,356963,1492,10,Y,N,-,-1,-1
MEMMUS.txt,355518,357070,1552,10,Y,N,-,-1,-1
MEMMUS.txt,355610,357373,1763,10,Y,N,-,-1,-1
MEMMUS.txt,355775,357474,1699,10,Y,N,-,-1,-1
MEMMUS.txt,355975,357586,1611,10,Y,N,-,-1,-1
MEMMUS.txt,356141,357800,1659,10,Y,N,-,-1,-1
MEMMUS.txt,356230,358042,1812,10,Y,N,-,-1,-1
MEMMUS.txt,356457,358352,1895,10,Y,N,-,-1,-1
MEMMUS.txt,356591,358440,1849,10,Y,N,-,-1,-1
MEMMUS.txt,356707,358539,1832,10,Y,N,-,-1,-1
MEMMUS.txt,356964,358632,1668,10,Y,N,-,-1,-1
MEMMUS.txt,357075,358665,1590,10,Y,N,-,-1,-1
MEMMUS.txt,357376,358990,1614,10,Y,N,-,-1,-1
MEMMUS.txt,357475,359098,1623,10,Y,N,-,-1,-1
MEMMUS.txt,357589,359207,1618,10,Y,N,-,-1,-1
MEMMUS.txt,357801,359233,1432,10,Y,N,-,-1,-1
MEMMUS.txt,358043,359305,1262,10,N,N,-,-1,-1
MEMMUS.txt,358354,359441,1087,10,Y,N,-,-1,-1
MEMMUS.txt,358441,359619,1178,10,Y,N,-,-1,-1
MEMMUS.txt,358541,359706,1165,10,N,N,-,-1,-1
MEMMUS.txt,358633,359847,1214,10,Y,N,-,-1,-1
MEMMUS.txt,358668,360092,1424,10,Y,N,-,-1,-1
MEMMUS.txt,358991,360269,1278,10,Y,Y,1448314503640,180207,180355
MEMMUS.txt,359099,360426,1327,10,Y,Y,1448314503640,180207,180355
MEMMUS.txt,359208,360548,1340,10,Y,Y,1448314503640,180207,180355
MEMMUS.txt,359234,360664,1430,10,Y,Y,1448314503640,180207,180355
MEMMUS.txt,359308,360834,1526,10,Y,Y,1448314503640,180207,180355
MEMMUS.txt,359443,360997,1554,10,Y,Y,1448314503640,180207,180355
MEMMUS.txt,359620,361159,1539,10,Y,Y,1448314503640,180207,180355
MEMMUS.txt,359707,361366,1659,10,Y,Y,1448314503640,180207,180355
MEMMUS.txt,359850,361450,1600,10,Y,Y,1448314503640,180207,180355
MEMMUS.txt,360095,361557,1462,10,Y,Y,1448314503640,180207,180355
MEMMUS.txt,360270,361723,1453,10,Y,Y,1448314503640,180207,180355
MEMMUS.txt,360427,361822,1395,10,Y,Y,1448314503640,180207,180355
MEMMUS.txt,360549,361985,1436,10,N,Y,1448314503640,180207,180355
MEMMUS.txt,360665,362150,1485,10,N,Y,1448314503640,180207,180355
MEMMUS.txt,360837,362302,1465,10,N,N,-,-1,-1
MEMMUS.txt,360998,362421,1423,10,N,Y,1437472966198,394609,395892
MEMMUS.txt,361160,362700,1540,10,Y,Y,1437472966198,394609,395892
MEMMUS.txt,361368,362887,1519,10,Y,Y,1437472966198,394609,395892
MEMMUS.txt,361451,362972,1521,10,Y,Y,1437472966198,394609,395892
MEMMUS.txt,361558,363046,1488,10,Y,Y,1437472966198,394609,395892
MEMMUS.txt,361724,363248,1524,10,Y,Y,1437472966198,394609,395892
MEMMUS.txt,361823,363291,1468,10,Y,Y,1437472966198,394609,395892
MEMMUS.txt,361986,363473,1487,10,N,Y,1437472966198,394609,395892
MEMMUS.txt,362151,363494,1343,10,N,Y,1437472966198,394609,395892
MEMMUS.txt,362305,363575,1270,10,N,Y,1437472966198,394609,395892
MEMMUS.txt,362422,363740,1318,10,N,Y,1437472966198,394609,395892
MEMMUS.txt,362701,364032,1331,10,N,Y,1437472966198,394609,395892
MEMMUS.txt,362890,364081,1191,10,N,N,-,-1,-1
MEMMUS.txt,362973,364258,1285,10,N,N,-,-1,-1
MEMMUS.txt,363047,364358,1311,10,N,N,-,-1,-1
MEMMUS.txt,363249,364483,1234,10,N,N,-,-1,-1
MEMMUS.txt,363294,364634,1340,10,N,N,-,-1,-1
MEMMUS.txt,363474,364778,1304,10,N,N,-,-1,-1
MEMMUS.txt,363497,364876,1379,10,N,N,-,-1,-1
MEMMUS.txt,363576,365061,1485,10,N,N,-,-1,-1
MEMMUS.txt,363743,365110,1367,10,N,N,-,-1,-1
MEMMUS.txt,364032,365292,1260,10,N,N,-,-1,-1
MEMMUS.txt,364082,365380,1298,10,N,N,-,-1,-1
MEMMUS.txt,364260,365663,1403,10,N,N,-,-1,-1
MEMMUS.txt,364361,365790,1429,10,N,N,-,-1,-1
MEMMUS.txt,364484,365876,1392,10,N,N,-,-1,-1
MEMMUS.txt,364636,366001,1365,10,N,N,-,-1,-1
MEMMUS.txt,364780,366118,1338,10,N,N,-,-1,-1
MEMMUS.txt,364878,366168,1290,10,N,N,-,-1,-1
MEMMUS.txt,365062,366227,1165,10,N,N,-,-1,-1
MEMMUS.txt,365111,366343,1232,10,N,N,-,-1,-1
MEMMUS.txt,365295,366353,1058,10,N,N,-,-1,-1
MEMMUS.txt,365381,366506,1125,10,N,N,-,-1,-1
MEMMUS.txt,365664,366603,939,10,N,N,-,-1,-1
MEMMUS.txt,365793,366717,924,10,N,N,-,-1,-1
MEMMUS.txt,365879,366788,909,10,N,N,-,-1,-1
MEMMUS.txt,366002,366900,898,10,N,Y,1448322979449,227304,227638
MEMMUS.txt,366119,367087,968,10,N,Y,1448322979449,227304,227638
MEMMUS.txt,366169,367193,1024,10,N,Y,1448322979449,227304,227638
MEMMUS.txt,366230,367251,1021,10,N,Y,1448322979449,227304,227638
MEMMUS.txt,366349,367372,1023,10,N,Y,1448322979449,227304,227638
MEMMUS.txt,366354,367507,1153,10,N,Y,1448322979449,227304,227638
MEMMUS.txt,366507,367636,1129,10,N,Y,1448322979449,227304,227638
MEMMUS.txt,366604,367829,1225,10,N,Y,1448322979449,227304,227638
MEMMUS.txt,366718,367869,1151,10,N,Y,1448322979449,227304,227638
MEMMUS.txt,366789,367990,1201,10,N,Y,1448322979449,227304,227638
MEMMUS.txt,366901,368236,1335,10,Y,Y,1448322979449,227304,227638
MEMMUS.txt,367088,368364,1276,10,N,Y,1448322979449,227304,227638
MEMMUS.txt,367194,368641,1447,10,Y,Y,1448322979449,227304,227638
MEMMUS.txt,367252,368883,1631,10,N,Y,1448322979449,227304,227638
MEMMUS.txt,367373,368952,1579,10,N,Y,1448322979449,227304,227638
MEMMUS.txt,367509,369019,1510,10,N,Y,1448322979449,227304,227638
MEMMUS.txt,367637,369282,1645,10,N,N,-,-1,-1
MEMMUS.txt,367830,369349,1519,10,N,N,-,-1,-1
MEMMUS.txt,367874,369478,1604,10,N,N,-,-1,-1
MEMMUS.txt,367992,369604,1612,10,N,N,-,-1,-1
MEMMUS.txt,368237,369925,1688,10,Y,N,-,-1,-1
MEMMUS.txt,368365,370102,1737,10,Y,N,-,-1,-1
MEMMUS.txt,368642,370216,1574,10,Y,N,-,-1,-1
MEMMUS.txt,368886,370404,1518,10,Y,N,-,-1,-1
MEMMUS.txt,368953,370538,1585,10,Y,N,-,-1,-1
MEMMUS.txt,369021,370583,1562,10,Y,N,-,-1,-1
MEMMUS.txt,369283,370717,1434,10,Y,N,-,-1,-1
MEMMUS.txt,369350,370777,1427,10,Y,N,-,-1,-1
MEMMUS.txt,369480,370884,1404,10,Y,N,-,-1,-1
MEMMUS.txt,369605,370944,1339,10,Y,N,-,-1,-1
MEMMUS.txt,369926,371038,1112,10,N,N,-,-1,-1
MEMMUS.txt,370103,371101,998,10,N,N,-,-1,-1
MEMMUS.txt,370219,371176,957,10,N,N,-,-1,-1
MEMMUS.txt,370406,371424,1018,10,N,N,-,-1,-1
MEMMUS.txt,370539,371538,999,10,N,N,-,-1,-1
MEMMUS.txt,370584,371574,990,10,N,N,-,-1,-1
MEMMUS.txt,370718,371673,955,10,N,N,-,-1,-1
MEMMUS.txt,370779,371750,971,10,N,N,-,-1,-1
MEMMUS.txt,370885,371822,937,10,N,N,-,-1,-1
MEMMUS.txt,370947,372065,1118,10,N,N,-,-1,-1
MEMMUS.txt,371039,372164,1125,10,N,N,-,-1,-1
MEMMUS.txt,371103,372193,1090,10,N,N,-,-1,-1
MEMMUS.txt,371177,372492,1315,10,N,N,-,-1,-1
MEMMUS.txt,371427,372622,1195,10,N,N,-,-1,-1
MEMMUS.txt,371541,372744,1203,10,N,N,-,-1,-1
MEMMUS.txt,371577,372830,1253,10,N,N,-,-1,-1
MEMMUS.txt,371674,372936,1262,10,N,N,-,-1,-1
MEMMUS.txt,371751,373110,1359,10,N,N,-,-1,-1
MEMMUS.txt,371824,373285,1461,10,N,N,-,-1,-1
MEMMUS.txt,372066,373351,1285,10,N,N,-,-1,-1
MEMMUS.txt,372165,373372,1207,10,N,N,-,-1,-1
MEMMUS.txt,372196,373493,1297,10,N,N,-,-1,-1
MEMMUS.txt,372494,373568,1074,10,N,N,-,-1,-1
MEMMUS.txt,372625,373719,1094,10,N,N,-,-1,-1
MEMMUS.txt,372745,373800,1055,10,N,N,-,-1,-1
MEMMUS.txt,372831,373881,1050,10,Y,N,-,-1,-1
MEMMUS.txt,372937,374077,1140,10,N,N,-,-1,-1
MEMMUS.txt,373111,374251,1140,10,N,N,-,-1,-1
MEMMUS.txt,373287,374391,1104,10,N,N,-,-1,-1
MEMMUS.txt,373352,374580,1228,10,N,N,-,-1,-1
MEMMUS.txt,373373,374687,1314,10,N,N,-,-1,-1
MEMMUS.txt,373494,374783,1289,10,N,N,-,-1,-1
MEMMUS.txt,373571,374935,1364,10,N,N,-,-1,-1
MEMMUS.txt,373720,375045,1325,10,N,N,-,-1,-1
MEMMUS.txt,373802,375126,1324,10,N,N,-,-1,-1
MEMMUS.txt,373882,375263,1381,10,N,N,-,-1,-1
MEMMUS.txt,374078,375498,1420,10,N,N,-,-1,-1
MEMMUS.txt,374253,375577,1324,10,N,N,-,-1,-1
MEMMUS.txt,374393,375798,1405,10,N,N,-,-1,-1
MEMMUS.txt,374582,375905,1323,10,N,N,-,-1,-1
MEMMUS.txt,374688,376044,1356,10,N,N,-,-1,-1
MEMMUS.txt,374784,376126,1342,10,N,N,-,-1,-1
MEMMUS.txt,374936,376186,1250,10,N,N,-,-1,-1
MEMMUS.txt,375048,376280,1232,10,N,N,-,-1,-1
MEMMUS.txt,375127,376428,1301,10,N,N,-,-1,-1
MEMMUS.txt,375266,376472,1206,10,N,N,-,-1,-1
MEMMUS.txt,375501,376559,1058,10,N,N,-,-1,-1
MEMMUS.txt,375578,376688,1110,10,N,Y,1448286451685,111065,112127
MEMMUS.txt,375801,376822,1021,10,N,Y,1448286451685,111065,112127
MEMMUS.txt,375906,376895,989,10,N,Y,1448286451685,111065,112127
MEMMUS.txt,376045,377147,1102,10,N,Y,1448286451685,111065,112127
MEMMUS.txt,376127,377326,1199,10,Y,Y,1448286451685,111065,112127
MEMMUS.txt,376188,377403,1215,10,Y,Y,1448286451685,111065,112127
MEMMUS.txt,376282,377546,1264,10,Y,Y,1448286451685,111065,112127
MEMMUS.txt,376429,377728,1299,10,Y,Y,1437471397525,350644,351290
MEMMUS.txt,376473,377803,1330,10,N,Y,1437471397525,350644,351290
MEMMUS.txt,376562,378116,1554,10,Y,Y,1437471397525,350644,351290
MEMMUS.txt,376689,378247,1558,10,Y,Y,1437471397525,350644,351290
MEMMUS.txt,376823,378314,1491,10,Y,Y,1437471397525,350644,351290
MEMMUS.txt,376896,378389,1493,10,N,Y,1437471397525,350644,351290
MEMMUS.txt,377149,378497,1348,10,N,Y,1437471397525,350644,351290
MEMMUS.txt,377327,378566,1239,10,N,Y,1437471397525,350644,351290
MEMMUS.txt,377404,378818,1414,10,N,Y,1437471397525,350644,351290
MEMMUS.txt,377547,379011,1464,10,N,Y,1437471397525,350644,351290
MEMMUS.txt,377729,379137,1408,10,N,Y,1437471397525,350644,351290
MEMMUS.txt,377805,379368,1563,10,N,Y,1437471397525,350644,351290
MEMMUS.txt,378118,379420,1302,10,N,Y,1437471397525,350644,351290
MEMMUS.txt,378248,379766,1518,10,N,Y,1437471397525,350644,351290
MEMMUS.txt,378315,379896,1581,10,N,Y,1437471397525,350644,351290
MEMMUS.txt,378390,380010,1620,10,N,Y,1437471397525,350644,351290
MEMMUS.txt,378498,380293,1795,10,N,Y,1448281320115,89144,91129
MEMMUS.txt,378569,380431,1862,10,N,Y,1448281320115,89144,91129
MEMMUS.txt,378819,380651,1832,10,Y,Y,1448281320115,89144,91129
MEMMUS.txt,379014,381002,1988,10,Y,Y,1448313674408,176614,178600
MEMMUS.txt,379138,381069,1931,10,Y,Y,1448313674408,176614,178600
MEMMUS.txt,379373,381207,1834,10,Y,N,-,-1,-1
MEMMUS.txt,379423,381281,1858,10,Y,N,-,-1,-1
MEMMUS.txt,379769,381467,1698,10,Y,N,-,-1,-1
MEMMUS.txt,379897,381518,1621,10,Y,N,-,-1,-1
MEMMUS.txt,380011,381615,1604,10,Y,N,-,-1,-1
MEMMUS.txt,380294,381697,1403,10,N,N,-,-1,-1
MEMMUS.txt,380432,381820,1388,10,N,N,-,-1,-1
MEMMUS.txt,380652,381913,1261,10,N,N,-,-1,-1
MEMMUS.txt,381003,382001,998,10,N,N,-,-1,-1
MEMMUS.txt,381072,382054,982,10,N,N,-,-1,-1
MEMMUS.txt,381209,382310,1101,10,N,N,-,-1,-1
MEMMUS.txt,381282,382771,1489,10,N,N,-,-1,-1
MEMMUS.txt,381470,382806,1336,10,N,N,-,-1,-1
MEMMUS.txt,381519,382918,1399,10,N,N,-,-1,-1
MEMMUS.txt,381616,383100,1484,10,N,N,-,-1,-1
MEMMUS.txt,381698,383252,1554,10,N,N,-,-1,-1
MEMMUS.txt,381822,383516,1694,10,N,N,-,-1,-1
MEMMUS.txt,381916,383742,1826,10,N,N,-,-1,-1
MEMMUS.txt,382004,383924,1920,10,N,N,-,-1,-1
MEMMUS.txt,382055,384143,2088,10,N,N,-,-1,-1
MEMMUS.txt,382313,384298,1985,10,N,N,-,-1,-1
MEMMUS.txt,382772,384415,1643,10,N,N,-,-1,-1
MEMMUS.txt,382809,384519,1710,10,N,N,-,-1,-1
MEMMUS.txt,382921,384697,1776,10,N,N,-,-1,-1
MEMMUS.txt,383102,384827,1725,10,N,N,-,-1,-1
MEMMUS.txt,383253,384835,1582,10,N,N,-,-1,-1
MEMMUS.txt,383517,384906,1389,10,N,N,-,-1,-1
MEMMUS.txt,383743,385213,1470,10,N,N,-,-1,-1
MEMMUS.txt,383927,385507,1580,10,N,N,-,-1,-1
MEMMUS.txt,384144,385687,1543,10,N,N,-,-1,-1
MEMMUS.txt,384300,385842,1542,10,N,N,-,-1,-1
MEMMUS.txt,384418,385859,1441,10,N,N,-,-1,-1
MEMMUS.txt,384520,385872,1352,10,N,N,-,-1,-1
MEMMUS.txt,384700,386102,1402,10,N,N,-,-1,-1
MEMMUS.txt,384830,386290,1460,10,N,N,-,-1,-1
MEMMUS.txt,384836,386566,1730,10,N,N,-,-1,-1
MEMMUS.txt,384907,386693,1786,10,N,N,-,-1,-1
MEMMUS.txt,385216,386900,1684,10,N,N,-,-1,-1
MEMMUS.txt,385508,387143,1635,10,N,N,-,-1,-1
MEMMUS.txt,385690,387372,1682,10,N,N,-,-1,-1
MEMMUS.txt,385843,387606,1763,10,N,N,-,-1,-1
MEMMUS.txt,385860,387714,1854,10,Y,N,-,-1,-1
MEMMUS.txt,385874,387850,1976,10,N,N,-,-1,-1
MEMMUS.txt,386104,388037,1933,10,N,N,-,-1,-1
MEMMUS.txt,386291,388188,1897,10,N,N,-,-1,-1
MEMMUS.txt,386569,388255,1686,10,N,N,-,-1,-1
MEMMUS.txt,386694,388287,1593,10,N,N,-,-1,-1
MEMMUS.txt,386903,388580,1677,10,N,N,-,-1,-1
MEMMUS.txt,387145,388790,1645,10,N,N,-,-1,-1
MEMMUS.txt,387373,388998,1625,10,N,N,-,-1,-1
MEMMUS.txt,387609,389091,1482,10,N,N,-,-1,-1
MEMMUS.txt,387717,389157,1440,10,N,N,-,-1,-1
MEMMUS.txt,387851,389342,1491,10,N,N,-,-1,-1
MEMMUS.txt,388038,389448,1410,10,N,N,-,-1,-1
MEMMUS.txt,388189,389663,1474,10,N,N,-,-1,-1
MEMMUS.txt,388256,389768,1512,10,N,N,-,-1,-1
MEMMUS.txt,388290,389794,1504,10,N,N,-,-1,-1
MEMMUS.txt,388581,389878,1297,10,N,N,-,-1,-1
MEMMUS.txt,388793,389941,1148,10,N,N,-,-1,-1
MEMMUS.txt,389003,390251,1248,10,N,N,-,-1,-1
MEMMUS.txt,389092,390454,1362,10,N,N,-,-1,-1
MEMMUS.txt,389158,390601,1443,10,N,N,-,-1,-1
MEMMUS.txt,389343,390850,1507,10,N,N,-,-1,-1
MEMMUS.txt,389451,391050,1599,10,N,N,-,-1,-1
MEMMUS.txt,389664,391125,1461,10,N,N,-,-1,-1
MEMMUS.txt,389771,391375,1604,10,N,N,-,-1,-1
MEMMUS.txt,389795,391473,1678,10,N,N,-,-1,-1
MEMMUS.txt,389879,391533,1654,10,N,N,-,-1,-1
MEMMUS.txt,389944,391717,1773,10,Y,N,-,-1,-1
MEMMUS.txt,390252,391820,1568,10,Y,N,-,-1,-1
MEMMUS.txt,390457,391932,1475,10,Y,N,-,-1,-1
MEMMUS.txt,390604,392061,1457,10,N,N,-,-1,-1
MEMMUS.txt,390851,392252,1401,10,N,N,-,-1,-1
MEMMUS.txt,391051,392306,1255,10,N,N,-,-1,-1
MEMMUS.txt,391126,392652,1526,10,N,N,-,-1,-1
MEMMUS.txt,391378,393033,1655,10,N,N,-,-1,-1
MEMMUS.txt,391474,393307,1833,10,N,N,-,-1,-1
MEMMUS.txt,391534,393428,1894,10,N,N,-,-1,-1
MEMMUS.txt,391720,393574,1854,10,N,N,-,-1,-1
MEMMUS.txt,391821,393776,1955,10,Y,N,-,-1,-1
MEMMUS.txt,391933,393945,2012,10,Y,N,-,-1,-1
MEMMUS.txt,392062,394079,2017,10,Y,N,-,-1,-1
MEMMUS.txt,392253,394190,1937,10,Y,N,-,-1,-1
MEMMUS.txt,392309,394388,2079,10,Y,N,-,-1,-1
MEMMUS.txt,392655,394558,1903,10,Y,N,-,-1,-1
MEMMUS.txt,393036,394591,1555,10,Y,N,-,-1,-1
MEMMUS.txt,393310,394819,1509,10,Y,N,-,-1,-1
MEMMUS.txt,393429,394938,1509,10,Y,N,-,-1,-1
MEMMUS.txt,393577,394965,1388,10,Y,N,-,-1,-1
MEMMUS.txt,393777,395184,1407,10,Y,N,-,-1,-1
MEMMUS.txt,393946,395253,1307,10,Y,N,-,-1,-1
MEMMUS.txt,394082,395417,1335,10,Y,N,-,-1,-1
MEMMUS.txt,394191,395529,1338,10,Y,N,-,-1,-1
MEMMUS.txt,394389,395679,1290,10,Y,N,-,-1,-1
MEMMUS.txt,394559,396074,1515,10,Y,N,-,-1,-1
MEMMUS.txt,394592,396143,1551,10,Y,N,-,-1,-1
MEMMUS.txt,394820,396280,1460,10,N,N,-,-1,-1
MEMMUS.txt,394940,396456,1516,10,N,N,-,-1,-1
MEMMUS.txt,394968,396613,1645,10,N,N,-,-1,-1
MEMMUS.txt,395185,396770,1585,10,N,N,-,-1,-1
MEMMUS.txt,395254,396969,1715,10,Y,N,-,-1,-1
MEMMUS.txt,395420,397139,1719,10,N,N,-,-1,-1
MEMMUS.txt,395530,397296,1766,10,Y,N,-,-1,-1
MEMMUS.txt,395680,397378,1698,10,Y,N,-,-1,-1
MEMMUS.txt,396077,397469,1392,10,N,N,-,-1,-1
MEMMUS.txt,396148,397709,1561,10,N,N,-,-1,-1
MEMMUS.txt,396281,397854,1573,10,N,N,-,-1,-1
MEMMUS.txt,396457,398081,1624,10,N,N,-,-1,-1
MEMMUS.txt,396616,398117,1501,10,N,N,-,-1,-1
MEMMUS.txt,396771,398135,1364,10,N,N,-,-1,-1
MEMMUS.txt,396970,398322,1352,10,N,N,-,-1,-1
MEMMUS.txt,397140,398505,1365,10,N,N,-,-1,-1
MEMMUS.txt,397297,398560,1263,10,N,N,-,-1,-1
MEMMUS.txt,397379,398686,1307,10,N,N,-,-1,-1
MEMMUS.txt,397470,398787,1317,10,N,N,-,-1,-1
MEMMUS.txt,397712,398942,1230,10,N,N,-,-1,-1
MEMMUS.txt,397855,399158,1303,10,N,N,-,-1,-1
MEMMUS.txt,398082,399306,1224,10,N,N,-,-1,-1
MEMMUS.txt,398118,399493,1375,10,N,N,-,-1,-1
MEMMUS.txt,398138,399723,1585,10,N,N,-,-1,-1
MEMMUS.txt,398324,399874,1550,10,Y,N,-,-1,-1
MEMMUS.txt,398506,399990,1484,10,Y,N,-,-1,-1
MEMMUS.txt,398561,400224,1663,10,N,N,-,-1,-1
MEMMUS.txt,398689,400330,1641,10,N,N,-,-1,-1
MEMMUS.txt,398788,400494,1706,10,N,N,-,-1,-1
MEMMUS.txt,398943,401043,2100,10,N,N,-,-1,-1
MEMMUS.txt,399159,401267,2108,10,N,N,-,-1,-1
MEMMUS.txt,399307,401518,2211,10,N,N,-,-1,-1
MEMMUS.txt,399494,401644,2150,10,N,N,-,-1,-1
MEMMUS.txt,399724,401820,2096,10,N,N,-,-1,-1
MEMMUS.txt,399875,401857,1982,10,N,N,-,-1,-1
MEMMUS.txt,399993,401984,1991,10,N,N,-,-1,-1
MEMMUS.txt,400226,402133,1907,10,N,N,-,-1,-1
MEMMUS.txt,400331,402247,1916,10,N,N,-,-1,-1
MEMMUS.txt,400499,402397,1898,10,N,N,-,-1,-1
MEMMUS.txt,401046,402470,1424,10,N,N,-,-1,-1
MEMMUS.txt,401268,402663,1395,10,N,N,-,-1,-1
MEMMUS.txt,401521,402708,1187,10,N,N,-,-1,-1
MEMMUS.txt,401645,402792,1147,10,N,N,-,-1,-1
MEMMUS.txt,401823,402836,1013,10,N,N,-,-1,-1
MEMMUS.txt,401858,402919,1061,10,N,N,-,-1,-1
MEMMUS.txt,401985,402968,983,10,N,N,-,-1,-1
MEMMUS.txt,402134,402982,848,10,N,N,-,-1,-1
MEMMUS.txt,402248,402999,751,10,N,N,-,-1,-1
MEMMUS.txt,402400,403008,608,10,N,N,-,-1,-1
MEMMUS.txt,402473,403021,548,10,N,N,-,-1,-1
MEMMUS.txt,402664,403042,378,10,N,N,-,-1,-1
MEMMUS.txt,402709,403068,359,10,N,N,-,-1,-1
MEMMUS.txt,402794,403072,278,10,N,N,-,-1,-1
MEMMUS.txt,402838,403081,243,10,N,N,-,-1,-1
MEMMUS.txt,402922,403100,178,10,N,N,-,-1,-1
MEMMUS.txt,402971,403122,151,10,N,N,-,-1,-1
MEMMUS.txt,402983,403132,149,10,N,N,-,-1,-1
MEMMUS.txt,403000,403178,178,10,N,N,-,-1,-1
MEMMUS.txt,403009,403465,456,10,N,N,-,-1,-1
MEMMUS.txt,403024,403582,558,10,N,N,-,-1,-1
MEMMUS.txt,403045,403711,666,10,N,N,-,-1,-1
MEMMUS.txt,403069,403743,674,10,N,N,-,-1,-1
MEMMUS.txt,403073,404018,945,10,N,N,-,-1,-1
MEMMUS.txt,403082,404266,1184,10,N,N,-,-1,-1
MEMMUS.txt,403102,404560,1458,10,N,N,-,-1,-1
MEMMUS.txt,403123,404771,1648,10,N,N,-,-1,-1
MEMMUS.txt,403135,404959,1824,10,N,N,-,-1,-1
MEMMUS.txt,403181,405107,1926,10,N,N,-,-1,-1
MEMMUS.txt,403468,405571,2103,10,N,N,-,-1,-1
MEMMUS.txt,403583,405697,2114,10,N,N,-,-1,-1
MEMMUS.txt,403712,405971,2259,10,N,N,-,-1,-1
MEMMUS.txt,403743,406088,2345,10,N,N,-,-1,-1
MEMMUS.txt,404021,406312,2291,10,N,N,-,-1,-1
MEMMUS.txt,404267,406510,2243,10,N,N,-,-1,-1
MEMMUS.txt,404561,406882,2321,10,N,N,-,-1,-1
MEMMUS.txt,404774,406921,2147,10,N,N,-,-1,-1
MEMMUS.txt,404961,406973,2012,10,N,N,-,-1,-1
MEMMUS.txt,405110,407054,1944,10,N,N,-,-1,-1
MEMMUS.txt,405572,407355,1783,10,N,N,-,-1,-1
MEMMUS.txt,405698,407505,1807,10,N,N,-,-1,-1
MEMMUS.txt,405972,407680,1708,10,N,Y,1448366833867,275966,276698
MEMMUS.txt,406091,407790,1699,10,N,Y,1448366833867,275966,276698
MEMMUS.txt,406314,407927,1613,10,N,Y,1448366833867,275966,276698
MEMMUS.txt,406513,408157,1644,10,N,Y,1448366833867,275966,276698
MEMMUS.txt,406884,408410,1526,10,N,Y,1448366833867,275966,276698
MEMMUS.txt,406922,408470,1548,10,N,Y,1448366833867,275966,276698
MEMMUS.txt,406974,408646,1672,10,N,Y,1448366833867,275966,276698
MEMMUS.txt,407057,408784,1727,10,N,Y,1448366833867,275966,276698
MEMMUS.txt,407356,408953,1597,10,N,Y,1448366833867,275966,276698
MEMMUS.txt,407508,409136,1628,10,N,Y,1448366833867,275966,276698
MEMMUS.txt,407681,409379,1698,10,N,Y,1448366833867,275966,276698
MEMMUS.txt,407791,409438,1647,10,Y,Y,1448366833867,275966,276698
MEMMUS.txt,407928,409558,1630,10,Y,Y,1448366833867,275966,276698
MEMMUS.txt,408158,409740,1582,10,Y,Y,1448366833867,275966,276698
MEMMUS.txt,408412,409849,1437,10,Y,Y,1448366833867,275966,276698
MEMMUS.txt,408471,409914,1443,10,Y,Y,1448366833867,275966,276698
MEMMUS.txt,408649,410031,1382,10,Y,Y,1448366833867,275966,276698
MEMMUS.txt,408785,410347,1562,10,Y,Y,1448366833867,275966,276698
MEMMUS.txt,408956,410577,1621,10,Y,Y,1448366833867,275966,276698
MEMMUS.txt,409137,410710,1573,10,Y,Y,1448366833867,275966,276698
MEMMUS.txt,409382,410969,1587,10,Y,Y,1448366833867,275966,276698
MEMMUS.txt,409439,411014,1575,10,Y,Y,1448366833867,275966,276698
MEMMUS.txt,409559,411018,1459,10,N,Y,1448366833867,275966,276698
MEMMUS.txt,409741,411063,1322,10,N,Y,1448366833867,275966,276698
MEMMUS.txt,409852,411218,1366,10,Y,N,-,-1,-1
MEMMUS.txt,409915,411304,1389,10,N,N,-,-1,-1
MEMMUS.txt,410034,411387,1353,10,N,N,-,-1,-1
MEMMUS.txt,410348,411650,1302,10,N,N,-,-1,-1
MEMMUS.txt,410580,411749,1169,10,N,N,-,-1,-1
MEMMUS.txt,410713,411952,1239,10,N,N,-,-1,-1
MEMMUS.txt,410971,412329,1358,10,N,N,-,-1,-1
MEMMUS.txt,411015,412588,1573,10,N,N,-,-1,-1
MEMMUS.txt,411020,412810,1790,10,N,N,-,-1,-1
MEMMUS.txt,411066,413128,2062,10,N,N,-,-1,-1
MEMMUS.txt,411219,413283,2064,10,N,N,-,-1,-1
MEMMUS.txt,411307,413647,2340,10,N,N,-,-1,-1
MEMMUS.txt,411388,413707,2319,10,N,N,-,-1,-1
MEMMUS.txt,411653,413933,2280,10,N,N,-,-1,-1
MEMMUS.txt,411751,414242,2491,10,N,N,-,-1,-1
MEMMUS.txt,411953,414484,2531,10,N,N,-,-1,-1
MEMMUS.txt,412332,414607,2275,10,N,N,-,-1,-1
MEMMUS.txt,412589,414811,2222,10,N,N,-,-1,-1
MEMMUS.txt,412813,414955,2142,10,N,N,-,-1,-1
MEMMUS.txt,413129,415140,2011,10,N,N,-,-1,-1
MEMMUS.txt,413286,415180,1894,10,N,N,-,-1,-1
MEMMUS.txt,413648,415388,1740,10,N,N,-,-1,-1
MEMMUS.txt,413710,415599,1889,10,N,N,-,-1,-1
MEMMUS.txt,413936,415896,1960,10,N,N,-,-1,-1
MEMMUS.txt,414245,416017,1772,10,N,N,-,-1,-1
MEMMUS.txt,414487,416184,1697,10,N,N,-,-1,-1
MEMMUS.txt,414608,416367,1759,10,N,N,-,-1,-1
MEMMUS.txt,414812,416556,1744,10,Y,N,-,-1,-1
MEMMUS.txt,414957,416611,1654,10,N,N,-,-1,-1
MEMMUS.txt,415141,416761,1620,10,N,N,-,-1,-1
MEMMUS.txt,415183,416884,1701,10,Y,N,-,-1,-1
MEMMUS.txt,415389,417012,1623,10,Y,N,-,-1,-1
MEMMUS.txt,415600,417239,1639,10,Y,N,-,-1,-1
MEMMUS.txt,415898,417398,1500,10,Y,N,-,-1,-1
MEMMUS.txt,416018,417442,1424,10,N,N,-,-1,-1
MEMMUS.txt,416187,417607,1420,10,N,N,-,-1,-1
MEMMUS.txt,416368,417693,1325,10,N,N,-,-1,-1
MEMMUS.txt,416557,417854,1297,10,N,N,-,-1,-1
MEMMUS.txt,416614,418041,1427,10,N,N,-,-1,-1
MEMMUS.txt,416762,418202,1440,10,N,N,-,-1,-1
MEMMUS.txt,416886,418382,1496,10,N,N,-,-1,-1
MEMMUS.txt,417013,418435,1422,10,N,N,-,-1,-1
MEMMUS.txt,417242,418573,1331,10,N,N,-,-1,-1
MEMMUS.txt,417399,418653,1254,10,N,N,-,-1,-1
MEMMUS.txt,417445,418714,1269,10,N,N,-,-1,-1
MEMMUS.txt,417608,418796,1188,10,N,N,-,-1,-1
MEMMUS.txt,417696,418935,1239,10,Y,N,-,-1,-1
MEMMUS.txt,417856,419076,1220,10,Y,N,-,-1,-1
MEMMUS.txt,418044,419090,1046,10,Y,N,-,-1,-1
MEMMUS.txt,418205,419206,1001,10,Y,N,-,-1,-1
MEMMUS.txt,418385,419426,1041,10,Y,N,-,-1,-1
MEMMUS.txt,418436,419495,1059,10,Y,N,-,-1,-1
MEMMUS.txt,418574,419654,1080,10,Y,N,-,-1,-1
MEMMUS.txt,418654,419727,1073,10,Y,N,-,-1,-1
MEMMUS.txt,418715,419843,1128,10,Y,N,-,-1,-1
MEMMUS.txt,418798,419969,1171,10,Y,N,-,-1,-1
MEMMUS.txt,418937,420144,1207,10,Y,N,-,-1,-1
MEMMUS.txt,419077,420264,1187,10,Y,N,-,-1,-1
MEMMUS.txt,419091,420509,1418,10,Y,N,-,-1,-1
MEMMUS.txt,419211,420686,1475,10,Y,N,-,-1,-1
MEMMUS.txt,419428,420728,1300,10,Y,N,-,-1,-1
MEMMUS.txt,419498,420938,1440,10,Y,N,-,-1,-1
MEMMUS.txt,419655,420985,1330,10,Y,N,-,-1,-1
MEMMUS.txt,419728,421138,1410,10,Y,N,-,-1,-1
MEMMUS.txt,419844,421359,1515,10,Y,N,-,-1,-1
MEMMUS.txt,419970,421482,1512,10,Y,N,-,-1,-1
MEMMUS.txt,420146,421595,1449,10,Y,N,-,-1,-1
MEMMUS.txt,420267,421740,1473,10,Y,N,-,-1,-1
MEMMUS.txt,420512,422068,1556,10,N,N,-,-1,-1
MEMMUS.txt,420687,422096,1409,10,N,N,-,-1,-1
MEMMUS.txt,420729,422141,1412,10,N,N,-,-1,-1
MEMMUS.txt,420939,422340,1401,10,N,N,-,-1,-1
MEMMUS.txt,420986,422419,1433,10,N,N,-,-1,-1
MEMMUS.txt,421139,422502,1363,10,N,N,-,-1,-1
MEMMUS.txt,421360,422740,1380,10,N,N,-,-1,-1
MEMMUS.txt,421484,422811,1327,10,N,N,-,-1,-1
MEMMUS.txt,421596,422980,1384,10,N,N,-,-1,-1
MEMMUS.txt,421743,423062,1319,10,N,N,-,-1,-1
MEMMUS.txt,422070,423199,1129,10,N,N,-,-1,-1
MEMMUS.txt,422101,423417,1316,10,N,N,-,-1,-1
MEMMUS.txt,422144,423473,1329,10,N,N,-,-1,-1
MEMMUS.txt,422343,423581,1238,10,N,N,-,-1,-1
MEMMUS.txt,422420,423684,1264,10,N,N,-,-1,-1
MEMMUS.txt,422505,423745,1240,10,N,N,-,-1,-1
MEMMUS.txt,422741,423932,1191,10,N,N,-,-1,-1
MEMMUS.txt,422814,424134,1320,10,N,N,-,-1,-1
MEMMUS.txt,422981,424338,1357,10,N,N,-,-1,-1
MEMMUS.txt,423065,424547,1482,10,N,N,-,-1,-1
MEMMUS.txt,423202,424705,1503,10,N,N,-,-1,-1
MEMMUS.txt,423420,424997,1577,10,N,N,-,-1,-1
MEMMUS.txt,423474,425157,1683,10,N,N,-,-1,-1
MEMMUS.txt,423582,425509,1927,10,N,N,-,-1,-1
MEMMUS.txt,423685,425577,1892,10,N,N,-,-1,-1
MEMMUS.txt,423746,425816,2070,10,N,N,-,-1,-1
MEMMUS.txt,423933,426088,2155,10,N,N,-,-1,-1
MEMMUS.txt,424135,426122,1987,10,N,N,-,-1,-1
MEMMUS.txt,424339,426292,1953,10,N,N,-,-1,-1
MEMMUS.txt,424550,426650,2100,10,N,N,-,-1,-1
MEMMUS.txt,424707,426684,1977,10,N,N,-,-1,-1
MEMMUS.txt,424998,426754,1756,10,N,N,-,-1,-1
MEMMUS.txt,425159,426896,1737,10,N,N,-,-1,-1
MEMMUS.txt,425510,427081,1571,10,N,N,-,-1,-1
MEMMUS.txt,425580,427286,1706,10,N,N,-,-1,-1
MEMMUS.txt,425819,427476,1657,10,N,N,-,-1,-1
MEMMUS.txt,426093,427638,1545,10,N,N,-,-1,-1
MEMMUS.txt,426125,427872,1747,10,N,N,-,-1,-1
MEMMUS.txt,426293,428088,1795,10,N,N,-,-1,-1
MEMMUS.txt,426651,428295,1644,10,N,N,-,-1,-1
MEMMUS.txt,426685,428390,1705,10,N,N,-,-1,-1
MEMMUS.txt,426756,428441,1685,10,N,N,-,-1,-1
MEMMUS.txt,426898,428633,1735,10,N,N,-,-1,-1
MEMMUS.txt,427082,428776,1694,10,N,N,-,-1,-1
MEMMUS.txt,427289,428827,1538,10,N,N,-,-1,-1
MEMMUS.txt,427481,428960,1479,10,N,N,-,-1,-1
MEMMUS.txt,427639,429001,1362,10,N,N,-,-1,-1
MEMMUS.txt,427873,429041,1168,10,N,N,-,-1,-1
MEMMUS.txt,428091,429173,1082,10,N,N,-,-1,-1
MEMMUS.txt,428296,429281,985,10,N,N,-,-1,-1
MEMMUS.txt,428391,429453,1062,10,N,N,-,-1,-1
MEMMUS.txt,428442,429558,1116,10,N,N,-,-1,-1
MEMMUS.txt,428634,429626,992,10,N,N,-,-1,-1
MEMMUS.txt,428776,429643,867,10,N,N,-,-1,-1
MEMMUS.txt,428828,429766,938,10,N,N,-,-1,-1
MEMMUS.txt,428962,429844,882,10,N,N,-,-1,-1
MEMMUS.txt,429002,429879,877,10,N,N,-,-1,-1
MEMMUS.txt,429044,430024,980,10,N,N,-,-1,-1
MEMMUS.txt,429174,430074,900,10,N,N,-,-1,-1
MEMMUS.txt,429282,430136,854,10,N,N,-,-1,-1
MEMMUS.txt,429455,431664,2209,10,N,N,-,-1,-1
MEMMUS.txt,429559,431734,2175,10,N,N,-,-1,-1
MEMMUS.txt,429627,431779,2152,10,N,N,-,-1,-1
MEMMUS.txt,429645,431949,2304,10,N,N,-,-1,-1
MEMMUS.txt,429767,432025,2258,10,N,N,-,-1,-1
MEMMUS.txt,429847,432201,2354,10,N,N,-,-1,-1
MEMMUS.txt,429880,432365,2485,10,N,N,-,-1,-1
MEMMUS.txt,430025,432553,2528,10,N,N,-,-1,-1
MEMMUS.txt,430077,432674,2597,10,N,N,-,-1,-1
MEMMUS.txt,430139,432846,2707,10,N,N,-,-1,-1
MEMMUS.txt,431667,432950,1283,10,N,N,-,-1,-1
MEMMUS.txt,431735,433014,1279,10,N,N,-,-1,-1
MEMMUS.txt,431782,433062,1280,10,N,N,-,-1,-1
MEMMUS.txt,431950,433168,1218,10,N,N,-,-1,-1
MEMMUS.txt,432026,433229,1203,10,N,N,-,-1,-1
MEMMUS.txt,432204,433396,1192,10,N,N,-,-1,-1
MEMMUS.txt,432368,433490,1122,10,N,N,-,-1,-1
MEMMUS.txt,432555,433603,1048,10,N,N,-,-1,-1
MEMMUS.txt,432675,433739,1064,10,N,N,-,-1,-1
MEMMUS.txt,432847,433897,1050,10,N,N,-,-1,-1
MEMMUS.txt,432951,433993,1042,10,N,N,-,-1,-1
MEMMUS.txt,433015,434152,1137,10,N,N,-,-1,-1
MEMMUS.txt,433065,434177,1112,10,N,N,-,-1,-1
MEMMUS.txt,433169,434270,1101,10,N,N,-,-1,-1
MEMMUS.txt,433230,434399,1169,10,N,N,-,-1,-1
MEMMUS.txt,433397,434640,1243,10,N,N,-,-1,-1
MEMMUS.txt,433493,434967,1474,10,N,N,-,-1,-1
MEMMUS.txt,433604,435185,1581,10,Y,N,-,-1,-1
MEMMUS.txt,433740,435296,1556,10,Y,N,-,-1,-1
MEMMUS.txt,433900,435414,1514,10,N,N,-,-1,-1
MEMMUS.txt,433994,435565,1571,10,N,N,-,-1,-1
MEMMUS.txt,434153,435656,1503,10,N,N,-,-1,-1
MEMMUS.txt,434178,435784,1606,10,N,N,-,-1,-1
MEMMUS.txt,434273,435887,1614,10,N,N,-,-1,-1
MEMMUS.txt,434400,435956,1556,10,N,N,-,-1,-1
MEMMUS.txt,434641,436796,2155,10,N,N,-,-1,-1
MEMMUS.txt,434968,436883,1915,10,N,Y,1448369133400,279084,280004
MEMMUS.txt,435186,437152,1966,10,N,Y,1448369133400,279084,280004
MEMMUS.txt,435297,437487,2190,10,Y,Y,1448369133400,279084,280004
MEMMUS.txt,435417,437774,2357,10,Y,Y,1448369133400,279084,280004
MEMMUS.txt,435566,437838,2272,10,Y,Y,1448369133400,279084,280004
MEMMUS.txt,435657,437991,2334,10,Y,Y,1448369133400,279084,280004
MEMMUS.txt,435786,438077,2291,10,Y,Y,1448322514970,220165,221397
MEMMUS.txt,435888,438212,2324,10,Y,Y,1448322514970,220165,221397
MEMMUS.txt,435961,438297,2336,10,Y,Y,1448322514970,220165,221397
MEMMUS.txt,436799,438332,1533,10,Y,Y,1448322514970,220165,221397
MEMMUS.txt,436884,438364,1480,10,Y,Y,1448322514970,220165,221397
MEMMUS.txt,437153,438382,1229,10,Y,Y,1448322514970,220165,221397
MEMMUS.txt,437488,438507,1019,10,Y,Y,1448322514970,220165,221397
MEMMUS.txt,437775,438715,940,10,N,Y,1448322514970,220165,221397
MEMMUS.txt,437839,438743,904,10,N,Y,1448322514970,220165,221397
MEMMUS.txt,437994,439032,1038,10,N,Y,1448322514970,220165,221397
MEMMUS.txt,438078,439354,1276,10,Y,Y,1448322514970,220165,221397
MEMMUS.txt,438213,439648,1435,10,Y,Y,1448277582432,52552,54595
MEMMUS.txt,438298,439742,1444,10,Y,Y,1448277582432,52552,54595
MEMMUS.txt,438333,439864,1531,10,Y,Y,1448277582432,52552,54595
MEMMUS.txt,438366,440025,1659,10,Y,Y,1448277582432,52552,54595
MEMMUS.txt,438383,440269,1886,10,Y,Y,1448277582432,52552,54595
MEMMUS.txt,438509,440368,1859,10,Y,Y,1448277582432,52552,54595
MEMMUS.txt,438721,440487,1766,10,Y,Y,1448277582432,52552,54595
MEMMUS.txt,438748,440567,1819,10,N,Y,1448277582432,52552,54595
MEMMUS.txt,439033,440721,1688,10,Y,Y,1448277582432,52552,54595
MEMMUS.txt,439357,440795,1438,10,N,Y,1448277582432,52552,54595
MEMMUS.txt,439649,441012,1363,10,Y,Y,1448277582432,52552,54595
MEMMUS.txt,439743,441105,1362,10,N,Y,1448277582432,52552,54595
MEMMUS.txt,439865,441259,1394,10,N,Y,1448277582432,52552,54595
MEMMUS.txt,440028,441376,1348,10,Y,N,-,-1,-1
MEMMUS.txt,440271,441448,1177,10,Y,N,-,-1,-1
MEMMUS.txt,440369,441563,1194,10,Y,N,-,-1,-1
MEMMUS.txt,440488,441623,1135,10,Y,N,-,-1,-1
MEMMUS.txt,440568,441669,1101,10,Y,N,-,-1,-1
MEMMUS.txt,440722,441760,1038,10,N,N,-,-1,-1
MEMMUS.txt,440796,441828,1032,10,N,N,-,-1,-1
MEMMUS.txt,441015,441848,833,10,N,N,-,-1,-1
MEMMUS.txt,441107,441921,814,10,N,N,-,-1,-1
MEMMUS.txt,441260,442021,761,10,N,N,-,-1,-1
MEMMUS.txt,441377,442099,722,10,N,N,-,-1,-1
MEMMUS.txt,441449,442139,690,10,N,N,-,-1,-1
MEMMUS.txt,441565,442167,602,10,N,N,-,-1,-1
MEMMUS.txt,441624,442207,583,10,N,N,-,-1,-1
MEMMUS.txt,441670,442437,767,10,N,N,-,-1,-1
MEMMUS.txt,441761,442470,709,10,N,N,-,-1,-1
MEMMUS.txt,441829,442617,788,10,N,N,-,-1,-1
MEMMUS.txt,441849,442870,1021,10,N,N,-,-1,-1
MEMMUS.txt,441922,443057,1135,10,N,N,-,-1,-1
MEMMUS.txt,442022,443218,1196,10,N,N,-,-1,-1
MEMMUS.txt,442100,443372,1272,10,N,N,-,-1,-1
MEMMUS.txt,442140,443607,1467,10,N,Y,1436867017136,105674,106651
MEMMUS.txt,442168,443691,1523,10,N,Y,1436867017136,105674,106651
MEMMUS.txt,442210,443800,1590,10,N,Y,1436867017136,105674,106651
MEMMUS.txt,442438,443872,1434,10,N,Y,1436867017136,105674,106651
MEMMUS.txt,442471,444143,1672,10,N,Y,1436867017136,105674,106651
MEMMUS.txt,442620,444276,1656,10,N,Y,1436867017136,105674,106651
MEMMUS.txt,442871,444434,1563,10,Y,Y,1436867017136,105674,106651
MEMMUS.txt,443058,444513,1455,10,Y,Y,1436867017136,105674,106651
MEMMUS.txt,443219,444622,1403,10,Y,Y,1436867017136,105674,106651
MEMMUS.txt,443375,444865,1490,10,Y,Y,1436867017136,105674,106651
MEMMUS.txt,443608,444959,1351,10,Y,Y,1436867017136,105674,106651
MEMMUS.txt,443693,445322,1629,10,Y,Y,1436867017136,105674,106651
MEMMUS.txt,443803,445551,1748,10,Y,Y,1436867017136,105674,106651
MEMMUS.txt,443873,445661,1788,10,Y,Y,1436867017136,105674,106651
MEMMUS.txt,444144,445787,1643,10,Y,Y,1436867017136,105674,106651
MEMMUS.txt,444277,445955,1678,10,Y,Y,1436867017136,105674,106651
MEMMUS.txt,444436,446098,1662,10,N,Y,1436867017136,105674,106651
MEMMUS.txt,444514,446287,1773,10,N,Y,1436867017136,105674,106651
MEMMUS.txt,444624,446494,1870,10,N,Y,1436867017136,105674,106651
MEMMUS.txt,444871,446653,1782,10,Y,Y,1448274893770,25386,26202
MEMMUS.txt,444960,446756,1796,10,Y,Y,1448274893770,25386,26202
MEMMUS.txt,445325,446829,1504,10,N,Y,1448274893770,25386,26202
MEMMUS.txt,445554,447113,1559,10,N,Y,1448274893770,25386,26202
MEMMUS.txt,445662,447334,1672,10,N,Y,1448274893770,25386,26202
MEMMUS.txt,445788,447430,1642,10,N,Y,1448274893770,25386,26202
MEMMUS.txt,445956,447697,1741,10,Y,Y,1448274893770,25386,26202
MEMMUS.txt,446100,447798,1698,10,Y,Y,1448312128598,172353,173027
MEMMUS.txt,446290,447978,1688,10,N,Y,1448312128598,172353,173027
MEMMUS.txt,446495,448167,1672,10,N,Y,1448312128598,172353,173027
MEMMUS.txt,446654,448381,1727,10,Y,Y,1448312128598,172353,173027
MEMMUS.txt,446757,448451,1694,10,Y,Y,1448312128598,172353,173027
MEMMUS.txt,446830,448545,1715,10,Y,Y,1448312128598,172353,173027
MEMMUS.txt,447116,448666,1550,10,Y,Y,1448312128598,172353,173027
MEMMUS.txt,447335,448953,1618,10,Y,Y,1448287306770,114686,120152
MEMMUS.txt,447431,449101,1670,10,Y,Y,1448287306770,114686,120152
MEMMUS.txt,447700,449191,1491,10,N,Y,1448287306770,114686,120152
MEMMUS.txt,447800,449287,1487,10,N,Y,1448287306770,114686,120152
MEMMUS.txt,447979,449338,1359,10,N,Y,1448287306770,114686,120152
MEMMUS.txt,448170,449475,1305,10,N,Y,1448287306770,114686,120152
MEMMUS.txt,448382,449552,1170,10,N,Y,1448287306770,114686,120152
MEMMUS.txt,448452,449726,1274,10,N,Y,1448287306770,114686,120152
MEMMUS.txt,448546,449936,1390,10,N,Y,1448287306770,114686,120152
MEMMUS.txt,448668,450200,1532,10,N,Y,1448287306770,114686,120152
MEMMUS.txt,448954,450375,1421,10,N,Y,1448287306770,114686,120152
MEMMUS.txt,449102,450501,1399,10,N,Y,1448287306770,114686,120152
MEMMUS.txt,449193,450620,1427,10,N,Y,1448287306770,114686,120152
MEMMUS.txt,449289,450712,1423,10,N,Y,1448287306770,114686,120152
MEMMUS.txt,449339,450843,1504,10,N,N,-,-1,-1
MEMMUS.txt,449478,450951,1473,10,N,N,-,-1,-1
MEMMUS.txt,449553,451067,1514,10,N,N,-,-1,-1
MEMMUS.txt,449727,451237,1510,10,N,N,-,-1,-1
MEMMUS.txt,449939,451384,1445,10,N,N,-,-1,-1
MEMMUS.txt,450201,451457,1256,10,N,N,-,-1,-1
MEMMUS.txt,450376,451615,1239,10,N,N,-,-1,-1
MEMMUS.txt,450504,451773,1269,10,N,N,-,-1,-1
MEMMUS.txt,450621,451955,1334,10,N,N,-,-1,-1
MEMMUS.txt,450713,452381,1668,10,N,N,-,-1,-1
MEMMUS.txt,450844,452523,1679,10,N,N,-,-1,-1
MEMMUS.txt,450954,452605,1651,10,N,N,-,-1,-1
MEMMUS.txt,451068,452653,1585,10,N,Y,1448311366799,143137,146264
MEMMUS.txt,451238,452851,1613,10,N,Y,1448311366799,143137,146264
MEMMUS.txt,451385,452933,1548,10,N,Y,1448311366799,143137,146264
MEMMUS.txt,451459,453008,1549,10,N,Y,1448311366799,143137,146264
MEMMUS.txt,451618,453061,1443,10,N,Y,1448311366799,143137,146264
MEMMUS.txt,451774,453215,1441,10,N,Y,1448311366799,143137,146264
MEMMUS.txt,451958,453401,1443,10,N,Y,1448311366799,143137,146264
MEMMUS.txt,452382,453735,1353,10,N,Y,1448311366799,143137,146264
MEMMUS.txt,452524,453904,1380,10,N,Y,1448311366799,143137,146264
MEMMUS.txt,452608,454057,1449,10,N,Y,1448311366799,143137,146264
MEMMUS.txt,452655,454294,1639,10,N,Y,1448311366799,143137,146264
MEMMUS.txt,452852,454422,1570,10,N,Y,1448311366799,143137,146264
MEMMUS.txt,452935,454490,1555,10,N,Y,1448311366799,143137,146264
MEMMUS.txt,453009,454759,1750,10,N,Y,1448311366799,143137,146264
MEMMUS.txt,453062,454946,1884,10,N,Y,1448311366799,143137,146264
MEMMUS.txt,453216,455119,1903,10,N,Y,1448311366799,143137,146264
MEMMUS.txt,453404,455460,2056,10,N,N,-,-1,-1
MEMMUS.txt,453736,455634,1898,10,N,N,-,-1,-1
MEMMUS.txt,453905,455774,1869,10,Y,N,-,-1,-1
MEMMUS.txt,454058,455838,1780,10,Y,N,-,-1,-1
MEMMUS.txt,454297,455974,1677,10,Y,N,-,-1,-1
MEMMUS.txt,454423,456076,1653,10,N,N,-,-1,-1
MEMMUS.txt,454492,456157,1665,10,N,N,-,-1,-1
MEMMUS.txt,454760,456205,1445,10,N,N,-,-1,-1
MEMMUS.txt,454947,456344,1397,10,Y,N,-,-1,-1
MEMMUS.txt,455120,456410,1290,10,Y,N,-,-1,-1
MEMMUS.txt,455463,456448,985,10,N,N,-,-1,-1
MEMMUS.txt,455635,456563,928,10,N,N,-,-1,-1
MEMMUS.txt,455775,456674,899,10,N,N,-,-1,-1
MEMMUS.txt,455840,456783,943,10,N,N,-,-1,-1
MEMMUS.txt,455977,456874,897,10,N,N,-,-1,-1
MEMMUS.txt,456077,457032,955,10,N,N,-,-1,-1
MEMMUS.txt,456158,457158,1000,10,N,N,-,-1,-1
MEMMUS.txt,456206,457308,1102,10,N,N,-,-1,-1
MEMMUS.txt,456345,457386,1041,10,N,N,-,-1,-1
MEMMUS.txt,456411,457486,1075,10,N,N,-,-1,-1
MEMMUS.txt,456449,457641,1192,10,N,N,-,-1,-1
MEMMUS.txt,456564,457708,1144,10,N,N,-,-1,-1
MEMMUS.txt,456675,457911,1236,10,N,N,-,-1,-1
MEMMUS.txt,456784,458050,1266,10,N,N,-,-1,-1
MEMMUS.txt,456875,458141,1266,10,N,N,-,-1,-1
MEMMUS.txt,457035,458287,1252,10,N,N,-,-1,-1
MEMMUS.txt,457161,458349,1188,10,N,N,-,-1,-1
MEMMUS.txt,457309,458407,1098,10,N,N,-,-1,-1
MEMMUS.txt,457387,458542,1155,10,N,N,-,-1,-1
MEMMUS.txt,457487,458799,1312,10,N,N,-,-1,-1
MEMMUS.txt,457642,458944,1302,10,N,N,-,-1,-1
MEMMUS.txt,457711,459108,1397,10,N,N,-,-1,-1
MEMMUS.txt,457914,459256,1342,10,N,N,-,-1,-1
MEMMUS.txt,458052,459294,1242,10,N,N,-,-1,-1
MEMMUS.txt,458143,459356,1213,10,N,N,-,-1,-1
MEMMUS.txt,458288,459412,1124,10,N,N,-,-1,-1
MEMMUS.txt,458350,459700,1350,10,N,N,-,-1,-1
MEMMUS.txt,458408,459868,1460,10,N,N,-,-1,-1
MEMMUS.txt,458545,460120,1575,10,N,N,-,-1,-1
MEMMUS.txt,458800,460281,1481,10,N,N,-,-1,-1
MEMMUS.txt,458945,460528,1583,10,N,N,-,-1,-1
MEMMUS.txt,459111,460606,1495,10,N,N,-,-1,-1
MEMMUS.txt,459257,461047,1790,10,N,N,-,-1,-1
MEMMUS.txt,459295,461287,1992,10,N,N,-,-1,-1
MEMMUS.txt,459357,461445,2088,10,N,N,-,-1,-1
MEMMUS.txt,459415,461516,2101,10,N,N,-,-1,-1
MEMMUS.txt,459701,461938,2237,10,N,N,-,-1,-1
MEMMUS.txt,459869,462140,2271,10,N,N,-,-1,-1
MEMMUS.txt,460123,462159,2036,10,N,N,-,-1,-1
MEMMUS.txt,460284,462162,1878,10,N,N,-,-1,-1
MEMMUS.txt,460529,462610,2081,10,Y,N,-,-1,-1
MEMMUS.txt,460608,462720,2112,10,Y,N,-,-1,-1
MEMMUS.txt,461048,462790,1742,10,Y,N,-,-1,-1
MEMMUS.txt,461292,462842,1550,10,N,N,-,-1,-1
MEMMUS.txt,461446,462965,1519,10,Y,N,-,-1,-1
MEMMUS.txt,461517,463354,1837,10,Y,N,-,-1,-1
MEMMUS.txt,461939,463595,1656,10,Y,N,-,-1,-1
MEMMUS.txt,462145,463786,1641,10,Y,N,-,-1,-1
MEMMUS.txt,462159,463855,1696,10,Y,N,-,-1,-1
MEMMUS.txt,462168,463974,1806,10,Y,N,-,-1,-1
MEMMUS.txt,462611,464125,1514,10,N,N,-,-1,-1
MEMMUS.txt,462725,464262,1537,10,Y,N,-,-1,-1
MEMMUS.txt,462791,464387,1596,10,Y,N,-,-1,-1
MEMMUS.txt,462843,464528,1685,10,Y,N,-,-1,-1
MEMMUS.txt,462966,464680,1714,10,Y,N,-,-1,-1
MEMMUS.txt,463355,464924,1569,10,Y,N,-,-1,-1
MEMMUS.txt,463598,465017,1419,10,Y,N,-,-1,-1
MEMMUS.txt,463787,465212,1425,10,Y,N,-,-1,-1
MEMMUS.txt,463856,465554,1698,10,Y,N,-,-1,-1
MEMMUS.txt,463975,465688,1713,10,Y,N,-,-1,-1
MEMMUS.txt,464128,465994,1866,10,Y,N,-,-1,-1
MEMMUS.txt,464263,466165,1902,10,Y,N,-,-1,-1
MEMMUS.txt,464388,466432,2044,10,Y,N,-,-1,-1
MEMMUS.txt,464529,466615,2086,10,Y,N,-,-1,-1
MEMMUS.txt,464681,466681,2000,10,Y,N,-,-1,-1
MEMMUS.txt,464925,466876,1951,10,Y,N,-,-1,-1
MEMMUS.txt,465020,466969,1949,10,Y,N,-,-1,-1
MEMMUS.txt,465213,467129,1916,10,N,N,-,-1,-1
MEMMUS.txt,465555,467247,1692,10,Y,N,-,-1,-1
MEMMUS.txt,465691,467405,1714,10,Y,N,-,-1,-1
MEMMUS.txt,465995,467556,1561,10,Y,N,-,-1,-1
MEMMUS.txt,466166,467607,1441,10,N,N,-,-1,-1
MEMMUS.txt,466435,467738,1303,10,N,N,-,-1,-1
MEMMUS.txt,466616,467848,1232,10,N,N,-,-1,-1
MEMMUS.txt,466682,468131,1449,10,N,N,-,-1,-1
MEMMUS.txt,466877,468460,1583,10,N,N,-,-1,-1
MEMMUS.txt,466970,468571,1601,10,N,N,-,-1,-1
MEMMUS.txt,467130,468659,1529,10,N,N,-,-1,-1
MEMMUS.txt,467250,469016,1766,10,N,N,-,-1,-1
MEMMUS.txt,467410,469124,1714,10,N,N,-,-1,-1
MEMMUS.txt,467557,469216,1659,10,N,Y,1448281491382,97818,98860
MEMMUS.txt,467608,469369,1761,10,N,Y,1448281491382,97818,98860
MEMMUS.txt,467739,469530,1791,10,N,Y,1448281491382,97818,98860
MEMMUS.txt,467851,469716,1865,10,N,Y,1448281491382,97818,98860
MEMMUS.txt,468133,469794,1661,10,N,Y,1448281491382,97818,98860
MEMMUS.txt,468461,469875,1414,10,N,Y,1448281491382,97818,98860
MEMMUS.txt,468572,470133,1561,10,N,Y,1448281491382,97818,98860
MEMMUS.txt,468662,470285,1623,10,N,Y,1448281491382,97818,98860
MEMMUS.txt,469021,470483,1462,10,N,Y,1448281491382,97818,98860
MEMMUS.txt,469127,470617,1490,10,N,Y,1448281491382,97818,98860
MEMMUS.txt,469219,470781,1562,10,N,Y,1448281491382,97818,98860
MEMMUS.txt,469372,470976,1604,10,N,Y,1448281491382,97818,98860
MEMMUS.txt,469531,471298,1767,10,N,Y,1448281491382,97818,98860
MEMMUS.txt,469717,471472,1755,10,N,Y,1448281491382,97818,98860
MEMMUS.txt,469795,471647,1852,10,N,Y,1448281491382,97818,98860
MEMMUS.txt,469878,471747,1869,10,N,Y,1448285563397,102964,108476
MEMMUS.txt,470134,472111,1977,10,N,Y,1448285563397,102964,108476
MEMMUS.txt,470286,472216,1930,10,N,Y,1448285563397,102964,108476
MEMMUS.txt,470485,472383,1898,10,N,Y,1448285563397,102964,108476
MEMMUS.txt,470618,472457,1839,10,N,Y,1448285563397,102964,108476
MEMMUS.txt,470782,472578,1796,10,N,Y,1448285563397,102964,108476
MEMMUS.txt,470977,472679,1702,10,N,Y,1448285563397,102964,108476
MEMMUS.txt,471300,472865,1565,10,N,Y,1448285563397,102964,108476
MEMMUS.txt,471473,472954,1481,10,N,Y,1448285563397,102964,108476
MEMMUS.txt,471650,473034,1384,10,N,Y,1448285563397,102964,108476
MEMMUS.txt,471752,473284,1532,10,N,Y,1448285563397,102964,108476
MEMMUS.txt,472114,473380,1266,10,N,Y,1448285563397,102964,108476
MEMMUS.txt,472217,473554,1337,10,N,Y,1448285563397,102964,108476
MEMMUS.txt,472386,473800,1414,10,N,Y,1448285563397,102964,108476
MEMMUS.txt,472458,474011,1553,10,N,Y,1448285563397,102964,108476
MEMMUS.txt,472581,474195,1614,10,N,Y,1448285563397,102964,108476
MEMMUS.txt,472680,474383,1703,10,N,Y,1448285563397,102964,108476
MEMMUS.txt,472866,474535,1669,10,N,Y,1448285563397,102964,108476
MEMMUS.txt,472955,474769,1814,10,N,Y,1448285563397,102964,108476
MEMMUS.txt,473036,474903,1867,10,N,Y,1448285563397,102964,108476
MEMMUS.txt,473285,475094,1809,10,N,Y,1448285563397,102964,108476
MEMMUS.txt,473381,475306,1925,10,Y,Y,1448285563397,102964,108476
MEMMUS.txt,473555,475505,1950,10,Y,Y,1448285563397,102964,108476
MEMMUS.txt,473801,475653,1852,10,Y,Y,1448285563397,102964,108476
MEMMUS.txt,474012,475925,1913,10,Y,Y,1448285563397,102964,108476
MEMMUS.txt,474196,476019,1823,10,Y,Y,1448285563397,102964,108476
MEMMUS.txt,474384,476184,1800,10,Y,Y,1448285563397,102964,108476
MEMMUS.txt,474538,476599,2061,10,Y,Y,1448285563397,102964,108476
MEMMUS.txt,474770,476751,1981,10,Y,Y,1448039123601,19678,19935
MEMMUS.txt,474906,476822,1916,10,Y,Y,1448039123601,19678,19935
MEMMUS.txt,475096,476991,1895,10,Y,Y,1448039123601,19678,19935
MEMMUS.txt,475307,477058,1751,10,N,N,-,-1,-1
MEMMUS.txt,475507,477173,1666,10,Y,N,-,-1,-1
MEMMUS.txt,475654,477265,1611,10,Y,N,-,-1,-1
MEMMUS.txt,475926,477495,1569,10,Y,N,-,-1,-1
MEMMUS.txt,476020,477693,1673,10,Y,N,-,-1,-1
MEMMUS.txt,476187,477707,1520,10,Y,N,-,-1,-1
MEMMUS.txt,476602,477753,1151,10,N,N,-,-1,-1
MEMMUS.txt,476752,478003,1251,10,N,N,-,-1,-1
MEMMUS.txt,476825,478208,1383,10,N,N,-,-1,-1
MEMMUS.txt,476992,478270,1278,10,N,N,-,-1,-1
MEMMUS.txt,477059,478375,1316,10,N,N,-,-1,-1
MEMMUS.txt,477174,478422,1248,10,N,N,-,-1,-1
MEMMUS.txt,477268,478624,1356,10,N,N,-,-1,-1
MEMMUS.txt,477500,478772,1272,10,N,N,-,-1,-1
MEMMUS.txt,477694,478854,1160,10,N,N,-,-1,-1
MEMMUS.txt,477708,479038,1330,10,N,N,-,-1,-1
MEMMUS.txt,477754,479240,1486,10,N,N,-,-1,-1
MEMMUS.txt,478004,479320,1316,10,N,N,-,-1,-1
MEMMUS.txt,478211,479609,1398,10,N,N,-,-1,-1
MEMMUS.txt,478271,479663,1392,10,N,N,-,-1,-1
MEMMUS.txt,478376,479955,1579,10,N,N,-,-1,-1
MEMMUS.txt,478423,480019,1596,10,N,N,-,-1,-1
MEMMUS.txt,478625,480035,1410,10,N,N,-,-1,-1
MEMMUS.txt,478773,480042,1269,10,N,N,-,-1,-1
MEMMUS.txt,478857,480054,1197,10,N,N,-,-1,-1
MEMMUS.txt,479040,480061,1021,10,N,N,-,-1,-1
MEMMUS.txt,479241,480087,846,10,N,N,-,-1,-1
MEMMUS.txt,479323,480105,782,10,N,N,-,-1,-1
MEMMUS.txt,479609,480114,505,10,N,N,-,-1,-1
MEMMUS.txt,479666,480130,464,10,N,N,-,-1,-1
MEMMUS.txt,479960,480139,179,10,N,N,-,-1,-1
MEMMUS.txt,480022,480154,132,10,N,N,-,-1,-1
MEMMUS.txt,480036,480161,125,10,N,N,-,-1,-1
MEMMUS.txt,480045,480183,138,10,N,N,-,-1,-1
MEMMUS.txt,480055,480202,147,10,N,N,-,-1,-1
MEMMUS.txt,480064,480211,147,10,N,N,-,-1,-1
MEMMUS.txt,480090,480224,134,10,N,N,-,-1,-1
MEMMUS.txt,480106,480233,127,10,N,N,-,-1,-1
MEMMUS.txt,480117,480245,128,10,N,N,-,-1,-1
MEMMUS.txt,480131,480271,140,10,N,N,-,-1,-1
MEMMUS.txt,480142,480290,148,10,N,N,-,-1,-1
MEMMUS.txt,480155,480311,156,10,N,N,-,-1,-1
MEMMUS.txt,480164,480320,156,10,N,N,-,-1,-1
MEMMUS.txt,480186,480337,151,10,N,N,-,-1,-1
MEMMUS.txt,480203,480356,153,10,N,N,-,-1,-1
MEMMUS.txt,480214,480370,156,10,N,N,-,-1,-1
MEMMUS.txt,480225,480389,164,10,N,N,-,-1,-1
MEMMUS.txt,480236,480398,162,10,N,N,-,-1,-1
MEMMUS.txt,480246,480434,188,10,N,N,-,-1,-1
MEMMUS.txt,480272,480450,178,10,N,N,-,-1,-1
MEMMUS.txt,480293,480457,164,10,N,N,-,-1,-1
MEMMUS.txt,480312,480472,160,10,N,N,-,-1,-1
MEMMUS.txt,480323,480485,162,10,N,N,-,-1,-1
MEMMUS.txt,480338,480492,154,10,N,N,-,-1,-1
MEMMUS.txt,480359,480513,154,10,N,N,-,-1,-1
MEMMUS.txt,480373,480533,160,10,N,N,-,-1,-1
MEMMUS.txt,480390,480540,150,10,N,N,-,-1,-1
MEMMUS.txt,480401,480615,214,10,N,N,-,-1,-1
MEMMUS.txt,480437,480635,198,10,N,N,-,-1,-1
MEMMUS.txt,480451,480658,207,10,N,N,-,-1,-1
MEMMUS.txt,480460,480675,215,10,N,N,-,-1,-1
MEMMUS.txt,480475,480692,217,10,N,N,-,-1,-1
MEMMUS.txt,480486,480724,238,10,N,N,-,-1,-1
MEMMUS.txt,480495,480759,264,10,N,N,-,-1,-1
MEMMUS.txt,480514,480778,264,10,N,N,-,-1,-1
MEMMUS.txt,480534,480802,268,10,N,N,-,-1,-1
MEMMUS.txt,480543,480831,288,10,N,N,-,-1,-1
MEMMUS.txt,480618,480851,233,10,N,N,-,-1,-1
MEMMUS.txt,480638,480870,232,10,N,N,-,-1,-1
MEMMUS.txt,480661,480892,231,10,N,N,-,-1,-1
MEMMUS.txt,480678,480912,234,10,N,N,-,-1,-1
MEMMUS.txt,480695,480936,241,10,N,N,-,-1,-1
MEMMUS.txt,480727,480959,232,10,N,N,-,-1,-1
MEMMUS.txt,480762,480980,218,10,N,N,-,-1,-1
MEMMUS.txt,480781,481007,226,10,N,N,-,-1,-1
MEMMUS.txt,480805,481037,232,10,N,N,-,-1,-1
MEMMUS.txt,480834,481064,230,10,N,N,-,-1,-1
MEMMUS.txt,480854,481089,235,10,N,N,-,-1,-1
MEMMUS.txt,480873,481543,670,10,N,N,-,-1,-1
MEMMUS.txt,480895,484282,3387,10,N,N,-,-1,-1
MEMMUS.txt,480915,484524,3609,10,N,N,-,-1,-1
MEMMUS.txt,480939,485950,5011,10,N,N,-,-1,-1
MEMMUS.txt,480962,486063,5101,10,N,N,-,-1,-1
MEMMUS.txt,480983,486272,5289,10,N,N,-,-1,-1
MEMMUS.txt,481010,486430,5420,10,N,N,-,-1,-1
MEMMUS.txt,481040,487267,6227,10,N,N,-,-1,-1
MEMMUS.txt,481067,488061,6994,10,N,N,-,-1,-1
MEMMUS.txt,481092,488133,7041,10,N,N,-,-1,-1
MEMMUS.txt,481544,488850,7306,10,N,N,-,-1,-1
MEMMUS.txt,484284,489923,5639,10,N,N,-,-1,-1
MEMMUS.txt,484525,490954,6429,10,N,N,-,-1,-1
MEMMUS.txt,485951,491153,5202,10,N,N,-,-1,-1
MEMMUS.txt,486065,491381,5316,10,N,N,-,-1,-1
MEMMUS.txt,486273,492413,6140,10,N,N,-,-1,-1
MULIFE.txt,0,799,799,10,N,N,-,-1,-1
MULIFE.txt,47,1452,1405,10,N,N,-,-1,-1
MULIFE.txt,112,1474,1362,10,N,N,-,-1,-1
MULIFE.txt,133,1498,1365,10,N,N,-,-1,-1
MULIFE.txt,151,1509,1358,10,N,N,-,-1,-1
MULIFE.txt,227,1521,1294,10,N,N,-,-1,-1
MULIFE.txt,409,1533,1124,10,N,N,-,-1,-1
MULIFE.txt,436,1562,1126,10,N,N,-,-1,-1
MULIFE.txt,549,1572,1023,10,N,N,-,-1,-1
MULIFE.txt,791,1584,793,10,N,N,-,-1,-1
MULIFE.txt,804,1604,800,10,N,N,-,-1,-1
MULIFE.txt,1457,1634,177,10,N,N,-,-1,-1
MULIFE.txt,1476,1656,180,10,N,N,-,-1,-1
MULIFE.txt,1499,1693,194,10,N,N,-,-1,-1
MULIFE.txt,1512,1704,192,10,N,N,-,-1,-1
MULIFE.txt,1522,1711,189,10,N,N,-,-1,-1
MULIFE.txt,1534,1753,219,10,N,N,-,-1,-1
MULIFE.txt,1563,1784,221,10,N,N,-,-1,-1
MULIFE.txt,1573,1801,228,10,N,N,-,-1,-1
MULIFE.txt,1585,1810,225,10,N,N,-,-1,-1
MULIFE.txt,1605,1839,234,10,N,N,-,-1,-1
MULIFE.txt,1635,1874,239,10,N,N,-,-1,-1
MULIFE.txt,1657,1899,242,10,N,N,-,-1,-1
MULIFE.txt,1694,1929,235,10,N,N,-,-1,-1
MULIFE.txt,1705,1953,248,10,N,N,-,-1,-1
MULIFE.txt,1712,1976,264,10,N,N,-,-1,-1
MULIFE.txt,1754,2008,254,10,N,N,-,-1,-1
MULIFE.txt,1785,2010,225,10,N,N,-,-1,-1
MULIFE.txt,1802,2029,227,10,N,N,-,-1,-1
MULIFE.txt,1811,2042,231,10,N,N,-,-1,-1
MULIFE.txt,1840,2049,209,10,N,N,-,-1,-1
MULIFE.txt,1875,2065,190,10,N,N,-,-1,-1
MULIFE.txt,1900,2084,184,10,N,N,-,-1,-1
MULIFE.txt,1930,2109,179,10,N,N,-,-1,-1
MULIFE.txt,1954,2125,171,10,N,N,-,-1,-1
MULIFE.txt,1977,2145,168,10,N,N,-,-1,-1
MULIFE.txt,2009,2151,142,10,N,N,-,-1,-1
MULIFE.txt,2011,2172,161,10,N,N,-,-1,-1
MULIFE.txt,2032,2186,154,10,N,N,-,-1,-1
MULIFE.txt,2043,2196,153,10,N,N,-,-1,-1
MULIFE.txt,2050,2224,174,10,N,N,-,-1,-1
MULIFE.txt,2066,2256,190,10,N,N,-,-1,-1
MULIFE.txt,2085,2267,182,10,N,N,-,-1,-1
MULIFE.txt,2110,2273,163,10,N,N,-,-1,-1
MULIFE.txt,2126,2299,173,10,N,N,-,-1,-1
MULIFE.txt,2146,2329,183,10,N,N,-,-1,-1
MULIFE.txt,2152,2362,210,10,N,N,-,-1,-1
MULIFE.txt,2173,2392,219,10,N,N,-,-1,-1
MULIFE.txt,2187,2415,228,10,N,N,-,-1,-1
MULIFE.txt,2197,2462,265,10,N,N,-,-1,-1
MULIFE.txt,2225,2487,262,10,N,N,-,-1,-1
MULIFE.txt,2257,2533,276,10,N,N,-,-1,-1
MULIFE.txt,2270,2545,275,10,N,N,-,-1,-1
MULIFE.txt,2274,2554,280,10,N,N,-,-1,-1
MULIFE.txt,2300,2584,284,10,N,N,-,-1,-1
MULIFE.txt,2330,2594,264,10,N,N,-,-1,-1
MULIFE.txt,2363,2629,266,10,N,N,-,-1,-1
MULIFE.txt,2393,2659,266,10,N,N,-,-1,-1
MULIFE.txt,2416,2677,261,10,N,N,-,-1,-1
MULIFE.txt,2463,2701,238,10,N,N,-,-1,-1
MULIFE.txt,2488,2732,244,10,N,N,-,-1,-1
MULIFE.txt,2534,2770,236,10,N,N,-,-1,-1
MULIFE.txt,2546,2786,240,10,N,N,-,-1,-1
MULIFE.txt,2555,2795,240,10,N,N,-,-1,-1
MULIFE.txt,2585,2818,233,10,N,N,-,-1,-1
MULIFE.txt,2595,2827,232,10,N,N,-,-1,-1
MULIFE.txt,2630,2843,213,10,N,N,-,-1,-1
MULIFE.txt,2660,2845,185,10,N,N,-,-1,-1
MULIFE.txt,2678,2856,178,10,N,N,-,-1,-1
MULIFE.txt,2702,2891,189,10,N,N,-,-1,-1
MULIFE.txt,2733,2923,190,10,N,N,-,-1,-1
MULIFE.txt,2771,2968,197,10,N,N,-,-1,-1
MULIFE.txt,2787,2994,207,10,N,N,-,-1,-1
MULIFE.txt,2796,3008,212,10,N,N,-,-1,-1
MULIFE.txt,2819,3010,191,10,N,N,-,-1,-1
MULIFE.txt,2828,3019,191,10,N,N,-,-1,-1
MULIFE.txt,2844,3047,203,10,N,N,-,-1,-1
MULIFE.txt,2846,3065,219,10,N,N,-,-1,-1
MULIFE.txt,2857,3074,217,10,N,N,-,-1,-1
MULIFE.txt,2892,3097,205,10,N,N,-,-1,-1
MULIFE.txt,2924,3137,213,10,N,N,-,-1,-1
MULIFE.txt,2969,3155,186,10,N,N,-,-1,-1
MULIFE.txt,2995,3166,171,10,N,N,-,-1,-1
MULIFE.txt,3009,3177,168,10,N,N,-,-1,-1
MULIFE.txt,3011,3218,207,10,N,N,-,-1,-1
MULIFE.txt,3020,3228,208,10,N,N,-,-1,-1
MULIFE.txt,3048,3255,207,10,N,N,-,-1,-1
MULIFE.txt,3066,3278,212,10,N,N,-,-1,-1
MULIFE.txt,3075,3299,224,10,N,N,-,-1,-1
MULIFE.txt,3098,3300,202,10,N,N,-,-1,-1
MULIFE.txt,3142,3302,160,10,N,N,-,-1,-1
MULIFE.txt,3156,3304,148,10,N,N,-,-1,-1
MULIFE.txt,3169,3313,144,10,N,N,-,-1,-1
MULIFE.txt,3178,3328,150,10,N,N,-,-1,-1
MULIFE.txt,3219,3337,118,10,N,N,-,-1,-1
MULIFE.txt,3229,3366,137,10,N,N,-,-1,-1
MULIFE.txt,3256,3405,149,10,N,N,-,-1,-1
MULIFE.txt,3279,3442,163,10,N,N,-,-1,-1
MULIFE.txt,3299,3479,180,10,N,N,-,-1,-1
MULIFE.txt,3300,3511,211,10,N,N,-,-1,-1
MULIFE.txt,3302,3525,223,10,N,N,-,-1,-1
MULIFE.txt,3305,3547,242,10,N,N,-,-1,-1
MULIFE.txt,3314,3577,263,10,N,N,-,-1,-1
MULIFE.txt,3329,3606,277,10,N,N,-,-1,-1
MULIFE.txt,3338,3630,292,10,N,N,-,-1,-1
MULIFE.txt,3367,3652,285,10,N,N,-,-1,-1
MULIFE.txt,3406,3654,248,10,N,N,-,-1,-1
MULIFE.txt,3443,3656,213,10,N,N,-,-1,-1
MULIFE.txt,3480,3668,188,10,N,N,-,-1,-1
MULIFE.txt,3512,3675,163,10,N,N,-,-1,-1
MULIFE.txt,3526,3681,155,10,N,N,-,-1,-1
MULIFE.txt,3548,3687,139,10,N,N,-,-1,-1
MULIFE.txt,3578,3704,126,10,N,N,-,-1,-1
MULIFE.txt,3607,3714,107,10,N,N,-,-1,-1
MULIFE.txt,3631,3737,106,10,N,N,-,-1,-1
MULIFE.txt,3653,3752,99,10,N,N,-,-1,-1
MULIFE.txt,3655,3786,131,10,N,N,-,-1,-1
MULIFE.txt,3657,3827,170,10,N,N,-,-1,-1
MULIFE.txt,3669,3852,183,10,N,N,-,-1,-1
MULIFE.txt,3676,3877,201,10,N,N,-,-1,-1
MULIFE.txt,3684,3901,217,10,N,N,-,-1,-1
MULIFE.txt,3688,3927,239,10,N,N,-,-1,-1
MULIFE.txt,3705,3979,274,10,N,N,-,-1,-1
MULIFE.txt,3715,3995,280,10,N,N,-,-1,-1
MULIFE.txt,3738,4021,283,10,N,N,-,-1,-1
MULIFE.txt,3753,4043,290,10,N,N,-,-1,-1
MULIFE.txt,3787,4073,286,10,N,N,-,-1,-1
MULIFE.txt,3828,4102,274,10,N,N,-,-1,-1
MULIFE.txt,3853,4142,289,10,N,N,-,-1,-1
MULIFE.txt,3878,4192,314,10,N,N,-,-1,-1
MULIFE.txt,3902,4205,303,10,N,N,-,-1,-1
MULIFE.txt,3928,4223,295,10,N,N,-,-1,-1
MULIFE.txt,3980,4244,264,10,N,N,-,-1,-1
MULIFE.txt,3996,4294,298,10,N,N,-,-1,-1
MULIFE.txt,4022,4329,307,10,N,N,-,-1,-1
MULIFE.txt,4044,4347,303,10,N,N,-,-1,-1
MULIFE.txt,4074,4384,310,10,N,N,-,-1,-1
MULIFE.txt,4103,4403,300,10,N,N,-,-1,-1
MULIFE.txt,4143,4405,262,10,N,N,-,-1,-1
MULIFE.txt,4195,4415,220,10,N,N,-,-1,-1
MULIFE.txt,4206,4461,255,10,N,N,-,-1,-1
MULIFE.txt,4224,4482,258,10,N,N,-,-1,-1
MULIFE.txt,4245,4517,272,10,N,N,-,-1,-1
MULIFE.txt,4295,4553,258,10,N,N,-,-1,-1
MULIFE.txt,4330,4555,225,10,N,N,-,-1,-1
MULIFE.txt,4348,4565,217,10,N,N,-,-1,-1
MULIFE.txt,4385,4597,212,10,N,N,-,-1,-1
MULIFE.txt,4404,4634,230,10,N,N,-,-1,-1
MULIFE.txt,4406,4691,285,10,N,N,-,-1,-1
MULIFE.txt,4416,4697,281,10,N,N,-,-1,-1
MULIFE.txt,4464,4734,270,10,N,N,-,-1,-1
MULIFE.txt,4484,4757,273,10,N,N,-,-1,-1
MULIFE.txt,4518,4775,257,10,N,N,-,-1,-1
MULIFE.txt,4554,4802,248,10,N,N,-,-1,-1
MULIFE.txt,4556,4808,252,10,N,N,-,-1,-1
MULIFE.txt,4566,4819,253,10,N,N,-,-1,-1
MULIFE.txt,4598,4849,251,10,N,N,-,-1,-1
MULIFE.txt,4635,4885,250,10,N,N,-,-1,-1
MULIFE.txt,4694,4922,228,10,N,N,-,-1,-1
MULIFE.txt,4698,4972,274,10,N,N,-,-1,-1
MULIFE.txt,4735,5014,279,10,N,N,-,-1,-1
MULIFE.txt,4758,5059,301,10,N,N,-,-1,-1
MULIFE.txt,4776,5106,330,10,N,N,-,-1,-1
MULIFE.txt,4802,5145,343,10,N,N,-,-1,-1
MULIFE.txt,4809,5183,374,10,N,N,-,-1,-1
MULIFE.txt,4820,5227,407,10,N,N,-,-1,-1
MULIFE.txt,4850,5269,419,10,N,N,-,-1,-1
MULIFE.txt,4886,5288,402,10,N,N,-,-1,-1
MULIFE.txt,4923,5326,403,10,N,N,-,-1,-1
MULIFE.txt,4973,5341,368,10,N,N,-,-1,-1
MULIFE.txt,5015,5352,337,10,N,N,-,-1,-1
MULIFE.txt,5060,5383,323,10,N,N,-,-1,-1
MULIFE.txt,5107,5414,307,10,N,N,-,-1,-1
MULIFE.txt,5146,5444,298,10,N,N,-,-1,-1
MULIFE.txt,5184,5474,290,10,N,N,-,-1,-1
MULIFE.txt,5228,5505,277,10,N,N,-,-1,-1
MULIFE.txt,5270,5539,269,10,N,N,-,-1,-1
MULIFE.txt,5289,5541,252,10,N,N,-,-1,-1
MULIFE.txt,5327,5552,225,10,N,N,-,-1,-1
MULIFE.txt,5342,5580,238,10,N,N,-,-1,-1
MULIFE.txt,5353,5582,229,10,N,N,-,-1,-1
MULIFE.txt,5384,5593,209,10,N,N,-,-1,-1
MULIFE.txt,5415,5622,207,10,N,N,-,-1,-1
MULIFE.txt,5445,5629,184,10,N,N,-,-1,-1
MULIFE.txt,5475,5655,180,10,N,N,-,-1,-1
MULIFE.txt,5506,5673,167,10,N,N,-,-1,-1
MULIFE.txt,5540,5684,144,10,N,N,-,-1,-1
MULIFE.txt,5542,5708,166,10,N,N,-,-1,-1
MULIFE.txt,5553,5723,170,10,N,N,-,-1,-1
MULIFE.txt,5581,5730,149,10,N,N,-,-1,-1
MULIFE.txt,5583,5756,173,10,N,N,-,-1,-1
MULIFE.txt,5594,5788,194,10,N,N,-,-1,-1
MULIFE.txt,5625,5815,190,10,N,N,-,-1,-1
MULIFE.txt,5630,5847,217,10,N,N,-,-1,-1
MULIFE.txt,5656,5873,217,10,N,N,-,-1,-1
MULIFE.txt,5674,5875,201,10,N,N,-,-1,-1
MULIFE.txt,5685,5886,201,10,N,N,-,-1,-1
MULIFE.txt,5709,5927,218,10,N,N,-,-1,-1
MULIFE.txt,5726,5966,240,10,N,N,-,-1,-1
MULIFE.txt,5731,5988,257,10,N,N,-,-1,-1
MULIFE.txt,5757,6007,250,10,N,N,-,-1,-1
MULIFE.txt,5789,6024,235,10,N,N,-,-1,-1
MULIFE.txt,5816,6066,250,10,N,N,-,-1,-1
MULIFE.txt,5848,6104,256,10,N,N,-,-1,-1
MULIFE.txt,5874,6132,258,10,N,N,-,-1,-1
MULIFE.txt,5876,6169,293,10,N,N,-,-1,-1
MULIFE.txt,5887,6206,319,10,N,N,-,-1,-1
MULIFE.txt,5928,6237,309,10,N,N,-,-1,-1
MULIFE.txt,5967,6272,305,10,N,N,-,-1,-1
MULIFE.txt,5989,6289,300,10,N,N,-,-1,-1
MULIFE.txt,6008,6308,300,10,N,N,-,-1,-1
MULIFE.txt,6025,6343,318,10,N,N,-,-1,-1
MULIFE.txt,6067,6369,302,10,N,N,-,-1,-1
MULIFE.txt,6105,6409,304,10,N,N,-,-1,-1
MULIFE.txt,6133,6453,320,10,N,N,-,-1,-1
MULIFE.txt,6170,6470,300,10,N,N,-,-1,-1
MULIFE.txt,6207,6496,289,10,N,N,-,-1,-1
MULIFE.txt,6238,6524,286,10,N,N,-,-1,-1
MULIFE.txt,6273,6563,290,10,N,N,-,-1,-1
MULIFE.txt,6290,6606,316,10,N,N,-,-1,-1
MULIFE.txt,6309,6639,330,10,N,N,-,-1,-1
MULIFE.txt,6344,6674,330,10,N,N,-,-1,-1
MULIFE.txt,6370,6685,315,10,N,N,-,-1,-1
MULIFE.txt,6410,6729,319,10,N,N,-,-1,-1
MULIFE.txt,6456,6767,311,10,N,N,-,-1,-1
MULIFE.txt,6470,6778,308,10,N,N,-,-1,-1
MULIFE.txt,6497,6822,325,10,N,N,-,-1,-1
MULIFE.txt,6525,6848,323,10,N,N,-,-1,-1
MULIFE.txt,6564,6861,297,10,N,N,-,-1,-1
MULIFE.txt,6607,6899,292,10,N,N,-,-1,-1
MULIFE.txt,6640,6910,270,10,N,N,-,-1,-1
MULIFE.txt,6675,6961,286,10,N,N,-,-1,-1
MULIFE.txt,6686,6994,308,10,N,N,-,-1,-1
MULIFE.txt,6730,7019,289,10,N,N,-,-1,-1
MULIFE.txt,6768,7069,301,10,N,N,-,-1,-1
MULIFE.txt,6779,7076,297,10,N,N,-,-1,-1
MULIFE.txt,6823,7088,265,10,N,N,-,-1,-1
MULIFE.txt,6849,7099,250,10,N,N,-,-1,-1
MULIFE.txt,6862,7118,256,10,N,N,-,-1,-1
MULIFE.txt,6900,7120,220,10,N,N,-,-1,-1
MULIFE.txt,6911,7131,220,10,N,N,-,-1,-1
MULIFE.txt,6962,7154,192,10,N,N,-,-1,-1
MULIFE.txt,6995,7203,208,10,N,N,-,-1,-1
MULIFE.txt,7022,7232,210,10,N,N,-,-1,-1
MULIFE.txt,7072,7279,207,10,N,N,-,-1,-1
MULIFE.txt,7077,7286,209,10,N,N,-,-1,-1
MULIFE.txt,7089,7306,217,10,N,N,-,-1,-1
MULIFE.txt,7100,7345,245,10,N,N,-,-1,-1
MULIFE.txt,7119,7372,253,10,N,N,-,-1,-1
MULIFE.txt,7121,7401,280,10,N,N,-,-1,-1
MULIFE.txt,7132,7420,288,10,N,N,-,-1,-1
MULIFE.txt,7155,7431,276,10,N,N,-,-1,-1
MULIFE.txt,7204,7467,263,10,N,N,-,-1,-1
MULIFE.txt,7233,7500,267,10,N,N,-,-1,-1
MULIFE.txt,7282,7517,235,10,N,N,-,-1,-1
MULIFE.txt,7287,7571,284,10,N,N,-,-1,-1
MULIFE.txt,7307,7593,286,10,N,N,-,-1,-1
MULIFE.txt,7346,7643,297,10,N,N,-,-1,-1
MULIFE.txt,7373,7657,284,10,N,N,-,-1,-1
MULIFE.txt,7402,7668,266,10,N,N,-,-1,-1
MULIFE.txt,7421,7690,269,10,N,N,-,-1,-1
MULIFE.txt,7432,7701,269,10,N,N,-,-1,-1
MULIFE.txt,7468,7740,272,10,N,N,-,-1,-1
MULIFE.txt,7501,7766,265,10,N,N,-,-1,-1
MULIFE.txt,7518,7800,282,10,N,N,-,-1,-1
MULIFE.txt,7572,7830,258,10,N,N,-,-1,-1
MULIFE.txt,7594,7856,262,10,N,N,-,-1,-1
MULIFE.txt,7644,7889,245,10,N,N,-,-1,-1
MULIFE.txt,7658,7927,269,10,N,N,-,-1,-1
MULIFE.txt,7669,7955,286,10,N,N,-,-1,-1
MULIFE.txt,7691,8004,313,10,N,N,-,-1,-1
MULIFE.txt,7702,8021,319,10,N,N,-,-1,-1
MULIFE.txt,7741,8032,291,10,N,N,-,-1,-1
MULIFE.txt,7767,8047,280,10,N,N,-,-1,-1
MULIFE.txt,7801,8049,248,10,N,N,-,-1,-1
MULIFE.txt,7831,8060,229,10,N,N,-,-1,-1
MULIFE.txt,7857,8081,224,10,N,N,-,-1,-1
MULIFE.txt,7890,8092,202,10,N,N,-,-1,-1
MULIFE.txt,7928,8124,196,10,N,N,-,-1,-1
MULIFE.txt,7956,8145,189,10,N,N,-,-1,-1
MULIFE.txt,8005,8156,151,10,N,N,-,-1,-1
MULIFE.txt,8022,8187,165,10,N,N,-,-1,-1
MULIFE.txt,8033,8204,171,10,N,N,-,-1,-1
MULIFE.txt,8048,8206,158,10,N,N,-,-1,-1
MULIFE.txt,8050,8217,167,10,N,N,-,-1,-1
MULIFE.txt,8061,8250,189,10,N,N,-,-1,-1
MULIFE.txt,8082,8261,179,10,N,N,-,-1,-1
MULIFE.txt,8093,8286,193,10,N,N,-,-1,-1
MULIFE.txt,8125,8306,181,10,N,N,-,-1,-1
MULIFE.txt,8146,8340,194,10,N,N,-,-1,-1
MULIFE.txt,8157,8361,204,10,N,N,-,-1,-1
MULIFE.txt,8188,8403,215,10,N,N,-,-1,-1
MULIFE.txt,8205,8432,227,10,N,N,-,-1,-1
MULIFE.txt,8207,8456,249,10,N,N,-,-1,-1
MULIFE.txt,8218,8486,268,10,N,N,-,-1,-1
MULIFE.txt,8251,8521,270,10,N,N,-,-1,-1
MULIFE.txt,8262,8549,287,10,N,N,-,-1,-1
MULIFE.txt,8287,8592,305,10,N,N,-,-1,-1
MULIFE.txt,8307,8618,311,10,N,N,-,-1,-1
MULIFE.txt,8341,8629,288,10,N,N,-,-1,-1
MULIFE.txt,8362,8658,296,10,N,N,-,-1,-1
MULIFE.txt,8404,8692,288,10,N,N,-,-1,-1
MULIFE.txt,8433,8722,289,10,N,N,-,-1,-1
MULIFE.txt,8457,8753,296,10,N,N,-,-1,-1
MULIFE.txt,8487,8796,309,10,N,N,-,-1,-1
MULIFE.txt,8522,8800,278,10,N,N,-,-1,-1
MULIFE.txt,8550,8858,308,10,N,N,-,-1,-1
MULIFE.txt,8593,8866,273,10,N,N,-,-1,-1
MULIFE.txt,8619,8892,273,10,N,N,-,-1,-1
MULIFE.txt,8630,8905,275,10,N,N,-,-1,-1
MULIFE.txt,8659,8920,261,10,N,N,-,-1,-1
MULIFE.txt,8693,8941,248,10,N,N,-,-1,-1
MULIFE.txt,8723,8959,236,10,N,N,-,-1,-1
MULIFE.txt,8754,8981,227,10,N,N,-,-1,-1
MULIFE.txt,8796,9028,232,10,N,N,-,-1,-1
MULIFE.txt,8801,9074,273,10,N,N,-,-1,-1
MULIFE.txt,8863,9119,256,10,N,N,-,-1,-1
MULIFE.txt,8867,9158,291,10,N,N,-,-1,-1
MULIFE.txt,8895,9178,283,10,N,N,-,-1,-1
MULIFE.txt,8906,9198,292,10,N,N,-,-1,-1
MULIFE.txt,8921,9235,314,10,N,N,-,-1,-1
MULIFE.txt,8942,9291,349,10,N,N,-,-1,-1
MULIFE.txt,8960,9331,371,10,N,N,-,-1,-1
MULIFE.txt,8982,9379,397,10,N,N,-,-1,-1
MULIFE.txt,9029,9413,384,10,N,N,-,-1,-1
MULIFE.txt,9075,9459,384,10,N,N,-,-1,-1
MULIFE.txt,9120,9486,366,10,N,N,-,-1,-1
MULIFE.txt,9159,9497,338,10,N,N,-,-1,-1
MULIFE.txt,9179,9539,360,10,N,N,-,-1,-1
MULIFE.txt,9199,9587,388,10,N,N,-,-1,-1
MULIFE.txt,9236,9628,392,10,N,N,-,-1,-1
MULIFE.txt,9292,9673,381,10,N,N,-,-1,-1
MULIFE.txt,9332,9706,374,10,N,N,-,-1,-1
MULIFE.txt,9380,9742,362,10,N,N,-,-1,-1
MULIFE.txt,9414,9779,365,10,N,N,-,-1,-1
MULIFE.txt,9460,9823,363,10,N,N,-,-1,-1
MULIFE.txt,9487,9863,376,10,N,N,-,-1,-1
MULIFE.txt,9498,9905,407,10,N,N,-,-1,-1
MULIFE.txt,9540,9936,396,10,N,N,-,-1,-1
MULIFE.txt,9588,9962,374,10,N,N,-,-1,-1
MULIFE.txt,9629,9999,370,10,N,N,-,-1,-1
MULIFE.txt,9674,10015,341,10,N,N,-,-1,-1
MULIFE.txt,9707,10048,341,10,N,N,-,-1,-1
MULIFE.txt,9743,10082,339,10,N,N,-,-1,-1
MULIFE.txt,9780,10123,343,10,N,N,-,-1,-1
MULIFE.txt,9824,10165,341,10,N,N,-,-1,-1
MULIFE.txt,9864,10207,343,10,N,N,-,-1,-1
MULIFE.txt,9906,10277,371,10,N,N,-,-1,-1
MULIFE.txt,9937,10284,347,10,N,N,-,-1,-1
MULIFE.txt,9963,10315,352,10,N,N,-,-1,-1
MULIFE.txt,10000,10370,370,10,N,N,-,-1,-1
MULIFE.txt,10016,10389,373,10,N,N,-,-1,-1
MULIFE.txt,10049,10412,363,10,N,N,-,-1,-1
MULIFE.txt,10083,10423,340,10,N,N,-,-1,-1
MULIFE.txt,10124,10498,374,10,N,N,-,-1,-1
MULIFE.txt,10166,10505,339,10,N,N,-,-1,-1
MULIFE.txt,10208,10530,322,10,N,N,-,-1,-1
MULIFE.txt,10280,10544,264,10,N,N,-,-1,-1
MULIFE.txt,10285,10556,271,10,N,N,-,-1,-1
MULIFE.txt,10316,10567,251,10,N,N,-,-1,-1
MULIFE.txt,10371,10595,224,10,N,N,-,-1,-1
MULIFE.txt,10390,10621,231,10,N,N,-,-1,-1
MULIFE.txt,10413,10622,209,10,N,N,-,-1,-1
MULIFE.txt,10424,10639,215,10,N,N,-,-1,-1
MULIFE.txt,10501,10692,191,10,N,N,-,-1,-1
MULIFE.txt,10506,10725,219,10,N,N,-,-1,-1
MULIFE.txt,10531,10736,205,10,N,N,-,-1,-1
MULIFE.txt,10545,10764,219,10,N,N,-,-1,-1
MULIFE.txt,10557,10773,216,10,N,N,-,-1,-1
MULIFE.txt,10568,10783,215,10,N,N,-,-1,-1
MULIFE.txt,10596,10821,225,10,N,N,-,-1,-1
MULIFE.txt,10621,10828,207,10,N,N,-,-1,-1
MULIFE.txt,10622,10862,240,10,N,N,-,-1,-1
MULIFE.txt,10640,10868,228,10,N,N,-,-1,-1
MULIFE.txt,10693,10870,177,10,N,N,-,-1,-1
MULIFE.txt,10726,10886,160,10,N,N,-,-1,-1
MULIFE.txt,10737,10905,168,10,N,N,-,-1,-1
MULIFE.txt,10765,10934,169,10,N,N,-,-1,-1
MULIFE.txt,10774,10955,181,10,N,N,-,-1,-1
MULIFE.txt,10784,10974,190,10,N,N,-,-1,-1
MULIFE.txt,10824,10996,172,10,N,N,-,-1,-1
MULIFE.txt,10829,11022,193,10,N,N,-,-1,-1
MULIFE.txt,10863,11023,160,10,N,N,-,-1,-1
MULIFE.txt,10869,11025,156,10,N,N,-,-1,-1
MULIFE.txt,10870,11041,171,10,N,N,-,-1,-1
MULIFE.txt,10887,11069,182,10,N,N,-,-1,-1
MULIFE.txt,10906,11070,164,10,N,N,-,-1,-1
MULIFE.txt,10935,11072,137,10,N,N,-,-1,-1
MULIFE.txt,10956,11096,140,10,N,N,-,-1,-1
MULIFE.txt,10975,11103,128,10,N,N,-,-1,-1
MULIFE.txt,10997,11131,134,10,N,N,-,-1,-1
MULIFE.txt,11022,11164,142,10,N,N,-,-1,-1
MULIFE.txt,11023,11188,165,10,N,N,-,-1,-1
MULIFE.txt,11025,11207,182,10,N,N,-,-1,-1
MULIFE.txt,11042,11254,212,10,N,N,-,-1,-1
MULIFE.txt,11069,11283,214,10,N,N,-,-1,-1
MULIFE.txt,11070,11284,214,10,N,N,-,-1,-1
MULIFE.txt,11072,11295,223,10,N,N,-,-1,-1
MULIFE.txt,11099,11343,244,10,N,N,-,-1,-1
MULIFE.txt,11104,11384,280,10,N,N,-,-1,-1
MULIFE.txt,11132,11427,295,10,N,N,-,-1,-1
MULIFE.txt,11165,11450,285,10,N,N,-,-1,-1
MULIFE.txt,11189,11461,272,10,N,N,-,-1,-1
MULIFE.txt,11208,11512,304,10,N,N,-,-1,-1
MULIFE.txt,11255,11572,317,10,N,N,-,-1,-1
MULIFE.txt,11283,11586,303,10,N,N,-,-1,-1
MULIFE.txt,11285,11613,328,10,N,N,-,-1,-1
MULIFE.txt,11296,11644,348,10,N,N,-,-1,-1
MULIFE.txt,11344,11665,321,10,N,N,-,-1,-1
MULIFE.txt,11385,11693,308,10,N,N,-,-1,-1
MULIFE.txt,11428,11713,285,10,N,N,-,-1,-1
MULIFE.txt,11451,11738,287,10,N,N,-,-1,-1
MULIFE.txt,11462,11765,303,10,N,N,-,-1,-1
MULIFE.txt,11513,11789,276,10,N,N,-,-1,-1
MULIFE.txt,11575,11815,240,10,N,N,-,-1,-1
MULIFE.txt,11587,11834,247,10,N,N,-,-1,-1
MULIFE.txt,11614,11846,232,10,N,N,-,-1,-1
MULIFE.txt,11645,11887,242,10,N,N,-,-1,-1
MULIFE.txt,11666,11909,243,10,N,N,-,-1,-1
MULIFE.txt,11694,11934,240,10,N,N,-,-1,-1
MULIFE.txt,11714,11945,231,10,N,N,-,-1,-1
MULIFE.txt,11739,11963,224,10,N,N,-,-1,-1
MULIFE.txt,11766,11974,208,10,N,N,-,-1,-1
MULIFE.txt,11790,11993,203,10,N,N,-,-1,-1
MULIFE.txt,11816,12020,204,10,N,N,-,-1,-1
MULIFE.txt,11835,12050,215,10,N,N,-,-1,-1
MULIFE.txt,11847,12069,222,10,N,N,-,-1,-1
MULIFE.txt,11888,12080,192,10,N,N,-,-1,-1
MULIFE.txt,11910,12109,199,10,N,N,-,-1,-1
MULIFE.txt,11935,12143,208,10,N,N,-,-1,-1
MULIFE.txt,11946,12167,221,10,N,N,-,-1,-1
MULIFE.txt,11964,12188,224,10,N,N,-,-1,-1
MULIFE.txt,11975,12199,224,10,N,N,-,-1,-1
MULIFE.txt,11994,12229,235,10,N,N,-,-1,-1
MULIFE.txt,12021,12264,243,10,N,N,-,-1,-1
MULIFE.txt,12051,12282,231,10,N,N,-,-1,-1
MULIFE.txt,12070,12316,246,10,N,N,-,-1,-1
MULIFE.txt,12081,12335,254,10,N,N,-,-1,-1
MULIFE.txt,12110,12351,241,10,N,N,-,-1,-1
MULIFE.txt,12144,12384,240,10,N,N,-,-1,-1
MULIFE.txt,12168,12431,263,10,N,N,-,-1,-1
MULIFE.txt,12189,12444,255,10,N,N,-,-1,-1
MULIFE.txt,12200,12451,251,10,N,N,-,-1,-1
MULIFE.txt,12230,12479,249,10,N,N,-,-1,-1
MULIFE.txt,12265,12492,227,10,N,N,-,-1,-1
MULIFE.txt,12283,12512,229,10,N,N,-,-1,-1
MULIFE.txt,12317,12514,197,10,N,N,-,-1,-1
MULIFE.txt,12336,12532,196,10,N,N,-,-1,-1
MULIFE.txt,12352,12550,198,10,N,N,-,-1,-1
MULIFE.txt,12387,12569,182,10,N,N,-,-1,-1
MULIFE.txt,12434,12580,146,10,N,N,-,-1,-1
MULIFE.txt,12447,12602,155,10,N,N,-,-1,-1
MULIFE.txt,12452,12632,180,10,N,N,-,-1,-1
MULIFE.txt,12480,12670,190,10,N,N,-,-1,-1
MULIFE.txt,12493,12709,216,10,N,N,-,-1,-1
MULIFE.txt,12513,12750,237,10,N,N,-,-1,-1
MULIFE.txt,12515,12774,259,10,N,N,-,-1,-1
MULIFE.txt,12533,12817,284,10,N,N,-,-1,-1
MULIFE.txt,12551,12852,301,10,N,N,-,-1,-1
MULIFE.txt,12570,12888,318,10,N,N,-,-1,-1
MULIFE.txt,12581,12899,318,10,N,N,-,-1,-1
MULIFE.txt,12603,12933,330,10,N,N,-,-1,-1
MULIFE.txt,12633,12984,351,10,N,N,-,-1,-1
MULIFE.txt,12671,13014,343,10,N,N,-,-1,-1
MULIFE.txt,12710,13059,349,10,N,N,-,-1,-1
MULIFE.txt,12751,13087,336,10,N,N,-,-1,-1
MULIFE.txt,12775,13105,330,10,N,N,-,-1,-1
MULIFE.txt,12818,13134,316,10,N,N,-,-1,-1
MULIFE.txt,12853,13167,314,10,N,N,-,-1,-1
MULIFE.txt,12889,13196,307,10,N,N,-,-1,-1
MULIFE.txt,12900,13228,328,10,N,N,-,-1,-1
MULIFE.txt,12934,13255,321,10,N,N,-,-1,-1
MULIFE.txt,12985,13292,307,10,N,N,-,-1,-1
MULIFE.txt,13015,13331,316,10,N,N,-,-1,-1
MULIFE.txt,13060,13359,299,10,N,N,-,-1,-1
MULIFE.txt,13088,13380,292,10,N,N,-,-1,-1
MULIFE.txt,13106,13416,310,10,N,N,-,-1,-1
MULIFE.txt,13135,13454,319,10,N,N,-,-1,-1
MULIFE.txt,13168,13478,310,10,N,N,-,-1,-1
MULIFE.txt,13197,13518,321,10,N,N,-,-1,-1
MULIFE.txt,13229,13555,326,10,N,N,-,-1,-1
MULIFE.txt,13256,13603,347,10,N,N,-,-1,-1
MULIFE.txt,13293,13631,338,10,N,N,-,-1,-1
MULIFE.txt,13332,13670,338,10,N,N,-,-1,-1
MULIFE.txt,13360,13702,342,10,N,N,-,-1,-1
MULIFE.txt,13381,13728,347,10,N,N,-,-1,-1
MULIFE.txt,13417,13759,342,10,N,N,-,-1,-1
MULIFE.txt,13455,13792,337,10,N,N,-,-1,-1
MULIFE.txt,13479,13830,351,10,N,N,-,-1,-1
MULIFE.txt,13519,13852,333,10,N,N,-,-1,-1
MULIFE.txt,13556,13873,317,10,N,N,-,-1,-1
MULIFE.txt,13604,13887,283,10,N,N,-,-1,-1
MULIFE.txt,13632,13912,280,10,N,N,-,-1,-1
MULIFE.txt,13671,13929,258,10,N,N,-,-1,-1
MULIFE.txt,13703,13961,258,10,N,N,-,-1,-1
MULIFE.txt,13729,13990,261,10,N,N,-,-1,-1
MULIFE.txt,13760,14001,241,10,N,N,-,-1,-1
MULIFE.txt,13793,14049,256,10,N,N,-,-1,-1
MULIFE.txt,13831,14073,242,10,N,N,-,-1,-1
MULIFE.txt,13853,14084,231,10,N,N,-,-1,-1
MULIFE.txt,13876,14115,239,10,N,N,-,-1,-1
MULIFE.txt,13888,14151,263,10,N,N,-,-1,-1
MULIFE.txt,13913,14189,276,10,N,N,-,-1,-1
MULIFE.txt,13930,14201,271,10,N,N,-,-1,-1
MULIFE.txt,13962,14213,251,10,N,N,-,-1,-1
MULIFE.txt,13991,14240,249,10,N,N,-,-1,-1
MULIFE.txt,14002,14251,249,10,N,N,-,-1,-1
MULIFE.txt,14050,14298,248,10,N,N,-,-1,-1
MULIFE.txt,14074,14346,272,10,N,N,-,-1,-1
MULIFE.txt,14085,14381,296,10,N,N,-,-1,-1
MULIFE.txt,14116,14421,305,10,N,N,-,-1,-1
MULIFE.txt,14152,14453,301,10,N,N,-,-1,-1
MULIFE.txt,14190,14486,296,10,N,N,-,-1,-1
MULIFE.txt,14202,14503,301,10,N,N,-,-1,-1
MULIFE.txt,14214,14536,322,10,N,N,-,-1,-1
MULIFE.txt,14241,14562,321,10,N,N,-,-1,-1
MULIFE.txt,14252,14575,323,10,N,N,-,-1,-1
MULIFE.txt,14299,14604,305,10,N,N,-,-1,-1
MULIFE.txt,14347,14650,303,10,N,N,-,-1,-1
MULIFE.txt,14382,14676,294,10,N,N,-,-1,-1
MULIFE.txt,14422,14711,289,10,N,N,-,-1,-1
MULIFE.txt,14454,14740,286,10,N,N,-,-1,-1
MULIFE.txt,14487,14747,260,10,N,N,-,-1,-1
MULIFE.txt,14504,14776,272,10,N,N,-,-1,-1
MULIFE.txt,14537,14815,278,10,N,N,-,-1,-1
MULIFE.txt,14563,14854,291,10,N,N,-,-1,-1
MULIFE.txt,14576,14870,294,10,N,N,-,-1,-1
MULIFE.txt,14605,14898,293,10,N,N,-,-1,-1
MULIFE.txt,14651,14924,273,10,N,N,-,-1,-1
MULIFE.txt,14677,14943,266,10,N,N,-,-1,-1
MULIFE.txt,14712,14967,255,10,N,N,-,-1,-1
MULIFE.txt,14743,14999,256,10,N,N,-,-1,-1
MULIFE.txt,14748,15038,290,10,N,N,-,-1,-1
MULIFE.txt,14777,15055,278,10,N,N,-,-1,-1
MULIFE.txt,14816,15069,253,10,N,N,-,-1,-1
MULIFE.txt,14855,15092,237,10,N,N,-,-1,-1
MULIFE.txt,14871,15094,223,10,N,N,-,-1,-1
MULIFE.txt,14899,15105,206,10,N,N,-,-1,-1
MULIFE.txt,14925,15124,199,10,N,N,-,-1,-1
MULIFE.txt,14944,15142,198,10,N,N,-,-1,-1
MULIFE.txt,14968,15183,215,10,N,N,-,-1,-1
MULIFE.txt,15000,15216,216,10,N,N,-,-1,-1
MULIFE.txt,15039,15246,207,10,N,N,-,-1,-1
MULIFE.txt,15058,15272,214,10,N,N,-,-1,-1
MULIFE.txt,15070,15305,235,10,N,N,-,-1,-1
MULIFE.txt,15093,15340,247,10,N,N,-,-1,-1
MULIFE.txt,15095,15366,271,10,N,N,-,-1,-1
MULIFE.txt,15106,15394,288,10,N,N,-,-1,-1
MULIFE.txt,15125,15435,310,10,N,N,-,-1,-1
MULIFE.txt,15143,15494,351,10,N,N,-,-1,-1
MULIFE.txt,15184,15501,317,10,N,N,-,-1,-1
MULIFE.txt,15217,15529,312,10,N,N,-,-1,-1
MULIFE.txt,15247,15561,314,10,N,N,-,-1,-1
MULIFE.txt,15273,15590,317,10,N,N,-,-1,-1
MULIFE.txt,15306,15609,303,10,N,N,-,-1,-1
MULIFE.txt,15341,15632,291,10,N,N,-,-1,-1
MULIFE.txt,15367,15658,291,10,N,N,-,-1,-1
MULIFE.txt,15395,15691,296,10,N,N,-,-1,-1
MULIFE.txt,15436,15698,262,10,N,N,-,-1,-1
MULIFE.txt,15497,15730,233,10,N,N,-,-1,-1
MULIFE.txt,15502,15757,255,10,N,N,-,-1,-1
MULIFE.txt,15530,15785,255,10,N,N,-,-1,-1
MULIFE.txt,15562,15813,251,10,N,N,-,-1,-1
MULIFE.txt,15591,15841,250,10,N,N,-,-1,-1
MULIFE.txt,15610,15870,260,10,N,N,-,-1,-1
MULIFE.txt,15633,15900,267,10,N,N,-,-1,-1
MULIFE.txt,15659,15957,298,10,N,N,-,-1,-1
MULIFE.txt,15694,15964,270,10,N,N,-,-1,-1
MULIFE.txt,15699,15992,293,10,N,N,-,-1,-1
MULIFE.txt,15731,16026,295,10,N,N,-,-1,-1
MULIFE.txt,15758,16035,277,10,N,N,-,-1,-1
MULIFE.txt,15786,16074,288,10,N,N,-,-1,-1
MULIFE.txt,15814,16115,301,10,N,N,-,-1,-1
MULIFE.txt,15842,16157,315,10,N,N,-,-1,-1
MULIFE.txt,15871,16192,321,10,N,N,-,-1,-1
MULIFE.txt,15901,16203,302,10,N,N,-,-1,-1
MULIFE.txt,15960,16230,270,10,N,N,-,-1,-1
MULIFE.txt,15965,16242,277,10,N,N,-,-1,-1
MULIFE.txt,15993,16263,270,10,N,N,-,-1,-1
MULIFE.txt,16031,16279,248,10,N,N,-,-1,-1
MULIFE.txt,16036,16286,250,10,N,N,-,-1,-1
MULIFE.txt,16075,16314,239,10,N,N,-,-1,-1
MULIFE.txt,16116,16359,243,10,N,N,-,-1,-1
MULIFE.txt,16158,16386,228,10,N,N,-,-1,-1
MULIFE.txt,16193,16407,214,10,N,N,-,-1,-1
MULIFE.txt,16204,16429,225,10,N,N,-,-1,-1
MULIFE.txt,16231,16445,214,10,N,N,-,-1,-1
MULIFE.txt,16243,16471,228,10,N,N,-,-1,-1
MULIFE.txt,16266,16499,233,10,N,N,-,-1,-1
MULIFE.txt,16282,16508,226,10,N,N,-,-1,-1
MULIFE.txt,16287,16515,228,10,N,N,-,-1,-1
MULIFE.txt,16315,16552,237,10,N,N,-,-1,-1
MULIFE.txt,16360,16601,241,10,N,N,-,-1,-1
MULIFE.txt,16387,16633,246,10,N,N,-,-1,-1
MULIFE.txt,16408,16654,246,10,N,N,-,-1,-1
MULIFE.txt,16430,16677,247,10,N,N,-,-1,-1
MULIFE.txt,16446,16698,252,10,N,N,-,-1,-1
MULIFE.txt,16472,16709,237,10,N,N,-,-1,-1
MULIFE.txt,16500,16745,245,10,N,N,-,-1,-1
MULIFE.txt,16511,16756,245,10,N,N,-,-1,-1
MULIFE.txt,16516,16763,247,10,N,N,-,-1,-1
MULIFE.txt,16553,16804,251,10,N,N,-,-1,-1
MULIFE.txt,16602,16826,224,10,N,N,-,-1,-1
MULIFE.txt,16634,16856,222,10,N,N,-,-1,-1
MULIFE.txt,16655,16892,237,10,N,N,-,-1,-1
MULIFE.txt,16678,16921,243,10,N,N,-,-1,-1
MULIFE.txt,16699,16949,250,10,N,N,-,-1,-1
MULIFE.txt,16710,16985,275,10,N,N,-,-1,-1
MULIFE.txt,16746,17018,272,10,N,N,-,-1,-1
MULIFE.txt,16759,17038,279,10,N,N,-,-1,-1
MULIFE.txt,16764,17075,311,10,N,N,-,-1,-1
MULIFE.txt,16805,17100,295,10,N,N,-,-1,-1
MULIFE.txt,16827,17122,295,10,N,N,-,-1,-1
MULIFE.txt,16857,17150,293,10,N,N,-,-1,-1
MULIFE.txt,16893,17167,274,10,N,N,-,-1,-1
MULIFE.txt,16922,17174,252,10,N,N,-,-1,-1
MULIFE.txt,16950,17209,259,10,N,N,-,-1,-1
MULIFE.txt,16986,17249,263,10,N,N,-,-1,-1
MULIFE.txt,17019,17279,260,10,N,N,-,-1,-1
MULIFE.txt,17039,17313,274,10,N,N,-,-1,-1
MULIFE.txt,17076,17335,259,10,N,N,-,-1,-1
MULIFE.txt,17101,17354,253,10,N,N,-,-1,-1
MULIFE.txt,17123,17384,261,10,N,N,-,-1,-1
MULIFE.txt,17151,17423,272,10,N,N,-,-1,-1
MULIFE.txt,17170,17430,260,10,N,N,-,-1,-1
MULIFE.txt,17175,17462,287,10,N,N,-,-1,-1
MULIFE.txt,17210,17491,281,10,N,N,-,-1,-1
MULIFE.txt,17250,17515,265,10,N,N,-,-1,-1
MULIFE.txt,17280,17527,247,10,N,N,-,-1,-1
MULIFE.txt,17314,17534,220,10,N,N,-,-1,-1
MULIFE.txt,17336,17557,221,10,N,N,-,-1,-1
MULIFE.txt,17355,17579,224,10,N,N,-,-1,-1
MULIFE.txt,17385,17591,206,10,N,N,-,-1,-1
MULIFE.txt,17426,17618,192,10,N,N,-,-1,-1
MULIFE.txt,17431,17629,198,10,N,N,-,-1,-1
MULIFE.txt,17463,17675,212,10,N,N,-,-1,-1
MULIFE.txt,17492,17713,221,10,N,N,-,-1,-1
MULIFE.txt,17516,17737,221,10,N,N,-,-1,-1
MULIFE.txt,17530,17768,238,10,N,N,-,-1,-1
MULIFE.txt,17535,17785,250,10,N,N,-,-1,-1
MULIFE.txt,17558,17817,259,10,N,N,-,-1,-1
MULIFE.txt,17580,17840,260,10,N,N,-,-1,-1
MULIFE.txt,17592,17877,285,10,N,N,-,-1,-1
MULIFE.txt,17619,17902,283,10,N,N,-,-1,-1
MULIFE.txt,17630,17949,319,10,N,N,-,-1,-1
MULIFE.txt,17676,17965,289,10,N,N,-,-1,-1
MULIFE.txt,17714,17972,258,10,N,N,-,-1,-1
MULIFE.txt,17738,17979,241,10,N,N,-,-1,-1
MULIFE.txt,17769,18000,231,10,N,N,-,-1,-1
MULIFE.txt,17786,18025,239,10,N,N,-,-1,-1
MULIFE.txt,17818,18050,232,10,N,N,-,-1,-1
MULIFE.txt,17841,18063,222,10,N,N,-,-1,-1
MULIFE.txt,17878,18105,227,10,N,N,-,-1,-1
MULIFE.txt,17903,18148,245,10,N,N,-,-1,-1
MULIFE.txt,17954,18197,243,10,N,N,-,-1,-1
MULIFE.txt,17968,18209,241,10,N,N,-,-1,-1
MULIFE.txt,17975,18228,253,10,N,N,-,-1,-1
MULIFE.txt,17980,18235,255,10,N,N,-,-1,-1
MULIFE.txt,18001,18267,266,10,N,N,-,-1,-1
MULIFE.txt,18026,18295,269,10,N,N,-,-1,-1
MULIFE.txt,18051,18347,296,10,N,N,-,-1,-1
MULIFE.txt,18064,18391,327,10,N,N,-,-1,-1
MULIFE.txt,18106,18401,295,10,N,N,-,-1,-1
MULIFE.txt,18149,18408,259,10,N,N,-,-1,-1
MULIFE.txt,18198,18434,236,10,N,N,-,-1,-1
MULIFE.txt,18210,18451,241,10,N,N,-,-1,-1
MULIFE.txt,18231,18507,276,10,N,N,-,-1,-1
MULIFE.txt,18236,18541,305,10,N,N,-,-1,-1
MULIFE.txt,18268,18568,300,10,N,N,-,-1,-1
MULIFE.txt,18296,18580,284,10,N,N,-,-1,-1
MULIFE.txt,18348,18616,268,10,N,N,-,-1,-1
MULIFE.txt,18392,18645,253,10,N,N,-,-1,-1
MULIFE.txt,18404,18703,299,10,N,N,-,-1,-1
MULIFE.txt,18409,18727,318,10,N,N,-,-1,-1
MULIFE.txt,18435,18729,294,10,N,N,-,-1,-1
MULIFE.txt,18452,18746,294,10,N,N,-,-1,-1
MULIFE.txt,18508,18757,249,10,N,N,-,-1,-1
MULIFE.txt,18542,18783,241,10,N,N,-,-1,-1
MULIFE.txt,18569,18800,231,10,N,N,-,-1,-1
MULIFE.txt,18581,18811,230,10,N,N,-,-1,-1
MULIFE.txt,18617,18833,216,10,N,N,-,-1,-1
MULIFE.txt,18646,18848,202,10,N,N,-,-1,-1
MULIFE.txt,18704,18859,155,10,N,N,-,-1,-1
MULIFE.txt,18728,18894,166,10,N,N,-,-1,-1
MULIFE.txt,18730,18926,196,10,N,N,-,-1,-1
MULIFE.txt,18749,18946,197,10,N,N,-,-1,-1
MULIFE.txt,18758,18968,210,10,N,N,-,-1,-1
MULIFE.txt,18784,18986,202,10,N,N,-,-1,-1
MULIFE.txt,18801,19004,203,10,N,N,-,-1,-1
MULIFE.txt,18812,19018,206,10,N,N,-,-1,-1
MULIFE.txt,18834,19050,216,10,N,N,-,-1,-1
MULIFE.txt,18849,19072,223,10,N,N,-,-1,-1
MULIFE.txt,18860,19102,242,10,N,N,-,-1,-1
MULIFE.txt,18895,19141,246,10,N,N,-,-1,-1
MULIFE.txt,18927,19172,245,10,N,N,-,-1,-1
MULIFE.txt,18947,19194,247,10,N,N,-,-1,-1
MULIFE.txt,18969,19217,248,10,N,N,-,-1,-1
MULIFE.txt,18987,19238,251,10,N,N,-,-1,-1
MULIFE.txt,19007,19272,265,10,N,N,-,-1,-1
MULIFE.txt,19019,19279,260,10,N,N,-,-1,-1
MULIFE.txt,19051,19313,262,10,N,N,-,-1,-1
MULIFE.txt,19073,19342,269,10,N,N,-,-1,-1
MULIFE.txt,19103,19376,273,10,N,N,-,-1,-1
MULIFE.txt,19142,19391,249,10,N,N,-,-1,-1
MULIFE.txt,19173,19402,229,10,N,N,-,-1,-1
MULIFE.txt,19195,19431,236,10,N,N,-,-1,-1
MULIFE.txt,19218,19466,248,10,N,N,-,-1,-1
MULIFE.txt,19239,19474,235,10,N,N,-,-1,-1
MULIFE.txt,19275,19485,210,10,N,N,-,-1,-1
MULIFE.txt,19280,19516,236,10,N,N,-,-1,-1
MULIFE.txt,19314,19540,226,10,N,N,-,-1,-1
MULIFE.txt,19343,19568,225,10,N,N,-,-1,-1
MULIFE.txt,19377,19579,202,10,N,N,-,-1,-1
MULIFE.txt,19392,19601,209,10,N,N,-,-1,-1
MULIFE.txt,19403,19633,230,10,N,N,-,-1,-1
MULIFE.txt,19432,19658,226,10,N,N,-,-1,-1
MULIFE.txt,19467,19700,233,10,N,N,-,-1,-1
MULIFE.txt,19475,19707,232,10,N,N,-,-1,-1
MULIFE.txt,19486,19732,246,10,N,N,-,-1,-1
MULIFE.txt,19517,19761,244,10,N,N,-,-1,-1
MULIFE.txt,19541,19771,230,10,N,N,-,-1,-1
MULIFE.txt,19569,19778,209,10,N,N,-,-1,-1
MULIFE.txt,19580,19785,205,10,N,N,-,-1,-1
MULIFE.txt,19602,19806,204,10,N,N,-,-1,-1
MULIFE.txt,19634,19826,192,10,N,N,-,-1,-1
MULIFE.txt,19659,19877,218,10,N,N,-,-1,-1
MULIFE.txt,19703,19883,180,10,N,N,-,-1,-1
MULIFE.txt,19708,19918,210,10,N,N,-,-1,-1
MULIFE.txt,19733,19947,214,10,N,N,-,-1,-1
MULIFE.txt,19762,19959,197,10,N,N,-,-1,-1
MULIFE.txt,19772,19982,210,10,N,N,-,-1,-1
MULIFE.txt,19781,19996,215,10,N,N,-,-1,-1
MULIFE.txt,19786,20023,237,10,N,N,-,-1,-1
MULIFE.txt,19807,20055,248,10,N,N,-,-1,-1
MULIFE.txt,19827,20090,263,10,N,N,-,-1,-1
MULIFE.txt,19878,20129,251,10,N,N,-,-1,-1
MULIFE.txt,19884,20162,278,10,N,N,-,-1,-1
MULIFE.txt,19919,20192,273,10,N,N,-,-1,-1
MULIFE.txt,19948,20214,266,10,N,N,-,-1,-1
MULIFE.txt,19960,20225,265,10,N,N,-,-1,-1
MULIFE.txt,19985,20246,261,10,N,N,-,-1,-1
MULIFE.txt,19997,20266,269,10,N,N,-,-1,-1
MULIFE.txt,20024,20288,264,10,N,N,-,-1,-1
MULIFE.txt,20056,20299,243,10,N,N,-,-1,-1
MULIFE.txt,20091,20320,229,10,N,N,-,-1,-1
MULIFE.txt,20130,20331,201,10,N,N,-,-1,-1
MULIFE.txt,20163,20354,191,10,N,N,-,-1,-1
MULIFE.txt,20193,20356,163,10,N,N,-,-1,-1
MULIFE.txt,20215,20367,152,10,N,N,-,-1,-1
MULIFE.txt,20226,20394,168,10,N,N,-,-1,-1
MULIFE.txt,20247,20422,175,10,N,N,-,-1,-1
MULIFE.txt,20267,20456,189,10,N,N,-,-1,-1
MULIFE.txt,20289,20503,214,10,N,N,-,-1,-1
MULIFE.txt,20300,20535,235,10,N,N,-,-1,-1
MULIFE.txt,20321,20570,249,10,N,N,-,-1,-1
MULIFE.txt,20332,20600,268,10,N,N,-,-1,-1
MULIFE.txt,20355,20620,265,10,N,N,-,-1,-1
MULIFE.txt,20357,20664,307,10,N,N,-,-1,-1
MULIFE.txt,20368,20694,326,10,N,N,-,-1,-1
MULIFE.txt,20395,20722,327,10,N,N,-,-1,-1
MULIFE.txt,20423,20754,331,10,N,N,-,-1,-1
MULIFE.txt,20457,20805,348,10,N,N,-,-1,-1
MULIFE.txt,20504,20838,334,10,N,N,-,-1,-1
MULIFE.txt,20536,20872,336,10,N,N,-,-1,-1
MULIFE.txt,20571,20925,354,10,N,N,-,-1,-1
MULIFE.txt,20601,20958,357,10,N,N,-,-1,-1
MULIFE.txt,20621,21001,380,10,N,N,-,-1,-1
MULIFE.txt,20665,21033,368,10,N,N,-,-1,-1
MULIFE.txt,20695,21071,376,10,N,N,-,-1,-1
MULIFE.txt,20723,21094,371,10,N,N,-,-1,-1
MULIFE.txt,20755,21134,379,10,N,N,-,-1,-1
MULIFE.txt,20806,21164,358,10,N,N,-,-1,-1
MULIFE.txt,20839,21204,365,10,N,N,-,-1,-1
MULIFE.txt,20873,21247,374,10,N,N,-,-1,-1
MULIFE.txt,20926,21265,339,10,N,N,-,-1,-1
MULIFE.txt,20959,21294,335,10,N,N,-,-1,-1
MULIFE.txt,21002,21316,314,10,N,N,-,-1,-1
MULIFE.txt,21034,21345,311,10,N,N,-,-1,-1
MULIFE.txt,21072,21359,287,10,N,N,-,-1,-1
MULIFE.txt,21095,21386,291,10,N,N,-,-1,-1
MULIFE.txt,21135,21397,262,10,N,N,-,-1,-1
MULIFE.txt,21165,21423,258,10,N,N,-,-1,-1
MULIFE.txt,21205,21450,245,10,N,N,-,-1,-1
MULIFE.txt,21248,21468,220,10,N,N,-,-1,-1
MULIFE.txt,21266,21479,213,10,N,N,-,-1,-1
MULIFE.txt,21295,21506,211,10,N,N,-,-1,-1
MULIFE.txt,21317,21535,218,10,N,N,-,-1,-1
MULIFE.txt,21348,21570,222,10,N,N,-,-1,-1
MULIFE.txt,21360,21591,231,10,N,N,-,-1,-1
MULIFE.txt,21387,21646,259,10,N,N,-,-1,-1
MULIFE.txt,21398,21657,259,10,N,N,-,-1,-1
MULIFE.txt,21424,21695,271,10,N,N,-,-1,-1
MULIFE.txt,21451,21750,299,10,N,N,-,-1,-1
MULIFE.txt,21469,21790,321,10,N,N,-,-1,-1
MULIFE.txt,21480,21826,346,10,N,N,-,-1,-1
MULIFE.txt,21507,21852,345,10,N,N,-,-1,-1
MULIFE.txt,21536,21868,332,10,N,N,-,-1,-1
MULIFE.txt,21571,21872,301,10,N,N,-,-1,-1
MULIFE.txt,21592,21898,306,10,N,N,-,-1,-1
MULIFE.txt,21647,21923,276,10,N,N,-,-1,-1
MULIFE.txt,21658,21977,319,10,N,N,-,-1,-1
MULIFE.txt,21696,22024,328,10,N,N,-,-1,-1
MULIFE.txt,21751,22073,322,10,N,N,-,-1,-1
MULIFE.txt,21791,22097,306,10,N,N,-,-1,-1
MULIFE.txt,21827,22107,280,10,N,N,-,-1,-1
MULIFE.txt,21853,22212,359,10,N,N,-,-1,-1
MULIFE.txt,21869,22278,409,10,N,N,-,-1,-1
MULIFE.txt,21873,22353,480,10,N,N,-,-1,-1
MULIFE.txt,21899,22365,466,10,N,N,-,-1,-1
MULIFE.txt,21924,22684,760,10,N,N,-,-1,-1
MULIFE.txt,21978,22744,766,10,N,N,-,-1,-1
MULIFE.txt,22025,22857,832,10,N,N,-,-1,-1
MULIFE.txt,22076,22889,813,10,N,N,-,-1,-1
MULIFE.txt,22098,22952,854,10,N,N,-,-1,-1
MULIFE.txt,22108,22979,871,10,N,N,-,-1,-1
MULIFE.txt,22213,23027,814,10,N,N,-,-1,-1
MULIFE.txt,22284,23083,799,10,N,N,-,-1,-1
MULIFE.txt,22355,23136,781,10,N,N,-,-1,-1
MULIFE.txt,22368,23346,978,10,N,N,-,-1,-1
MULIFE.txt,22685,23401,716,10,N,N,-,-1,-1
MULIFE.txt,22745,23639,894,10,N,N,-,-1,-1
MULIFE.txt,22860,23807,947,10,N,N,-,-1,-1
MULIFE.txt,22892,23889,997,10,N,N,-,-1,-1
MULIFE.txt,22953,24020,1067,10,N,N,-,-1,-1
MULIFE.txt,22982,24115,1133,10,N,N,-,-1,-1
MULIFE.txt,23028,24323,1295,10,N,N,-,-1,-1
MULIFE.txt,23084,24366,1282,10,N,N,-,-1,-1
MULIFE.txt,23139,24420,1281,10,N,N,-,-1,-1
MULIFE.txt,23347,24463,1116,10,N,N,-,-1,-1
MULIFE.txt,23402,24604,1202,10,N,N,-,-1,-1
MULIFE.txt,23642,24620,978,10,N,N,-,-1,-1
MULIFE.txt,23810,24713,903,10,N,N,-,-1,-1
MULIFE.txt,23890,24725,835,10,N,N,-,-1,-1
MULIFE.txt,24023,24770,747,10,N,N,-,-1,-1
MULIFE.txt,24116,24805,689,10,N,N,-,-1,-1
MULIFE.txt,24324,24952,628,10,N,N,-,-1,-1
MULIFE.txt,24367,25078,711,10,N,N,-,-1,-1
MULIFE.txt,24421,25174,753,10,N,N,-,-1,-1
MULIFE.txt,24464,25206,742,10,N,N,-,-1,-1
MULIFE.txt,24605,25336,731,10,N,N,-,-1,-1
MULIFE.txt,24623,25421,798,10,N,N,-,-1,-1
MULIFE.txt,24714,25452,738,10,N,N,-,-1,-1
MULIFE.txt,24726,25457,731,10,N,N,-,-1,-1
MULIFE.txt,24772,25540,768,10,N,N,-,-1,-1
MULIFE.txt,24806,25565,759,10,N,N,-,-1,-1
MULIFE.txt,24955,25732,777,10,N,N,-,-1,-1
MULIFE.txt,25079,25811,732,10,N,N,-,-1,-1
MULIFE.txt,25175,26045,870,10,N,N,-,-1,-1
MULIFE.txt,25209,26102,893,10,N,N,-,-1,-1
MULIFE.txt,25339,26517,1178,10,N,N,-,-1,-1
MULIFE.txt,25421,26589,1168,10,N,N,-,-1,-1
MULIFE.txt,25453,26859,1406,10,N,N,-,-1,-1
MULIFE.txt,25458,27006,1548,10,N,N,-,-1,-1
MULIFE.txt,25541,27091,1550,10,N,N,-,-1,-1
MULIFE.txt,25566,27159,1593,10,N,N,-,-1,-1
MULIFE.txt,25735,27265,1530,10,N,N,-,-1,-1
MULIFE.txt,25812,27312,1500,10,N,N,-,-1,-1
MULIFE.txt,26046,27398,1352,10,N,N,-,-1,-1
MULIFE.txt,26103,27504,1401,10,N,N,-,-1,-1
MULIFE.txt,26520,27539,1019,10,N,N,-,-1,-1
MULIFE.txt,26590,27682,1092,10,N,N,-,-1,-1
MULIFE.txt,26860,27768,908,10,N,N,-,-1,-1
MULIFE.txt,27007,27958,951,10,N,N,-,-1,-1
MULIFE.txt,27094,28050,956,10,N,N,-,-1,-1
MULIFE.txt,27160,28116,956,10,N,N,-,-1,-1
MULIFE.txt,27268,28224,956,10,N,N,-,-1,-1
MULIFE.txt,27313,28312,999,10,N,N,-,-1,-1
MULIFE.txt,27399,28379,980,10,N,N,-,-1,-1
MULIFE.txt,27505,28412,907,10,N,N,-,-1,-1
MULIFE.txt,27541,28483,942,10,N,N,-,-1,-1
MULIFE.txt,27683,28518,835,10,N,N,-,-1,-1
MULIFE.txt,27769,28539,770,10,N,N,-,-1,-1
MULIFE.txt,27959,28595,636,10,N,N,-,-1,-1
MULIFE.txt,28052,28710,658,10,N,N,-,-1,-1
MULIFE.txt,28117,28910,793,10,N,N,-,-1,-1
MULIFE.txt,28226,29060,834,10,N,N,-,-1,-1
MULIFE.txt,28315,29194,879,10,N,N,-,-1,-1
MULIFE.txt,28382,29369,987,10,N,N,-,-1,-1
MULIFE.txt,28413,29518,1105,10,N,N,-,-1,-1
MULIFE.txt,28484,29671,1187,10,N,N,-,-1,-1
MULIFE.txt,28519,29755,1236,10,Y,N,-,-1,-1
MULIFE.txt,28542,30205,1663,10,Y,N,-,-1,-1
MULIFE.txt,28596,30400,1804,10,Y,N,-,-1,-1
MULIFE.txt,28711,30417,1706,10,Y,N,-,-1,-1
MULIFE.txt,28911,30492,1581,10,Y,N,-,-1,-1
MULIFE.txt,29061,30895,1834,10,N,N,-,-1,-1
MULIFE.txt,29195,31270,2075,10,N,N,-,-1,-1
MULIFE.txt,29370,31297,1927,10,N,N,-,-1,-1
MULIFE.txt,29519,31490,1971,10,N,N,-,-1,-1
MULIFE.txt,29672,31568,1896,10,N,N,-,-1,-1
MULIFE.txt,29756,31623,1867,10,N,N,-,-1,-1
MULIFE.txt,30205,31666,1461,10,N,N,-,-1,-1
MULIFE.txt,30401,31703,1302,10,N,N,-,-1,-1
MULIFE.txt,30418,31757,1339,10,N,N,-,-1,-1
MULIFE.txt,30493,31826,1333,10,N,N,-,-1,-1
MULIFE.txt,30896,31919,1023,10,N,N,-,-1,-1
MULIFE.txt,31275,31999,724,10,N,N,-,-1,-1
MULIFE.txt,31300,32031,731,10,N,N,-,-1,-1
MULIFE.txt,31495,32257,762,10,N,N,-,-1,-1
MULIFE.txt,31569,32542,973,10,N,N,-,-1,-1
MULIFE.txt,31624,32737,1113,10,N,N,-,-1,-1
MULIFE.txt,31667,32813,1146,10,N,N,-,-1,-1
MULIFE.txt,31704,33144,1440,10,N,N,-,-1,-1
MULIFE.txt,31758,33286,1528,10,N,Y,1448322514970,220165,221397
MULIFE.txt,31827,33379,1552,10,N,Y,1448322514970,220165,221397
MULIFE.txt,31921,33464,1543,10,N,Y,1448322514970,220165,221397
MULIFE.txt,32000,33616,1616,10,N,Y,1448322514970,220165,221397
MULIFE.txt,32032,33662,1630,10,N,Y,1448322514970,220165,221397
MULIFE.txt,32258,33732,1474,10,N,Y,1448322514970,220165,221397
MULIFE.txt,32543,33842,1299,10,N,Y,1448322514970,220165,221397
MULIFE.txt,32738,34062,1324,10,N,Y,1448322514970,220165,221397
MULIFE.txt,32814,34314,1500,10,N,Y,1448322514970,220165,221397
MULIFE.txt,33147,34449,1302,10,N,Y,1448322514970,220165,221397
MULIFE.txt,33287,34595,1308,10,N,Y,1448322514970,220165,221397
MULIFE.txt,33382,34738,1356,10,N,Y,1448322514970,220165,221397
MULIFE.txt,33465,34806,1341,10,N,Y,1448322514970,220165,221397
MULIFE.txt,33617,34890,1273,10,N,Y,1448322514970,220165,221397
MULIFE.txt,33664,34953,1289,10,N,Y,1448322514970,220165,221397
MULIFE.txt,33733,35016,1283,10,N,Y,1448322514970,220165,221397
MULIFE.txt,33843,35112,1269,10,N,Y,1448322514970,220165,221397
MULIFE.txt,34063,35255,1192,10,N,Y,1448322514970,220165,221397
MULIFE.txt,34317,35302,985,10,N,Y,1448322514970,220165,221397
MULIFE.txt,34450,35355,905,10,N,Y,1448322514970,220165,221397
MULIFE.txt,34596,35578,982,10,N,Y,1448037533268,13930,15031
MULIFE.txt,34741,35637,896,10,N,Y,1448037533268,13930,15031
MULIFE.txt,34807,35666,859,10,N,Y,1448037533268,13930,15031
MULIFE.txt,34891,35684,793,10,N,Y,1448037533268,13930,15031
MULIFE.txt,34954,35750,796,10,N,Y,1448037533268,13930,15031
MULIFE.txt,35017,35784,767,10,N,Y,1448037533268,13930,15031
MULIFE.txt,35113,36415,1302,10,N,Y,1448037533268,13930,15031
MULIFE.txt,35256,36468,1212,10,N,Y,1448037533268,13930,15031
MULIFE.txt,35303,36547,1244,10,N,Y,1448037533268,13930,15031
MULIFE.txt,35356,36692,1336,10,N,Y,1448037533268,13930,15031
MULIFE.txt,35581,36944,1363,10,N,Y,1448037533268,13930,15031
MULIFE.txt,35640,37006,1366,10,N,Y,1448037533268,13930,15031
MULIFE.txt,35667,37075,1408,10,N,Y,1448037533268,13930,15031
MULIFE.txt,35685,37174,1489,10,N,Y,1448037533268,13930,15031
MULIFE.txt,35755,37281,1526,10,N,Y,1448037533268,13930,15031
MULIFE.txt,35785,37325,1540,10,N,Y,1448037533268,13930,15031
MULIFE.txt,36418,37375,957,10,N,Y,1448037533268,13930,15031
MULIFE.txt,36469,37417,948,10,N,Y,1448037533268,13930,15031
MULIFE.txt,36548,37665,1117,10,N,Y,1448037533268,13930,15031
MULIFE.txt,36693,37770,1077,10,N,Y,1448037533268,13930,15031
MULIFE.txt,36946,37997,1051,10,N,Y,1448037533268,13930,15031
MULIFE.txt,37007,38111,1104,10,N,Y,1448037533268,13930,15031
MULIFE.txt,37076,38120,1044,10,N,Y,1448037533268,13930,15031
MULIFE.txt,37176,38260,1084,10,N,Y,1448037533268,13930,15031
MULIFE.txt,37282,38319,1037,10,N,N,-,-1,-1
MULIFE.txt,37326,38407,1081,10,Y,N,-,-1,-1
MULIFE.txt,37378,38590,1212,10,Y,N,-,-1,-1
MULIFE.txt,37418,38748,1330,10,Y,N,-,-1,-1
MULIFE.txt,37666,38787,1121,10,Y,N,-,-1,-1
MULIFE.txt,37772,38856,1084,10,N,N,-,-1,-1
MULIFE.txt,38000,38952,952,10,N,N,-,-1,-1
MULIFE.txt,38112,39110,998,10,Y,N,-,-1,-1
MULIFE.txt,38121,39188,1067,10,Y,N,-,-1,-1
MULIFE.txt,38261,39317,1056,10,Y,N,-,-1,-1
MULIFE.txt,38320,39439,1119,10,Y,Y,1448279813455,71525,72226
MULIFE.txt,38408,39505,1097,10,N,Y,1448279813455,71525,72226
MULIFE.txt,38591,39577,986,10,N,Y,1448279813455,71525,72226
MULIFE.txt,38749,39817,1068,10,N,Y,1448279813455,71525,72226
MULIFE.txt,38788,39857,1069,10,N,Y,1448279813455,71525,72226
MULIFE.txt,38857,39970,1113,10,N,Y,1448279813455,71525,72226
MULIFE.txt,38953,40060,1107,10,N,Y,1448279813455,71525,72226
MULIFE.txt,39111,40127,1016,10,N,Y,1448279813455,71525,72226
MULIFE.txt,39189,40240,1051,10,Y,Y,1448279813455,71525,72226
MULIFE.txt,39320,40313,993,10,N,Y,1448279813455,71525,72226
MULIFE.txt,39440,40340,900,10,N,Y,1448279813455,71525,72226
MULIFE.txt,39506,40456,950,10,Y,Y,1448279813455,71525,72226
MULIFE.txt,39578,40530,952,10,Y,Y,1448279813455,71525,72226
MULIFE.txt,39819,40538,719,10,N,Y,1448314402792,179959,180202
MULIFE.txt,39858,40690,832,10,N,Y,1448314402792,179959,180202
MULIFE.txt,39971,40756,785,10,N,Y,1448314402792,179959,180202
MULIFE.txt,40061,40776,715,10,N,Y,1448314402792,179959,180202
MULIFE.txt,40128,40814,686,10,N,Y,1448314402792,179959,180202
MULIFE.txt,40241,40905,664,10,N,Y,1448314402792,179959,180202
MULIFE.txt,40318,41003,685,10,N,Y,1448314402792,179959,180202
MULIFE.txt,40343,41076,733,10,N,Y,1448314402792,179959,180202
MULIFE.txt,40457,41153,696,10,N,Y,1448314402792,179959,180202
MULIFE.txt,40531,41254,723,10,N,Y,1448314402792,179959,180202
MULIFE.txt,40539,41316,777,10,N,Y,1448314402792,179959,180202
MULIFE.txt,40691,41370,679,10,N,Y,1448314402792,179959,180202
MULIFE.txt,40757,41402,645,10,N,Y,1448314402792,179959,180202
MULIFE.txt,40777,41470,693,10,N,Y,1448314402792,179959,180202
MULIFE.txt,40815,41483,668,10,N,Y,1448314402792,179959,180202
MULIFE.txt,40906,41630,724,10,N,Y,1448314402792,179959,180202
MULIFE.txt,41005,41783,778,10,N,Y,1448314402792,179959,180202
MULIFE.txt,41077,41952,875,10,N,Y,1448314402792,179959,180202
MULIFE.txt,41154,42098,944,10,N,Y,1448314402792,179959,180202
MULIFE.txt,41257,42373,1116,10,Y,N,-,-1,-1
MULIFE.txt,41317,42598,1281,10,Y,N,-,-1,-1
MULIFE.txt,41371,42622,1251,10,Y,N,-,-1,-1
MULIFE.txt,41403,42639,1236,10,Y,N,-,-1,-1
MULIFE.txt,41471,42662,1191,10,Y,N,-,-1,-1
MULIFE.txt,41484,42845,1361,10,N,N,-,-1,-1
MULIFE.txt,41631,43305,1674,10,Y,N,-,-1,-1
MULIFE.txt,41784,43389,1605,10,Y,N,-,-1,-1
MULIFE.txt,41953,43627,1674,10,N,N,-,-1,-1
MULIFE.txt,42099,43686,1587,10,N,N,-,-1,-1
MULIFE.txt,42376,43728,1352,10,N,N,-,-1,-1
MULIFE.txt,42601,43967,1366,10,N,N,-,-1,-1
MULIFE.txt,42623,44109,1486,10,N,N,-,-1,-1
MULIFE.txt,42640,44389,1749,10,N,N,-,-1,-1
MULIFE.txt,42663,44411,1748,10,N,N,-,-1,-1
MULIFE.txt,42846,44602,1756,10,N,N,-,-1,-1
MULIFE.txt,43308,44720,1412,10,N,N,-,-1,-1
MULIFE.txt,43390,44757,1367,10,N,N,-,-1,-1
MULIFE.txt,43628,44836,1208,10,N,N,-,-1,-1
MULIFE.txt,43687,44855,1168,10,N,N,-,-1,-1
MULIFE.txt,43729,44953,1224,10,N,N,-,-1,-1
MULIFE.txt,43968,45078,1110,10,N,N,-,-1,-1
MULIFE.txt,44110,45220,1110,10,N,N,-,-1,-1
MULIFE.txt,44390,45314,924,10,N,N,-,-1,-1
MULIFE.txt,44412,45483,1071,10,N,N,-,-1,-1
MULIFE.txt,44603,45583,980,10,N,N,-,-1,-1
MULIFE.txt,44721,45667,946,10,N,N,-,-1,-1
MULIFE.txt,44758,45697,939,10,N,N,-,-1,-1
MULIFE.txt,44841,45889,1048,10,N,N,-,-1,-1
MULIFE.txt,44856,45961,1105,10,N,N,-,-1,-1
MULIFE.txt,44954,46084,1130,10,N,N,-,-1,-1
MULIFE.txt,45079,46317,1238,10,N,N,-,-1,-1
MULIFE.txt,45221,46468,1247,10,N,N,-,-1,-1
MULIFE.txt,45315,46621,1306,10,N,N,-,-1,-1
MULIFE.txt,45484,46710,1226,10,N,N,-,-1,-1
MULIFE.txt,45584,46825,1241,10,N,N,-,-1,-1
MULIFE.txt,45668,46994,1326,10,N,N,-,-1,-1
MULIFE.txt,45698,47056,1358,10,N,N,-,-1,-1
MULIFE.txt,45890,47113,1223,10,N,N,-,-1,-1
MULIFE.txt,45962,47188,1226,10,N,N,-,-1,-1
MULIFE.txt,46085,47274,1189,10,N,N,-,-1,-1
MULIFE.txt,46319,47348,1029,10,N,N,-,-1,-1
MULIFE.txt,46471,47483,1012,10,N,N,-,-1,-1
MULIFE.txt,46622,47552,930,10,N,N,-,-1,-1
MULIFE.txt,46712,47824,1112,10,N,N,-,-1,-1
MULIFE.txt,46826,47855,1029,10,N,N,-,-1,-1
MULIFE.txt,46995,47968,973,10,N,N,-,-1,-1
MULIFE.txt,47057,48090,1033,10,N,N,-,-1,-1
MULIFE.txt,47114,48142,1028,10,N,N,-,-1,-1
MULIFE.txt,47189,48202,1013,10,N,N,-,-1,-1
MULIFE.txt,47275,48233,958,10,N,N,-,-1,-1
MULIFE.txt,47349,48292,943,10,N,N,-,-1,-1
MULIFE.txt,47485,48369,884,10,N,N,-,-1,-1
MULIFE.txt,47553,48433,880,10,N,N,-,-1,-1
MULIFE.txt,47825,48517,692,10,N,N,-,-1,-1
MULIFE.txt,47856,48745,889,10,Y,N,-,-1,-1
MULIFE.txt,47969,48788,819,10,N,N,-,-1,-1
MULIFE.txt,48091,48977,886,10,Y,N,-,-1,-1
MULIFE.txt,48143,49001,858,10,Y,N,-,-1,-1
MULIFE.txt,48205,49052,847,10,Y,N,-,-1,-1
MULIFE.txt,48234,49312,1078,10,Y,N,-,-1,-1
MULIFE.txt,48293,49487,1194,10,Y,N,-,-1,-1
MULIFE.txt,48371,49527,1156,10,Y,N,-,-1,-1
MULIFE.txt,48434,49581,1147,10,Y,N,-,-1,-1
MULIFE.txt,48518,49639,1121,10,Y,N,-,-1,-1
MULIFE.txt,48747,49725,978,10,Y,N,-,-1,-1
MULIFE.txt,48789,49845,1056,10,Y,N,-,-1,-1
MULIFE.txt,48978,50015,1037,10,N,N,-,-1,-1
MULIFE.txt,49002,50173,1171,10,N,Y,1448313800274,179025,179317
MULIFE.txt,49053,50332,1279,10,N,Y,1448313800274,179025,179317
MULIFE.txt,49313,50466,1153,10,N,Y,1448313800274,179025,179317
MULIFE.txt,49488,50622,1134,10,N,Y,1448313800274,179025,179317
MULIFE.txt,49528,50679,1151,10,N,Y,1448313800274,179025,179317
MULIFE.txt,49584,51071,1487,10,Y,Y,1448313800274,179025,179317
MULIFE.txt,49641,51165,1524,10,N,Y,1448313800274,179025,179317
MULIFE.txt,49726,51206,1480,10,N,Y,1448313800274,179025,179317
MULIFE.txt,49846,51275,1429,10,N,Y,1448313800274,179025,179317
MULIFE.txt,50018,51343,1325,10,Y,Y,1448313800274,179025,179317
MULIFE.txt,50174,51366,1192,10,Y,Y,1448313800274,179025,179317
MULIFE.txt,50333,51422,1089,10,Y,Y,1448313800274,179025,179317
MULIFE.txt,50467,51468,1001,10,Y,Y,1448313800274,179025,179317
MULIFE.txt,50624,51592,968,10,Y,Y,1448313800274,179025,179317
MULIFE.txt,50680,51634,954,10,N,Y,1448313800274,179025,179317
MULIFE.txt,51072,51818,746,10,N,Y,1448313800274,179025,179317
MULIFE.txt,51166,51865,699,10,N,Y,1448313800274,179025,179317
MULIFE.txt,51207,51923,716,10,N,Y,1448313800274,179025,179317
MULIFE.txt,51276,51988,712,10,N,N,-,-1,-1
MULIFE.txt,51344,52031,687,10,N,N,-,-1,-1
MULIFE.txt,51367,52373,1006,10,N,N,-,-1,-1
MULIFE.txt,51423,52394,971,10,N,N,-,-1,-1
MULIFE.txt,51471,52463,992,10,N,N,-,-1,-1
MULIFE.txt,51593,52533,940,10,N,N,-,-1,-1
MULIFE.txt,51635,52581,946,10,N,N,-,-1,-1
MULIFE.txt,51821,52594,773,10,N,N,-,-1,-1
MULIFE.txt,51866,52629,763,10,N,N,-,-1,-1
MULIFE.txt,51924,52679,755,10,N,N,-,-1,-1
MULIFE.txt,51991,53016,1025,10,N,N,-,-1,-1
MULIFE.txt,52032,53104,1072,10,N,N,-,-1,-1
MULIFE.txt,52374,53251,877,10,N,N,-,-1,-1
MULIFE.txt,52395,53385,990,10,N,N,-,-1,-1
MULIFE.txt,52464,53547,1083,10,N,N,-,-1,-1
MULIFE.txt,52534,53632,1098,10,N,N,-,-1,-1
MULIFE.txt,52584,53682,1098,10,N,N,-,-1,-1
MULIFE.txt,52595,53753,1158,10,N,N,-,-1,-1
MULIFE.txt,52630,53834,1204,10,Y,N,-,-1,-1
MULIFE.txt,52680,53905,1225,10,Y,Y,1448280423373,85694,86154
MULIFE.txt,53017,53955,938,10,N,Y,1448280423373,85694,86154
MULIFE.txt,53105,54054,949,10,N,Y,1448280423373,85694,86154
MULIFE.txt,53252,54062,810,10,N,Y,1448280423373,85694,86154
MULIFE.txt,53387,54073,686,10,N,Y,1448280423373,85694,86154
MULIFE.txt,53548,54637,1089,10,N,Y,1448280423373,85694,86154
MULIFE.txt,53633,54845,1212,10,N,Y,1448280423373,85694,86154
MULIFE.txt,53683,54880,1197,10,N,Y,1448280423373,85694,86154
MULIFE.txt,53754,54943,1189,10,N,Y,1448280423373,85694,86154
MULIFE.txt,53837,55025,1188,10,N,Y,1448280423373,85694,86154
MULIFE.txt,53906,55058,1152,10,N,Y,1448280423373,85694,86154
MULIFE.txt,53956,55286,1330,10,N,Y,1448280423373,85694,86154
MULIFE.txt,54055,55507,1452,10,N,Y,1448280423373,85694,86154
MULIFE.txt,54063,55660,1597,10,N,Y,1448280423373,85694,86154
MULIFE.txt,54074,55730,1656,10,N,Y,1448280423373,85694,86154
MULIFE.txt,54638,55891,1253,10,Y,Y,1437490253936,460795,462238
MULIFE.txt,54846,55924,1078,10,Y,Y,1437490253936,460795,462238
MULIFE.txt,54882,56121,1239,10,Y,Y,1437490253936,460795,462238
MULIFE.txt,54944,56240,1296,10,Y,Y,1437490253936,460795,462238
MULIFE.txt,55026,56309,1283,10,Y,Y,1437490253936,460795,462238
MULIFE.txt,55059,56398,1339,10,Y,Y,1437490253936,460795,462238
MULIFE.txt,55288,56477,1189,10,N,Y,1437490253936,460795,462238
MULIFE.txt,55508,56495,987,10,N,Y,1437490253936,460795,462238
MULIFE.txt,55663,56608,945,10,N,Y,1437490253936,460795,462238
MULIFE.txt,55733,56696,963,10,N,Y,1437490253936,460795,462238
MULIFE.txt,55892,56720,828,10,N,Y,1437490253936,460795,462238
MULIFE.txt,55925,56946,1021,10,N,Y,1437490253936,460795,462238
MULIFE.txt,56122,56998,876,10,N,Y,1437490253936,460795,462238
MULIFE.txt,56241,57049,808,10,N,Y,1437490253936,460795,462238
MULIFE.txt,56311,57133,822,10,N,Y,1437490253936,460795,462238
MULIFE.txt,56399,57217,818,10,N,Y,1437490253936,460795,462238
MULIFE.txt,56478,57905,1427,10,N,Y,1437490253936,460795,462238
MULIFE.txt,56496,57950,1454,10,N,Y,1437490253936,460795,462238
MULIFE.txt,56609,58041,1432,10,N,Y,1437490253936,460795,462238
MULIFE.txt,56697,58173,1476,10,N,Y,1437490253936,460795,462238
MULIFE.txt,56721,58344,1623,10,Y,Y,1437490253936,460795,462238
MULIFE.txt,56948,58401,1453,10,Y,Y,1437490253936,460795,462238
MULIFE.txt,57001,58507,1506,10,Y,Y,1437490253936,460795,462238
MULIFE.txt,57050,58617,1567,10,Y,Y,1437490253936,460795,462238
MULIFE.txt,57134,58741,1607,10,Y,Y,1437490253936,460795,462238
MULIFE.txt,57218,58814,1596,10,Y,Y,1437490253936,460795,462238
MULIFE.txt,57906,58931,1025,10,Y,Y,1448287306770,114686,120152
MULIFE.txt,57951,58974,1023,10,Y,Y,1448287306770,114686,120152
MULIFE.txt,58042,59005,963,10,Y,Y,1448287306770,114686,120152
MULIFE.txt,58174,59179,1005,10,Y,Y,1448287306770,114686,120152
MULIFE.txt,58345,59266,921,10,N,Y,1448287306770,114686,120152
MULIFE.txt,58402,59324,922,10,N,Y,1448287306770,114686,120152
MULIFE.txt,58508,59449,941,10,N,Y,1448287306770,114686,120152
MULIFE.txt,58618,59586,968,10,N,Y,1448287306770,114686,120152
MULIFE.txt,58744,59740,996,10,Y,Y,1448287306770,114686,120152
MULIFE.txt,58817,59794,977,10,Y,Y,1448287306770,114686,120152
MULIFE.txt,58934,60093,1159,10,N,Y,1448287306770,114686,120152
MULIFE.txt,58975,60106,1131,10,N,Y,1448287306770,114686,120152
MULIFE.txt,59006,60345,1339,10,N,Y,1448287306770,114686,120152
MULIFE.txt,59180,60443,1263,10,N,Y,1448287306770,114686,120152
MULIFE.txt,59267,60503,1236,10,N,Y,1448287306770,114686,120152
MULIFE.txt,59325,60585,1260,10,N,Y,1448287306770,114686,120152
MULIFE.txt,59450,60643,1193,10,N,Y,1448287306770,114686,120152
MULIFE.txt,59589,60745,1156,10,N,N,-,-1,-1
MULIFE.txt,59741,60872,1131,10,N,N,-,-1,-1
MULIFE.txt,59797,60953,1156,10,N,N,-,-1,-1
MULIFE.txt,60094,61014,920,10,N,N,-,-1,-1
MULIFE.txt,60107,61073,966,10,N,N,-,-1,-1
MULIFE.txt,60346,61090,744,10,N,N,-,-1,-1
MULIFE.txt,60444,61108,664,10,N,N,-,-1,-1
MULIFE.txt,60504,61182,678,10,N,N,-,-1,-1
MULIFE.txt,60586,61192,606,10,N,N,-,-1,-1
MULIFE.txt,60644,61290,646,10,N,N,-,-1,-1
MULIFE.txt,60746,61348,602,10,N,N,-,-1,-1
MULIFE.txt,60873,61591,718,10,N,N,-,-1,-1
MULIFE.txt,60956,61681,725,10,N,N,-,-1,-1
MULIFE.txt,61017,61872,855,10,N,N,-,-1,-1
MULIFE.txt,61076,62036,960,10,N,N,-,-1,-1
MULIFE.txt,61091,62180,1089,10,N,N,-,-1,-1
MULIFE.txt,61109,62571,1462,10,N,N,-,-1,-1
MULIFE.txt,61185,62648,1463,10,N,N,-,-1,-1
MULIFE.txt,61193,62743,1550,10,N,N,-,-1,-1
MULIFE.txt,61292,62751,1459,10,N,N,-,-1,-1
MULIFE.txt,61350,62951,1601,10,N,N,-,-1,-1
MULIFE.txt,61596,63020,1424,10,N,N,-,-1,-1
MULIFE.txt,61682,63070,1388,10,N,N,-,-1,-1
MULIFE.txt,61873,63099,1226,10,N,N,-,-1,-1
MULIFE.txt,62037,63177,1140,10,N,N,-,-1,-1
MULIFE.txt,62183,63388,1205,10,N,N,-,-1,-1
MULIFE.txt,62574,63419,845,10,N,N,-,-1,-1
MULIFE.txt,62649,63459,810,10,N,N,-,-1,-1
MULIFE.txt,62746,63571,825,10,N,N,-,-1,-1
MULIFE.txt,62752,63618,866,10,N,N,-,-1,-1
MULIFE.txt,62952,63635,683,10,N,N,-,-1,-1
MULIFE.txt,63022,63747,725,10,N,N,-,-1,-1
MULIFE.txt,63071,63857,786,10,N,N,-,-1,-1
MULIFE.txt,63100,64008,908,10,N,Y,1437472966198,394609,395892
MULIFE.txt,63178,64144,966,10,N,Y,1437472966198,394609,395892
MULIFE.txt,63389,64402,1013,10,N,Y,1437472966198,394609,395892
MULIFE.txt,63420,64437,1017,10,N,Y,1437472966198,394609,395892
MULIFE.txt,63461,64605,1144,10,Y,Y,1437472966198,394609,395892
MULIFE.txt,63572,64767,1195,10,Y,Y,1437472966198,394609,395892
MULIFE.txt,63619,64821,1202,10,Y,Y,1437472966198,394609,395892
MULIFE.txt,63638,64864,1226,10,Y,Y,1437472966198,394609,395892
MULIFE.txt,63748,65129,1381,10,Y,Y,1437472966198,394609,395892
MULIFE.txt,63858,65333,1475,10,Y,Y,1437472966198,394609,395892
MULIFE.txt,64009,65381,1372,10,Y,Y,1437472966198,394609,395892
MULIFE.txt,64145,65413,1268,10,N,Y,1437472966198,394609,395892
MULIFE.txt,64405,65489,1084,10,N,N,-,-1,-1
MULIFE.txt,64438,65524,1086,10,N,N,-,-1,-1
MULIFE.txt,64608,65619,1011,10,N,N,-,-1,-1
MULIFE.txt,64770,65852,1082,10,N,N,-,-1,-1
MULIFE.txt,64822,66022,1200,10,N,N,-,-1,-1
MULIFE.txt,64865,66044,1179,10,N,N,-,-1,-1
MULIFE.txt,65131,66165,1034,10,N,N,-,-1,-1
MULIFE.txt,65334,66490,1156,10,N,N,-,-1,-1
MULIFE.txt,65382,66709,1327,10,N,N,-,-1,-1
MULIFE.txt,65414,66869,1455,10,N,N,-,-1,-1
MULIFE.txt,65490,67467,1977,10,Y,N,-,-1,-1
MULIFE.txt,65525,67672,2147,10,Y,N,-,-1,-1
MULIFE.txt,65622,67844,2222,10,Y,N,-,-1,-1
MULIFE.txt,65855,67852,1997,10,Y,N,-,-1,-1
MULIFE.txt,66027,67886,1859,10,Y,N,-,-1,-1
MULIFE.txt,66045,67898,1853,10,Y,N,-,-1,-1
MULIFE.txt,66168,68136,1968,10,Y,N,-,-1,-1
MULIFE.txt,66491,68199,1708,10,Y,N,-,-1,-1
MULIFE.txt,66712,68237,1525,10,Y,N,-,-1,-1
MULIFE.txt,66870,68319,1449,10,Y,N,-,-1,-1
MULIFE.txt,67470,68413,943,10,N,N,-,-1,-1
MULIFE.txt,67673,68481,808,10,N,N,-,-1,-1
MULIFE.txt,67849,68527,678,10,N,N,-,-1,-1
MULIFE.txt,67855,68552,697,10,N,N,-,-1,-1
MULIFE.txt,67888,68574,686,10,N,N,-,-1,-1
MULIFE.txt,67901,68652,751,10,N,N,-,-1,-1
MULIFE.txt,68137,68790,653,10,N,N,-,-1,-1
MULIFE.txt,68200,68829,629,10,N,N,-,-1,-1
MULIFE.txt,68238,68877,639,10,N,N,-,-1,-1
MULIFE.txt,68320,68900,580,10,N,N,-,-1,-1
MULIFE.txt,68414,68917,503,10,N,N,-,-1,-1
MULIFE.txt,68482,68977,495,10,N,N,-,-1,-1
MULIFE.txt,68528,68982,454,10,N,N,-,-1,-1
MULIFE.txt,68557,68995,438,10,N,N,-,-1,-1
MULIFE.txt,68575,69015,440,10,N,N,-,-1,-1
MULIFE.txt,68655,69117,462,10,N,N,-,-1,-1
MULIFE.txt,68791,69151,360,10,N,N,-,-1,-1
MULIFE.txt,68830,69260,430,10,N,N,-,-1,-1
MULIFE.txt,68878,69308,430,10,N,N,-,-1,-1
MULIFE.txt,68903,69339,436,10,N,N,-,-1,-1
MULIFE.txt,68918,69382,464,10,N,N,-,-1,-1
MULIFE.txt,68978,69492,514,10,N,N,-,-1,-1
MULIFE.txt,68983,69526,543,10,N,N,-,-1,-1
MULIFE.txt,68996,69742,746,10,N,N,-,-1,-1
MULIFE.txt,69018,69946,928,10,N,N,-,-1,-1
MULIFE.txt,69118,70012,894,10,N,N,-,-1,-1
MULIFE.txt,69152,70260,1108,10,Y,N,-,-1,-1
MULIFE.txt,69263,70301,1038,10,N,N,-,-1,-1
MULIFE.txt,69309,70325,1016,10,N,N,-,-1,-1
MULIFE.txt,69340,70438,1098,10,N,N,-,-1,-1
MULIFE.txt,69383,70469,1086,10,N,N,-,-1,-1
MULIFE.txt,69494,70619,1125,10,N,N,-,-1,-1
MULIFE.txt,69527,70902,1375,10,N,N,-,-1,-1
MULIFE.txt,69743,70970,1227,10,N,N,-,-1,-1
MULIFE.txt,69947,71135,1188,10,N,N,-,-1,-1
MULIFE.txt,70015,71176,1161,10,N,N,-,-1,-1
MULIFE.txt,70263,71297,1034,10,N,N,-,-1,-1
MULIFE.txt,70302,71468,1166,10,N,N,-,-1,-1
MULIFE.txt,70326,71497,1171,10,N,N,-,-1,-1
MULIFE.txt,70440,71647,1207,10,N,N,-,-1,-1
MULIFE.txt,70470,71805,1335,10,N,N,-,-1,-1
MULIFE.txt,70620,71863,1243,10,N,N,-,-1,-1
MULIFE.txt,70903,71913,1010,10,N,N,-,-1,-1
MULIFE.txt,70973,71991,1018,10,N,N,-,-1,-1
MULIFE.txt,71136,72005,869,10,N,N,-,-1,-1
MULIFE.txt,71177,72236,1059,10,N,N,-,-1,-1
MULIFE.txt,71299,72287,988,10,N,N,-,-1,-1
MULIFE.txt,71473,72364,891,10,N,N,-,-1,-1
MULIFE.txt,71498,72631,1133,10,N,N,-,-1,-1
MULIFE.txt,71648,72732,1084,10,N,N,-,-1,-1
MULIFE.txt,71807,72793,986,10,N,N,-,-1,-1
MULIFE.txt,71866,72812,946,10,N,N,-,-1,-1
MULIFE.txt,71914,72908,994,10,N,N,-,-1,-1
MULIFE.txt,71992,73006,1014,10,N,N,-,-1,-1
MULIFE.txt,72006,73027,1021,10,N,N,-,-1,-1
MULIFE.txt,72237,73086,849,10,N,N,-,-1,-1
MULIFE.txt,72288,73250,962,10,N,N,-,-1,-1
MULIFE.txt,72365,73277,912,10,N,N,-,-1,-1
MULIFE.txt,72633,73336,703,10,N,N,-,-1,-1
MULIFE.txt,72733,73373,640,10,N,N,-,-1,-1
MULIFE.txt,72794,73413,619,10,N,N,-,-1,-1
MULIFE.txt,72814,73486,672,10,N,N,-,-1,-1
MULIFE.txt,72909,73491,582,10,N,N,-,-1,-1
MULIFE.txt,73007,73645,638,10,N,N,-,-1,-1
MULIFE.txt,73028,73924,896,10,N,N,-,-1,-1
MULIFE.txt,73091,74227,1136,10,N,N,-,-1,-1
MULIFE.txt,73253,74310,1057,10,N,Y,1448316586529,210063,210674
MULIFE.txt,73278,74454,1176,10,N,Y,1448316586529,210063,210674
MULIFE.txt,73337,74507,1170,10,N,Y,1448316586529,210063,210674
MULIFE.txt,73374,74575,1201,10,N,Y,1448316586529,210063,210674
MULIFE.txt,73414,74711,1297,10,N,Y,1448316586529,210063,210674
MULIFE.txt,73487,74780,1293,10,N,Y,1448316586529,210063,210674
MULIFE.txt,73492,74810,1318,10,N,Y,1448316586529,210063,210674
MULIFE.txt,73647,74878,1231,10,N,Y,1448316586529,210063,210674
MULIFE.txt,73925,74918,993,10,N,Y,1448316586529,210063,210674
MULIFE.txt,74230,74937,707,10,N,Y,1448316586529,210063,210674
MULIFE.txt,74311,75119,808,10,N,Y,1448316586529,210063,210674
MULIFE.txt,74455,75321,866,10,N,Y,1448316586529,210063,210674
MULIFE.txt,74510,75474,964,10,N,Y,1448316586529,210063,210674
MULIFE.txt,74576,75631,1055,10,N,Y,1448316586529,210063,210674
MULIFE.txt,74712,75735,1023,10,N,Y,1448316586529,210063,210674
MULIFE.txt,74781,76105,1324,10,N,Y,1448316586529,210063,210674
MULIFE.txt,74812,76332,1520,10,N,Y,1448039370049,20775,21297
MULIFE.txt,74879,76371,1492,10,N,Y,1448039370049,20775,21297
MULIFE.txt,74919,76634,1715,10,N,Y,1448039370049,20775,21297
MULIFE.txt,74938,76672,1734,10,N,Y,1448039370049,20775,21297
MULIFE.txt,75120,76833,1713,10,N,Y,1448039370049,20775,21297
MULIFE.txt,75322,76938,1616,10,N,Y,1448039370049,20775,21297
MULIFE.txt,75475,77045,1570,10,Y,Y,1448039370049,20775,21297
MULIFE.txt,75632,77241,1609,10,Y,Y,1448039370049,20775,21297
MULIFE.txt,75736,77330,1594,10,Y,Y,1448039370049,20775,21297
MULIFE.txt,76106,77401,1295,10,Y,Y,1448039370049,20775,21297
MULIFE.txt,76337,77584,1247,10,Y,Y,1448039370049,20775,21297
MULIFE.txt,76374,77666,1292,10,Y,Y,1448039370049,20775,21297
MULIFE.txt,76635,77778,1143,10,Y,Y,1448039370049,20775,21297
MULIFE.txt,76673,77874,1201,10,Y,Y,1448039370049,20775,21297
MULIFE.txt,76836,77896,1060,10,Y,N,-,-1,-1
MULIFE.txt,76939,77922,983,10,N,N,-,-1,-1
MULIFE.txt,77046,77929,883,10,N,N,-,-1,-1
MULIFE.txt,77243,77957,714,10,N,N,-,-1,-1
MULIFE.txt,77331,77986,655,10,N,N,-,-1,-1
MULIFE.txt,77402,78183,781,10,N,N,-,-1,-1
MULIFE.txt,77585,78348,763,10,N,N,-,-1,-1
MULIFE.txt,77667,78386,719,10,N,N,-,-1,-1
MULIFE.txt,77779,78427,648,10,N,N,-,-1,-1
MULIFE.txt,77875,78592,717,10,N,N,-,-1,-1
MULIFE.txt,77897,78912,1015,10,N,N,-,-1,-1
MULIFE.txt,77923,79143,1220,10,N,N,-,-1,-1
MULIFE.txt,77930,79287,1357,10,N,N,-,-1,-1
MULIFE.txt,77959,79411,1452,10,N,N,-,-1,-1
MULIFE.txt,77989,79541,1552,10,N,N,-,-1,-1
MULIFE.txt,78184,79805,1621,10,N,N,-,-1,-1
MULIFE.txt,78349,79873,1524,10,N,N,-,-1,-1
MULIFE.txt,78387,79976,1589,10,N,N,-,-1,-1
MULIFE.txt,78428,80036,1608,10,N,N,-,-1,-1
MULIFE.txt,78593,80040,1447,10,N,N,-,-1,-1
MULIFE.txt,78913,80058,1145,10,N,N,-,-1,-1
MULIFE.txt,79146,80135,989,10,N,N,-,-1,-1
MULIFE.txt,79288,80313,1025,10,N,N,-,-1,-1
MULIFE.txt,79414,80431,1017,10,N,N,-,-1,-1
MULIFE.txt,79542,80523,981,10,N,N,-,-1,-1
MULIFE.txt,79808,80614,806,10,N,N,-,-1,-1
MULIFE.txt,79874,80666,792,10,N,N,-,-1,-1
MULIFE.txt,79979,80727,748,10,N,N,-,-1,-1
MULIFE.txt,80037,80860,823,10,N,N,-,-1,-1
MULIFE.txt,80041,80972,931,10,Y,N,-,-1,-1
MULIFE.txt,80059,81113,1054,10,N,N,-,-1,-1
MULIFE.txt,80136,81280,1144,10,Y,N,-,-1,-1
MULIFE.txt,80314,81456,1142,10,Y,N,-,-1,-1
MULIFE.txt,80432,81605,1173,10,Y,N,-,-1,-1
MULIFE.txt,80524,81661,1137,10,N,N,-,-1,-1
MULIFE.txt,80615,81826,1211,10,N,N,-,-1,-1
MULIFE.txt,80667,81837,1170,10,N,N,-,-1,-1
MULIFE.txt,80728,81849,1121,10,N,N,-,-1,-1
MULIFE.txt,80861,81939,1078,10,N,N,-,-1,-1
MULIFE.txt,80973,82012,1039,10,N,N,-,-1,-1
MULIFE.txt,81116,82223,1107,10,N,N,-,-1,-1
MULIFE.txt,81281,82251,970,10,N,N,-,-1,-1
MULIFE.txt,81458,82363,905,10,N,N,-,-1,-1
MULIFE.txt,81606,82373,767,10,N,N,-,-1,-1
MULIFE.txt,81662,82561,899,10,N,N,-,-1,-1
MULIFE.txt,81827,82746,919,10,N,N,-,-1,-1
MULIFE.txt,81838,82860,1022,10,N,Y,1448279089520,67624,69991
MULIFE.txt,81850,83171,1321,10,N,Y,1448279089520,67624,69991
MULIFE.txt,81940,83343,1403,10,N,Y,1448279089520,67624,69991
MULIFE.txt,82013,83419,1406,10,N,Y,1448279089520,67624,69991
MULIFE.txt,82224,83472,1248,10,N,Y,1448279089520,67624,69991
MULIFE.txt,82252,83589,1337,10,N,Y,1448279089520,67624,69991
MULIFE.txt,82366,83673,1307,10,Y,Y,1448279089520,67624,69991
MULIFE.txt,82374,83750,1376,10,Y,Y,1448279089520,67624,69991
MULIFE.txt,82562,83896,1334,10,Y,Y,1448279089520,67624,69991
MULIFE.txt,82749,83970,1221,10,Y,Y,1448279089520,67624,69991
MULIFE.txt,82863,84106,1243,10,Y,Y,1448279089520,67624,69991
MULIFE.txt,83172,84168,996,10,Y,Y,1448279089520,67624,69991
MULIFE.txt,83344,84277,933,10,Y,N,-,-1,-1
MULIFE.txt,83422,84384,962,10,Y,N,-,-1,-1
MULIFE.txt,83475,84459,984,10,Y,N,-,-1,-1
MULIFE.txt,83592,84555,963,10,N,N,-,-1,-1
MULIFE.txt,83674,84752,1078,10,N,N,-,-1,-1
MULIFE.txt,83751,84854,1103,10,N,N,-,-1,-1
MULIFE.txt,83897,84976,1079,10,N,N,-,-1,-1
MULIFE.txt,83972,85058,1086,10,N,N,-,-1,-1
MULIFE.txt,84107,85157,1050,10,N,N,-,-1,-1
MULIFE.txt,84169,85247,1078,10,N,N,-,-1,-1
MULIFE.txt,84280,85335,1055,10,N,N,-,-1,-1
MULIFE.txt,84385,85374,989,10,N,N,-,-1,-1
MULIFE.txt,84460,85452,992,10,N,N,-,-1,-1
MULIFE.txt,84556,85474,918,10,N,N,-,-1,-1
MULIFE.txt,84753,85705,952,10,N,N,-,-1,-1
MULIFE.txt,84855,85902,1047,10,N,N,-,-1,-1
MULIFE.txt,84977,86282,1305,10,N,N,-,-1,-1
MULIFE.txt,85060,86381,1321,10,N,N,-,-1,-1
MULIFE.txt,85160,86421,1261,10,N,N,-,-1,-1
MULIFE.txt,85248,86472,1224,10,N,N,-,-1,-1
MULIFE.txt,85336,86570,1234,10,N,N,-,-1,-1
MULIFE.txt,85375,86623,1248,10,N,N,-,-1,-1
MULIFE.txt,85453,86842,1389,10,N,N,-,-1,-1
MULIFE.txt,85478,86909,1431,10,N,N,-,-1,-1
MULIFE.txt,85706,87003,1297,10,N,N,-,-1,-1
MULIFE.txt,85903,87134,1231,10,N,N,-,-1,-1
MULIFE.txt,86285,87173,888,10,N,N,-,-1,-1
MULIFE.txt,86382,87274,892,10,Y,N,-,-1,-1
MULIFE.txt,86424,87336,912,10,Y,N,-,-1,-1
MULIFE.txt,86473,87413,940,10,Y,N,-,-1,-1
MULIFE.txt,86571,87462,891,10,Y,N,-,-1,-1
MULIFE.txt,86624,87558,934,10,Y,N,-,-1,-1
MULIFE.txt,86843,87646,803,10,Y,N,-,-1,-1
MULIFE.txt,86910,87706,796,10,Y,N,-,-1,-1
MULIFE.txt,87004,87915,911,10,Y,N,-,-1,-1
MULIFE.txt,87135,88063,928,10,Y,N,-,-1,-1
MULIFE.txt,87174,88121,947,10,Y,N,-,-1,-1
MULIFE.txt,87275,88315,1040,10,N,N,-,-1,-1
MULIFE.txt,87339,88672,1333,10,Y,N,-,-1,-1
MULIFE.txt,87414,88792,1378,10,N,N,-,-1,-1
MULIFE.txt,87463,88816,1353,10,N,N,-,-1,-1
MULIFE.txt,87559,88892,1333,10,N,N,-,-1,-1
MULIFE.txt,87647,89106,1459,10,N,N,-,-1,-1
MULIFE.txt,87707,89145,1438,10,N,N,-,-1,-1
MULIFE.txt,87918,89200,1282,10,N,N,-,-1,-1
MULIFE.txt,88066,89281,1215,10,N,N,-,-1,-1
MULIFE.txt,88122,89375,1253,10,N,N,-,-1,-1
MULIFE.txt,88316,89487,1171,10,N,N,-,-1,-1
MULIFE.txt,88675,89527,852,10,N,N,-,-1,-1
MULIFE.txt,88793,89577,784,10,N,N,-,-1,-1
MULIFE.txt,88817,89613,796,10,N,N,-,-1,-1
MULIFE.txt,88893,89641,748,10,N,N,-,-1,-1
MULIFE.txt,89107,89663,556,10,N,N,-,-1,-1
MULIFE.txt,89147,89709,562,10,N,N,-,-1,-1
MULIFE.txt,89202,89894,692,10,N,N,-,-1,-1
MULIFE.txt,89282,90211,929,10,N,N,-,-1,-1
MULIFE.txt,89377,90257,880,10,N,N,-,-1,-1
MULIFE.txt,89488,90312,824,10,N,N,-,-1,-1
MULIFE.txt,89528,90357,829,10,N,N,-,-1,-1
MULIFE.txt,89578,90438,860,10,N,N,-,-1,-1
MULIFE.txt,89614,90479,865,10,N,N,-,-1,-1
MULIFE.txt,89643,90611,968,10,N,N,-,-1,-1
MULIFE.txt,89664,90682,1018,10,N,N,-,-1,-1
MULIFE.txt,89710,91127,1417,10,N,N,-,-1,-1
MULIFE.txt,89895,91170,1275,10,N,N,-,-1,-1
MULIFE.txt,90213,91306,1093,10,N,N,-,-1,-1
MULIFE.txt,90258,91338,1080,10,N,N,-,-1,-1
MULIFE.txt,90313,91449,1136,10,N,N,-,-1,-1
MULIFE.txt,90358,91582,1224,10,N,N,-,-1,-1
MULIFE.txt,90439,91715,1276,10,N,N,-,-1,-1
MULIFE.txt,90480,91785,1305,10,N,N,-,-1,-1
MULIFE.txt,90614,91827,1213,10,N,N,-,-1,-1
MULIFE.txt,90683,91908,1225,10,N,N,-,-1,-1
MULIFE.txt,91130,92004,874,10,N,N,-,-1,-1
MULIFE.txt,91173,92254,1081,10,N,N,-,-1,-1
MULIFE.txt,91307,92458,1151,10,N,N,-,-1,-1
MULIFE.txt,91341,92615,1274,10,N,N,-,-1,-1
MULIFE.txt,91450,92702,1252,10,N,N,-,-1,-1
MULIFE.txt,91585,92747,1162,10,N,N,-,-1,-1
MULIFE.txt,91716,93044,1328,10,N,N,-,-1,-1
MULIFE.txt,91786,93126,1340,10,N,N,-,-1,-1
MULIFE.txt,91828,93259,1431,10,N,N,-,-1,-1
MULIFE.txt,91909,93426,1517,10,N,N,-,-1,-1
MULIFE.txt,92005,93480,1475,10,N,N,-,-1,-1
MULIFE.txt,92255,93592,1337,10,N,N,-,-1,-1
MULIFE.txt,92459,93625,1166,10,N,N,-,-1,-1
MULIFE.txt,92617,93658,1041,10,N,N,-,-1,-1
MULIFE.txt,92703,93969,1266,10,N,N,-,-1,-1
MULIFE.txt,92748,94128,1380,10,N,N,-,-1,-1
MULIFE.txt,93045,94202,1157,10,N,N,-,-1,-1
MULIFE.txt,93129,94253,1124,10,N,N,-,-1,-1
MULIFE.txt,93260,94293,1033,10,N,N,-,-1,-1
MULIFE.txt,93429,94598,1169,10,N,N,-,-1,-1
MULIFE.txt,93482,94845,1363,10,N,N,-,-1,-1
MULIFE.txt,93593,94969,1376,10,N,N,-,-1,-1
MULIFE.txt,93626,95175,1549,10,N,N,-,-1,-1
MULIFE.txt,93660,95301,1641,10,N,N,-,-1,-1
MULIFE.txt,93972,95515,1543,10,N,N,-,-1,-1
MULIFE.txt,94131,95632,1501,10,N,N,-,-1,-1
MULIFE.txt,94203,95707,1504,10,N,N,-,-1,-1
MULIFE.txt,94254,95760,1506,10,N,N,-,-1,-1
MULIFE.txt,94296,95784,1488,10,N,N,-,-1,-1
MULIFE.txt,94601,96008,1407,10,N,N,-,-1,-1
MULIFE.txt,94848,96188,1340,10,N,N,-,-1,-1
MULIFE.txt,94970,96253,1283,10,N,N,-,-1,-1
MULIFE.txt,95176,96346,1170,10,N,N,-,-1,-1
MULIFE.txt,95302,96372,1070,10,N,N,-,-1,-1
MULIFE.txt,95516,96438,922,10,N,N,-,-1,-1
MULIFE.txt,95633,96600,967,10,N,N,-,-1,-1
MULIFE.txt,95710,96707,997,10,N,N,-,-1,-1
MULIFE.txt,95761,96748,987,10,N,N,-,-1,-1
MULIFE.txt,95785,96854,1069,10,N,N,-,-1,-1
MULIFE.txt,96009,97011,1002,10,N,N,-,-1,-1
MULIFE.txt,96191,97094,903,10,N,N,-,-1,-1
MULIFE.txt,96254,97290,1036,10,N,N,-,-1,-1
MULIFE.txt,96347,97575,1228,10,N,N,-,-1,-1
MULIFE.txt,96373,97687,1314,10,N,N,-,-1,-1
MULIFE.txt,96441,97790,1349,10,N,N,-,-1,-1
MULIFE.txt,96601,97892,1291,10,N,N,-,-1,-1
MULIFE.txt,96708,97957,1249,10,N,N,-,-1,-1
MULIFE.txt,96749,98049,1300,10,N,N,-,-1,-1
MULIFE.txt,96857,98054,1197,10,N,N,-,-1,-1
MULIFE.txt,97014,98102,1088,10,N,N,-,-1,-1
MULIFE.txt,97095,98341,1246,10,N,N,-,-1,-1
MULIFE.txt,97291,98416,1125,10,N,N,-,-1,-1
MULIFE.txt,97576,98468,892,10,N,N,-,-1,-1
MULIFE.txt,97688,98598,910,10,N,N,-,-1,-1
MULIFE.txt,97791,98626,835,10,N,N,-,-1,-1
MULIFE.txt,97893,98633,740,10,N,N,-,-1,-1
MULIFE.txt,97958,98664,706,10,N,N,-,-1,-1
MULIFE.txt,98050,98715,665,10,N,N,-,-1,-1
MULIFE.txt,98055,98734,679,10,N,N,-,-1,-1
MULIFE.txt,98103,98762,659,10,N,N,-,-1,-1
MULIFE.txt,98344,98801,457,10,N,N,-,-1,-1
MULIFE.txt,98417,99030,613,10,N,N,-,-1,-1
MULIFE.txt,98469,99429,960,10,N,N,-,-1,-1
MULIFE.txt,98599,99462,863,10,N,N,-,-1,-1
MULIFE.txt,98629,99498,869,10,N,N,-,-1,-1
MULIFE.txt,98634,99636,1002,10,N,N,-,-1,-1
MULIFE.txt,98665,99776,1111,10,N,N,-,-1,-1
MULIFE.txt,98716,99953,1237,10,N,N,-,-1,-1
MULIFE.txt,98735,99992,1257,10,N,N,-,-1,-1
MULIFE.txt,98763,100059,1296,10,N,N,-,-1,-1
MULIFE.txt,98802,100320,1518,10,N,N,-,-1,-1
MULIFE.txt,99031,100329,1298,10,N,N,-,-1,-1
MULIFE.txt,99432,100550,1118,10,N,N,-,-1,-1
MULIFE.txt,99463,100591,1128,10,N,N,-,-1,-1
MULIFE.txt,99499,100671,1172,10,N,N,-,-1,-1
MULIFE.txt,99637,100709,1072,10,N,N,-,-1,-1
MULIFE.txt,99777,100805,1028,10,N,N,-,-1,-1
MULIFE.txt,99958,100841,883,10,N,N,-,-1,-1
MULIFE.txt,99995,100855,860,10,N,N,-,-1,-1
MULIFE.txt,100060,101007,947,10,N,N,-,-1,-1
MULIFE.txt,100321,101014,693,10,N,N,-,-1,-1
MULIFE.txt,100330,101076,746,10,N,N,-,-1,-1
MULIFE.txt,100551,101104,553,10,N,N,-,-1,-1
MULIFE.txt,100594,101132,538,10,N,N,-,-1,-1
MULIFE.txt,100672,101160,488,10,N,N,-,-1,-1
MULIFE.txt,100710,101272,562,10,N,N,-,-1,-1
MULIFE.txt,100806,101316,510,10,N,N,-,-1,-1
MULIFE.txt,100842,101447,605,10,N,N,-,-1,-1
MULIFE.txt,100856,101586,730,10,N,N,-,-1,-1
MULIFE.txt,101010,101822,812,10,N,N,-,-1,-1
MULIFE.txt,101015,101844,829,10,N,N,-,-1,-1
MULIFE.txt,101077,101900,823,10,N,N,-,-1,-1
MULIFE.txt,101105,101958,853,10,N,N,-,-1,-1
MULIFE.txt,101133,102058,925,10,N,N,-,-1,-1
MULIFE.txt,101161,102101,940,10,N,N,-,-1,-1
MULIFE.txt,101273,102116,843,10,N,N,-,-1,-1
MULIFE.txt,101319,102127,808,10,N,N,-,-1,-1
MULIFE.txt,101448,102163,715,10,N,N,-,-1,-1
MULIFE.txt,101589,102187,598,10,N,N,-,-1,-1
MULIFE.txt,101824,102261,437,10,N,N,-,-1,-1
MULIFE.txt,101847,102285,438,10,N,N,-,-1,-1
MULIFE.txt,101901,102377,476,10,N,N,-,-1,-1
MULIFE.txt,101961,102536,575,10,N,N,-,-1,-1
MULIFE.txt,102059,102752,693,10,N,N,-,-1,-1
MULIFE.txt,102102,102789,687,10,N,N,-,-1,-1
MULIFE.txt,102117,102867,750,10,N,N,-,-1,-1
MULIFE.txt,102128,102963,835,10,N,N,-,-1,-1
MULIFE.txt,102164,103004,840,10,N,N,-,-1,-1
MULIFE.txt,102189,103165,976,10,N,N,-,-1,-1
MULIFE.txt,102262,103279,1017,10,N,N,-,-1,-1
MULIFE.txt,102286,103320,1034,10,N,N,-,-1,-1
MULIFE.txt,102378,103338,960,10,N,N,-,-1,-1
MULIFE.txt,102537,103403,866,10,N,N,-,-1,-1
MULIFE.txt,102753,103571,818,10,N,N,-,-1,-1
MULIFE.txt,102790,103752,962,10,N,N,-,-1,-1
MULIFE.txt,102870,104037,1167,10,N,N,-,-1,-1
MULIFE.txt,102966,104107,1141,10,N,N,-,-1,-1
MULIFE.txt,103005,104153,1148,10,N,N,-,-1,-1
MULIFE.txt,103168,104182,1014,10,N,N,-,-1,-1
MULIFE.txt,103280,104247,967,10,N,N,-,-1,-1
MULIFE.txt,103321,104262,941,10,N,N,-,-1,-1
MULIFE.txt,103341,104287,946,10,N,N,-,-1,-1
MULIFE.txt,103404,104414,1010,10,N,N,-,-1,-1
MULIFE.txt,103574,104462,888,10,N,N,-,-1,-1
MULIFE.txt,103753,104537,784,10,N,N,-,-1,-1
MULIFE.txt,104040,104634,594,10,N,N,-,-1,-1
MULIFE.txt,104108,104840,732,10,N,N,-,-1,-1
MULIFE.txt,104155,104942,787,10,N,N,-,-1,-1
MULIFE.txt,104183,104954,771,10,N,N,-,-1,-1
MULIFE.txt,104248,104976,728,10,N,N,-,-1,-1
MULIFE.txt,104263,105022,759,10,N,N,-,-1,-1
MULIFE.txt,104288,105054,766,10,N,N,-,-1,-1
MULIFE.txt,104415,105094,679,10,N,N,-,-1,-1
MULIFE.txt,104463,105183,720,10,N,N,-,-1,-1
MULIFE.txt,104538,105290,752,10,N,N,-,-1,-1
MULIFE.txt,104635,105327,692,10,N,N,-,-1,-1
MULIFE.txt,104843,105398,555,10,N,N,-,-1,-1
MULIFE.txt,104943,105513,570,10,N,N,-,-1,-1
MULIFE.txt,104955,105550,595,10,N,N,-,-1,-1
MULIFE.txt,104979,105596,617,10,N,N,-,-1,-1
MULIFE.txt,105023,105631,608,10,N,N,-,-1,-1
MULIFE.txt,105055,105728,673,10,N,N,-,-1,-1
MULIFE.txt,105096,105768,672,10,N,N,-,-1,-1
MULIFE.txt,105184,105828,644,10,N,N,-,-1,-1
MULIFE.txt,105293,105856,563,10,N,N,-,-1,-1
MULIFE.txt,105328,105999,671,10,N,N,-,-1,-1
MULIFE.txt,105401,106108,707,10,N,N,-,-1,-1
MULIFE.txt,105516,106195,679,10,N,N,-,-1,-1
MULIFE.txt,105551,106356,805,10,N,N,-,-1,-1
MULIFE.txt,105597,106370,773,10,N,N,-,-1,-1
MULIFE.txt,105634,106435,801,10,N,N,-,-1,-1
MULIFE.txt,105731,106524,793,10,N,N,-,-1,-1
MULIFE.txt,105769,106847,1078,10,N,N,-,-1,-1
MULIFE.txt,105829,106912,1083,10,N,N,-,-1,-1
MULIFE.txt,105857,106998,1141,10,N,N,-,-1,-1
MULIFE.txt,106000,107015,1015,10,N,N,-,-1,-1
MULIFE.txt,106109,107055,946,10,N,N,-,-1,-1
MULIFE.txt,106198,107169,971,10,N,N,-,-1,-1
MULIFE.txt,106357,107188,831,10,N,N,-,-1,-1
MULIFE.txt,106371,107198,827,10,N,N,-,-1,-1
MULIFE.txt,106436,107411,975,10,N,N,-,-1,-1
MULIFE.txt,106525,107597,1072,10,N,N,-,-1,-1
MULIFE.txt,106850,107699,849,10,N,N,-,-1,-1
MULIFE.txt,106913,107719,806,10,N,N,-,-1,-1
MULIFE.txt,106999,107941,942,10,N,N,-,-1,-1
MULIFE.txt,107017,108010,993,10,N,N,-,-1,-1
MULIFE.txt,107056,108191,1135,10,N,N,-,-1,-1
MULIFE.txt,107170,108246,1076,10,N,N,-,-1,-1
MULIFE.txt,107189,108277,1088,10,N,N,-,-1,-1
MULIFE.txt,107199,108314,1115,10,N,N,-,-1,-1
MULIFE.txt,107414,108458,1044,10,N,N,-,-1,-1
MULIFE.txt,107600,108645,1045,10,N,N,-,-1,-1
MULIFE.txt,107700,108684,984,10,N,N,-,-1,-1
MULIFE.txt,107720,108773,1053,10,N,N,-,-1,-1
MULIFE.txt,107942,108820,878,10,N,N,-,-1,-1
MULIFE.txt,108013,108853,840,10,N,N,-,-1,-1
MULIFE.txt,108194,109018,824,10,N,N,-,-1,-1
MULIFE.txt,108249,109132,883,10,N,N,-,-1,-1
MULIFE.txt,108278,109376,1098,10,N,N,-,-1,-1
MULIFE.txt,108315,109418,1103,10,N,N,-,-1,-1
MULIFE.txt,108459,109556,1097,10,N,N,-,-1,-1
MULIFE.txt,108650,109757,1107,10,N,N,-,-1,-1
MULIFE.txt,108687,109863,1176,10,N,N,-,-1,-1
MULIFE.txt,108774,109914,1140,10,N,N,-,-1,-1
MULIFE.txt,108821,110102,1281,10,N,N,-,-1,-1
MULIFE.txt,108855,110150,1295,10,N,N,-,-1,-1
MULIFE.txt,109020,110241,1221,10,N,N,-,-1,-1
MULIFE.txt,109134,110270,1136,10,N,N,-,-1,-1
MULIFE.txt,109377,110316,939,10,N,N,-,-1,-1
MULIFE.txt,109419,110484,1065,10,N,N,-,-1,-1
MULIFE.txt,109559,110594,1035,10,N,N,-,-1,-1
MULIFE.txt,109758,110714,956,10,N,N,-,-1,-1
MULIFE.txt,109866,110964,1098,10,N,N,-,-1,-1
MULIFE.txt,109916,111210,1294,10,N,N,-,-1,-1
MULIFE.txt,110103,111318,1215,10,N,N,-,-1,-1
MULIFE.txt,110151,111466,1315,10,N,N,-,-1,-1
MULIFE.txt,110242,111659,1417,10,N,N,-,-1,-1
MULIFE.txt,110273,111665,1392,10,N,N,-,-1,-1
MULIFE.txt,110317,111672,1355,10,N,N,-,-1,-1
MULIFE.txt,110485,111809,1324,10,N,N,-,-1,-1
MULIFE.txt,110595,111933,1338,10,N,N,-,-1,-1
MULIFE.txt,110717,111975,1258,10,N,N,-,-1,-1
MULIFE.txt,110965,112042,1077,10,N,N,-,-1,-1
MULIFE.txt,111213,112099,886,10,N,N,-,-1,-1
MULIFE.txt,111319,112122,803,10,N,N,-,-1,-1
MULIFE.txt,111467,112189,722,10,N,N,-,-1,-1
MULIFE.txt,111662,112262,600,10,N,N,-,-1,-1
MULIFE.txt,111666,112301,635,10,N,N,-,-1,-1
MULIFE.txt,111673,112327,654,10,N,N,-,-1,-1
MULIFE.txt,111810,112452,642,10,N,N,-,-1,-1
MULIFE.txt,111934,112459,525,10,N,N,-,-1,-1
MULIFE.txt,111976,112515,539,10,N,N,-,-1,-1
MULIFE.txt,112043,112594,551,10,N,N,-,-1,-1
MULIFE.txt,112100,112711,611,10,N,N,-,-1,-1
MULIFE.txt,112123,112776,653,10,N,N,-,-1,-1
MULIFE.txt,112192,112825,633,10,N,N,-,-1,-1
MULIFE.txt,112263,112864,601,10,N,N,-,-1,-1
MULIFE.txt,112303,112940,637,10,N,N,-,-1,-1
MULIFE.txt,112328,113050,722,10,N,N,-,-1,-1
MULIFE.txt,112453,113175,722,10,N,N,-,-1,-1
MULIFE.txt,112460,113255,795,10,N,N,-,-1,-1
MULIFE.txt,112516,113286,770,10,N,N,-,-1,-1
MULIFE.txt,112595,113438,843,10,N,N,-,-1,-1
MULIFE.txt,112712,113560,848,10,N,N,-,-1,-1
MULIFE.txt,112777,113568,791,10,N,N,-,-1,-1
MULIFE.txt,112826,113688,862,10,N,N,-,-1,-1
MULIFE.txt,112866,113847,981,10,N,N,-,-1,-1
MULIFE.txt,112941,113902,961,10,N,N,-,-1,-1
MULIFE.txt,113051,113959,908,10,N,N,-,-1,-1
MULIFE.txt,113176,114017,841,10,N,N,-,-1,-1
MULIFE.txt,113256,114129,873,10,N,N,-,-1,-1
MULIFE.txt,113287,114226,939,10,N,N,-,-1,-1
MULIFE.txt,113441,114461,1020,10,N,Y,1448278425221,65586,65914
MULIFE.txt,113561,114674,1113,10,N,Y,1448278425221,65586,65914
MULIFE.txt,113569,114800,1231,10,N,Y,1448278425221,65586,65914
MULIFE.txt,113689,114894,1205,10,N,Y,1448278425221,65586,65914
MULIFE.txt,113849,115033,1184,10,N,Y,1448278425221,65586,65914
MULIFE.txt,113904,115323,1419,10,N,Y,1448278425221,65586,65914
MULIFE.txt,113961,115342,1381,10,N,Y,1448278425221,65586,65914
MULIFE.txt,114019,115390,1371,10,N,Y,1448278425221,65586,65914
MULIFE.txt,114130,115440,1310,10,N,Y,1448278425221,65586,65914
MULIFE.txt,114229,115484,1255,10,N,Y,1448278425221,65586,65914
MULIFE.txt,114462,115587,1125,10,N,Y,1448278425221,65586,65914
MULIFE.txt,114675,115935,1260,10,Y,Y,1448278425221,65586,65914
MULIFE.txt,114803,116047,1244,10,Y,Y,1448038356234,18463,18881
MULIFE.txt,114895,116159,1264,10,Y,Y,1448038356234,18463,18881
MULIFE.txt,115035,116213,1178,10,N,Y,1448038356234,18463,18881
MULIFE.txt,115325,116431,1106,10,N,Y,1448038356234,18463,18881
MULIFE.txt,115345,116563,1218,10,N,Y,1448038356234,18463,18881
MULIFE.txt,115391,116718,1327,10,N,Y,1448038356234,18463,18881
MULIFE.txt,115441,116838,1397,10,N,Y,1448038356234,18463,18881
MULIFE.txt,115485,116866,1381,10,N,Y,1448038356234,18463,18881
MULIFE.txt,115588,116963,1375,10,N,Y,1448038356234,18463,18881
MULIFE.txt,115936,117001,1065,10,N,Y,1448038356234,18463,18881
MULIFE.txt,116048,117030,982,10,N,Y,1448038356234,18463,18881
MULIFE.txt,116160,117084,924,10,N,Y,1448038356234,18463,18881
MULIFE.txt,116214,117160,946,10,N,Y,1448038356234,18463,18881
MULIFE.txt,116434,117260,826,10,N,N,-,-1,-1
MULIFE.txt,116564,117431,867,10,N,N,-,-1,-1
MULIFE.txt,116719,117562,843,10,N,N,-,-1,-1
MULIFE.txt,116840,117607,767,10,N,N,-,-1,-1
MULIFE.txt,116867,117690,823,10,N,Y,1448285913012,108803,110925
MULIFE.txt,116964,117805,841,10,N,Y,1448285913012,108803,110925
MULIFE.txt,117002,117923,921,10,N,Y,1448285913012,108803,110925
MULIFE.txt,117031,118292,1261,10,N,Y,1448285913012,108803,110925
MULIFE.txt,117087,118342,1255,10,N,Y,1448285913012,108803,110925
MULIFE.txt,117161,118659,1498,10,N,Y,1448285913012,108803,110925
MULIFE.txt,117263,118900,1637,10,N,Y,1448285913012,108803,110925
MULIFE.txt,117433,119076,1643,10,Y,Y,1448285913012,108803,110925
MULIFE.txt,117565,119109,1544,10,Y,Y,1448285913012,108803,110925
MULIFE.txt,117610,119143,1533,10,Y,Y,1448285913012,108803,110925
MULIFE.txt,117691,119217,1526,10,Y,Y,1448285913012,108803,110925
MULIFE.txt,117806,119223,1417,10,Y,Y,1448285913012,108803,110925
MULIFE.txt,117924,119273,1349,10,N,Y,1448285913012,108803,110925
MULIFE.txt,118295,119367,1072,10,N,N,-,-1,-1
MULIFE.txt,118343,119450,1107,10,N,N,-,-1,-1
MULIFE.txt,118660,119489,829,10,Y,N,-,-1,-1
MULIFE.txt,118903,119643,740,10,Y,N,-,-1,-1
MULIFE.txt,119077,119787,710,10,N,N,-,-1,-1
MULIFE.txt,119110,119951,841,10,Y,N,-,-1,-1
MULIFE.txt,119144,119956,812,10,Y,N,-,-1,-1
MULIFE.txt,119218,120023,805,10,Y,N,-,-1,-1
MULIFE.txt,119224,120119,895,10,Y,N,-,-1,-1
MULIFE.txt,119274,120270,996,10,Y,N,-,-1,-1
MULIFE.txt,119369,120324,955,10,Y,N,-,-1,-1
MULIFE.txt,119451,120376,925,10,N,N,-,-1,-1
MULIFE.txt,119490,120397,907,10,N,N,-,-1,-1
MULIFE.txt,119644,120410,766,10,N,N,-,-1,-1
MULIFE.txt,119790,120453,663,10,N,N,-,-1,-1
MULIFE.txt,119953,120641,688,10,N,N,-,-1,-1
MULIFE.txt,119958,120714,756,10,N,N,-,-1,-1
MULIFE.txt,120026,120774,748,10,N,N,-,-1,-1
MULIFE.txt,120120,120834,714,10,N,N,-,-1,-1
MULIFE.txt,120271,121082,811,10,N,N,-,-1,-1
MULIFE.txt,120325,121197,872,10,N,N,-,-1,-1
MULIFE.txt,120377,121310,933,10,N,N,-,-1,-1
MULIFE.txt,120398,121460,1062,10,N,N,-,-1,-1
MULIFE.txt,120415,121642,1227,10,N,N,-,-1,-1
MULIFE.txt,120454,121751,1297,10,N,N,-,-1,-1
MULIFE.txt,120642,121834,1192,10,N,N,-,-1,-1
MULIFE.txt,120716,121910,1194,10,N,N,-,-1,-1
MULIFE.txt,120776,122042,1266,10,N,N,-,-1,-1
MULIFE.txt,120836,122120,1284,10,N,N,-,-1,-1
MULIFE.txt,121083,122164,1081,10,N,N,-,-1,-1
MULIFE.txt,121200,122248,1048,10,N,N,-,-1,-1
MULIFE.txt,121313,122270,957,10,N,N,-,-1,-1
MULIFE.txt,121463,122418,955,10,N,N,-,-1,-1
MULIFE.txt,121645,122512,867,10,N,N,-,-1,-1
MULIFE.txt,121752,122526,774,10,N,N,-,-1,-1
MULIFE.txt,121835,122608,773,10,N,N,-,-1,-1
MULIFE.txt,121913,122730,817,10,N,N,-,-1,-1
MULIFE.txt,122043,122902,859,10,N,N,-,-1,-1
MULIFE.txt,122123,122949,826,10,N,N,-,-1,-1
MULIFE.txt,122165,122961,796,10,N,N,-,-1,-1
MULIFE.txt,122249,122988,739,10,N,N,-,-1,-1
MULIFE.txt,122271,123026,755,10,N,N,-,-1,-1
MULIFE.txt,122419,123120,701,10,N,N,-,-1,-1
MULIFE.txt,122514,123157,643,10,N,N,-,-1,-1
MULIFE.txt,122527,123231,704,10,N,N,-,-1,-1
MULIFE.txt,122609,123290,681,10,N,N,-,-1,-1
MULIFE.txt,122731,123305,574,10,N,N,-,-1,-1
MULIFE.txt,122904,123338,434,10,N,N,-,-1,-1
MULIFE.txt,122950,123355,405,10,N,N,-,-1,-1
MULIFE.txt,122963,123388,425,10,N,N,-,-1,-1
MULIFE.txt,122991,123429,438,10,N,N,-,-1,-1
MULIFE.txt,123029,123476,447,10,N,N,-,-1,-1
MULIFE.txt,123121,123500,379,10,N,N,-,-1,-1
MULIFE.txt,123158,123565,407,10,N,N,-,-1,-1
MULIFE.txt,123234,123605,371,10,N,N,-,-1,-1
MULIFE.txt,123293,123717,424,10,N,N,-,-1,-1
MULIFE.txt,123306,123919,613,10,N,N,-,-1,-1
MULIFE.txt,123339,123958,619,10,N,N,-,-1,-1
MULIFE.txt,123356,124073,717,10,N,N,-,-1,-1
MULIFE.txt,123389,124275,886,10,N,N,-,-1,-1
MULIFE.txt,123430,124434,1004,10,N,N,-,-1,-1
MULIFE.txt,123477,124558,1081,10,N,N,-,-1,-1
MULIFE.txt,123501,124693,1192,10,N,N,-,-1,-1
MULIFE.txt,123566,124761,1195,10,N,N,-,-1,-1
MULIFE.txt,123606,124803,1197,10,N,N,-,-1,-1
MULIFE.txt,123718,124968,1250,10,N,N,-,-1,-1
MULIFE.txt,123920,125305,1385,10,N,N,-,-1,-1
MULIFE.txt,123959,125398,1439,10,N,N,-,-1,-1
MULIFE.txt,124074,125763,1689,10,N,N,-,-1,-1
MULIFE.txt,124278,125880,1602,10,N,N,-,-1,-1
MULIFE.txt,124435,125992,1557,10,N,N,-,-1,-1
MULIFE.txt,124561,126013,1452,10,N,N,-,-1,-1
MULIFE.txt,124694,126111,1417,10,N,N,-,-1,-1
MULIFE.txt,124762,126196,1434,10,N,N,-,-1,-1
MULIFE.txt,124805,126225,1420,10,N,N,-,-1,-1
MULIFE.txt,124970,126354,1384,10,N,N,-,-1,-1
MULIFE.txt,125306,126521,1215,10,N,N,-,-1,-1
MULIFE.txt,125399,126635,1236,10,N,N,-,-1,-1
MULIFE.txt,125766,126718,952,10,N,N,-,-1,-1
MULIFE.txt,125883,126857,974,10,N,N,-,-1,-1
MULIFE.txt,125995,126957,962,10,N,N,-,-1,-1
MULIFE.txt,126014,127056,1042,10,N,N,-,-1,-1
MULIFE.txt,126112,127286,1174,10,N,N,-,-1,-1
MULIFE.txt,126199,127463,1264,10,N,Y,1437028092146,121457,123204
MULIFE.txt,126226,127631,1405,10,N,Y,1437028092146,121457,123204
MULIFE.txt,126355,127710,1355,10,N,Y,1437028092146,121457,123204
MULIFE.txt,126522,127807,1285,10,N,Y,1437028092146,121457,123204
MULIFE.txt,126636,127883,1247,10,N,Y,1437028092146,121457,123204
MULIFE.txt,126719,128065,1346,10,N,Y,1437028092146,121457,123204
MULIFE.txt,126858,128383,1525,10,N,Y,1437028092146,121457,123204
MULIFE.txt,126958,128489,1531,10,N,Y,1437028092146,121457,123204
MULIFE.txt,127057,128558,1501,10,N,Y,1437028092146,121457,123204
MULIFE.txt,127289,128768,1479,10,N,Y,1437028092146,121457,123204
MULIFE.txt,127465,128943,1478,10,Y,Y,1437028092146,121457,123204
MULIFE.txt,127633,128965,1332,10,Y,Y,1437028092146,121457,123204
MULIFE.txt,127711,129207,1496,10,Y,Y,1437028092146,121457,123204
MULIFE.txt,127810,129295,1485,10,Y,Y,1437028092146,121457,123204
MULIFE.txt,127884,129396,1512,10,Y,Y,1437028092146,121457,123204
MULIFE.txt,128066,129420,1354,10,Y,Y,1437028092146,121457,123204
MULIFE.txt,128384,129552,1168,10,Y,Y,1437028092146,121457,123204
MULIFE.txt,128490,129640,1150,10,Y,Y,1437028092146,121457,123204
MULIFE.txt,128559,129773,1214,10,Y,Y,1437028092146,121457,123204
MULIFE.txt,128771,129913,1142,10,N,Y,1437477878183,427206,428439
MULIFE.txt,128945,130222,1277,10,Y,Y,1437477878183,427206,428439
MULIFE.txt,128966,130248,1282,10,Y,Y,1437477878183,427206,428439
MULIFE.txt,129210,130277,1067,10,N,Y,1437477878183,427206,428439
MULIFE.txt,129296,130375,1079,10,N,Y,1437477878183,427206,428439
MULIFE.txt,129397,130697,1300,10,N,Y,1437477878183,427206,428439
MULIFE.txt,129421,130713,1292,10,N,Y,1437477878183,427206,428439
MULIFE.txt,129554,130726,1172,10,Y,Y,1437477878183,427206,428439
MULIFE.txt,129641,130739,1098,10,Y,Y,1437477878183,427206,428439
MULIFE.txt,129774,130779,1005,10,N,N,-,-1,-1
MULIFE.txt,129915,130805,890,10,N,N,-,-1,-1
MULIFE.txt,130224,130868,644,10,N,N,-,-1,-1
MULIFE.txt,130249,130906,657,10,N,N,-,-1,-1
MULIFE.txt,130279,130927,648,10,N,N,-,-1,-1
MULIFE.txt,130376,131004,628,10,N,N,-,-1,-1
MULIFE.txt,130702,131016,314,10,N,N,-,-1,-1
MULIFE.txt,130716,131020,304,10,N,N,-,-1,-1
MULIFE.txt,130729,131026,297,10,N,N,-,-1,-1
MULIFE.txt,130742,131047,305,10,N,N,-,-1,-1
MULIFE.txt,130780,131142,362,10,N,N,-,-1,-1
MULIFE.txt,130806,131279,473,10,N,N,-,-1,-1
MULIFE.txt,130869,131410,541,10,N,N,-,-1,-1
MULIFE.txt,130907,131418,511,10,N,N,-,-1,-1
MULIFE.txt,130928,131617,689,10,N,N,-,-1,-1
MULIFE.txt,131007,131673,666,10,N,N,-,-1,-1
MULIFE.txt,131017,131732,715,10,N,N,-,-1,-1
MULIFE.txt,131020,131848,828,10,N,N,-,-1,-1
MULIFE.txt,131029,131962,933,10,N,N,-,-1,-1
MULIFE.txt,131050,131986,936,10,N,N,-,-1,-1
MULIFE.txt,131143,132199,1056,10,N,N,-,-1,-1
MULIFE.txt,131281,132305,1024,10,N,N,-,-1,-1
MULIFE.txt,131410,132416,1006,10,N,N,-,-1,-1
MULIFE.txt,131419,132460,1041,10,N,N,-,-1,-1
MULIFE.txt,131620,132537,917,10,N,N,-,-1,-1
MULIFE.txt,131675,132611,936,10,N,N,-,-1,-1
MULIFE.txt,131734,132660,926,10,N,N,-,-1,-1
MULIFE.txt,131849,132691,842,10,N,N,-,-1,-1
MULIFE.txt,131963,132786,823,10,N,N,-,-1,-1
MULIFE.txt,131989,133216,1227,10,N,N,-,-1,-1
MULIFE.txt,132200,133238,1038,10,N,N,-,-1,-1
MULIFE.txt,132306,133259,953,10,N,N,-,-1,-1
MULIFE.txt,132417,133289,872,10,N,N,-,-1,-1
MULIFE.txt,132461,133326,865,10,N,N,-,-1,-1
MULIFE.txt,132538,133354,816,10,N,N,-,-1,-1
MULIFE.txt,132612,133397,785,10,N,N,-,-1,-1
MULIFE.txt,132661,133476,815,10,N,N,-,-1,-1
MULIFE.txt,132692,133565,873,10,N,N,-,-1,-1
MULIFE.txt,132787,133574,787,10,N,N,-,-1,-1
MULIFE.txt,133219,133754,535,10,N,N,-,-1,-1
MULIFE.txt,133239,133937,698,10,N,N,-,-1,-1
MULIFE.txt,133260,133958,698,10,N,N,-,-1,-1
MULIFE.txt,133290,134073,783,10,N,N,-,-1,-1
MULIFE.txt,133327,134145,818,10,N,N,-,-1,-1
MULIFE.txt,133355,134279,924,10,N,N,-,-1,-1
MULIFE.txt,133398,134343,945,10,N,N,-,-1,-1
MULIFE.txt,133477,134491,1014,10,N,N,-,-1,-1
MULIFE.txt,133566,134534,968,10,N,N,-,-1,-1
MULIFE.txt,133575,134606,1031,10,N,N,-,-1,-1
MULIFE.txt,133755,134809,1054,10,N,N,-,-1,-1
MULIFE.txt,133938,134974,1036,10,N,N,-,-1,-1
MULIFE.txt,133959,135036,1077,10,N,N,-,-1,-1
MULIFE.txt,134074,135202,1128,10,N,N,-,-1,-1
MULIFE.txt,134146,135273,1127,10,N,N,-,-1,-1
MULIFE.txt,134280,135385,1105,10,N,N,-,-1,-1
MULIFE.txt,134344,135610,1266,10,N,N,-,-1,-1
MULIFE.txt,134492,136084,1592,10,N,N,-,-1,-1
MULIFE.txt,134537,136302,1765,10,N,N,-,-1,-1
MULIFE.txt,134607,136359,1752,10,N,N,-,-1,-1
MULIFE.txt,134810,136497,1687,10,N,N,-,-1,-1
MULIFE.txt,134975,136544,1569,10,N,N,-,-1,-1
MULIFE.txt,135037,136595,1558,10,N,N,-,-1,-1
MULIFE.txt,135203,136728,1525,10,N,N,-,-1,-1
MULIFE.txt,135274,136765,1491,10,N,N,-,-1,-1
MULIFE.txt,135388,136869,1481,10,N,N,-,-1,-1
MULIFE.txt,135614,137002,1388,10,N,N,-,-1,-1
MULIFE.txt,136085,137126,1041,10,N,Y,1448275407308,26987,29181
MULIFE.txt,136305,137166,861,10,N,Y,1448275407308,26987,29181
MULIFE.txt,136361,137208,847,10,N,Y,1448275407308,26987,29181
MULIFE.txt,136498,137228,730,10,N,Y,1448275407308,26987,29181
MULIFE.txt,136545,137233,688,10,N,Y,1448275407308,26987,29181
MULIFE.txt,136596,137243,647,10,N,Y,1448275407308,26987,29181
MULIFE.txt,136729,137248,519,10,N,Y,1448275407308,26987,29181
MULIFE.txt,136766,137699,933,10,N,Y,1448275407308,26987,29181
MULIFE.txt,136870,137873,1003,10,N,Y,1448275407308,26987,29181
MULIFE.txt,137005,137953,948,10,N,Y,1448275407308,26987,29181
MULIFE.txt,137127,138030,903,10,N,Y,1448275407308,26987,29181
MULIFE.txt,137169,138199,1030,10,N,Y,1448275407308,26987,29181
MULIFE.txt,137209,138343,1134,10,N,Y,1448275407308,26987,29181
MULIFE.txt,137229,138416,1187,10,N,Y,1448275407308,26987,29181
MULIFE.txt,137234,138530,1296,10,N,Y,1448275407308,26987,29181
MULIFE.txt,137244,138884,1640,10,N,Y,1448275407308,26987,29181
MULIFE.txt,137251,139102,1851,10,N,Y,1448275407308,26987,29181
MULIFE.txt,137702,139505,1803,10,N,Y,1448275407308,26987,29181
MULIFE.txt,137875,139527,1652,10,N,Y,1448275407308,26987,29181
MULIFE.txt,137956,139660,1704,10,N,Y,1448275407308,26987,29181
MULIFE.txt,138033,139875,1842,10,N,Y,1448275407308,26987,29181
MULIFE.txt,138200,139991,1791,10,Y,Y,1448275407308,26987,29181
MULIFE.txt,138344,140120,1776,10,Y,Y,1448275407308,26987,29181
MULIFE.txt,138417,140156,1739,10,Y,Y,1448275407308,26987,29181
MULIFE.txt,138531,140339,1808,10,Y,Y,1448275407308,26987,29181
MULIFE.txt,138885,140441,1556,10,Y,Y,1448275407308,26987,29181
MULIFE.txt,139103,140529,1426,10,Y,Y,1448275407308,26987,29181
MULIFE.txt,139506,140661,1155,10,N,Y,1448275407308,26987,29181
MULIFE.txt,139528,140713,1185,10,N,Y,1448275407308,26987,29181
MULIFE.txt,139661,140807,1146,10,N,Y,1448275407308,26987,29181
MULIFE.txt,139876,140953,1077,10,N,Y,1448275407308,26987,29181
MULIFE.txt,139992,141255,1263,10,N,Y,1448275407308,26987,29181
MULIFE.txt,140121,141354,1233,10,N,Y,1448310549245,137491,141408
MULIFE.txt,140159,141491,1332,10,N,Y,1448310549245,137491,141408
MULIFE.txt,140340,141830,1490,10,N,Y,1448310549245,137491,141408
MULIFE.txt,140442,141942,1500,10,N,Y,1448310549245,137491,141408
MULIFE.txt,140531,141999,1468,10,N,Y,1448310549245,137491,141408
MULIFE.txt,140662,142071,1409,10,N,Y,1448038101349,15101,17486
MULIFE.txt,140714,142107,1393,10,N,Y,1448038101349,15101,17486
MULIFE.txt,140808,142132,1324,10,N,Y,1448038101349,15101,17486
MULIFE.txt,140956,142141,1185,10,N,Y,1448038101349,15101,17486
MULIFE.txt,141256,142194,938,10,N,Y,1448038101349,15101,17486
MULIFE.txt,141356,142293,937,10,N,Y,1448038101349,15101,17486
MULIFE.txt,141492,142399,907,10,N,Y,1448038101349,15101,17486
MULIFE.txt,141833,142499,666,10,N,Y,1448038101349,15101,17486
MULIFE.txt,141943,142589,646,10,N,Y,1448038101349,15101,17486
MULIFE.txt,142002,142611,609,10,N,Y,1448038101349,15101,17486
MULIFE.txt,142072,142828,756,10,N,Y,1448038101349,15101,17486
MULIFE.txt,142108,142976,868,10,N,Y,1448038101349,15101,17486
MULIFE.txt,142133,143092,959,10,Y,Y,1448038101349,15101,17486
MULIFE.txt,142142,143118,976,10,Y,Y,1448038101349,15101,17486
MULIFE.txt,142195,143155,960,10,Y,Y,1448038101349,15101,17486
MULIFE.txt,142294,143308,1014,10,Y,Y,1448038101349,15101,17486
MULIFE.txt,142400,143384,984,10,N,Y,1448038101349,15101,17486
MULIFE.txt,142502,143451,949,10,N,Y,1448038101349,15101,17486
MULIFE.txt,142590,143481,891,10,N,Y,1448038101349,15101,17486
MULIFE.txt,142613,143520,907,10,N,Y,1448038101349,15101,17486
MULIFE.txt,142829,143552,723,10,N,Y,1448038101349,15101,17486
MULIFE.txt,142977,143576,599,10,N,Y,1448038101349,15101,17486
MULIFE.txt,143093,143724,631,10,N,Y,1448038101349,15101,17486
MULIFE.txt,143119,143746,627,10,N,Y,1448038101349,15101,17486
MULIFE.txt,143156,143863,707,10,N,Y,1448038101349,15101,17486
MULIFE.txt,143309,143922,613,10,N,Y,1448038101349,15101,17486
MULIFE.txt,143385,144016,631,10,N,Y,1448038101349,15101,17486
MULIFE.txt,143452,144470,1018,10,N,Y,1448038101349,15101,17486
MULIFE.txt,143483,144571,1088,10,N,Y,1448038101349,15101,17486
MULIFE.txt,143521,144992,1471,10,N,Y,1448038101349,15101,17486
MULIFE.txt,143553,145119,1566,10,Y,Y,1448038101349,15101,17486
MULIFE.txt,143577,145161,1584,10,Y,Y,1448038101349,15101,17486
MULIFE.txt,143727,145348,1621,10,Y,Y,1448038101349,15101,17486
MULIFE.txt,143747,145405,1658,10,Y,Y,1448038101349,15101,17486
MULIFE.txt,143864,145448,1584,10,Y,Y,1448038101349,15101,17486
MULIFE.txt,143925,145765,1840,10,Y,Y,1448038101349,15101,17486
MULIFE.txt,144017,145807,1790,10,Y,Y,1448038101349,15101,17486
MULIFE.txt,144471,145987,1516,10,N,Y,1448038101349,15101,17486
MULIFE.txt,144572,146085,1513,10,N,Y,1448038101349,15101,17486
MULIFE.txt,144995,146152,1157,10,Y,N,-,-1,-1
MULIFE.txt,145120,146225,1105,10,Y,N,-,-1,-1
MULIFE.txt,145163,146414,1251,10,Y,N,-,-1,-1
MULIFE.txt,145349,146593,1244,10,Y,N,-,-1,-1
MULIFE.txt,145406,146702,1296,10,Y,N,-,-1,-1
MULIFE.txt,145449,146784,1335,10,Y,N,-,-1,-1
MULIFE.txt,145768,146811,1043,10,Y,N,-,-1,-1
MULIFE.txt,145810,147158,1348,10,Y,N,-,-1,-1
MULIFE.txt,145990,147209,1219,10,Y,N,-,-1,-1
MULIFE.txt,146086,147259,1173,10,Y,N,-,-1,-1
MULIFE.txt,146155,147426,1271,10,N,N,-,-1,-1
MULIFE.txt,146226,147584,1358,10,N,N,-,-1,-1
MULIFE.txt,146415,147701,1286,10,N,N,-,-1,-1
MULIFE.txt,146596,147820,1224,10,N,N,-,-1,-1
MULIFE.txt,146703,147832,1129,10,N,N,-,-1,-1
MULIFE.txt,146787,147959,1172,10,N,N,-,-1,-1
MULIFE.txt,146812,148025,1213,10,N,N,-,-1,-1
MULIFE.txt,147159,148127,968,10,N,N,-,-1,-1
MULIFE.txt,147210,148370,1160,10,N,N,-,-1,-1
MULIFE.txt,147260,148412,1152,10,N,N,-,-1,-1
MULIFE.txt,147427,148560,1133,10,N,N,-,-1,-1
MULIFE.txt,147587,148650,1063,10,N,N,-,-1,-1
MULIFE.txt,147702,148747,1045,10,N,N,-,-1,-1
MULIFE.txt,147821,148826,1005,10,N,N,-,-1,-1
MULIFE.txt,147833,149012,1179,10,N,N,-,-1,-1
MULIFE.txt,147960,149176,1216,10,N,N,-,-1,-1
MULIFE.txt,148026,149240,1214,10,N,N,-,-1,-1
MULIFE.txt,148128,149366,1238,10,N,N,-,-1,-1
MULIFE.txt,148371,149471,1100,10,N,N,-,-1,-1
MULIFE.txt,148413,149541,1128,10,N,N,-,-1,-1
MULIFE.txt,148561,149785,1224,10,N,N,-,-1,-1
MULIFE.txt,148651,149837,1186,10,N,N,-,-1,-1
MULIFE.txt,148750,149913,1163,10,N,N,-,-1,-1
MULIFE.txt,148827,149917,1090,10,N,N,-,-1,-1
MULIFE.txt,149014,150238,1224,10,N,N,-,-1,-1
MULIFE.txt,149177,150771,1594,10,N,N,-,-1,-1
MULIFE.txt,149241,150776,1535,10,N,N,-,-1,-1
MULIFE.txt,149368,150899,1531,10,N,N,-,-1,-1
MULIFE.txt,149472,150905,1433,10,N,N,-,-1,-1
MULIFE.txt,149543,151142,1599,10,N,N,-,-1,-1
MULIFE.txt,149788,151217,1429,10,N,N,-,-1,-1
MULIFE.txt,149838,151390,1552,10,N,N,-,-1,-1
MULIFE.txt,149914,151492,1578,10,N,N,-,-1,-1
MULIFE.txt,149918,151591,1673,10,N,N,-,-1,-1
MULIFE.txt,150240,151780,1540,10,N,N,-,-1,-1
MULIFE.txt,150773,151834,1061,10,N,N,-,-1,-1
MULIFE.txt,150777,152035,1258,10,N,N,-,-1,-1
MULIFE.txt,150900,152204,1304,10,N,N,-,-1,-1
MULIFE.txt,150906,152373,1467,10,N,N,-,-1,-1
MULIFE.txt,151145,152489,1344,10,N,N,-,-1,-1
MULIFE.txt,151218,152605,1387,10,N,N,-,-1,-1
MULIFE.txt,151391,152708,1317,10,N,N,-,-1,-1
MULIFE.txt,151493,152726,1233,10,N,N,-,-1,-1
MULIFE.txt,151592,152842,1250,10,N,N,-,-1,-1
MULIFE.txt,151781,152920,1139,10,N,N,-,-1,-1
MULIFE.txt,151835,152946,1111,10,N,N,-,-1,-1
MULIFE.txt,152038,153035,997,10,N,N,-,-1,-1
MULIFE.txt,152207,153070,863,10,N,N,-,-1,-1
MULIFE.txt,152375,153272,897,10,N,N,-,-1,-1
MULIFE.txt,152490,153387,897,10,N,N,-,-1,-1
MULIFE.txt,152606,153457,851,10,N,N,-,-1,-1
MULIFE.txt,152713,153476,763,10,N,N,-,-1,-1
MULIFE.txt,152729,153746,1017,10,N,N,-,-1,-1
MULIFE.txt,152843,153760,917,10,N,N,-,-1,-1
MULIFE.txt,152921,154003,1082,10,N,N,-,-1,-1
MULIFE.txt,152949,154034,1085,10,N,N,-,-1,-1
MULIFE.txt,153036,154055,1019,10,N,N,-,-1,-1
MULIFE.txt,153071,154206,1135,10,N,N,-,-1,-1
MULIFE.txt,153273,154240,967,10,N,N,-,-1,-1
MULIFE.txt,153388,154287,899,10,N,N,-,-1,-1
MULIFE.txt,153458,154571,1113,10,N,N,-,-1,-1
MULIFE.txt,153477,154650,1173,10,N,N,-,-1,-1
MULIFE.txt,153747,154804,1057,10,N,N,-,-1,-1
MULIFE.txt,153762,154858,1096,10,N,N,-,-1,-1
MULIFE.txt,154006,155028,1022,10,N,N,-,-1,-1
MULIFE.txt,154035,155059,1024,10,N,N,-,-1,-1
MULIFE.txt,154056,155109,1053,10,N,N,-,-1,-1
MULIFE.txt,154211,155127,916,10,N,N,-,-1,-1
MULIFE.txt,154241,155135,894,10,N,N,-,-1,-1
MULIFE.txt,154288,155155,867,10,N,N,-,-1,-1
MULIFE.txt,154572,155214,642,10,N,N,-,-1,-1
MULIFE.txt,154651,155237,586,10,N,N,-,-1,-1
MULIFE.txt,154807,155279,472,10,N,N,-,-1,-1
MULIFE.txt,154861,155348,487,10,N,N,-,-1,-1
MULIFE.txt,155029,155369,340,10,N,N,-,-1,-1
MULIFE.txt,155060,155402,342,10,N,N,-,-1,-1
MULIFE.txt,155110,155420,310,10,N,N,-,-1,-1
MULIFE.txt,155128,155466,338,10,N,N,-,-1,-1
MULIFE.txt,155136,155490,354,10,N,N,-,-1,-1
MULIFE.txt,155156,155638,482,10,N,N,-,-1,-1
MULIFE.txt,155215,155690,475,10,N,N,-,-1,-1
MULIFE.txt,155238,155757,519,10,N,N,-,-1,-1
MULIFE.txt,155280,155767,487,10,N,N,-,-1,-1
MULIFE.txt,155349,155992,643,10,N,N,-,-1,-1
MULIFE.txt,155371,156045,674,10,N,N,-,-1,-1
MULIFE.txt,155405,156194,789,10,N,N,-,-1,-1
MULIFE.txt,155421,156361,940,10,N,N,-,-1,-1
MULIFE.txt,155467,156431,964,10,N,N,-,-1,-1
MULIFE.txt,155491,156482,991,10,N,N,-,-1,-1
MULIFE.txt,155639,156515,876,10,N,N,-,-1,-1
MULIFE.txt,155691,156520,829,10,N,N,-,-1,-1
MULIFE.txt,155760,156582,822,10,N,N,-,-1,-1
MULIFE.txt,155768,156591,823,10,N,N,-,-1,-1
MULIFE.txt,155995,156705,710,10,N,N,-,-1,-1
MULIFE.txt,156046,156860,814,10,N,N,-,-1,-1
MULIFE.txt,156197,156933,736,10,N,N,-,-1,-1
MULIFE.txt,156363,156985,622,10,N,N,-,-1,-1
MULIFE.txt,156432,157014,582,10,N,N,-,-1,-1
MULIFE.txt,156483,157082,599,10,N,N,-,-1,-1
MULIFE.txt,156516,157123,607,10,N,N,-,-1,-1
MULIFE.txt,156521,157361,840,10,N,N,-,-1,-1
MULIFE.txt,156583,157502,919,10,Y,N,-,-1,-1
MULIFE.txt,156592,157595,1003,10,Y,N,-,-1,-1
MULIFE.txt,156706,157603,897,10,Y,N,-,-1,-1
MULIFE.txt,156861,157773,912,10,N,N,-,-1,-1
MULIFE.txt,156934,158177,1243,10,N,N,-,-1,-1
MULIFE.txt,156986,158196,1210,10,N,N,-,-1,-1
MULIFE.txt,157015,158385,1370,10,N,N,-,-1,-1
MULIFE.txt,157083,158584,1501,10,N,N,-,-1,-1
MULIFE.txt,157124,158647,1523,10,N,N,-,-1,-1
MULIFE.txt,157364,158695,1331,10,N,N,-,-1,-1
MULIFE.txt,157503,158737,1234,10,N,N,-,-1,-1
MULIFE.txt,157598,158888,1290,10,N,N,-,-1,-1
MULIFE.txt,157604,158928,1324,10,N,N,-,-1,-1
MULIFE.txt,157774,158950,1176,10,N,N,-,-1,-1
MULIFE.txt,158178,159042,864,10,N,N,-,-1,-1
MULIFE.txt,158197,159486,1289,10,N,N,-,-1,-1
MULIFE.txt,158387,159601,1214,10,N,N,-,-1,-1
MULIFE.txt,158587,159826,1239,10,Y,N,-,-1,-1
MULIFE.txt,158649,159896,1247,10,Y,N,-,-1,-1
MULIFE.txt,158696,159919,1223,10,Y,N,-,-1,-1
MULIFE.txt,158738,160071,1333,10,Y,N,-,-1,-1
MULIFE.txt,158889,160148,1259,10,N,N,-,-1,-1
MULIFE.txt,158929,160348,1419,10,N,N,-,-1,-1
MULIFE.txt,158951,160372,1421,10,N,N,-,-1,-1
MULIFE.txt,159045,160437,1392,10,N,N,-,-1,-1
MULIFE.txt,159487,160644,1157,10,N,N,-,-1,-1
MULIFE.txt,159604,160956,1352,10,N,N,-,-1,-1
MULIFE.txt,159829,161084,1255,10,N,N,-,-1,-1
MULIFE.txt,159897,161114,1217,10,N,N,-,-1,-1
MULIFE.txt,159920,161278,1358,10,N,N,-,-1,-1
MULIFE.txt,160072,161335,1263,10,N,N,-,-1,-1
MULIFE.txt,160149,161524,1375,10,N,N,-,-1,-1
MULIFE.txt,160349,161602,1253,10,N,N,-,-1,-1
MULIFE.txt,160373,161827,1454,10,N,N,-,-1,-1
MULIFE.txt,160440,161868,1428,10,N,N,-,-1,-1
MULIFE.txt,160645,161995,1350,10,N,N,-,-1,-1
MULIFE.txt,160957,162212,1255,10,N,N,-,-1,-1
MULIFE.txt,161085,162309,1224,10,N,N,-,-1,-1
MULIFE.txt,161116,162457,1341,10,N,N,-,-1,-1
MULIFE.txt,161280,162519,1239,10,N,N,-,-1,-1
MULIFE.txt,161337,162573,1236,10,N,N,-,-1,-1
MULIFE.txt,161527,162616,1089,10,N,N,-,-1,-1
MULIFE.txt,161603,162804,1201,10,N,N,-,-1,-1
MULIFE.txt,161828,162847,1019,10,N,N,-,-1,-1
MULIFE.txt,161870,162874,1004,10,N,N,-,-1,-1
MULIFE.txt,161996,162938,942,10,N,N,-,-1,-1
MULIFE.txt,162213,163058,845,10,N,N,-,-1,-1
MULIFE.txt,162310,163151,841,10,N,N,-,-1,-1
MULIFE.txt,162460,163232,772,10,N,N,-,-1,-1
MULIFE.txt,162520,163283,763,10,N,N,-,-1,-1
MULIFE.txt,162574,163309,735,10,N,N,-,-1,-1
MULIFE.txt,162619,163321,702,10,N,N,-,-1,-1
MULIFE.txt,162807,163399,592,10,N,N,-,-1,-1
MULIFE.txt,162848,163417,569,10,N,N,-,-1,-1
MULIFE.txt,162875,163605,730,10,N,N,-,-1,-1
MULIFE.txt,162939,163692,753,10,N,N,-,-1,-1
MULIFE.txt,163061,163756,695,10,N,N,-,-1,-1
MULIFE.txt,163152,163922,770,10,N,N,-,-1,-1
MULIFE.txt,163233,164129,896,10,N,N,-,-1,-1
MULIFE.txt,163286,164185,899,10,N,N,-,-1,-1
MULIFE.txt,163310,164251,941,10,N,N,-,-1,-1
MULIFE.txt,163322,164400,1078,10,N,N,-,-1,-1
MULIFE.txt,163400,164419,1019,10,N,N,-,-1,-1
MULIFE.txt,163418,164669,1251,10,N,N,-,-1,-1
MULIFE.txt,163606,164909,1303,10,N,N,-,-1,-1
MULIFE.txt,163693,164987,1294,10,N,N,-,-1,-1
MULIFE.txt,163759,165129,1370,10,N,N,-,-1,-1
MULIFE.txt,163923,165203,1280,10,N,N,-,-1,-1
MULIFE.txt,164130,165539,1409,10,N,N,-,-1,-1
MULIFE.txt,164188,165563,1375,10,N,N,-,-1,-1
MULIFE.txt,164254,165594,1340,10,N,N,-,-1,-1
MULIFE.txt,164401,165649,1248,10,N,N,-,-1,-1
MULIFE.txt,164421,165821,1400,10,N,N,-,-1,-1
MULIFE.txt,164670,165920,1250,10,N,N,-,-1,-1
MULIFE.txt,164912,165986,1074,10,N,N,-,-1,-1
MULIFE.txt,164988,166251,1263,10,N,N,-,-1,-1
MULIFE.txt,165130,166408,1278,10,N,N,-,-1,-1
MULIFE.txt,165204,166581,1377,10,N,N,-,-1,-1
MULIFE.txt,165540,166700,1160,10,N,N,-,-1,-1
MULIFE.txt,165564,166944,1380,10,N,N,-,-1,-1
MULIFE.txt,165595,167106,1511,10,N,N,-,-1,-1
MULIFE.txt,165650,167137,1487,10,N,N,-,-1,-1
MULIFE.txt,165822,167206,1384,10,N,N,-,-1,-1
MULIFE.txt,165921,167258,1337,10,N,N,-,-1,-1
MULIFE.txt,165987,167275,1288,10,N,N,-,-1,-1
MULIFE.txt,166252,167381,1129,10,N,N,-,-1,-1
MULIFE.txt,166409,167596,1187,10,N,N,-,-1,-1
MULIFE.txt,166582,167740,1158,10,N,N,-,-1,-1
MULIFE.txt,166701,168048,1347,10,N,N,-,-1,-1
MULIFE.txt,166947,168199,1252,10,N,N,-,-1,-1
MULIFE.txt,167107,168574,1467,10,N,N,-,-1,-1
MULIFE.txt,167140,168667,1527,10,N,N,-,-1,-1
MULIFE.txt,167207,168707,1500,10,N,N,-,-1,-1
MULIFE.txt,167260,168744,1484,10,N,N,-,-1,-1
MULIFE.txt,167276,168934,1658,10,N,N,-,-1,-1
MULIFE.txt,167382,168942,1560,10,N,N,-,-1,-1
MULIFE.txt,167597,168951,1354,10,N,N,-,-1,-1
MULIFE.txt,167741,168959,1218,10,N,N,-,-1,-1
MULIFE.txt,168051,169046,995,10,N,N,-,-1,-1
MULIFE.txt,168200,169159,959,10,N,N,-,-1,-1
MULIFE.txt,168577,169350,773,10,N,N,-,-1,-1
MULIFE.txt,168668,169924,1256,10,N,N,-,-1,-1
MULIFE.txt,168708,170172,1464,10,N,N,-,-1,-1
MULIFE.txt,168745,170579,1834,10,N,N,-,-1,-1
MULIFE.txt,168939,170652,1713,10,N,Y,1448311594480,155711,156312
MULIFE.txt,168945,170827,1882,10,N,Y,1448311594480,155711,156312
MULIFE.txt,168954,170891,1937,10,N,Y,1448311594480,155711,156312
MULIFE.txt,168962,171143,2181,10,N,Y,1448311594480,155711,156312
MULIFE.txt,169047,171319,2272,10,N,Y,1448311594480,155711,156312
MULIFE.txt,169160,171384,2224,10,N,Y,1448311594480,155711,156312
MULIFE.txt,169351,171413,2062,10,N,Y,1448311594480,155711,156312
MULIFE.txt,169927,171705,1778,10,N,Y,1448311594480,155711,156312
MULIFE.txt,170173,171762,1589,10,N,Y,1448311594480,155711,156312
MULIFE.txt,170582,171937,1355,10,N,Y,1448311594480,155711,156312
MULIFE.txt,170653,171999,1346,10,N,Y,1448311594480,155711,156312
MULIFE.txt,170828,172139,1311,10,N,Y,1448311594480,155711,156312
MULIFE.txt,170892,172268,1376,10,N,Y,1448311594480,155711,156312
MULIFE.txt,171144,172367,1223,10,N,Y,1448311594480,155711,156312
MULIFE.txt,171320,172392,1072,10,N,Y,1448311594480,155711,156312
MULIFE.txt,171389,172461,1072,10,N,Y,1448311594480,155711,156312
MULIFE.txt,171414,172508,1094,10,N,Y,1448311594480,155711,156312
MULIFE.txt,171708,172596,888,10,N,N,-,-1,-1
MULIFE.txt,171763,172673,910,10,N,N,-,-1,-1
MULIFE.txt,171938,172774,836,10,N,N,-,-1,-1
MULIFE.txt,172001,172807,806,10,N,N,-,-1,-1
MULIFE.txt,172140,172845,705,10,N,N,-,-1,-1
MULIFE.txt,172269,173061,792,10,N,N,-,-1,-1
MULIFE.txt,172370,173183,813,10,N,N,-,-1,-1
MULIFE.txt,172395,173359,964,10,N,N,-,-1,-1
MULIFE.txt,172462,173547,1085,10,N,N,-,-1,-1
MULIFE.txt,172509,173626,1117,10,N,N,-,-1,-1
MULIFE.txt,172597,173714,1117,10,N,N,-,-1,-1
MULIFE.txt,172674,173760,1086,10,N,N,-,-1,-1
MULIFE.txt,172775,174100,1325,10,N,N,-,-1,-1
MULIFE.txt,172810,174278,1468,10,N,N,-,-1,-1
MULIFE.txt,172846,174519,1673,10,N,N,-,-1,-1
MULIFE.txt,173064,174898,1834,10,N,N,-,-1,-1
MULIFE.txt,173184,174973,1789,10,N,N,-,-1,-1
MULIFE.txt,173360,175029,1669,10,N,N,-,-1,-1
MULIFE.txt,173548,175151,1603,10,N,N,-,-1,-1
MULIFE.txt,173627,175214,1587,10,N,N,-,-1,-1
MULIFE.txt,173715,175451,1736,10,N,N,-,-1,-1
MULIFE.txt,173761,175717,1956,10,N,N,-,-1,-1
MULIFE.txt,174101,175812,1711,10,N,N,-,-1,-1
MULIFE.txt,174279,175829,1550,10,N,N,-,-1,-1
MULIFE.txt,174521,176044,1523,10,N,N,-,-1,-1
MULIFE.txt,174899,176143,1244,10,N,N,-,-1,-1
MULIFE.txt,174976,176632,1656,10,N,N,-,-1,-1
MULIFE.txt,175031,176794,1763,10,N,N,-,-1,-1
MULIFE.txt,175152,176846,1694,10,N,N,-,-1,-1
MULIFE.txt,175215,176878,1663,10,N,N,-,-1,-1
MULIFE.txt,175453,176933,1480,10,N,N,-,-1,-1
MULIFE.txt,175718,177124,1406,10,N,N,-,-1,-1
MULIFE.txt,175815,177261,1446,10,N,N,-,-1,-1
MULIFE.txt,175830,177344,1514,10,N,N,-,-1,-1
MULIFE.txt,176046,177429,1383,10,N,N,-,-1,-1
MULIFE.txt,176144,177473,1329,10,N,N,-,-1,-1
MULIFE.txt,176635,177765,1130,10,N,N,-,-1,-1
MULIFE.txt,176797,177849,1052,10,N,N,-,-1,-1
MULIFE.txt,176847,177856,1009,10,N,N,-,-1,-1
MULIFE.txt,176879,177941,1062,10,N,N,-,-1,-1
MULIFE.txt,176934,177985,1051,10,N,N,-,-1,-1
MULIFE.txt,177126,178064,938,10,N,N,-,-1,-1
MULIFE.txt,177262,178159,897,10,N,N,-,-1,-1
MULIFE.txt,177345,178223,878,10,N,N,-,-1,-1
MULIFE.txt,177430,178256,826,10,N,N,-,-1,-1
MULIFE.txt,177474,178324,850,10,N,N,-,-1,-1
MULIFE.txt,177766,178349,583,10,N,N,-,-1,-1
MULIFE.txt,177850,178384,534,10,N,N,-,-1,-1
MULIFE.txt,177857,178510,653,10,N,N,-,-1,-1
MULIFE.txt,177942,178600,658,10,N,N,-,-1,-1
MULIFE.txt,177986,178722,736,10,N,N,-,-1,-1
MULIFE.txt,178065,178750,685,10,N,N,-,-1,-1
MULIFE.txt,178160,178802,642,10,N,N,-,-1,-1
MULIFE.txt,178224,178850,626,10,N,N,-,-1,-1
MULIFE.txt,178258,179058,800,10,N,N,-,-1,-1
MULIFE.txt,178325,179200,875,10,N,N,-,-1,-1
MULIFE.txt,178350,179440,1090,10,N,N,-,-1,-1
MULIFE.txt,178385,179520,1135,10,N,N,-,-1,-1
MULIFE.txt,178511,179587,1076,10,N,N,-,-1,-1
MULIFE.txt,178603,179754,1151,10,N,N,-,-1,-1
MULIFE.txt,178725,179955,1230,10,N,N,-,-1,-1
MULIFE.txt,178751,180086,1335,10,N,N,-,-1,-1
MULIFE.txt,178803,180182,1379,10,N,N,-,-1,-1
MULIFE.txt,178851,180200,1349,10,N,N,-,-1,-1
MULIFE.txt,179061,180225,1164,10,N,N,-,-1,-1
MULIFE.txt,179201,180314,1113,10,N,N,-,-1,-1
MULIFE.txt,179441,180385,944,10,N,N,-,-1,-1
MULIFE.txt,179521,180401,880,10,N,N,-,-1,-1
MULIFE.txt,179588,180504,916,10,N,N,-,-1,-1
MULIFE.txt,179755,180615,860,10,N,N,-,-1,-1
MULIFE.txt,179958,180857,899,10,N,N,-,-1,-1
MULIFE.txt,180087,181055,968,10,N,N,-,-1,-1
MULIFE.txt,180183,181114,931,10,N,N,-,-1,-1
MULIFE.txt,180201,181260,1059,10,N,N,-,-1,-1
MULIFE.txt,180228,181360,1132,10,N,N,-,-1,-1
MULIFE.txt,180315,181535,1220,10,N,N,-,-1,-1
MULIFE.txt,180386,181550,1164,10,N,N,-,-1,-1
MULIFE.txt,180404,181842,1438,10,N,N,-,-1,-1
MULIFE.txt,180506,181970,1464,10,N,N,-,-1,-1
MULIFE.txt,180618,182317,1699,10,N,N,-,-1,-1
MULIFE.txt,180858,182386,1528,10,N,N,-,-1,-1
MULIFE.txt,181056,182483,1427,10,N,N,-,-1,-1
MULIFE.txt,181115,182650,1535,10,N,N,-,-1,-1
MULIFE.txt,181261,182699,1438,10,N,N,-,-1,-1
MULIFE.txt,181361,182794,1433,10,N,N,-,-1,-1
MULIFE.txt,181540,182877,1337,10,N,N,-,-1,-1
MULIFE.txt,181553,182893,1340,10,N,N,-,-1,-1
MULIFE.txt,181844,182928,1084,10,N,N,-,-1,-1
MULIFE.txt,181971,182988,1017,10,N,N,-,-1,-1
MULIFE.txt,182318,183070,752,10,N,N,-,-1,-1
MULIFE.txt,182388,183089,701,10,N,N,-,-1,-1
MULIFE.txt,182484,183120,636,10,N,N,-,-1,-1
MULIFE.txt,182653,183189,536,10,N,N,-,-1,-1
MULIFE.txt,182700,183229,529,10,N,N,-,-1,-1
MULIFE.txt,182795,183241,446,10,N,N,-,-1,-1
MULIFE.txt,182880,183379,499,10,N,N,-,-1,-1
MULIFE.txt,182894,183387,493,10,N,N,-,-1,-1
MULIFE.txt,182930,183394,464,10,N,N,-,-1,-1
MULIFE.txt,182990,183410,420,10,N,N,-,-1,-1
MULIFE.txt,183070,183577,507,10,N,N,-,-1,-1
MULIFE.txt,183090,183800,710,10,N,N,-,-1,-1
MULIFE.txt,183121,183887,766,10,N,N,-,-1,-1
MULIFE.txt,183194,183971,777,10,N,N,-,-1,-1
MULIFE.txt,183231,184075,844,10,N,N,-,-1,-1
MULIFE.txt,183244,184220,976,10,N,N,-,-1,-1
MULIFE.txt,183380,184358,978,10,N,N,-,-1,-1
MULIFE.txt,183388,184442,1054,10,N,N,-,-1,-1
MULIFE.txt,183395,184547,1152,10,N,N,-,-1,-1
MULIFE.txt,183413,184581,1168,10,N,N,-,-1,-1
MULIFE.txt,183578,184817,1239,10,N,N,-,-1,-1
MULIFE.txt,183801,184911,1110,10,N,N,-,-1,-1
MULIFE.txt,183888,185203,1315,10,N,N,-,-1,-1
MULIFE.txt,183972,185285,1313,10,N,N,-,-1,-1
MULIFE.txt,184076,185313,1237,10,N,N,-,-1,-1
MULIFE.txt,184223,185357,1134,10,N,N,-,-1,-1
MULIFE.txt,184361,185461,1100,10,N,N,-,-1,-1
MULIFE.txt,184443,185497,1054,10,N,N,-,-1,-1
MULIFE.txt,184548,185526,978,10,N,N,-,-1,-1
MULIFE.txt,184584,185593,1009,10,N,N,-,-1,-1
MULIFE.txt,184818,185693,875,10,N,N,-,-1,-1
MULIFE.txt,184912,185778,866,10,N,N,-,-1,-1
MULIFE.txt,185204,185816,612,10,N,N,-,-1,-1
MULIFE.txt,185286,185915,629,10,N,N,-,-1,-1
MULIFE.txt,185314,186006,692,10,N,N,-,-1,-1
MULIFE.txt,185358,186112,754,10,N,N,-,-1,-1
MULIFE.txt,185462,186802,1340,10,N,N,-,-1,-1
MULIFE.txt,185499,186894,1395,10,N,N,-,-1,-1
MULIFE.txt,185527,186923,1396,10,N,N,-,-1,-1
MULIFE.txt,185594,186959,1365,10,N,N,-,-1,-1
MULIFE.txt,185694,186994,1300,10,N,N,-,-1,-1
MULIFE.txt,185779,187059,1280,10,N,N,-,-1,-1
MULIFE.txt,185817,187169,1352,10,N,N,-,-1,-1
MULIFE.txt,185916,187214,1298,10,N,N,-,-1,-1
MULIFE.txt,186009,187261,1252,10,N,N,-,-1,-1
MULIFE.txt,186113,187434,1321,10,N,N,-,-1,-1
MULIFE.txt,186803,187552,749,10,N,N,-,-1,-1
MULIFE.txt,186895,187623,728,10,N,N,-,-1,-1
MULIFE.txt,186925,187670,745,10,N,N,-,-1,-1
MULIFE.txt,186960,187850,890,10,N,N,-,-1,-1
MULIFE.txt,186995,187901,906,10,N,N,-,-1,-1
MULIFE.txt,187060,188029,969,10,N,N,-,-1,-1
MULIFE.txt,187170,188167,997,10,N,N,-,-1,-1
MULIFE.txt,187215,188428,1213,10,N,Y,1448275023016,26258,26837
MULIFE.txt,187264,188534,1270,10,N,Y,1448275023016,26258,26837
MULIFE.txt,187437,188677,1240,10,N,Y,1448275023016,26258,26837
MULIFE.txt,187553,188731,1178,10,N,Y,1448275023016,26258,26837
MULIFE.txt,187624,188769,1145,10,N,Y,1448275023016,26258,26837
MULIFE.txt,187671,188777,1106,10,N,Y,1448275023016,26258,26837
MULIFE.txt,187853,188973,1120,10,N,Y,1448275023016,26258,26837
MULIFE.txt,187902,189054,1152,10,N,Y,1448275023016,26258,26837
MULIFE.txt,188032,189077,1045,10,N,Y,1448275023016,26258,26837
MULIFE.txt,188168,189276,1108,10,N,Y,1448275023016,26258,26837
MULIFE.txt,188429,189408,979,10,N,Y,1448275023016,26258,26837
MULIFE.txt,188535,189464,929,10,N,Y,1448275023016,26258,26837
MULIFE.txt,188678,189529,851,10,N,Y,1448275023016,26258,26837
MULIFE.txt,188732,189591,859,10,N,Y,1448275023016,26258,26837
MULIFE.txt,188770,189732,962,10,N,Y,1448275023016,26258,26837
MULIFE.txt,188778,189880,1102,10,N,Y,1448275023016,26258,26837
MULIFE.txt,188975,190175,1200,10,N,Y,1448275023016,26258,26837
MULIFE.txt,189055,190275,1220,10,N,Y,1448275023016,26258,26837
MULIFE.txt,189078,190499,1421,10,N,Y,1448275023016,26258,26837
MULIFE.txt,189277,190637,1360,10,N,Y,1448275023016,26258,26837
MULIFE.txt,189409,190714,1305,10,N,Y,1448275023016,26258,26837
MULIFE.txt,189465,190778,1313,10,N,Y,1448275023016,26258,26837
MULIFE.txt,189532,190969,1437,10,N,Y,1448275023016,26258,26837
MULIFE.txt,189593,191211,1618,10,N,Y,1448275023016,26258,26837
MULIFE.txt,189733,191405,1672,10,N,Y,1448275023016,26258,26837
MULIFE.txt,189881,191563,1682,10,N,Y,1448275023016,26258,26837
MULIFE.txt,190178,191569,1391,10,N,Y,1448276340407,30017,39003
MULIFE.txt,190278,191639,1361,10,N,Y,1448276340407,30017,39003
MULIFE.txt,190500,191742,1242,10,N,Y,1448276340407,30017,39003
MULIFE.txt,190639,191764,1125,10,N,Y,1448276340407,30017,39003
MULIFE.txt,190715,191890,1175,10,N,Y,1448276340407,30017,39003
MULIFE.txt,190779,191980,1201,10,N,Y,1448039533036,21326,21680
MULIFE.txt,190970,192041,1071,10,N,Y,1448039533036,21326,21680
MULIFE.txt,191213,192112,899,10,N,Y,1448039533036,21326,21680
MULIFE.txt,191408,192166,758,10,N,Y,1448039533036,21326,21680
MULIFE.txt,191566,192504,938,10,N,Y,1448039533036,21326,21680
MULIFE.txt,191572,192642,1070,10,N,Y,1448039533036,21326,21680
MULIFE.txt,191640,192668,1028,10,N,Y,1448039533036,21326,21680
MULIFE.txt,191747,192695,948,10,N,Y,1448039533036,21326,21680
MULIFE.txt,191765,192735,970,10,N,Y,1448039533036,21326,21680
MULIFE.txt,191893,192807,914,10,N,Y,1448039533036,21326,21680
MULIFE.txt,191981,192847,866,10,N,Y,1448039533036,21326,21680
MULIFE.txt,192042,192889,847,10,N,Y,1448039533036,21326,21680
MULIFE.txt,192113,193123,1010,10,N,Y,1448039533036,21326,21680
MULIFE.txt,192169,193286,1117,10,N,N,-,-1,-1
MULIFE.txt,192505,193358,853,10,N,N,-,-1,-1
MULIFE.txt,192644,193452,808,10,N,N,-,-1,-1
MULIFE.txt,192669,193577,908,10,N,N,-,-1,-1
MULIFE.txt,192696,193837,1141,10,N,N,-,-1,-1
MULIFE.txt,192738,193894,1156,10,N,N,-,-1,-1
MULIFE.txt,192808,193899,1091,10,N,N,-,-1,-1
MULIFE.txt,192848,194046,1198,10,N,N,-,-1,-1
MULIFE.txt,192890,194198,1308,10,N,N,-,-1,-1
MULIFE.txt,193126,194257,1131,10,N,N,-,-1,-1
MULIFE.txt,193289,194432,1143,10,N,N,-,-1,-1
MULIFE.txt,193359,194578,1219,10,N,N,-,-1,-1
MULIFE.txt,193455,194742,1287,10,N,N,-,-1,-1
MULIFE.txt,193578,194822,1244,10,N,N,-,-1,-1
MULIFE.txt,193838,194834,996,10,N,N,-,-1,-1
MULIFE.txt,193895,195065,1170,10,N,N,-,-1,-1
MULIFE.txt,193900,195149,1249,10,N,N,-,-1,-1
MULIFE.txt,194047,195192,1145,10,N,N,-,-1,-1
MULIFE.txt,194201,195339,1138,10,N,N,-,-1,-1
MULIFE.txt,194260,195754,1494,10,N,N,-,-1,-1
MULIFE.txt,194435,195890,1455,10,N,N,-,-1,-1
MULIFE.txt,194579,195969,1390,10,N,N,-,-1,-1
MULIFE.txt,194743,195999,1256,10,N,N,-,-1,-1
MULIFE.txt,194823,196341,1518,10,N,N,-,-1,-1
MULIFE.txt,194835,196414,1579,10,N,N,-,-1,-1
MULIFE.txt,195068,196437,1369,10,N,N,-,-1,-1
MULIFE.txt,195150,196498,1348,10,N,N,-,-1,-1
MULIFE.txt,195193,196549,1356,10,N,N,-,-1,-1
MULIFE.txt,195340,196667,1327,10,N,N,-,-1,-1
MULIFE.txt,195755,196712,957,10,N,N,-,-1,-1
MULIFE.txt,195891,196934,1043,10,N,N,-,-1,-1
MULIFE.txt,195970,197003,1033,10,N,N,-,-1,-1
MULIFE.txt,196000,197051,1051,10,N,N,-,-1,-1
MULIFE.txt,196342,197204,862,10,N,N,-,-1,-1
MULIFE.txt,196417,197238,821,10,N,N,-,-1,-1
MULIFE.txt,196438,197271,833,10,N,N,-,-1,-1
MULIFE.txt,196499,197411,912,10,N,N,-,-1,-1
MULIFE.txt,196550,197497,947,10,N,N,-,-1,-1
MULIFE.txt,196668,197710,1042,10,N,N,-,-1,-1
MULIFE.txt,196714,197795,1081,10,N,N,-,-1,-1
MULIFE.txt,196935,197938,1003,10,N,N,-,-1,-1
MULIFE.txt,197006,197968,962,10,N,N,-,-1,-1
MULIFE.txt,197052,198090,1038,10,N,N,-,-1,-1
MULIFE.txt,197205,198163,958,10,N,N,-,-1,-1
MULIFE.txt,197239,198300,1061,10,N,N,-,-1,-1
MULIFE.txt,197272,198355,1083,10,N,N,-,-1,-1
MULIFE.txt,197412,198442,1030,10,N,N,-,-1,-1
MULIFE.txt,197498,198652,1154,10,N,N,-,-1,-1
MULIFE.txt,197711,198701,990,10,N,N,-,-1,-1
MULIFE.txt,197796,198804,1008,10,N,N,-,-1,-1
MULIFE.txt,197943,198854,911,10,N,N,-,-1,-1
MULIFE.txt,197969,198902,933,10,N,N,-,-1,-1
MULIFE.txt,198091,198910,819,10,N,N,-,-1,-1
MULIFE.txt,198164,198918,754,10,N,N,-,-1,-1
MULIFE.txt,198301,198928,627,10,N,N,-,-1,-1
MULIFE.txt,198356,198946,590,10,N,N,-,-1,-1
MULIFE.txt,198444,199146,702,10,N,N,-,-1,-1
MULIFE.txt,198653,199373,720,10,N,N,-,-1,-1
MULIFE.txt,198702,199586,884,10,N,N,-,-1,-1
MULIFE.txt,198805,199715,910,10,N,N,-,-1,-1
MULIFE.txt,198855,199872,1017,10,N,N,-,-1,-1
MULIFE.txt,198903,199912,1009,10,N,N,-,-1,-1
MULIFE.txt,198911,200045,1134,10,N,N,-,-1,-1
MULIFE.txt,198919,200137,1218,10,N,N,-,-1,-1
MULIFE.txt,198929,200301,1372,10,N,N,-,-1,-1
MULIFE.txt,198947,200498,1551,10,N,N,-,-1,-1
MULIFE.txt,199147,200636,1489,10,N,N,-,-1,-1
MULIFE.txt,199376,200680,1304,10,N,N,-,-1,-1
MULIFE.txt,199589,200747,1158,10,N,N,-,-1,-1
MULIFE.txt,199716,200930,1214,10,N,N,-,-1,-1
MULIFE.txt,199873,201061,1188,10,N,N,-,-1,-1
MULIFE.txt,199915,201085,1170,10,N,N,-,-1,-1
MULIFE.txt,200046,201132,1086,10,N,N,-,-1,-1
MULIFE.txt,200140,201181,1041,10,N,N,-,-1,-1
MULIFE.txt,200302,201245,943,10,N,N,-,-1,-1
MULIFE.txt,200499,201262,763,10,N,N,-,-1,-1
MULIFE.txt,200637,201340,703,10,N,N,-,-1,-1
MULIFE.txt,200681,201354,673,10,N,N,-,-1,-1
MULIFE.txt,200750,201487,737,10,N,N,-,-1,-1
MULIFE.txt,200931,201712,781,10,N,N,-,-1,-1
MULIFE.txt,201062,202097,1035,10,N,N,-,-1,-1
MULIFE.txt,201086,202184,1098,10,N,N,-,-1,-1
MULIFE.txt,201135,202266,1131,10,N,N,-,-1,-1
MULIFE.txt,201184,202409,1225,10,N,N,-,-1,-1
MULIFE.txt,201246,202438,1192,10,N,N,-,-1,-1
MULIFE.txt,201263,202454,1191,10,N,N,-,-1,-1
MULIFE.txt,201341,202480,1139,10,N,N,-,-1,-1
MULIFE.txt,201355,202569,1214,10,N,N,-,-1,-1
MULIFE.txt,201488,202600,1112,10,N,N,-,-1,-1
MULIFE.txt,201713,202804,1091,10,N,N,-,-1,-1
MULIFE.txt,202098,203152,1054,10,N,N,-,-1,-1
MULIFE.txt,202185,203213,1028,10,N,N,-,-1,-1
MULIFE.txt,202267,203235,968,10,N,N,-,-1,-1
MULIFE.txt,202411,203265,854,10,N,N,-,-1,-1
MULIFE.txt,202439,203340,901,10,N,N,-,-1,-1
MULIFE.txt,202455,203471,1016,10,N,N,-,-1,-1
MULIFE.txt,202481,203735,1254,10,N,N,-,-1,-1
MULIFE.txt,202572,203927,1355,10,N,N,-,-1,-1
MULIFE.txt,202601,204092,1491,10,N,N,-,-1,-1
MULIFE.txt,202807,204104,1297,10,N,N,-,-1,-1
MULIFE.txt,203154,204192,1038,10,N,N,-,-1,-1
MULIFE.txt,203215,204398,1183,10,N,N,-,-1,-1
MULIFE.txt,203236,205100,1864,10,N,N,-,-1,-1
MULIFE.txt,203266,205238,1972,10,N,N,-,-1,-1
MULIFE.txt,203341,205626,2285,10,N,N,-,-1,-1
MULIFE.txt,203472,205665,2193,10,N,N,-,-1,-1
MULIFE.txt,203738,205792,2054,10,N,N,-,-1,-1
MULIFE.txt,203928,205910,1982,10,N,N,-,-1,-1
MULIFE.txt,204093,206003,1910,10,N,N,-,-1,-1
MULIFE.txt,204105,206230,2125,10,N,N,-,-1,-1
MULIFE.txt,204193,206480,2287,10,N,N,-,-1,-1
MULIFE.txt,204399,206490,2091,10,N,N,-,-1,-1
MULIFE.txt,205102,206620,1518,10,N,N,-,-1,-1
MULIFE.txt,205241,206690,1449,10,N,N,-,-1,-1
MULIFE.txt,205631,206766,1135,10,N,N,-,-1,-1
MULIFE.txt,205668,206788,1120,10,N,N,-,-1,-1
MULIFE.txt,205793,206842,1049,10,N,N,-,-1,-1
MULIFE.txt,205911,206877,966,10,N,N,-,-1,-1
MULIFE.txt,206004,206887,883,10,N,N,-,-1,-1
MULIFE.txt,206231,206910,679,10,N,N,-,-1,-1
MULIFE.txt,206485,206930,445,10,N,N,-,-1,-1
MULIFE.txt,206491,206950,459,10,N,N,-,-1,-1
MULIFE.txt,206621,206992,371,10,N,N,-,-1,-1
MULIFE.txt,206693,207249,556,10,N,N,-,-1,-1
MULIFE.txt,206769,207570,801,10,N,N,-,-1,-1
MULIFE.txt,206791,207715,924,10,N,N,-,-1,-1
MULIFE.txt,206844,207740,896,10,N,N,-,-1,-1
MULIFE.txt,206882,207827,945,10,N,N,-,-1,-1
MULIFE.txt,206892,207938,1046,10,N,N,-,-1,-1
MULIFE.txt,206915,208179,1264,10,N,N,-,-1,-1
MULIFE.txt,206932,208241,1309,10,N,N,-,-1,-1
MULIFE.txt,206956,208407,1451,10,N,N,-,-1,-1
MULIFE.txt,206995,208704,1709,10,N,N,-,-1,-1
MULIFE.txt,207251,209010,1759,10,N,N,-,-1,-1
MULIFE.txt,207573,209085,1512,10,N,N,-,-1,-1
MULIFE.txt,207716,209132,1416,10,N,N,-,-1,-1
MULIFE.txt,207741,209182,1441,10,N,N,-,-1,-1
MULIFE.txt,207828,209230,1402,10,N,N,-,-1,-1
MULIFE.txt,207939,209350,1411,10,N,N,-,-1,-1
MULIFE.txt,208182,209470,1288,10,N,N,-,-1,-1
MULIFE.txt,208244,209572,1328,10,N,N,-,-1,-1
MULIFE.txt,208410,209674,1264,10,N,N,-,-1,-1
MULIFE.txt,208707,210190,1483,10,N,N,-,-1,-1
MULIFE.txt,209011,210298,1287,10,N,N,-,-1,-1
MULIFE.txt,209088,210302,1214,10,N,N,-,-1,-1
MULIFE.txt,209133,210304,1171,10,N,N,-,-1,-1
MULIFE.txt,209183,210405,1222,10,N,N,-,-1,-1
MULIFE.txt,209231,210535,1304,10,N,N,-,-1,-1
MULIFE.txt,209351,210554,1203,10,N,N,-,-1,-1
MULIFE.txt,209471,210638,1167,10,N,N,-,-1,-1
MULIFE.txt,209575,210684,1109,10,N,N,-,-1,-1
MULIFE.txt,209675,210723,1048,10,N,N,-,-1,-1
MULIFE.txt,210191,210944,753,10,N,N,-,-1,-1
MULIFE.txt,210301,211015,714,10,N,N,-,-1,-1
MULIFE.txt,210303,211068,765,10,N,N,-,-1,-1
MULIFE.txt,210307,211245,938,10,N,N,-,-1,-1
MULIFE.txt,210408,211298,890,10,N,N,-,-1,-1
MULIFE.txt,210536,211360,824,10,N,N,-,-1,-1
MULIFE.txt,210555,211392,837,10,N,N,-,-1,-1
MULIFE.txt,210641,211440,799,10,N,N,-,-1,-1
MULIFE.txt,210685,211530,845,10,N,N,-,-1,-1
MULIFE.txt,210724,211595,871,10,N,N,-,-1,-1
MULIFE.txt,210945,211691,746,10,N,N,-,-1,-1
MULIFE.txt,211020,211771,751,10,N,N,-,-1,-1
MULIFE.txt,211069,211811,742,10,N,N,-,-1,-1
MULIFE.txt,211246,211856,610,10,N,N,-,-1,-1
MULIFE.txt,211299,211874,575,10,N,N,-,-1,-1
MULIFE.txt,211361,212224,863,10,N,N,-,-1,-1
MULIFE.txt,211393,212310,917,10,N,N,-,-1,-1
MULIFE.txt,211441,212392,951,10,N,N,-,-1,-1
MULIFE.txt,211531,212457,926,10,N,N,-,-1,-1
MULIFE.txt,211596,212572,976,10,N,N,-,-1,-1
MULIFE.txt,211692,212786,1094,10,N,N,-,-1,-1
MULIFE.txt,211772,212814,1042,10,N,N,-,-1,-1
MULIFE.txt,211812,212824,1012,10,N,N,-,-1,-1
MULIFE.txt,211861,213192,1331,10,N,N,-,-1,-1
MULIFE.txt,211875,213208,1333,10,N,N,-,-1,-1
MULIFE.txt,212225,213240,1015,10,N,N,-,-1,-1
MULIFE.txt,212311,213246,935,10,N,N,-,-1,-1
MULIFE.txt,212393,213272,879,10,N,N,-,-1,-1
MULIFE.txt,212458,213478,1020,10,N,N,-,-1,-1
MULIFE.txt,212573,213569,996,10,N,N,-,-1,-1
MULIFE.txt,212787,213771,984,10,N,N,-,-1,-1
MULIFE.txt,212815,213868,1053,10,N,N,-,-1,-1
MULIFE.txt,212825,213948,1123,10,N,N,-,-1,-1
MULIFE.txt,213193,214027,834,10,N,N,-,-1,-1
MULIFE.txt,213213,214029,816,10,N,N,-,-1,-1
MULIFE.txt,213243,214030,787,10,N,N,-,-1,-1
MULIFE.txt,213249,214279,1030,10,N,N,-,-1,-1
MULIFE.txt,213275,214525,1250,10,N,N,-,-1,-1
MULIFE.txt,213479,214594,1115,10,N,N,-,-1,-1
MULIFE.txt,213570,214742,1172,10,N,N,-,-1,-1
MULIFE.txt,213774,214771,997,10,N,N,-,-1,-1
MULIFE.txt,213869,214873,1004,10,N,N,-,-1,-1
MULIFE.txt,213951,215042,1091,10,N,N,-,-1,-1
MULIFE.txt,214028,215385,1357,10,N,N,-,-1,-1
MULIFE.txt,214029,215413,1384,10,N,N,-,-1,-1
MULIFE.txt,214031,215478,1447,10,N,N,-,-1,-1
MULIFE.txt,214280,215484,1204,10,N,N,-,-1,-1
MULIFE.txt,214526,215550,1024,10,N,N,-,-1,-1
MULIFE.txt,214595,215557,962,10,N,N,-,-1,-1
MULIFE.txt,214743,215597,854,10,N,N,-,-1,-1
MULIFE.txt,214773,215663,890,10,N,N,-,-1,-1
MULIFE.txt,214874,215722,848,10,N,N,-,-1,-1
MULIFE.txt,215043,215980,937,10,N,N,-,-1,-1
MULIFE.txt,215388,216051,663,10,N,N,-,-1,-1
MULIFE.txt,215414,216115,701,10,N,N,-,-1,-1
MULIFE.txt,215481,216393,912,10,N,N,-,-1,-1
MULIFE.txt,215485,216462,977,10,N,N,-,-1,-1
MULIFE.txt,215553,216516,963,10,N,N,-,-1,-1
MULIFE.txt,215558,216550,992,10,N,N,-,-1,-1
MULIFE.txt,215600,216591,991,10,N,N,-,-1,-1
MULIFE.txt,215666,216959,1293,10,N,N,-,-1,-1
MULIFE.txt,215723,217056,1333,10,N,N,-,-1,-1
MULIFE.txt,215983,217269,1286,10,N,N,-,-1,-1
MULIFE.txt,216052,217366,1314,10,N,N,-,-1,-1
MULIFE.txt,216116,217403,1287,10,N,N,-,-1,-1
MULIFE.txt,216396,217484,1088,10,N,N,-,-1,-1
MULIFE.txt,216463,217561,1098,10,N,N,-,-1,-1
MULIFE.txt,216517,217580,1063,10,N,N,-,-1,-1
MULIFE.txt,216551,217761,1210,10,N,N,-,-1,-1
MULIFE.txt,216592,217951,1359,10,N,N,-,-1,-1
MULIFE.txt,216960,218091,1131,10,N,N,-,-1,-1
MULIFE.txt,217057,218178,1121,10,N,N,-,-1,-1
MULIFE.txt,217270,218246,976,10,N,N,-,-1,-1
MULIFE.txt,217367,218351,984,10,N,N,-,-1,-1
MULIFE.txt,217404,218392,988,10,N,N,-,-1,-1
MULIFE.txt,217485,218565,1080,10,N,N,-,-1,-1
MULIFE.txt,217562,218822,1260,10,N,N,-,-1,-1
MULIFE.txt,217581,218870,1289,10,N,N,-,-1,-1
MULIFE.txt,217763,219043,1280,10,N,N,-,-1,-1
MULIFE.txt,217952,219075,1123,10,N,N,-,-1,-1
MULIFE.txt,218092,219204,1112,10,N,N,-,-1,-1
MULIFE.txt,218181,219235,1054,10,N,N,-,-1,-1
MULIFE.txt,218247,219241,994,10,N,N,-,-1,-1
MULIFE.txt,218352,219303,951,10,N,N,-,-1,-1
MULIFE.txt,218395,219376,981,10,N,N,-,-1,-1
MULIFE.txt,218566,219459,893,10,N,N,-,-1,-1
MULIFE.txt,218824,219464,640,10,N,N,-,-1,-1
MULIFE.txt,218871,219496,625,10,N,N,-,-1,-1
MULIFE.txt,219048,219545,497,10,N,N,-,-1,-1
MULIFE.txt,219078,219680,602,10,N,N,-,-1,-1
MULIFE.txt,219205,219956,751,10,N,N,-,-1,-1
MULIFE.txt,219237,219996,759,10,N,N,-,-1,-1
MULIFE.txt,219243,220178,935,10,N,N,-,-1,-1
MULIFE.txt,219304,220314,1010,10,N,N,-,-1,-1
MULIFE.txt,219377,220319,942,10,N,N,-,-1,-1
MULIFE.txt,219462,220345,883,10,N,N,-,-1,-1
MULIFE.txt,219465,220431,966,10,N,N,-,-1,-1
MULIFE.txt,219497,220570,1073,10,N,N,-,-1,-1
MULIFE.txt,219546,220658,1112,10,N,N,-,-1,-1
MULIFE.txt,219681,220663,982,10,N,N,-,-1,-1
MULIFE.txt,219957,220693,736,10,N,N,-,-1,-1
MULIFE.txt,219997,220740,743,10,N,N,-,-1,-1
MULIFE.txt,220179,220994,815,10,N,N,-,-1,-1
MULIFE.txt,220317,221102,785,10,N,N,-,-1,-1
MULIFE.txt,220320,221131,811,10,N,N,-,-1,-1
MULIFE.txt,220346,221166,820,10,N,N,-,-1,-1
MULIFE.txt,220433,221281,848,10,N,N,-,-1,-1
MULIFE.txt,220571,221573,1002,10,N,N,-,-1,-1
MULIFE.txt,220661,221616,955,10,N,N,-,-1,-1
MULIFE.txt,220664,221719,1055,10,N,N,-,-1,-1
MULIFE.txt,220694,221781,1087,10,N,N,-,-1,-1
MULIFE.txt,220741,221809,1068,10,N,N,-,-1,-1
MULIFE.txt,220997,221958,961,10,N,N,-,-1,-1
MULIFE.txt,221103,222044,941,10,N,N,-,-1,-1
MULIFE.txt,221132,222110,978,10,N,N,-,-1,-1
MULIFE.txt,221169,222154,985,10,N,N,-,-1,-1
MULIFE.txt,221282,222249,967,10,N,N,-,-1,-1
MULIFE.txt,221574,222408,834,10,N,N,-,-1,-1
MULIFE.txt,221618,222642,1024,10,N,N,-,-1,-1
MULIFE.txt,221722,223154,1432,10,N,N,-,-1,-1
MULIFE.txt,221782,223203,1421,10,N,N,-,-1,-1
MULIFE.txt,221810,223269,1459,10,N,N,-,-1,-1
MULIFE.txt,221959,223405,1446,10,N,N,-,-1,-1
MULIFE.txt,222047,223545,1498,10,N,N,-,-1,-1
MULIFE.txt,222111,223728,1617,10,N,N,-,-1,-1
MULIFE.txt,222155,223984,1829,10,N,N,-,-1,-1
MULIFE.txt,222252,224296,2044,10,N,N,-,-1,-1
MULIFE.txt,222409,224422,2013,10,N,N,-,-1,-1
MULIFE.txt,222645,224648,2003,10,N,N,-,-1,-1
MULIFE.txt,223155,224831,1676,10,N,N,-,-1,-1
MULIFE.txt,223204,224866,1662,10,N,N,-,-1,-1
MULIFE.txt,223270,224933,1663,10,N,N,-,-1,-1
MULIFE.txt,223408,224964,1556,10,N,N,-,-1,-1
MULIFE.txt,223546,224995,1449,10,N,N,-,-1,-1
MULIFE.txt,223729,225031,1302,10,N,N,-,-1,-1
MULIFE.txt,223985,225045,1060,10,N,N,-,-1,-1
MULIFE.txt,224297,225081,784,10,N,N,-,-1,-1
MULIFE.txt,224425,225152,727,10,N,N,-,-1,-1
MULIFE.txt,224649,225227,578,10,N,N,-,-1,-1
MULIFE.txt,224832,225291,459,10,N,N,-,-1,-1
MULIFE.txt,224867,225321,454,10,N,N,-,-1,-1
MULIFE.txt,224934,225442,508,10,N,N,-,-1,-1
MULIFE.txt,224965,225579,614,10,N,N,-,-1,-1
MULIFE.txt,224998,225640,642,10,N,N,-,-1,-1
MULIFE.txt,225032,225739,707,10,N,N,-,-1,-1
MULIFE.txt,225046,225986,940,10,N,N,-,-1,-1
MULIFE.txt,225084,226042,958,10,N,N,-,-1,-1
MULIFE.txt,225153,226344,1191,10,N,N,-,-1,-1
MULIFE.txt,225228,226447,1219,10,N,N,-,-1,-1
MULIFE.txt,225292,226456,1164,10,N,N,-,-1,-1
MULIFE.txt,225322,226514,1192,10,N,N,-,-1,-1
MULIFE.txt,225443,226591,1148,10,N,N,-,-1,-1
MULIFE.txt,225580,226686,1106,10,N,N,-,-1,-1
MULIFE.txt,225641,227012,1371,10,N,N,-,-1,-1
MULIFE.txt,225740,227074,1334,10,N,N,-,-1,-1
MULIFE.txt,225987,227235,1248,10,N,N,-,-1,-1
MULIFE.txt,226042,227303,1261,10,N,N,-,-1,-1
MULIFE.txt,226347,227331,984,10,N,N,-,-1,-1
MULIFE.txt,226448,227371,923,10,N,N,-,-1,-1
MULIFE.txt,226459,227475,1016,10,N,N,-,-1,-1
MULIFE.txt,226515,227492,977,10,N,N,-,-1,-1
MULIFE.txt,226592,227520,928,10,N,N,-,-1,-1
MULIFE.txt,226687,227570,883,10,N,N,-,-1,-1
MULIFE.txt,227013,227580,567,10,N,N,-,-1,-1
MULIFE.txt,227076,227587,511,10,N,N,-,-1,-1
MULIFE.txt,227236,227591,355,10,N,N,-,-1,-1
MULIFE.txt,227305,227746,441,10,N,N,-,-1,-1
MULIFE.txt,227334,227814,480,10,N,N,-,-1,-1
MULIFE.txt,227372,228050,678,10,N,N,-,-1,-1
MULIFE.txt,227476,228148,672,10,N,N,-,-1,-1
MULIFE.txt,227492,228507,1015,10,N,N,-,-1,-1
MULIFE.txt,227521,228566,1045,10,N,N,-,-1,-1
MULIFE.txt,227571,228634,1063,10,N,N,-,-1,-1
MULIFE.txt,227581,228718,1137,10,N,N,-,-1,-1
MULIFE.txt,227587,228759,1172,10,N,N,-,-1,-1
MULIFE.txt,227594,229006,1412,10,N,N,-,-1,-1
MULIFE.txt,227747,229147,1400,10,N,N,-,-1,-1
MULIFE.txt,227816,229393,1577,10,N,N,-,-1,-1
MULIFE.txt,228052,229711,1659,10,N,N,-,-1,-1
MULIFE.txt,228151,229804,1653,10,N,N,-,-1,-1
MULIFE.txt,228510,229925,1415,10,N,N,-,-1,-1
MULIFE.txt,228569,230279,1710,10,N,N,-,-1,-1
MULIFE.txt,228635,230972,2337,10,N,N,-,-1,-1
MULIFE.txt,228719,231080,2361,10,N,N,-,-1,-1
MULIFE.txt,228760,231266,2506,10,N,N,-,-1,-1
MULIFE.txt,229007,231319,2312,10,N,N,-,-1,-1
MULIFE.txt,229149,231394,2245,10,N,N,-,-1,-1
MULIFE.txt,229394,231613,2219,10,N,N,-,-1,-1
MULIFE.txt,229712,231839,2127,10,N,N,-,-1,-1
MULIFE.txt,229807,231973,2166,10,N,N,-,-1,-1
MULIFE.txt,229927,231987,2060,10,N,N,-,-1,-1
MULIFE.txt,230280,232013,1733,10,N,N,-,-1,-1
MULIFE.txt,230975,232460,1485,10,N,N,-,-1,-1
MULIFE.txt,231081,232620,1539,10,N,N,-,-1,-1
MULIFE.txt,231267,232758,1491,10,N,N,-,-1,-1
MULIFE.txt,231322,233050,1728,10,N,N,-,-1,-1
MULIFE.txt,231397,233471,2074,10,N,N,-,-1,-1
MULIFE.txt,231614,233521,1907,10,N,N,-,-1,-1
MULIFE.txt,231842,233649,1807,10,N,N,-,-1,-1
MULIFE.txt,231974,233724,1750,10,N,N,-,-1,-1
MULIFE.txt,231988,233985,1997,10,N,N,-,-1,-1
MULIFE.txt,232015,234212,2197,10,N,N,-,-1,-1
MULIFE.txt,232462,234312,1850,10,N,N,-,-1,-1
MULIFE.txt,232623,234443,1820,10,N,N,-,-1,-1
MULIFE.txt,232759,234560,1801,10,N,N,-,-1,-1
MULIFE.txt,233051,234679,1628,10,N,N,-,-1,-1
MULIFE.txt,233474,234761,1287,10,N,N,-,-1,-1
MULIFE.txt,233522,234791,1269,10,N,N,-,-1,-1
MULIFE.txt,233651,234820,1169,10,N,N,-,-1,-1
MULIFE.txt,233725,234853,1128,10,N,N,-,-1,-1
MULIFE.txt,233986,234916,930,10,N,N,-,-1,-1
MULIFE.txt,234213,235015,802,10,N,N,-,-1,-1
MULIFE.txt,234315,235146,831,10,N,N,-,-1,-1
MULIFE.txt,234446,235364,918,10,N,N,-,-1,-1
MULIFE.txt,234563,235744,1181,10,N,N,-,-1,-1
MULIFE.txt,234680,235768,1088,10,N,N,-,-1,-1
MULIFE.txt,234762,235895,1133,10,N,N,-,-1,-1
MULIFE.txt,234792,236029,1237,10,N,N,-,-1,-1
MULIFE.txt,234821,236220,1399,10,N,N,-,-1,-1
MULIFE.txt,234854,236287,1433,10,N,N,-,-1,-1
MULIFE.txt,234917,236349,1432,10,N,N,-,-1,-1
MULIFE.txt,235016,236425,1409,10,N,N,-,-1,-1
MULIFE.txt,235147,236651,1504,10,N,N,-,-1,-1
MULIFE.txt,235367,236883,1516,10,N,N,-,-1,-1
MULIFE.txt,235745,236907,1162,10,N,N,-,-1,-1
MULIFE.txt,235769,237079,1310,10,N,N,-,-1,-1
MULIFE.txt,235896,237134,1238,10,N,N,-,-1,-1
MULIFE.txt,236032,237219,1187,10,N,N,-,-1,-1
MULIFE.txt,236223,237347,1124,10,N,N,-,-1,-1
MULIFE.txt,236288,237416,1128,10,N,N,-,-1,-1
MULIFE.txt,236350,237577,1227,10,N,N,-,-1,-1
MULIFE.txt,236426,237809,1383,10,N,N,-,-1,-1
MULIFE.txt,236652,237908,1256,10,N,N,-,-1,-1
MULIFE.txt,236884,238001,1117,10,N,N,-,-1,-1
MULIFE.txt,236910,238110,1200,10,N,N,-,-1,-1
MULIFE.txt,237081,238408,1327,10,N,N,-,-1,-1
MULIFE.txt,237135,238472,1337,10,N,N,-,-1,-1
MULIFE.txt,237222,238505,1283,10,N,N,-,-1,-1
MULIFE.txt,237348,238540,1192,10,N,N,-,-1,-1
MULIFE.txt,237417,238606,1189,10,N,N,-,-1,-1
MULIFE.txt,237580,238732,1152,10,N,N,-,-1,-1
MULIFE.txt,237810,238765,955,10,N,N,-,-1,-1
MULIFE.txt,237909,238790,881,10,N,N,-,-1,-1
MULIFE.txt,238004,238873,869,10,N,N,-,-1,-1
MULIFE.txt,238111,238951,840,10,N,N,-,-1,-1
MULIFE.txt,238409,239270,861,10,N,N,-,-1,-1
MULIFE.txt,238475,239333,858,10,N,N,-,-1,-1
MULIFE.txt,238506,239593,1087,10,N,N,-,-1,-1
MULIFE.txt,238541,239870,1329,10,N,N,-,-1,-1
MULIFE.txt,238607,239896,1289,10,N,N,-,-1,-1
MULIFE.txt,238735,240009,1274,10,N,N,-,-1,-1
MULIFE.txt,238766,240038,1272,10,N,N,-,-1,-1
MULIFE.txt,238792,240099,1307,10,N,N,-,-1,-1
MULIFE.txt,238874,240182,1308,10,N,N,-,-1,-1
MULIFE.txt,238952,240189,1237,10,N,N,-,-1,-1
MULIFE.txt,239271,240252,981,10,N,N,-,-1,-1
MULIFE.txt,239334,240405,1071,10,N,N,-,-1,-1
MULIFE.txt,239596,240426,830,10,N,N,-,-1,-1
MULIFE.txt,239871,240726,855,10,N,N,-,-1,-1
MULIFE.txt,239899,240857,958,10,N,N,-,-1,-1
MULIFE.txt,240012,240996,984,10,N,N,-,-1,-1
MULIFE.txt,240039,241193,1154,10,N,N,-,-1,-1
MULIFE.txt,240102,241445,1343,10,N,N,-,-1,-1
MULIFE.txt,240183,241502,1319,10,N,N,-,-1,-1
MULIFE.txt,240190,241524,1334,10,N,N,-,-1,-1
MULIFE.txt,240253,241584,1331,10,N,N,-,-1,-1
MULIFE.txt,240406,241646,1240,10,N,N,-,-1,-1
MULIFE.txt,240427,241670,1243,10,N,N,-,-1,-1
MULIFE.txt,240727,241709,982,10,N,N,-,-1,-1
MULIFE.txt,240860,241756,896,10,N,N,-,-1,-1
MULIFE.txt,240997,241831,834,10,N,N,-,-1,-1
MULIFE.txt,241195,241937,742,10,N,N,-,-1,-1
MULIFE.txt,241448,242062,614,10,N,N,-,-1,-1
MULIFE.txt,241507,242103,596,10,N,N,-,-1,-1
MULIFE.txt,241525,242415,890,10,N,N,-,-1,-1
MULIFE.txt,241587,242486,899,10,N,N,-,-1,-1
MULIFE.txt,241648,242592,944,10,N,N,-,-1,-1
MULIFE.txt,241671,242652,981,10,N,N,-,-1,-1
MULIFE.txt,241710,242703,993,10,N,N,-,-1,-1
MULIFE.txt,241757,242860,1103,10,N,N,-,-1,-1
MULIFE.txt,241832,242927,1095,10,N,N,-,-1,-1
MULIFE.txt,241938,243093,1155,10,N,N,-,-1,-1
MULIFE.txt,242063,243122,1059,10,N,N,-,-1,-1
MULIFE.txt,242105,243317,1212,10,N,N,-,-1,-1
MULIFE.txt,242418,243490,1072,10,N,N,-,-1,-1
MULIFE.txt,242487,243530,1043,10,N,N,-,-1,-1
MULIFE.txt,242594,243749,1155,10,N,N,-,-1,-1
MULIFE.txt,242654,243854,1200,10,N,N,-,-1,-1
MULIFE.txt,242704,243917,1213,10,N,N,-,-1,-1
MULIFE.txt,242861,244050,1189,10,N,N,-,-1,-1
MULIFE.txt,242928,244131,1203,10,N,N,-,-1,-1
MULIFE.txt,243096,244357,1261,10,N,N,-,-1,-1
MULIFE.txt,243123,244496,1373,10,N,N,-,-1,-1
MULIFE.txt,243320,244587,1267,10,N,N,-,-1,-1
MULIFE.txt,243493,244644,1151,10,N,N,-,-1,-1
MULIFE.txt,243531,244739,1208,10,N,N,-,-1,-1
MULIFE.txt,243752,244931,1179,10,N,N,-,-1,-1
MULIFE.txt,243855,245002,1147,10,N,N,-,-1,-1
MULIFE.txt,243919,245093,1174,10,N,N,-,-1,-1
MULIFE.txt,244051,245170,1119,10,N,N,-,-1,-1
MULIFE.txt,244133,245348,1215,10,N,N,-,-1,-1
MULIFE.txt,244359,245459,1100,10,N,N,-,-1,-1
MULIFE.txt,244497,245518,1021,10,N,N,-,-1,-1
MULIFE.txt,244588,245676,1088,10,N,N,-,-1,-1
MULIFE.txt,244645,245924,1279,10,N,N,-,-1,-1
MULIFE.txt,244741,245976,1235,10,N,N,-,-1,-1
MULIFE.txt,244934,246041,1107,10,N,N,-,-1,-1
MULIFE.txt,245003,246147,1144,10,N,N,-,-1,-1
MULIFE.txt,245095,246211,1116,10,N,N,-,-1,-1
MULIFE.txt,245171,246648,1477,10,N,N,-,-1,-1
MULIFE.txt,245349,246661,1312,10,N,N,-,-1,-1
MULIFE.txt,245460,246773,1313,10,N,N,-,-1,-1
MULIFE.txt,245519,246888,1369,10,N,N,-,-1,-1
MULIFE.txt,245677,247113,1436,10,N,N,-,-1,-1
MULIFE.txt,245925,247345,1420,10,N,N,-,-1,-1
MULIFE.txt,245979,247431,1452,10,N,N,-,-1,-1
MULIFE.txt,246044,247598,1554,10,N,N,-,-1,-1
MULIFE.txt,246148,247818,1670,10,N,N,-,-1,-1
MULIFE.txt,246213,247896,1683,10,N,N,-,-1,-1
MULIFE.txt,246651,248156,1505,10,N,N,-,-1,-1
MULIFE.txt,246662,248194,1532,10,N,N,-,-1,-1
MULIFE.txt,246774,248381,1607,10,N,N,-,-1,-1
MULIFE.txt,246889,248513,1624,10,N,N,-,-1,-1
MULIFE.txt,247114,248578,1464,10,N,N,-,-1,-1
MULIFE.txt,247346,248587,1241,10,N,N,-,-1,-1
MULIFE.txt,247432,248667,1235,10,N,N,-,-1,-1
MULIFE.txt,247601,248851,1250,10,N,N,-,-1,-1
MULIFE.txt,247819,248885,1066,10,N,N,-,-1,-1
MULIFE.txt,247898,249015,1117,10,N,N,-,-1,-1
MULIFE.txt,248157,249428,1271,10,N,N,-,-1,-1
MULIFE.txt,248195,249513,1318,10,N,N,-,-1,-1
MULIFE.txt,248383,249891,1508,10,N,N,-,-1,-1
MULIFE.txt,248516,250052,1536,10,N,N,-,-1,-1
MULIFE.txt,248579,250116,1537,10,N,N,-,-1,-1
MULIFE.txt,248588,250181,1593,10,N,N,-,-1,-1
MULIFE.txt,248668,250228,1560,10,N,N,-,-1,-1
MULIFE.txt,248854,250350,1496,10,N,N,-,-1,-1
MULIFE.txt,248886,250436,1550,10,N,N,-,-1,-1
MULIFE.txt,249017,250552,1535,10,N,N,-,-1,-1
MULIFE.txt,249431,250771,1340,10,N,N,-,-1,-1
MULIFE.txt,249514,250966,1452,10,N,N,-,-1,-1
MULIFE.txt,249893,251328,1435,10,Y,N,-,-1,-1
MULIFE.txt,250055,251386,1331,10,N,N,-,-1,-1
MULIFE.txt,250117,251720,1603,10,Y,N,-,-1,-1
MULIFE.txt,250182,251743,1561,10,N,N,-,-1,-1
MULIFE.txt,250229,251777,1548,10,N,N,-,-1,-1
MULIFE.txt,250351,251819,1468,10,N,N,-,-1,-1
MULIFE.txt,250437,251923,1486,10,N,N,-,-1,-1
MULIFE.txt,250553,251951,1398,10,N,N,-,-1,-1
MULIFE.txt,250772,252192,1420,10,N,N,-,-1,-1
MULIFE.txt,250969,252318,1349,10,N,N,-,-1,-1
MULIFE.txt,251329,252454,1125,10,N,N,-,-1,-1
MULIFE.txt,251387,252529,1142,10,N,N,-,-1,-1
MULIFE.txt,251725,252735,1010,10,N,N,-,-1,-1
MULIFE.txt,251748,252866,1118,10,N,N,-,-1,-1
MULIFE.txt,251782,253022,1240,10,N,N,-,-1,-1
MULIFE.txt,251820,253104,1284,10,N,N,-,-1,-1
MULIFE.txt,251924,253564,1640,10,N,N,-,-1,-1
MULIFE.txt,251954,253730,1776,10,N,N,-,-1,-1
MULIFE.txt,252193,253752,1559,10,N,N,-,-1,-1
MULIFE.txt,252319,253974,1655,10,N,N,-,-1,-1
MULIFE.txt,252456,254107,1651,10,N,N,-,-1,-1
MULIFE.txt,252530,254369,1839,10,N,N,-,-1,-1
MULIFE.txt,252738,254416,1678,10,N,N,-,-1,-1
MULIFE.txt,252867,254640,1773,10,N,N,-,-1,-1
MULIFE.txt,253023,254988,1965,10,N,N,-,-1,-1
MULIFE.txt,253105,255373,2268,10,N,N,-,-1,-1
MULIFE.txt,253567,255545,1978,10,N,N,-,-1,-1
MULIFE.txt,253731,255842,2111,10,N,N,-,-1,-1
MULIFE.txt,253753,255957,2204,10,N,N,-,-1,-1
MULIFE.txt,253975,256030,2055,10,N,N,-,-1,-1
MULIFE.txt,254108,256334,2226,10,N,N,-,-1,-1
MULIFE.txt,254370,256385,2015,10,N,N,-,-1,-1
MULIFE.txt,254419,256635,2216,10,N,N,-,-1,-1
MULIFE.txt,254643,256855,2212,10,N,N,-,-1,-1
MULIFE.txt,254991,257463,2472,10,N,N,-,-1,-1
MULIFE.txt,255374,257680,2306,10,N,N,-,-1,-1
MULIFE.txt,255546,257688,2142,10,N,N,-,-1,-1
MULIFE.txt,255843,257705,1862,10,N,N,-,-1,-1
MULIFE.txt,255958,257742,1784,10,N,N,-,-1,-1
MULIFE.txt,256033,257793,1760,10,N,N,-,-1,-1
MULIFE.txt,256337,257912,1575,10,N,N,-,-1,-1
MULIFE.txt,256386,257960,1574,10,N,N,-,-1,-1
MULIFE.txt,256638,258124,1486,10,N,N,-,-1,-1
MULIFE.txt,256855,258303,1448,10,N,N,-,-1,-1
MULIFE.txt,257466,258449,983,10,N,N,-,-1,-1
MULIFE.txt,257685,258557,872,10,N,N,-,-1,-1
MULIFE.txt,257691,258637,946,10,N,N,-,-1,-1
MULIFE.txt,257708,258839,1131,10,N,N,-,-1,-1
MULIFE.txt,257743,258978,1235,10,N,N,-,-1,-1
MULIFE.txt,257794,259016,1222,10,N,N,-,-1,-1
MULIFE.txt,257913,259148,1235,10,N,N,-,-1,-1
MULIFE.txt,257961,259204,1243,10,N,N,-,-1,-1
MULIFE.txt,258125,259219,1094,10,N,N,-,-1,-1
MULIFE.txt,258304,259338,1034,10,N,N,-,-1,-1
MULIFE.txt,258450,259442,992,10,N,N,-,-1,-1
MULIFE.txt,258558,259505,947,10,N,N,-,-1,-1
MULIFE.txt,258638,259584,946,10,N,N,-,-1,-1
MULIFE.txt,258840,259607,767,10,N,N,-,-1,-1
MULIFE.txt,258981,259710,729,10,N,N,-,-1,-1
MULIFE.txt,259017,259799,782,10,N,N,-,-1,-1
MULIFE.txt,259151,259917,766,10,N,N,-,-1,-1
MULIFE.txt,259207,260027,820,10,N,N,-,-1,-1
MULIFE.txt,259220,260071,851,10,N,N,-,-1,-1
MULIFE.txt,259339,260087,748,10,N,N,-,-1,-1
MULIFE.txt,259443,260185,742,10,N,N,-,-1,-1
MULIFE.txt,259507,260235,728,10,N,N,-,-1,-1
MULIFE.txt,259585,260338,753,10,N,N,-,-1,-1
MULIFE.txt,259608,260521,913,10,N,N,-,-1,-1
MULIFE.txt,259711,260620,909,10,N,N,-,-1,-1
MULIFE.txt,259801,260700,899,10,N,N,-,-1,-1
MULIFE.txt,259918,260727,809,10,N,N,-,-1,-1
MULIFE.txt,260028,260800,772,10,N,N,-,-1,-1
MULIFE.txt,260072,261004,932,10,N,N,-,-1,-1
MULIFE.txt,260088,261255,1167,10,N,N,-,-1,-1
MULIFE.txt,260188,261345,1157,10,N,N,-,-1,-1
MULIFE.txt,260236,261452,1216,10,N,N,-,-1,-1
MULIFE.txt,260339,261611,1272,10,N,N,-,-1,-1
MULIFE.txt,260524,261750,1226,10,N,N,-,-1,-1
MULIFE.txt,260621,261791,1170,10,N,N,-,-1,-1
MULIFE.txt,260701,261871,1170,10,N,N,-,-1,-1
MULIFE.txt,260728,261960,1232,10,N,N,-,-1,-1
MULIFE.txt,260801,262077,1276,10,N,N,-,-1,-1
MULIFE.txt,261005,262176,1171,10,N,N,-,-1,-1
MULIFE.txt,261256,262222,966,10,N,N,-,-1,-1
MULIFE.txt,261346,262285,939,10,N,N,-,-1,-1
MULIFE.txt,261453,262351,898,10,N,N,-,-1,-1
MULIFE.txt,261612,262438,826,10,N,N,-,-1,-1
MULIFE.txt,261751,262720,969,10,N,N,-,-1,-1
MULIFE.txt,261792,262827,1035,10,N,N,-,-1,-1
MULIFE.txt,261872,262908,1036,10,N,N,-,-1,-1
MULIFE.txt,261961,262996,1035,10,N,N,-,-1,-1
MULIFE.txt,262078,263189,1111,10,N,N,-,-1,-1
MULIFE.txt,262177,263264,1087,10,N,N,-,-1,-1
MULIFE.txt,262223,263296,1073,10,N,N,-,-1,-1
MULIFE.txt,262286,263352,1066,10,N,N,-,-1,-1
MULIFE.txt,262352,263476,1124,10,N,N,-,-1,-1
MULIFE.txt,262439,263530,1091,10,N,N,-,-1,-1
MULIFE.txt,262721,263567,846,10,N,N,-,-1,-1
MULIFE.txt,262830,263685,855,10,N,N,-,-1,-1
MULIFE.txt,262909,263925,1016,10,N,N,-,-1,-1
MULIFE.txt,262998,264020,1022,10,N,N,-,-1,-1
MULIFE.txt,263190,264045,855,10,N,N,-,-1,-1
MULIFE.txt,263265,264092,827,10,N,N,-,-1,-1
MULIFE.txt,263299,264797,1498,10,N,N,-,-1,-1
MULIFE.txt,263353,264919,1566,10,N,N,-,-1,-1
MULIFE.txt,263479,265023,1544,10,N,N,-,-1,-1
MULIFE.txt,263532,265046,1514,10,N,N,-,-1,-1
MULIFE.txt,263568,265104,1536,10,N,N,-,-1,-1
MULIFE.txt,263686,265110,1424,10,N,N,-,-1,-1
MULIFE.txt,263928,265111,1183,10,N,N,-,-1,-1
MULIFE.txt,264021,265181,1160,10,N,N,-,-1,-1
MULIFE.txt,264046,265368,1322,10,N,N,-,-1,-1
MULIFE.txt,264095,265621,1526,10,N,N,-,-1,-1
MULIFE.txt,264798,266042,1244,10,N,N,-,-1,-1
MULIFE.txt,264922,266318,1396,10,N,N,-,-1,-1
MULIFE.txt,265024,266390,1366,10,N,N,-,-1,-1
MULIFE.txt,265047,266479,1432,10,N,N,-,-1,-1
MULIFE.txt,265104,266483,1379,10,N,N,-,-1,-1
MULIFE.txt,265110,266625,1515,10,N,N,-,-1,-1
MULIFE.txt,265111,267141,2030,10,N,N,-,-1,-1
MULIFE.txt,265182,267386,2204,10,N,N,-,-1,-1
MULIFE.txt,265369,267432,2063,10,N,N,-,-1,-1
MULIFE.txt,265622,267508,1886,10,N,N,-,-1,-1
MULIFE.txt,266043,267651,1608,10,N,N,-,-1,-1
MULIFE.txt,266319,267790,1471,10,N,N,-,-1,-1
MULIFE.txt,266393,267891,1498,10,N,N,-,-1,-1
MULIFE.txt,266482,268285,1803,10,N,N,-,-1,-1
MULIFE.txt,266486,268319,1833,10,N,N,-,-1,-1
MULIFE.txt,266626,268383,1757,10,N,N,-,-1,-1
MULIFE.txt,267142,268401,1259,10,N,N,-,-1,-1
MULIFE.txt,267389,268507,1118,10,N,N,-,-1,-1
MULIFE.txt,267433,268536,1103,10,N,N,-,-1,-1
MULIFE.txt,267509,268919,1410,10,N,N,-,-1,-1
MULIFE.txt,267652,269364,1712,10,N,N,-,-1,-1
MULIFE.txt,267791,269540,1749,10,N,N,-,-1,-1
MULIFE.txt,267892,269727,1835,10,N,N,-,-1,-1
MULIFE.txt,268288,269749,1461,10,N,N,-,-1,-1
MULIFE.txt,268320,269765,1445,10,N,N,-,-1,-1
MULIFE.txt,268384,269801,1417,10,N,N,-,-1,-1
MULIFE.txt,268402,270008,1606,10,N,N,-,-1,-1
MULIFE.txt,268508,270118,1610,10,N,N,-,-1,-1
MULIFE.txt,268537,270350,1813,10,N,N,-,-1,-1
MULIFE.txt,268920,270374,1454,10,N,N,-,-1,-1
MULIFE.txt,269367,270472,1105,10,N,N,-,-1,-1
MULIFE.txt,269543,270492,949,10,N,N,-,-1,-1
MULIFE.txt,269728,270590,862,10,N,N,-,-1,-1
MULIFE.txt,269750,270601,851,10,N,N,-,-1,-1
MULIFE.txt,269768,270647,879,10,N,N,-,-1,-1
MULIFE.txt,269802,270725,923,10,N,N,-,-1,-1
MULIFE.txt,270009,270732,723,10,N,N,-,-1,-1
MULIFE.txt,270119,271051,932,10,N,N,-,-1,-1
MULIFE.txt,270353,271058,705,10,N,N,-,-1,-1
MULIFE.txt,270375,271067,692,10,N,N,-,-1,-1
MULIFE.txt,270473,271222,749,10,N,N,-,-1,-1
MULIFE.txt,270493,271241,748,10,N,N,-,-1,-1
MULIFE.txt,270591,271455,864,10,N,N,-,-1,-1
MULIFE.txt,270602,271531,929,10,N,N,-,-1,-1
MULIFE.txt,270648,271642,994,10,N,N,-,-1,-1
MULIFE.txt,270726,271839,1113,10,N,N,-,-1,-1
MULIFE.txt,270733,271891,1158,10,N,N,-,-1,-1
MULIFE.txt,271052,272012,960,10,N,N,-,-1,-1
MULIFE.txt,271059,272041,982,10,N,N,-,-1,-1
MULIFE.txt,271068,272150,1082,10,N,N,-,-1,-1
MULIFE.txt,271225,272290,1065,10,N,N,-,-1,-1
MULIFE.txt,271242,272313,1071,10,N,N,-,-1,-1
MULIFE.txt,271457,272484,1027,10,N,N,-,-1,-1
MULIFE.txt,271532,272787,1255,10,N,N,-,-1,-1
MULIFE.txt,271643,272815,1172,10,N,N,-,-1,-1
MULIFE.txt,271840,272869,1029,10,N,N,-,-1,-1
MULIFE.txt,271892,272874,982,10,N,N,-,-1,-1
MULIFE.txt,272013,272946,933,10,N,N,-,-1,-1
MULIFE.txt,272042,272951,909,10,N,N,-,-1,-1
MULIFE.txt,272151,273143,992,10,N,N,-,-1,-1
MULIFE.txt,272295,273148,853,10,N,N,-,-1,-1
MULIFE.txt,272316,273186,870,10,N,N,-,-1,-1
MULIFE.txt,272485,273314,829,10,N,N,-,-1,-1
MULIFE.txt,272788,273358,570,10,N,N,-,-1,-1
MULIFE.txt,272816,273410,594,10,N,N,-,-1,-1
MULIFE.txt,272872,273429,557,10,N,N,-,-1,-1
MULIFE.txt,272875,273502,627,10,N,N,-,-1,-1
MULIFE.txt,272949,273594,645,10,N,N,-,-1,-1
MULIFE.txt,272952,273692,740,10,N,N,-,-1,-1
MULIFE.txt,273146,273733,587,10,N,N,-,-1,-1
MULIFE.txt,273149,273825,676,10,N,N,-,-1,-1
MULIFE.txt,273187,274141,954,10,N,N,-,-1,-1
MULIFE.txt,273317,274395,1078,10,N,N,-,-1,-1
MULIFE.txt,273359,274519,1160,10,N,N,-,-1,-1
MULIFE.txt,273411,274556,1145,10,N,N,-,-1,-1
MULIFE.txt,273430,274622,1192,10,N,N,-,-1,-1
MULIFE.txt,273503,274664,1161,10,N,N,-,-1,-1
MULIFE.txt,273597,274698,1101,10,N,N,-,-1,-1
MULIFE.txt,273693,274758,1065,10,N,N,-,-1,-1
MULIFE.txt,273734,274989,1255,10,N,Y,1448315575026,182236,182361
MULIFE.txt,273826,275150,1324,10,N,Y,1448315575026,182236,182361
MULIFE.txt,274143,275231,1088,10,N,Y,1448315575026,182236,182361
MULIFE.txt,274396,275296,900,10,N,Y,1448315575026,182236,182361
MULIFE.txt,274520,275430,910,10,N,Y,1448315575026,182236,182361
MULIFE.txt,274557,275718,1161,10,Y,Y,1448315575026,182236,182361
MULIFE.txt,274624,275888,1264,10,Y,Y,1448315575026,182236,182361
MULIFE.txt,274665,276473,1808,10,Y,Y,1448315575026,182236,182361
MULIFE.txt,274699,276665,1966,10,Y,Y,1448315575026,182236,182361
MULIFE.txt,274759,276805,2046,10,Y,Y,1448315575026,182236,182361
MULIFE.txt,274990,276870,1880,10,Y,Y,1448315575026,182236,182361
MULIFE.txt,275153,276904,1751,10,Y,Y,1448315575026,182236,182361
MULIFE.txt,275234,276932,1698,10,Y,Y,1448315575026,182236,182361
MULIFE.txt,275297,276990,1693,10,Y,Y,1448315575026,182236,182361
MULIFE.txt,275431,277074,1643,10,Y,Y,1448315575026,182236,182361
MULIFE.txt,275720,277230,1510,10,Y,Y,1448315575026,182236,182361
MULIFE.txt,275889,277432,1543,10,Y,Y,1448315575026,182236,182361
MULIFE.txt,276474,277560,1086,10,N,Y,1448315575026,182236,182361
MULIFE.txt,276668,277595,927,10,N,N,-,-1,-1
MULIFE.txt,276806,277857,1051,10,N,N,-,-1,-1
MULIFE.txt,276871,278142,1271,10,N,N,-,-1,-1
MULIFE.txt,276905,278285,1380,10,N,N,-,-1,-1
MULIFE.txt,276933,278315,1382,10,N,N,-,-1,-1
MULIFE.txt,276991,278638,1647,10,N,N,-,-1,-1
MULIFE.txt,277075,278645,1570,10,N,N,-,-1,-1
MULIFE.txt,277231,278855,1624,10,N,N,-,-1,-1
MULIFE.txt,277435,278886,1451,10,N,N,-,-1,-1
MULIFE.txt,277561,278923,1362,10,N,N,-,-1,-1
MULIFE.txt,277596,279013,1417,10,N,N,-,-1,-1
MULIFE.txt,277858,279242,1384,10,N,N,-,-1,-1
MULIFE.txt,278143,279433,1290,10,N,N,-,-1,-1
MULIFE.txt,278288,279476,1188,10,N,N,-,-1,-1
MULIFE.txt,278318,279497,1179,10,N,N,-,-1,-1
MULIFE.txt,278639,279800,1161,10,N,N,-,-1,-1
MULIFE.txt,278647,279983,1336,10,N,N,-,-1,-1
MULIFE.txt,278856,280153,1297,10,N,N,-,-1,-1
MULIFE.txt,278887,280303,1416,10,N,N,-,-1,-1
MULIFE.txt,278924,280369,1445,10,N,N,-,-1,-1
MULIFE.txt,279014,280453,1439,10,N,N,-,-1,-1
MULIFE.txt,279245,280466,1221,10,N,N,-,-1,-1
MULIFE.txt,279434,280649,1215,10,N,N,-,-1,-1
MULIFE.txt,279477,280743,1266,10,N,N,-,-1,-1
MULIFE.txt,279498,281149,1651,10,N,N,-,-1,-1
MULIFE.txt,279801,281184,1383,10,N,N,-,-1,-1
MULIFE.txt,279986,281283,1297,10,N,N,-,-1,-1
MULIFE.txt,280154,281498,1344,10,N,N,-,-1,-1
MULIFE.txt,280304,282217,1913,10,N,N,-,-1,-1
MULIFE.txt,280370,282241,1871,10,N,N,-,-1,-1
MULIFE.txt,280454,282254,1800,10,N,N,-,-1,-1
MULIFE.txt,280467,282489,2022,10,N,N,-,-1,-1
MULIFE.txt,280650,282573,1923,10,N,N,-,-1,-1
MULIFE.txt,280744,282780,2036,10,N,N,-,-1,-1
MULIFE.txt,281150,282846,1696,10,N,N,-,-1,-1
MULIFE.txt,281187,283071,1884,10,N,N,-,-1,-1
MULIFE.txt,281284,283151,1867,10,N,N,-,-1,-1
MULIFE.txt,281500,283189,1689,10,N,N,-,-1,-1
MULIFE.txt,282218,283208,990,10,N,N,-,-1,-1
MULIFE.txt,282242,283245,1003,10,N,N,-,-1,-1
MULIFE.txt,282255,283467,1212,10,N,N,-,-1,-1
MULIFE.txt,282491,283533,1042,10,N,N,-,-1,-1
MULIFE.txt,282574,283540,966,10,N,N,-,-1,-1
MULIFE.txt,282781,283615,834,10,N,N,-,-1,-1
MULIFE.txt,282847,283883,1036,10,N,N,-,-1,-1
MULIFE.txt,283074,283962,888,10,N,N,-,-1,-1
MULIFE.txt,283152,284281,1129,10,N,N,-,-1,-1
MULIFE.txt,283192,284371,1179,10,N,N,-,-1,-1
MULIFE.txt,283209,284414,1205,10,N,N,-,-1,-1
MULIFE.txt,283247,284485,1238,10,N,N,-,-1,-1
MULIFE.txt,283468,284777,1309,10,N,N,-,-1,-1
MULIFE.txt,283534,284814,1280,10,N,N,-,-1,-1
MULIFE.txt,283541,284879,1338,10,N,N,-,-1,-1
MULIFE.txt,283616,284950,1334,10,N,N,-,-1,-1
MULIFE.txt,283886,285443,1557,10,N,N,-,-1,-1
MULIFE.txt,283965,285560,1595,10,N,N,-,-1,-1
MULIFE.txt,284282,285859,1577,10,N,N,-,-1,-1
MULIFE.txt,284372,285903,1531,10,N,N,-,-1,-1
MULIFE.txt,284415,286305,1890,10,Y,N,-,-1,-1
MULIFE.txt,284486,286492,2006,10,N,N,-,-1,-1
MULIFE.txt,284778,286611,1833,10,N,N,-,-1,-1
MULIFE.txt,284815,286646,1831,10,N,N,-,-1,-1
MULIFE.txt,284880,286826,1946,10,N,N,-,-1,-1
MULIFE.txt,284952,286978,2026,10,N,N,-,-1,-1
MULIFE.txt,285444,287068,1624,10,N,N,-,-1,-1
MULIFE.txt,285561,287451,1890,10,N,N,-,-1,-1
MULIFE.txt,285862,287532,1670,10,N,N,-,-1,-1
MULIFE.txt,285904,287611,1707,10,N,N,-,-1,-1
MULIFE.txt,286305,287792,1487,10,N,N,-,-1,-1
MULIFE.txt,286493,287945,1452,10,N,N,-,-1,-1
MULIFE.txt,286614,287978,1364,10,N,N,-,-1,-1
MULIFE.txt,286647,288040,1393,10,N,N,-,-1,-1
MULIFE.txt,286829,288083,1254,10,N,N,-,-1,-1
MULIFE.txt,286979,288171,1192,10,N,N,-,-1,-1
MULIFE.txt,287071,288234,1163,10,N,N,-,-1,-1
MULIFE.txt,287452,288261,809,10,N,N,-,-1,-1
MULIFE.txt,287534,288503,969,10,N,N,-,-1,-1
MULIFE.txt,287612,288528,916,10,N,N,-,-1,-1
MULIFE.txt,287793,288589,796,10,N,N,-,-1,-1
MULIFE.txt,287948,288627,679,10,N,N,-,-1,-1
MULIFE.txt,287979,288694,715,10,N,N,-,-1,-1
MULIFE.txt,288043,288794,751,10,N,N,-,-1,-1
MULIFE.txt,288084,288844,760,10,N,N,-,-1,-1
MULIFE.txt,288172,288925,753,10,N,N,-,-1,-1
MULIFE.txt,288235,288978,743,10,N,N,-,-1,-1
MULIFE.txt,288264,288995,731,10,N,N,-,-1,-1
MULIFE.txt,288504,289014,510,10,N,N,-,-1,-1
MULIFE.txt,288529,289066,537,10,N,N,-,-1,-1
MULIFE.txt,288590,289220,630,10,N,N,-,-1,-1
MULIFE.txt,288630,289421,791,10,N,N,-,-1,-1
MULIFE.txt,288695,289620,925,10,N,N,-,-1,-1
MULIFE.txt,288797,289727,930,10,N,N,-,-1,-1
MULIFE.txt,288845,289733,888,10,N,N,-,-1,-1
MULIFE.txt,288926,289929,1003,10,N,N,-,-1,-1
MULIFE.txt,288979,289979,1000,10,N,N,-,-1,-1
MULIFE.txt,288996,290214,1218,10,N,N,-,-1,-1
MULIFE.txt,289015,290270,1255,10,N,N,-,-1,-1
MULIFE.txt,289068,290990,1922,10,N,N,-,-1,-1
MULIFE.txt,289221,291047,1826,10,N,N,-,-1,-1
MULIFE.txt,289422,291422,2000,10,N,N,-,-1,-1
MULIFE.txt,289623,291448,1825,10,N,N,-,-1,-1
MULIFE.txt,289729,291641,1912,10,N,N,-,-1,-1
MULIFE.txt,289736,291764,2028,10,N,N,-,-1,-1
MULIFE.txt,289932,291961,2029,10,N,N,-,-1,-1
MULIFE.txt,289980,292140,2160,10,N,N,-,-1,-1
MULIFE.txt,290215,292246,2031,10,N,N,-,-1,-1
MULIFE.txt,290271,292457,2186,10,N,N,-,-1,-1
MULIFE.txt,290993,292552,1559,10,N,N,-,-1,-1
MULIFE.txt,291050,292983,1933,10,N,N,-,-1,-1
MULIFE.txt,291423,293215,1792,10,N,N,-,-1,-1
MULIFE.txt,291449,293384,1935,10,N,N,-,-1,-1
MULIFE.txt,291644,293509,1865,10,N,N,-,-1,-1
MULIFE.txt,291765,293770,2005,10,N,N,-,-1,-1
MULIFE.txt,291962,294003,2041,10,N,N,-,-1,-1
MULIFE.txt,292141,294158,2017,10,N,N,-,-1,-1
MULIFE.txt,292247,294394,2147,10,N,N,-,-1,-1
MULIFE.txt,292458,294537,2079,10,N,N,-,-1,-1
MULIFE.txt,292553,294575,2022,10,N,N,-,-1,-1
MULIFE.txt,292986,294865,1879,10,N,N,-,-1,-1
MULIFE.txt,293216,295199,1983,10,N,N,-,-1,-1
MULIFE.txt,293387,295276,1889,10,N,N,-,-1,-1
MULIFE.txt,293510,295579,2069,10,N,N,-,-1,-1
MULIFE.txt,293771,295633,1862,10,N,N,-,-1,-1
MULIFE.txt,294004,295679,1675,10,N,N,-,-1,-1
MULIFE.txt,294160,295810,1650,10,N,N,-,-1,-1
MULIFE.txt,294395,295845,1450,10,Y,N,-,-1,-1
MULIFE.txt,294542,296102,1560,10,Y,N,-,-1,-1
MULIFE.txt,294576,296296,1720,10,Y,N,-,-1,-1
MULIFE.txt,294867,296389,1522,10,Y,N,-,-1,-1
MULIFE.txt,295200,296587,1387,10,Y,N,-,-1,-1
MULIFE.txt,295277,296623,1346,10,N,N,-,-1,-1
MULIFE.txt,295580,296781,1201,10,Y,N,-,-1,-1
MULIFE.txt,295634,297095,1461,10,Y,N,-,-1,-1
MULIFE.txt,295682,297218,1536,10,Y,N,-,-1,-1
MULIFE.txt,295811,297227,1416,10,Y,N,-,-1,-1
MULIFE.txt,295848,297258,1410,10,Y,N,-,-1,-1
MULIFE.txt,296105,297295,1190,10,Y,N,-,-1,-1
MULIFE.txt,296298,297608,1310,10,N,N,-,-1,-1
MULIFE.txt,296390,297621,1231,10,N,N,-,-1,-1
MULIFE.txt,296589,297732,1143,10,N,N,-,-1,-1
MULIFE.txt,296624,297815,1191,10,N,N,-,-1,-1
MULIFE.txt,296782,298024,1242,10,N,N,-,-1,-1
MULIFE.txt,297098,298206,1108,10,N,N,-,-1,-1
MULIFE.txt,297219,298513,1294,10,N,N,-,-1,-1
MULIFE.txt,297228,298593,1365,10,N,N,-,-1,-1
MULIFE.txt,297260,299058,1798,10,N,N,-,-1,-1
MULIFE.txt,297296,299210,1914,10,N,N,-,-1,-1
MULIFE.txt,297609,299314,1705,10,N,N,-,-1,-1
MULIFE.txt,297622,299642,2020,10,N,N,-,-1,-1
MULIFE.txt,297733,299679,1946,10,N,N,-,-1,-1
MULIFE.txt,297816,299736,1920,10,N,N,-,-1,-1
MULIFE.txt,298026,299804,1778,10,N,N,-,-1,-1
MULIFE.txt,298208,299982,1774,10,N,N,-,-1,-1
MULIFE.txt,298514,300304,1790,10,N,N,-,-1,-1
MULIFE.txt,298596,300531,1935,10,N,N,-,-1,-1
MULIFE.txt,299061,300575,1514,10,N,N,-,-1,-1
MULIFE.txt,299213,300686,1473,10,N,N,-,-1,-1
MULIFE.txt,299315,300714,1399,10,N,N,-,-1,-1
MULIFE.txt,299645,300789,1144,10,N,N,-,-1,-1
MULIFE.txt,299680,300876,1196,10,N,N,-,-1,-1
MULIFE.txt,299737,301036,1299,10,N,N,-,-1,-1
MULIFE.txt,299806,301063,1257,10,N,N,-,-1,-1
MULIFE.txt,299983,301166,1183,10,N,N,-,-1,-1
MULIFE.txt,300305,301305,1000,10,N,N,-,-1,-1
MULIFE.txt,300532,301377,845,10,N,N,-,-1,-1
MULIFE.txt,300576,301437,861,10,N,N,-,-1,-1
MULIFE.txt,300691,301548,857,10,N,N,-,-1,-1
MULIFE.txt,300715,301575,860,10,N,N,-,-1,-1
MULIFE.txt,300790,301633,843,10,N,N,-,-1,-1
MULIFE.txt,300877,301852,975,10,N,N,-,-1,-1
MULIFE.txt,301037,301914,877,10,N,N,-,-1,-1
MULIFE.txt,301064,301960,896,10,N,N,-,-1,-1
MULIFE.txt,301167,302040,873,10,N,N,-,-1,-1
MULIFE.txt,301308,302048,740,10,N,N,-,-1,-1
MULIFE.txt,301378,302203,825,10,N,N,-,-1,-1
MULIFE.txt,301438,302252,814,10,N,N,-,-1,-1
MULIFE.txt,301549,302375,826,10,N,N,-,-1,-1
MULIFE.txt,301576,302418,842,10,N,N,-,-1,-1
MULIFE.txt,301634,302574,940,10,N,N,-,-1,-1
MULIFE.txt,301853,302719,866,10,N,N,-,-1,-1
MULIFE.txt,301915,303063,1148,10,N,N,-,-1,-1
MULIFE.txt,301961,303224,1263,10,N,N,-,-1,-1
MULIFE.txt,302041,303336,1295,10,N,N,-,-1,-1
MULIFE.txt,302048,303473,1425,10,N,N,-,-1,-1
MULIFE.txt,302206,303486,1280,10,N,N,-,-1,-1
MULIFE.txt,302253,303686,1433,10,N,N,-,-1,-1
MULIFE.txt,302376,303705,1329,10,N,N,-,-1,-1
MULIFE.txt,302419,303908,1489,10,N,N,-,-1,-1
MULIFE.txt,302575,304136,1561,10,N,N,-,-1,-1
MULIFE.txt,302720,304239,1519,10,N,N,-,-1,-1
MULIFE.txt,303064,304316,1252,10,N,N,-,-1,-1
MULIFE.txt,303225,304550,1325,10,N,N,-,-1,-1
MULIFE.txt,303339,304561,1222,10,N,N,-,-1,-1
MULIFE.txt,303474,304786,1312,10,N,N,-,-1,-1
MULIFE.txt,303487,305030,1543,10,N,N,-,-1,-1
MULIFE.txt,303687,305170,1483,10,N,N,-,-1,-1
MULIFE.txt,303706,305203,1497,10,Y,N,-,-1,-1
MULIFE.txt,303909,305242,1333,10,Y,N,-,-1,-1
MULIFE.txt,304137,305414,1277,10,Y,N,-,-1,-1
MULIFE.txt,304240,305419,1179,10,N,N,-,-1,-1
MULIFE.txt,304317,305515,1198,10,N,N,-,-1,-1
MULIFE.txt,304551,305520,969,10,N,N,-,-1,-1
MULIFE.txt,304563,305633,1070,10,N,N,-,-1,-1
MULIFE.txt,304788,305638,850,10,N,N,-,-1,-1
MULIFE.txt,305031,305956,925,10,N,N,-,-1,-1
MULIFE.txt,305173,306149,976,10,N,N,-,-1,-1
MULIFE.txt,305204,306211,1007,10,N,N,-,-1,-1
MULIFE.txt,305245,306216,971,10,N,N,-,-1,-1
MULIFE.txt,305417,306268,851,10,N,N,-,-1,-1
MULIFE.txt,305420,306403,983,10,N,N,-,-1,-1
MULIFE.txt,305518,306581,1063,10,N,N,-,-1,-1
MULIFE.txt,305521,306770,1249,10,N,N,-,-1,-1
MULIFE.txt,305636,307163,1527,10,N,N,-,-1,-1
MULIFE.txt,305639,307413,1774,10,N,N,-,-1,-1
MULIFE.txt,305957,307565,1608,10,N,N,-,-1,-1
MULIFE.txt,306150,307704,1554,10,N,N,-,-1,-1
MULIFE.txt,306214,307764,1550,10,N,N,-,-1,-1
MULIFE.txt,306217,307771,1554,10,N,N,-,-1,-1
MULIFE.txt,306270,307860,1590,10,N,N,-,-1,-1
MULIFE.txt,306404,307897,1493,10,N,N,-,-1,-1
MULIFE.txt,306582,307954,1372,10,N,N,-,-1,-1
MULIFE.txt,306771,307981,1210,10,N,N,-,-1,-1
MULIFE.txt,307166,308004,838,10,N,N,-,-1,-1
MULIFE.txt,307414,308033,619,10,N,N,-,-1,-1
MULIFE.txt,307566,308063,497,10,N,N,-,-1,-1
MULIFE.txt,307707,308087,380,10,N,N,-,-1,-1
MULIFE.txt,307767,308113,346,10,N,N,-,-1,-1
MULIFE.txt,307772,308139,367,10,N,N,-,-1,-1
MULIFE.txt,307861,308164,303,10,N,N,-,-1,-1
MULIFE.txt,307898,308199,301,10,N,N,-,-1,-1
MULIFE.txt,307957,308211,254,10,N,N,-,-1,-1
MULIFE.txt,307982,308254,272,10,N,N,-,-1,-1
MULIFE.txt,308007,308377,370,10,N,N,-,-1,-1
MULIFE.txt,308034,308455,421,10,N,N,-,-1,-1
MULIFE.txt,308066,308527,461,10,N,N,-,-1,-1
MULIFE.txt,308088,308617,529,10,N,N,-,-1,-1
MULIFE.txt,308114,308673,559,10,N,N,-,-1,-1
MULIFE.txt,308140,308903,763,10,N,N,-,-1,-1
MULIFE.txt,308165,308984,819,10,N,N,-,-1,-1
MULIFE.txt,308202,309023,821,10,N,N,-,-1,-1
MULIFE.txt,308212,309317,1105,10,N,N,-,-1,-1
MULIFE.txt,308255,309741,1486,10,N,N,-,-1,-1
MULIFE.txt,308380,310206,1826,10,N,N,-,-1,-1
MULIFE.txt,308456,310423,1967,10,N,N,-,-1,-1
MULIFE.txt,308528,310564,2036,10,N,N,-,-1,-1
MULIFE.txt,308618,310716,2098,10,N,N,-,-1,-1
MULIFE.txt,308674,310872,2198,10,N,N,-,-1,-1
MULIFE.txt,308906,311039,2133,10,N,N,-,-1,-1
MULIFE.txt,308985,311250,2265,10,N,N,-,-1,-1
MULIFE.txt,309024,311559,2535,10,N,N,-,-1,-1
MULIFE.txt,309318,311729,2411,10,N,N,-,-1,-1
MULIFE.txt,309742,311801,2059,10,N,N,-,-1,-1
MULIFE.txt,310209,311843,1634,10,N,N,-,-1,-1
MULIFE.txt,310426,311928,1502,10,N,N,-,-1,-1
MULIFE.txt,310565,312022,1457,10,N,N,-,-1,-1
MULIFE.txt,310717,312053,1336,10,N,N,-,-1,-1
MULIFE.txt,310875,312362,1487,10,N,N,-,-1,-1
MULIFE.txt,311040,312419,1379,10,N,N,-,-1,-1
MULIFE.txt,311253,312528,1275,10,N,N,-,-1,-1
MULIFE.txt,311562,312975,1413,10,N,N,-,-1,-1
MULIFE.txt,311730,313102,1372,10,N,N,-,-1,-1
MULIFE.txt,311804,313224,1420,10,N,N,-,-1,-1
MULIFE.txt,311844,313505,1661,10,N,N,-,-1,-1
MULIFE.txt,311929,313617,1688,10,N,N,-,-1,-1
MULIFE.txt,312023,313728,1705,10,N,N,-,-1,-1
MULIFE.txt,312054,313855,1801,10,N,N,-,-1,-1
MULIFE.txt,312365,314147,1782,10,N,N,-,-1,-1
MULIFE.txt,312422,314229,1807,10,N,N,-,-1,-1
MULIFE.txt,312529,314240,1711,10,N,N,-,-1,-1
MULIFE.txt,312978,314356,1378,10,N,N,-,-1,-1
MULIFE.txt,313103,314382,1279,10,N,N,-,-1,-1
MULIFE.txt,313225,314411,1186,10,N,N,-,-1,-1
MULIFE.txt,313506,314426,920,10,N,N,-,-1,-1
MULIFE.txt,313618,314433,815,10,N,N,-,-1,-1
MULIFE.txt,313729,314456,727,10,N,N,-,-1,-1
MULIFE.txt,313856,314483,627,10,N,N,-,-1,-1
MULIFE.txt,314150,314489,339,10,N,N,-,-1,-1
MULIFE.txt,314232,314510,278,10,N,N,-,-1,-1
MULIFE.txt,314241,314514,273,10,N,N,-,-1,-1
MULIFE.txt,314357,314536,179,10,N,N,-,-1,-1
MULIFE.txt,314385,314572,187,10,N,N,-,-1,-1
MULIFE.txt,314412,314900,488,10,N,N,-,-1,-1
MULIFE.txt,314429,314982,553,10,N,N,-,-1,-1
MULIFE.txt,314434,315024,590,10,N,N,-,-1,-1
MULIFE.txt,314457,315156,699,10,N,N,-,-1,-1
MULIFE.txt,314486,315560,1074,10,N,N,-,-1,-1
MULIFE.txt,314490,315575,1085,10,N,N,-,-1,-1
MULIFE.txt,314511,315705,1194,10,N,N,-,-1,-1
MULIFE.txt,314515,315710,1195,10,N,N,-,-1,-1
MULIFE.txt,314539,315790,1251,10,N,N,-,-1,-1
MULIFE.txt,314573,315846,1273,10,N,N,-,-1,-1
MULIFE.txt,314903,315947,1044,10,N,N,-,-1,-1
MULIFE.txt,314983,316612,1629,10,N,N,-,-1,-1
MULIFE.txt,315025,318142,3117,10,N,N,-,-1,-1
MULIFE.txt,315157,318227,3070,10,N,N,-,-1,-1
MULIFE.txt,315561,318266,2705,10,N,N,-,-1,-1
MULIFE.txt,315577,318478,2901,10,N,N,-,-1,-1
MULIFE.txt,315706,318654,2948,10,N,N,-,-1,-1
MULIFE.txt,315711,318728,3017,10,N,N,-,-1,-1
MULIFE.txt,315791,318941,3150,10,N,N,-,-1,-1
MULIFE.txt,315847,319060,3213,10,N,N,-,-1,-1
MULIFE.txt,315948,319717,3769,10,N,N,-,-1,-1
MULIFE.txt,316613,319846,3233,10,N,N,-,-1,-1
MULIFE.txt,318143,319968,1825,10,N,N,-,-1,-1
MULIFE.txt,318228,320089,1861,10,N,N,-,-1,-1
MULIFE.txt,318268,320205,1937,10,N,N,-,-1,-1
MULIFE.txt,318479,320292,1813,10,N,N,-,-1,-1
MULIFE.txt,318655,320518,1863,10,N,N,-,-1,-1
MULIFE.txt,318729,320607,1878,10,N,N,-,-1,-1
MULIFE.txt,318942,320638,1696,10,N,N,-,-1,-1
MULIFE.txt,319061,321075,2014,10,N,N,-,-1,-1
MULIFE.txt,319720,321201,1481,10,N,N,-,-1,-1
MULIFE.txt,319847,321294,1447,10,N,N,-,-1,-1
MULIFE.txt,319969,321488,1519,10,N,N,-,-1,-1
MULIFE.txt,320090,321676,1586,10,N,N,-,-1,-1
MULIFE.txt,320207,322168,1961,10,N,N,-,-1,-1
MULIFE.txt,320295,322288,1993,10,N,N,-,-1,-1
MULIFE.txt,320519,322378,1859,10,N,N,-,-1,-1
MULIFE.txt,320610,322513,1903,10,N,N,-,-1,-1
MULIFE.txt,320639,322770,2131,10,N,N,-,-1,-1
MULIFE.txt,321078,322959,1881,10,N,N,-,-1,-1
MULIFE.txt,321202,323068,1866,10,N,N,-,-1,-1
MULIFE.txt,321295,323080,1785,10,N,N,-,-1,-1
MULIFE.txt,321489,323194,1705,10,N,N,-,-1,-1
MULIFE.txt,321677,323570,1893,10,N,N,-,-1,-1
MULIFE.txt,322169,323599,1430,10,N,N,-,-1,-1
MULIFE.txt,322291,323624,1333,10,N,N,-,-1,-1
MULIFE.txt,322379,323670,1291,10,N,N,-,-1,-1
MULIFE.txt,322514,323844,1330,10,N,N,-,-1,-1
MULIFE.txt,322772,323977,1205,10,N,N,-,-1,-1
MULIFE.txt,322962,324057,1095,10,N,N,-,-1,-1
MULIFE.txt,323069,324290,1221,10,N,N,-,-1,-1
MULIFE.txt,323081,324329,1248,10,N,N,-,-1,-1
MULIFE.txt,323195,324362,1167,10,N,N,-,-1,-1
MULIFE.txt,323571,324628,1057,10,N,N,-,-1,-1
MULIFE.txt,323600,324901,1301,10,N,N,-,-1,-1
MULIFE.txt,323625,324958,1333,10,N,N,-,-1,-1
MULIFE.txt,323673,324964,1291,10,N,N,-,-1,-1
MULIFE.txt,323846,325035,1189,10,N,N,-,-1,-1
MULIFE.txt,323978,325275,1297,10,N,N,-,-1,-1
MULIFE.txt,324058,325348,1290,10,N,N,-,-1,-1
MULIFE.txt,324291,325805,1514,10,N,N,-,-1,-1
MULIFE.txt,324330,325838,1508,10,N,N,-,-1,-1
MULIFE.txt,324364,325843,1479,10,N,N,-,-1,-1
MULIFE.txt,324629,325938,1309,10,N,N,-,-1,-1
MULIFE.txt,324902,325943,1041,10,N,N,-,-1,-1
MULIFE.txt,324960,326049,1089,10,N,N,-,-1,-1
MULIFE.txt,324965,326054,1089,10,N,N,-,-1,-1
MULIFE.txt,325036,326169,1133,10,N,N,-,-1,-1
MULIFE.txt,325276,326344,1068,10,N,N,-,-1,-1
MULIFE.txt,325349,326742,1393,10,N,N,-,-1,-1
MULIFE.txt,325806,326978,1172,10,N,N,-,-1,-1
MULIFE.txt,325841,327162,1321,10,N,N,-,-1,-1
MULIFE.txt,325844,327259,1415,10,N,N,-,-1,-1
MULIFE.txt,325941,327269,1328,10,N,N,-,-1,-1
MULIFE.txt,325944,327282,1338,10,N,N,-,-1,-1
MULIFE.txt,326052,327356,1304,10,N,N,-,-1,-1
MULIFE.txt,326055,327481,1426,10,N,N,-,-1,-1
MULIFE.txt,326172,327624,1452,10,N,N,-,-1,-1
MULIFE.txt,326345,327834,1489,10,N,N,-,-1,-1
MULIFE.txt,326745,327945,1200,10,N,N,-,-1,-1
MULIFE.txt,326981,327977,996,10,N,N,-,-1,-1
MULIFE.txt,327167,328010,843,10,N,N,-,-1,-1
MULIFE.txt,327265,328373,1108,10,N,N,-,-1,-1
MULIFE.txt,327272,328640,1368,10,N,N,-,-1,-1
MULIFE.txt,327287,328857,1570,10,N,N,-,-1,-1
MULIFE.txt,327357,328974,1617,10,N,N,-,-1,-1
MULIFE.txt,327482,329078,1596,10,N,N,-,-1,-1
MULIFE.txt,327627,329166,1539,10,N,N,-,-1,-1
MULIFE.txt,327837,329276,1439,10,N,N,-,-1,-1
MULIFE.txt,327948,329319,1371,10,N,N,-,-1,-1
MULIFE.txt,327978,329443,1465,10,N,N,-,-1,-1
MULIFE.txt,328011,329444,1433,10,N,N,-,-1,-1
MULIFE.txt,328376,329462,1086,10,N,N,-,-1,-1
MULIFE.txt,328641,329733,1092,10,N,N,-,-1,-1
MULIFE.txt,328858,329975,1117,10,N,N,-,-1,-1
MULIFE.txt,328975,330120,1145,10,N,N,-,-1,-1
MULIFE.txt,329079,330191,1112,10,N,N,-,-1,-1
MULIFE.txt,329168,330341,1173,10,N,N,-,-1,-1
MULIFE.txt,329281,330410,1129,10,N,N,-,-1,-1
MULIFE.txt,329320,330481,1161,10,N,N,-,-1,-1
MULIFE.txt,329443,330669,1226,10,N,N,-,-1,-1
MULIFE.txt,329445,330825,1380,10,N,N,-,-1,-1
MULIFE.txt,329463,330870,1407,10,N,N,-,-1,-1
MULIFE.txt,329734,331061,1327,10,N,N,-,-1,-1
MULIFE.txt,329976,331210,1234,10,N,N,-,-1,-1
MULIFE.txt,330121,331340,1219,10,N,N,-,-1,-1
MULIFE.txt,330192,331661,1469,10,N,N,-,-1,-1
MULIFE.txt,330342,331814,1472,10,N,N,-,-1,-1
MULIFE.txt,330411,331962,1551,10,N,N,-,-1,-1
MULIFE.txt,330482,331989,1507,10,N,N,-,-1,-1
MULIFE.txt,330670,332081,1411,10,N,N,-,-1,-1
MULIFE.txt,330830,332148,1318,10,N,N,-,-1,-1
MULIFE.txt,330873,332191,1318,10,N,N,-,-1,-1
MULIFE.txt,331062,332292,1230,10,N,N,-,-1,-1
MULIFE.txt,331212,332374,1162,10,N,N,-,-1,-1
MULIFE.txt,331341,332517,1176,10,N,N,-,-1,-1
MULIFE.txt,331662,332595,933,10,N,N,-,-1,-1
MULIFE.txt,331815,332731,916,10,N,N,-,-1,-1
MULIFE.txt,331965,332806,841,10,N,N,-,-1,-1
MULIFE.txt,331990,332830,840,10,N,N,-,-1,-1
MULIFE.txt,332084,333110,1026,10,N,N,-,-1,-1
MULIFE.txt,332149,333174,1025,10,N,N,-,-1,-1
MULIFE.txt,332194,333323,1129,10,N,N,-,-1,-1
MULIFE.txt,332293,333496,1203,10,N,N,-,-1,-1
MULIFE.txt,332375,333517,1142,10,N,N,-,-1,-1
MULIFE.txt,332518,333523,1005,10,N,N,-,-1,-1
MULIFE.txt,332596,333538,942,10,N,N,-,-1,-1
MULIFE.txt,332736,333708,972,10,N,N,-,-1,-1
MULIFE.txt,332807,333755,948,10,N,N,-,-1,-1
MULIFE.txt,332831,333769,938,10,N,N,-,-1,-1
MULIFE.txt,333111,334067,956,10,N,N,-,-1,-1
MULIFE.txt,333175,334116,941,10,N,N,-,-1,-1
MULIFE.txt,333324,334222,898,10,N,N,-,-1,-1
MULIFE.txt,333501,334257,756,10,N,N,-,-1,-1
MULIFE.txt,333520,334370,850,10,N,N,-,-1,-1
MULIFE.txt,333526,334402,876,10,N,N,-,-1,-1
MULIFE.txt,333541,334539,998,10,N,N,-,-1,-1
MULIFE.txt,333709,334744,1035,10,N,N,-,-1,-1
MULIFE.txt,333758,334758,1000,10,N,N,-,-1,-1
MULIFE.txt,333770,334776,1006,10,N,N,-,-1,-1
MULIFE.txt,334070,334854,784,10,N,N,-,-1,-1
MULIFE.txt,334117,334905,788,10,N,N,-,-1,-1
MULIFE.txt,334223,334949,726,10,N,N,-,-1,-1
MULIFE.txt,334258,335013,755,10,N,N,-,-1,-1
MULIFE.txt,334373,335098,725,10,N,N,-,-1,-1
MULIFE.txt,334403,335247,844,10,N,N,-,-1,-1
MULIFE.txt,334541,335458,917,10,N,N,-,-1,-1
MULIFE.txt,334749,335647,898,10,N,N,-,-1,-1
MULIFE.txt,334759,335771,1012,10,N,N,-,-1,-1
MULIFE.txt,334777,335919,1142,10,N,N,-,-1,-1
MULIFE.txt,334855,336010,1155,10,N,N,-,-1,-1
MULIFE.txt,334906,336190,1284,10,N,N,-,-1,-1
MULIFE.txt,334952,336270,1318,10,N,N,-,-1,-1
MULIFE.txt,335014,336363,1349,10,N,N,-,-1,-1
MULIFE.txt,335099,336383,1284,10,N,N,-,-1,-1
MULIFE.txt,335248,336452,1204,10,N,N,-,-1,-1
MULIFE.txt,335459,336679,1220,10,N,N,-,-1,-1
MULIFE.txt,335648,336737,1089,10,N,N,-,-1,-1
MULIFE.txt,335772,336836,1064,10,N,N,-,-1,-1
MULIFE.txt,335920,336977,1057,10,N,N,-,-1,-1
MULIFE.txt,336011,337147,1136,10,N,N,-,-1,-1
MULIFE.txt,336193,337297,1104,10,N,N,-,-1,-1
MULIFE.txt,336273,337372,1099,10,N,N,-,-1,-1
MULIFE.txt,336364,337464,1100,10,N,N,-,-1,-1
MULIFE.txt,336386,337690,1304,10,N,N,-,-1,-1
MULIFE.txt,336453,337807,1354,10,N,N,-,-1,-1
MULIFE.txt,336682,337879,1197,10,N,N,-,-1,-1
MULIFE.txt,336739,338235,1496,10,N,N,-,-1,-1
MULIFE.txt,336837,338718,1881,10,N,N,-,-1,-1
MULIFE.txt,336980,338962,1982,10,N,N,-,-1,-1
MULIFE.txt,337149,339050,1901,10,N,N,-,-1,-1
MULIFE.txt,337298,339187,1889,10,N,N,-,-1,-1
MULIFE.txt,337374,339193,1819,10,N,N,-,-1,-1
MULIFE.txt,337465,339214,1749,10,N,N,-,-1,-1
MULIFE.txt,337691,339632,1941,10,Y,N,-,-1,-1
MULIFE.txt,337810,339678,1868,10,Y,N,-,-1,-1
MULIFE.txt,337880,339810,1930,10,Y,N,-,-1,-1
MULIFE.txt,338236,339842,1606,10,N,N,-,-1,-1
MULIFE.txt,338721,339914,1193,10,N,N,-,-1,-1
MULIFE.txt,338965,339972,1007,10,N,N,-,-1,-1
MULIFE.txt,339051,340126,1075,10,N,N,-,-1,-1
MULIFE.txt,339188,340253,1065,10,N,N,-,-1,-1
MULIFE.txt,339198,340415,1217,10,N,N,-,-1,-1
MULIFE.txt,339217,340532,1315,10,N,N,-,-1,-1
MULIFE.txt,339635,340607,972,10,N,N,-,-1,-1
MULIFE.txt,339679,340699,1020,10,N,N,-,-1,-1
MULIFE.txt,339813,340733,920,10,N,N,-,-1,-1
MULIFE.txt,339843,340795,952,10,N,N,-,-1,-1
MULIFE.txt,339915,340829,914,10,N,N,-,-1,-1
MULIFE.txt,339973,341148,1175,10,N,N,-,-1,-1
MULIFE.txt,340127,341243,1116,10,N,N,-,-1,-1
MULIFE.txt,340256,341454,1198,10,N,N,-,-1,-1
MULIFE.txt,340416,341656,1240,10,N,N,-,-1,-1
MULIFE.txt,340535,341811,1276,10,N,N,-,-1,-1
MULIFE.txt,340608,341929,1321,10,N,N,-,-1,-1
MULIFE.txt,340700,342121,1421,10,N,N,-,-1,-1
MULIFE.txt,340734,342182,1448,10,N,N,-,-1,-1
MULIFE.txt,340797,342424,1627,10,N,N,-,-1,-1
MULIFE.txt,340830,342523,1693,10,N,N,-,-1,-1
MULIFE.txt,341151,342740,1589,10,N,N,-,-1,-1
MULIFE.txt,341244,342799,1555,10,N,N,-,-1,-1
MULIFE.txt,341455,343001,1546,10,N,N,-,-1,-1
MULIFE.txt,341659,343076,1417,10,N,N,-,-1,-1
MULIFE.txt,341812,343176,1364,10,N,N,-,-1,-1
MULIFE.txt,341930,343396,1466,10,N,N,-,-1,-1
MULIFE.txt,342122,343458,1336,10,N,N,-,-1,-1
MULIFE.txt,342185,343555,1370,10,N,N,-,-1,-1
MULIFE.txt,342427,343629,1202,10,N,N,-,-1,-1
MULIFE.txt,342524,343680,1156,10,N,N,-,-1,-1
MULIFE.txt,342741,343762,1021,10,N,N,-,-1,-1
MULIFE.txt,342800,343966,1166,10,N,N,-,-1,-1
MULIFE.txt,343004,343995,991,10,N,N,-,-1,-1
MULIFE.txt,343077,344237,1160,10,N,N,-,-1,-1
MULIFE.txt,343178,344359,1181,10,N,N,-,-1,-1
MULIFE.txt,343397,344458,1061,10,N,N,-,-1,-1
MULIFE.txt,343461,344472,1011,10,N,N,-,-1,-1
MULIFE.txt,343556,344622,1066,10,N,N,-,-1,-1
MULIFE.txt,343630,344813,1183,10,N,N,-,-1,-1
MULIFE.txt,343681,344970,1289,10,N,N,-,-1,-1
MULIFE.txt,343763,345055,1292,10,N,N,-,-1,-1
MULIFE.txt,343967,345083,1116,10,N,N,-,-1,-1
MULIFE.txt,343996,345243,1247,10,N,N,-,-1,-1
MULIFE.txt,344240,345433,1193,10,N,N,-,-1,-1
MULIFE.txt,344362,345520,1158,10,N,N,-,-1,-1
MULIFE.txt,344461,345905,1444,10,N,N,-,-1,-1
MULIFE.txt,344473,345991,1518,10,N,N,-,-1,-1
MULIFE.txt,344623,346080,1457,10,N,N,-,-1,-1
MULIFE.txt,344814,346196,1382,10,N,N,-,-1,-1
MULIFE.txt,344971,346332,1361,10,N,N,-,-1,-1
MULIFE.txt,345058,346413,1355,10,N,N,-,-1,-1
MULIFE.txt,345086,346497,1411,10,N,N,-,-1,-1
MULIFE.txt,345246,346590,1344,10,N,N,-,-1,-1
MULIFE.txt,345434,346845,1411,10,N,N,-,-1,-1
MULIFE.txt,345521,346882,1361,10,N,N,-,-1,-1
MULIFE.txt,345908,346895,987,10,N,N,-,-1,-1
MULIFE.txt,345992,346946,954,10,N,N,-,-1,-1
MULIFE.txt,346083,346976,893,10,N,N,-,-1,-1
MULIFE.txt,346197,347069,872,10,N,N,-,-1,-1
MULIFE.txt,346333,347169,836,10,N,N,-,-1,-1
MULIFE.txt,346414,347189,775,10,N,N,-,-1,-1
MULIFE.txt,346498,347210,712,10,N,N,-,-1,-1
MULIFE.txt,346591,347273,682,10,N,N,-,-1,-1
MULIFE.txt,346848,347400,552,10,N,N,-,-1,-1
MULIFE.txt,346883,347675,792,10,N,N,-,-1,-1
MULIFE.txt,346896,347727,831,10,N,N,-,-1,-1
MULIFE.txt,346947,347918,971,10,N,N,-,-1,-1
MULIFE.txt,346977,347959,982,10,N,N,-,-1,-1
MULIFE.txt,347072,347986,914,10,N,N,-,-1,-1
MULIFE.txt,347170,348162,992,10,N,N,-,-1,-1
MULIFE.txt,347190,348261,1071,10,N,N,-,-1,-1
MULIFE.txt,347211,348684,1473,10,N,N,-,-1,-1
MULIFE.txt,347274,349042,1768,10,N,N,-,-1,-1
MULIFE.txt,347402,349199,1797,10,N,N,-,-1,-1
MULIFE.txt,347676,349270,1594,10,N,N,-,-1,-1
MULIFE.txt,347728,349536,1808,10,N,N,-,-1,-1
MULIFE.txt,347919,349604,1685,10,N,N,-,-1,-1
MULIFE.txt,347960,349759,1799,10,N,N,-,-1,-1
MULIFE.txt,347989,349905,1916,10,N,N,-,-1,-1
MULIFE.txt,348163,350114,1951,10,N,N,-,-1,-1
MULIFE.txt,348262,350393,2131,10,N,N,-,-1,-1
MULIFE.txt,348685,350485,1800,10,N,N,-,-1,-1
MULIFE.txt,349045,350516,1471,10,N,N,-,-1,-1
MULIFE.txt,349200,350643,1443,10,N,N,-,-1,-1
MULIFE.txt,349273,350672,1399,10,N,N,-,-1,-1
MULIFE.txt,349537,351069,1532,10,N,N,-,-1,-1
MULIFE.txt,349606,351082,1476,10,N,N,-,-1,-1
MULIFE.txt,349760,351126,1366,10,N,N,-,-1,-1
MULIFE.txt,349906,351337,1431,10,N,N,-,-1,-1
MULIFE.txt,350115,351597,1482,10,N,N,-,-1,-1
MULIFE.txt,350396,351687,1291,10,N,N,-,-1,-1
MULIFE.txt,350486,351829,1343,10,N,N,-,-1,-1
MULIFE.txt,350517,351921,1404,10,N,N,-,-1,-1
MULIFE.txt,350644,351981,1337,10,N,N,-,-1,-1
MULIFE.txt,350673,352125,1452,10,N,N,-,-1,-1
MULIFE.txt,351072,352258,1186,10,N,N,-,-1,-1
MULIFE.txt,351083,352424,1341,10,N,N,-,-1,-1
MULIFE.txt,351128,352470,1342,10,N,N,-,-1,-1
MULIFE.txt,351338,352520,1182,10,N,N,-,-1,-1
MULIFE.txt,351598,352658,1060,10,N,N,-,-1,-1
MULIFE.txt,351688,352722,1034,10,N,N,-,-1,-1
MULIFE.txt,351830,352742,912,10,N,N,-,-1,-1
MULIFE.txt,351922,352956,1034,10,N,N,-,-1,-1
MULIFE.txt,351982,353020,1038,10,N,N,-,-1,-1
MULIFE.txt,352126,353052,926,10,N,N,-,-1,-1
MULIFE.txt,352259,353193,934,10,N,N,-,-1,-1
MULIFE.txt,352425,353234,809,10,N,N,-,-1,-1
MULIFE.txt,352471,353662,1191,10,N,N,-,-1,-1
MULIFE.txt,352522,353784,1262,10,N,N,-,-1,-1
MULIFE.txt,352659,353986,1327,10,N,N,-,-1,-1
MULIFE.txt,352723,354029,1306,10,N,N,-,-1,-1
MULIFE.txt,352743,354072,1329,10,N,N,-,-1,-1
MULIFE.txt,352957,354194,1237,10,N,N,-,-1,-1
MULIFE.txt,353023,354250,1227,10,N,N,-,-1,-1
MULIFE.txt,353053,354413,1360,10,N,N,-,-1,-1
MULIFE.txt,353196,354537,1341,10,N,N,-,-1,-1
MULIFE.txt,353235,354802,1567,10,N,N,-,-1,-1
MULIFE.txt,353663,354861,1198,10,N,N,-,-1,-1
MULIFE.txt,353785,354990,1205,10,N,N,-,-1,-1
MULIFE.txt,353987,355007,1020,10,N,N,-,-1,-1
MULIFE.txt,354030,355057,1027,10,N,N,-,-1,-1
MULIFE.txt,354073,355226,1153,10,N,N,-,-1,-1
MULIFE.txt,354195,355231,1036,10,N,N,-,-1,-1
MULIFE.txt,354253,355448,1195,10,N,N,-,-1,-1
MULIFE.txt,354414,355453,1039,10,N,N,-,-1,-1
MULIFE.txt,354538,355643,1105,10,N,N,-,-1,-1
MULIFE.txt,354805,355805,1000,10,N,N,-,-1,-1
MULIFE.txt,354862,355854,992,10,N,N,-,-1,-1
MULIFE.txt,354991,356023,1032,10,N,N,-,-1,-1
MULIFE.txt,355008,356092,1084,10,N,N,-,-1,-1
MULIFE.txt,355058,356095,1037,10,N,N,-,-1,-1
MULIFE.txt,355229,356160,931,10,N,N,-,-1,-1
MULIFE.txt,355232,356272,1040,10,N,N,-,-1,-1
MULIFE.txt,355451,356472,1021,10,N,N,-,-1,-1
MULIFE.txt,355454,356594,1140,10,N,N,-,-1,-1
MULIFE.txt,355644,356762,1118,10,N,N,-,-1,-1
MULIFE.txt,355806,357099,1293,10,N,N,-,-1,-1
MULIFE.txt,355857,357286,1429,10,N,N,-,-1,-1
MULIFE.txt,356026,357346,1320,10,N,N,-,-1,-1
MULIFE.txt,356093,357635,1542,10,N,N,-,-1,-1
MULIFE.txt,356096,357994,1898,10,Y,N,-,-1,-1
MULIFE.txt,356161,358208,2047,10,Y,N,-,-1,-1
MULIFE.txt,356274,358489,2215,10,Y,N,-,-1,-1
MULIFE.txt,356475,358553,2078,10,Y,N,-,-1,-1
MULIFE.txt,356597,358640,2043,10,Y,N,-,-1,-1
MULIFE.txt,356763,358778,2015,10,Y,N,-,-1,-1
MULIFE.txt,357102,359276,2174,10,Y,N,-,-1,-1
MULIFE.txt,357287,359588,2301,10,Y,N,-,-1,-1
MULIFE.txt,357349,359638,2289,10,Y,N,-,-1,-1
MULIFE.txt,357638,359674,2036,10,N,N,-,-1,-1
MULIFE.txt,357997,359764,1767,10,N,N,-,-1,-1
MULIFE.txt,358211,359838,1627,10,N,N,-,-1,-1
MULIFE.txt,358490,359947,1457,10,N,N,-,-1,-1
MULIFE.txt,358554,360145,1591,10,N,N,-,-1,-1
MULIFE.txt,358641,360233,1592,10,N,N,-,-1,-1
MULIFE.txt,358779,360629,1850,10,N,N,-,-1,-1
MULIFE.txt,359279,360705,1426,10,N,N,-,-1,-1
MULIFE.txt,359591,360908,1317,10,N,N,-,-1,-1
MULIFE.txt,359639,361057,1418,10,N,N,-,-1,-1
MULIFE.txt,359675,361155,1480,10,N,N,-,-1,-1
MULIFE.txt,359766,361176,1410,10,N,N,-,-1,-1
MULIFE.txt,359839,361422,1583,10,N,N,-,-1,-1
MULIFE.txt,359950,361462,1512,10,N,N,-,-1,-1
MULIFE.txt,360148,361683,1535,10,N,N,-,-1,-1
MULIFE.txt,360236,361885,1649,10,N,N,-,-1,-1
MULIFE.txt,360630,361921,1291,10,N,N,-,-1,-1
MULIFE.txt,360708,361996,1288,10,N,N,-,-1,-1
MULIFE.txt,360909,362091,1182,10,N,N,-,-1,-1
MULIFE.txt,361060,362150,1090,10,N,N,-,-1,-1
MULIFE.txt,361156,362344,1188,10,N,N,-,-1,-1
MULIFE.txt,361177,362499,1322,10,N,N,-,-1,-1
MULIFE.txt,361423,362735,1312,10,N,N,-,-1,-1
MULIFE.txt,361463,362935,1472,10,N,N,-,-1,-1
MULIFE.txt,361684,362972,1288,10,N,N,-,-1,-1
MULIFE.txt,361886,362974,1088,10,N,N,-,-1,-1
MULIFE.txt,361924,362982,1058,10,N,N,-,-1,-1
MULIFE.txt,361997,363112,1115,10,N,N,-,-1,-1
MULIFE.txt,362093,363192,1099,10,N,N,-,-1,-1
MULIFE.txt,362153,363616,1463,10,N,N,-,-1,-1
MULIFE.txt,362345,363662,1317,10,N,N,-,-1,-1
MULIFE.txt,362500,363848,1348,10,N,N,-,-1,-1
MULIFE.txt,362738,364009,1271,10,N,N,-,-1,-1
MULIFE.txt,362936,364125,1189,10,N,N,-,-1,-1
MULIFE.txt,362973,364244,1271,10,N,N,-,-1,-1
MULIFE.txt,362974,364308,1334,10,N,N,-,-1,-1
MULIFE.txt,362982,364366,1384,10,N,N,-,-1,-1
MULIFE.txt,363115,364484,1369,10,N,N,-,-1,-1
MULIFE.txt,363193,364526,1333,10,N,N,-,-1,-1
MULIFE.txt,363619,364606,987,10,N,N,-,-1,-1
MULIFE.txt,363663,364706,1043,10,N,N,-,-1,-1
MULIFE.txt,363849,364956,1107,10,N,N,-,-1,-1
MULIFE.txt,364010,365017,1007,10,N,N,-,-1,-1
MULIFE.txt,364128,365185,1057,10,N,N,-,-1,-1
MULIFE.txt,364245,365339,1094,10,N,N,-,-1,-1
MULIFE.txt,364309,365641,1332,10,N,N,-,-1,-1
MULIFE.txt,364367,365854,1487,10,N,N,-,-1,-1
MULIFE.txt,364485,365926,1441,10,N,N,-,-1,-1
MULIFE.txt,364528,366015,1487,10,N,N,-,-1,-1
MULIFE.txt,364607,366113,1506,10,N,N,-,-1,-1
MULIFE.txt,364711,366140,1429,10,N,N,-,-1,-1
MULIFE.txt,364957,366272,1315,10,N,N,-,-1,-1
MULIFE.txt,365018,366430,1412,10,N,N,-,-1,-1
MULIFE.txt,365186,366440,1254,10,N,N,-,-1,-1
MULIFE.txt,365340,366708,1368,10,N,N,-,-1,-1
MULIFE.txt,365642,366894,1252,10,N,N,-,-1,-1
MULIFE.txt,365856,366989,1133,10,N,N,-,-1,-1
MULIFE.txt,365927,367151,1224,10,N,N,-,-1,-1
MULIFE.txt,366016,367260,1244,10,N,N,-,-1,-1
MULIFE.txt,366116,367593,1477,10,N,N,-,-1,-1
MULIFE.txt,366141,367701,1560,10,N,N,-,-1,-1
MULIFE.txt,366275,367821,1546,10,N,N,-,-1,-1
MULIFE.txt,366431,367907,1476,10,N,N,-,-1,-1
MULIFE.txt,366443,367933,1490,10,N,N,-,-1,-1
MULIFE.txt,366709,367982,1273,10,N,N,-,-1,-1
MULIFE.txt,366897,368003,1106,10,N,N,-,-1,-1
MULIFE.txt,366990,368018,1028,10,N,N,-,-1,-1
MULIFE.txt,367154,368294,1140,10,N,N,-,-1,-1
MULIFE.txt,367261,368576,1315,10,N,N,-,-1,-1
MULIFE.txt,367594,368677,1083,10,N,N,-,-1,-1
MULIFE.txt,367704,368763,1059,10,N,N,-,-1,-1
MULIFE.txt,367822,368835,1013,10,N,N,-,-1,-1
MULIFE.txt,367908,369023,1115,10,N,N,-,-1,-1
MULIFE.txt,367934,369051,1117,10,N,N,-,-1,-1
MULIFE.txt,367985,369170,1185,10,N,N,-,-1,-1
MULIFE.txt,368004,369235,1231,10,N,N,-,-1,-1
MULIFE.txt,368019,369284,1265,10,N,N,-,-1,-1
MULIFE.txt,368297,369356,1059,10,N,N,-,-1,-1
MULIFE.txt,368577,369402,825,10,N,N,-,-1,-1
MULIFE.txt,368678,369415,737,10,N,N,-,-1,-1
MULIFE.txt,368764,369482,718,10,N,N,-,-1,-1
MULIFE.txt,368836,369549,713,10,N,N,-,-1,-1
MULIFE.txt,369026,369601,575,10,N,N,-,-1,-1
MULIFE.txt,369054,369692,638,10,N,N,-,-1,-1
MULIFE.txt,369173,369881,708,10,N,N,-,-1,-1
MULIFE.txt,369236,370052,816,10,N,N,-,-1,-1
MULIFE.txt,369285,370081,796,10,N,N,-,-1,-1
MULIFE.txt,369357,370211,854,10,N,N,-,-1,-1
MULIFE.txt,369405,370316,911,10,N,N,-,-1,-1
MULIFE.txt,369416,370358,942,10,N,N,-,-1,-1
MULIFE.txt,369483,370531,1048,10,N,N,-,-1,-1
MULIFE.txt,369550,370781,1231,10,N,N,-,-1,-1
MULIFE.txt,369602,371004,1402,10,N,N,-,-1,-1
MULIFE.txt,369693,371074,1381,10,N,N,-,-1,-1
MULIFE.txt,369884,371515,1631,10,Y,N,-,-1,-1
MULIFE.txt,370054,372050,1996,10,Y,N,-,-1,-1
MULIFE.txt,370082,372071,1989,10,Y,N,-,-1,-1
MULIFE.txt,370212,372139,1927,10,Y,N,-,-1,-1
MULIFE.txt,370317,372187,1870,10,Y,N,-,-1,-1
MULIFE.txt,370359,372455,2096,10,Y,N,-,-1,-1
MULIFE.txt,370532,372595,2063,10,Y,N,-,-1,-1
MULIFE.txt,370783,372665,1882,10,Y,N,-,-1,-1
MULIFE.txt,371005,372842,1837,10,Y,N,-,-1,-1
MULIFE.txt,371076,373001,1925,10,Y,N,-,-1,-1
MULIFE.txt,371518,373151,1633,10,N,N,-,-1,-1
MULIFE.txt,372055,373574,1519,10,N,N,-,-1,-1
MULIFE.txt,372074,373670,1596,10,N,N,-,-1,-1
MULIFE.txt,372140,373843,1703,10,N,N,-,-1,-1
MULIFE.txt,372188,373963,1775,10,N,N,-,-1,-1
MULIFE.txt,372456,374081,1625,10,N,N,-,-1,-1
MULIFE.txt,372597,374180,1583,10,N,N,-,-1,-1
MULIFE.txt,372666,374495,1829,10,N,N,-,-1,-1
MULIFE.txt,372843,374648,1805,10,N,N,-,-1,-1
MULIFE.txt,373003,374820,1817,10,N,N,-,-1,-1
MULIFE.txt,373152,374883,1731,10,N,N,-,-1,-1
MULIFE.txt,373577,375002,1425,10,N,N,-,-1,-1
MULIFE.txt,373671,375138,1467,10,N,N,-,-1,-1
MULIFE.txt,373846,375195,1349,10,N,N,-,-1,-1
MULIFE.txt,373965,375326,1361,10,N,N,-,-1,-1
MULIFE.txt,374084,375522,1438,10,N,N,-,-1,-1
MULIFE.txt,374182,375748,1566,10,N,N,-,-1,-1
MULIFE.txt,374496,375866,1370,10,N,N,-,-1,-1
MULIFE.txt,374649,376060,1411,10,N,N,-,-1,-1
MULIFE.txt,374823,376308,1485,10,N,N,-,-1,-1
MULIFE.txt,374884,376441,1557,10,N,N,-,-1,-1
MULIFE.txt,375003,376455,1452,10,N,N,-,-1,-1
MULIFE.txt,375141,376523,1382,10,N,N,-,-1,-1
MULIFE.txt,375197,376640,1443,10,N,N,-,-1,-1
MULIFE.txt,375327,376776,1449,10,N,N,-,-1,-1
MULIFE.txt,375525,377008,1483,10,N,N,-,-1,-1
MULIFE.txt,375751,377185,1434,10,N,N,-,-1,-1
MULIFE.txt,375869,377347,1478,10,N,N,-,-1,-1
MULIFE.txt,376063,377680,1617,10,N,N,-,-1,-1
MULIFE.txt,376311,377876,1565,10,N,N,-,-1,-1
MULIFE.txt,376442,378010,1568,10,N,N,-,-1,-1
MULIFE.txt,376456,378159,1703,10,N,N,-,-1,-1
MULIFE.txt,376524,378344,1820,10,N,N,-,-1,-1
MULIFE.txt,376641,378467,1826,10,N,N,-,-1,-1
MULIFE.txt,376777,378722,1945,10,N,N,-,-1,-1
MULIFE.txt,377011,378821,1810,10,N,N,-,-1,-1
MULIFE.txt,377188,378985,1797,10,N,N,-,-1,-1
MULIFE.txt,377350,379133,1783,10,N,N,-,-1,-1
MULIFE.txt,377683,379205,1522,10,N,N,-,-1,-1
MULIFE.txt,377879,379242,1363,10,N,N,-,-1,-1
MULIFE.txt,378013,379320,1307,10,N,N,-,-1,-1
MULIFE.txt,378160,379372,1212,10,N,N,-,-1,-1
MULIFE.txt,378346,379380,1034,10,N,N,-,-1,-1
MULIFE.txt,378468,379444,976,10,N,N,-,-1,-1
MULIFE.txt,378725,379611,886,10,N,N,-,-1,-1
MULIFE.txt,378822,379748,926,10,N,N,-,-1,-1
MULIFE.txt,378986,379788,802,10,N,N,-,-1,-1
MULIFE.txt,379136,379854,718,10,N,N,-,-1,-1
MULIFE.txt,379206,380041,835,10,N,N,-,-1,-1
MULIFE.txt,379243,380308,1065,10,N,N,-,-1,-1
MULIFE.txt,379321,380525,1204,10,N,N,-,-1,-1
MULIFE.txt,379375,380538,1163,10,N,N,-,-1,-1
MULIFE.txt,379381,380557,1176,10,N,N,-,-1,-1
MULIFE.txt,379445,380633,1188,10,N,N,-,-1,-1
MULIFE.txt,379614,380695,1081,10,N,N,-,-1,-1
MULIFE.txt,379749,380886,1137,10,N,N,-,-1,-1
MULIFE.txt,379791,381036,1245,10,N,N,-,-1,-1
MULIFE.txt,379855,381186,1331,10,N,N,-,-1,-1
MULIFE.txt,380044,381300,1256,10,N,N,-,-1,-1
MULIFE.txt,380309,381326,1017,10,N,N,-,-1,-1
MULIFE.txt,380527,381442,915,10,N,N,-,-1,-1
MULIFE.txt,380539,381500,961,10,N,N,-,-1,-1
MULIFE.txt,380560,381790,1230,10,N,N,-,-1,-1
MULIFE.txt,380636,381842,1206,10,N,N,-,-1,-1
MULIFE.txt,380697,381960,1263,10,N,N,-,-1,-1
MULIFE.txt,380889,381989,1100,10,N,N,-,-1,-1
MULIFE.txt,381039,382149,1110,10,N,N,-,-1,-1
MULIFE.txt,381189,382349,1160,10,N,N,-,-1,-1
MULIFE.txt,381302,382434,1132,10,N,N,-,-1,-1
MULIFE.txt,381329,382511,1182,10,N,N,-,-1,-1
MULIFE.txt,381445,382780,1335,10,N,N,-,-1,-1
MULIFE.txt,381503,382998,1495,10,N,N,-,-1,-1
MULIFE.txt,381791,383224,1433,10,N,N,-,-1,-1
MULIFE.txt,381843,383404,1561,10,N,N,-,-1,-1
MULIFE.txt,381965,383425,1460,10,N,N,-,-1,-1
MULIFE.txt,381990,383512,1522,10,N,N,-,-1,-1
MULIFE.txt,382150,383633,1483,10,N,N,-,-1,-1
MULIFE.txt,382350,383724,1374,10,N,N,-,-1,-1
MULIFE.txt,382435,383815,1380,10,N,N,-,-1,-1
MULIFE.txt,382512,383925,1413,10,N,N,-,-1,-1
MULIFE.txt,382781,384054,1273,10,N,N,-,-1,-1
MULIFE.txt,382999,384392,1393,10,N,N,-,-1,-1
MULIFE.txt,383227,384542,1315,10,N,N,-,-1,-1
MULIFE.txt,383409,384603,1194,10,N,N,-,-1,-1
MULIFE.txt,383428,384886,1458,10,N,N,-,-1,-1
MULIFE.txt,383513,384908,1395,10,N,N,-,-1,-1
MULIFE.txt,383634,385037,1403,10,N,N,-,-1,-1
MULIFE.txt,383725,385042,1317,10,N,N,-,-1,-1
MULIFE.txt,383816,385068,1252,10,N,N,-,-1,-1
MULIFE.txt,383927,385172,1245,10,N,N,-,-1,-1
MULIFE.txt,384055,385282,1227,10,N,N,-,-1,-1
MULIFE.txt,384395,385368,973,10,N,N,-,-1,-1
MULIFE.txt,384543,385395,852,10,N,N,-,-1,-1
MULIFE.txt,384604,385660,1056,10,N,N,-,-1,-1
MULIFE.txt,384891,385766,875,10,N,N,-,-1,-1
MULIFE.txt,384909,385918,1009,10,N,N,-,-1,-1
MULIFE.txt,385038,386143,1105,10,N,N,-,-1,-1
MULIFE.txt,385043,386329,1286,10,N,N,-,-1,-1
MULIFE.txt,385070,386350,1280,10,N,N,-,-1,-1
MULIFE.txt,385174,386456,1282,10,N,N,-,-1,-1
MULIFE.txt,385284,386484,1200,10,N,N,-,-1,-1
MULIFE.txt,385371,386538,1167,10,N,N,-,-1,-1
MULIFE.txt,385396,386586,1190,10,N,N,-,-1,-1
MULIFE.txt,385661,386732,1071,10,N,N,-,-1,-1
MULIFE.txt,385767,386871,1104,10,N,N,-,-1,-1
MULIFE.txt,385920,386946,1026,10,N,N,-,-1,-1
MULIFE.txt,386144,387052,908,10,N,N,-,-1,-1
MULIFE.txt,386334,387132,798,10,N,N,-,-1,-1
MULIFE.txt,386353,387263,910,10,N,N,-,-1,-1
MULIFE.txt,386457,387371,914,10,N,N,-,-1,-1
MULIFE.txt,386485,387476,991,10,N,N,-,-1,-1
MULIFE.txt,386539,387596,1057,10,N,N,-,-1,-1
MULIFE.txt,386587,387683,1096,10,N,N,-,-1,-1
MULIFE.txt,386733,387846,1113,10,N,N,-,-1,-1
MULIFE.txt,386872,387973,1101,10,N,N,-,-1,-1
MULIFE.txt,386947,388068,1121,10,N,N,-,-1,-1
MULIFE.txt,387053,388188,1135,10,N,N,-,-1,-1
MULIFE.txt,387133,388228,1095,10,N,N,-,-1,-1
MULIFE.txt,387264,388359,1095,10,N,N,-,-1,-1
MULIFE.txt,387374,388589,1215,10,N,N,-,-1,-1
MULIFE.txt,387479,388672,1193,10,N,N,-,-1,-1
MULIFE.txt,387599,388765,1166,10,N,N,-,-1,-1
MULIFE.txt,387684,389041,1357,10,N,N,-,-1,-1
MULIFE.txt,387847,389230,1383,10,N,N,-,-1,-1
MULIFE.txt,387974,389249,1275,10,N,N,-,-1,-1
MULIFE.txt,388071,389342,1271,10,N,N,-,-1,-1
MULIFE.txt,388189,389405,1216,10,N,N,-,-1,-1
MULIFE.txt,388229,389414,1185,10,N,N,-,-1,-1
MULIFE.txt,388361,389454,1093,10,N,N,-,-1,-1
MULIFE.txt,388590,389675,1085,10,N,N,-,-1,-1
MULIFE.txt,388673,389737,1064,10,N,N,-,-1,-1
MULIFE.txt,388766,389885,1119,10,N,N,-,-1,-1
MULIFE.txt,389044,389920,876,10,N,N,-,-1,-1
MULIFE.txt,389233,390160,927,10,N,N,-,-1,-1
MULIFE.txt,389250,390385,1135,10,N,N,-,-1,-1
MULIFE.txt,389344,390438,1094,10,N,N,-,-1,-1
MULIFE.txt,389406,390543,1137,10,N,N,-,-1,-1
MULIFE.txt,389414,390610,1196,10,N,N,-,-1,-1
MULIFE.txt,389455,390663,1208,10,N,N,-,-1,-1
MULIFE.txt,389676,390737,1061,10,N,N,-,-1,-1
MULIFE.txt,389738,390792,1054,10,N,N,-,-1,-1
MULIFE.txt,389886,390930,1044,10,N,N,-,-1,-1
MULIFE.txt,389922,391051,1129,10,N,N,-,-1,-1
MULIFE.txt,390161,391494,1333,10,N,N,-,-1,-1
MULIFE.txt,390386,392010,1624,10,N,N,-,-1,-1
MULIFE.txt,390441,392233,1792,10,N,N,-,-1,-1
MULIFE.txt,390546,392282,1736,10,N,N,-,-1,-1
MULIFE.txt,390615,392362,1747,10,N,N,-,-1,-1
MULIFE.txt,390664,392483,1819,10,N,N,-,-1,-1
MULIFE.txt,390738,392595,1857,10,N,N,-,-1,-1
MULIFE.txt,390793,392788,1995,10,N,N,-,-1,-1
MULIFE.txt,390931,393002,2071,10,N,N,-,-1,-1
MULIFE.txt,391052,393032,1980,10,N,N,-,-1,-1
MULIFE.txt,391497,393109,1612,10,N,N,-,-1,-1
MULIFE.txt,392011,393110,1099,10,N,N,-,-1,-1
MULIFE.txt,392236,393155,919,10,N,N,-,-1,-1
MULIFE.txt,392283,393251,968,10,N,N,-,-1,-1
MULIFE.txt,392363,393257,894,10,N,N,-,-1,-1
MULIFE.txt,392486,393317,831,10,N,N,-,-1,-1
MULIFE.txt,392596,393403,807,10,N,N,-,-1,-1
MULIFE.txt,392789,393479,690,10,N,N,-,-1,-1
MULIFE.txt,393005,393508,503,10,N,N,-,-1,-1
MULIFE.txt,393033,393554,521,10,N,N,-,-1,-1
MULIFE.txt,393109,393658,549,10,N,N,-,-1,-1
MULIFE.txt,393113,393941,828,10,N,N,-,-1,-1
MULIFE.txt,393156,394161,1005,10,N,N,-,-1,-1
MULIFE.txt,393253,394239,986,10,N,N,-,-1,-1
MULIFE.txt,393260,394459,1199,10,N,N,-,-1,-1
MULIFE.txt,393318,394534,1216,10,N,N,-,-1,-1
MULIFE.txt,393406,394553,1147,10,N,N,-,-1,-1
MULIFE.txt,393482,394573,1091,10,N,N,-,-1,-1
MULIFE.txt,393509,394602,1093,10,N,N,-,-1,-1
MULIFE.txt,393555,394628,1073,10,N,N,-,-1,-1
MULIFE.txt,393661,394650,989,10,N,N,-,-1,-1
MULIFE.txt,393944,394677,733,10,N,N,-,-1,-1
MULIFE.txt,394162,394716,554,10,N,N,-,-1,-1
MULIFE.txt,394242,394743,501,10,N,N,-,-1,-1
MULIFE.txt,394460,394764,304,10,N,N,-,-1,-1
MULIFE.txt,394537,394790,253,10,N,N,-,-1,-1
MULIFE.txt,394555,394845,290,10,N,N,-,-1,-1
MULIFE.txt,394576,394873,297,10,N,N,-,-1,-1
MULIFE.txt,394604,394915,311,10,N,N,-,-1,-1
MULIFE.txt,394631,394991,360,10,N,N,-,-1,-1
MULIFE.txt,394653,395012,359,10,N,N,-,-1,-1
MULIFE.txt,394680,395028,348,10,N,N,-,-1,-1
MULIFE.txt,394719,395048,329,10,N,N,-,-1,-1
MULIFE.txt,394748,395059,311,10,N,N,-,-1,-1
MULIFE.txt,394767,395083,316,10,N,N,-,-1,-1
MULIFE.txt,394793,395102,309,10,N,N,-,-1,-1
MULIFE.txt,394848,395118,270,10,N,N,-,-1,-1
MULIFE.txt,394876,395153,277,10,N,N,-,-1,-1
MULIFE.txt,394918,395180,262,10,N,N,-,-1,-1
MULIFE.txt,394994,395195,201,10,N,N,-,-1,-1
MULIFE.txt,395014,395220,206,10,N,N,-,-1,-1
MULIFE.txt,395030,395245,215,10,N,N,-,-1,-1
MULIFE.txt,395049,395272,223,10,N,N,-,-1,-1
MULIFE.txt,395062,395295,233,10,N,N,-,-1,-1
MULIFE.txt,395086,395296,210,10,N,N,-,-1,-1
MULIFE.txt,395103,395325,222,10,N,N,-,-1,-1
MULIFE.txt,395120,395343,223,10,N,N,-,-1,-1
MULIFE.txt,395156,395363,207,10,N,N,-,-1,-1
MULIFE.txt,395182,395397,215,10,N,N,-,-1,-1
MULIFE.txt,395200,395425,225,10,N,N,-,-1,-1
MULIFE.txt,395225,395451,226,10,N,N,-,-1,-1
MULIFE.txt,395248,395470,222,10,N,N,-,-1,-1
MULIFE.txt,395275,395496,221,10,N,N,-,-1,-1
MULIFE.txt,395295,395514,219,10,N,N,-,-1,-1
MULIFE.txt,395298,395538,240,10,N,N,-,-1,-1
MULIFE.txt,395327,395568,241,10,N,N,-,-1,-1
MULIFE.txt,395348,395577,229,10,N,N,-,-1,-1
MULIFE.txt,395364,395620,256,10,N,N,-,-1,-1
MULIFE.txt,395400,395745,345,10,N,N,-,-1,-1
MULIFE.txt,395428,395772,344,10,N,N,-,-1,-1
MULIFE.txt,395454,396058,604,10,N,N,-,-1,-1
MULIFE.txt,395473,396431,958,10,N,N,-,-1,-1
MULIFE.txt,395499,396490,991,10,N,N,-,-1,-1
MULIFE.txt,395517,396626,1109,10,N,N,-,-1,-1
MULIFE.txt,395543,396665,1122,10,N,N,-,-1,-1
MULIFE.txt,395573,396673,1100,10,N,N,-,-1,-1
MULIFE.txt,395580,396701,1121,10,N,N,-,-1,-1
MULIFE.txt,395623,396880,1257,10,N,N,-,-1,-1
MULIFE.txt,395746,397004,1258,10,N,N,-,-1,-1
MULIFE.txt,395773,397070,1297,10,N,N,-,-1,-1
MULIFE.txt,396059,397700,1641,10,N,N,-,-1,-1
MULIFE.txt,396432,397735,1303,10,N,N,-,-1,-1
MULIFE.txt,396491,397922,1431,10,N,N,-,-1,-1
MULIFE.txt,396627,397955,1328,10,N,N,-,-1,-1
MULIFE.txt,396670,398165,1495,10,N,N,-,-1,-1
MULIFE.txt,396676,398287,1611,10,N,N,-,-1,-1
MULIFE.txt,396704,398326,1622,10,N,N,-,-1,-1
MULIFE.txt,396883,398984,2101,10,N,N,-,-1,-1
MULIFE.txt,397005,399021,2016,10,N,N,-,-1,-1
MULIFE.txt,397071,399045,1974,10,N,N,-,-1,-1
MULIFE.txt,397705,399132,1427,10,N,N,-,-1,-1
MULIFE.txt,397738,399272,1534,10,N,N,-,-1,-1
MULIFE.txt,397923,399845,1922,10,N,N,-,-1,-1
MULIFE.txt,397956,399914,1958,10,N,N,-,-1,-1
MULIFE.txt,398166,399972,1806,10,N,N,-,-1,-1
MULIFE.txt,398289,400101,1812,10,N,N,-,-1,-1
MULIFE.txt,398327,400120,1793,10,N,N,-,-1,-1
MULIFE.txt,398987,400215,1228,10,N,N,-,-1,-1
MULIFE.txt,399022,400479,1457,10,N,N,-,-1,-1
MULIFE.txt,399046,400585,1539,10,N,N,-,-1,-1
MULIFE.txt,399133,400710,1577,10,N,N,-,-1,-1
MULIFE.txt,399273,400818,1545,10,N,N,-,-1,-1
MULIFE.txt,399848,400891,1043,10,N,N,-,-1,-1
MULIFE.txt,399915,400994,1079,10,N,N,-,-1,-1
MULIFE.txt,399973,401057,1084,10,N,N,-,-1,-1
MULIFE.txt,400102,401113,1011,10,N,N,-,-1,-1
MULIFE.txt,400121,401275,1154,10,N,N,-,-1,-1
MULIFE.txt,400217,401734,1517,10,N,N,-,-1,-1
MULIFE.txt,400480,401813,1333,10,N,N,-,-1,-1
MULIFE.txt,400586,402241,1655,10,Y,N,-,-1,-1
MULIFE.txt,400711,402380,1669,10,Y,N,-,-1,-1
MULIFE.txt,400821,402527,1706,10,N,N,-,-1,-1
MULIFE.txt,400892,402829,1937,10,N,N,-,-1,-1
MULIFE.txt,400997,403251,2254,10,N,N,-,-1,-1
MULIFE.txt,401058,403357,2299,10,N,N,-,-1,-1
MULIFE.txt,401114,403459,2345,10,N,N,-,-1,-1
MULIFE.txt,401276,403583,2307,10,N,N,-,-1,-1
MULIFE.txt,401735,403648,1913,10,Y,N,-,-1,-1
MULIFE.txt,401814,403704,1890,10,Y,N,-,-1,-1
MULIFE.txt,402242,403984,1742,10,N,N,-,-1,-1
MULIFE.txt,402381,403996,1615,10,N,N,-,-1,-1
MULIFE.txt,402528,404463,1935,10,N,N,-,-1,-1
MULIFE.txt,402830,404629,1799,10,N,N,-,-1,-1
MULIFE.txt,403252,404826,1574,10,N,N,-,-1,-1
MULIFE.txt,403358,404951,1593,10,N,N,-,-1,-1
MULIFE.txt,403462,405111,1649,10,N,N,-,-1,-1
MULIFE.txt,403584,405124,1540,10,N,N,-,-1,-1
MULIFE.txt,403651,405217,1566,10,N,N,-,-1,-1
MULIFE.txt,403705,405289,1584,10,N,N,-,-1,-1
MULIFE.txt,403987,405343,1356,10,N,N,-,-1,-1
MULIFE.txt,403997,405514,1517,10,N,N,-,-1,-1
MULIFE.txt,404465,405547,1082,10,N,N,-,-1,-1
MULIFE.txt,404631,405570,939,10,N,N,-,-1,-1
MULIFE.txt,404827,405858,1031,10,N,N,-,-1,-1
MULIFE.txt,404952,406188,1236,10,N,N,-,-1,-1
MULIFE.txt,405111,406475,1364,10,N,N,-,-1,-1
MULIFE.txt,405125,406684,1559,10,N,N,-,-1,-1
MULIFE.txt,405218,406715,1497,10,Y,N,-,-1,-1
MULIFE.txt,405290,406789,1499,10,Y,N,-,-1,-1
MULIFE.txt,405344,406858,1514,10,Y,N,-,-1,-1
MULIFE.txt,405515,406887,1372,10,Y,N,-,-1,-1
MULIFE.txt,405552,406993,1441,10,Y,N,-,-1,-1
MULIFE.txt,405571,407052,1481,10,Y,N,-,-1,-1
MULIFE.txt,405859,407128,1269,10,N,N,-,-1,-1
MULIFE.txt,406190,407422,1232,10,N,N,-,-1,-1
MULIFE.txt,406477,407510,1033,10,N,N,-,-1,-1
MULIFE.txt,406687,407595,908,10,N,N,-,-1,-1
MULIFE.txt,406716,407670,954,10,N,N,-,-1,-1
MULIFE.txt,406790,407780,990,10,N,N,-,-1,-1
MULIFE.txt,406859,408003,1144,10,Y,N,-,-1,-1
MULIFE.txt,406888,408420,1532,10,Y,N,-,-1,-1
MULIFE.txt,406994,408522,1528,10,Y,N,-,-1,-1
MULIFE.txt,407055,408706,1651,10,Y,N,-,-1,-1
MULIFE.txt,407129,408745,1616,10,Y,N,-,-1,-1
MULIFE.txt,407423,408786,1363,10,Y,N,-,-1,-1
MULIFE.txt,407512,408851,1339,10,Y,N,-,-1,-1
MULIFE.txt,407596,409022,1426,10,Y,N,-,-1,-1
MULIFE.txt,407671,409246,1575,10,Y,N,-,-1,-1
MULIFE.txt,407781,409722,1941,10,Y,N,-,-1,-1
MULIFE.txt,408004,409894,1890,10,N,N,-,-1,-1
MULIFE.txt,408421,409987,1566,10,N,N,-,-1,-1
MULIFE.txt,408523,410166,1643,10,N,N,-,-1,-1
MULIFE.txt,408707,410210,1503,10,N,N,-,-1,-1
MULIFE.txt,408750,410349,1599,10,N,N,-,-1,-1
MULIFE.txt,408787,410378,1591,10,N,N,-,-1,-1
MULIFE.txt,408853,410626,1773,10,N,N,-,-1,-1
MULIFE.txt,409023,410661,1638,10,N,N,-,-1,-1
MULIFE.txt,409247,410723,1476,10,N,N,-,-1,-1
MULIFE.txt,409725,410855,1130,10,N,N,-,-1,-1
MULIFE.txt,409897,411342,1445,10,N,N,-,-1,-1
MULIFE.txt,409988,411497,1509,10,N,N,-,-1,-1
MULIFE.txt,410167,411726,1559,10,N,N,-,-1,-1
MULIFE.txt,410211,411868,1657,10,N,N,-,-1,-1
MULIFE.txt,410352,412022,1670,10,Y,N,-,-1,-1
MULIFE.txt,410379,412084,1705,10,Y,N,-,-1,-1
MULIFE.txt,410627,412376,1749,10,Y,N,-,-1,-1
MULIFE.txt,410662,412469,1807,10,Y,N,-,-1,-1
MULIFE.txt,410724,412564,1840,10,Y,N,-,-1,-1
MULIFE.txt,410856,412738,1882,10,Y,N,-,-1,-1
MULIFE.txt,411343,413108,1765,10,Y,N,-,-1,-1
MULIFE.txt,411498,413366,1868,10,Y,N,-,-1,-1
MULIFE.txt,411729,413510,1781,10,Y,N,-,-1,-1
MULIFE.txt,411869,413886,2017,10,Y,N,-,-1,-1
MULIFE.txt,412023,414091,2068,10,N,N,-,-1,-1
MULIFE.txt,412085,414485,2400,10,N,N,-,-1,-1
MULIFE.txt,412379,414728,2349,10,N,N,-,-1,-1
MULIFE.txt,412470,414735,2265,10,N,N,-,-1,-1
MULIFE.txt,412565,414758,2193,10,N,N,-,-1,-1
MULIFE.txt,412740,414815,2075,10,N,N,-,-1,-1
MULIFE.txt,413109,414911,1802,10,N,N,-,-1,-1
MULIFE.txt,413369,415013,1644,10,N,N,-,-1,-1
MULIFE.txt,413511,415060,1549,10,N,N,-,-1,-1
MULIFE.txt,413888,415156,1268,10,N,N,-,-1,-1
MULIFE.txt,414092,415407,1315,10,N,N,-,-1,-1
MULIFE.txt,414488,415488,1000,10,N,N,-,-1,-1
MULIFE.txt,414728,415613,885,10,N,N,-,-1,-1
MULIFE.txt,414736,415648,912,10,N,N,-,-1,-1
MULIFE.txt,414759,415738,979,10,N,N,-,-1,-1
MULIFE.txt,414816,415761,945,10,N,N,-,-1,-1
MULIFE.txt,414912,415896,984,10,N,N,-,-1,-1
MULIFE.txt,415014,416044,1030,10,N,N,-,-1,-1
MULIFE.txt,415061,416103,1042,10,N,N,-,-1,-1
MULIFE.txt,415158,416427,1269,10,N,N,-,-1,-1
MULIFE.txt,415408,416533,1125,10,N,N,-,-1,-1
MULIFE.txt,415491,416666,1175,10,N,N,-,-1,-1
MULIFE.txt,415614,416806,1192,10,N,N,-,-1,-1
MULIFE.txt,415649,417012,1363,10,N,N,-,-1,-1
MULIFE.txt,415739,417195,1456,10,N,N,-,-1,-1
MULIFE.txt,415762,417234,1472,10,N,N,-,-1,-1
MULIFE.txt,415897,417339,1442,10,N,N,-,-1,-1
MULIFE.txt,416045,417629,1584,10,N,N,-,-1,-1
MULIFE.txt,416105,417732,1627,10,N,N,-,-1,-1
MULIFE.txt,416430,417738,1308,10,N,N,-,-1,-1
MULIFE.txt,416534,417919,1385,10,N,N,-,-1,-1
MULIFE.txt,416669,417923,1254,10,N,N,-,-1,-1
MULIFE.txt,416807,418034,1227,10,N,N,-,-1,-1
MULIFE.txt,417013,418074,1061,10,N,N,-,-1,-1
MULIFE.txt,417197,418208,1011,10,N,N,-,-1,-1
MULIFE.txt,417235,418469,1234,10,N,N,-,-1,-1
MULIFE.txt,417340,418553,1213,10,N,N,-,-1,-1
MULIFE.txt,417632,418649,1017,10,N,N,-,-1,-1
MULIFE.txt,417734,418680,946,10,N,N,-,-1,-1
MULIFE.txt,417740,418726,986,10,N,N,-,-1,-1
MULIFE.txt,417920,419088,1168,10,N,N,-,-1,-1
MULIFE.txt,417926,419156,1230,10,N,N,-,-1,-1
MULIFE.txt,418035,419428,1393,10,N,N,-,-1,-1
MULIFE.txt,418075,419488,1413,10,N,N,-,-1,-1
MULIFE.txt,418210,419734,1524,10,N,N,-,-1,-1
MULIFE.txt,418470,420012,1542,10,N,N,-,-1,-1
MULIFE.txt,418555,420213,1658,10,N,N,-,-1,-1
MULIFE.txt,418650,420262,1612,10,N,N,-,-1,-1
MULIFE.txt,418681,420448,1767,10,N,N,-,-1,-1
MULIFE.txt,418728,420530,1802,10,N,N,-,-1,-1
MULIFE.txt,419091,420856,1765,10,N,N,-,-1,-1
MULIFE.txt,419157,421049,1892,10,N,N,-,-1,-1
MULIFE.txt,419431,421119,1688,10,N,N,-,-1,-1
MULIFE.txt,419490,421409,1919,10,N,N,-,-1,-1
MULIFE.txt,419735,421557,1822,10,N,N,-,-1,-1
MULIFE.txt,420013,421680,1667,10,N,N,-,-1,-1
MULIFE.txt,420214,422272,2058,10,N,N,-,-1,-1
MULIFE.txt,420263,422392,2129,10,N,N,-,-1,-1
MULIFE.txt,420449,422630,2181,10,N,N,-,-1,-1
MULIFE.txt,420531,422685,2154,10,N,N,-,-1,-1
MULIFE.txt,420857,422821,1964,10,N,N,-,-1,-1
MULIFE.txt,421050,422958,1908,10,N,N,-,-1,-1
MULIFE.txt,421120,423076,1956,10,N,N,-,-1,-1
MULIFE.txt,421411,423418,2007,10,N,N,-,-1,-1
MULIFE.txt,421558,424028,2470,10,N,N,-,-1,-1
MULIFE.txt,421681,424304,2623,10,N,N,-,-1,-1
MULIFE.txt,422273,424534,2261,10,N,N,-,-1,-1
MULIFE.txt,422393,424962,2569,10,N,N,-,-1,-1
MULIFE.txt,422631,425232,2601,10,N,N,-,-1,-1
MULIFE.txt,422688,425315,2627,10,N,N,-,-1,-1
MULIFE.txt,422822,425405,2583,10,N,N,-,-1,-1
MULIFE.txt,422959,425513,2554,10,N,N,-,-1,-1
MULIFE.txt,423077,425611,2534,10,N,N,-,-1,-1
MULIFE.txt,423419,425681,2262,10,N,N,-,-1,-1
MULIFE.txt,424029,425839,1810,10,N,N,-,-1,-1
MULIFE.txt,424305,425869,1564,10,N,N,-,-1,-1
MULIFE.txt,424535,425989,1454,10,N,N,-,-1,-1
MULIFE.txt,424963,426090,1127,10,N,N,-,-1,-1
MULIFE.txt,425235,426346,1111,10,N,N,-,-1,-1
MULIFE.txt,425316,426509,1193,10,N,N,-,-1,-1
MULIFE.txt,425407,426572,1165,10,N,N,-,-1,-1
MULIFE.txt,425514,426637,1123,10,N,N,-,-1,-1
MULIFE.txt,425612,426830,1218,10,N,N,-,-1,-1
MULIFE.txt,425683,427281,1598,10,N,N,-,-1,-1
MULIFE.txt,425842,427438,1596,10,N,N,-,-1,-1
MULIFE.txt,425870,427611,1741,10,N,N,-,-1,-1
MULIFE.txt,425990,428160,2170,10,N,N,-,-1,-1
MULIFE.txt,426091,428308,2217,10,N,N,-,-1,-1
MULIFE.txt,426347,428332,1985,10,N,N,-,-1,-1
MULIFE.txt,426510,428788,2278,10,N,N,-,-1,-1
MULIFE.txt,426573,428994,2421,10,N,N,-,-1,-1
MULIFE.txt,426638,429005,2367,10,N,N,-,-1,-1
MULIFE.txt,426831,429233,2402,10,N,N,-,-1,-1
MULIFE.txt,427282,429345,2063,10,N,N,-,-1,-1
MULIFE.txt,427439,429465,2026,10,N,N,-,-1,-1
MULIFE.txt,427612,429573,1961,10,N,N,-,-1,-1
MULIFE.txt,428163,429638,1475,10,N,N,-,-1,-1
MULIFE.txt,428309,429691,1382,10,N,N,-,-1,-1
MULIFE.txt,428335,429797,1462,10,N,N,-,-1,-1
MULIFE.txt,428789,429819,1030,10,N,N,-,-1,-1
MULIFE.txt,428997,429840,843,10,N,N,-,-1,-1
MULIFE.txt,429006,430167,1161,10,N,N,-,-1,-1
MULIFE.txt,429234,430271,1037,10,N,N,-,-1,-1
MULIFE.txt,429346,430527,1181,10,N,N,-,-1,-1
MULIFE.txt,429466,430642,1176,10,N,N,-,-1,-1
MULIFE.txt,429576,430682,1106,10,N,N,-,-1,-1
MULIFE.txt,429639,430688,1049,10,N,N,-,-1,-1
MULIFE.txt,429692,430749,1057,10,N,N,-,-1,-1
MULIFE.txt,429800,431077,1277,10,N,N,-,-1,-1
MULIFE.txt,429820,431158,1338,10,N,N,-,-1,-1
MULIFE.txt,429841,431274,1433,10,N,N,-,-1,-1
MULIFE.txt,430168,431420,1252,10,N,N,-,-1,-1
MULIFE.txt,430272,431693,1421,10,N,N,-,-1,-1
MULIFE.txt,430528,431934,1406,10,N,N,-,-1,-1
MULIFE.txt,430643,431997,1354,10,N,N,-,-1,-1
MULIFE.txt,430683,432087,1404,10,N,N,-,-1,-1
MULIFE.txt,430689,432165,1476,10,N,N,-,-1,-1
MULIFE.txt,430750,432345,1595,10,N,N,-,-1,-1
MULIFE.txt,431078,432441,1363,10,Y,N,-,-1,-1
MULIFE.txt,431159,432532,1373,10,N,N,-,-1,-1
MULIFE.txt,431275,432596,1321,10,N,N,-,-1,-1
MULIFE.txt,431421,432681,1260,10,N,N,-,-1,-1
MULIFE.txt,431694,432878,1184,10,N,N,-,-1,-1
MULIFE.txt,431935,433102,1167,10,N,N,-,-1,-1
MULIFE.txt,432000,433162,1162,10,N,N,-,-1,-1
MULIFE.txt,432090,433269,1179,10,N,N,-,-1,-1
MULIFE.txt,432166,433330,1164,10,N,N,-,-1,-1
MULIFE.txt,432346,433344,998,10,N,N,-,-1,-1
MULIFE.txt,432442,433360,918,10,N,N,-,-1,-1
MULIFE.txt,432534,433363,829,10,N,N,-,-1,-1
MULIFE.txt,432597,433365,768,10,N,N,-,-1,-1
MULIFE.txt,432682,433594,912,10,N,N,-,-1,-1
MULIFE.txt,432879,433622,743,10,N,N,-,-1,-1
MULIFE.txt,433105,433829,724,10,N,N,-,-1,-1
MULIFE.txt,433164,433992,828,10,N,N,-,-1,-1
MULIFE.txt,433271,434114,843,10,N,N,-,-1,-1
MULIFE.txt,433333,434247,914,10,N,N,-,-1,-1
MULIFE.txt,433345,434385,1040,10,N,N,-,-1,-1
MULIFE.txt,433361,434398,1037,10,N,N,-,-1,-1
MULIFE.txt,433364,434478,1114,10,N,N,-,-1,-1
MULIFE.txt,433368,434688,1320,10,N,N,-,-1,-1
MULIFE.txt,433595,434754,1159,10,N,N,-,-1,-1
MULIFE.txt,433623,434858,1235,10,N,N,-,-1,-1
MULIFE.txt,433830,434957,1127,10,N,N,-,-1,-1
MULIFE.txt,433993,435097,1104,10,N,N,-,-1,-1
MULIFE.txt,434117,435203,1086,10,N,N,-,-1,-1
MULIFE.txt,434248,435287,1039,10,N,N,-,-1,-1
MULIFE.txt,434388,435480,1092,10,N,N,-,-1,-1
MULIFE.txt,434401,435709,1308,10,N,N,-,-1,-1
MULIFE.txt,434479,435745,1266,10,N,N,-,-1,-1
MULIFE.txt,434689,435940,1251,10,N,N,-,-1,-1
MULIFE.txt,434755,436032,1277,10,N,N,-,-1,-1
MULIFE.txt,434859,436243,1384,10,N,N,-,-1,-1
MULIFE.txt,434958,436444,1486,10,N,N,-,-1,-1
MULIFE.txt,435100,436566,1466,10,N,N,-,-1,-1
MULIFE.txt,435204,436605,1401,10,N,N,-,-1,-1
MULIFE.txt,435289,436850,1561,10,N,N,-,-1,-1
MULIFE.txt,435481,436994,1513,10,N,N,-,-1,-1
MULIFE.txt,435712,437302,1590,10,N,N,-,-1,-1
MULIFE.txt,435746,437380,1634,10,N,N,-,-1,-1
MULIFE.txt,435943,437605,1662,10,N,N,-,-1,-1
MULIFE.txt,436033,437692,1659,10,N,N,-,-1,-1
MULIFE.txt,436244,437831,1587,10,N,N,-,-1,-1
MULIFE.txt,436445,437927,1482,10,N,N,-,-1,-1
MULIFE.txt,436567,437981,1414,10,N,N,-,-1,-1
MULIFE.txt,436606,438120,1514,10,N,N,-,-1,-1
MULIFE.txt,436852,438152,1300,10,N,N,-,-1,-1
MULIFE.txt,436995,438315,1320,10,N,N,-,-1,-1
MULIFE.txt,437303,438542,1239,10,N,N,-,-1,-1
MULIFE.txt,437383,438630,1247,10,N,N,-,-1,-1
MULIFE.txt,437606,438751,1145,10,N,N,-,-1,-1
MULIFE.txt,437695,438969,1274,10,Y,N,-,-1,-1
MULIFE.txt,437832,439102,1270,10,Y,N,-,-1,-1
MULIFE.txt,437928,439230,1302,10,N,N,-,-1,-1
MULIFE.txt,437982,439464,1482,10,N,N,-,-1,-1
MULIFE.txt,438123,439534,1411,10,N,N,-,-1,-1
MULIFE.txt,438153,439581,1428,10,N,N,-,-1,-1
MULIFE.txt,438316,439648,1332,10,N,N,-,-1,-1
MULIFE.txt,438543,439659,1116,10,N,N,-,-1,-1
MULIFE.txt,438631,439681,1050,10,N,N,-,-1,-1
MULIFE.txt,438752,439722,970,10,N,N,-,-1,-1
MULIFE.txt,438970,439754,784,10,N,N,-,-1,-1
MULIFE.txt,439103,440058,955,10,N,N,-,-1,-1
MULIFE.txt,439232,440230,998,10,N,N,-,-1,-1
MULIFE.txt,439467,440310,843,10,N,N,-,-1,-1
MULIFE.txt,439535,440319,784,10,N,N,-,-1,-1
MULIFE.txt,439583,440324,741,10,N,N,-,-1,-1
MULIFE.txt,439649,440849,1200,10,N,N,-,-1,-1
MULIFE.txt,439660,440933,1273,10,N,N,-,-1,-1
MULIFE.txt,439682,441053,1371,10,N,N,-,-1,-1
MULIFE.txt,439723,441163,1440,10,N,N,-,-1,-1
MULIFE.txt,439755,441212,1457,10,N,N,-,-1,-1
MULIFE.txt,440061,441337,1276,10,N,N,-,-1,-1
MULIFE.txt,440233,441407,1174,10,N,N,-,-1,-1
MULIFE.txt,440311,441597,1286,10,N,N,-,-1,-1
MULIFE.txt,440319,441735,1416,10,N,N,-,-1,-1
MULIFE.txt,440325,441942,1617,10,N,N,-,-1,-1
MULIFE.txt,440850,442056,1206,10,N,N,-,-1,-1
MULIFE.txt,440934,442211,1277,10,N,N,-,-1,-1
MULIFE.txt,441054,442213,1159,10,N,N,-,-1,-1
MULIFE.txt,441164,442337,1173,10,N,N,-,-1,-1
MULIFE.txt,441215,442439,1224,10,N,N,-,-1,-1
MULIFE.txt,441339,442517,1178,10,N,N,-,-1,-1
MULIFE.txt,441408,442625,1217,10,N,N,-,-1,-1
MULIFE.txt,441600,442740,1140,10,N,N,-,-1,-1
MULIFE.txt,441738,442837,1099,10,N,N,-,-1,-1
MULIFE.txt,441943,443082,1139,10,N,N,-,-1,-1
MULIFE.txt,442057,443302,1245,10,N,N,-,-1,-1
MULIFE.txt,442212,443318,1106,10,N,N,-,-1,-1
MULIFE.txt,442213,443415,1202,10,N,N,-,-1,-1
MULIFE.txt,442338,443499,1161,10,N,N,-,-1,-1
MULIFE.txt,442441,443521,1080,10,N,N,-,-1,-1
MULIFE.txt,442518,443546,1028,10,N,N,-,-1,-1
MULIFE.txt,442626,443747,1121,10,Y,N,-,-1,-1
MULIFE.txt,442741,443762,1021,10,N,N,-,-1,-1
MULIFE.txt,442838,443844,1006,10,N,N,-,-1,-1
MULIFE.txt,443083,443862,779,10,N,N,-,-1,-1
MULIFE.txt,443303,444031,728,10,N,N,-,-1,-1
MULIFE.txt,443319,444065,746,10,N,N,-,-1,-1
MULIFE.txt,443417,444258,841,10,N,N,-,-1,-1
MULIFE.txt,443500,444577,1077,10,N,N,-,-1,-1
MULIFE.txt,443522,444665,1143,10,N,N,-,-1,-1
MULIFE.txt,443547,444784,1237,10,N,N,-,-1,-1
MULIFE.txt,443748,444820,1072,10,N,N,-,-1,-1
MULIFE.txt,443763,445083,1320,10,N,N,-,-1,-1
MULIFE.txt,443845,445184,1339,10,N,N,-,-1,-1
MULIFE.txt,443863,445275,1412,10,N,N,-,-1,-1
MULIFE.txt,444036,445280,1244,10,N,N,-,-1,-1
MULIFE.txt,444068,445455,1387,10,N,N,-,-1,-1
MULIFE.txt,444259,445580,1321,10,N,N,-,-1,-1
MULIFE.txt,444580,445738,1158,10,N,N,-,-1,-1
MULIFE.txt,444666,445797,1131,10,N,N,-,-1,-1
MULIFE.txt,444785,445863,1078,10,N,N,-,-1,-1
MULIFE.txt,444821,445990,1169,10,N,N,-,-1,-1
MULIFE.txt,445084,446114,1030,10,N,N,-,-1,-1
MULIFE.txt,445185,446218,1033,10,N,N,-,-1,-1
MULIFE.txt,445276,446362,1086,10,N,N,-,-1,-1
MULIFE.txt,445283,446470,1187,10,N,N,-,-1,-1
MULIFE.txt,445456,446511,1055,10,N,N,-,-1,-1
MULIFE.txt,445581,446692,1111,10,N,N,-,-1,-1
MULIFE.txt,445741,446733,992,10,N,N,-,-1,-1
MULIFE.txt,445799,446881,1082,10,N,N,-,-1,-1
MULIFE.txt,445864,446934,1070,10,N,N,-,-1,-1
MULIFE.txt,445991,447024,1033,10,N,N,-,-1,-1
MULIFE.txt,446115,447249,1134,10,N,N,-,-1,-1
MULIFE.txt,446219,447423,1204,10,N,N,-,-1,-1
MULIFE.txt,446363,447520,1157,10,N,N,-,-1,-1
MULIFE.txt,446473,448026,1553,10,N,N,-,-1,-1
MULIFE.txt,446512,448033,1521,10,N,N,-,-1,-1
MULIFE.txt,446694,448045,1351,10,N,N,-,-1,-1
MULIFE.txt,446736,448113,1377,10,N,N,-,-1,-1
MULIFE.txt,446882,448212,1330,10,N,N,-,-1,-1
MULIFE.txt,446937,448333,1396,10,N,N,-,-1,-1
MULIFE.txt,447025,448421,1396,10,N,N,-,-1,-1
MULIFE.txt,447252,448681,1429,10,N,N,-,-1,-1
MULIFE.txt,447424,448752,1328,10,N,N,-,-1,-1
MULIFE.txt,447521,448851,1330,10,N,N,-,-1,-1
MULIFE.txt,448029,449060,1031,10,Y,N,-,-1,-1
MULIFE.txt,448034,449156,1122,10,Y,N,-,-1,-1
MULIFE.txt,448046,449383,1337,10,Y,N,-,-1,-1
MULIFE.txt,448114,449481,1367,10,Y,N,-,-1,-1
MULIFE.txt,448214,449543,1329,10,Y,N,-,-1,-1
MULIFE.txt,448334,449597,1263,10,Y,N,-,-1,-1
MULIFE.txt,448422,449673,1251,10,N,N,-,-1,-1
MULIFE.txt,448682,449738,1056,10,N,N,-,-1,-1
MULIFE.txt,448753,449945,1192,10,Y,N,-,-1,-1
MULIFE.txt,448852,450003,1151,10,Y,N,-,-1,-1
MULIFE.txt,449061,450041,980,10,N,N,-,-1,-1
MULIFE.txt,449157,450119,962,10,N,N,-,-1,-1
MULIFE.txt,449384,450343,959,10,N,N,-,-1,-1
MULIFE.txt,449482,450463,981,10,N,N,-,-1,-1
MULIFE.txt,449544,450631,1087,10,N,N,-,-1,-1
MULIFE.txt,449598,450772,1174,10,N,N,-,-1,-1
MULIFE.txt,449674,450833,1159,10,N,N,-,-1,-1
MULIFE.txt,449739,450984,1245,10,N,N,-,-1,-1
MULIFE.txt,449947,451159,1212,10,N,N,-,-1,-1
MULIFE.txt,450003,451280,1277,10,N,N,-,-1,-1
MULIFE.txt,450044,451339,1295,10,N,N,-,-1,-1
MULIFE.txt,450120,451459,1339,10,N,N,-,-1,-1
MULIFE.txt,450346,451543,1197,10,N,N,-,-1,-1
MULIFE.txt,450464,451627,1163,10,N,N,-,-1,-1
MULIFE.txt,450632,451848,1216,10,N,N,-,-1,-1
MULIFE.txt,450773,452154,1381,10,N,N,-,-1,-1
MULIFE.txt,450834,452314,1480,10,N,N,-,-1,-1
MULIFE.txt,450985,452389,1404,10,N,N,-,-1,-1
MULIFE.txt,451162,452407,1245,10,N,N,-,-1,-1
MULIFE.txt,451282,452417,1135,10,N,N,-,-1,-1
MULIFE.txt,451341,452503,1162,10,N,N,-,-1,-1
MULIFE.txt,451460,452639,1179,10,N,N,-,-1,-1
MULIFE.txt,451544,452741,1197,10,N,N,-,-1,-1
MULIFE.txt,451628,452862,1234,10,N,N,-,-1,-1
MULIFE.txt,451850,453054,1204,10,N,N,-,-1,-1
MULIFE.txt,452157,453144,987,10,N,N,-,-1,-1
MULIFE.txt,452315,453376,1061,10,N,N,-,-1,-1
MULIFE.txt,452392,453685,1293,10,N,N,-,-1,-1
MULIFE.txt,452408,453777,1369,10,N,N,-,-1,-1
MULIFE.txt,452418,453987,1569,10,N,N,-,-1,-1
MULIFE.txt,452504,454036,1532,10,N,N,-,-1,-1
MULIFE.txt,452640,454087,1447,10,N,N,-,-1,-1
MULIFE.txt,452742,454308,1566,10,N,N,-,-1,-1
MULIFE.txt,452863,454457,1594,10,N,N,-,-1,-1
MULIFE.txt,453057,454597,1540,10,N,N,-,-1,-1
MULIFE.txt,453147,454613,1466,10,N,N,-,-1,-1
MULIFE.txt,453377,454878,1501,10,N,N,-,-1,-1
MULIFE.txt,453686,455030,1344,10,N,N,-,-1,-1
MULIFE.txt,453780,455324,1544,10,N,N,-,-1,-1
MULIFE.txt,453988,455817,1829,10,N,N,-,-1,-1
MULIFE.txt,454037,455965,1928,10,N,N,-,-1,-1
MULIFE.txt,454089,456143,2054,10,N,N,-,-1,-1
MULIFE.txt,454309,456463,2154,10,N,N,-,-1,-1
MULIFE.txt,454458,456543,2085,10,N,N,-,-1,-1
MULIFE.txt,454602,456568,1966,10,N,N,-,-1,-1
MULIFE.txt,454614,456638,2024,10,N,N,-,-1,-1
MULIFE.txt,454879,456765,1886,10,N,N,-,-1,-1
MULIFE.txt,455031,457058,2027,10,N,N,-,-1,-1
MULIFE.txt,455327,457277,1950,10,N,N,-,-1,-1
MULIFE.txt,455818,457353,1535,10,N,N,-,-1,-1
MULIFE.txt,455966,457534,1568,10,N,N,-,-1,-1
MULIFE.txt,456144,457649,1505,10,N,N,-,-1,-1
MULIFE.txt,456466,457727,1261,10,N,N,-,-1,-1
MULIFE.txt,456544,457756,1212,10,N,N,-,-1,-1
MULIFE.txt,456569,457935,1366,10,N,N,-,-1,-1
MULIFE.txt,456641,457965,1324,10,N,N,-,-1,-1
MULIFE.txt,456766,458055,1289,10,N,N,-,-1,-1
MULIFE.txt,457059,458131,1072,10,N,N,-,-1,-1
MULIFE.txt,457278,458267,989,10,N,N,-,-1,-1
MULIFE.txt,457354,458294,940,10,N,N,-,-1,-1
MULIFE.txt,457535,458563,1028,10,N,N,-,-1,-1
MULIFE.txt,457650,458645,995,10,N,N,-,-1,-1
MULIFE.txt,457728,458802,1074,10,N,N,-,-1,-1
MULIFE.txt,457757,458884,1127,10,N,N,-,-1,-1
MULIFE.txt,457936,459225,1289,10,N,N,-,-1,-1
MULIFE.txt,457966,459335,1369,10,N,N,-,-1,-1
MULIFE.txt,458058,459459,1401,10,N,N,-,-1,-1
MULIFE.txt,458132,459865,1733,10,N,N,-,-1,-1
MULIFE.txt,458268,459943,1675,10,N,N,-,-1,-1
MULIFE.txt,458295,460017,1722,10,N,N,-,-1,-1
MULIFE.txt,458564,460088,1524,10,N,N,-,-1,-1
MULIFE.txt,458647,460133,1486,10,N,N,-,-1,-1
MULIFE.txt,458803,460247,1444,10,N,N,-,-1,-1
MULIFE.txt,458886,460617,1731,10,N,N,-,-1,-1
MULIFE.txt,459226,460742,1516,10,N,N,-,-1,-1
MULIFE.txt,459338,460806,1468,10,N,N,-,-1,-1
MULIFE.txt,459462,460899,1437,10,N,N,-,-1,-1
MULIFE.txt,459866,461125,1259,10,N,N,-,-1,-1
MULIFE.txt,459944,461408,1464,10,N,N,-,-1,-1
MULIFE.txt,460019,461511,1492,10,N,N,-,-1,-1
MULIFE.txt,460089,461670,1581,10,Y,N,-,-1,-1
MULIFE.txt,460135,461760,1625,10,Y,N,-,-1,-1
MULIFE.txt,460250,461893,1643,10,Y,N,-,-1,-1
MULIFE.txt,460618,461947,1329,10,N,N,-,-1,-1
MULIFE.txt,460743,462124,1381,10,N,N,-,-1,-1
MULIFE.txt,460808,462257,1449,10,N,N,-,-1,-1
MULIFE.txt,460900,462294,1394,10,N,N,-,-1,-1
MULIFE.txt,461126,462348,1222,10,N,N,-,-1,-1
MULIFE.txt,461409,462842,1433,10,N,N,-,-1,-1
MULIFE.txt,461514,463029,1515,10,N,N,-,-1,-1
MULIFE.txt,461671,463052,1381,10,N,N,-,-1,-1
MULIFE.txt,461761,463215,1454,10,N,N,-,-1,-1
MULIFE.txt,461894,463250,1356,10,N,N,-,-1,-1
MULIFE.txt,461948,463579,1631,10,N,N,-,-1,-1
MULIFE.txt,462125,463605,1480,10,N,N,-,-1,-1
MULIFE.txt,462260,463752,1492,10,N,N,-,-1,-1
MULIFE.txt,462295,464098,1803,10,N,N,-,-1,-1
MULIFE.txt,462349,464155,1806,10,N,N,-,-1,-1
MULIFE.txt,462845,464195,1350,10,N,N,-,-1,-1
MULIFE.txt,463030,464240,1210,10,N,N,-,-1,-1
MULIFE.txt,463055,464357,1302,10,N,N,-,-1,-1
MULIFE.txt,463218,464435,1217,10,N,N,-,-1,-1
MULIFE.txt,463251,464465,1214,10,N,N,-,-1,-1
MULIFE.txt,463580,464631,1051,10,N,N,-,-1,-1
MULIFE.txt,463606,464825,1219,10,N,N,-,-1,-1
MULIFE.txt,463753,465331,1578,10,N,N,-,-1,-1
MULIFE.txt,464099,465365,1266,10,N,N,-,-1,-1
MULIFE.txt,464156,465595,1439,10,N,N,-,-1,-1
MULIFE.txt,464196,465616,1420,10,N,N,-,-1,-1
MULIFE.txt,464241,465667,1426,10,N,N,-,-1,-1
MULIFE.txt,464358,465719,1361,10,N,N,-,-1,-1
MULIFE.txt,464436,465820,1384,10,N,N,-,-1,-1
MULIFE.txt,464466,465936,1470,10,N,N,-,-1,-1
MULIFE.txt,464632,466072,1440,10,N,N,-,-1,-1
MULIFE.txt,464826,466139,1313,10,N,N,-,-1,-1
MULIFE.txt,465336,466151,815,10,N,N,-,-1,-1
MULIFE.txt,465368,466205,837,10,N,N,-,-1,-1
MULIFE.txt,465598,466233,635,10,N,N,-,-1,-1
MULIFE.txt,465617,466272,655,10,N,N,-,-1,-1
MULIFE.txt,465669,466437,768,10,N,N,-,-1,-1
MULIFE.txt,465720,466534,814,10,N,N,-,-1,-1
MULIFE.txt,465821,466603,782,10,N,N,-,-1,-1
MULIFE.txt,465937,466688,751,10,N,N,-,-1,-1
MULIFE.txt,466073,466784,711,10,N,N,-,-1,-1
MULIFE.txt,466144,466845,701,10,N,N,-,-1,-1
MULIFE.txt,466152,467053,901,10,N,N,-,-1,-1
MULIFE.txt,466208,467129,921,10,N,N,-,-1,-1
MULIFE.txt,466234,467207,973,10,N,N,-,-1,-1
MULIFE.txt,466274,467227,953,10,N,N,-,-1,-1
MULIFE.txt,466440,467334,894,10,N,N,-,-1,-1
MULIFE.txt,466537,467382,845,10,N,N,-,-1,-1
MULIFE.txt,466604,467436,832,10,N,N,-,-1,-1
MULIFE.txt,466689,467450,761,10,N,N,-,-1,-1
MULIFE.txt,466785,467476,691,10,N,N,-,-1,-1
MULIFE.txt,466846,467701,855,10,N,N,-,-1,-1
MULIFE.txt,467056,467769,713,10,N,N,-,-1,-1
MULIFE.txt,467130,467905,775,10,N,N,-,-1,-1
MULIFE.txt,467208,468160,952,10,N,N,-,-1,-1
MULIFE.txt,467228,468369,1141,10,N,N,-,-1,-1
MULIFE.txt,467337,468573,1236,10,N,N,-,-1,-1
MULIFE.txt,467383,468666,1283,10,N,N,-,-1,-1
MULIFE.txt,467437,468741,1304,10,N,N,-,-1,-1
MULIFE.txt,467451,468784,1333,10,N,N,-,-1,-1
MULIFE.txt,467477,468895,1418,10,N,N,-,-1,-1
MULIFE.txt,467702,468936,1234,10,N,N,-,-1,-1
MULIFE.txt,467770,469335,1565,10,N,N,-,-1,-1
MULIFE.txt,467906,469494,1588,10,N,N,-,-1,-1
MULIFE.txt,468161,469566,1405,10,N,N,-,-1,-1
MULIFE.txt,468371,469628,1257,10,N,N,-,-1,-1
MULIFE.txt,468574,469671,1097,10,N,N,-,-1,-1
MULIFE.txt,468669,469718,1049,10,N,N,-,-1,-1
MULIFE.txt,468742,469802,1060,10,N,N,-,-1,-1
MULIFE.txt,468785,470006,1221,10,N,N,-,-1,-1
MULIFE.txt,468896,470019,1123,10,N,N,-,-1,-1
MULIFE.txt,468938,470400,1462,10,N,N,-,-1,-1
MULIFE.txt,469336,470637,1301,10,N,N,-,-1,-1
MULIFE.txt,469497,470755,1258,10,N,N,-,-1,-1
MULIFE.txt,469567,470894,1327,10,N,N,-,-1,-1
MULIFE.txt,469629,470902,1273,10,N,N,-,-1,-1
MULIFE.txt,469672,470939,1267,10,N,N,-,-1,-1
MULIFE.txt,469720,471015,1295,10,N,N,-,-1,-1
MULIFE.txt,469803,471054,1251,10,N,N,-,-1,-1
MULIFE.txt,470009,471098,1089,10,N,N,-,-1,-1
MULIFE.txt,470020,471209,1189,10,N,N,-,-1,-1
MULIFE.txt,470401,471285,884,10,N,N,-,-1,-1
MULIFE.txt,470638,471349,711,10,N,N,-,-1,-1
MULIFE.txt,470756,471368,612,10,N,N,-,-1,-1
MULIFE.txt,470899,471597,698,10,N,N,-,-1,-1
MULIFE.txt,470905,471709,804,10,N,N,-,-1,-1
MULIFE.txt,470942,471729,787,10,N,N,-,-1,-1
MULIFE.txt,471016,471885,869,10,N,N,-,-1,-1
MULIFE.txt,471056,471994,938,10,N,N,-,-1,-1
MULIFE.txt,471099,472066,967,10,N,N,-,-1,-1
MULIFE.txt,471210,472139,929,10,N,N,-,-1,-1
MULIFE.txt,471286,472143,857,10,N,N,-,-1,-1
MULIFE.txt,471351,472242,891,10,N,N,-,-1,-1
MULIFE.txt,471369,472375,1006,10,N,N,-,-1,-1
MULIFE.txt,471598,472427,829,10,N,N,-,-1,-1
MULIFE.txt,471710,472615,905,10,N,N,-,-1,-1
MULIFE.txt,471730,472731,1001,10,N,N,-,-1,-1
MULIFE.txt,471886,472889,1003,10,N,N,-,-1,-1
MULIFE.txt,471996,472930,934,10,N,N,-,-1,-1
MULIFE.txt,472067,472985,918,10,N,N,-,-1,-1
MULIFE.txt,472140,473092,952,10,N,N,-,-1,-1
MULIFE.txt,472144,473318,1174,10,N,N,-,-1,-1
MULIFE.txt,472243,473669,1426,10,N,N,-,-1,-1
MULIFE.txt,472376,473829,1453,10,N,N,-,-1,-1
MULIFE.txt,472428,474053,1625,10,N,N,-,-1,-1
MULIFE.txt,472616,474426,1810,10,N,N,-,-1,-1
MULIFE.txt,472732,475013,2281,10,N,N,-,-1,-1
MULIFE.txt,472892,475247,2355,10,Y,N,-,-1,-1
MULIFE.txt,472931,475293,2362,10,Y,N,-,-1,-1
MULIFE.txt,472986,475331,2345,10,Y,N,-,-1,-1
MULIFE.txt,473095,475394,2299,10,Y,N,-,-1,-1
MULIFE.txt,473319,475406,2087,10,N,N,-,-1,-1
MULIFE.txt,473670,475518,1848,10,N,N,-,-1,-1
MULIFE.txt,473830,475589,1759,10,N,N,-,-1,-1
MULIFE.txt,474054,475649,1595,10,N,N,-,-1,-1
MULIFE.txt,474427,475718,1291,10,N,N,-,-1,-1
MULIFE.txt,475016,475809,793,10,N,N,-,-1,-1
MULIFE.txt,475250,475892,642,10,N,N,-,-1,-1
MULIFE.txt,475296,475947,651,10,N,N,-,-1,-1
MULIFE.txt,475334,475961,627,10,N,N,-,-1,-1
MULIFE.txt,475395,476072,677,10,N,N,-,-1,-1
MULIFE.txt,475407,476087,680,10,N,N,-,-1,-1
MULIFE.txt,475519,476395,876,10,N,N,-,-1,-1
MULIFE.txt,475590,476556,966,10,N,N,-,-1,-1
MULIFE.txt,475651,476635,984,10,N,N,-,-1,-1
MULIFE.txt,475719,476670,951,10,N,N,-,-1,-1
MULIFE.txt,475812,476676,864,10,N,N,-,-1,-1
MULIFE.txt,475895,476725,830,10,N,N,-,-1,-1
MULIFE.txt,475948,476804,856,10,N,N,-,-1,-1
MULIFE.txt,475962,476962,1000,10,N,N,-,-1,-1
MULIFE.txt,476075,477033,958,10,N,N,-,-1,-1
MULIFE.txt,476090,477062,972,10,N,N,-,-1,-1
MULIFE.txt,476396,477112,716,10,N,N,-,-1,-1
MULIFE.txt,476557,477177,620,10,N,N,-,-1,-1
MULIFE.txt,476636,477345,709,10,N,N,-,-1,-1
MULIFE.txt,476671,477377,706,10,N,N,-,-1,-1
MULIFE.txt,476677,477465,788,10,N,N,-,-1,-1
MULIFE.txt,476726,477486,760,10,N,N,-,-1,-1
MULIFE.txt,476805,477493,688,10,N,N,-,-1,-1
MULIFE.txt,476963,477563,600,10,N,N,-,-1,-1
MULIFE.txt,477038,477593,555,10,N,N,-,-1,-1
MULIFE.txt,477063,477632,569,10,N,N,-,-1,-1
MULIFE.txt,477113,477684,571,10,N,N,-,-1,-1
MULIFE.txt,477178,477733,555,10,N,N,-,-1,-1
MULIFE.txt,477348,477759,411,10,N,N,-,-1,-1
MULIFE.txt,477378,477783,405,10,N,N,-,-1,-1
MULIFE.txt,477467,477881,414,10,N,N,-,-1,-1
MULIFE.txt,477487,477890,403,10,N,N,-,-1,-1
MULIFE.txt,477494,477950,456,10,N,N,-,-1,-1
MULIFE.txt,477566,478107,541,10,N,N,-,-1,-1
MULIFE.txt,477594,478121,527,10,N,N,-,-1,-1
MULIFE.txt,477633,478171,538,10,N,N,-,-1,-1
MULIFE.txt,477686,478461,775,10,N,N,-,-1,-1
MULIFE.txt,477734,478581,847,10,N,N,-,-1,-1
MULIFE.txt,477760,478630,870,10,N,N,-,-1,-1
MULIFE.txt,477784,478972,1188,10,N,N,-,-1,-1
MULIFE.txt,477884,479010,1126,10,N,N,-,-1,-1
MULIFE.txt,477891,479126,1235,10,N,N,-,-1,-1
MULIFE.txt,477951,479215,1264,10,N,N,-,-1,-1
MULIFE.txt,478108,479228,1120,10,N,N,-,-1,-1
MULIFE.txt,478122,479261,1139,10,N,N,-,-1,-1
MULIFE.txt,478172,479326,1154,10,N,N,-,-1,-1
MULIFE.txt,478464,479416,952,10,N,N,-,-1,-1
MULIFE.txt,478582,479445,863,10,N,N,-,-1,-1
MULIFE.txt,478633,479454,821,10,N,N,-,-1,-1
MULIFE.txt,478973,479498,525,10,N,N,-,-1,-1
MULIFE.txt,479011,479573,562,10,N,N,-,-1,-1
MULIFE.txt,479128,479662,534,10,N,N,-,-1,-1
MULIFE.txt,479216,479687,471,10,N,N,-,-1,-1
MULIFE.txt,479229,479889,660,10,N,N,-,-1,-1
MULIFE.txt,479262,480115,853,10,N,N,-,-1,-1
MULIFE.txt,479327,480327,1000,10,N,N,-,-1,-1
MULIFE.txt,479417,480350,933,10,N,N,-,-1,-1
MULIFE.txt,479447,480404,957,10,N,N,-,-1,-1
MULIFE.txt,479455,480443,988,10,N,N,-,-1,-1
MULIFE.txt,479499,480582,1083,10,N,N,-,-1,-1
MULIFE.txt,479576,480616,1040,10,N,N,-,-1,-1
MULIFE.txt,479663,480687,1024,10,N,N,-,-1,-1
MULIFE.txt,479689,480745,1056,10,N,N,-,-1,-1
MULIFE.txt,479890,480956,1066,10,N,N,-,-1,-1
MULIFE.txt,480118,480990,872,10,N,N,-,-1,-1
MULIFE.txt,480328,481039,711,10,N,N,-,-1,-1
MULIFE.txt,480351,481166,815,10,N,N,-,-1,-1
MULIFE.txt,480405,481205,800,10,N,N,-,-1,-1
MULIFE.txt,480446,481220,774,10,N,N,-,-1,-1
MULIFE.txt,480583,481242,659,10,N,N,-,-1,-1
MULIFE.txt,480617,481283,666,10,N,N,-,-1,-1
MULIFE.txt,480690,481404,714,10,N,N,-,-1,-1
MULIFE.txt,480746,481419,673,10,N,N,-,-1,-1
MULIFE.txt,480957,481531,574,10,N,N,-,-1,-1
MULIFE.txt,480991,481811,820,10,N,N,-,-1,-1
MULIFE.txt,481042,481936,894,10,N,N,-,-1,-1
MULIFE.txt,481169,482037,868,10,N,N,-,-1,-1
MULIFE.txt,481206,482075,869,10,N,N,-,-1,-1
MULIFE.txt,481221,482197,976,10,N,N,-,-1,-1
MULIFE.txt,481243,482263,1020,10,N,N,-,-1,-1
MULIFE.txt,481286,482273,987,10,N,N,-,-1,-1
MULIFE.txt,481407,482354,947,10,N,N,-,-1,-1
MULIFE.txt,481420,482363,943,10,N,N,-,-1,-1
MULIFE.txt,481532,482454,922,10,N,N,-,-1,-1
MULIFE.txt,481813,482483,670,10,N,N,-,-1,-1
MULIFE.txt,481937,482562,625,10,N,N,-,-1,-1
MULIFE.txt,482038,482633,595,10,N,N,-,-1,-1
MULIFE.txt,482076,482741,665,10,N,N,-,-1,-1
MULIFE.txt,482198,482807,609,10,N,N,-,-1,-1
MULIFE.txt,482264,483072,808,10,N,N,-,-1,-1
MULIFE.txt,482276,483226,950,10,N,N,-,-1,-1
MULIFE.txt,482357,483353,996,10,N,N,-,-1,-1
MULIFE.txt,482364,483420,1056,10,N,N,-,-1,-1
MULIFE.txt,482457,483429,972,10,N,N,-,-1,-1
MULIFE.txt,482484,483604,1120,10,N,N,-,-1,-1
MULIFE.txt,482563,483657,1094,10,N,N,-,-1,-1
MULIFE.txt,482636,483711,1075,10,N,N,-,-1,-1
MULIFE.txt,482742,483790,1048,10,N,N,-,-1,-1
MULIFE.txt,482808,484008,1200,10,N,N,-,-1,-1
MULIFE.txt,483073,484023,950,10,N,N,-,-1,-1
MULIFE.txt,483227,484177,950,10,N,N,-,-1,-1
MULIFE.txt,483354,484334,980,10,N,N,-,-1,-1
MULIFE.txt,483421,484439,1018,10,N,N,-,-1,-1
MULIFE.txt,483432,484511,1079,10,N,N,-,-1,-1
MULIFE.txt,483605,484736,1131,10,N,N,-,-1,-1
MULIFE.txt,483658,484804,1146,10,N,N,-,-1,-1
MULIFE.txt,483713,484912,1199,10,N,N,-,-1,-1
MULIFE.txt,483793,484928,1135,10,N,N,-,-1,-1
MULIFE.txt,484009,484975,966,10,N,N,-,-1,-1
MULIFE.txt,484024,485058,1034,10,N,N,-,-1,-1
MULIFE.txt,484178,485419,1241,10,N,N,-,-1,-1
MULIFE.txt,484335,485449,1114,10,N,N,-,-1,-1
MULIFE.txt,484440,485499,1059,10,N,N,-,-1,-1
MULIFE.txt,484512,485632,1120,10,N,N,-,-1,-1
MULIFE.txt,484737,485821,1084,10,N,N,-,-1,-1
MULIFE.txt,484807,486059,1252,10,N,N,-,-1,-1
MULIFE.txt,484913,486323,1410,10,N,N,-,-1,-1
MULIFE.txt,484929,486744,1815,10,N,N,-,-1,-1
MULIFE.txt,484976,487120,2144,10,N,N,-,-1,-1
MULIFE.txt,485059,487131,2072,10,N,N,-,-1,-1
MULIFE.txt,485422,487324,1902,10,N,N,-,-1,-1
MULIFE.txt,485450,487561,2111,10,N,N,-,-1,-1
MULIFE.txt,485500,487666,2166,10,N,N,-,-1,-1
MULIFE.txt,485633,488024,2391,10,N,N,-,-1,-1
MULIFE.txt,485822,488168,2346,10,N,N,-,-1,-1
MULIFE.txt,486060,488302,2242,10,N,N,-,-1,-1
MULIFE.txt,486326,488363,2037,10,N,N,-,-1,-1
MULIFE.txt,486747,488417,1670,10,N,N,-,-1,-1
MULIFE.txt,487121,488533,1412,10,N,N,-,-1,-1
MULIFE.txt,487134,488622,1488,10,N,N,-,-1,-1
MULIFE.txt,487325,488717,1392,10,N,N,-,-1,-1
MULIFE.txt,487562,488722,1160,10,N,N,-,-1,-1
MULIFE.txt,487667,488755,1088,10,N,N,-,-1,-1
MULIFE.txt,488027,488760,733,10,N,N,-,-1,-1
MULIFE.txt,488169,488800,631,10,N,N,-,-1,-1
MULIFE.txt,488303,488805,502,10,N,N,-,-1,-1
MULIFE.txt,488365,488858,493,10,N,N,-,-1,-1
MULIFE.txt,488418,488863,445,10,N,N,-,-1,-1
MULIFE.txt,488536,488885,349,10,N,N,-,-1,-1
MULIFE.txt,488623,488931,308,10,N,N,-,-1,-1
MULIFE.txt,488718,488936,218,10,N,N,-,-1,-1
MULIFE.txt,488723,488956,233,10,N,N,-,-1,-1
MULIFE.txt,488756,489005,249,10,N,N,-,-1,-1
MULIFE.txt,488761,489152,391,10,N,N,-,-1,-1
MULIFE.txt,488801,489268,467,10,N,N,-,-1,-1
MULIFE.txt,488806,489292,486,10,N,N,-,-1,-1
MULIFE.txt,488859,489309,450,10,N,N,-,-1,-1
MULIFE.txt,488864,489357,493,10,N,N,-,-1,-1
MULIFE.txt,488886,489404,518,10,N,N,-,-1,-1
MULIFE.txt,488932,489435,503,10,N,N,-,-1,-1
MULIFE.txt,488937,489563,626,10,N,N,-,-1,-1
MULIFE.txt,488958,489615,657,10,N,N,-,-1,-1
MULIFE.txt,489006,489638,632,10,N,N,-,-1,-1
MULIFE.txt,489155,489831,676,10,N,N,-,-1,-1
MULIFE.txt,489271,490036,765,10,N,N,-,-1,-1
MULIFE.txt,489293,490047,754,10,N,N,-,-1,-1
MULIFE.txt,489310,490212,902,10,N,N,-,-1,-1
MULIFE.txt,489357,490304,947,10,N,N,-,-1,-1
MULIFE.txt,489407,490404,997,10,N,N,-,-1,-1
MULIFE.txt,489436,490416,980,10,N,N,-,-1,-1
MULIFE.txt,489566,490491,925,10,N,N,-,-1,-1
MULIFE.txt,489616,490547,931,10,N,N,-,-1,-1
MULIFE.txt,489641,490556,915,10,N,N,-,-1,-1
MULIFE.txt,489834,490584,750,10,N,N,-,-1,-1
MULIFE.txt,490037,490596,559,10,N,N,-,-1,-1
MULIFE.txt,490050,490638,588,10,N,N,-,-1,-1
MULIFE.txt,490215,490801,586,10,N,N,-,-1,-1
MULIFE.txt,490305,491046,741,10,N,N,-,-1,-1
MULIFE.txt,490407,491513,1106,10,N,N,-,-1,-1
MULIFE.txt,490417,491704,1287,10,N,N,-,-1,-1
MULIFE.txt,490492,491890,1398,10,N,N,-,-1,-1
MULIFE.txt,490549,491930,1381,10,N,Y,1448314192885,179720,179950
MULIFE.txt,490561,491986,1425,10,N,Y,1448314192885,179720,179950
MULIFE.txt,490585,492181,1596,10,Y,Y,1448314192885,179720,179950
MULIFE.txt,490599,492275,1676,10,Y,Y,1448314192885,179720,179950
MULIFE.txt,490641,492385,1744,10,Y,Y,1448314192885,179720,179950
MULIFE.txt,490802,492515,1713,10,Y,Y,1448314192885,179720,179950
MULIFE.txt,491047,492736,1689,10,Y,Y,1448314192885,179720,179950
MULIFE.txt,491516,492786,1270,10,Y,Y,1448314192885,179720,179950
MULIFE.txt,491707,492897,1190,10,N,Y,1448314192885,179720,179950
MULIFE.txt,491891,492971,1080,10,N,Y,1448314192885,179720,179950
MULIFE.txt,491931,492990,1059,10,N,Y,1448314192885,179720,179950
MULIFE.txt,491987,493128,1141,10,N,Y,1448314192885,179720,179950
MULIFE.txt,492182,493246,1064,10,N,Y,1448314192885,179720,179950
MULIFE.txt,492276,493327,1051,10,N,Y,1448314192885,179720,179950
MULIFE.txt,492388,493396,1008,10,N,N,-,-1,-1
MULIFE.txt,492518,493546,1028,10,N,N,-,-1,-1
MULIFE.txt,492739,493639,900,10,Y,N,-,-1,-1
MULIFE.txt,492787,493697,910,10,Y,N,-,-1,-1
MULIFE.txt,492898,493796,898,10,Y,N,-,-1,-1
MULIFE.txt,492974,493876,902,10,Y,Y,1448285563397,102964,108476
MULIFE.txt,492991,493980,989,10,Y,Y,1448285563397,102964,108476
MULIFE.txt,493129,494067,938,10,Y,Y,1448285563397,102964,108476
MULIFE.txt,493249,494229,980,10,Y,Y,1448285563397,102964,108476
MULIFE.txt,493328,494260,932,10,Y,Y,1448285563397,102964,108476
MULIFE.txt,493397,494334,937,10,Y,Y,1448285563397,102964,108476
MULIFE.txt,493547,494365,818,10,N,Y,1448285563397,102964,108476
MULIFE.txt,493640,494462,822,10,N,Y,1448285563397,102964,108476
MULIFE.txt,493698,494537,839,10,N,Y,1448285563397,102964,108476
MULIFE.txt,493797,494580,783,10,N,Y,1448285563397,102964,108476
MULIFE.txt,493877,494585,708,10,N,Y,1448285563397,102964,108476
MULIFE.txt,493981,494591,610,10,N,Y,1448285563397,102964,108476
MULIFE.txt,494068,494620,552,10,N,Y,1448285563397,102964,108476
MULIFE.txt,494231,494702,471,10,N,N,-,-1,-1
MULIFE.txt,494261,494721,460,10,N,N,-,-1,-1
MULIFE.txt,494337,494815,478,10,N,N,-,-1,-1
MULIFE.txt,494366,494845,479,10,N,N,-,-1,-1
MULIFE.txt,494465,494888,423,10,N,N,-,-1,-1
MULIFE.txt,494538,494948,410,10,N,N,-,-1,-1
MULIFE.txt,494581,495056,475,10,N,N,-,-1,-1
MULIFE.txt,494586,495188,602,10,N,N,-,-1,-1
MULIFE.txt,494592,495395,803,10,N,N,-,-1,-1
MULIFE.txt,494621,495423,802,10,N,N,-,-1,-1
MULIFE.txt,494703,495452,749,10,N,N,-,-1,-1
MULIFE.txt,494722,495592,870,10,N,N,-,-1,-1
MULIFE.txt,494816,495829,1013,10,N,N,-,-1,-1
MULIFE.txt,494846,495876,1030,10,N,N,-,-1,-1
MULIFE.txt,494889,495972,1083,10,Y,N,-,-1,-1
MULIFE.txt,494949,496002,1053,10,Y,N,-,-1,-1
MULIFE.txt,495057,496100,1043,10,N,N,-,-1,-1
MULIFE.txt,495191,496199,1008,10,N,N,-,-1,-1
MULIFE.txt,495396,496391,995,10,Y,N,-,-1,-1
MULIFE.txt,495426,496569,1143,10,Y,N,-,-1,-1
MULIFE.txt,495453,496706,1253,10,Y,N,-,-1,-1
MULIFE.txt,495593,496806,1213,10,Y,N,-,-1,-1
MULIFE.txt,495830,496920,1090,10,Y,N,-,-1,-1
MULIFE.txt,495877,497086,1209,10,Y,N,-,-1,-1
MULIFE.txt,495975,497191,1216,10,Y,N,-,-1,-1
MULIFE.txt,496003,497214,1211,10,Y,N,-,-1,-1
MULIFE.txt,496101,497287,1186,10,Y,N,-,-1,-1
MULIFE.txt,496200,497369,1169,10,Y,N,-,-1,-1
MULIFE.txt,496392,497407,1015,10,Y,N,-,-1,-1
MULIFE.txt,496572,497458,886,10,N,N,-,-1,-1
MULIFE.txt,496707,497602,895,10,N,N,-,-1,-1
MULIFE.txt,496807,497650,843,10,Y,N,-,-1,-1
MULIFE.txt,496921,497766,845,10,Y,N,-,-1,-1
MULIFE.txt,497088,497833,745,10,N,N,-,-1,-1
MULIFE.txt,497194,497963,769,10,N,N,-,-1,-1
MULIFE.txt,497215,498056,841,10,N,N,-,-1,-1
MULIFE.txt,497288,498105,817,10,N,N,-,-1,-1
MULIFE.txt,497371,498204,833,10,N,N,-,-1,-1
MULIFE.txt,497408,498265,857,10,N,N,-,-1,-1
MULIFE.txt,497461,498515,1054,10,N,N,-,-1,-1
MULIFE.txt,497603,498620,1017,10,N,N,-,-1,-1
MULIFE.txt,497651,498671,1020,10,N,N,-,-1,-1
MULIFE.txt,497767,498745,978,10,N,N,-,-1,-1
MULIFE.txt,497834,498925,1091,10,N,N,-,-1,-1
MULIFE.txt,497964,499034,1070,10,N,N,-,-1,-1
MULIFE.txt,498057,499136,1079,10,N,N,-,-1,-1
MULIFE.txt,498106,499148,1042,10,N,N,-,-1,-1
MULIFE.txt,498207,499329,1122,10,N,N,-,-1,-1
MULIFE.txt,498266,499449,1183,10,Y,N,-,-1,-1
MULIFE.txt,498516,499598,1082,10,Y,N,-,-1,-1
MULIFE.txt,498621,499671,1050,10,Y,N,-,-1,-1
MULIFE.txt,498672,499735,1063,10,Y,N,-,-1,-1
MULIFE.txt,498746,499799,1053,10,Y,N,-,-1,-1
MULIFE.txt,498928,499952,1024,10,N,N,-,-1,-1
MULIFE.txt,499036,500021,985,10,N,N,-,-1,-1
MULIFE.txt,499139,500090,951,10,N,N,-,-1,-1
MULIFE.txt,499149,500095,946,10,N,N,-,-1,-1
MULIFE.txt,499330,500106,776,10,N,N,-,-1,-1
MULIFE.txt,499450,500137,687,10,N,N,-,-1,-1
MULIFE.txt,499599,500155,556,10,N,N,-,-1,-1
MULIFE.txt,499672,500190,518,10,N,N,-,-1,-1
MULIFE.txt,499737,500394,657,10,N,N,-,-1,-1
MULIFE.txt,499802,500459,657,10,N,N,-,-1,-1
MULIFE.txt,499955,500531,576,10,N,N,-,-1,-1
MULIFE.txt,500022,500689,667,10,N,N,-,-1,-1
MULIFE.txt,500091,500875,784,10,N,N,-,-1,-1
MULIFE.txt,500096,500963,867,10,N,N,-,-1,-1
MULIFE.txt,500107,501138,1031,10,N,N,-,-1,-1
MULIFE.txt,500138,501192,1054,10,N,N,-,-1,-1
MULIFE.txt,500156,501367,1211,10,N,N,-,-1,-1
MULIFE.txt,500191,501396,1205,10,N,N,-,-1,-1
MULIFE.txt,500395,501456,1061,10,N,N,-,-1,-1
MULIFE.txt,500462,501524,1062,10,N,N,-,-1,-1
MULIFE.txt,500532,501656,1124,10,Y,N,-,-1,-1
MULIFE.txt,500692,501678,986,10,Y,N,-,-1,-1
MULIFE.txt,500878,502043,1165,10,Y,N,-,-1,-1
MULIFE.txt,500964,502262,1298,10,N,N,-,-1,-1
MULIFE.txt,501141,502575,1434,10,N,N,-,-1,-1
MULIFE.txt,501194,502863,1669,10,N,N,-,-1,-1
MULIFE.txt,501372,503026,1654,10,N,N,-,-1,-1
MULIFE.txt,501397,503333,1936,10,N,N,-,-1,-1
MULIFE.txt,501459,503452,1993,10,N,N,-,-1,-1
MULIFE.txt,501525,503608,2083,10,N,N,-,-1,-1
MULIFE.txt,501657,503802,2145,10,N,N,-,-1,-1
MULIFE.txt,501679,503935,2256,10,N,N,-,-1,-1
MULIFE.txt,502046,504066,2020,10,N,N,-,-1,-1
MULIFE.txt,502263,504225,1962,10,N,N,-,-1,-1
MULIFE.txt,502578,504247,1669,10,N,N,-,-1,-1
MULIFE.txt,502864,504261,1397,10,N,N,-,-1,-1
MULIFE.txt,503029,504272,1243,10,N,N,-,-1,-1
MULIFE.txt,503334,504443,1109,10,N,N,-,-1,-1
MULIFE.txt,503453,505425,1972,10,N,N,-,-1,-1
MULIFE.txt,503610,505679,2069,10,N,N,-,-1,-1
MULIFE.txt,503803,505905,2102,10,N,N,-,-1,-1
MULIFE.txt,503936,505964,2028,10,N,N,-,-1,-1
MULIFE.txt,504068,506033,1965,10,N,N,-,-1,-1
MULIFE.txt,504230,506154,1924,10,N,N,-,-1,-1
MULIFE.txt,504248,506325,2077,10,N,N,-,-1,-1
MULIFE.txt,504263,506329,2066,10,N,N,-,-1,-1
MULIFE.txt,504275,506456,2181,10,N,N,-,-1,-1
MULIFE.txt,504446,506674,2228,10,N,N,-,-1,-1
MULIFE.txt,505428,506871,1443,10,N,N,-,-1,-1
MULIFE.txt,505680,506983,1303,10,N,N,-,-1,-1
MULIFE.txt,505908,507388,1480,10,N,N,-,-1,-1
MULIFE.txt,505967,507511,1544,10,N,N,-,-1,-1
MULIFE.txt,506034,507549,1515,10,N,N,-,-1,-1
MULIFE.txt,506155,507796,1641,10,N,N,-,-1,-1
MULIFE.txt,506328,507845,1517,10,N,N,-,-1,-1
MULIFE.txt,506329,508204,1875,10,N,N,-,-1,-1
MULIFE.txt,506457,508309,1852,10,N,N,-,-1,-1
MULIFE.txt,506676,508596,1920,10,N,N,-,-1,-1
MULIFE.txt,506872,508872,2000,10,N,N,-,-1,-1
MULIFE.txt,506984,508926,1942,10,N,N,-,-1,-1
MULIFE.txt,507391,509011,1620,10,N,N,-,-1,-1
MULIFE.txt,507512,509097,1585,10,N,N,-,-1,-1
MULIFE.txt,507550,509155,1605,10,N,N,-,-1,-1
MULIFE.txt,507797,509212,1415,10,N,N,-,-1,-1
MULIFE.txt,507846,509643,1797,10,N,N,-,-1,-1
MULIFE.txt,508205,509764,1559,10,N,N,-,-1,-1
MULIFE.txt,508310,509871,1561,10,N,N,-,-1,-1
MULIFE.txt,508597,510008,1411,10,N,N,-,-1,-1
MULIFE.txt,508873,510056,1183,10,N,Y,1448281320115,89144,91129
MULIFE.txt,508927,510105,1178,10,N,Y,1448281320115,89144,91129
MULIFE.txt,509012,510254,1242,10,N,Y,1448281320115,89144,91129
MULIFE.txt,509100,510414,1314,10,N,Y,1448281320115,89144,91129
MULIFE.txt,509156,510428,1272,10,N,Y,1448281320115,89144,91129
MULIFE.txt,509213,510443,1230,10,N,Y,1448281320115,89144,91129
MULIFE.txt,509644,510561,917,10,N,Y,1448281320115,89144,91129
MULIFE.txt,509765,510715,950,10,N,Y,1448281320115,89144,91129
MULIFE.txt,509872,510855,983,10,N,Y,1448281320115,89144,91129
MULIFE.txt,510011,510883,872,10,N,Y,1448281320115,89144,91129
MULIFE.txt,510057,511105,1048,10,N,Y,1448281320115,89144,91129
MULIFE.txt,510106,511189,1083,10,N,Y,1448281320115,89144,91129
MULIFE.txt,510255,511392,1137,10,N,Y,1448281320115,89144,91129
MULIFE.txt,510415,511522,1107,10,N,Y,1448281320115,89144,91129
MULIFE.txt,510429,511540,1111,10,N,Y,1448281320115,89144,91129
MULIFE.txt,510444,511677,1233,10,N,Y,1448281320115,89144,91129
MULIFE.txt,510562,511746,1184,10,N,N,-,-1,-1
MULIFE.txt,510716,511874,1158,10,N,Y,1448279941918,72406,72905
MULIFE.txt,510856,511929,1073,10,N,Y,1448279941918,72406,72905
MULIFE.txt,510884,511995,1111,10,N,Y,1448279941918,72406,72905
MULIFE.txt,511106,512302,1196,10,N,Y,1448279941918,72406,72905
MULIFE.txt,511190,512414,1224,10,N,Y,1448279941918,72406,72905
MULIFE.txt,511397,512618,1221,10,N,Y,1448279941918,72406,72905
MULIFE.txt,511523,512794,1271,10,N,Y,1448279941918,72406,72905
MULIFE.txt,511541,512869,1328,10,N,Y,1448279941918,72406,72905
MULIFE.txt,511678,512937,1259,10,N,Y,1448279941918,72406,72905
MULIFE.txt,511747,513010,1263,10,N,Y,1448279941918,72406,72905
MULIFE.txt,511875,513136,1261,10,N,Y,1448279941918,72406,72905
MULIFE.txt,511929,513157,1228,10,N,Y,1448279941918,72406,72905
MULIFE.txt,511997,513280,1283,10,N,Y,1448279941918,72406,72905
MULIFE.txt,512303,513352,1049,10,N,Y,1448279941918,72406,72905
MULIFE.txt,512415,513476,1061,10,N,N,-,-1,-1
MULIFE.txt,512619,513548,929,10,N,N,-,-1,-1
MULIFE.txt,512797,513603,806,10,N,N,-,-1,-1
MULIFE.txt,512870,513778,908,10,N,N,-,-1,-1
MULIFE.txt,512938,514104,1166,10,N,N,-,-1,-1
MULIFE.txt,513011,514226,1215,10,N,N,-,-1,-1
MULIFE.txt,513137,514245,1108,10,N,N,-,-1,-1
MULIFE.txt,513158,514504,1346,10,N,N,-,-1,-1
MULIFE.txt,513281,514559,1278,10,N,N,-,-1,-1
MULIFE.txt,513354,514741,1387,10,N,N,-,-1,-1
MULIFE.txt,513478,514780,1302,10,N,N,-,-1,-1
MULIFE.txt,513549,514837,1288,10,N,N,-,-1,-1
MULIFE.txt,513604,515012,1408,10,N,N,-,-1,-1
MULIFE.txt,513779,515087,1308,10,N,N,-,-1,-1
MULIFE.txt,514105,515257,1152,10,N,N,-,-1,-1
MULIFE.txt,514227,515364,1137,10,N,N,-,-1,-1
MULIFE.txt,514247,515575,1328,10,N,N,-,-1,-1
MULIFE.txt,514505,515709,1204,10,N,N,-,-1,-1
MULIFE.txt,514562,515859,1297,10,N,N,-,-1,-1
MULIFE.txt,514743,516078,1335,10,N,N,-,-1,-1
MULIFE.txt,514781,516105,1324,10,N,N,-,-1,-1
MULIFE.txt,514840,516492,1652,10,N,N,-,-1,-1
MULIFE.txt,515015,516794,1779,10,Y,N,-,-1,-1
MULIFE.txt,515088,516908,1820,10,Y,N,-,-1,-1
MULIFE.txt,515260,517155,1895,10,Y,N,-,-1,-1
MULIFE.txt,515365,517367,2002,10,Y,N,-,-1,-1
MULIFE.txt,515576,517568,1992,10,Y,Y,1437476486340,221621,222520
MULIFE.txt,515710,517660,1950,10,Y,Y,1437476486340,221621,222520
MULIFE.txt,515860,517940,2080,10,Y,Y,1437476486340,221621,222520
MULIFE.txt,516083,518056,1973,10,Y,Y,1437476486340,221621,222520
MULIFE.txt,516106,518365,2259,10,Y,Y,1437476486340,221621,222520
MULIFE.txt,516495,518435,1940,10,Y,Y,1437476486340,221621,222520
MULIFE.txt,516795,518688,1893,10,N,Y,1437476486340,221621,222520
MULIFE.txt,516909,518854,1945,10,N,Y,1437476486340,221621,222520
MULIFE.txt,517157,518922,1765,10,N,Y,1437476486340,221621,222520
MULIFE.txt,517368,519510,2142,10,Y,Y,1437476486340,221621,222520
MULIFE.txt,517571,519947,2376,10,Y,Y,1437476486340,221621,222520
MULIFE.txt,517661,520050,2389,10,Y,N,-,-1,-1
MULIFE.txt,517943,520121,2178,10,N,N,-,-1,-1
MULIFE.txt,518057,520288,2231,10,N,Y,1448323072174,227638,227786
MULIFE.txt,518366,520533,2167,10,N,Y,1448323072174,227638,227786
MULIFE.txt,518436,520540,2104,10,N,Y,1448323072174,227638,227786
MULIFE.txt,518691,520737,2046,10,N,Y,1448323072174,227638,227786
MULIFE.txt,518856,520876,2020,10,N,Y,1448323072174,227638,227786
MULIFE.txt,518923,520939,2016,10,N,Y,1437477480340,424837,425856
MULIFE.txt,519513,520966,1453,10,N,Y,1437477480340,424837,425856
MULIFE.txt,519948,520993,1045,10,N,Y,1437477480340,424837,425856
MULIFE.txt,520051,521185,1134,10,N,Y,1437477480340,424837,425856
MULIFE.txt,520122,521252,1130,10,N,Y,1437477480340,424837,425856
MULIFE.txt,520289,521401,1112,10,N,Y,1437477480340,424837,425856
MULIFE.txt,520536,521468,932,10,N,Y,1437477480340,424837,425856
MULIFE.txt,520541,521527,986,10,N,Y,1437477480340,424837,425856
MULIFE.txt,520738,521656,918,10,N,Y,1437477480340,424837,425856
MULIFE.txt,520879,521726,847,10,N,Y,1437477480340,424837,425856
MULIFE.txt,520940,521895,955,10,N,Y,1437477480340,424837,425856
MULIFE.txt,520967,522038,1071,10,N,Y,1437477480340,424837,425856
MULIFE.txt,520994,522054,1060,10,N,Y,1437477480340,424837,425856
MULIFE.txt,521186,522236,1050,10,N,Y,1437477480340,424837,425856
MULIFE.txt,521253,522305,1052,10,N,Y,1437471855423,351318,351853
MULIFE.txt,521402,522418,1016,10,N,Y,1437471855423,351318,351853
MULIFE.txt,521469,522550,1081,10,N,Y,1437471855423,351318,351853
MULIFE.txt,521528,522887,1359,10,N,Y,1437471855423,351318,351853
MULIFE.txt,521657,523040,1383,10,Y,Y,1437471855423,351318,351853
MULIFE.txt,521728,523137,1409,10,Y,Y,1437471855423,351318,351853
MULIFE.txt,521896,523308,1412,10,Y,Y,1437471855423,351318,351853
MULIFE.txt,522039,523507,1468,10,Y,Y,1437471855423,351318,351853
MULIFE.txt,522055,523981,1926,10,N,Y,1437471855423,351318,351853
MULIFE.txt,522239,524066,1827,10,N,Y,1437471855423,351318,351853
MULIFE.txt,522306,524218,1912,10,N,Y,1437471855423,351318,351853
MULIFE.txt,522419,524381,1962,10,N,Y,1437471855423,351318,351853
MULIFE.txt,522551,524559,2008,10,N,Y,1437471855423,351318,351853
MULIFE.txt,522888,524762,1874,10,N,Y,1437471855423,351318,351853
MULIFE.txt,523042,525018,1976,10,N,Y,1437471855423,351318,351853
MULIFE.txt,523140,525033,1893,10,N,N,-,-1,-1
MULIFE.txt,523310,525139,1829,10,N,N,-,-1,-1
MULIFE.txt,523508,525274,1766,10,N,N,-,-1,-1
MULIFE.txt,523982,525413,1431,10,N,N,-,-1,-1
MULIFE.txt,524067,525588,1521,10,N,N,-,-1,-1
MULIFE.txt,524219,525706,1487,10,N,N,-,-1,-1
MULIFE.txt,524383,525972,1589,10,N,N,-,-1,-1
MULIFE.txt,524560,526068,1508,10,N,N,-,-1,-1
MULIFE.txt,524765,526118,1353,10,N,N,-,-1,-1
MULIFE.txt,525023,526409,1386,10,N,N,-,-1,-1
MULIFE.txt,525034,526719,1685,10,N,N,-,-1,-1
MULIFE.txt,525140,526907,1767,10,N,N,-,-1,-1
MULIFE.txt,525277,526968,1691,10,N,N,-,-1,-1
MULIFE.txt,525416,527080,1664,10,N,N,-,-1,-1
MULIFE.txt,525590,527207,1617,10,N,N,-,-1,-1
MULIFE.txt,525708,527349,1641,10,N,N,-,-1,-1
MULIFE.txt,525975,527491,1516,10,N,N,-,-1,-1
MULIFE.txt,526069,527569,1500,10,N,N,-,-1,-1
MULIFE.txt,526119,527664,1545,10,N,N,-,-1,-1
MULIFE.txt,526410,527703,1293,10,N,N,-,-1,-1
MULIFE.txt,526720,527982,1262,10,N,N,-,-1,-1
MULIFE.txt,526908,528009,1101,10,N,N,-,-1,-1
MULIFE.txt,526968,528039,1071,10,N,N,-,-1,-1
MULIFE.txt,527081,528088,1007,10,N,N,-,-1,-1
MULIFE.txt,527208,528253,1045,10,N,N,-,-1,-1
MULIFE.txt,527352,528318,966,10,N,N,-,-1,-1
MULIFE.txt,527494,528411,917,10,N,N,-,-1,-1
MULIFE.txt,527570,528493,923,10,N,N,-,-1,-1
MULIFE.txt,527667,528729,1062,10,N,N,-,-1,-1
MULIFE.txt,527704,528855,1151,10,N,N,-,-1,-1
MULIFE.txt,527983,529180,1197,10,N,N,-,-1,-1
MULIFE.txt,528010,529298,1288,10,N,N,-,-1,-1
MULIFE.txt,528040,529453,1413,10,N,N,-,-1,-1
MULIFE.txt,528089,529569,1480,10,N,N,-,-1,-1
MULIFE.txt,528254,529653,1399,10,N,N,-,-1,-1
MULIFE.txt,528319,529889,1570,10,N,N,-,-1,-1
MULIFE.txt,528412,529989,1577,10,N,N,-,-1,-1
MULIFE.txt,528494,530179,1685,10,N,N,-,-1,-1
MULIFE.txt,528730,530319,1589,10,N,N,-,-1,-1
MULIFE.txt,528856,530459,1603,10,N,N,-,-1,-1
MULIFE.txt,529181,530603,1422,10,N,N,-,-1,-1
MULIFE.txt,529301,530969,1668,10,N,Y,1448357582358,234204,234401
MULIFE.txt,529454,531106,1652,10,N,Y,1448357582358,234204,234401
MULIFE.txt,529570,531335,1765,10,N,Y,1448357582358,234204,234401
MULIFE.txt,529656,531421,1765,10,N,Y,1448357582358,234204,234401
MULIFE.txt,529890,531717,1827,10,N,Y,1448357582358,234204,234401
MULIFE.txt,529991,531769,1778,10,N,Y,1448357582358,234204,234401
MULIFE.txt,530180,531936,1756,10,N,Y,1448357582358,234204,234401
MULIFE.txt,530320,532185,1865,10,N,Y,1448357582358,234204,234401
MULIFE.txt,530462,532336,1874,10,N,Y,1448357582358,234204,234401
MULIFE.txt,530604,532382,1778,10,N,Y,1448357582358,234204,234401
MULIFE.txt,530970,532475,1505,10,N,Y,1448357582358,234204,234401
MULIFE.txt,531107,532534,1427,10,N,Y,1448357582358,234204,234401
MULIFE.txt,531336,532612,1276,10,N,Y,1448357582358,234204,234401
MULIFE.txt,531422,532859,1437,10,N,Y,1448357582358,234204,234401
MULIFE.txt,531718,532982,1264,10,N,Y,1448357582358,234204,234401
MULIFE.txt,531770,532993,1223,10,N,Y,1448357582358,234204,234401
MULIFE.txt,531939,533069,1130,10,Y,N,-,-1,-1
MULIFE.txt,532186,533179,993,10,N,N,-,-1,-1
MULIFE.txt,532338,533381,1043,10,N,N,-,-1,-1
MULIFE.txt,532383,533516,1133,10,N,N,-,-1,-1
MULIFE.txt,532480,533556,1076,10,N,N,-,-1,-1
MULIFE.txt,532535,533719,1184,10,N,N,-,-1,-1
MULIFE.txt,532613,533838,1225,10,N,N,-,-1,-1
MULIFE.txt,532862,533950,1088,10,N,N,-,-1,-1
MULIFE.txt,532984,533991,1007,10,N,N,-,-1,-1
MULIFE.txt,532994,534012,1018,10,N,N,-,-1,-1
MULIFE.txt,533070,534185,1115,10,N,N,-,-1,-1
MULIFE.txt,533184,534240,1056,10,N,N,-,-1,-1
MULIFE.txt,533382,534395,1013,10,N,N,-,-1,-1
MULIFE.txt,533521,534737,1216,10,N,N,-,-1,-1
MULIFE.txt,533557,534833,1276,10,N,N,-,-1,-1
MULIFE.txt,533720,535011,1291,10,N,N,-,-1,-1
MULIFE.txt,533839,535032,1193,10,N,N,-,-1,-1
MULIFE.txt,533952,535298,1346,10,N,N,-,-1,-1
MULIFE.txt,533992,535433,1441,10,N,N,-,-1,-1
MULIFE.txt,534014,535506,1492,10,N,N,-,-1,-1
MULIFE.txt,534188,535683,1495,10,N,N,-,-1,-1
MULIFE.txt,534242,535821,1579,10,N,N,-,-1,-1
MULIFE.txt,534396,535932,1536,10,N,N,-,-1,-1
MULIFE.txt,534738,536005,1267,10,N,N,-,-1,-1
MULIFE.txt,534834,536163,1329,10,N,N,-,-1,-1
MULIFE.txt,535013,536430,1417,10,N,N,-,-1,-1
MULIFE.txt,535033,536587,1554,10,N,N,-,-1,-1
MULIFE.txt,535300,536644,1344,10,N,N,-,-1,-1
MULIFE.txt,535434,536720,1286,10,N,N,-,-1,-1
MULIFE.txt,535507,536777,1270,10,N,N,-,-1,-1
MULIFE.txt,535684,536793,1109,10,N,N,-,-1,-1
MULIFE.txt,535822,536883,1061,10,N,N,-,-1,-1
MULIFE.txt,535933,537027,1094,10,N,N,-,-1,-1
MULIFE.txt,536006,537097,1091,10,N,N,-,-1,-1
MULIFE.txt,536164,537242,1078,10,N,N,-,-1,-1
MULIFE.txt,536431,537337,906,10,N,N,-,-1,-1
MULIFE.txt,536588,537442,854,10,N,N,-,-1,-1
MULIFE.txt,536645,537548,903,10,N,N,-,-1,-1
MULIFE.txt,536721,537685,964,10,N,N,-,-1,-1
MULIFE.txt,536778,537714,936,10,N,N,-,-1,-1
MULIFE.txt,536794,537890,1096,10,N,N,-,-1,-1
MULIFE.txt,536884,537948,1064,10,N,N,-,-1,-1
MULIFE.txt,537030,538291,1261,10,N,N,-,-1,-1
MULIFE.txt,537098,538462,1364,10,N,N,-,-1,-1
MULIFE.txt,537243,538526,1283,10,N,N,-,-1,-1
MULIFE.txt,537338,538625,1287,10,N,N,-,-1,-1
MULIFE.txt,537443,538720,1277,10,N,N,-,-1,-1
MULIFE.txt,537551,538913,1362,10,N,N,-,-1,-1
MULIFE.txt,537686,539004,1318,10,N,N,-,-1,-1
MULIFE.txt,537717,539082,1365,10,N,N,-,-1,-1
MULIFE.txt,537891,539292,1401,10,N,N,-,-1,-1
MULIFE.txt,537949,539357,1408,10,N,N,-,-1,-1
MULIFE.txt,538292,539396,1104,10,N,N,-,-1,-1
MULIFE.txt,538463,539678,1215,10,N,N,-,-1,-1
MULIFE.txt,538527,539988,1461,10,N,N,-,-1,-1
MULIFE.txt,538626,540095,1469,10,N,N,-,-1,-1
MULIFE.txt,538721,540254,1533,10,N,N,-,-1,-1
MULIFE.txt,538914,540414,1500,10,N,N,-,-1,-1
MULIFE.txt,539005,540701,1696,10,N,N,-,-1,-1
MULIFE.txt,539085,540758,1673,10,N,N,-,-1,-1
MULIFE.txt,539293,540824,1531,10,N,N,-,-1,-1
MULIFE.txt,539358,540907,1549,10,N,N,-,-1,-1
MULIFE.txt,539397,540979,1582,10,N,N,-,-1,-1
MULIFE.txt,539681,541312,1631,10,N,N,-,-1,-1
MULIFE.txt,539991,541435,1444,10,N,N,-,-1,-1
MULIFE.txt,540096,541453,1357,10,N,N,-,-1,-1
MULIFE.txt,540255,541610,1355,10,N,N,-,-1,-1
MULIFE.txt,540415,541721,1306,10,N,N,-,-1,-1
MULIFE.txt,540704,541813,1109,10,N,N,-,-1,-1
MULIFE.txt,540760,541994,1234,10,N,N,-,-1,-1
MULIFE.txt,540825,542097,1272,10,N,N,-,-1,-1
MULIFE.txt,540908,542417,1509,10,N,N,-,-1,-1
MULIFE.txt,540982,542599,1617,10,N,N,-,-1,-1
MULIFE.txt,541313,543081,1768,10,N,N,-,-1,-1
MULIFE.txt,541436,543092,1656,10,N,N,-,-1,-1
MULIFE.txt,541454,543447,1993,10,N,N,-,-1,-1
MULIFE.txt,541611,543529,1918,10,N,N,-,-1,-1
MULIFE.txt,541722,543611,1889,10,N,N,-,-1,-1
MULIFE.txt,541814,543791,1977,10,N,N,-,-1,-1
MULIFE.txt,541995,543840,1845,10,N,N,-,-1,-1
MULIFE.txt,542098,543945,1847,10,N,N,-,-1,-1
MULIFE.txt,542418,543952,1534,10,N,N,-,-1,-1
MULIFE.txt,542600,544148,1548,10,N,N,-,-1,-1
MULIFE.txt,543084,544276,1192,10,N,N,-,-1,-1
MULIFE.txt,543093,544421,1328,10,N,N,-,-1,-1
MULIFE.txt,543450,544536,1086,10,N,N,-,-1,-1
MULIFE.txt,543530,544723,1193,10,N,N,-,-1,-1
MULIFE.txt,543612,544793,1181,10,N,N,-,-1,-1
MULIFE.txt,543794,544999,1205,10,N,N,-,-1,-1
MULIFE.txt,543841,545088,1247,10,N,N,-,-1,-1
MULIFE.txt,543948,545241,1293,10,N,N,-,-1,-1
MULIFE.txt,543955,545318,1363,10,N,N,-,-1,-1
MULIFE.txt,544149,545546,1397,10,N,N,-,-1,-1
MULIFE.txt,544277,545637,1360,10,N,Y,1448281071558,89330,89524
MULIFE.txt,544422,545667,1245,10,N,Y,1448281071558,89330,89524
MULIFE.txt,544537,545791,1254,10,N,Y,1448281071558,89330,89524
MULIFE.txt,544725,545804,1079,10,N,Y,1448281071558,89330,89524
MULIFE.txt,544794,545906,1112,10,N,Y,1448281071558,89330,89524
MULIFE.txt,545002,546068,1066,10,N,Y,1448281071558,89330,89524
MULIFE.txt,545089,546149,1060,10,N,Y,1448281071558,89330,89524
MULIFE.txt,545244,546365,1121,10,N,Y,1448281071558,89330,89524
MULIFE.txt,545319,546648,1329,10,N,Y,1448281071558,89330,89524
MULIFE.txt,545549,546738,1189,10,N,Y,1448281071558,89330,89524
MULIFE.txt,545638,546883,1245,10,N,Y,1448281071558,89330,89524
MULIFE.txt,545668,546934,1266,10,N,Y,1448281071558,89330,89524
MULIFE.txt,545792,547045,1253,10,N,Y,1448281071558,89330,89524
MULIFE.txt,545805,547170,1365,10,N,Y,1448281071558,89330,89524
MULIFE.txt,545907,547236,1329,10,N,Y,1448281071558,89330,89524
MULIFE.txt,546070,547318,1248,10,N,Y,1448281071558,89330,89524
MULIFE.txt,546150,547368,1218,10,N,Y,1448281071558,89330,89524
MULIFE.txt,546366,547387,1021,10,N,N,-,-1,-1
MULIFE.txt,546651,547503,852,10,N,N,-,-1,-1
MULIFE.txt,546739,547522,783,10,N,N,-,-1,-1
MULIFE.txt,546886,547612,726,10,N,N,-,-1,-1
MULIFE.txt,546936,547790,854,10,N,N,-,-1,-1
MULIFE.txt,547046,547952,906,10,N,N,-,-1,-1
MULIFE.txt,547172,548134,962,10,N,N,-,-1,-1
MULIFE.txt,547239,548151,912,10,N,N,-,-1,-1
MULIFE.txt,547319,548235,916,10,N,N,-,-1,-1
MULIFE.txt,547369,548286,917,10,N,N,-,-1,-1
MULIFE.txt,547388,548389,1001,10,N,N,-,-1,-1
MULIFE.txt,547503,548472,969,10,N,N,-,-1,-1
MULIFE.txt,547523,548537,1014,10,N,N,-,-1,-1
MULIFE.txt,547615,548560,945,10,N,N,-,-1,-1
MULIFE.txt,547793,548614,821,10,N,N,-,-1,-1
MULIFE.txt,547953,548809,856,10,N,N,-,-1,-1
MULIFE.txt,548135,548924,789,10,N,N,-,-1,-1
MULIFE.txt,548152,548950,798,10,N,N,-,-1,-1
MULIFE.txt,548236,549013,777,10,N,N,-,-1,-1
MULIFE.txt,548287,549053,766,10,N,N,-,-1,-1
MULIFE.txt,548390,549185,795,10,N,N,-,-1,-1
MULIFE.txt,548473,549351,878,10,N,N,-,-1,-1
MULIFE.txt,548538,549474,936,10,N,Y,1437471397525,350644,351290
MULIFE.txt,548563,549563,1000,10,N,Y,1437471397525,350644,351290
MULIFE.txt,548617,549676,1059,10,N,Y,1437471397525,350644,351290
MULIFE.txt,548812,549846,1034,10,N,Y,1437471397525,350644,351290
MULIFE.txt,548927,550013,1086,10,N,Y,1437471397525,350644,351290
MULIFE.txt,548953,550063,1110,10,N,Y,1437471397525,350644,351290
MULIFE.txt,549014,550126,1112,10,N,Y,1437471397525,350644,351290
MULIFE.txt,549055,550235,1180,10,N,Y,1437471397525,350644,351290
MULIFE.txt,549186,550248,1062,10,N,Y,1437471397525,350644,351290
MULIFE.txt,549352,550259,907,10,N,Y,1437471397525,350644,351290
MULIFE.txt,549475,550387,912,10,N,Y,1437471397525,350644,351290
MULIFE.txt,549564,550396,832,10,N,Y,1437471397525,350644,351290
MULIFE.txt,549677,550616,939,10,N,Y,1437471397525,350644,351290
MULIFE.txt,549847,550787,940,10,N,Y,1437471397525,350644,351290
MULIFE.txt,550016,550958,942,10,N,N,-,-1,-1
MULIFE.txt,550064,551111,1047,10,N,N,-,-1,-1
MULIFE.txt,550127,551354,1227,10,N,N,-,-1,-1
MULIFE.txt,550238,551564,1326,10,N,N,-,-1,-1
MULIFE.txt,550251,551702,1451,10,N,N,-,-1,-1
MULIFE.txt,550260,551871,1611,10,N,N,-,-1,-1
MULIFE.txt,550388,551987,1599,10,N,N,-,-1,-1
MULIFE.txt,550397,552040,1643,10,N,N,-,-1,-1
MULIFE.txt,550617,552200,1583,10,N,N,-,-1,-1
MULIFE.txt,550788,552337,1549,10,N,N,-,-1,-1
MULIFE.txt,550959,552380,1421,10,N,N,-,-1,-1
MULIFE.txt,551112,552416,1304,10,N,N,-,-1,-1
MULIFE.txt,551355,552524,1169,10,N,N,-,-1,-1
MULIFE.txt,551565,552690,1125,10,N,N,-,-1,-1
MULIFE.txt,551703,552807,1104,10,N,Y,1448039123601,19678,19935
MULIFE.txt,551872,552851,979,10,N,Y,1448039123601,19678,19935
MULIFE.txt,551990,553024,1034,10,N,Y,1448039123601,19678,19935
MULIFE.txt,552041,553200,1159,10,N,Y,1448039123601,19678,19935
MULIFE.txt,552201,553287,1086,10,N,Y,1448039123601,19678,19935
MULIFE.txt,552338,553360,1022,10,N,Y,1448039123601,19678,19935
MULIFE.txt,552381,553429,1048,10,N,Y,1448039123601,19678,19935
MULIFE.txt,552417,553472,1055,10,N,Y,1448039123601,19678,19935
MULIFE.txt,552525,553607,1082,10,N,Y,1448039123601,19678,19935
MULIFE.txt,552693,553669,976,10,N,Y,1448039123601,19678,19935
MULIFE.txt,552808,553779,971,10,N,Y,1448039123601,19678,19935
MULIFE.txt,552852,553890,1038,10,N,Y,1448039123601,19678,19935
MULIFE.txt,553025,554159,1134,10,N,Y,1448039123601,19678,19935
MULIFE.txt,553201,554310,1109,10,N,Y,1448039123601,19678,19935
MULIFE.txt,553288,554368,1080,10,N,Y,1448039123601,19678,19935
MULIFE.txt,553361,554587,1226,10,N,Y,1448039123601,19678,19935
MULIFE.txt,553430,554834,1404,10,N,Y,1448039123601,19678,19935
MULIFE.txt,553473,555072,1599,10,N,Y,1448039123601,19678,19935
MULIFE.txt,553608,555249,1641,10,N,Y,1448039123601,19678,19935
MULIFE.txt,553670,555461,1791,10,N,Y,1448039123601,19678,19935
MULIFE.txt,553780,555550,1770,10,N,Y,1448039123601,19678,19935
MULIFE.txt,553893,556167,2274,10,N,N,-,-1,-1
MULIFE.txt,554160,556340,2180,10,N,N,-,-1,-1
MULIFE.txt,554311,556362,2051,10,N,N,-,-1,-1
MULIFE.txt,554369,556430,2061,10,N,N,-,-1,-1
MULIFE.txt,554588,556533,1945,10,N,N,-,-1,-1
MULIFE.txt,554837,556590,1753,10,N,N,-,-1,-1
MULIFE.txt,555073,556769,1696,10,N,N,-,-1,-1
MULIFE.txt,555250,556861,1611,10,N,N,-,-1,-1
MULIFE.txt,555462,557037,1575,10,N,N,-,-1,-1
MULIFE.txt,555551,557182,1631,10,N,N,-,-1,-1
MULIFE.txt,556168,557331,1163,10,N,N,-,-1,-1
MULIFE.txt,556345,557450,1105,10,N,N,-,-1,-1
MULIFE.txt,556363,557649,1286,10,N,N,-,-1,-1
MULIFE.txt,556431,557903,1472,10,N,N,-,-1,-1
MULIFE.txt,556536,557977,1441,10,N,N,-,-1,-1
MULIFE.txt,556595,558187,1592,10,N,N,-,-1,-1
MULIFE.txt,556771,558319,1548,10,N,N,-,-1,-1
MULIFE.txt,556862,558563,1701,10,N,N,-,-1,-1
MULIFE.txt,557038,558691,1653,10,N,N,-,-1,-1
MULIFE.txt,557183,558793,1610,10,N,N,-,-1,-1
MULIFE.txt,557332,558812,1480,10,N,N,-,-1,-1
MULIFE.txt,557451,558948,1497,10,N,N,-,-1,-1
MULIFE.txt,557650,559148,1498,10,N,N,-,-1,-1
MULIFE.txt,557905,559254,1349,10,N,N,-,-1,-1
MULIFE.txt,557980,559395,1415,10,N,N,-,-1,-1
MULIFE.txt,558188,559492,1304,10,N,N,-,-1,-1
MULIFE.txt,558320,559533,1213,10,N,N,-,-1,-1
MULIFE.txt,558566,559654,1088,10,N,N,-,-1,-1
MULIFE.txt,558692,559866,1174,10,N,N,-,-1,-1
MULIFE.txt,558796,560041,1245,10,N,N,-,-1,-1
MULIFE.txt,558813,560260,1447,10,N,N,-,-1,-1
MULIFE.txt,558949,560523,1574,10,N,N,-,-1,-1
MULIFE.txt,559150,560633,1483,10,N,N,-,-1,-1
MULIFE.txt,559255,560780,1525,10,N,N,-,-1,-1
MULIFE.txt,559396,560854,1458,10,N,N,-,-1,-1
MULIFE.txt,559493,560969,1476,10,N,N,-,-1,-1
MULIFE.txt,559534,561048,1514,10,N,N,-,-1,-1
MULIFE.txt,559656,561093,1437,10,N,N,-,-1,-1
MULIFE.txt,559867,561122,1255,10,N,N,-,-1,-1
MULIFE.txt,560042,561205,1163,10,N,N,-,-1,-1
MULIFE.txt,560261,561302,1041,10,N,N,-,-1,-1
MULIFE.txt,560524,561331,807,10,N,N,-,-1,-1
MULIFE.txt,560635,561511,876,10,N,N,-,-1,-1
MULIFE.txt,560781,561807,1026,10,N,N,-,-1,-1
MULIFE.txt,560856,561914,1058,10,N,N,-,-1,-1
MULIFE.txt,560971,562032,1061,10,N,N,-,-1,-1
MULIFE.txt,561049,562181,1132,10,N,N,-,-1,-1
MULIFE.txt,561096,562252,1156,10,N,N,-,-1,-1
MULIFE.txt,561123,562400,1277,10,N,N,-,-1,-1
MULIFE.txt,561206,562616,1410,10,N,N,-,-1,-1
MULIFE.txt,561303,562664,1361,10,N,N,-,-1,-1
MULIFE.txt,561332,562830,1498,10,N,N,-,-1,-1
MULIFE.txt,561512,562916,1404,10,N,N,-,-1,-1
MULIFE.txt,561808,563028,1220,10,N,N,-,-1,-1
MULIFE.txt,561915,563067,1152,10,N,N,-,-1,-1
MULIFE.txt,562033,563150,1117,10,N,N,-,-1,-1
MULIFE.txt,562182,563518,1336,10,N,N,-,-1,-1
MULIFE.txt,562255,563752,1497,10,N,N,-,-1,-1
MULIFE.txt,562401,563754,1353,10,N,N,-,-1,-1
MULIFE.txt,562617,563806,1189,10,N,N,-,-1,-1
MULIFE.txt,562665,563998,1333,10,N,N,-,-1,-1
MULIFE.txt,562831,564025,1194,10,N,N,-,-1,-1
MULIFE.txt,562917,564110,1193,10,N,N,-,-1,-1
MULIFE.txt,563029,564173,1144,10,N,N,-,-1,-1
MULIFE.txt,563068,564350,1282,10,N,Y,1448325046337,230539,231128
MULIFE.txt,563151,564674,1523,10,N,Y,1448325046337,230539,231128
MULIFE.txt,563521,564881,1360,10,N,Y,1448325046337,230539,231128
MULIFE.txt,563753,565038,1285,10,N,Y,1448325046337,230539,231128
MULIFE.txt,563757,565190,1433,10,N,Y,1448325046337,230539,231128
MULIFE.txt,563808,565454,1646,10,Y,Y,1448325046337,230539,231128
MULIFE.txt,563999,565589,1590,10,Y,Y,1448325046337,230539,231128
MULIFE.txt,564026,565732,1706,10,Y,Y,1448325046337,230539,231128
MULIFE.txt,564113,565771,1658,10,Y,Y,1448325046337,230539,231128
MULIFE.txt,564175,565955,1780,10,Y,Y,1448325046337,230539,231128
MULIFE.txt,564351,566213,1862,10,Y,Y,1448325046337,230539,231128
MULIFE.txt,564675,566582,1907,10,Y,Y,1448325046337,230539,231128
MULIFE.txt,564882,566703,1821,10,Y,Y,1448325046337,230539,231128
MULIFE.txt,565039,566860,1821,10,Y,Y,1448325046337,230539,231128
MULIFE.txt,565191,566967,1776,10,Y,Y,1448325046337,230539,231128
MULIFE.txt,565457,567158,1701,10,Y,N,-,-1,-1
MULIFE.txt,565590,567179,1589,10,Y,N,-,-1,-1
MULIFE.txt,565733,567343,1610,10,N,Y,1448314503640,180207,180355
MULIFE.txt,565772,567529,1757,10,Y,Y,1448314503640,180207,180355
MULIFE.txt,565956,567998,2042,10,Y,Y,1448314503640,180207,180355
MULIFE.txt,566215,568135,1920,10,Y,Y,1448314503640,180207,180355
MULIFE.txt,566583,568368,1785,10,Y,Y,1448314503640,180207,180355
MULIFE.txt,566704,568374,1670,10,Y,Y,1448314503640,180207,180355
MULIFE.txt,566861,568503,1642,10,Y,Y,1448314503640,180207,180355
MULIFE.txt,566968,568744,1776,10,Y,Y,1448314503640,180207,180355
MULIFE.txt,567163,568950,1787,10,Y,Y,1448314503640,180207,180355
MULIFE.txt,567182,569172,1990,10,Y,Y,1448314503640,180207,180355
MULIFE.txt,567345,569322,1977,10,Y,Y,1448314503640,180207,180355
MULIFE.txt,567530,569373,1843,10,Y,Y,1448314503640,180207,180355
MULIFE.txt,567999,569476,1477,10,Y,Y,1448314503640,180207,180355
MULIFE.txt,568136,569617,1481,10,N,Y,1448314503640,180207,180355
MULIFE.txt,568370,569691,1321,10,N,Y,1448314503640,180207,180355
MULIFE.txt,568375,570169,1794,10,N,Y,1448314503640,180207,180355
MULIFE.txt,568504,570187,1683,10,N,Y,1448314503640,180207,180355
MULIFE.txt,568745,570294,1549,10,N,Y,1448314503640,180207,180355
MULIFE.txt,568953,570408,1455,10,N,N,-,-1,-1
MULIFE.txt,569173,570719,1546,10,N,N,-,-1,-1
MULIFE.txt,569325,571057,1732,10,N,N,-,-1,-1
MULIFE.txt,569374,571347,1973,10,N,N,-,-1,-1
MULIFE.txt,569477,571422,1945,10,N,N,-,-1,-1
MULIFE.txt,569618,571696,2078,10,N,N,-,-1,-1
MULIFE.txt,569694,571708,2014,10,N,N,-,-1,-1
MULIFE.txt,570174,571895,1721,10,N,N,-,-1,-1
MULIFE.txt,570190,572096,1906,10,N,N,-,-1,-1
MULIFE.txt,570295,572141,1846,10,N,N,-,-1,-1
MULIFE.txt,570411,572276,1865,10,N,N,-,-1,-1
MULIFE.txt,570720,572315,1595,10,N,N,-,-1,-1
MULIFE.txt,571060,572359,1299,10,N,N,-,-1,-1
MULIFE.txt,571348,572482,1134,10,N,N,-,-1,-1
MULIFE.txt,571423,572694,1271,10,N,N,-,-1,-1
MULIFE.txt,571701,572748,1047,10,N,N,-,-1,-1
MULIFE.txt,571709,572825,1116,10,N,N,-,-1,-1
MULIFE.txt,571896,572858,962,10,N,N,-,-1,-1
MULIFE.txt,572099,572940,841,10,N,N,-,-1,-1
MULIFE.txt,572142,573017,875,10,N,N,-,-1,-1
MULIFE.txt,572277,573120,843,10,N,N,-,-1,-1
MULIFE.txt,572318,573237,919,10,N,N,-,-1,-1
MULIFE.txt,572360,573390,1030,10,N,N,-,-1,-1
MULIFE.txt,572485,573454,969,10,N,N,-,-1,-1
MULIFE.txt,572695,573482,787,10,N,N,-,-1,-1
MULIFE.txt,572749,573544,795,10,N,N,-,-1,-1
MULIFE.txt,572828,573707,879,10,N,N,-,-1,-1
MULIFE.txt,572859,573864,1005,10,N,N,-,-1,-1
MULIFE.txt,572941,574125,1184,10,N,N,-,-1,-1
MULIFE.txt,573018,574384,1366,10,N,N,-,-1,-1
MULIFE.txt,573123,574436,1313,10,N,N,-,-1,-1
MULIFE.txt,573239,574550,1311,10,N,N,-,-1,-1
MULIFE.txt,573393,574563,1170,10,N,N,-,-1,-1
MULIFE.txt,573455,574669,1214,10,N,N,-,-1,-1
MULIFE.txt,573483,574730,1247,10,N,N,-,-1,-1
MULIFE.txt,573545,574757,1212,10,N,N,-,-1,-1
MULIFE.txt,573708,574779,1071,10,N,N,-,-1,-1
MULIFE.txt,573865,574945,1080,10,N,N,-,-1,-1
MULIFE.txt,574126,575045,919,10,N,N,-,-1,-1
MULIFE.txt,574385,575187,802,10,N,N,-,-1,-1
MULIFE.txt,574437,575410,973,10,N,N,-,-1,-1
MULIFE.txt,574555,575498,943,10,N,N,-,-1,-1
MULIFE.txt,574564,576110,1546,10,N,N,-,-1,-1
MULIFE.txt,574670,576253,1583,10,N,N,-,-1,-1
MULIFE.txt,574731,576389,1658,10,N,N,-,-1,-1
MULIFE.txt,574758,576433,1675,10,N,N,-,-1,-1
MULIFE.txt,574782,576544,1762,10,N,N,-,-1,-1
MULIFE.txt,574946,576618,1672,10,N,N,-,-1,-1
MULIFE.txt,575046,576711,1665,10,N,N,-,-1,-1
MULIFE.txt,575188,576771,1583,10,N,N,-,-1,-1
MULIFE.txt,575411,576858,1447,10,N,N,-,-1,-1
MULIFE.txt,575499,576931,1432,10,N,N,-,-1,-1
MULIFE.txt,576113,577256,1143,10,N,N,-,-1,-1
MULIFE.txt,576256,577347,1091,10,N,N,-,-1,-1
MULIFE.txt,576390,577389,999,10,N,N,-,-1,-1
MULIFE.txt,576434,577429,995,10,N,N,-,-1,-1
MULIFE.txt,576547,577475,928,10,N,N,-,-1,-1
MULIFE.txt,576619,577549,930,10,N,N,-,-1,-1
MULIFE.txt,576714,577621,907,10,N,N,-,-1,-1
MULIFE.txt,576774,577789,1015,10,N,N,-,-1,-1
MULIFE.txt,576859,577837,978,10,N,N,-,-1,-1
MULIFE.txt,576932,577997,1065,10,N,N,-,-1,-1
MULIFE.txt,577257,578147,890,10,N,N,-,-1,-1
MULIFE.txt,577352,578430,1078,10,N,N,-,-1,-1
MULIFE.txt,577394,578519,1125,10,N,N,-,-1,-1
MULIFE.txt,577434,578608,1174,10,N,N,-,-1,-1
MULIFE.txt,577478,578802,1324,10,N,N,-,-1,-1
MULIFE.txt,577550,578886,1336,10,N,N,-,-1,-1
MULIFE.txt,577623,579074,1451,10,N,N,-,-1,-1
MULIFE.txt,577791,579100,1309,10,N,N,-,-1,-1
MULIFE.txt,577838,579112,1274,10,N,N,-,-1,-1
MULIFE.txt,578000,579122,1122,10,N,N,-,-1,-1
MULIFE.txt,578148,579224,1076,10,N,N,-,-1,-1
MULIFE.txt,578433,579371,938,10,N,N,-,-1,-1
MULIFE.txt,578520,579375,855,10,N,N,-,-1,-1
MULIFE.txt,578610,579378,768,10,N,N,-,-1,-1
MULIFE.txt,578803,579380,577,10,N,N,-,-1,-1
MULIFE.txt,578887,579398,511,10,N,N,-,-1,-1
MULIFE.txt,579079,579431,352,10,N,N,-,-1,-1
MULIFE.txt,579101,579552,451,10,N,N,-,-1,-1
MULIFE.txt,579115,579595,480,10,N,N,-,-1,-1
MULIFE.txt,579125,579811,686,10,N,N,-,-1,-1
MULIFE.txt,579225,579894,669,10,N,N,-,-1,-1
MULIFE.txt,579372,579915,543,10,N,N,-,-1,-1
MULIFE.txt,579376,580179,803,10,N,N,-,-1,-1
MULIFE.txt,579379,580195,816,10,N,N,-,-1,-1
MULIFE.txt,579383,580280,897,10,N,N,-,-1,-1
MULIFE.txt,579401,580366,965,10,N,N,-,-1,-1
MULIFE.txt,579432,580384,952,10,N,N,-,-1,-1
MULIFE.txt,579555,581126,1571,10,N,N,-,-1,-1
MULIFE.txt,579596,581366,1770,10,N,N,-,-1,-1
MULIFE.txt,579814,581423,1609,10,N,N,-,-1,-1
MULIFE.txt,579895,581680,1785,10,N,N,-,-1,-1
MULIFE.txt,579916,581700,1784,10,N,N,-,-1,-1
MULIFE.txt,580184,581872,1688,10,N,Y,1437470299748,152207,152889
MULIFE.txt,580198,581888,1690,10,N,Y,1437470299748,152207,152889
MULIFE.txt,580281,582091,1810,10,N,Y,1437470299748,152207,152889
MULIFE.txt,580369,582302,1933,10,N,Y,1437470299748,152207,152889
MULIFE.txt,580385,582386,2001,10,N,Y,1437470299748,152207,152889
MULIFE.txt,581129,582503,1374,10,N,Y,1437470299748,152207,152889
MULIFE.txt,581367,582608,1241,10,N,Y,1437470299748,152207,152889
MULIFE.txt,581424,582720,1296,10,N,Y,1437470299748,152207,152889
MULIFE.txt,581685,582974,1289,10,N,Y,1437470299748,152207,152889
MULIFE.txt,581701,583003,1302,10,N,Y,1437470299748,152207,152889
MULIFE.txt,581875,583049,1174,10,N,Y,1437470299748,152207,152889
MULIFE.txt,581889,583226,1337,10,N,Y,1437470299748,152207,152889
MULIFE.txt,582093,583236,1143,10,N,Y,1437470299748,152207,152889
MULIFE.txt,582303,583303,1000,10,N,Y,1437470299748,152207,152889
MULIFE.txt,582387,583394,1007,10,N,Y,1437470299748,152207,152889
MULIFE.txt,582506,583513,1007,10,N,N,-,-1,-1
MULIFE.txt,582609,583624,1015,10,N,N,-,-1,-1
MULIFE.txt,582721,583798,1077,10,N,N,-,-1,-1
MULIFE.txt,582977,584018,1041,10,N,N,-,-1,-1
MULIFE.txt,583004,584211,1207,10,N,N,-,-1,-1
MULIFE.txt,583050,584262,1212,10,N,N,-,-1,-1
MULIFE.txt,583229,584337,1108,10,N,N,-,-1,-1
MULIFE.txt,583237,584570,1333,10,N,N,-,-1,-1
MULIFE.txt,583304,584642,1338,10,N,N,-,-1,-1
MULIFE.txt,583396,584734,1338,10,N,N,-,-1,-1
MULIFE.txt,583515,584807,1292,10,N,N,-,-1,-1
MULIFE.txt,583626,584943,1317,10,N,N,-,-1,-1
MULIFE.txt,583801,585133,1332,10,N,N,-,-1,-1
MULIFE.txt,584021,585401,1380,10,N,N,-,-1,-1
MULIFE.txt,584211,585460,1249,10,N,N,-,-1,-1
MULIFE.txt,584265,585600,1335,10,N,N,-,-1,-1
MULIFE.txt,584338,585624,1286,10,N,N,-,-1,-1
MULIFE.txt,584573,585706,1133,10,N,N,-,-1,-1
MULIFE.txt,584643,586186,1543,10,N,N,-,-1,-1
MULIFE.txt,584735,586202,1467,10,N,N,-,-1,-1
MULIFE.txt,584808,586536,1728,10,N,N,-,-1,-1
MULIFE.txt,584944,586650,1706,10,N,N,-,-1,-1
MULIFE.txt,585134,586705,1571,10,N,N,-,-1,-1
MULIFE.txt,585404,586825,1421,10,N,N,-,-1,-1
MULIFE.txt,585462,586959,1497,10,N,N,-,-1,-1
MULIFE.txt,585603,587258,1655,10,N,N,-,-1,-1
MULIFE.txt,585624,587460,1836,10,N,N,-,-1,-1
MULIFE.txt,585707,587522,1815,10,N,N,-,-1,-1
MULIFE.txt,586191,587593,1402,10,N,N,-,-1,-1
MULIFE.txt,586205,587661,1456,10,N,N,-,-1,-1
MULIFE.txt,586537,587729,1192,10,N,N,-,-1,-1
MULIFE.txt,586651,587814,1163,10,N,N,-,-1,-1
MULIFE.txt,586706,587938,1232,10,N,N,-,-1,-1
MULIFE.txt,586826,588007,1181,10,N,N,-,-1,-1
MULIFE.txt,586960,588092,1132,10,N,N,-,-1,-1
MULIFE.txt,587259,588302,1043,10,N,N,-,-1,-1
MULIFE.txt,587463,588421,958,10,N,N,-,-1,-1
MULIFE.txt,587524,588493,969,10,N,N,-,-1,-1
MULIFE.txt,587594,588708,1114,10,N,N,-,-1,-1
MULIFE.txt,587662,588753,1091,10,N,N,-,-1,-1
MULIFE.txt,587730,588827,1097,10,N,N,-,-1,-1
MULIFE.txt,587815,588905,1090,10,N,N,-,-1,-1
MULIFE.txt,587939,589002,1063,10,N,N,-,-1,-1
MULIFE.txt,588008,589164,1156,10,N,N,-,-1,-1
MULIFE.txt,588093,589196,1103,10,N,N,-,-1,-1
MULIFE.txt,588305,589292,987,10,N,N,-,-1,-1
MULIFE.txt,588422,589400,978,10,N,N,-,-1,-1
MULIFE.txt,588494,589625,1131,10,N,N,-,-1,-1
MULIFE.txt,588709,589986,1277,10,N,N,-,-1,-1
MULIFE.txt,588754,590082,1328,10,N,N,-,-1,-1
MULIFE.txt,588828,590345,1517,10,N,N,-,-1,-1
MULIFE.txt,588906,590531,1625,10,N,N,-,-1,-1
MULIFE.txt,589004,590669,1665,10,N,N,-,-1,-1
MULIFE.txt,589165,590693,1528,10,N,N,-,-1,-1
MULIFE.txt,589199,590731,1532,10,N,N,-,-1,-1
MULIFE.txt,589295,590894,1599,10,N,N,-,-1,-1
MULIFE.txt,589401,590933,1532,10,N,N,-,-1,-1
MULIFE.txt,589626,591137,1511,10,N,N,-,-1,-1
MULIFE.txt,589987,591335,1348,10,N,N,-,-1,-1
MULIFE.txt,590085,591423,1338,10,N,N,-,-1,-1
MULIFE.txt,590346,591683,1337,10,N,N,-,-1,-1
MULIFE.txt,590533,592160,1627,10,N,N,-,-1,-1
MULIFE.txt,590670,592239,1569,10,N,N,-,-1,-1
MULIFE.txt,590694,592305,1611,10,N,N,-,-1,-1
MULIFE.txt,590733,592433,1700,10,N,N,-,-1,-1
MULIFE.txt,590895,592576,1681,10,N,N,-,-1,-1
MULIFE.txt,590933,592868,1935,10,N,N,-,-1,-1
MULIFE.txt,591138,592995,1857,10,N,N,-,-1,-1
MULIFE.txt,591337,593055,1718,10,N,N,-,-1,-1
MULIFE.txt,591424,593149,1725,10,N,N,-,-1,-1
MULIFE.txt,591684,593225,1541,10,N,N,-,-1,-1
MULIFE.txt,592163,593384,1221,10,N,N,-,-1,-1
MULIFE.txt,592242,593665,1423,10,N,N,-,-1,-1
MULIFE.txt,592306,593786,1480,10,N,N,-,-1,-1
MULIFE.txt,592434,593846,1412,10,N,N,-,-1,-1
MULIFE.txt,592577,593961,1384,10,N,N,-,-1,-1
MULIFE.txt,592869,594076,1207,10,N,N,-,-1,-1
MULIFE.txt,592997,594129,1132,10,N,N,-,-1,-1
MULIFE.txt,593058,594457,1399,10,N,N,-,-1,-1
MULIFE.txt,593150,594603,1453,10,N,N,-,-1,-1
MULIFE.txt,593226,595330,2104,10,N,N,-,-1,-1
MULIFE.txt,593385,595358,1973,10,N,N,-,-1,-1
MULIFE.txt,593666,595560,1894,10,N,N,-,-1,-1
MULIFE.txt,593787,595858,2071,10,N,N,-,-1,-1
MULIFE.txt,593847,595953,2106,10,N,N,-,-1,-1
MULIFE.txt,593964,596012,2048,10,N,N,-,-1,-1
MULIFE.txt,594079,596162,2083,10,N,N,-,-1,-1
MULIFE.txt,594132,596182,2050,10,N,N,-,-1,-1
MULIFE.txt,594458,596282,1824,10,N,N,-,-1,-1
MULIFE.txt,594604,596549,1945,10,N,N,-,-1,-1
MULIFE.txt,595331,596835,1504,10,N,N,-,-1,-1
MULIFE.txt,595361,597068,1707,10,N,N,-,-1,-1
MULIFE.txt,595561,597218,1657,10,N,N,-,-1,-1
MULIFE.txt,595859,597334,1475,10,N,N,-,-1,-1
MULIFE.txt,595956,597376,1420,10,N,N,-,-1,-1
MULIFE.txt,596013,597615,1602,10,N,N,-,-1,-1
MULIFE.txt,596163,597880,1717,10,N,N,-,-1,-1
MULIFE.txt,596185,598263,2078,10,N,N,-,-1,-1
MULIFE.txt,596284,598279,1995,10,N,N,-,-1,-1
MULIFE.txt,596550,598364,1814,10,N,N,-,-1,-1
MULIFE.txt,596836,598631,1795,10,N,N,-,-1,-1
MULIFE.txt,597069,598848,1779,10,Y,N,-,-1,-1
MULIFE.txt,597221,598975,1754,10,Y,N,-,-1,-1
MULIFE.txt,597335,599014,1679,10,Y,N,-,-1,-1
MULIFE.txt,597378,599198,1820,10,N,N,-,-1,-1
MULIFE.txt,597616,599553,1937,10,N,N,-,-1,-1
MULIFE.txt,597881,599660,1779,10,N,N,-,-1,-1
MULIFE.txt,598268,599682,1414,10,N,N,-,-1,-1
MULIFE.txt,598282,599709,1427,10,N,N,-,-1,-1
MULIFE.txt,598365,599809,1444,10,N,N,-,-1,-1
MULIFE.txt,598632,599943,1311,10,N,N,-,-1,-1
MULIFE.txt,598849,599970,1121,10,N,N,-,-1,-1
MULIFE.txt,598976,600008,1032,10,N,N,-,-1,-1
MULIFE.txt,599015,600195,1180,10,N,N,-,-1,-1
MULIFE.txt,599201,600290,1089,10,N,N,-,-1,-1
MULIFE.txt,599554,600481,927,10,N,N,-,-1,-1
MULIFE.txt,599663,600818,1155,10,N,N,-,-1,-1
MULIFE.txt,599683,600874,1191,10,N,N,-,-1,-1
MULIFE.txt,599710,600991,1281,10,N,N,-,-1,-1
MULIFE.txt,599810,600996,1186,10,N,N,-,-1,-1
MULIFE.txt,599944,601061,1117,10,N,N,-,-1,-1
MULIFE.txt,599971,601113,1142,10,N,N,-,-1,-1
MULIFE.txt,600009,601271,1262,10,N,N,-,-1,-1
MULIFE.txt,600196,601291,1095,10,N,N,-,-1,-1
MULIFE.txt,600291,601533,1242,10,N,N,-,-1,-1
MULIFE.txt,600482,601607,1125,10,N,N,-,-1,-1
MULIFE.txt,600819,601652,833,10,N,N,-,-1,-1
MULIFE.txt,600877,602073,1196,10,N,N,-,-1,-1
MULIFE.txt,600992,602190,1198,10,N,N,-,-1,-1
MULIFE.txt,600997,602583,1586,10,N,N,-,-1,-1
MULIFE.txt,601062,602754,1692,10,N,N,-,-1,-1
MULIFE.txt,601114,602792,1678,10,N,N,-,-1,-1
MULIFE.txt,601272,602958,1686,10,N,N,-,-1,-1
MULIFE.txt,601294,603079,1785,10,N,N,-,-1,-1
MULIFE.txt,601534,603388,1854,10,N,N,-,-1,-1
MULIFE.txt,601608,603606,1998,10,N,N,-,-1,-1
MULIFE.txt,601653,603737,2084,10,N,N,-,-1,-1
MULIFE.txt,602074,603867,1793,10,N,N,-,-1,-1
MULIFE.txt,602191,604098,1907,10,Y,N,-,-1,-1
MULIFE.txt,602583,604161,1578,10,Y,N,-,-1,-1
MULIFE.txt,602759,604165,1406,10,Y,N,-,-1,-1
MULIFE.txt,602793,604182,1389,10,Y,N,-,-1,-1
MULIFE.txt,602961,604311,1350,10,Y,N,-,-1,-1
MULIFE.txt,603080,604409,1329,10,Y,N,-,-1,-1
MULIFE.txt,603389,604449,1060,10,Y,N,-,-1,-1
MULIFE.txt,603606,604707,1101,10,Y,N,-,-1,-1
MULIFE.txt,603738,604915,1177,10,N,N,-,-1,-1
MULIFE.txt,603868,604979,1111,10,Y,N,-,-1,-1
MULIFE.txt,604099,605020,921,10,N,N,-,-1,-1
MULIFE.txt,604162,605149,987,10,N,N,-,-1,-1
MULIFE.txt,604170,605264,1094,10,N,N,-,-1,-1
MULIFE.txt,604185,605365,1180,10,N,N,-,-1,-1
MULIFE.txt,604312,605559,1247,10,N,N,-,-1,-1
MULIFE.txt,604410,605699,1289,10,N,N,-,-1,-1
MULIFE.txt,604450,605772,1322,10,N,N,-,-1,-1
MULIFE.txt,604708,605866,1158,10,N,N,-,-1,-1
MULIFE.txt,604916,605966,1050,10,Y,N,-,-1,-1
MULIFE.txt,604982,606166,1184,10,Y,N,-,-1,-1
MULIFE.txt,605021,606571,1550,10,Y,N,-,-1,-1
MULIFE.txt,605152,606828,1676,10,Y,N,-,-1,-1
MULIFE.txt,605266,606972,1706,10,Y,N,-,-1,-1
MULIFE.txt,605366,607054,1688,10,Y,N,-,-1,-1
MULIFE.txt,605561,607133,1572,10,Y,N,-,-1,-1
MULIFE.txt,605700,607185,1485,10,Y,N,-,-1,-1
MULIFE.txt,605775,607228,1453,10,Y,N,-,-1,-1
MULIFE.txt,605867,607354,1487,10,N,N,-,-1,-1
MULIFE.txt,605967,607718,1751,10,N,N,-,-1,-1
MULIFE.txt,606167,607956,1789,10,Y,N,-,-1,-1
MULIFE.txt,606572,608181,1609,10,N,N,-,-1,-1
MULIFE.txt,606831,608504,1673,10,N,N,-,-1,-1
MULIFE.txt,606973,608576,1603,10,N,N,-,-1,-1
MULIFE.txt,607054,608706,1652,10,N,N,-,-1,-1
MULIFE.txt,607134,608724,1590,10,N,N,-,-1,-1
MULIFE.txt,607188,609101,1913,10,N,N,-,-1,-1
MULIFE.txt,607229,609130,1901,10,N,N,-,-1,-1
MULIFE.txt,607355,609168,1813,10,N,N,-,-1,-1
MULIFE.txt,607719,609505,1786,10,N,N,-,-1,-1
MULIFE.txt,607957,609589,1632,10,N,N,-,-1,-1
MULIFE.txt,608182,609865,1683,10,N,N,-,-1,-1
MULIFE.txt,608507,609915,1408,10,N,N,-,-1,-1
MULIFE.txt,608577,610050,1473,10,N,N,-,-1,-1
MULIFE.txt,608707,610407,1700,10,Y,N,-,-1,-1
MULIFE.txt,608725,610493,1768,10,Y,N,-,-1,-1
MULIFE.txt,609104,610738,1634,10,N,N,-,-1,-1
MULIFE.txt,609131,611350,2219,10,N,N,-,-1,-1
MULIFE.txt,609169,611505,2336,10,N,N,-,-1,-1
MULIFE.txt,609506,611593,2087,10,N,N,-,-1,-1
MULIFE.txt,609590,611674,2084,10,N,N,-,-1,-1
MULIFE.txt,609866,611883,2017,10,N,N,-,-1,-1
MULIFE.txt,609918,612078,2160,10,N,N,-,-1,-1
MULIFE.txt,610053,612511,2458,10,N,N,-,-1,-1
MULIFE.txt,610410,612764,2354,10,N,N,-,-1,-1
MULIFE.txt,610494,612829,2335,10,N,N,-,-1,-1
MULIFE.txt,610739,612881,2142,10,N,N,-,-1,-1
MULIFE.txt,611351,612991,1640,10,N,N,-,-1,-1
MULIFE.txt,611506,613059,1553,10,N,N,-,-1,-1
MULIFE.txt,611594,613110,1516,10,N,N,-,-1,-1
MULIFE.txt,611675,613144,1469,10,N,N,-,-1,-1
MULIFE.txt,611884,613349,1465,10,N,N,-,-1,-1
MULIFE.txt,612079,613594,1515,10,N,N,-,-1,-1
MULIFE.txt,612514,613719,1205,10,N,N,-,-1,-1
MULIFE.txt,612767,613890,1123,10,N,N,-,-1,-1
MULIFE.txt,612832,614150,1318,10,N,N,-,-1,-1
MULIFE.txt,612883,614313,1430,10,N,N,-,-1,-1
MULIFE.txt,612992,614488,1496,10,N,N,-,-1,-1
MULIFE.txt,613062,614572,1510,10,N,N,-,-1,-1
MULIFE.txt,613111,614642,1531,10,N,N,-,-1,-1
MULIFE.txt,613145,614751,1606,10,N,N,-,-1,-1
MULIFE.txt,613350,614861,1511,10,N,N,-,-1,-1
MULIFE.txt,613595,615190,1595,10,N,N,-,-1,-1
MULIFE.txt,613720,615497,1777,10,N,N,-,-1,-1
MULIFE.txt,613891,615870,1979,10,N,N,-,-1,-1
MULIFE.txt,614151,616095,1944,10,N,N,-,-1,-1
MULIFE.txt,614314,616214,1900,10,N,N,-,-1,-1
MULIFE.txt,614491,616490,1999,10,N,N,-,-1,-1
MULIFE.txt,614573,616669,2096,10,N,N,-,-1,-1
MULIFE.txt,614643,616760,2117,10,N,N,-,-1,-1
MULIFE.txt,614754,616835,2081,10,N,N,-,-1,-1
MULIFE.txt,614864,616954,2090,10,N,N,-,-1,-1
MULIFE.txt,615191,617308,2117,10,N,N,-,-1,-1
MULIFE.txt,615499,617446,1947,10,N,N,-,-1,-1
MULIFE.txt,615871,617537,1666,10,N,N,-,-1,-1
MULIFE.txt,616098,617564,1466,10,N,N,-,-1,-1
MULIFE.txt,616215,617708,1493,10,N,N,-,-1,-1
MULIFE.txt,616491,617785,1294,10,N,N,-,-1,-1
MULIFE.txt,616669,617981,1312,10,N,N,-,-1,-1
MULIFE.txt,616761,618282,1521,10,N,N,-,-1,-1
MULIFE.txt,616837,618453,1616,10,N,N,-,-1,-1
MULIFE.txt,616955,618565,1610,10,N,N,-,-1,-1
MULIFE.txt,617309,618985,1676,10,N,N,-,-1,-1
MULIFE.txt,617447,619382,1935,10,N,N,-,-1,-1
MULIFE.txt,617542,619422,1880,10,N,N,-,-1,-1
MULIFE.txt,617565,619523,1958,10,N,N,-,-1,-1
MULIFE.txt,617711,619629,1918,10,N,N,-,-1,-1
MULIFE.txt,617786,619928,2142,10,N,N,-,-1,-1
MULIFE.txt,617982,620336,2354,10,N,N,-,-1,-1
MULIFE.txt,618285,620392,2107,10,N,Y,1448278279697,58861,59444
MULIFE.txt,618456,620468,2012,10,N,Y,1448278279697,58861,59444
MULIFE.txt,618568,620583,2015,10,N,Y,1448278279697,58861,59444
MULIFE.txt,618988,620681,1693,10,N,Y,1448278279697,58861,59444
MULIFE.txt,619385,620730,1345,10,N,Y,1448278279697,58861,59444
MULIFE.txt,619423,620762,1339,10,N,Y,1448278279697,58861,59444
MULIFE.txt,619524,620883,1359,10,N,Y,1448278279697,58861,59444
MULIFE.txt,619630,620978,1348,10,N,Y,1448278279697,58861,59444
MULIFE.txt,619929,621087,1158,10,N,Y,1448278279697,58861,59444
MULIFE.txt,620339,621200,861,10,N,Y,1448278279697,58861,59444
MULIFE.txt,620394,621427,1033,10,N,Y,1448278279697,58861,59444
MULIFE.txt,620469,621606,1137,10,Y,Y,1448278279697,58861,59444
MULIFE.txt,620586,621817,1231,10,Y,Y,1448278279697,58861,59444
MULIFE.txt,620682,621890,1208,10,N,Y,1448278279697,58861,59444
MULIFE.txt,620731,622037,1306,10,N,Y,1448278279697,58861,59444
MULIFE.txt,620763,622104,1341,10,N,Y,1448278279697,58861,59444
MULIFE.txt,620884,622395,1511,10,N,Y,1448278279697,58861,59444
MULIFE.txt,620981,622511,1530,10,N,N,-,-1,-1
MULIFE.txt,621088,622550,1462,10,N,N,-,-1,-1
MULIFE.txt,621201,622644,1443,10,N,N,-,-1,-1
MULIFE.txt,621430,622661,1231,10,N,N,-,-1,-1
MULIFE.txt,621608,622803,1195,10,N,N,-,-1,-1
MULIFE.txt,621818,623121,1303,10,N,N,-,-1,-1
MULIFE.txt,621891,623488,1597,10,N,N,-,-1,-1
MULIFE.txt,622040,623602,1562,10,N,N,-,-1,-1
MULIFE.txt,622105,623674,1569,10,N,N,-,-1,-1
MULIFE.txt,622398,623707,1309,10,N,N,-,-1,-1
MULIFE.txt,622512,623924,1412,10,N,N,-,-1,-1
MULIFE.txt,622551,624121,1570,10,N,N,-,-1,-1
MULIFE.txt,622645,624199,1554,10,N,N,-,-1,-1
MULIFE.txt,622662,624442,1780,10,N,N,-,-1,-1
MULIFE.txt,622804,624658,1854,10,N,N,-,-1,-1
MULIFE.txt,623122,625162,2040,10,N,N,-,-1,-1
MULIFE.txt,623489,625240,1751,10,N,N,-,-1,-1
MULIFE.txt,623603,625473,1870,10,N,N,-,-1,-1
MULIFE.txt,623675,625630,1955,10,N,N,-,-1,-1
MULIFE.txt,623708,625676,1968,10,N,N,-,-1,-1
MULIFE.txt,623925,625847,1922,10,N,N,-,-1,-1
MULIFE.txt,624122,625944,1822,10,N,N,-,-1,-1
MULIFE.txt,624200,625964,1764,10,N,N,-,-1,-1
MULIFE.txt,624445,626232,1787,10,N,N,-,-1,-1
MULIFE.txt,624659,626331,1672,10,N,Y,1436867017136,105674,106651
MULIFE.txt,625165,626352,1187,10,N,Y,1436867017136,105674,106651
MULIFE.txt,625241,626414,1173,10,N,Y,1436867017136,105674,106651
MULIFE.txt,625476,626479,1003,10,N,Y,1436867017136,105674,106651
MULIFE.txt,625631,626605,974,10,N,Y,1436867017136,105674,106651
MULIFE.txt,625677,626622,945,10,N,Y,1436867017136,105674,106651
MULIFE.txt,625848,626774,926,10,N,Y,1436867017136,105674,106651
MULIFE.txt,625947,626901,954,10,N,Y,1436867017136,105674,106651
MULIFE.txt,625965,626982,1017,10,N,Y,1436867017136,105674,106651
MULIFE.txt,626235,627167,932,10,N,Y,1436867017136,105674,106651
MULIFE.txt,626332,627411,1079,10,N,Y,1436867017136,105674,106651
MULIFE.txt,626353,627632,1279,10,N,Y,1436867017136,105674,106651
MULIFE.txt,626415,627678,1263,10,N,Y,1436867017136,105674,106651
MULIFE.txt,626480,627722,1242,10,N,Y,1436867017136,105674,106651
MULIFE.txt,626605,627919,1314,10,N,Y,1436867017136,105674,106651
MULIFE.txt,626623,628093,1470,10,N,Y,1436867017136,105674,106651
MULIFE.txt,626775,628129,1354,10,N,Y,1436867017136,105674,106651
MULIFE.txt,626902,628447,1545,10,N,N,-,-1,-1
MULIFE.txt,626983,629444,2461,10,N,N,-,-1,-1
MULIFE.txt,627168,629631,2463,10,N,N,-,-1,-1
MULIFE.txt,627412,629685,2273,10,N,N,-,-1,-1
MULIFE.txt,627635,629708,2073,10,N,N,-,-1,-1
MULIFE.txt,627679,629955,2276,10,N,N,-,-1,-1
MULIFE.txt,627723,630222,2499,10,N,N,-,-1,-1
MULIFE.txt,627920,630292,2372,10,N,N,-,-1,-1
MULIFE.txt,628096,630331,2235,10,N,N,-,-1,-1
MULIFE.txt,628130,630400,2270,10,N,N,-,-1,-1
MULIFE.txt,628450,630443,1993,10,N,N,-,-1,-1
MULIFE.txt,629447,630466,1019,10,N,N,-,-1,-1
MULIFE.txt,629632,630740,1108,10,N,N,-,-1,-1
MULIFE.txt,629686,630851,1165,10,N,N,-,-1,-1
MULIFE.txt,629709,631046,1337,10,Y,N,-,-1,-1
MULIFE.txt,629956,631082,1126,10,Y,N,-,-1,-1
MULIFE.txt,630225,631124,899,10,N,N,-,-1,-1
MULIFE.txt,630293,631199,906,10,N,N,-,-1,-1
MULIFE.txt,630332,631358,1026,10,N,N,-,-1,-1
MULIFE.txt,630401,631403,1002,10,N,N,-,-1,-1
MULIFE.txt,630446,632311,1865,10,N,N,-,-1,-1
MULIFE.txt,630467,632588,2121,10,N,N,-,-1,-1
MULIFE.txt,630743,632620,1877,10,N,N,-,-1,-1
MULIFE.txt,630854,632749,1895,10,N,N,-,-1,-1
MULIFE.txt,631049,632774,1725,10,N,N,-,-1,-1
MULIFE.txt,631083,632868,1785,10,N,N,-,-1,-1
MULIFE.txt,631125,632942,1817,10,N,N,-,-1,-1
MULIFE.txt,631200,632994,1794,10,N,N,-,-1,-1
MULIFE.txt,631361,633286,1925,10,N,N,-,-1,-1
MULIFE.txt,631404,633453,2049,10,N,Y,1448281888079,98877,102290
MULIFE.txt,632312,633582,1270,10,N,Y,1448281888079,98877,102290
MULIFE.txt,632593,633752,1159,10,N,Y,1448281888079,98877,102290
MULIFE.txt,632621,633819,1198,10,N,Y,1448281888079,98877,102290
MULIFE.txt,632750,633927,1177,10,N,Y,1448281888079,98877,102290
MULIFE.txt,632775,634072,1297,10,N,Y,1448281888079,98877,102290
MULIFE.txt,632869,634126,1257,10,N,Y,1448281888079,98877,102290
MULIFE.txt,632943,634188,1245,10,N,Y,1448281888079,98877,102290
MULIFE.txt,632995,634653,1658,10,N,Y,1448281888079,98877,102290
MULIFE.txt,633289,634825,1536,10,N,Y,1448281888079,98877,102290
MULIFE.txt,633456,635022,1566,10,N,Y,1448281888079,98877,102290
MULIFE.txt,633583,635162,1579,10,N,Y,1448281888079,98877,102290
MULIFE.txt,633753,635437,1684,10,N,Y,1448281888079,98877,102290
MULIFE.txt,633820,635715,1895,10,N,Y,1448281888079,98877,102290
MULIFE.txt,633928,635855,1927,10,N,Y,1448281888079,98877,102290
MULIFE.txt,634073,635885,1812,10,N,Y,1448282044001,101941,102395
MULIFE.txt,634129,636115,1986,10,N,Y,1448282044001,101941,102395
MULIFE.txt,634190,636214,2024,10,N,Y,1448282044001,101941,102395
MULIFE.txt,634655,636335,1680,10,N,Y,1448282044001,101941,102395
MULIFE.txt,634827,636840,2013,10,Y,Y,1448282044001,101941,102395
MULIFE.txt,635023,636883,1860,10,Y,Y,1448282044001,101941,102395
MULIFE.txt,635165,636904,1739,10,Y,Y,1448282044001,101941,102395
MULIFE.txt,635438,637021,1583,10,Y,Y,1448282044001,101941,102395
MULIFE.txt,635716,637145,1429,10,N,Y,1448282044001,101941,102395
MULIFE.txt,635856,637205,1349,10,N,Y,1448282044001,101941,102395
MULIFE.txt,635887,637232,1345,10,N,Y,1448282044001,101941,102395
MULIFE.txt,636117,637598,1481,10,N,Y,1448282044001,101941,102395
MULIFE.txt,636217,637910,1693,10,N,N,-,-1,-1
MULIFE.txt,636336,637926,1590,10,N,N,-,-1,-1
MULIFE.txt,636843,638003,1160,10,N,N,-,-1,-1
MULIFE.txt,636884,638143,1259,10,N,N,-,-1,-1
MULIFE.txt,636905,638211,1306,10,N,N,-,-1,-1
MULIFE.txt,637022,638247,1225,10,N,N,-,-1,-1
MULIFE.txt,637148,638468,1320,10,N,N,-,-1,-1
MULIFE.txt,637207,638553,1346,10,N,N,-,-1,-1
MULIFE.txt,637233,638562,1329,10,N,N,-,-1,-1
MULIFE.txt,637599,638861,1262,10,N,N,-,-1,-1
MULIFE.txt,637913,639027,1114,10,N,N,-,-1,-1
MULIFE.txt,637926,639494,1568,10,N,N,-,-1,-1
MULIFE.txt,638006,639739,1733,10,N,N,-,-1,-1
MULIFE.txt,638144,639895,1751,10,N,N,-,-1,-1
MULIFE.txt,638212,639976,1764,10,N,N,-,-1,-1
MULIFE.txt,638248,640079,1831,10,N,N,-,-1,-1
MULIFE.txt,638471,640180,1709,10,N,N,-,-1,-1
MULIFE.txt,638554,640291,1737,10,N,N,-,-1,-1
MULIFE.txt,638563,640417,1854,10,N,N,-,-1,-1
MULIFE.txt,638862,640816,1954,10,N,N,-,-1,-1
MULIFE.txt,639030,640913,1883,10,N,N,-,-1,-1
MULIFE.txt,639497,641406,1909,10,N,N,-,-1,-1
MULIFE.txt,639740,641484,1744,10,N,N,-,-1,-1
MULIFE.txt,639900,641884,1984,10,N,N,-,-1,-1
MULIFE.txt,639979,642047,2068,10,N,N,-,-1,-1
MULIFE.txt,640081,642153,2072,10,N,N,-,-1,-1
MULIFE.txt,640182,642485,2303,10,N,N,-,-1,-1
MULIFE.txt,640293,642493,2200,10,N,N,-,-1,-1
MULIFE.txt,640418,642577,2159,10,N,N,-,-1,-1
MULIFE.txt,640817,642587,1770,10,N,N,-,-1,-1
MULIFE.txt,640915,642607,1692,10,N,N,-,-1,-1
MULIFE.txt,641409,642639,1230,10,N,N,-,-1,-1
MULIFE.txt,641485,642677,1192,10,N,N,-,-1,-1
MULIFE.txt,641886,642757,871,10,N,N,-,-1,-1
MULIFE.txt,642048,642878,830,10,N,N,-,-1,-1
MULIFE.txt,642154,643041,887,10,N,N,-,-1,-1
MULIFE.txt,642486,643222,736,10,N,N,-,-1,-1
MULIFE.txt,642494,643318,824,10,N,N,-,-1,-1
MULIFE.txt,642578,643379,801,10,N,N,-,-1,-1
MULIFE.txt,642588,643385,797,10,N,N,-,-1,-1
MULIFE.txt,642608,643484,876,10,N,N,-,-1,-1
MULIFE.txt,642640,643775,1135,10,N,N,-,-1,-1
MULIFE.txt,642678,644136,1458,10,N,N,-,-1,-1
MULIFE.txt,642758,644258,1500,10,N,N,-,-1,-1
MULIFE.txt,642879,644289,1410,10,N,N,-,-1,-1
MULIFE.txt,643044,644479,1435,10,N,N,-,-1,-1
MULIFE.txt,643225,644543,1318,10,N,N,-,-1,-1
MULIFE.txt,643319,644733,1414,10,N,N,-,-1,-1
MULIFE.txt,643381,644771,1390,10,N,N,-,-1,-1
MULIFE.txt,643387,644862,1475,10,N,N,-,-1,-1
MULIFE.txt,643485,644894,1409,10,N,N,-,-1,-1
MULIFE.txt,643776,644986,1210,10,N,N,-,-1,-1
MULIFE.txt,644139,645113,974,10,N,N,-,-1,-1
MULIFE.txt,644259,645305,1046,10,N,N,-,-1,-1
MULIFE.txt,644291,645401,1110,10,N,N,-,-1,-1
MULIFE.txt,644480,645463,983,10,N,N,-,-1,-1
MULIFE.txt,644545,645729,1184,10,N,N,-,-1,-1
MULIFE.txt,644736,645800,1064,10,N,N,-,-1,-1
MULIFE.txt,644772,645807,1035,10,N,N,-,-1,-1
MULIFE.txt,644863,645914,1051,10,N,N,-,-1,-1
MULIFE.txt,644897,645981,1084,10,N,N,-,-1,-1
MULIFE.txt,644987,646106,1119,10,N,N,-,-1,-1
MULIFE.txt,645114,646267,1153,10,N,N,-,-1,-1
MULIFE.txt,645306,646311,1005,10,N,N,-,-1,-1
MULIFE.txt,645404,646434,1030,10,N,N,-,-1,-1
MULIFE.txt,645465,646649,1184,10,N,N,-,-1,-1
MULIFE.txt,645732,646762,1030,10,N,N,-,-1,-1
MULIFE.txt,645803,646962,1159,10,N,N,-,-1,-1
MULIFE.txt,645808,647035,1227,10,N,N,-,-1,-1
MULIFE.txt,645916,647094,1178,10,N,N,-,-1,-1
MULIFE.txt,645982,647142,1160,10,N,N,-,-1,-1
MULIFE.txt,646107,647178,1071,10,N,N,-,-1,-1
MULIFE.txt,646270,647199,929,10,N,N,-,-1,-1
MULIFE.txt,646312,647249,937,10,N,N,-,-1,-1
MULIFE.txt,646435,647296,861,10,N,N,-,-1,-1
MULIFE.txt,646652,647385,733,10,N,N,-,-1,-1
MULIFE.txt,646763,647434,671,10,N,N,-,-1,-1
MULIFE.txt,646963,647468,505,10,N,N,-,-1,-1
MULIFE.txt,647038,647553,515,10,N,N,-,-1,-1
MULIFE.txt,647096,647579,483,10,N,N,-,-1,-1
MULIFE.txt,647143,647708,565,10,N,N,-,-1,-1
MULIFE.txt,647179,647723,544,10,N,N,-,-1,-1
MULIFE.txt,647200,647819,619,10,N,N,-,-1,-1
MULIFE.txt,647250,647833,583,10,N,N,-,-1,-1
MULIFE.txt,647299,647982,683,10,N,N,-,-1,-1
MULIFE.txt,647386,648360,974,10,N,N,-,-1,-1
MULIFE.txt,647436,648401,965,10,N,N,-,-1,-1
MULIFE.txt,647469,648516,1047,10,N,N,-,-1,-1
MULIFE.txt,647554,648583,1029,10,N,N,-,-1,-1
MULIFE.txt,647579,648659,1080,10,N,N,-,-1,-1
MULIFE.txt,647709,648839,1130,10,N,N,-,-1,-1
MULIFE.txt,647724,648961,1237,10,N,N,-,-1,-1
MULIFE.txt,647821,649074,1253,10,N,N,-,-1,-1
MULIFE.txt,647834,649094,1260,10,N,N,-,-1,-1
MULIFE.txt,647985,649269,1284,10,N,N,-,-1,-1
MULIFE.txt,648361,649411,1050,10,N,N,-,-1,-1
MULIFE.txt,648404,649529,1125,10,N,N,-,-1,-1
MULIFE.txt,648517,649596,1079,10,N,N,-,-1,-1
MULIFE.txt,648586,649759,1173,10,N,N,-,-1,-1
MULIFE.txt,648662,649899,1237,10,N,N,-,-1,-1
MULIFE.txt,648842,649972,1130,10,N,N,-,-1,-1
MULIFE.txt,648962,649984,1022,10,N,N,-,-1,-1
MULIFE.txt,649077,650092,1015,10,N,N,-,-1,-1
MULIFE.txt,649095,650168,1073,10,N,N,-,-1,-1
MULIFE.txt,649270,650253,983,10,N,N,-,-1,-1
MULIFE.txt,649414,650384,970,10,N,N,-,-1,-1
MULIFE.txt,649530,650529,999,10,N,N,-,-1,-1
MULIFE.txt,649597,650605,1008,10,N,N,-,-1,-1
MULIFE.txt,649762,650718,956,10,N,N,-,-1,-1
MULIFE.txt,649900,650802,902,10,N,N,-,-1,-1
MULIFE.txt,649973,650915,942,10,N,N,-,-1,-1
MULIFE.txt,649985,650922,937,10,N,N,-,-1,-1
MULIFE.txt,650092,651046,954,10,N,N,-,-1,-1
MULIFE.txt,650169,651082,913,10,N,N,-,-1,-1
MULIFE.txt,650255,651190,935,10,N,N,-,-1,-1
MULIFE.txt,650385,651347,962,10,N,N,-,-1,-1
MULIFE.txt,650530,651363,833,10,N,N,-,-1,-1
MULIFE.txt,650607,651664,1057,10,N,N,-,-1,-1
MULIFE.txt,650719,651927,1208,10,N,N,-,-1,-1
MULIFE.txt,650805,652026,1221,10,N,N,-,-1,-1
MULIFE.txt,650918,652053,1135,10,N,N,-,-1,-1
MULIFE.txt,650923,652085,1162,10,N,N,-,-1,-1
MULIFE.txt,651047,652182,1135,10,N,N,-,-1,-1
MULIFE.txt,651083,652334,1251,10,Y,N,-,-1,-1
MULIFE.txt,651191,652673,1482,10,Y,N,-,-1,-1
MULIFE.txt,651352,652804,1452,10,Y,N,-,-1,-1
MULIFE.txt,651366,652838,1472,10,Y,N,-,-1,-1
MULIFE.txt,651665,652982,1317,10,Y,N,-,-1,-1
MULIFE.txt,651930,653251,1321,10,N,N,-,-1,-1
MULIFE.txt,652027,653301,1274,10,N,N,-,-1,-1
MULIFE.txt,652054,653351,1297,10,N,N,-,-1,-1
MULIFE.txt,652086,653618,1532,10,N,N,-,-1,-1
MULIFE.txt,652183,653807,1624,10,N,N,-,-1,-1
MULIFE.txt,652335,653865,1530,10,N,N,-,-1,-1
MULIFE.txt,652676,654008,1332,10,N,N,-,-1,-1
MULIFE.txt,652809,654336,1527,10,N,N,-,-1,-1
MULIFE.txt,652839,654352,1513,10,N,N,-,-1,-1
MULIFE.txt,652983,654365,1382,10,N,N,-,-1,-1
MULIFE.txt,653252,654513,1261,10,N,N,-,-1,-1
MULIFE.txt,653304,654742,1438,10,N,N,-,-1,-1
MULIFE.txt,653352,654909,1557,10,N,N,-,-1,-1
MULIFE.txt,653619,655035,1416,10,N,N,-,-1,-1
MULIFE.txt,653808,655180,1372,10,N,N,-,-1,-1
MULIFE.txt,653867,655276,1409,10,N,N,-,-1,-1
MULIFE.txt,654011,655421,1410,10,N,N,-,-1,-1
MULIFE.txt,654341,655450,1109,10,N,N,-,-1,-1
MULIFE.txt,654355,655641,1286,10,N,N,-,-1,-1
MULIFE.txt,654366,655779,1413,10,N,N,-,-1,-1
MULIFE.txt,654514,655825,1311,10,N,N,-,-1,-1
MULIFE.txt,654743,655976,1233,10,N,N,-,-1,-1
MULIFE.txt,654910,655995,1085,10,N,N,-,-1,-1
MULIFE.txt,655038,656014,976,10,N,N,-,-1,-1
MULIFE.txt,655181,656076,895,10,N,N,-,-1,-1
MULIFE.txt,655279,656348,1069,10,N,N,-,-1,-1
MULIFE.txt,655422,656519,1097,10,N,N,-,-1,-1
MULIFE.txt,655452,656602,1150,10,N,N,-,-1,-1
MULIFE.txt,655644,656639,995,10,N,N,-,-1,-1
MULIFE.txt,655780,656719,939,10,N,N,-,-1,-1
MULIFE.txt,655826,656830,1004,10,N,N,-,-1,-1
MULIFE.txt,655979,656897,918,10,N,N,-,-1,-1
MULIFE.txt,655996,657227,1231,10,N,N,-,-1,-1
MULIFE.txt,656015,657291,1276,10,N,N,-,-1,-1
MULIFE.txt,656077,657375,1298,10,N,N,-,-1,-1
MULIFE.txt,656351,657730,1379,10,N,N,-,-1,-1
MULIFE.txt,656522,657935,1413,10,N,N,-,-1,-1
MULIFE.txt,656603,658143,1540,10,N,N,-,-1,-1
MULIFE.txt,656639,658288,1649,10,N,N,-,-1,-1
MULIFE.txt,656720,658323,1603,10,N,N,-,-1,-1
MULIFE.txt,656831,658547,1716,10,N,N,-,-1,-1
MULIFE.txt,656898,658786,1888,10,Y,N,-,-1,-1
MULIFE.txt,657230,658856,1626,10,Y,N,-,-1,-1
MULIFE.txt,657292,658958,1666,10,Y,N,-,-1,-1
MULIFE.txt,657376,658978,1602,10,Y,N,-,-1,-1
MULIFE.txt,657731,659106,1375,10,Y,N,-,-1,-1
MULIFE.txt,657936,659203,1267,10,Y,N,-,-1,-1
MULIFE.txt,658144,659282,1138,10,N,Y,1448322713112,221941,223038
MULIFE.txt,658289,659322,1033,10,N,Y,1448322713112,221941,223038
MULIFE.txt,658326,659460,1134,10,N,Y,1448322713112,221941,223038
MULIFE.txt,658548,659580,1032,10,N,Y,1448322713112,221941,223038
MULIFE.txt,658787,659673,886,10,N,Y,1448322713112,221941,223038
MULIFE.txt,658859,659899,1040,10,N,Y,1448322713112,221941,223038
MULIFE.txt,658959,659965,1006,10,N,Y,1448322713112,221941,223038
MULIFE.txt,658979,660129,1150,10,N,Y,1448322713112,221941,223038
MULIFE.txt,659107,660210,1103,10,N,Y,1448322713112,221941,223038
MULIFE.txt,659204,660291,1087,10,N,Y,1448322713112,221941,223038
MULIFE.txt,659283,660352,1069,10,N,Y,1448322713112,221941,223038
MULIFE.txt,659323,660498,1175,10,N,Y,1448322713112,221941,223038
MULIFE.txt,659461,660775,1314,10,N,Y,1448322713112,221941,223038
MULIFE.txt,659581,660856,1275,10,N,Y,1448322713112,221941,223038
MULIFE.txt,659675,661013,1338,10,N,Y,1448322713112,221941,223038
MULIFE.txt,659902,661154,1252,10,N,N,-,-1,-1
MULIFE.txt,659966,661353,1387,10,N,N,-,-1,-1
MULIFE.txt,660130,661377,1247,10,N,N,-,-1,-1
MULIFE.txt,660213,661428,1215,10,N,N,-,-1,-1
MULIFE.txt,660292,661531,1239,10,N,N,-,-1,-1
MULIFE.txt,660353,661657,1304,10,N,N,-,-1,-1
MULIFE.txt,660501,661689,1188,10,N,N,-,-1,-1
MULIFE.txt,660777,661808,1031,10,N,N,-,-1,-1
MULIFE.txt,660857,661989,1132,10,N,N,-,-1,-1
MULIFE.txt,661014,662043,1029,10,N,Y,1448315012079,181380,182053
MULIFE.txt,661157,662279,1122,10,N,Y,1448315012079,181380,182053
MULIFE.txt,661354,662401,1047,10,N,Y,1448315012079,181380,182053
MULIFE.txt,661380,662503,1123,10,N,Y,1448315012079,181380,182053
MULIFE.txt,661430,662530,1100,10,N,Y,1448315012079,181380,182053
MULIFE.txt,661532,662746,1214,10,N,Y,1448315012079,181380,182053
MULIFE.txt,661658,662852,1194,10,N,Y,1448315012079,181380,182053
MULIFE.txt,661690,662929,1239,10,N,Y,1448315012079,181380,182053
MULIFE.txt,661810,662955,1145,10,N,Y,1448315012079,181380,182053
MULIFE.txt,661990,663021,1031,10,N,Y,1448315012079,181380,182053
MULIFE.txt,662045,663158,1113,10,N,Y,1448315012079,181380,182053
MULIFE.txt,662282,663359,1077,10,N,N,-,-1,-1
MULIFE.txt,662402,663610,1208,10,N,N,-,-1,-1
MULIFE.txt,662504,663716,1212,10,N,N,-,-1,-1
MULIFE.txt,662531,663801,1270,10,N,N,-,-1,-1
MULIFE.txt,662747,664027,1280,10,N,N,-,-1,-1
MULIFE.txt,662855,664158,1303,10,N,N,-,-1,-1
MULIFE.txt,662930,664308,1378,10,N,N,-,-1,-1
MULIFE.txt,662958,664419,1461,10,N,Y,1448280297446,84055,84972
MULIFE.txt,663022,664485,1463,10,N,Y,1448280297446,84055,84972
MULIFE.txt,663161,664564,1403,10,N,Y,1448280297446,84055,84972
MULIFE.txt,663360,664630,1270,10,N,Y,1448280297446,84055,84972
MULIFE.txt,663613,664861,1248,10,N,Y,1448280297446,84055,84972
MULIFE.txt,663717,665025,1308,10,N,Y,1448280297446,84055,84972
MULIFE.txt,663804,665175,1371,10,N,Y,1448280297446,84055,84972
MULIFE.txt,664028,665248,1220,10,N,Y,1448280297446,84055,84972
MULIFE.txt,664160,665396,1236,10,N,Y,1448280297446,84055,84972
MULIFE.txt,664311,665555,1244,10,N,Y,1448280297446,84055,84972
MULIFE.txt,664422,665759,1337,10,N,Y,1448280297446,84055,84972
MULIFE.txt,664486,665920,1434,10,N,Y,1448280297446,84055,84972
MULIFE.txt,664565,665996,1431,10,N,Y,1448280297446,84055,84972
MULIFE.txt,664631,666063,1432,10,N,Y,1448280297446,84055,84972
MULIFE.txt,664864,666108,1244,10,N,Y,1448280884746,88496,89294
MULIFE.txt,665026,666182,1156,10,N,Y,1448280884746,88496,89294
MULIFE.txt,665176,666206,1030,10,N,Y,1448280884746,88496,89294
MULIFE.txt,665249,666289,1040,10,N,Y,1448280884746,88496,89294
MULIFE.txt,665397,666401,1004,10,N,Y,1448280884746,88496,89294
MULIFE.txt,665558,666492,934,10,N,N,-,-1,-1
MULIFE.txt,665762,666529,767,10,N,N,-,-1,-1
MULIFE.txt,665925,666605,680,10,N,N,-,-1,-1
MULIFE.txt,665999,666677,678,10,N,N,-,-1,-1
MULIFE.txt,666064,666696,632,10,N,N,-,-1,-1
MULIFE.txt,666113,666710,597,10,N,N,-,-1,-1
MULIFE.txt,666183,666769,586,10,N,N,-,-1,-1
MULIFE.txt,666207,666849,642,10,N,N,-,-1,-1
MULIFE.txt,666291,666952,661,10,N,N,-,-1,-1
MULIFE.txt,666402,667076,674,10,N,N,-,-1,-1
MULIFE.txt,666493,667184,691,10,N,N,-,-1,-1
MULIFE.txt,666530,667235,705,10,N,N,-,-1,-1
MULIFE.txt,666606,667362,756,10,N,N,-,-1,-1
MULIFE.txt,666678,667419,741,10,N,N,-,-1,-1
MULIFE.txt,666697,667503,806,10,N,N,-,-1,-1
MULIFE.txt,666711,667528,817,10,N,N,-,-1,-1
MULIFE.txt,666770,667590,820,10,N,N,-,-1,-1
MULIFE.txt,666852,667601,749,10,N,N,-,-1,-1
MULIFE.txt,666953,667619,666,10,N,N,-,-1,-1
MULIFE.txt,667079,667761,682,10,N,N,-,-1,-1
MULIFE.txt,667185,667860,675,10,N,N,-,-1,-1
MULIFE.txt,667236,667939,703,10,N,N,-,-1,-1
MULIFE.txt,667365,668070,705,10,N,N,-,-1,-1
MULIFE.txt,667421,668135,714,10,N,N,-,-1,-1
MULIFE.txt,667504,668191,687,10,N,N,-,-1,-1
MULIFE.txt,667529,668236,707,10,N,N,-,-1,-1
MULIFE.txt,667591,668325,734,10,N,N,-,-1,-1
MULIFE.txt,667602,668423,821,10,N,N,-,-1,-1
MULIFE.txt,667620,668511,891,10,N,N,-,-1,-1
MULIFE.txt,667762,668551,789,10,N,N,-,-1,-1
MULIFE.txt,667861,668678,817,10,N,N,-,-1,-1
MULIFE.txt,667942,668772,830,10,N,N,-,-1,-1
MULIFE.txt,668075,668826,751,10,N,N,-,-1,-1
MULIFE.txt,668136,668921,785,10,N,N,-,-1,-1
MULIFE.txt,668192,668937,745,10,N,N,-,-1,-1
MULIFE.txt,668238,669056,818,10,N,Y,1448322979449,227304,227638
MULIFE.txt,668326,669097,771,10,N,Y,1448322979449,227304,227638
MULIFE.txt,668424,669211,787,10,N,Y,1448322979449,227304,227638
MULIFE.txt,668512,669221,709,10,N,Y,1448322979449,227304,227638
MULIFE.txt,668552,669237,685,10,N,Y,1448322979449,227304,227638
MULIFE.txt,668679,669264,585,10,N,Y,1448322979449,227304,227638
MULIFE.txt,668773,669421,648,10,N,Y,1448322979449,227304,227638
MULIFE.txt,668827,669557,730,10,N,Y,1448322979449,227304,227638
MULIFE.txt,668926,669611,685,10,N,Y,1448322979449,227304,227638
MULIFE.txt,668940,669806,866,10,N,Y,1448322979449,227304,227638
MULIFE.txt,669057,669911,854,10,N,Y,1448322979449,227304,227638
MULIFE.txt,669098,670076,978,10,N,Y,1448322979449,227304,227638
MULIFE.txt,669211,670140,929,10,N,Y,1448322979449,227304,227638
MULIFE.txt,669222,670308,1086,10,N,Y,1448322979449,227304,227638
MULIFE.txt,669238,670339,1101,10,N,Y,1448322979449,227304,227638
MULIFE.txt,669267,670377,1110,10,N,Y,1448322979449,227304,227638
MULIFE.txt,669422,670405,983,10,N,N,-,-1,-1
MULIFE.txt,669558,670410,852,10,N,N,-,-1,-1
MULIFE.txt,669612,670518,906,10,N,N,-,-1,-1
MULIFE.txt,669807,670609,802,10,N,N,-,-1,-1
MULIFE.txt,669912,670638,726,10,N,N,-,-1,-1
MULIFE.txt,670078,670730,652,10,N,N,-,-1,-1
MULIFE.txt,670141,670804,663,10,N,N,-,-1,-1
MULIFE.txt,670313,670837,524,10,N,N,-,-1,-1
MULIFE.txt,670340,671165,825,10,N,N,-,-1,-1
MULIFE.txt,670378,671205,827,10,N,N,-,-1,-1
MULIFE.txt,670406,671235,829,10,N,N,-,-1,-1
MULIFE.txt,670411,671332,921,10,N,N,-,-1,-1
MULIFE.txt,670521,671408,887,10,N,N,-,-1,-1
MULIFE.txt,670610,671577,967,10,N,N,-,-1,-1
MULIFE.txt,670639,671659,1020,10,N,N,-,-1,-1
MULIFE.txt,670731,671744,1013,10,N,N,-,-1,-1
MULIFE.txt,670807,671756,949,10,N,N,-,-1,-1
MULIFE.txt,670838,671798,960,10,N,N,-,-1,-1
MULIFE.txt,671168,671897,729,10,N,N,-,-1,-1
MULIFE.txt,671206,671991,785,10,N,N,-,-1,-1
MULIFE.txt,671236,672070,834,10,N,N,-,-1,-1
MULIFE.txt,671333,672189,856,10,N,N,-,-1,-1
MULIFE.txt,671411,672243,832,10,N,N,-,-1,-1
MULIFE.txt,671580,672277,697,10,N,N,-,-1,-1
MULIFE.txt,671660,672342,682,10,N,N,-,-1,-1
MULIFE.txt,671749,672389,640,10,N,N,-,-1,-1
MULIFE.txt,671759,672404,645,10,N,N,-,-1,-1
MULIFE.txt,671799,672491,692,10,N,N,-,-1,-1
MULIFE.txt,671900,672651,751,10,N,N,-,-1,-1
MULIFE.txt,671992,672679,687,10,N,N,-,-1,-1
MULIFE.txt,672073,672689,616,10,N,N,-,-1,-1
MULIFE.txt,672192,672724,532,10,N,N,-,-1,-1
MULIFE.txt,672244,672742,498,10,N,N,-,-1,-1
MULIFE.txt,672278,672840,562,10,N,N,-,-1,-1
MULIFE.txt,672343,673040,697,10,N,N,-,-1,-1
MULIFE.txt,672390,673062,672,10,N,N,-,-1,-1
MULIFE.txt,672407,673116,709,10,N,N,-,-1,-1
MULIFE.txt,672492,673131,639,10,N,N,-,-1,-1
MULIFE.txt,672652,673191,539,10,N,N,-,-1,-1
MULIFE.txt,672681,673282,601,10,N,N,-,-1,-1
MULIFE.txt,672690,673336,646,10,N,N,-,-1,-1
MULIFE.txt,672725,673534,809,10,N,N,-,-1,-1
MULIFE.txt,672743,673644,901,10,N,N,-,-1,-1
MULIFE.txt,672841,673673,832,10,N,N,-,-1,-1
MULIFE.txt,673041,673722,681,10,N,N,-,-1,-1
MULIFE.txt,673065,673746,681,10,N,N,-,-1,-1
MULIFE.txt,673117,673856,739,10,N,N,-,-1,-1
MULIFE.txt,673134,674057,923,10,N,N,-,-1,-1
MULIFE.txt,673193,674063,870,10,N,N,-,-1,-1
MULIFE.txt,673283,674207,924,10,N,N,-,-1,-1
MULIFE.txt,673337,674388,1051,10,N,N,-,-1,-1
MULIFE.txt,673535,674482,947,10,N,N,-,-1,-1
MULIFE.txt,673645,674638,993,10,N,N,-,-1,-1
MULIFE.txt,673676,674749,1073,10,N,N,-,-1,-1
MULIFE.txt,673723,674855,1132,10,N,N,-,-1,-1
MULIFE.txt,673747,674866,1119,10,N,N,-,-1,-1
MULIFE.txt,673857,674907,1050,10,N,N,-,-1,-1
MULIFE.txt,674060,674994,934,10,N,N,-,-1,-1
MULIFE.txt,674064,675015,951,10,N,N,-,-1,-1
MULIFE.txt,674208,675176,968,10,N,N,-,-1,-1
MULIFE.txt,674391,675275,884,10,N,N,-,-1,-1
MULIFE.txt,674483,675290,807,10,N,N,-,-1,-1
MULIFE.txt,674641,675393,752,10,N,N,-,-1,-1
MULIFE.txt,674752,675450,698,10,N,N,-,-1,-1
MULIFE.txt,674856,675529,673,10,N,N,-,-1,-1
MULIFE.txt,674867,675665,798,10,N,N,-,-1,-1
MULIFE.txt,674908,675674,766,10,N,N,-,-1,-1
MULIFE.txt,674995,675923,928,10,N,N,-,-1,-1
MULIFE.txt,675016,675995,979,10,N,N,-,-1,-1
MULIFE.txt,675177,676050,873,10,N,N,-,-1,-1
MULIFE.txt,675276,676061,785,10,N,N,-,-1,-1
MULIFE.txt,675291,676183,892,10,N,N,-,-1,-1
MULIFE.txt,675394,676201,807,10,N,N,-,-1,-1
MULIFE.txt,675453,676359,906,10,N,N,-,-1,-1
MULIFE.txt,675530,676502,972,10,N,N,-,-1,-1
MULIFE.txt,675666,676519,853,10,N,N,-,-1,-1
MULIFE.txt,675676,676584,908,10,N,N,-,-1,-1
MULIFE.txt,675926,676726,800,10,N,N,-,-1,-1
MULIFE.txt,675996,676829,833,10,N,N,-,-1,-1
MULIFE.txt,676051,676932,881,10,N,N,-,-1,-1
MULIFE.txt,676062,676991,929,10,N,N,-,-1,-1
MULIFE.txt,676184,677017,833,10,N,N,-,-1,-1
MULIFE.txt,676202,677196,994,10,N,N,-,-1,-1
MULIFE.txt,676360,677345,985,10,N,N,-,-1,-1
MULIFE.txt,676503,677421,918,10,N,N,-,-1,-1
MULIFE.txt,676520,677590,1070,10,N,N,-,-1,-1
MULIFE.txt,676585,677655,1070,10,N,N,-,-1,-1
MULIFE.txt,676727,677848,1121,10,N,N,-,-1,-1
MULIFE.txt,676830,677959,1129,10,N,N,-,-1,-1
MULIFE.txt,676935,678015,1080,10,N,N,-,-1,-1
MULIFE.txt,676994,678101,1107,10,N,N,-,-1,-1
MULIFE.txt,677018,678227,1209,10,N,N,-,-1,-1
MULIFE.txt,677199,678432,1233,10,N,N,-,-1,-1
MULIFE.txt,677348,678661,1313,10,N,N,-,-1,-1
MULIFE.txt,677424,678758,1334,10,N,N,-,-1,-1
MULIFE.txt,677592,678798,1206,10,N,N,-,-1,-1
MULIFE.txt,677658,678828,1170,10,N,N,-,-1,-1
MULIFE.txt,677849,678966,1117,10,N,N,-,-1,-1
MULIFE.txt,677960,678988,1028,10,N,N,-,-1,-1
MULIFE.txt,678018,679080,1062,10,N,N,-,-1,-1
MULIFE.txt,678102,679191,1089,10,N,N,-,-1,-1
MULIFE.txt,678230,679394,1164,10,N,N,-,-1,-1
MULIFE.txt,678435,679571,1136,10,N,N,-,-1,-1
MULIFE.txt,678664,679798,1134,10,N,N,-,-1,-1
MULIFE.txt,678759,679901,1142,10,N,N,-,-1,-1
MULIFE.txt,678799,680019,1220,10,N,N,-,-1,-1
MULIFE.txt,678829,680069,1240,10,N,N,-,-1,-1
MULIFE.txt,678967,680188,1221,10,N,N,-,-1,-1
MULIFE.txt,678991,680201,1210,10,N,N,-,-1,-1
MULIFE.txt,679081,680357,1276,10,N,N,-,-1,-1
MULIFE.txt,679192,680551,1359,10,N,N,-,-1,-1
MULIFE.txt,679397,680735,1338,10,N,N,-,-1,-1
MULIFE.txt,679574,680798,1224,10,N,N,-,-1,-1
MULIFE.txt,679800,680958,1158,10,N,N,-,-1,-1
MULIFE.txt,679904,681080,1176,10,N,N,-,-1,-1
MULIFE.txt,680020,681090,1070,10,N,N,-,-1,-1
MULIFE.txt,680072,681170,1098,10,N,N,-,-1,-1
MULIFE.txt,680191,681399,1208,10,N,N,-,-1,-1
MULIFE.txt,680202,681554,1352,10,N,N,-,-1,-1
MULIFE.txt,680360,681574,1214,10,N,N,-,-1,-1
MULIFE.txt,680554,681723,1169,10,N,N,-,-1,-1
MULIFE.txt,680736,681757,1021,10,N,N,-,-1,-1
MULIFE.txt,680799,681857,1058,10,N,N,-,-1,-1
MULIFE.txt,680961,681920,959,10,N,N,-,-1,-1
MULIFE.txt,681081,681996,915,10,N,N,-,-1,-1
MULIFE.txt,681091,682275,1184,10,N,N,-,-1,-1
MULIFE.txt,681171,682368,1197,10,N,N,-,-1,-1
MULIFE.txt,681400,682399,999,10,N,N,-,-1,-1
MULIFE.txt,681555,682411,856,10,N,N,-,-1,-1
MULIFE.txt,681575,682425,850,10,N,N,-,-1,-1
MULIFE.txt,681726,682445,719,10,N,N,-,-1,-1
MULIFE.txt,681758,682593,835,10,N,N,-,-1,-1
MULIFE.txt,681858,682606,748,10,N,N,-,-1,-1
MULIFE.txt,681921,682619,698,10,N,N,-,-1,-1
MULIFE.txt,681997,682648,651,10,N,N,-,-1,-1
MULIFE.txt,682278,682665,387,10,N,N,-,-1,-1
MULIFE.txt,682369,682799,430,10,N,N,-,-1,-1
MULIFE.txt,682400,682904,504,10,N,N,-,-1,-1
MULIFE.txt,682412,682933,521,10,N,N,-,-1,-1
MULIFE.txt,682426,682980,554,10,N,N,-,-1,-1
MULIFE.txt,682446,683031,585,10,N,N,-,-1,-1
MULIFE.txt,682594,683108,514,10,N,N,-,-1,-1
MULIFE.txt,682607,683289,682,10,N,N,-,-1,-1
MULIFE.txt,682620,683533,913,10,N,N,-,-1,-1
MULIFE.txt,682651,683897,1246,10,N,N,-,-1,-1
MULIFE.txt,682666,683946,1280,10,N,N,-,-1,-1
MULIFE.txt,682800,684108,1308,10,N,N,-,-1,-1
MULIFE.txt,682907,684117,1210,10,N,N,-,-1,-1
MULIFE.txt,682934,684185,1251,10,N,N,-,-1,-1
MULIFE.txt,682981,684191,1210,10,N,N,-,-1,-1
MULIFE.txt,683032,684253,1221,10,N,N,-,-1,-1
MULIFE.txt,683111,684306,1195,10,N,N,-,-1,-1
MULIFE.txt,683292,684342,1050,10,N,N,-,-1,-1
MULIFE.txt,683536,684525,989,10,N,N,-,-1,-1
MULIFE.txt,683902,684581,679,10,N,N,-,-1,-1
MULIFE.txt,683949,684738,789,10,N,N,-,-1,-1
MULIFE.txt,684109,684770,661,10,N,N,-,-1,-1
MULIFE.txt,684120,684942,822,10,N,N,-,-1,-1
MULIFE.txt,684186,685060,874,10,N,N,-,-1,-1
MULIFE.txt,684192,685107,915,10,N,N,-,-1,-1
MULIFE.txt,684254,685228,974,10,N,N,-,-1,-1
MULIFE.txt,684308,685345,1037,10,N,N,-,-1,-1
MULIFE.txt,684343,685568,1225,10,N,N,-,-1,-1
MULIFE.txt,684526,685684,1158,10,N,N,-,-1,-1
MULIFE.txt,684582,685752,1170,10,N,N,-,-1,-1
MULIFE.txt,684741,685801,1060,10,N,N,-,-1,-1
MULIFE.txt,684773,685857,1084,10,N,N,-,-1,-1
MULIFE.txt,684944,685900,956,10,N,N,-,-1,-1
MULIFE.txt,685061,686224,1163,10,N,N,-,-1,-1
MULIFE.txt,685109,686278,1169,10,N,N,-,-1,-1
MULIFE.txt,685231,686788,1557,10,N,N,-,-1,-1
MULIFE.txt,685347,687000,1653,10,N,N,-,-1,-1
MULIFE.txt,685571,687334,1763,10,N,N,-,-1,-1
MULIFE.txt,685685,687392,1707,10,N,N,-,-1,-1
MULIFE.txt,685753,687445,1692,10,N,N,-,-1,-1
MULIFE.txt,685802,687613,1811,10,N,N,-,-1,-1
MULIFE.txt,685858,687742,1884,10,N,N,-,-1,-1
MULIFE.txt,685902,687819,1917,10,N,N,-,-1,-1
MULIFE.txt,686225,687936,1711,10,N,N,-,-1,-1
MULIFE.txt,686279,688064,1785,10,N,N,-,-1,-1
MULIFE.txt,686789,688072,1283,10,N,N,-,-1,-1
MULIFE.txt,687001,688083,1082,10,N,N,-,-1,-1
MULIFE.txt,687335,688104,769,10,N,N,-,-1,-1
MULIFE.txt,687393,688171,778,10,N,N,-,-1,-1
MULIFE.txt,687448,688235,787,10,N,N,-,-1,-1
MULIFE.txt,687614,688343,729,10,N,N,-,-1,-1
MULIFE.txt,687743,688713,970,10,N,N,-,-1,-1
MULIFE.txt,687822,688848,1026,10,N,N,-,-1,-1
MULIFE.txt,687937,688861,924,10,N,N,-,-1,-1
MULIFE.txt,688069,688970,901,10,N,N,-,-1,-1
MULIFE.txt,688074,689301,1227,10,N,N,-,-1,-1
MULIFE.txt,688086,689512,1426,10,N,N,-,-1,-1
MULIFE.txt,688105,689857,1752,10,N,N,-,-1,-1
MULIFE.txt,688172,689874,1702,10,N,N,-,-1,-1
MULIFE.txt,688236,689984,1748,10,N,N,-,-1,-1
MULIFE.txt,688344,690212,1868,10,N,N,-,-1,-1
MULIFE.txt,688716,690230,1514,10,N,N,-,-1,-1
MULIFE.txt,688849,690363,1514,10,N,N,-,-1,-1
MULIFE.txt,688862,690458,1596,10,N,N,-,-1,-1
MULIFE.txt,688973,690505,1532,10,N,N,-,-1,-1
MULIFE.txt,689304,690641,1337,10,N,N,-,-1,-1
MULIFE.txt,689513,690942,1429,10,N,N,-,-1,-1
MULIFE.txt,689858,691004,1146,10,N,N,-,-1,-1
MULIFE.txt,689875,691183,1308,10,N,N,-,-1,-1
MULIFE.txt,689985,691380,1395,10,N,N,-,-1,-1
MULIFE.txt,690217,691433,1216,10,N,N,-,-1,-1
MULIFE.txt,690233,691621,1388,10,N,N,-,-1,-1
MULIFE.txt,690364,691635,1271,10,N,N,-,-1,-1
MULIFE.txt,690461,691657,1196,10,N,N,-,-1,-1
MULIFE.txt,690507,691845,1338,10,N,N,-,-1,-1
MULIFE.txt,690642,691887,1245,10,N,N,-,-1,-1
MULIFE.txt,690945,692293,1348,10,N,N,-,-1,-1
MULIFE.txt,691007,692594,1587,10,N,N,-,-1,-1
MULIFE.txt,691186,692623,1437,10,N,N,-,-1,-1
MULIFE.txt,691381,692761,1380,10,N,N,-,-1,-1
MULIFE.txt,691436,692862,1426,10,N,N,-,-1,-1
MULIFE.txt,691626,692994,1368,10,N,N,-,-1,-1
MULIFE.txt,691636,693119,1483,10,N,N,-,-1,-1
MULIFE.txt,691658,693178,1520,10,N,N,-,-1,-1
MULIFE.txt,691846,693201,1355,10,N,N,-,-1,-1
MULIFE.txt,691890,693239,1349,10,N,Y,1448279620157,70041,71486
MULIFE.txt,692295,693366,1071,10,N,Y,1448279620157,70041,71486
MULIFE.txt,692597,693435,838,10,N,Y,1448279620157,70041,71486
MULIFE.txt,692624,693446,822,10,N,Y,1448279620157,70041,71486
MULIFE.txt,692764,693450,686,10,N,Y,1448279620157,70041,71486
MULIFE.txt,692863,693452,589,10,N,Y,1448279620157,70041,71486
MULIFE.txt,692995,693502,507,10,N,Y,1448279620157,70041,71486
MULIFE.txt,693122,693570,448,10,N,Y,1448279620157,70041,71486
MULIFE.txt,693180,693763,583,10,N,Y,1448279620157,70041,71486
MULIFE.txt,693206,693841,635,10,N,Y,1448279620157,70041,71486
MULIFE.txt,693240,693907,667,10,N,Y,1448279620157,70041,71486
MULIFE.txt,693369,693983,614,10,N,Y,1448279620157,70041,71486
MULIFE.txt,693436,694058,622,10,N,Y,1448279620157,70041,71486
MULIFE.txt,693447,694067,620,10,N,Y,1448279620157,70041,71486
MULIFE.txt,693451,694166,715,10,N,Y,1448279620157,70041,71486
MULIFE.txt,693455,694231,776,10,N,Y,1448279620157,70041,71486
MULIFE.txt,693504,694267,763,10,N,Y,1448279620157,70041,71486
MULIFE.txt,693571,694415,844,10,N,Y,1448279620157,70041,71486
MULIFE.txt,693764,694519,755,10,N,Y,1448279620157,70041,71486
MULIFE.txt,693842,694563,721,10,N,Y,1448279620157,70041,71486
MULIFE.txt,693908,694728,820,10,N,Y,1448279620157,70041,71486
MULIFE.txt,693984,694822,838,10,N,Y,1448279620157,70041,71486
MULIFE.txt,694061,695143,1082,10,N,Y,1448280673594,87462,88501
MULIFE.txt,694070,695154,1084,10,N,Y,1448280673594,87462,88501
MULIFE.txt,694167,695202,1035,10,N,Y,1448280673594,87462,88501
MULIFE.txt,694234,695242,1008,10,N,Y,1448280673594,87462,88501
MULIFE.txt,694268,695281,1013,10,N,Y,1448280673594,87462,88501
MULIFE.txt,694416,695399,983,10,N,Y,1448280673594,87462,88501
MULIFE.txt,694520,695430,910,10,N,Y,1448280673594,87462,88501
MULIFE.txt,694566,695519,953,10,N,Y,1448280673594,87462,88501
MULIFE.txt,694729,695659,930,10,N,Y,1448280673594,87462,88501
MULIFE.txt,694823,695760,937,10,N,Y,1448280673594,87462,88501
MULIFE.txt,695144,695849,705,10,N,Y,1448280673594,87462,88501
MULIFE.txt,695155,695867,712,10,N,Y,1448280673594,87462,88501
MULIFE.txt,695205,695934,729,10,N,N,-,-1,-1
MULIFE.txt,695243,696052,809,10,N,N,-,-1,-1
MULIFE.txt,695282,696124,842,10,N,N,-,-1,-1
MULIFE.txt,695400,696153,753,10,N,N,-,-1,-1
MULIFE.txt,695433,696181,748,10,N,N,-,-1,-1
MULIFE.txt,695520,696429,909,10,N,N,-,-1,-1
MULIFE.txt,695660,696468,808,10,N,N,-,-1,-1
MULIFE.txt,695761,696751,990,10,N,N,-,-1,-1
MULIFE.txt,695854,696815,961,10,N,N,-,-1,-1
MULIFE.txt,695870,697074,1204,10,N,N,-,-1,-1
MULIFE.txt,695935,697329,1394,10,N,N,-,-1,-1
MULIFE.txt,696053,697403,1350,10,N,N,-,-1,-1
MULIFE.txt,696125,697484,1359,10,N,N,-,-1,-1
MULIFE.txt,696154,697549,1395,10,N,N,-,-1,-1
MULIFE.txt,696183,697567,1384,10,N,N,-,-1,-1
MULIFE.txt,696430,697706,1276,10,N,N,-,-1,-1
MULIFE.txt,696469,697886,1417,10,N,N,-,-1,-1
MULIFE.txt,696754,697952,1198,10,N,N,-,-1,-1
MULIFE.txt,696816,698218,1402,10,N,N,-,-1,-1
MULIFE.txt,697077,698237,1160,10,N,N,-,-1,-1
MULIFE.txt,697330,698440,1110,10,N,N,-,-1,-1
MULIFE.txt,697406,698516,1110,10,N,N,-,-1,-1
MULIFE.txt,697485,698755,1270,10,N,N,-,-1,-1
MULIFE.txt,697550,698823,1273,10,N,N,-,-1,-1
MULIFE.txt,697570,698921,1351,10,N,N,-,-1,-1
MULIFE.txt,697707,699141,1434,10,N,N,-,-1,-1
MULIFE.txt,697888,699236,1348,10,N,N,-,-1,-1
MULIFE.txt,697955,699360,1405,10,N,N,-,-1,-1
MULIFE.txt,698219,699558,1339,10,N,N,-,-1,-1
MULIFE.txt,698240,699641,1401,10,N,N,-,-1,-1
MULIFE.txt,698443,699922,1479,10,N,N,-,-1,-1
MULIFE.txt,698519,700105,1586,10,N,N,-,-1,-1
MULIFE.txt,698758,700347,1589,10,N,N,-,-1,-1
MULIFE.txt,698824,700415,1591,10,N,N,-,-1,-1
MULIFE.txt,698922,700444,1522,10,N,N,-,-1,-1
MULIFE.txt,699142,700505,1363,10,N,N,-,-1,-1
MULIFE.txt,699237,700568,1331,10,N,N,-,-1,-1
MULIFE.txt,699361,700814,1453,10,N,N,-,-1,-1
MULIFE.txt,699561,700848,1287,10,N,N,-,-1,-1
MULIFE.txt,699642,700984,1342,10,N,N,-,-1,-1
MULIFE.txt,699923,701009,1086,10,N,N,-,-1,-1
MULIFE.txt,700107,701057,950,10,N,N,-,-1,-1
MULIFE.txt,700350,701063,713,10,N,N,-,-1,-1
MULIFE.txt,700416,701117,701,10,N,N,-,-1,-1
MULIFE.txt,700445,701152,707,10,N,N,-,-1,-1
MULIFE.txt,700506,701184,678,10,N,N,-,-1,-1
MULIFE.txt,700569,701244,675,10,N,N,-,-1,-1
MULIFE.txt,700817,701262,445,10,N,N,-,-1,-1
MULIFE.txt,700849,701285,436,10,N,N,-,-1,-1
MULIFE.txt,700987,701301,314,10,N,N,-,-1,-1
MULIFE.txt,701010,701336,326,10,N,N,-,-1,-1
MULIFE.txt,701062,701453,391,10,N,N,-,-1,-1
MULIFE.txt,701063,701492,429,10,N,N,-,-1,-1
MULIFE.txt,701118,701738,620,10,N,N,-,-1,-1
MULIFE.txt,701153,701787,634,10,N,N,-,-1,-1
MULIFE.txt,701186,701840,654,10,N,N,-,-1,-1
MULIFE.txt,701249,701919,670,10,N,N,-,-1,-1
MULIFE.txt,701265,701959,694,10,N,Y,1448322273366,219239,219544
MULIFE.txt,701286,702082,796,10,N,Y,1448322273366,219239,219544
MULIFE.txt,701302,702173,871,10,N,Y,1448322273366,219239,219544
MULIFE.txt,701337,702282,945,10,N,Y,1448322273366,219239,219544
MULIFE.txt,701456,702317,861,10,N,Y,1448322273366,219239,219544
MULIFE.txt,701493,702382,889,10,N,Y,1448322273366,219239,219544
MULIFE.txt,701743,702425,682,10,N,Y,1448322273366,219239,219544
MULIFE.txt,701788,702484,696,10,N,Y,1448322273366,219239,219544
MULIFE.txt,701841,702580,739,10,N,Y,1448322273366,219239,219544
MULIFE.txt,701924,702640,716,10,N,Y,1448322273366,219239,219544
MULIFE.txt,701960,702786,826,10,N,Y,1448322273366,219239,219544
MULIFE.txt,702083,703040,957,10,N,Y,1448322273366,219239,219544
MULIFE.txt,702174,703082,908,10,N,Y,1448322273366,219239,219544
MULIFE.txt,702283,703132,849,10,N,Y,1448322273366,219239,219544
MULIFE.txt,702318,703169,851,10,N,Y,1448322273366,219239,219544
MULIFE.txt,702384,703263,879,10,N,Y,1448322273366,219239,219544
MULIFE.txt,702426,703555,1129,10,N,Y,1448322273366,219239,219544
MULIFE.txt,702485,703908,1423,10,N,Y,1448322273366,219239,219544
MULIFE.txt,702581,704021,1440,10,N,Y,1448322273366,219239,219544
MULIFE.txt,702641,704097,1456,10,N,Y,1448322273366,219239,219544
MULIFE.txt,702787,704163,1376,10,N,Y,1448322273366,219239,219544
MULIFE.txt,703041,704209,1168,10,N,Y,1448322273366,219239,219544
MULIFE.txt,703083,704300,1217,10,N,Y,1448322273366,219239,219544
MULIFE.txt,703133,704422,1289,10,N,N,-,-1,-1
MULIFE.txt,703172,704639,1467,10,N,N,-,-1,-1
MULIFE.txt,703264,704693,1429,10,N,N,-,-1,-1
MULIFE.txt,703558,704904,1346,10,N,N,-,-1,-1
MULIFE.txt,703910,704969,1059,10,N,N,-,-1,-1
MULIFE.txt,704024,705231,1207,10,N,N,-,-1,-1
MULIFE.txt,704100,705320,1220,10,N,N,-,-1,-1
MULIFE.txt,704164,705405,1241,10,N,N,-,-1,-1
MULIFE.txt,704211,705596,1385,10,N,N,-,-1,-1
MULIFE.txt,704303,705618,1315,10,N,N,-,-1,-1
MULIFE.txt,704425,705799,1374,10,N,N,-,-1,-1
MULIFE.txt,704640,705962,1322,10,N,N,-,-1,-1
MULIFE.txt,704694,705964,1270,10,N,N,-,-1,-1
MULIFE.txt,704907,706019,1112,10,N,N,-,-1,-1
MULIFE.txt,704970,706038,1068,10,N,N,-,-1,-1
MULIFE.txt,705232,706206,974,10,N,N,-,-1,-1
MULIFE.txt,705322,706373,1051,10,N,N,-,-1,-1
MULIFE.txt,705406,706696,1290,10,N,N,-,-1,-1
MULIFE.txt,705601,706782,1181,10,N,N,-,-1,-1
MULIFE.txt,705619,706889,1270,10,N,N,-,-1,-1
MULIFE.txt,705802,706958,1156,10,N,N,-,-1,-1
MULIFE.txt,705963,706983,1020,10,N,N,-,-1,-1
MULIFE.txt,705965,707103,1138,10,N,N,-,-1,-1
MULIFE.txt,706020,707181,1161,10,N,N,-,-1,-1
MULIFE.txt,706041,707360,1319,10,N,N,-,-1,-1
MULIFE.txt,706209,707520,1311,10,N,N,-,-1,-1
MULIFE.txt,706376,707610,1234,10,N,N,-,-1,-1
MULIFE.txt,706697,707846,1149,10,N,Y,1448277582432,52552,54595
MULIFE.txt,706783,707936,1153,10,N,Y,1448277582432,52552,54595
MULIFE.txt,706890,708037,1147,10,N,Y,1448277582432,52552,54595
MULIFE.txt,706961,708118,1157,10,N,Y,1448277582432,52552,54595
MULIFE.txt,706984,708225,1241,10,N,Y,1448277582432,52552,54595
MULIFE.txt,707106,708339,1233,10,N,Y,1448277582432,52552,54595
MULIFE.txt,707182,708373,1191,10,N,Y,1448277582432,52552,54595
MULIFE.txt,707363,708493,1130,10,N,Y,1448277582432,52552,54595
MULIFE.txt,707523,708537,1014,10,N,Y,1448277582432,52552,54595
MULIFE.txt,707613,708576,963,10,N,Y,1448277582432,52552,54595
MULIFE.txt,707847,708599,752,10,N,Y,1448277582432,52552,54595
MULIFE.txt,707937,708728,791,10,N,Y,1448277582432,52552,54595
MULIFE.txt,708038,708793,755,10,N,Y,1448277582432,52552,54595
MULIFE.txt,708119,708860,741,10,N,Y,1448277582432,52552,54595
MULIFE.txt,708226,708966,740,10,N,Y,1448277582432,52552,54595
MULIFE.txt,708342,709049,707,10,N,N,-,-1,-1
MULIFE.txt,708374,709066,692,10,N,N,-,-1,-1
MULIFE.txt,708495,709319,824,10,N,N,-,-1,-1
MULIFE.txt,708540,709425,885,10,N,N,-,-1,-1
MULIFE.txt,708577,709460,883,10,N,N,-,-1,-1
MULIFE.txt,708601,709537,936,10,N,N,-,-1,-1
MULIFE.txt,708729,709571,842,10,N,N,-,-1,-1
MULIFE.txt,708796,709836,1040,10,N,N,-,-1,-1
MULIFE.txt,708861,709900,1039,10,N,N,-,-1,-1
MULIFE.txt,708969,709963,994,10,N,N,-,-1,-1
MULIFE.txt,709050,710002,952,10,N,N,-,-1,-1
MULIFE.txt,709067,710154,1087,10,N,N,-,-1,-1
MULIFE.txt,709322,710366,1044,10,N,N,-,-1,-1
MULIFE.txt,709428,710510,1082,10,N,N,-,-1,-1
MULIFE.txt,709461,710641,1180,10,N,N,-,-1,-1
MULIFE.txt,709538,710651,1113,10,N,N,-,-1,-1
MULIFE.txt,709574,710689,1115,10,N,N,-,-1,-1
MULIFE.txt,709841,710792,951,10,N,N,-,-1,-1
MULIFE.txt,709901,710979,1078,10,N,N,-,-1,-1
MULIFE.txt,709966,710981,1015,10,N,N,-,-1,-1
MULIFE.txt,710003,710987,984,10,N,N,-,-1,-1
MULIFE.txt,710157,710989,832,10,N,N,-,-1,-1
MULIFE.txt,710369,711073,704,10,N,N,-,-1,-1
MULIFE.txt,710513,711199,686,10,N,N,-,-1,-1
MULIFE.txt,710644,711310,666,10,N,N,-,-1,-1
MULIFE.txt,710654,711391,737,10,N,N,-,-1,-1
MULIFE.txt,710690,711488,798,10,N,N,-,-1,-1
MULIFE.txt,710793,711588,795,10,N,N,-,-1,-1
MULIFE.txt,710980,711716,736,10,N,N,-,-1,-1
MULIFE.txt,710982,711728,746,10,N,N,-,-1,-1
MULIFE.txt,710988,711875,887,10,N,N,-,-1,-1
MULIFE.txt,710990,712006,1016,10,N,N,-,-1,-1
MULIFE.txt,711076,712195,1119,10,N,N,-,-1,-1
MULIFE.txt,711200,712271,1071,10,N,N,-,-1,-1
MULIFE.txt,711315,712328,1013,10,N,N,-,-1,-1
MULIFE.txt,711392,712521,1129,10,N,N,-,-1,-1
MULIFE.txt,711491,712617,1126,10,N,N,-,-1,-1
MULIFE.txt,711589,712857,1268,10,N,N,-,-1,-1
MULIFE.txt,711719,712955,1236,10,N,N,-,-1,-1
MULIFE.txt,711729,713311,1582,10,N,N,-,-1,-1
MULIFE.txt,711876,713423,1547,10,N,N,-,-1,-1
MULIFE.txt,712008,713635,1627,10,N,N,-,-1,-1
MULIFE.txt,712198,713715,1517,10,N,N,-,-1,-1
MULIFE.txt,712274,713728,1454,10,N,N,-,-1,-1
MULIFE.txt,712330,713900,1570,10,N,N,-,-1,-1
MULIFE.txt,712524,714268,1744,10,N,N,-,-1,-1
MULIFE.txt,712618,714388,1770,10,N,N,-,-1,-1
MULIFE.txt,712860,714503,1643,10,N,N,-,-1,-1
MULIFE.txt,712956,714781,1825,10,N,N,-,-1,-1
MULIFE.txt,713314,714871,1557,10,N,N,-,-1,-1
MULIFE.txt,713424,714933,1509,10,N,N,-,-1,-1
MULIFE.txt,713638,714971,1333,10,N,N,-,-1,-1
MULIFE.txt,713716,715003,1287,10,N,N,-,-1,-1
MULIFE.txt,713729,715056,1327,10,N,N,-,-1,-1
MULIFE.txt,713901,715118,1217,10,N,N,-,-1,-1
MULIFE.txt,714271,715221,950,10,N,N,-,-1,-1
MULIFE.txt,714389,715356,967,10,N,N,-,-1,-1
MULIFE.txt,714504,715440,936,10,N,N,-,-1,-1
MULIFE.txt,714782,715608,826,10,N,N,-,-1,-1
MULIFE.txt,714872,715625,753,10,N,N,-,-1,-1
MULIFE.txt,714934,715668,734,10,N,N,-,-1,-1
MULIFE.txt,714973,715730,757,10,N,N,-,-1,-1
MULIFE.txt,715004,715802,798,10,N,N,-,-1,-1
MULIFE.txt,715057,716045,988,10,N,N,-,-1,-1
MULIFE.txt,715119,716170,1051,10,N,N,-,-1,-1
MULIFE.txt,715224,716244,1020,10,N,N,-,-1,-1
MULIFE.txt,715357,716370,1013,10,N,N,-,-1,-1
MULIFE.txt,715441,716412,971,10,N,N,-,-1,-1
MULIFE.txt,715609,716768,1159,10,N,N,-,-1,-1
MULIFE.txt,715626,716916,1290,10,N,N,-,-1,-1
MULIFE.txt,715669,716993,1324,10,N,N,-,-1,-1
MULIFE.txt,715732,717093,1361,10,N,N,-,-1,-1
MULIFE.txt,715803,717299,1496,10,N,N,-,-1,-1
MULIFE.txt,716048,717579,1531,10,N,N,-,-1,-1
MULIFE.txt,716171,717657,1486,10,N,N,-,-1,-1
MULIFE.txt,716245,717791,1546,10,N,N,-,-1,-1
MULIFE.txt,716371,717958,1587,10,N,N,-,-1,-1
MULIFE.txt,716413,718037,1624,10,N,N,-,-1,-1
MULIFE.txt,716769,718116,1347,10,N,N,-,-1,-1
MULIFE.txt,716917,718128,1211,10,N,N,-,-1,-1
MULIFE.txt,716996,718222,1226,10,N,N,-,-1,-1
MULIFE.txt,717094,718317,1223,10,N,N,-,-1,-1
MULIFE.txt,717300,718563,1263,10,N,N,-,-1,-1
MULIFE.txt,717580,718740,1160,10,N,N,-,-1,-1
MULIFE.txt,717660,718827,1167,10,N,Y,1448278147591,54631,55869
MULIFE.txt,717794,718888,1094,10,N,Y,1448278147591,54631,55869
MULIFE.txt,717959,718964,1005,10,N,Y,1448278147591,54631,55869
MULIFE.txt,718038,719079,1041,10,N,Y,1448278147591,54631,55869
MULIFE.txt,718117,719300,1183,10,N,Y,1448278147591,54631,55869
MULIFE.txt,718129,719456,1327,10,N,Y,1448278147591,54631,55869
MULIFE.txt,718225,719579,1354,10,N,Y,1448278147591,54631,55869
MULIFE.txt,718320,719664,1344,10,N,Y,1448278147591,54631,55869
MULIFE.txt,718564,719842,1278,10,N,Y,1448278147591,54631,55869
MULIFE.txt,718743,719904,1161,10,N,Y,1448278147591,54631,55869
MULIFE.txt,718828,719960,1132,10,N,Y,1448038803075,18895,19670
MULIFE.txt,718889,720447,1558,10,N,Y,1448038803075,18895,19670
MULIFE.txt,718965,720493,1528,10,N,Y,1448038803075,18895,19670
MULIFE.txt,719080,720509,1429,10,N,Y,1448038803075,18895,19670
MULIFE.txt,719303,720536,1233,10,N,Y,1448038803075,18895,19670
MULIFE.txt,719457,720770,1313,10,N,Y,1448038803075,18895,19670
MULIFE.txt,719582,720781,1199,10,N,Y,1448038803075,18895,19670
MULIFE.txt,719665,720870,1205,10,N,Y,1448038803075,18895,19670
MULIFE.txt,719845,720960,1115,10,N,Y,1448038803075,18895,19670
MULIFE.txt,719907,720974,1067,10,N,Y,1448038803075,18895,19670
MULIFE.txt,719962,720976,1014,10,N,Y,1448038803075,18895,19670
MULIFE.txt,720448,721104,656,10,N,Y,1448038803075,18895,19670
MULIFE.txt,720494,721148,654,10,N,Y,1448038803075,18895,19670
MULIFE.txt,720510,721295,785,10,N,Y,1448038803075,18895,19670
MULIFE.txt,720539,721377,838,10,N,Y,1448038803075,18895,19670
MULIFE.txt,720773,721452,679,10,N,N,-,-1,-1
MULIFE.txt,720784,721533,749,10,N,N,-,-1,-1
MULIFE.txt,720871,721642,771,10,N,N,-,-1,-1
MULIFE.txt,720961,721865,904,10,N,N,-,-1,-1
MULIFE.txt,720975,722014,1039,10,N,N,-,-1,-1
MULIFE.txt,720979,722040,1061,10,N,N,-,-1,-1
MULIFE.txt,721107,722117,1010,10,N,N,-,-1,-1
MULIFE.txt,721149,722233,1084,10,N,N,-,-1,-1
MULIFE.txt,721298,722281,983,10,N,N,-,-1,-1
MULIFE.txt,721380,722315,935,10,N,N,-,-1,-1
MULIFE.txt,721453,722439,986,10,N,N,-,-1,-1
MULIFE.txt,721534,722461,927,10,N,N,-,-1,-1
MULIFE.txt,721643,722479,836,10,N,N,-,-1,-1
MULIFE.txt,721868,722491,623,10,N,N,-,-1,-1
MULIFE.txt,722015,722621,606,10,N,N,-,-1,-1
MULIFE.txt,722043,722706,663,10,N,N,-,-1,-1
MULIFE.txt,722118,722810,692,10,N,N,-,-1,-1
MULIFE.txt,722234,722916,682,10,N,N,-,-1,-1
MULIFE.txt,722282,722943,661,10,N,N,-,-1,-1
MULIFE.txt,722317,723100,783,10,N,N,-,-1,-1
MULIFE.txt,722444,723245,801,10,N,N,-,-1,-1
MULIFE.txt,722462,723326,864,10,N,N,-,-1,-1
MULIFE.txt,722480,723529,1049,10,N,N,-,-1,-1
MULIFE.txt,722492,723634,1142,10,N,N,-,-1,-1
MULIFE.txt,722622,723687,1065,10,N,N,-,-1,-1
MULIFE.txt,722708,723777,1069,10,N,N,-,-1,-1
MULIFE.txt,722813,723909,1096,10,N,N,-,-1,-1
MULIFE.txt,722917,724005,1088,10,N,N,-,-1,-1
MULIFE.txt,722944,724160,1216,10,N,N,-,-1,-1
MULIFE.txt,723101,724234,1133,10,N,N,-,-1,-1
MULIFE.txt,723246,724408,1162,10,N,N,-,-1,-1
MULIFE.txt,723329,724600,1271,10,N,N,-,-1,-1
MULIFE.txt,723530,724706,1176,10,N,N,-,-1,-1
MULIFE.txt,723635,724772,1137,10,N,N,-,-1,-1
MULIFE.txt,723688,725003,1315,10,N,N,-,-1,-1
MULIFE.txt,723780,725190,1410,10,N,N,-,-1,-1
MULIFE.txt,723912,725341,1429,10,N,N,-,-1,-1
MULIFE.txt,724008,725386,1378,10,N,N,-,-1,-1
MULIFE.txt,724161,725560,1399,10,N,N,-,-1,-1
MULIFE.txt,724237,725599,1362,10,N,N,-,-1,-1
MULIFE.txt,724411,725663,1252,10,N,N,-,-1,-1
MULIFE.txt,724601,725976,1375,10,N,N,-,-1,-1
MULIFE.txt,724708,726144,1436,10,N,N,-,-1,-1
MULIFE.txt,724773,726258,1485,10,N,N,-,-1,-1
MULIFE.txt,725005,726425,1420,10,N,N,-,-1,-1
MULIFE.txt,725195,726744,1549,10,N,N,-,-1,-1
MULIFE.txt,725342,726822,1480,10,N,N,-,-1,-1
MULIFE.txt,725387,726922,1535,10,N,N,-,-1,-1
MULIFE.txt,725563,726924,1361,10,N,N,-,-1,-1
MULIFE.txt,725600,727023,1423,10,N,N,-,-1,-1
MULIFE.txt,725664,727259,1595,10,N,N,-,-1,-1
MULIFE.txt,725979,727330,1351,10,N,N,-,-1,-1
MULIFE.txt,726147,727422,1275,10,N,N,-,-1,-1
MULIFE.txt,726261,727578,1317,10,N,N,-,-1,-1
MULIFE.txt,726426,727893,1467,10,N,N,-,-1,-1
MULIFE.txt,726747,727983,1236,10,N,N,-,-1,-1
MULIFE.txt,726825,728086,1261,10,N,N,-,-1,-1
MULIFE.txt,726923,728135,1212,10,N,N,-,-1,-1
MULIFE.txt,726927,728336,1409,10,N,N,-,-1,-1
MULIFE.txt,727024,728664,1640,10,N,N,-,-1,-1
MULIFE.txt,727260,728760,1500,10,N,N,-,-1,-1
MULIFE.txt,727331,729044,1713,10,N,N,-,-1,-1
MULIFE.txt,727423,729216,1793,10,N,N,-,-1,-1
MULIFE.txt,727579,729273,1694,10,N,N,-,-1,-1
MULIFE.txt,727894,729405,1511,10,N,N,-,-1,-1
MULIFE.txt,727984,729489,1505,10,N,N,-,-1,-1
MULIFE.txt,728088,729520,1432,10,N,N,-,-1,-1
MULIFE.txt,728136,729677,1541,10,N,N,-,-1,-1
MULIFE.txt,728339,729733,1394,10,N,N,-,-1,-1
MULIFE.txt,728667,729975,1308,10,N,N,-,-1,-1
MULIFE.txt,728763,730146,1383,10,N,N,-,-1,-1
MULIFE.txt,729047,730236,1189,10,N,N,-,-1,-1
MULIFE.txt,729218,730258,1040,10,N,N,-,-1,-1
MULIFE.txt,729276,730300,1024,10,N,N,-,-1,-1
MULIFE.txt,729406,730326,920,10,N,N,-,-1,-1
MULIFE.txt,729490,730492,1002,10,N,N,-,-1,-1
MULIFE.txt,729523,730827,1304,10,N,N,-,-1,-1
MULIFE.txt,729680,731172,1492,10,N,N,-,-1,-1
MULIFE.txt,729735,731223,1488,10,N,N,-,-1,-1
MULIFE.txt,729976,731267,1291,10,N,N,-,-1,-1
MULIFE.txt,730147,731331,1184,10,N,N,-,-1,-1
MULIFE.txt,730241,731583,1342,10,N,N,-,-1,-1
MULIFE.txt,730259,731655,1396,10,N,N,-,-1,-1
MULIFE.txt,730303,731782,1479,10,N,N,-,-1,-1
MULIFE.txt,730329,731871,1542,10,N,N,-,-1,-1
MULIFE.txt,730495,731998,1503,10,N,N,-,-1,-1
MULIFE.txt,730829,732108,1279,10,N,N,-,-1,-1
MULIFE.txt,731173,732165,992,10,N,N,-,-1,-1
MULIFE.txt,731224,732230,1006,10,N,N,-,-1,-1
MULIFE.txt,731268,732505,1237,10,N,N,-,-1,-1
MULIFE.txt,731333,732626,1293,10,N,N,-,-1,-1
MULIFE.txt,731584,732696,1112,10,N,N,-,-1,-1
MULIFE.txt,731658,732744,1086,10,N,N,-,-1,-1
MULIFE.txt,731783,732995,1212,10,N,N,-,-1,-1
MULIFE.txt,731874,733091,1217,10,N,N,-,-1,-1
MULIFE.txt,731999,733200,1201,10,N,N,-,-1,-1
MULIFE.txt,732109,733232,1123,10,N,N,-,-1,-1
MULIFE.txt,732166,733607,1441,10,N,N,-,-1,-1
MULIFE.txt,732231,733689,1458,10,N,N,-,-1,-1
MULIFE.txt,732506,733893,1387,10,N,N,-,-1,-1
MULIFE.txt,732627,733945,1318,10,N,N,-,-1,-1
MULIFE.txt,732699,734054,1355,10,N,N,-,-1,-1
MULIFE.txt,732745,734180,1435,10,N,N,-,-1,-1
MULIFE.txt,732996,734282,1286,10,N,N,-,-1,-1
MULIFE.txt,733092,734416,1324,10,N,N,-,-1,-1
MULIFE.txt,733201,734515,1314,10,N,N,-,-1,-1
MULIFE.txt,733234,734621,1387,10,N,N,-,-1,-1
MULIFE.txt,733607,734722,1115,10,N,N,-,-1,-1
MULIFE.txt,733690,734971,1281,10,N,N,-,-1,-1
MULIFE.txt,733896,735133,1237,10,N,N,-,-1,-1
MULIFE.txt,733946,735142,1196,10,N,N,-,-1,-1
MULIFE.txt,734055,735167,1112,10,N,N,-,-1,-1
MULIFE.txt,734181,735503,1322,10,N,N,-,-1,-1
MULIFE.txt,734283,735516,1233,10,N,N,-,-1,-1
MULIFE.txt,734417,735666,1249,10,N,N,-,-1,-1
MULIFE.txt,734516,735838,1322,10,N,N,-,-1,-1
MULIFE.txt,734622,735942,1320,10,N,N,-,-1,-1
MULIFE.txt,734723,736017,1294,10,N,N,-,-1,-1
MULIFE.txt,734974,736068,1094,10,N,N,-,-1,-1
MULIFE.txt,735134,736202,1068,10,N,N,-,-1,-1
MULIFE.txt,735145,736327,1182,10,N,N,-,-1,-1
MULIFE.txt,735168,736350,1182,10,N,N,-,-1,-1
MULIFE.txt,735504,736435,931,10,N,N,-,-1,-1
MULIFE.txt,735517,736449,932,10,N,N,-,-1,-1
MULIFE.txt,735667,736714,1047,10,N,N,-,-1,-1
MULIFE.txt,735839,736872,1033,10,N,N,-,-1,-1
MULIFE.txt,735943,736962,1019,10,N,N,-,-1,-1
MULIFE.txt,736018,737071,1053,10,N,N,-,-1,-1
MULIFE.txt,736069,737165,1096,10,N,N,-,-1,-1
MULIFE.txt,736205,737227,1022,10,N,N,-,-1,-1
MULIFE.txt,736328,737297,969,10,N,N,-,-1,-1
MULIFE.txt,736351,737362,1011,10,N,N,-,-1,-1
MULIFE.txt,736437,737421,984,10,N,N,-,-1,-1
MULIFE.txt,736450,737592,1142,10,N,N,-,-1,-1
MULIFE.txt,736715,737620,905,10,N,N,-,-1,-1
MULIFE.txt,736875,737740,865,10,N,N,-,-1,-1
MULIFE.txt,736965,737965,1000,10,N,N,-,-1,-1
MULIFE.txt,737074,738016,942,10,N,N,-,-1,-1
MULIFE.txt,737166,738060,894,10,N,N,-,-1,-1
MULIFE.txt,737228,738252,1024,10,N,N,-,-1,-1
MULIFE.txt,737298,738456,1158,10,N,N,-,-1,-1
MULIFE.txt,737363,738497,1134,10,N,N,-,-1,-1
MULIFE.txt,737422,738561,1139,10,N,N,-,-1,-1
MULIFE.txt,737593,738786,1193,10,N,N,-,-1,-1
MULIFE.txt,737622,738813,1191,10,N,N,-,-1,-1
MULIFE.txt,737742,738931,1189,10,N,N,-,-1,-1
MULIFE.txt,737966,739033,1067,10,N,N,-,-1,-1
MULIFE.txt,738019,739184,1165,10,N,N,-,-1,-1
MULIFE.txt,738061,739192,1131,10,N,N,-,-1,-1
MULIFE.txt,738254,739215,961,10,N,N,-,-1,-1
MULIFE.txt,738457,739220,763,10,N,N,-,-1,-1
MULIFE.txt,738498,739231,733,10,N,N,-,-1,-1
MULIFE.txt,738564,739281,717,10,N,N,-,-1,-1
MULIFE.txt,738787,739394,607,10,N,N,-,-1,-1
MULIFE.txt,738814,739527,713,10,N,N,-,-1,-1
MULIFE.txt,738932,739659,727,10,N,N,-,-1,-1
MULIFE.txt,739034,739850,816,10,N,N,-,-1,-1
MULIFE.txt,739189,739921,732,10,N,N,-,-1,-1
MULIFE.txt,739195,739986,791,10,N,N,-,-1,-1
MULIFE.txt,739218,740014,796,10,N,N,-,-1,-1
MULIFE.txt,739221,740087,866,10,N,N,-,-1,-1
MULIFE.txt,739234,740227,993,10,N,N,-,-1,-1
MULIFE.txt,739282,740282,1000,10,N,N,-,-1,-1
MULIFE.txt,739397,740325,928,10,N,N,-,-1,-1
MULIFE.txt,739530,740463,933,10,N,N,-,-1,-1
MULIFE.txt,739662,740702,1040,10,N,N,-,-1,-1
MULIFE.txt,739853,740839,986,10,N,Y,1448311811907,157566,161100
MULIFE.txt,739922,740851,929,10,N,Y,1448311811907,157566,161100
MULIFE.txt,739987,740943,956,10,N,Y,1448311811907,157566,161100
MULIFE.txt,740016,740964,948,10,N,Y,1448311811907,157566,161100
MULIFE.txt,740088,741188,1100,10,N,Y,1448311811907,157566,161100
MULIFE.txt,740228,741305,1077,10,N,Y,1448311811907,157566,161100
MULIFE.txt,740283,741394,1111,10,N,Y,1448311811907,157566,161100
MULIFE.txt,740326,741476,1150,10,N,Y,1448311811907,157566,161100
MULIFE.txt,740465,741568,1103,10,N,Y,1448311811907,157566,161100
MULIFE.txt,740705,741679,974,10,N,Y,1448311811907,157566,161100
MULIFE.txt,740840,741742,902,10,N,Y,1448311811907,157566,161100
MULIFE.txt,740852,741839,987,10,N,Y,1448311811907,157566,161100
MULIFE.txt,740944,741964,1020,10,N,Y,1448311811907,157566,161100
MULIFE.txt,740967,742009,1042,10,N,Y,1448311811907,157566,161100
MULIFE.txt,741189,742084,895,10,N,Y,1448311811907,157566,161100
MULIFE.txt,741306,742326,1020,10,N,Y,1448311811907,157566,161100
MULIFE.txt,741395,742341,946,10,N,Y,1448311811907,157566,161100
MULIFE.txt,741477,742383,906,10,N,Y,1448311811907,157566,161100
MULIFE.txt,741569,742428,859,10,N,Y,1448311811907,157566,161100
MULIFE.txt,741680,742471,791,10,N,Y,1448311811907,157566,161100
MULIFE.txt,741743,742646,903,10,N,Y,1448311811907,157566,161100
MULIFE.txt,741842,742694,852,10,N,N,-,-1,-1
MULIFE.txt,741965,742724,759,10,N,N,-,-1,-1
MULIFE.txt,742010,742783,773,10,N,N,-,-1,-1
MULIFE.txt,742085,742927,842,10,N,N,-,-1,-1
MULIFE.txt,742329,742939,610,10,N,N,-,-1,-1
MULIFE.txt,742342,742954,612,10,N,N,-,-1,-1
MULIFE.txt,742385,743006,621,10,N,N,-,-1,-1
MULIFE.txt,742429,743113,684,10,N,N,-,-1,-1
MULIFE.txt,742472,743117,645,10,N,N,-,-1,-1
MULIFE.txt,742647,743199,552,10,N,N,-,-1,-1
MULIFE.txt,742695,743250,555,10,N,N,-,-1,-1
MULIFE.txt,742725,743307,582,10,N,N,-,-1,-1
MULIFE.txt,742784,743370,586,10,N,N,-,-1,-1
MULIFE.txt,742928,743411,483,10,N,N,-,-1,-1
MULIFE.txt,742941,743442,501,10,N,N,-,-1,-1
MULIFE.txt,742955,743489,534,10,N,N,-,-1,-1
MULIFE.txt,743007,743683,676,10,N,N,-,-1,-1
MULIFE.txt,743114,743743,629,10,N,N,-,-1,-1
MULIFE.txt,743118,743763,645,10,N,N,-,-1,-1
MULIFE.txt,743200,743806,606,10,N,N,-,-1,-1
MULIFE.txt,743251,743854,603,10,N,N,-,-1,-1
MULIFE.txt,743308,743951,643,10,N,N,-,-1,-1
MULIFE.txt,743371,744079,708,10,N,N,-,-1,-1
MULIFE.txt,743412,744126,714,10,N,N,-,-1,-1
MULIFE.txt,743443,744199,756,10,N,N,-,-1,-1
MULIFE.txt,743490,744359,869,10,N,N,-,-1,-1
MULIFE.txt,743685,744418,733,10,N,N,-,-1,-1
MULIFE.txt,743746,744579,833,10,N,N,-,-1,-1
MULIFE.txt,743764,744831,1067,10,N,N,-,-1,-1
MULIFE.txt,743809,744977,1168,10,N,N,-,-1,-1
MULIFE.txt,743855,745183,1328,10,N,N,-,-1,-1
MULIFE.txt,743952,745307,1355,10,N,N,-,-1,-1
MULIFE.txt,744080,745429,1349,10,N,N,-,-1,-1
MULIFE.txt,744127,745621,1494,10,N,N,-,-1,-1
MULIFE.txt,744200,745667,1467,10,N,N,-,-1,-1
MULIFE.txt,744362,745791,1429,10,N,N,-,-1,-1
MULIFE.txt,744420,745990,1570,10,N,N,-,-1,-1
MULIFE.txt,744582,746138,1556,10,N,N,-,-1,-1
MULIFE.txt,744832,746216,1384,10,N,N,-,-1,-1
MULIFE.txt,744978,746352,1374,10,N,N,-,-1,-1
MULIFE.txt,745184,746619,1435,10,N,N,-,-1,-1
MULIFE.txt,745310,746741,1431,10,N,N,-,-1,-1
MULIFE.txt,745432,746806,1374,10,N,Y,1448311366799,143137,146264
MULIFE.txt,745622,746859,1237,10,N,Y,1448311366799,143137,146264
MULIFE.txt,745668,746920,1252,10,N,Y,1448311366799,143137,146264
MULIFE.txt,745792,747100,1308,10,N,Y,1448311366799,143137,146264
MULIFE.txt,745991,747398,1407,10,N,Y,1448311366799,143137,146264
MULIFE.txt,746139,747525,1386,10,N,Y,1448311366799,143137,146264
MULIFE.txt,746217,747715,1498,10,N,Y,1448311366799,143137,146264
MULIFE.txt,746353,747931,1578,10,N,Y,1448311366799,143137,146264
MULIFE.txt,746620,748138,1518,10,N,Y,1448311366799,143137,146264
MULIFE.txt,746742,748167,1425,10,N,Y,1448311366799,143137,146264
MULIFE.txt,746809,748184,1375,10,N,Y,1448311366799,143137,146264
MULIFE.txt,746860,748306,1446,10,Y,Y,1448311366799,143137,146264
MULIFE.txt,746923,748356,1433,10,Y,Y,1448311366799,143137,146264
MULIFE.txt,747101,748509,1408,10,Y,Y,1448311366799,143137,146264
MULIFE.txt,747399,748676,1277,10,N,Y,1448311366799,143137,146264
MULIFE.txt,747526,748721,1195,10,N,Y,1448311366799,143137,146264
MULIFE.txt,747716,748795,1079,10,N,Y,1448311366799,143137,146264
MULIFE.txt,747934,748885,951,10,N,Y,1448311366799,143137,146264
MULIFE.txt,748143,749107,964,10,N,N,-,-1,-1
MULIFE.txt,748172,749128,956,10,N,N,-,-1,-1
MULIFE.txt,748187,749228,1041,10,N,N,-,-1,-1
MULIFE.txt,748307,749260,953,10,N,N,-,-1,-1
MULIFE.txt,748359,749349,990,10,N,N,-,-1,-1
MULIFE.txt,748510,749364,854,10,N,N,-,-1,-1
MULIFE.txt,748677,749447,770,10,N,N,-,-1,-1
MULIFE.txt,748722,749538,816,10,N,N,-,-1,-1
MULIFE.txt,748796,749655,859,10,N,N,-,-1,-1
MULIFE.txt,748886,749825,939,10,N,N,-,-1,-1
MULIFE.txt,749110,750514,1404,10,N,N,-,-1,-1
MULIFE.txt,749129,750761,1632,10,N,N,-,-1,-1
MULIFE.txt,749229,750863,1634,10,N,N,-,-1,-1
MULIFE.txt,749261,751006,1745,10,N,N,-,-1,-1
MULIFE.txt,749350,751075,1725,10,N,N,-,-1,-1
MULIFE.txt,749365,751117,1752,10,N,N,-,-1,-1
MULIFE.txt,749448,751190,1742,10,N,N,-,-1,-1
MULIFE.txt,749539,751328,1789,10,N,N,-,-1,-1
MULIFE.txt,749656,751624,1968,10,N,N,-,-1,-1
MULIFE.txt,749826,751691,1865,10,N,N,-,-1,-1
MULIFE.txt,750515,751791,1276,10,N,N,-,-1,-1
MULIFE.txt,750764,751853,1089,10,N,N,-,-1,-1
MULIFE.txt,750864,751957,1093,10,N,N,-,-1,-1
MULIFE.txt,751007,752362,1355,10,N,N,-,-1,-1
MULIFE.txt,751078,752482,1404,10,N,N,-,-1,-1
MULIFE.txt,751118,752566,1448,10,N,N,-,-1,-1
MULIFE.txt,751192,752767,1575,10,N,N,-,-1,-1
MULIFE.txt,751329,752833,1504,10,N,N,-,-1,-1
MULIFE.txt,751627,752844,1217,10,N,N,-,-1,-1
MULIFE.txt,751692,753004,1312,10,N,N,-,-1,-1
MULIFE.txt,751794,753088,1294,10,N,N,-,-1,-1
MULIFE.txt,751855,753356,1501,10,N,N,-,-1,-1
MULIFE.txt,751959,753443,1484,10,N,N,-,-1,-1
MULIFE.txt,752363,753635,1272,10,N,N,-,-1,-1
MULIFE.txt,752483,753724,1241,10,N,N,-,-1,-1
MULIFE.txt,752567,753911,1344,10,N,N,-,-1,-1
MULIFE.txt,752768,753960,1192,10,N,N,-,-1,-1
MULIFE.txt,752834,754004,1170,10,N,N,-,-1,-1
MULIFE.txt,752845,754106,1261,10,N,N,-,-1,-1
MULIFE.txt,753005,754209,1204,10,N,N,-,-1,-1
MULIFE.txt,753089,754306,1217,10,N,N,-,-1,-1
MULIFE.txt,753357,754376,1019,10,N,N,-,-1,-1
MULIFE.txt,753444,754503,1059,10,N,N,-,-1,-1
MULIFE.txt,753636,754513,877,10,N,N,-,-1,-1
MULIFE.txt,753727,754590,863,10,N,N,-,-1,-1
MULIFE.txt,753912,754609,697,10,N,N,-,-1,-1
MULIFE.txt,753961,754707,746,10,N,N,-,-1,-1
MULIFE.txt,754005,754872,867,10,N,N,-,-1,-1
MULIFE.txt,754109,755036,927,10,N,N,-,-1,-1
MULIFE.txt,754210,755174,964,10,N,N,-,-1,-1
MULIFE.txt,754307,755263,956,10,N,N,-,-1,-1
MULIFE.txt,754377,755376,999,10,N,N,-,-1,-1
MULIFE.txt,754504,755462,958,10,N,N,-,-1,-1
MULIFE.txt,754514,755472,958,10,N,N,-,-1,-1
MULIFE.txt,754591,755569,978,10,N,N,-,-1,-1
MULIFE.txt,754610,755628,1018,10,N,N,-,-1,-1
MULIFE.txt,754708,755729,1021,10,N,N,-,-1,-1
MULIFE.txt,754875,755843,968,10,N,N,-,-1,-1
MULIFE.txt,755039,755853,814,10,N,N,-,-1,-1
MULIFE.txt,755175,755980,805,10,N,N,-,-1,-1
MULIFE.txt,755264,756089,825,10,N,N,-,-1,-1
MULIFE.txt,755377,756197,820,10,N,N,-,-1,-1
MULIFE.txt,755463,756508,1045,10,N,N,-,-1,-1
MULIFE.txt,755473,756660,1187,10,N,N,-,-1,-1
MULIFE.txt,755570,757139,1569,10,N,N,-,-1,-1
MULIFE.txt,755629,757300,1671,10,N,N,-,-1,-1
MULIFE.txt,755732,757401,1669,10,Y,N,-,-1,-1
MULIFE.txt,755844,757420,1576,10,N,N,-,-1,-1
MULIFE.txt,755854,757560,1706,10,N,N,-,-1,-1
MULIFE.txt,755981,757590,1609,10,N,N,-,-1,-1
MULIFE.txt,756091,758041,1950,10,N,N,-,-1,-1
MULIFE.txt,756199,758351,2152,10,N,N,-,-1,-1
MULIFE.txt,756509,758605,2096,10,N,N,-,-1,-1
MULIFE.txt,756661,758665,2004,10,N,N,-,-1,-1
MULIFE.txt,757144,758843,1699,10,N,N,-,-1,-1
MULIFE.txt,757303,758941,1638,10,N,N,-,-1,-1
MULIFE.txt,757402,759076,1674,10,N,N,-,-1,-1
MULIFE.txt,757421,759339,1918,10,N,N,-,-1,-1
MULIFE.txt,757561,759799,2238,10,N,N,-,-1,-1
MULIFE.txt,757591,759808,2217,10,N,N,-,-1,-1
MULIFE.txt,758044,759819,1775,10,N,N,-,-1,-1
MULIFE.txt,758352,759927,1575,10,N,Y,1437472380836,351899,352666
MULIFE.txt,758606,760119,1513,10,N,Y,1437472380836,351899,352666
MULIFE.txt,758666,760172,1506,10,N,Y,1437472380836,351899,352666
MULIFE.txt,758844,760253,1409,10,N,Y,1437472380836,351899,352666
MULIFE.txt,758942,760334,1392,10,N,Y,1437472380836,351899,352666
MULIFE.txt,759077,760435,1358,10,N,Y,1437472380836,351899,352666
MULIFE.txt,759340,760631,1291,10,N,Y,1437472380836,351899,352666
MULIFE.txt,759804,760841,1037,10,N,Y,1437472380836,351899,352666
MULIFE.txt,759809,760858,1049,10,N,Y,1437472380836,351899,352666
MULIFE.txt,759822,760992,1170,10,N,Y,1437472380836,351899,352666
MULIFE.txt,759930,761052,1122,10,N,Y,1437472380836,351899,352666
MULIFE.txt,760122,761166,1044,10,N,Y,1437472380836,351899,352666
MULIFE.txt,760173,761536,1363,10,N,Y,1437472380836,351899,352666
MULIFE.txt,760254,761615,1361,10,N,Y,1437472380836,351899,352666
MULIFE.txt,760335,761760,1425,10,N,Y,1437472380836,351899,352666
MULIFE.txt,760436,761930,1494,10,N,Y,1437472380836,351899,352666
MULIFE.txt,760634,762054,1420,10,N,N,-,-1,-1
MULIFE.txt,760842,762229,1387,10,N,N,-,-1,-1
MULIFE.txt,760861,762319,1458,10,N,N,-,-1,-1
MULIFE.txt,760993,762353,1360,10,N,N,-,-1,-1
MULIFE.txt,761053,762399,1346,10,N,N,-,-1,-1
MULIFE.txt,761167,762759,1592,10,N,N,-,-1,-1
MULIFE.txt,761539,762821,1282,10,N,N,-,-1,-1
MULIFE.txt,761616,762946,1330,10,N,N,-,-1,-1
MULIFE.txt,761763,763075,1312,10,N,N,-,-1,-1
MULIFE.txt,761933,763160,1227,10,N,N,-,-1,-1
MULIFE.txt,762055,763380,1325,10,N,N,-,-1,-1
MULIFE.txt,762230,763454,1224,10,N,N,-,-1,-1
MULIFE.txt,762320,763762,1442,10,N,N,-,-1,-1
MULIFE.txt,762354,764037,1683,10,N,N,-,-1,-1
MULIFE.txt,762400,764154,1754,10,N,N,-,-1,-1
MULIFE.txt,762762,764188,1426,10,N,N,-,-1,-1
MULIFE.txt,762822,764264,1442,10,N,N,-,-1,-1
MULIFE.txt,762947,764431,1484,10,N,N,-,-1,-1
MULIFE.txt,763078,764500,1422,10,N,N,-,-1,-1
MULIFE.txt,763161,764573,1412,10,N,N,-,-1,-1
MULIFE.txt,763381,764588,1207,10,N,N,-,-1,-1
MULIFE.txt,763455,764826,1371,10,N,N,-,-1,-1
MULIFE.txt,763763,764910,1147,10,N,N,-,-1,-1
MULIFE.txt,764040,765015,975,10,N,N,-,-1,-1
MULIFE.txt,764155,765408,1253,10,N,N,-,-1,-1
MULIFE.txt,764189,765569,1380,10,N,N,-,-1,-1
MULIFE.txt,764265,765795,1530,10,N,N,-,-1,-1
MULIFE.txt,764434,765836,1402,10,N,N,-,-1,-1
MULIFE.txt,764501,765880,1379,10,N,N,-,-1,-1
MULIFE.txt,764574,765984,1410,10,N,N,-,-1,-1
MULIFE.txt,764589,766000,1411,10,N,N,-,-1,-1
MULIFE.txt,764828,766149,1321,10,N,N,-,-1,-1
MULIFE.txt,764913,766309,1396,10,N,N,-,-1,-1
MULIFE.txt,765016,766417,1401,10,N,N,-,-1,-1
MULIFE.txt,765411,766484,1073,10,N,N,-,-1,-1
MULIFE.txt,765570,766539,969,10,N,N,-,-1,-1
MULIFE.txt,765798,766998,1200,10,N,N,-,-1,-1
MULIFE.txt,765837,767082,1245,10,N,N,-,-1,-1
MULIFE.txt,765883,767351,1468,10,N,N,-,-1,-1
MULIFE.txt,765987,767475,1488,10,N,N,-,-1,-1
MULIFE.txt,766001,767532,1531,10,N,N,-,-1,-1
MULIFE.txt,766150,767707,1557,10,N,N,-,-1,-1
MULIFE.txt,766310,768177,1867,10,N,N,-,-1,-1
MULIFE.txt,766420,768498,2078,10,N,N,-,-1,-1
MULIFE.txt,766485,768628,2143,10,N,N,-,-1,-1
MULIFE.txt,766540,768753,2213,10,N,N,-,-1,-1
MULIFE.txt,766999,768827,1828,10,N,N,-,-1,-1
MULIFE.txt,767083,768991,1908,10,N,N,-,-1,-1
MULIFE.txt,767352,769318,1966,10,N,N,-,-1,-1
MULIFE.txt,767478,769344,1866,10,N,N,-,-1,-1
MULIFE.txt,767535,769488,1953,10,N,N,-,-1,-1
MULIFE.txt,767710,769755,2045,10,N,N,-,-1,-1
MULIFE.txt,768179,770126,1947,10,N,N,-,-1,-1
MULIFE.txt,768499,770140,1641,10,N,N,-,-1,-1
MULIFE.txt,768631,770154,1523,10,N,N,-,-1,-1
MULIFE.txt,768754,770230,1476,10,N,N,-,-1,-1
MULIFE.txt,768830,770262,1432,10,N,N,-,-1,-1
MULIFE.txt,768994,770321,1327,10,N,N,-,-1,-1
MULIFE.txt,769321,770340,1019,10,N,N,-,-1,-1
MULIFE.txt,769345,770612,1267,10,N,N,-,-1,-1
MULIFE.txt,769490,770829,1339,10,N,N,-,-1,-1
MULIFE.txt,769756,770935,1179,10,N,N,-,-1,-1
MULIFE.txt,770127,770977,850,10,N,N,-,-1,-1
MULIFE.txt,770141,771029,888,10,N,N,-,-1,-1
MULIFE.txt,770157,771037,880,10,N,N,-,-1,-1
MULIFE.txt,770231,771059,828,10,N,N,-,-1,-1
MULIFE.txt,770263,771118,855,10,N,N,-,-1,-1
MULIFE.txt,770323,771190,867,10,N,Y,1448286451685,111065,112127
MULIFE.txt,770342,771316,974,10,N,Y,1448286451685,111065,112127
MULIFE.txt,770615,771325,710,10,N,Y,1448286451685,111065,112127
MULIFE.txt,770832,771489,657,10,N,Y,1448286451685,111065,112127
MULIFE.txt,770937,771560,623,10,N,Y,1448286451685,111065,112127
MULIFE.txt,770979,771920,941,10,N,Y,1448286451685,111065,112127
MULIFE.txt,771034,771956,922,10,N,Y,1448286451685,111065,112127
MULIFE.txt,771038,772202,1164,10,N,Y,1448286451685,111065,112127
MULIFE.txt,771062,772363,1301,10,N,Y,1448286451685,111065,112127
MULIFE.txt,771119,772451,1332,10,N,Y,1448286451685,111065,112127
MULIFE.txt,771191,772776,1585,10,N,Y,1448286451685,111065,112127
MULIFE.txt,771317,772943,1626,10,N,Y,1448286451685,111065,112127
MULIFE.txt,771326,772974,1648,10,N,Y,1448286451685,111065,112127
MULIFE.txt,771490,773082,1592,10,N,Y,1448286451685,111065,112127
MULIFE.txt,771561,773165,1604,10,N,Y,1448286451685,111065,112127
MULIFE.txt,771921,773247,1326,10,N,Y,1448286451685,111065,112127
MULIFE.txt,771959,773375,1416,10,N,N,-,-1,-1
MULIFE.txt,772203,773453,1250,10,N,N,-,-1,-1
MULIFE.txt,772364,773559,1195,10,N,N,-,-1,-1
MULIFE.txt,772452,773877,1425,10,N,N,-,-1,-1
MULIFE.txt,772779,773911,1132,10,N,N,-,-1,-1
MULIFE.txt,772946,773978,1032,10,N,N,-,-1,-1
MULIFE.txt,772975,774066,1091,10,N,N,-,-1,-1
MULIFE.txt,773083,774082,999,10,N,N,-,-1,-1
MULIFE.txt,773166,774104,938,10,N,N,-,-1,-1
MULIFE.txt,773248,774263,1015,10,N,N,-,-1,-1
MULIFE.txt,773376,774318,942,10,N,N,-,-1,-1
MULIFE.txt,773454,774396,942,10,N,N,-,-1,-1
MULIFE.txt,773560,775052,1492,10,N,N,-,-1,-1
MULIFE.txt,773880,775387,1507,10,N,N,-,-1,-1
MULIFE.txt,773914,775403,1489,10,N,N,-,-1,-1
MULIFE.txt,773979,775412,1433,10,N,N,-,-1,-1
MULIFE.txt,774067,775465,1398,10,N,N,-,-1,-1
MULIFE.txt,774085,775663,1578,10,N,N,-,-1,-1
MULIFE.txt,774105,775931,1826,10,N,N,-,-1,-1
MULIFE.txt,774264,775950,1686,10,N,N,-,-1,-1
MULIFE.txt,774319,775994,1675,10,N,N,-,-1,-1
MULIFE.txt,774397,776031,1634,10,N,N,-,-1,-1
MULIFE.txt,775055,776198,1143,10,N,N,-,-1,-1
MULIFE.txt,775392,776354,962,10,N,N,-,-1,-1
MULIFE.txt,775404,776407,1003,10,N,N,-,-1,-1
MULIFE.txt,775413,776431,1018,10,N,N,-,-1,-1
MULIFE.txt,775466,776714,1248,10,N,N,-,-1,-1
MULIFE.txt,775666,776868,1202,10,N,N,-,-1,-1
MULIFE.txt,775932,776935,1003,10,N,N,-,-1,-1
MULIFE.txt,775951,776982,1031,10,N,N,-,-1,-1
MULIFE.txt,775995,777034,1039,10,N,N,-,-1,-1
MULIFE.txt,776032,777242,1210,10,N,N,-,-1,-1
MULIFE.txt,776201,777579,1378,10,N,N,-,-1,-1
MULIFE.txt,776355,777637,1282,10,N,N,-,-1,-1
MULIFE.txt,776408,777839,1431,10,N,N,-,-1,-1
MULIFE.txt,776434,777994,1560,10,N,N,-,-1,-1
MULIFE.txt,776717,778043,1326,10,N,N,-,-1,-1
MULIFE.txt,776869,778283,1414,10,N,N,-,-1,-1
MULIFE.txt,776936,778389,1453,10,N,N,-,-1,-1
MULIFE.txt,776985,778512,1527,10,N,N,-,-1,-1
MULIFE.txt,777035,778536,1501,10,N,N,-,-1,-1
MULIFE.txt,777243,778624,1381,10,N,N,-,-1,-1
MULIFE.txt,777582,778747,1165,10,N,Y,1448313994373,179347,179715
MULIFE.txt,777639,778798,1159,10,N,Y,1448313994373,179347,179715
MULIFE.txt,777842,778825,983,10,N,Y,1448313994373,179347,179715
MULIFE.txt,777995,778914,919,10,N,Y,1448313994373,179347,179715
MULIFE.txt,778046,779048,1002,10,N,Y,1448313994373,179347,179715
MULIFE.txt,778285,779109,824,10,N,Y,1448313994373,179347,179715
MULIFE.txt,778390,779341,951,10,N,Y,1448313994373,179347,179715
MULIFE.txt,778517,779354,837,10,N,Y,1448313994373,179347,179715
MULIFE.txt,778537,779369,832,10,N,Y,1448313994373,179347,179715
MULIFE.txt,778627,779395,768,10,N,Y,1448313994373,179347,179715
MULIFE.txt,778748,779577,829,10,N,Y,1448313994373,179347,179715
MULIFE.txt,778801,780024,1223,10,N,Y,1448313994373,179347,179715
MULIFE.txt,778826,780037,1211,10,N,Y,1448313994373,179347,179715
MULIFE.txt,778915,780326,1411,10,N,Y,1448313994373,179347,179715
MULIFE.txt,779049,780399,1350,10,N,Y,1448313994373,179347,179715
MULIFE.txt,779110,780629,1519,10,N,Y,1448313994373,179347,179715
MULIFE.txt,779342,780646,1304,10,N,Y,1448313994373,179347,179715
MULIFE.txt,779355,780657,1302,10,N,Y,1448313994373,179347,179715
MULIFE.txt,779370,780777,1407,10,N,Y,1448313994373,179347,179715
MULIFE.txt,779396,780907,1511,10,N,Y,1448313994373,179347,179715
MULIFE.txt,779578,780953,1375,10,N,Y,1448313994373,179347,179715
MULIFE.txt,780027,780987,960,10,N,Y,1448313994373,179347,179715
MULIFE.txt,780038,781213,1175,10,N,Y,1448313994373,179347,179715
MULIFE.txt,780329,781225,896,10,N,Y,1448313994373,179347,179715
MULIFE.txt,780402,781368,966,10,N,N,-,-1,-1
MULIFE.txt,780632,781498,866,10,N,N,-,-1,-1
MULIFE.txt,780649,781579,930,10,N,N,-,-1,-1
MULIFE.txt,780658,781605,947,10,N,N,-,-1,-1
MULIFE.txt,780778,781661,883,10,N,N,-,-1,-1
MULIFE.txt,780908,781674,766,10,N,N,-,-1,-1
MULIFE.txt,780954,781706,752,10,N,N,-,-1,-1
MULIFE.txt,780988,781741,753,10,N,N,-,-1,-1
MULIFE.txt,781216,781811,595,10,N,N,-,-1,-1
MULIFE.txt,781226,782050,824,10,N,N,-,-1,-1
MULIFE.txt,781369,782062,693,10,N,N,-,-1,-1
MULIFE.txt,781499,782295,796,10,N,N,-,-1,-1
MULIFE.txt,781581,782310,729,10,N,N,-,-1,-1
MULIFE.txt,781606,782316,710,10,N,N,-,-1,-1
MULIFE.txt,781664,782326,662,10,N,N,-,-1,-1
MULIFE.txt,781675,782463,788,10,N,N,-,-1,-1
MULIFE.txt,781707,782524,817,10,N,N,-,-1,-1
MULIFE.txt,781742,782542,800,10,N,N,-,-1,-1
MULIFE.txt,781812,782654,842,10,N,N,-,-1,-1
MULIFE.txt,782053,782828,775,10,N,N,-,-1,-1
MULIFE.txt,782063,783072,1009,10,N,N,-,-1,-1
MULIFE.txt,782296,783101,805,10,N,N,-,-1,-1
MULIFE.txt,782313,783113,800,10,N,N,-,-1,-1
MULIFE.txt,782318,783204,886,10,N,N,-,-1,-1
MULIFE.txt,782329,783268,939,10,N,N,-,-1,-1
MULIFE.txt,782464,783328,864,10,N,N,-,-1,-1
MULIFE.txt,782525,783451,926,10,N,N,-,-1,-1
MULIFE.txt,782543,783784,1241,10,N,N,-,-1,-1
MULIFE.txt,782655,783955,1300,10,N,N,-,-1,-1
MULIFE.txt,782829,784060,1231,10,N,N,-,-1,-1
MULIFE.txt,783073,784281,1208,10,N,N,-,-1,-1
MULIFE.txt,783104,784310,1206,10,N,N,-,-1,-1
MULIFE.txt,783114,784384,1270,10,N,N,-,-1,-1
MULIFE.txt,783205,784835,1630,10,N,N,-,-1,-1
MULIFE.txt,783269,785000,1731,10,N,N,-,-1,-1
MULIFE.txt,783329,785012,1683,10,N,N,-,-1,-1
MULIFE.txt,783452,785104,1652,10,N,N,-,-1,-1
MULIFE.txt,783786,785274,1488,10,N,N,-,-1,-1
MULIFE.txt,783956,785373,1417,10,N,N,-,-1,-1
MULIFE.txt,784061,785434,1373,10,N,N,-,-1,-1
MULIFE.txt,784286,785500,1214,10,N,N,-,-1,-1
MULIFE.txt,784313,785532,1219,10,N,N,-,-1,-1
MULIFE.txt,784385,785604,1219,10,N,N,-,-1,-1
MULIFE.txt,784836,785742,906,10,N,N,-,-1,-1
MULIFE.txt,785003,785839,836,10,N,N,-,-1,-1
MULIFE.txt,785013,785909,896,10,N,N,-,-1,-1
MULIFE.txt,785105,786016,911,10,N,N,-,-1,-1
MULIFE.txt,785275,786103,828,10,N,N,-,-1,-1
MULIFE.txt,785375,786193,818,10,N,N,-,-1,-1
MULIFE.txt,785435,786199,764,10,N,N,-,-1,-1
MULIFE.txt,785501,786219,718,10,N,N,-,-1,-1
MULIFE.txt,785533,786325,792,10,N,N,-,-1,-1
MULIFE.txt,785605,786420,815,10,N,N,-,-1,-1
MULIFE.txt,785743,786510,767,10,N,N,-,-1,-1
MULIFE.txt,785840,786534,694,10,N,N,-,-1,-1
MULIFE.txt,785912,786669,757,10,N,N,-,-1,-1
MULIFE.txt,786017,786729,712,10,N,N,-,-1,-1
MULIFE.txt,786104,786805,701,10,N,N,-,-1,-1
MULIFE.txt,786196,786891,695,10,N,N,-,-1,-1
MULIFE.txt,786202,787000,798,10,N,N,-,-1,-1
MULIFE.txt,786222,787129,907,10,N,N,-,-1,-1
MULIFE.txt,786326,787192,866,10,N,N,-,-1,-1
MULIFE.txt,786421,787306,885,10,N,N,-,-1,-1
MULIFE.txt,786511,787350,839,10,N,N,-,-1,-1
MULIFE.txt,786535,787511,976,10,N,N,-,-1,-1
MULIFE.txt,786670,787559,889,10,N,N,-,-1,-1
MULIFE.txt,786730,787593,863,10,N,N,-,-1,-1
MULIFE.txt,786806,787691,885,10,N,N,-,-1,-1
MULIFE.txt,786892,787864,972,10,N,N,-,-1,-1
MULIFE.txt,787001,787881,880,10,N,N,-,-1,-1
MULIFE.txt,787130,787924,794,10,N,N,-,-1,-1
MULIFE.txt,787193,788174,981,10,N,N,-,-1,-1
MULIFE.txt,787307,788206,899,10,N,N,-,-1,-1
MULIFE.txt,787351,788519,1168,10,N,N,-,-1,-1
MULIFE.txt,787512,788660,1148,10,N,N,-,-1,-1
MULIFE.txt,787560,788741,1181,10,N,N,-,-1,-1
MULIFE.txt,787595,789052,1457,10,N,N,-,-1,-1
MULIFE.txt,787692,789329,1637,10,N,N,-,-1,-1
MULIFE.txt,787869,789581,1712,10,N,N,-,-1,-1
MULIFE.txt,787884,789650,1766,10,Y,N,-,-1,-1
MULIFE.txt,787927,789968,2041,10,Y,N,-,-1,-1
MULIFE.txt,788175,790120,1945,10,Y,N,-,-1,-1
MULIFE.txt,788207,790204,1997,10,Y,N,-,-1,-1
MULIFE.txt,788522,790643,2121,10,N,N,-,-1,-1
MULIFE.txt,788661,790692,2031,10,N,N,-,-1,-1
MULIFE.txt,788742,790807,2065,10,N,N,-,-1,-1
MULIFE.txt,789053,790863,1810,10,N,N,-,-1,-1
MULIFE.txt,789330,790878,1548,10,N,N,-,-1,-1
MULIFE.txt,789582,790996,1414,10,N,N,-,-1,-1
MULIFE.txt,789653,791247,1594,10,N,N,-,-1,-1
MULIFE.txt,789969,791379,1410,10,N,N,-,-1,-1
MULIFE.txt,790121,791416,1295,10,N,N,-,-1,-1
MULIFE.txt,790207,791670,1463,10,N,N,-,-1,-1
MULIFE.txt,790646,791822,1176,10,N,N,-,-1,-1
MULIFE.txt,790693,791832,1139,10,N,N,-,-1,-1
MULIFE.txt,790808,791863,1055,10,N,N,-,-1,-1
MULIFE.txt,790866,791973,1107,10,N,N,-,-1,-1
MULIFE.txt,790881,792035,1154,10,N,N,-,-1,-1
MULIFE.txt,790997,792111,1114,10,N,N,-,-1,-1
MULIFE.txt,791250,792402,1152,10,N,N,-,-1,-1
MULIFE.txt,791380,792574,1194,10,N,N,-,-1,-1
MULIFE.txt,791418,792839,1421,10,N,N,-,-1,-1
MULIFE.txt,791671,793053,1382,10,N,N,-,-1,-1
MULIFE.txt,791827,793170,1343,10,N,N,-,-1,-1
MULIFE.txt,791834,793376,1542,10,N,N,-,-1,-1
MULIFE.txt,791866,793593,1727,10,N,N,-,-1,-1
MULIFE.txt,791974,793782,1808,10,N,N,-,-1,-1
MULIFE.txt,792038,793909,1871,10,N,N,-,-1,-1
MULIFE.txt,792112,794019,1907,10,N,N,-,-1,-1
MULIFE.txt,792403,794040,1637,10,N,N,-,-1,-1
MULIFE.txt,792575,794356,1781,10,N,N,-,-1,-1
MULIFE.txt,792844,794368,1524,10,N,N,-,-1,-1
MULIFE.txt,793056,794550,1494,10,N,N,-,-1,-1
MULIFE.txt,793171,794647,1476,10,N,N,-,-1,-1
MULIFE.txt,793377,794894,1517,10,N,N,-,-1,-1
MULIFE.txt,793594,795074,1480,10,N,N,-,-1,-1
MULIFE.txt,793785,795166,1381,10,N,N,-,-1,-1
MULIFE.txt,793910,795194,1284,10,N,N,-,-1,-1
MULIFE.txt,794022,795199,1177,10,N,N,-,-1,-1
MULIFE.txt,794041,795332,1291,10,N,N,-,-1,-1
MULIFE.txt,794357,795532,1175,10,N,N,-,-1,-1
MULIFE.txt,794369,795895,1526,10,N,N,-,-1,-1
MULIFE.txt,794551,795966,1415,10,N,N,-,-1,-1
MULIFE.txt,794648,796088,1440,10,N,N,-,-1,-1
MULIFE.txt,794895,796114,1219,10,N,N,-,-1,-1
MULIFE.txt,795077,796119,1042,10,N,N,-,-1,-1
MULIFE.txt,795167,796169,1002,10,N,N,-,-1,-1
MULIFE.txt,795195,796174,979,10,N,N,-,-1,-1
MULIFE.txt,795200,796237,1037,10,N,N,-,-1,-1
MULIFE.txt,795333,796380,1047,10,N,N,-,-1,-1
MULIFE.txt,795533,796417,884,10,N,N,-,-1,-1
MULIFE.txt,795895,796422,527,10,N,N,-,-1,-1
MULIFE.txt,795969,796486,517,10,N,N,-,-1,-1
MULIFE.txt,796089,796751,662,10,N,N,-,-1,-1
MULIFE.txt,796117,796755,638,10,N,N,-,-1,-1
MULIFE.txt,796120,796877,757,10,N,N,-,-1,-1
MULIFE.txt,796172,796884,712,10,N,N,-,-1,-1
MULIFE.txt,796175,796925,750,10,N,N,-,-1,-1
MULIFE.txt,796240,797056,816,10,N,N,-,-1,-1
MULIFE.txt,796381,797132,751,10,N,N,-,-1,-1
MULIFE.txt,796420,797844,1424,10,N,N,-,-1,-1
MULIFE.txt,796423,798085,1662,10,N,N,-,-1,-1
MULIFE.txt,796489,798720,2231,10,N,N,-,-1,-1
MULIFE.txt,796754,799097,2343,10,N,N,-,-1,-1
MULIFE.txt,796758,799176,2418,10,N,N,-,-1,-1
MULIFE.txt,796878,799350,2472,10,N,N,-,-1,-1
MULIFE.txt,796885,799764,2879,10,N,N,-,-1,-1
MULIFE.txt,796925,800146,3221,10,N,N,-,-1,-1
MULIFE.txt,797057,800163,3106,10,N,N,-,-1,-1
MULIFE.txt,797133,800329,3196,10,N,N,-,-1,-1
MULIFE.txt,797845,800499,2654,10,N,N,-,-1,-1
MULIFE.txt,798088,800719,2631,10,N,N,-,-1,-1
MULIFE.txt,798723,800789,2066,10,N,N,-,-1,-1
MULIFE.txt,799098,800964,1866,10,N,N,-,-1,-1
MULIFE.txt,799179,801196,2017,10,N,N,-,-1,-1
MULIFE.txt,799353,801542,2189,10,N,N,-,-1,-1
MULIFE.txt,799765,801587,1822,10,N,N,-,-1,-1
MULIFE.txt,800147,801596,1449,10,N,N,-,-1,-1
MULIFE.txt,800164,801832,1668,10,N,N,-,-1,-1
MULIFE.txt,800330,801947,1617,10,N,N,-,-1,-1
MULIFE.txt,800502,802219,1717,10,N,N,-,-1,-1
MULIFE.txt,800722,802254,1532,10,N,N,-,-1,-1
MULIFE.txt,800790,802350,1560,10,N,N,-,-1,-1
MULIFE.txt,800965,802683,1718,10,N,N,-,-1,-1
MULIFE.txt,801197,802810,1613,10,N,N,-,-1,-1
MULIFE.txt,801547,803075,1528,10,N,N,-,-1,-1
MULIFE.txt,801590,803154,1564,10,N,N,-,-1,-1
MULIFE.txt,801599,803371,1772,10,N,N,-,-1,-1
MULIFE.txt,801835,803496,1661,10,N,N,-,-1,-1
MULIFE.txt,801949,803517,1568,10,N,N,-,-1,-1
MULIFE.txt,802220,803669,1449,10,N,N,-,-1,-1
MULIFE.txt,802255,803692,1437,10,N,N,-,-1,-1
MULIFE.txt,802351,803756,1405,10,N,N,-,-1,-1
MULIFE.txt,802684,803991,1307,10,N,N,-,-1,-1
MULIFE.txt,802812,804086,1274,10,N,N,-,-1,-1
MULIFE.txt,803076,804311,1235,10,N,N,-,-1,-1
MULIFE.txt,803157,804604,1447,10,N,N,-,-1,-1
MULIFE.txt,803372,804619,1247,10,N,N,-,-1,-1
MULIFE.txt,803499,804685,1186,10,N,N,-,-1,-1
MULIFE.txt,803518,804878,1360,10,N,N,-,-1,-1
MULIFE.txt,803672,805095,1423,10,N,N,-,-1,-1
MULIFE.txt,803693,805308,1615,10,N,N,-,-1,-1
MULIFE.txt,803757,805546,1789,10,N,N,-,-1,-1
MULIFE.txt,803992,805604,1612,10,N,N,-,-1,-1
MULIFE.txt,804087,805675,1588,10,N,N,-,-1,-1
MULIFE.txt,804312,805762,1450,10,N,N,-,-1,-1
MULIFE.txt,804607,805812,1205,10,N,N,-,-1,-1
MULIFE.txt,804620,805846,1226,10,N,N,-,-1,-1
MULIFE.txt,804686,805928,1242,10,N,N,-,-1,-1
MULIFE.txt,804879,806074,1195,10,N,N,-,-1,-1
MULIFE.txt,805096,806111,1015,10,N,N,-,-1,-1
MULIFE.txt,805311,806204,893,10,N,N,-,-1,-1
MULIFE.txt,805549,806249,700,10,N,N,-,-1,-1
MULIFE.txt,805605,806322,717,10,N,N,-,-1,-1
MULIFE.txt,805676,806361,685,10,N,N,-,-1,-1
MULIFE.txt,805763,806402,639,10,N,N,-,-1,-1
MULIFE.txt,805813,806510,697,10,N,N,-,-1,-1
MULIFE.txt,805849,806572,723,10,N,N,-,-1,-1
MULIFE.txt,805931,806823,892,10,N,N,-,-1,-1
MULIFE.txt,806075,806941,866,10,N,N,-,-1,-1
MULIFE.txt,806112,807075,963,10,N,N,-,-1,-1
MULIFE.txt,806205,807108,903,10,N,N,-,-1,-1
MULIFE.txt,806250,807376,1126,10,N,N,-,-1,-1
MULIFE.txt,806323,807498,1175,10,N,N,-,-1,-1
MULIFE.txt,806362,807617,1255,10,N,N,-,-1,-1
MULIFE.txt,806405,807867,1462,10,N,N,-,-1,-1
MULIFE.txt,806511,808114,1603,10,N,N,-,-1,-1
MULIFE.txt,806573,808227,1654,10,N,N,-,-1,-1
MULIFE.txt,806826,808586,1760,10,N,N,-,-1,-1
MULIFE.txt,806942,808674,1732,10,N,N,-,-1,-1
MULIFE.txt,807076,808738,1662,10,N,N,-,-1,-1
MULIFE.txt,807111,808844,1733,10,N,N,-,-1,-1
MULIFE.txt,807377,808960,1583,10,N,N,-,-1,-1
MULIFE.txt,807501,809053,1552,10,N,N,-,-1,-1
MULIFE.txt,807618,809220,1602,10,N,N,-,-1,-1
MULIFE.txt,807868,809432,1564,10,N,N,-,-1,-1
MULIFE.txt,808115,809651,1536,10,N,N,-,-1,-1
MULIFE.txt,808230,809749,1519,10,N,N,-,-1,-1
MULIFE.txt,808587,809892,1305,10,N,N,-,-1,-1
MULIFE.txt,808676,809978,1302,10,N,N,-,-1,-1
MULIFE.txt,808739,810201,1462,10,N,N,-,-1,-1
MULIFE.txt,808845,810492,1647,10,N,N,-,-1,-1
MULIFE.txt,808961,810553,1592,10,N,N,-,-1,-1
MULIFE.txt,809054,810604,1550,10,N,N,-,-1,-1
MULIFE.txt,809221,810693,1472,10,N,N,-,-1,-1
MULIFE.txt,809435,810908,1473,10,N,N,-,-1,-1
MULIFE.txt,809653,811043,1390,10,N,N,-,-1,-1
MULIFE.txt,809750,811125,1375,10,N,N,-,-1,-1
MULIFE.txt,809893,811339,1446,10,N,N,-,-1,-1
MULIFE.txt,809979,811610,1631,10,N,N,-,-1,-1
MULIFE.txt,810202,811620,1418,10,N,N,-,-1,-1
MULIFE.txt,810495,811789,1294,10,N,N,-,-1,-1
MULIFE.txt,810555,811805,1250,10,N,N,-,-1,-1
MULIFE.txt,810605,811912,1307,10,N,N,-,-1,-1
MULIFE.txt,810694,812028,1334,10,N,N,-,-1,-1
MULIFE.txt,810910,812270,1360,10,N,N,-,-1,-1
MULIFE.txt,811044,812496,1452,10,N,N,-,-1,-1
MULIFE.txt,811126,812544,1418,10,N,N,-,-1,-1
MULIFE.txt,811340,812759,1419,10,N,N,-,-1,-1
MULIFE.txt,811613,812914,1301,10,N,N,-,-1,-1
MULIFE.txt,811623,812957,1334,10,N,N,-,-1,-1
MULIFE.txt,811790,813198,1408,10,N,N,-,-1,-1
MULIFE.txt,811806,813489,1683,10,N,N,-,-1,-1
MULIFE.txt,811913,813576,1663,10,N,N,-,-1,-1
MULIFE.txt,812031,813601,1570,10,N,N,-,-1,-1
MULIFE.txt,812272,813990,1718,10,N,N,-,-1,-1
MULIFE.txt,812497,814188,1691,10,N,N,-,-1,-1
MULIFE.txt,812545,814277,1732,10,N,N,-,-1,-1
MULIFE.txt,812760,814585,1825,10,N,N,-,-1,-1
MULIFE.txt,812915,814719,1804,10,N,N,-,-1,-1
MULIFE.txt,812958,814953,1995,10,N,N,-,-1,-1
MULIFE.txt,813199,815032,1833,10,N,N,-,-1,-1
MULIFE.txt,813492,815155,1663,10,N,N,-,-1,-1
MULIFE.txt,813577,815238,1661,10,N,N,-,-1,-1
MULIFE.txt,813602,815281,1679,10,N,N,-,-1,-1
MULIFE.txt,813991,815412,1421,10,N,N,-,-1,-1
MULIFE.txt,814189,815517,1328,10,N,N,-,-1,-1
MULIFE.txt,814278,815527,1249,10,N,N,-,-1,-1
MULIFE.txt,814586,815641,1055,10,N,N,-,-1,-1
MULIFE.txt,814720,815967,1247,10,N,N,-,-1,-1
MULIFE.txt,814956,816072,1116,10,N,N,-,-1,-1
MULIFE.txt,815033,816547,1514,10,N,N,-,-1,-1
MULIFE.txt,815158,816576,1418,10,N,N,-,-1,-1
MULIFE.txt,815239,816687,1448,10,N,N,-,-1,-1
MULIFE.txt,815282,816774,1492,10,N,N,-,-1,-1
MULIFE.txt,815415,816805,1390,10,N,N,-,-1,-1
MULIFE.txt,815518,816835,1317,10,N,N,-,-1,-1
MULIFE.txt,815528,816890,1362,10,N,N,-,-1,-1
MULIFE.txt,815642,817105,1463,10,N,N,-,-1,-1
MULIFE.txt,815968,817327,1359,10,N,N,-,-1,-1
MULIFE.txt,816073,817598,1525,10,N,N,-,-1,-1
MULIFE.txt,816550,817719,1169,10,N,N,-,-1,-1
MULIFE.txt,816577,817762,1185,10,N,N,-,-1,-1
MULIFE.txt,816690,817861,1171,10,N,N,-,-1,-1
MULIFE.txt,816775,817876,1101,10,N,N,-,-1,-1
MULIFE.txt,816806,818005,1199,10,N,N,-,-1,-1
MULIFE.txt,816836,818030,1194,10,N,N,-,-1,-1
MULIFE.txt,816891,818316,1425,10,N,N,-,-1,-1
MULIFE.txt,817106,818375,1269,10,N,N,-,-1,-1
MULIFE.txt,817328,818478,1150,10,N,N,-,-1,-1
MULIFE.txt,817601,818537,936,10,N,N,-,-1,-1
MULIFE.txt,817720,818663,943,10,N,N,-,-1,-1
MULIFE.txt,817763,818872,1109,10,N,N,-,-1,-1
MULIFE.txt,817862,819239,1377,10,N,N,-,-1,-1
MULIFE.txt,817877,819314,1437,10,N,N,-,-1,-1
MULIFE.txt,818006,819527,1521,10,N,N,-,-1,-1
MULIFE.txt,818031,819583,1552,10,N,N,-,-1,-1
MULIFE.txt,818318,819726,1408,10,N,N,-,-1,-1
MULIFE.txt,818377,819803,1426,10,N,N,-,-1,-1
MULIFE.txt,818479,820071,1592,10,N,N,-,-1,-1
MULIFE.txt,818538,820302,1764,10,N,N,-,-1,-1
MULIFE.txt,818664,820426,1762,10,N,N,-,-1,-1
MULIFE.txt,818873,820549,1676,10,N,N,-,-1,-1
MULIFE.txt,819241,820882,1641,10,N,N,-,-1,-1
MULIFE.txt,819317,821087,1770,10,N,N,-,-1,-1
MULIFE.txt,819528,821122,1594,10,N,N,-,-1,-1
MULIFE.txt,819586,821254,1668,10,N,N,-,-1,-1
MULIFE.txt,819729,821536,1807,10,N,N,-,-1,-1
MULIFE.txt,819804,821659,1855,10,N,N,-,-1,-1
MULIFE.txt,820072,821907,1835,10,Y,N,-,-1,-1
MULIFE.txt,820305,821914,1609,10,Y,N,-,-1,-1
MULIFE.txt,820427,822336,1909,10,Y,N,-,-1,-1
MULIFE.txt,820550,822497,1947,10,N,N,-,-1,-1
MULIFE.txt,820883,822558,1675,10,N,N,-,-1,-1
MULIFE.txt,821092,822641,1549,10,N,N,-,-1,-1
MULIFE.txt,821123,822809,1686,10,N,N,-,-1,-1
MULIFE.txt,821255,822862,1607,10,N,N,-,-1,-1
MULIFE.txt,821538,822931,1393,10,N,N,-,-1,-1
MULIFE.txt,821661,823036,1375,10,N,N,-,-1,-1
MULIFE.txt,821908,823177,1269,10,N,N,-,-1,-1
MULIFE.txt,821915,823270,1355,10,N,N,-,-1,-1
MULIFE.txt,822339,823379,1040,10,N,N,-,-1,-1
MULIFE.txt,822498,823496,998,10,N,N,-,-1,-1
MULIFE.txt,822559,823517,958,10,N,N,-,-1,-1
MULIFE.txt,822642,823646,1004,10,N,N,-,-1,-1
MULIFE.txt,822810,823758,948,10,N,N,-,-1,-1
MULIFE.txt,822863,823818,955,10,N,N,-,-1,-1
MULIFE.txt,822932,824112,1180,10,N,N,-,-1,-1
MULIFE.txt,823037,824196,1159,10,N,N,-,-1,-1
MULIFE.txt,823178,824295,1117,10,N,N,-,-1,-1
MULIFE.txt,823273,824306,1033,10,N,N,-,-1,-1
MULIFE.txt,823380,824431,1051,10,N,N,-,-1,-1
MULIFE.txt,823499,824493,994,10,N,N,-,-1,-1
MULIFE.txt,823518,824643,1125,10,N,N,-,-1,-1
MULIFE.txt,823647,824817,1170,10,N,N,-,-1,-1
MULIFE.txt,823759,824940,1181,10,N,N,-,-1,-1
MULIFE.txt,823819,825035,1216,10,N,N,-,-1,-1
MULIFE.txt,824115,825114,999,10,N,N,-,-1,-1
MULIFE.txt,824197,825208,1011,10,N,N,-,-1,-1
MULIFE.txt,824298,825271,973,10,N,N,-,-1,-1
MULIFE.txt,824309,825288,979,10,N,N,-,-1,-1
MULIFE.txt,824432,825613,1181,10,N,N,-,-1,-1
MULIFE.txt,824494,825676,1182,10,N,N,-,-1,-1
MULIFE.txt,824644,825738,1094,10,N,N,-,-1,-1
MULIFE.txt,824818,825974,1156,10,N,N,-,-1,-1
MULIFE.txt,824941,826245,1304,10,N,N,-,-1,-1
MULIFE.txt,825036,826254,1218,10,N,N,-,-1,-1
MULIFE.txt,825116,826582,1466,10,N,N,-,-1,-1
MULIFE.txt,825209,826863,1654,10,N,N,-,-1,-1
MULIFE.txt,825272,827161,1889,10,N,N,-,-1,-1
MULIFE.txt,825290,827183,1893,10,N,N,-,-1,-1
MULIFE.txt,825614,827297,1683,10,N,N,-,-1,-1
MULIFE.txt,825679,827350,1671,10,N,N,-,-1,-1
MULIFE.txt,825740,827419,1679,10,N,N,-,-1,-1
MULIFE.txt,825977,827429,1452,10,N,N,-,-1,-1
MULIFE.txt,826246,827431,1185,10,N,N,-,-1,-1
MULIFE.txt,826255,827540,1285,10,N,N,-,-1,-1
MULIFE.txt,826583,827620,1037,10,N,N,-,-1,-1
MULIFE.txt,826864,827651,787,10,N,N,-,-1,-1
MULIFE.txt,827166,827664,498,10,N,N,-,-1,-1
MULIFE.txt,827184,827712,528,10,N,N,-,-1,-1
MULIFE.txt,827300,827928,628,10,N,N,-,-1,-1
MULIFE.txt,827353,828014,661,10,N,N,-,-1,-1
MULIFE.txt,827420,828032,612,10,N,N,-,-1,-1
MULIFE.txt,827430,828061,631,10,N,N,-,-1,-1
MULIFE.txt,827432,828184,752,10,N,N,-,-1,-1
MULIFE.txt,827543,828369,826,10,N,N,-,-1,-1
MULIFE.txt,827621,828512,891,10,N,N,-,-1,-1
MULIFE.txt,827654,828605,951,10,N,N,-,-1,-1
MULIFE.txt,827665,828623,958,10,N,N,-,-1,-1
MULIFE.txt,827715,828745,1030,10,N,N,-,-1,-1
MULIFE.txt,827929,828833,904,10,N,N,-,-1,-1
MULIFE.txt,828017,828941,924,10,N,N,-,-1,-1
MULIFE.txt,828033,829023,990,10,N,N,-,-1,-1
MULIFE.txt,828064,829126,1062,10,N,N,-,-1,-1
MULIFE.txt,828185,829217,1032,10,N,N,-,-1,-1
MULIFE.txt,828370,829295,925,10,N,N,-,-1,-1
MULIFE.txt,828515,829386,871,10,N,N,-,-1,-1
MULIFE.txt,828606,829445,839,10,N,N,-,-1,-1
MULIFE.txt,828624,829557,933,10,N,N,-,-1,-1
MULIFE.txt,828746,829576,830,10,N,N,-,-1,-1
MULIFE.txt,828834,829607,773,10,N,N,-,-1,-1
MULIFE.txt,828942,829680,738,10,N,N,-,-1,-1
MULIFE.txt,829024,829699,675,10,N,N,-,-1,-1
MULIFE.txt,829127,829910,783,10,N,N,-,-1,-1
MULIFE.txt,829218,829990,772,10,N,N,-,-1,-1
MULIFE.txt,829296,830094,798,10,N,N,-,-1,-1
MULIFE.txt,829387,830111,724,10,N,N,-,-1,-1
MULIFE.txt,829446,830286,840,10,N,N,-,-1,-1
MULIFE.txt,829558,830444,886,10,N,N,-,-1,-1
MULIFE.txt,829577,830695,1118,10,N,N,-,-1,-1
MULIFE.txt,829608,830822,1214,10,N,N,-,-1,-1
MULIFE.txt,829681,830881,1200,10,N,N,-,-1,-1
MULIFE.txt,829700,830936,1236,10,Y,N,-,-1,-1
MULIFE.txt,829911,831041,1130,10,N,N,-,-1,-1
MULIFE.txt,829991,831150,1159,10,N,N,-,-1,-1
MULIFE.txt,830095,831240,1145,10,N,N,-,-1,-1
MULIFE.txt,830112,831347,1235,10,N,N,-,-1,-1
MULIFE.txt,830287,831396,1109,10,N,N,-,-1,-1
MULIFE.txt,830445,831647,1202,10,N,N,-,-1,-1
MULIFE.txt,830696,831713,1017,10,N,N,-,-1,-1
MULIFE.txt,830823,831767,944,10,N,N,-,-1,-1
MULIFE.txt,830882,831790,908,10,N,N,-,-1,-1
MULIFE.txt,830937,832038,1101,10,N,N,-,-1,-1
MULIFE.txt,831042,832074,1032,10,N,N,-,-1,-1
MULIFE.txt,831151,832115,964,10,N,N,-,-1,-1
MULIFE.txt,831241,832128,887,10,N,N,-,-1,-1
MULIFE.txt,831348,832206,858,10,N,N,-,-1,-1
MULIFE.txt,831397,832247,850,10,N,N,-,-1,-1
MULIFE.txt,831648,832341,693,10,N,N,-,-1,-1
MULIFE.txt,831714,832534,820,10,N,N,-,-1,-1
MULIFE.txt,831768,832567,799,10,N,N,-,-1,-1
MULIFE.txt,831791,832676,885,10,N,N,-,-1,-1
MULIFE.txt,832039,832753,714,10,N,N,-,-1,-1
MULIFE.txt,832075,832804,729,10,N,N,-,-1,-1
MULIFE.txt,832116,832866,750,10,N,N,-,-1,-1
MULIFE.txt,832129,832926,797,10,N,N,-,-1,-1
MULIFE.txt,832208,833019,811,10,N,N,-,-1,-1
MULIFE.txt,832248,833048,800,10,N,N,-,-1,-1
MULIFE.txt,832342,833187,845,10,N,N,-,-1,-1
MULIFE.txt,832535,833237,702,10,N,N,-,-1,-1
MULIFE.txt,832569,833347,778,10,N,N,-,-1,-1
MULIFE.txt,832677,833564,887,10,N,N,-,-1,-1
MULIFE.txt,832754,833750,996,10,N,N,-,-1,-1
MULIFE.txt,832805,833823,1018,10,N,N,-,-1,-1
MULIFE.txt,832867,833909,1042,10,N,N,-,-1,-1
MULIFE.txt,832927,834116,1189,10,N,N,-,-1,-1
MULIFE.txt,833020,834172,1152,10,N,N,-,-1,-1
MULIFE.txt,833049,834217,1168,10,N,N,-,-1,-1
MULIFE.txt,833188,834243,1055,10,N,N,-,-1,-1
MULIFE.txt,833238,834369,1131,10,N,N,-,-1,-1
MULIFE.txt,833348,834405,1057,10,N,N,-,-1,-1
MULIFE.txt,833565,834589,1024,10,N,N,-,-1,-1
MULIFE.txt,833751,834753,1002,10,N,N,-,-1,-1
MULIFE.txt,833824,834922,1098,10,N,N,-,-1,-1
MULIFE.txt,833912,835410,1498,10,N,N,-,-1,-1
MULIFE.txt,834119,835439,1320,10,N,N,-,-1,-1
MULIFE.txt,834173,835451,1278,10,N,N,-,-1,-1
MULIFE.txt,834218,835464,1246,10,N,N,-,-1,-1
MULIFE.txt,834244,835591,1347,10,N,N,-,-1,-1
MULIFE.txt,834370,835704,1334,10,N,N,-,-1,-1
MULIFE.txt,834406,835987,1581,10,N,N,-,-1,-1
MULIFE.txt,834591,836156,1565,10,N,N,-,-1,-1
MULIFE.txt,834754,836218,1464,10,N,N,-,-1,-1
MULIFE.txt,834923,836329,1406,10,N,N,-,-1,-1
MULIFE.txt,835415,836461,1046,10,N,N,-,-1,-1
MULIFE.txt,835440,836605,1165,10,N,N,-,-1,-1
MULIFE.txt,835454,836702,1248,10,N,N,-,-1,-1
MULIFE.txt,835467,836704,1237,10,N,N,-,-1,-1
MULIFE.txt,835592,836752,1160,10,N,N,-,-1,-1
MULIFE.txt,835705,836807,1102,10,N,N,-,-1,-1
MULIFE.txt,835988,836887,899,10,N,N,-,-1,-1
MULIFE.txt,836157,837014,857,10,N,N,-,-1,-1
MULIFE.txt,836219,837214,995,10,N,N,-,-1,-1
MULIFE.txt,836332,837308,976,10,N,N,-,-1,-1
MULIFE.txt,836464,837512,1048,10,N,N,-,-1,-1
MULIFE.txt,836606,837766,1160,10,N,N,-,-1,-1
MULIFE.txt,836703,837871,1168,10,N,N,-,-1,-1
MULIFE.txt,836707,837906,1199,10,N,N,-,-1,-1
MULIFE.txt,836753,837954,1201,10,N,N,-,-1,-1
MULIFE.txt,836808,837979,1171,10,N,N,-,-1,-1
MULIFE.txt,836888,838169,1281,10,N,N,-,-1,-1
MULIFE.txt,837015,838247,1232,10,N,N,-,-1,-1
MULIFE.txt,837216,838379,1163,10,N,N,-,-1,-1
MULIFE.txt,837309,838428,1119,10,N,N,-,-1,-1
MULIFE.txt,837515,838663,1148,10,N,N,-,-1,-1
MULIFE.txt,837769,838877,1108,10,N,N,-,-1,-1
MULIFE.txt,837872,838988,1116,10,N,N,-,-1,-1
MULIFE.txt,837907,839187,1280,10,N,N,-,-1,-1
MULIFE.txt,837955,839283,1328,10,N,N,-,-1,-1
MULIFE.txt,837980,839351,1371,10,N,N,-,-1,-1
MULIFE.txt,838170,839473,1303,10,N,N,-,-1,-1
MULIFE.txt,838248,839617,1369,10,N,N,-,-1,-1
MULIFE.txt,838382,839743,1361,10,N,N,-,-1,-1
MULIFE.txt,838429,839756,1327,10,N,N,-,-1,-1
MULIFE.txt,838666,839809,1143,10,N,N,-,-1,-1
MULIFE.txt,838880,839929,1049,10,N,N,-,-1,-1
MULIFE.txt,838991,839931,940,10,N,N,-,-1,-1
MULIFE.txt,839188,840091,903,10,N,N,-,-1,-1
MULIFE.txt,839285,840282,997,10,N,N,-,-1,-1
MULIFE.txt,839352,840399,1047,10,N,N,-,-1,-1
MULIFE.txt,839476,840483,1007,10,N,N,-,-1,-1
MULIFE.txt,839620,840559,939,10,N,N,-,-1,-1
MULIFE.txt,839744,840622,878,10,N,N,-,-1,-1
MULIFE.txt,839757,840681,924,10,N,N,-,-1,-1
MULIFE.txt,839810,840722,912,10,N,N,-,-1,-1
MULIFE.txt,839930,840765,835,10,N,N,-,-1,-1
MULIFE.txt,839932,840841,909,10,N,N,-,-1,-1
MULIFE.txt,840092,840960,868,10,N,N,-,-1,-1
MULIFE.txt,840283,841049,766,10,N,N,-,-1,-1
MULIFE.txt,840400,841126,726,10,N,N,-,-1,-1
MULIFE.txt,840484,841293,809,10,N,N,-,-1,-1
MULIFE.txt,840560,841379,819,10,N,N,-,-1,-1
MULIFE.txt,840623,841415,792,10,N,N,-,-1,-1
MULIFE.txt,840682,841535,853,10,N,N,-,-1,-1
MULIFE.txt,840723,841583,860,10,N,N,-,-1,-1
MULIFE.txt,840766,841590,824,10,N,N,-,-1,-1
MULIFE.txt,840842,841645,803,10,N,N,-,-1,-1
MULIFE.txt,840961,841732,771,10,N,N,-,-1,-1
MULIFE.txt,841052,841820,768,10,N,N,-,-1,-1
MULIFE.txt,841127,841892,765,10,N,N,-,-1,-1
MULIFE.txt,841296,841980,684,10,N,N,-,-1,-1
MULIFE.txt,841380,842187,807,10,N,N,-,-1,-1
MULIFE.txt,841416,842280,864,10,N,N,-,-1,-1
MULIFE.txt,841536,842299,763,10,N,N,-,-1,-1
MULIFE.txt,841586,842400,814,10,N,N,-,-1,-1
MULIFE.txt,841591,842707,1116,10,N,N,-,-1,-1
MULIFE.txt,841648,842891,1243,10,N,N,-,-1,-1
MULIFE.txt,841733,843176,1443,10,N,N,-,-1,-1
MULIFE.txt,841821,843311,1490,10,N,N,-,-1,-1
MULIFE.txt,841895,843660,1765,10,N,N,-,-1,-1
MULIFE.txt,841981,843742,1761,10,N,N,-,-1,-1
MULIFE.txt,842188,843745,1557,10,N,N,-,-1,-1
MULIFE.txt,842285,843860,1575,10,N,N,-,-1,-1
MULIFE.txt,842302,843993,1691,10,N,N,-,-1,-1
MULIFE.txt,842403,844057,1654,10,N,N,-,-1,-1
MULIFE.txt,842710,844194,1484,10,N,N,-,-1,-1
MULIFE.txt,842892,844243,1351,10,N,N,-,-1,-1
MULIFE.txt,843179,844427,1248,10,N,N,-,-1,-1
MULIFE.txt,843312,844475,1163,10,N,N,-,-1,-1
MULIFE.txt,843661,844534,873,10,N,N,-,-1,-1
MULIFE.txt,843743,844738,995,10,N,N,-,-1,-1
MULIFE.txt,843745,844808,1063,10,N,N,-,-1,-1
MULIFE.txt,843861,844913,1052,10,N,N,-,-1,-1
MULIFE.txt,843994,844982,988,10,N,N,-,-1,-1
MULIFE.txt,844058,845004,946,10,N,N,-,-1,-1
MULIFE.txt,844195,845076,881,10,N,N,-,-1,-1
MULIFE.txt,844244,845107,863,10,N,N,-,-1,-1
MULIFE.txt,844428,845302,874,10,N,N,-,-1,-1
MULIFE.txt,844476,845380,904,10,N,N,-,-1,-1
MULIFE.txt,844535,845826,1291,10,N,N,-,-1,-1
MULIFE.txt,844739,845836,1097,10,N,N,-,-1,-1
MULIFE.txt,844809,846153,1344,10,N,N,-,-1,-1
MULIFE.txt,844916,846307,1391,10,N,N,-,-1,-1
MULIFE.txt,844983,846449,1466,10,N,N,-,-1,-1
MULIFE.txt,845007,846552,1545,10,N,N,-,-1,-1
MULIFE.txt,845077,846742,1665,10,N,N,-,-1,-1
MULIFE.txt,845110,846812,1702,10,N,N,-,-1,-1
MULIFE.txt,845305,846881,1576,10,N,N,-,-1,-1
MULIFE.txt,845383,846923,1540,10,N,N,-,-1,-1
MULIFE.txt,845827,847076,1249,10,N,N,-,-1,-1
MULIFE.txt,845839,847183,1344,10,N,N,-,-1,-1
MULIFE.txt,846154,847349,1195,10,N,N,-,-1,-1
MULIFE.txt,846308,847491,1183,10,Y,N,-,-1,-1
MULIFE.txt,846452,847668,1216,10,Y,N,-,-1,-1
MULIFE.txt,846554,848223,1669,10,Y,N,-,-1,-1
MULIFE.txt,846745,848461,1716,10,Y,N,-,-1,-1
MULIFE.txt,846815,848570,1755,10,Y,N,-,-1,-1
MULIFE.txt,846882,848846,1964,10,Y,N,-,-1,-1
MULIFE.txt,846924,848855,1931,10,Y,N,-,-1,-1
MULIFE.txt,847077,848995,1918,10,Y,N,-,-1,-1
MULIFE.txt,847186,849023,1837,10,N,N,-,-1,-1
MULIFE.txt,847350,849092,1742,10,N,N,-,-1,-1
MULIFE.txt,847492,849272,1780,10,N,N,-,-1,-1
MULIFE.txt,847669,849351,1682,10,N,N,-,-1,-1
MULIFE.txt,848226,849487,1261,10,N,N,-,-1,-1
MULIFE.txt,848462,849663,1201,10,N,N,-,-1,-1
MULIFE.txt,848571,850037,1466,10,N,N,-,-1,-1
MULIFE.txt,848849,850549,1700,10,N,N,-,-1,-1
MULIFE.txt,848858,850662,1804,10,N,N,-,-1,-1
MULIFE.txt,848996,850866,1870,10,N,N,-,-1,-1
MULIFE.txt,849026,851017,1991,10,N,N,-,-1,-1
MULIFE.txt,849093,851105,2012,10,N,N,-,-1,-1
MULIFE.txt,849273,851188,1915,10,N,N,-,-1,-1
MULIFE.txt,849354,851210,1856,10,N,N,-,-1,-1
MULIFE.txt,849488,851276,1788,10,N,N,-,-1,-1
MULIFE.txt,849664,851405,1741,10,N,N,-,-1,-1
MULIFE.txt,850038,851508,1470,10,N,N,-,-1,-1
MULIFE.txt,850550,851659,1109,10,N,N,-,-1,-1
MULIFE.txt,850665,851765,1100,10,N,N,-,-1,-1
MULIFE.txt,850867,851846,979,10,N,N,-,-1,-1
MULIFE.txt,851019,852084,1065,10,N,N,-,-1,-1
MULIFE.txt,851108,852118,1010,10,N,N,-,-1,-1
MULIFE.txt,851189,852147,958,10,N,N,-,-1,-1
MULIFE.txt,851211,852196,985,10,N,N,-,-1,-1
MULIFE.txt,851278,852240,962,10,N,N,-,-1,-1
MULIFE.txt,851408,852339,931,10,N,N,-,-1,-1
MULIFE.txt,851509,852390,881,10,N,N,-,-1,-1
MULIFE.txt,851660,852411,751,10,N,N,-,-1,-1
MULIFE.txt,851766,852532,766,10,N,N,-,-1,-1
MULIFE.txt,851847,852683,836,10,N,N,-,-1,-1
MULIFE.txt,852085,852716,631,10,N,N,-,-1,-1
MULIFE.txt,852119,852792,673,10,N,N,-,-1,-1
MULIFE.txt,852148,852899,751,10,N,N,-,-1,-1
MULIFE.txt,852197,852973,776,10,N,N,-,-1,-1
MULIFE.txt,852241,853249,1008,10,N,N,-,-1,-1
MULIFE.txt,852340,853298,958,10,N,N,-,-1,-1
MULIFE.txt,852391,853333,942,10,N,N,-,-1,-1
MULIFE.txt,852412,853481,1069,10,N,N,-,-1,-1
MULIFE.txt,852533,853505,972,10,N,N,-,-1,-1
MULIFE.txt,852684,853574,890,10,N,N,-,-1,-1
MULIFE.txt,852719,853677,958,10,N,N,-,-1,-1
MULIFE.txt,852793,853766,973,10,N,N,-,-1,-1
MULIFE.txt,852900,853790,890,10,N,N,-,-1,-1
MULIFE.txt,852974,853849,875,10,N,N,-,-1,-1
MULIFE.txt,853252,853955,703,10,N,N,-,-1,-1
MULIFE.txt,853299,853977,678,10,N,N,-,-1,-1
MULIFE.txt,853334,854025,691,10,N,N,-,-1,-1
MULIFE.txt,853483,854042,559,10,N,N,-,-1,-1
MULIFE.txt,853506,854069,563,10,N,N,-,-1,-1
MULIFE.txt,853577,854102,525,10,N,N,-,-1,-1
MULIFE.txt,853680,854232,552,10,N,N,-,-1,-1
MULIFE.txt,853767,854369,602,10,N,N,-,-1,-1
MULIFE.txt,853791,854421,630,10,N,N,-,-1,-1
MULIFE.txt,853850,854486,636,10,N,N,-,-1,-1
MULIFE.txt,853956,854546,590,10,N,N,-,-1,-1
MULIFE.txt,853980,854760,780,10,N,N,-,-1,-1
MULIFE.txt,854026,854971,945,10,N,N,-,-1,-1
MULIFE.txt,854043,854996,953,10,N,N,-,-1,-1
MULIFE.txt,854072,855033,961,10,N,N,-,-1,-1
MULIFE.txt,854103,855136,1033,10,N,N,-,-1,-1
MULIFE.txt,854233,855206,973,10,N,N,-,-1,-1
MULIFE.txt,854370,855261,891,10,N,N,-,-1,-1
MULIFE.txt,854422,855277,855,10,N,N,-,-1,-1
MULIFE.txt,854487,855326,839,10,N,N,-,-1,-1
MULIFE.txt,854547,855373,826,10,N,N,-,-1,-1
MULIFE.txt,854761,855402,641,10,N,N,-,-1,-1
MULIFE.txt,854972,855422,450,10,N,N,-,-1,-1
MULIFE.txt,854998,855521,523,10,N,N,-,-1,-1
MULIFE.txt,855035,855531,496,10,N,N,-,-1,-1
MULIFE.txt,855137,855545,408,10,N,N,-,-1,-1
MULIFE.txt,855207,855587,380,10,N,N,-,-1,-1
MULIFE.txt,855262,855649,387,10,N,N,-,-1,-1
MULIFE.txt,855278,855696,418,10,N,N,-,-1,-1
MULIFE.txt,855327,855756,429,10,N,N,-,-1,-1
MULIFE.txt,855378,855763,385,10,N,N,-,-1,-1
MULIFE.txt,855403,855770,367,10,N,N,-,-1,-1
MULIFE.txt,855423,855776,353,10,N,N,-,-1,-1
MULIFE.txt,855522,855788,266,10,N,N,-,-1,-1
MULIFE.txt,855532,856173,641,10,N,N,-,-1,-1
MULIFE.txt,855546,856358,812,10,N,N,-,-1,-1
MULIFE.txt,855588,856409,821,10,N,N,-,-1,-1
MULIFE.txt,855650,856499,849,10,N,N,-,-1,-1
MULIFE.txt,855698,856571,873,10,N,N,-,-1,-1
MULIFE.txt,855757,856607,850,10,N,N,-,-1,-1
MULIFE.txt,855764,856775,1011,10,Y,N,-,-1,-1
MULIFE.txt,855771,856794,1023,10,Y,N,-,-1,-1
MULIFE.txt,855777,857037,1260,10,Y,N,-,-1,-1
MULIFE.txt,855789,857379,1590,10,Y,N,-,-1,-1
MULIFE.txt,856176,857444,1268,10,N,N,-,-1,-1
MULIFE.txt,856361,857593,1232,10,N,N,-,-1,-1
MULIFE.txt,856410,857866,1456,10,N,N,-,-1,-1
MULIFE.txt,856500,857995,1495,10,N,N,-,-1,-1
MULIFE.txt,856572,858056,1484,10,N,N,-,-1,-1
MULIFE.txt,856608,858096,1488,10,N,N,-,-1,-1
MULIFE.txt,856780,858115,1335,10,N,N,-,-1,-1
MULIFE.txt,856797,858432,1635,10,N,N,-,-1,-1
MULIFE.txt,857038,858504,1466,10,N,N,-,-1,-1
MULIFE.txt,857382,858598,1216,10,N,N,-,-1,-1
MULIFE.txt,857445,858679,1234,10,N,N,-,-1,-1
MULIFE.txt,857594,858832,1238,10,N,N,-,-1,-1
MULIFE.txt,857869,858875,1006,10,N,N,-,-1,-1
MULIFE.txt,857996,858994,998,10,N,N,-,-1,-1
MULIFE.txt,858057,859235,1178,10,N,N,-,-1,-1
MULIFE.txt,858099,859674,1575,10,N,N,-,-1,-1
MULIFE.txt,858116,859782,1666,10,N,N,-,-1,-1
MULIFE.txt,858435,860058,1623,10,N,N,-,-1,-1
MULIFE.txt,858505,860068,1563,10,N,N,-,-1,-1
MULIFE.txt,858599,860146,1547,10,N,N,-,-1,-1
MULIFE.txt,858680,860238,1558,10,N,N,-,-1,-1
MULIFE.txt,858833,860388,1555,10,N,N,-,-1,-1
MULIFE.txt,858878,860537,1659,10,N,N,-,-1,-1
MULIFE.txt,858997,860610,1613,10,N,N,-,-1,-1
MULIFE.txt,859238,860681,1443,10,N,N,-,-1,-1
MULIFE.txt,859677,860759,1082,10,N,N,-,-1,-1
MULIFE.txt,859783,860850,1067,10,N,N,-,-1,-1
MULIFE.txt,860061,860954,893,10,N,N,-,-1,-1
MULIFE.txt,860071,861045,974,10,N,N,-,-1,-1
MULIFE.txt,860147,861140,993,10,N,N,-,-1,-1
MULIFE.txt,860241,861218,977,10,N,N,-,-1,-1
MULIFE.txt,860391,861254,863,10,N,N,-,-1,-1
MULIFE.txt,860538,861324,786,10,N,N,-,-1,-1
MULIFE.txt,860611,861455,844,10,N,N,-,-1,-1
MULIFE.txt,860683,861474,791,10,N,N,-,-1,-1
MULIFE.txt,860760,861481,721,10,N,N,-,-1,-1
MULIFE.txt,860851,861496,645,10,N,N,-,-1,-1
MULIFE.txt,860955,861514,559,10,N,N,-,-1,-1
MULIFE.txt,861046,861556,510,10,N,N,-,-1,-1
MULIFE.txt,861141,861813,672,10,N,N,-,-1,-1
MULIFE.txt,861219,861901,682,10,N,N,-,-1,-1
MULIFE.txt,861255,862130,875,10,N,N,-,-1,-1
MULIFE.txt,861327,862270,943,10,N,N,-,-1,-1
MULIFE.txt,861456,862523,1067,10,N,N,-,-1,-1
MULIFE.txt,861475,862642,1167,10,N,N,-,-1,-1
MULIFE.txt,861482,862701,1219,10,N,N,-,-1,-1
MULIFE.txt,861499,862773,1274,10,N,N,-,-1,-1
MULIFE.txt,861515,862816,1301,10,N,N,-,-1,-1
MULIFE.txt,861559,863004,1445,10,N,N,-,-1,-1
MULIFE.txt,861816,863435,1619,10,N,N,-,-1,-1
MULIFE.txt,861902,863574,1672,10,N,N,-,-1,-1
MULIFE.txt,862131,863649,1518,10,N,N,-,-1,-1
MULIFE.txt,862273,863985,1712,10,N,N,-,-1,-1
MULIFE.txt,862526,864008,1482,10,N,N,-,-1,-1
MULIFE.txt,862645,864112,1467,10,N,N,-,-1,-1
MULIFE.txt,862703,864235,1532,10,N,N,-,-1,-1
MULIFE.txt,862774,864327,1553,10,N,N,-,-1,-1
MULIFE.txt,862819,864469,1650,10,N,N,-,-1,-1
MULIFE.txt,863007,864639,1632,10,N,N,-,-1,-1
MULIFE.txt,863436,865019,1583,10,N,N,-,-1,-1
MULIFE.txt,863575,865151,1576,10,N,N,-,-1,-1
MULIFE.txt,863650,865238,1588,10,N,N,-,-1,-1
MULIFE.txt,863990,865483,1493,10,N,N,-,-1,-1
MULIFE.txt,864009,865502,1493,10,N,N,-,-1,-1
MULIFE.txt,864113,865680,1567,10,N,N,-,-1,-1
MULIFE.txt,864236,865847,1611,10,N,N,-,-1,-1
MULIFE.txt,864330,865921,1591,10,N,N,-,-1,-1
MULIFE.txt,864470,866017,1547,10,N,N,-,-1,-1
MULIFE.txt,864640,866299,1659,10,N,N,-,-1,-1
MULIFE.txt,865022,866420,1398,10,N,N,-,-1,-1
MULIFE.txt,865152,866477,1325,10,N,N,-,-1,-1
MULIFE.txt,865241,866785,1544,10,N,N,-,-1,-1
MULIFE.txt,865488,866893,1405,10,N,N,-,-1,-1
MULIFE.txt,865505,866909,1404,10,N,N,-,-1,-1
MULIFE.txt,865683,866922,1239,10,N,N,-,-1,-1
MULIFE.txt,865850,867077,1227,10,N,N,-,-1,-1
MULIFE.txt,865922,867107,1185,10,N,N,-,-1,-1
MULIFE.txt,866019,867120,1101,10,N,N,-,-1,-1
MULIFE.txt,866300,867151,851,10,N,N,-,-1,-1
MULIFE.txt,866421,867195,774,10,N,N,-,-1,-1
MULIFE.txt,866478,867246,768,10,N,N,-,-1,-1
MULIFE.txt,866788,867283,495,10,N,N,-,-1,-1
MULIFE.txt,866898,867300,402,10,N,N,-,-1,-1
MULIFE.txt,866910,867305,395,10,N,N,-,-1,-1
MULIFE.txt,866923,867367,444,10,N,N,-,-1,-1
MULIFE.txt,867078,867596,518,10,N,N,-,-1,-1
MULIFE.txt,867108,867946,838,10,N,N,-,-1,-1
MULIFE.txt,867121,867959,838,10,N,N,-,-1,-1
MULIFE.txt,867154,867988,834,10,N,N,-,-1,-1
MULIFE.txt,867196,868126,930,10,N,N,-,-1,-1
MULIFE.txt,867247,868271,1024,10,N,N,-,-1,-1
MULIFE.txt,867284,868407,1123,10,N,N,-,-1,-1
MULIFE.txt,867301,868490,1189,10,N,N,-,-1,-1
MULIFE.txt,867306,868814,1508,10,N,N,-,-1,-1
MULIFE.txt,867370,868944,1574,10,N,N,-,-1,-1
MULIFE.txt,867599,869040,1441,10,N,N,-,-1,-1
MULIFE.txt,867947,869121,1174,10,N,N,-,-1,-1
MULIFE.txt,867960,869294,1334,10,N,N,-,-1,-1
MULIFE.txt,867989,869543,1554,10,N,N,-,-1,-1
MULIFE.txt,868127,869639,1512,10,N,N,-,-1,-1
MULIFE.txt,868272,869916,1644,10,N,N,-,-1,-1
MULIFE.txt,868410,869928,1518,10,N,N,-,-1,-1
MULIFE.txt,868491,869964,1473,10,N,N,-,-1,-1
MULIFE.txt,868817,870077,1260,10,N,N,-,-1,-1
MULIFE.txt,868945,870168,1223,10,N,N,-,-1,-1
MULIFE.txt,869043,870597,1554,10,N,N,-,-1,-1
MULIFE.txt,869122,870786,1664,10,N,N,-,-1,-1
MULIFE.txt,869295,871000,1705,10,N,N,-,-1,-1
MULIFE.txt,869544,871044,1500,10,N,N,-,-1,-1
MULIFE.txt,869640,871124,1484,10,N,N,-,-1,-1
MULIFE.txt,869917,871140,1223,10,N,N,-,-1,-1
MULIFE.txt,869929,871240,1311,10,N,N,-,-1,-1
MULIFE.txt,869965,871365,1400,10,N,N,-,-1,-1
MULIFE.txt,870078,871409,1331,10,N,N,-,-1,-1
MULIFE.txt,870169,871446,1277,10,N,N,-,-1,-1
MULIFE.txt,870598,871468,870,10,N,N,-,-1,-1
MULIFE.txt,870787,871492,705,10,N,N,-,-1,-1
MULIFE.txt,871001,871577,576,10,N,N,-,-1,-1
MULIFE.txt,871045,871611,566,10,N,N,-,-1,-1
MULIFE.txt,871125,871623,498,10,N,N,-,-1,-1
MULIFE.txt,871141,871694,553,10,N,N,-,-1,-1
MULIFE.txt,871241,871744,503,10,N,N,-,-1,-1
MULIFE.txt,871368,871840,472,10,N,N,-,-1,-1
MULIFE.txt,871410,871920,510,10,N,N,-,-1,-1
MULIFE.txt,871449,871942,493,10,N,N,-,-1,-1
MULIFE.txt,871469,871992,523,10,N,N,-,-1,-1
MULIFE.txt,871493,872263,770,10,N,N,-,-1,-1
MULIFE.txt,871578,872274,696,10,N,N,-,-1,-1
MULIFE.txt,871613,872378,765,10,N,N,-,-1,-1
MULIFE.txt,871624,872529,905,10,N,N,-,-1,-1
MULIFE.txt,871695,872585,890,10,N,N,-,-1,-1
MULIFE.txt,871745,872739,994,10,N,N,-,-1,-1
MULIFE.txt,871841,872803,962,10,N,N,-,-1,-1
MULIFE.txt,871921,873185,1264,10,N,N,-,-1,-1
MULIFE.txt,871943,873518,1575,10,N,N,-,-1,-1
MULIFE.txt,871993,873587,1594,10,N,N,-,-1,-1
MULIFE.txt,872266,873628,1362,10,N,N,-,-1,-1
MULIFE.txt,872277,873759,1482,10,N,N,-,-1,-1
MULIFE.txt,872379,873785,1406,10,N,N,-,-1,-1
MULIFE.txt,872530,873818,1288,10,N,N,-,-1,-1
MULIFE.txt,872588,873828,1240,10,N,N,-,-1,-1
MULIFE.txt,872740,873851,1111,10,N,N,-,-1,-1
MULIFE.txt,872804,873890,1086,10,N,N,-,-1,-1
MULIFE.txt,873188,873971,783,10,N,N,-,-1,-1
MULIFE.txt,873519,874097,578,10,N,N,-,-1,-1
MULIFE.txt,873590,874163,573,10,N,N,-,-1,-1
MULIFE.txt,873629,874344,715,10,N,N,-,-1,-1
MULIFE.txt,873762,874613,851,10,N,N,-,-1,-1
MULIFE.txt,873786,874655,869,10,N,N,-,-1,-1
MULIFE.txt,873821,874768,947,10,N,N,-,-1,-1
MULIFE.txt,873829,874990,1161,10,N,N,-,-1,-1
MULIFE.txt,873854,875131,1277,10,N,N,-,-1,-1
MULIFE.txt,873891,875216,1325,10,N,N,-,-1,-1
MULIFE.txt,873973,875356,1383,10,N,N,-,-1,-1
MULIFE.txt,874098,875427,1329,10,N,N,-,-1,-1
MULIFE.txt,874164,875482,1318,10,N,N,-,-1,-1
MULIFE.txt,874347,875541,1194,10,N,N,-,-1,-1
MULIFE.txt,874616,875580,964,10,N,N,-,-1,-1
MULIFE.txt,874658,875670,1012,10,N,N,-,-1,-1
MULIFE.txt,874770,875746,976,10,N,N,-,-1,-1
MULIFE.txt,874993,875777,784,10,N,N,-,-1,-1
MULIFE.txt,875132,875787,655,10,N,N,-,-1,-1
MULIFE.txt,875217,875845,628,10,N,N,-,-1,-1
MULIFE.txt,875359,875864,505,10,N,N,-,-1,-1
MULIFE.txt,875428,875901,473,10,N,N,-,-1,-1
MULIFE.txt,875483,875994,511,10,N,N,-,-1,-1
MULIFE.txt,875542,876041,499,10,N,N,-,-1,-1
MULIFE.txt,875581,876122,541,10,N,N,-,-1,-1
MULIFE.txt,875673,876274,601,10,N,N,-,-1,-1
MULIFE.txt,875747,876294,547,10,N,N,-,-1,-1
MULIFE.txt,875778,876359,581,10,N,N,-,-1,-1
MULIFE.txt,875788,876374,586,10,N,N,-,-1,-1
MULIFE.txt,875848,876405,557,10,N,N,-,-1,-1
MULIFE.txt,875865,876449,584,10,N,N,-,-1,-1
MULIFE.txt,875903,876492,589,10,N,N,-,-1,-1
MULIFE.txt,875995,876556,561,10,N,N,-,-1,-1
MULIFE.txt,876042,876602,560,10,N,N,-,-1,-1
MULIFE.txt,876123,876716,593,10,N,N,-,-1,-1
MULIFE.txt,876277,876765,488,10,N,N,-,-1,-1
MULIFE.txt,876295,876816,521,10,N,N,-,-1,-1
MULIFE.txt,876360,876851,491,10,N,N,-,-1,-1
MULIFE.txt,876375,876873,498,10,N,N,-,-1,-1
MULIFE.txt,876406,876931,525,10,N,N,-,-1,-1
MULIFE.txt,876450,876969,519,10,N,N,-,-1,-1
MULIFE.txt,876495,876988,493,10,N,N,-,-1,-1
MULIFE.txt,876557,877007,450,10,N,N,-,-1,-1
MULIFE.txt,876604,877167,563,10,N,N,-,-1,-1
MULIFE.txt,876717,877206,489,10,N,N,-,-1,-1
MULIFE.txt,876766,877223,457,10,N,N,-,-1,-1
MULIFE.txt,876819,877325,506,10,N,N,-,-1,-1
MULIFE.txt,876852,877402,550,10,N,N,-,-1,-1
MULIFE.txt,876876,877427,551,10,N,N,-,-1,-1
MULIFE.txt,876931,877511,580,10,N,N,-,-1,-1
MULIFE.txt,876970,877541,571,10,N,N,-,-1,-1
MULIFE.txt,876991,877616,625,10,N,N,-,-1,-1
MULIFE.txt,877008,877670,662,10,N,N,-,-1,-1
MULIFE.txt,877170,877679,509,10,N,N,-,-1,-1
MULIFE.txt,877207,877689,482,10,N,N,-,-1,-1
MULIFE.txt,877224,877739,515,10,N,N,-,-1,-1
MULIFE.txt,877326,877830,504,10,N,N,-,-1,-1
MULIFE.txt,877403,877900,497,10,N,N,-,-1,-1
MULIFE.txt,877428,878043,615,10,N,N,-,-1,-1
MULIFE.txt,877512,878087,575,10,N,N,-,-1,-1
MULIFE.txt,877542,878205,663,10,N,N,-,-1,-1
MULIFE.txt,877617,878256,639,10,N,N,-,-1,-1
MULIFE.txt,877673,878261,588,10,N,N,-,-1,-1
MULIFE.txt,877680,878297,617,10,N,N,-,-1,-1
MULIFE.txt,877690,878306,616,10,N,N,-,-1,-1
MULIFE.txt,877740,878379,639,10,N,N,-,-1,-1
MULIFE.txt,877833,878464,631,10,N,N,-,-1,-1
MULIFE.txt,877901,878503,602,10,N,N,-,-1,-1
MULIFE.txt,878044,878542,498,10,N,N,-,-1,-1
MULIFE.txt,878088,878584,496,10,N,N,-,-1,-1
MULIFE.txt,878206,878655,449,10,N,N,-,-1,-1
MULIFE.txt,878257,878824,567,10,N,N,-,-1,-1
MULIFE.txt,878263,878889,626,10,N,N,-,-1,-1
MULIFE.txt,878298,878946,648,10,N,N,-,-1,-1
MULIFE.txt,878307,879080,773,10,N,N,-,-1,-1
MULIFE.txt,878381,879135,754,10,N,N,-,-1,-1
MULIFE.txt,878465,879245,780,10,N,N,-,-1,-1
MULIFE.txt,878504,879494,990,10,N,N,-,-1,-1
MULIFE.txt,878543,879503,960,10,N,N,-,-1,-1
MULIFE.txt,878585,879510,925,10,N,N,-,-1,-1
MULIFE.txt,878656,879519,863,10,N,N,-,-1,-1
MULIFE.txt,878825,879585,760,10,N,N,-,-1,-1
MULIFE.txt,878890,879661,771,10,N,N,-,-1,-1
MULIFE.txt,878947,879689,742,10,N,N,-,-1,-1
MULIFE.txt,879083,879810,727,10,N,N,-,-1,-1
MULIFE.txt,879138,879854,716,10,N,N,-,-1,-1
MULIFE.txt,879248,879894,646,10,N,N,-,-1,-1
MULIFE.txt,879497,880018,521,10,N,N,-,-1,-1
MULIFE.txt,879504,880025,521,10,N,N,-,-1,-1
MULIFE.txt,879511,880046,535,10,N,N,-,-1,-1
MULIFE.txt,879522,880065,543,10,N,N,-,-1,-1
MULIFE.txt,879586,880148,562,10,N,N,-,-1,-1
MULIFE.txt,879662,880179,517,10,N,N,-,-1,-1
MULIFE.txt,879690,880297,607,10,N,N,-,-1,-1
MULIFE.txt,879811,880308,497,10,N,N,-,-1,-1
MULIFE.txt,879855,880321,466,10,N,N,-,-1,-1
MULIFE.txt,879895,880356,461,10,N,N,-,-1,-1
MULIFE.txt,880019,880420,401,10,N,N,-,-1,-1
MULIFE.txt,880026,880622,596,10,N,N,-,-1,-1
MULIFE.txt,880051,880746,695,10,N,N,-,-1,-1
MULIFE.txt,880068,880821,753,10,N,N,-,-1,-1
MULIFE.txt,880149,880850,701,10,N,N,-,-1,-1
MULIFE.txt,880180,880873,693,10,N,N,-,-1,-1
MULIFE.txt,880298,880939,641,10,N,N,-,-1,-1
MULIFE.txt,880309,881141,832,10,N,N,-,-1,-1
MULIFE.txt,880322,881271,949,10,N,N,-,-1,-1
MULIFE.txt,880357,881300,943,10,N,N,-,-1,-1
MULIFE.txt,880421,881474,1053,10,N,N,-,-1,-1
MULIFE.txt,880623,881554,931,10,N,N,-,-1,-1
MULIFE.txt,880747,881640,893,10,N,N,-,-1,-1
MULIFE.txt,880822,881704,882,10,N,N,-,-1,-1
MULIFE.txt,880851,882120,1269,10,N,N,-,-1,-1
MULIFE.txt,880876,882232,1356,10,N,N,-,-1,-1
MULIFE.txt,880940,882371,1431,10,N,N,-,-1,-1
MULIFE.txt,881142,882533,1391,10,N,N,-,-1,-1
MULIFE.txt,881273,882609,1336,10,N,N,-,-1,-1
MULIFE.txt,881301,882831,1530,10,N,N,-,-1,-1
MULIFE.txt,881477,882960,1483,10,N,N,-,-1,-1
MULIFE.txt,881555,883013,1458,10,N,N,-,-1,-1
MULIFE.txt,881643,883096,1453,10,N,N,-,-1,-1
MULIFE.txt,881705,883300,1595,10,N,N,-,-1,-1
MULIFE.txt,882121,883320,1199,10,N,N,-,-1,-1
MULIFE.txt,882233,883531,1298,10,N,N,-,-1,-1
MULIFE.txt,882372,883802,1430,10,N,N,-,-1,-1
MULIFE.txt,882536,883921,1385,10,N,N,-,-1,-1
MULIFE.txt,882610,884152,1542,10,N,N,-,-1,-1
MULIFE.txt,882832,884385,1553,10,N,N,-,-1,-1
MULIFE.txt,882961,884503,1542,10,N,N,-,-1,-1
MULIFE.txt,883016,884572,1556,10,N,N,-,-1,-1
MULIFE.txt,883099,884821,1722,10,N,N,-,-1,-1
MULIFE.txt,883301,884867,1566,10,N,N,-,-1,-1
MULIFE.txt,883323,885040,1717,10,N,N,-,-1,-1
MULIFE.txt,883532,885253,1721,10,N,N,-,-1,-1
MULIFE.txt,883803,885300,1497,10,N,N,-,-1,-1
MULIFE.txt,883922,885431,1509,10,N,N,-,-1,-1
MULIFE.txt,884153,885515,1362,10,N,N,-,-1,-1
MULIFE.txt,884386,885597,1211,10,N,N,-,-1,-1
MULIFE.txt,884504,885646,1142,10,N,N,-,-1,-1
MULIFE.txt,884573,885665,1092,10,N,N,-,-1,-1
MULIFE.txt,884822,885694,872,10,N,N,-,-1,-1
MULIFE.txt,884868,885789,921,10,N,N,-,-1,-1
MULIFE.txt,885041,885833,792,10,N,N,-,-1,-1
MULIFE.txt,885256,885881,625,10,N,N,-,-1,-1
MULIFE.txt,885301,885960,659,10,N,N,-,-1,-1
MULIFE.txt,885434,885967,533,10,N,N,-,-1,-1
MULIFE.txt,885516,886019,503,10,N,N,-,-1,-1
MULIFE.txt,885600,886033,433,10,N,N,-,-1,-1
MULIFE.txt,885647,886040,393,10,N,N,-,-1,-1
MULIFE.txt,885666,886126,460,10,N,N,-,-1,-1
MULIFE.txt,885695,886225,530,10,N,N,-,-1,-1
MULIFE.txt,885790,886377,587,10,N,N,-,-1,-1
MULIFE.txt,885834,886437,603,10,N,N,-,-1,-1
MULIFE.txt,885883,886491,608,10,N,N,-,-1,-1
MULIFE.txt,885963,886515,552,10,N,N,-,-1,-1
MULIFE.txt,885968,886526,558,10,N,N,-,-1,-1
MULIFE.txt,886021,886561,540,10,N,N,-,-1,-1
MULIFE.txt,886034,886772,738,10,N,N,-,-1,-1
MULIFE.txt,886041,886896,855,10,N,N,-,-1,-1
MULIFE.txt,886127,887177,1050,10,N,N,-,-1,-1
MULIFE.txt,886226,887230,1004,10,N,N,-,-1,-1
MULIFE.txt,886380,887332,952,10,N,N,-,-1,-1
MULIFE.txt,886439,887438,999,10,N,N,-,-1,-1
MULIFE.txt,886494,887458,964,10,N,N,-,-1,-1
MULIFE.txt,886516,887486,970,10,N,N,-,-1,-1
MULIFE.txt,886527,887567,1040,10,N,N,-,-1,-1
MULIFE.txt,886562,887624,1062,10,N,N,-,-1,-1
MULIFE.txt,886773,887686,913,10,N,N,-,-1,-1
MULIFE.txt,886897,887771,874,10,N,N,-,-1,-1
MULIFE.txt,887178,887904,726,10,N,N,-,-1,-1
MULIFE.txt,887231,888042,811,10,N,N,-,-1,-1
MULIFE.txt,887333,888220,887,10,N,N,-,-1,-1
MULIFE.txt,887443,888251,808,10,N,N,-,-1,-1
MULIFE.txt,887459,888375,916,10,N,N,-,-1,-1
MULIFE.txt,887487,888382,895,10,N,N,-,-1,-1
MULIFE.txt,887568,888934,1366,10,N,N,-,-1,-1
MULIFE.txt,887626,890377,2751,10,N,N,-,-1,-1
MULIFE.txt,887689,890396,2707,10,N,N,-,-1,-1
MULIFE.txt,887772,890438,2666,10,N,N,-,-1,-1
MULIFE.txt,887907,890530,2623,10,N,N,-,-1,-1
MULIFE.txt,888043,890659,2616,10,Y,N,-,-1,-1
MULIFE.txt,888221,890875,2654,10,Y,N,-,-1,-1
MULIFE.txt,888254,890921,2667,10,Y,N,-,-1,-1
MULIFE.txt,888378,891033,2655,10,Y,N,-,-1,-1
MULIFE.txt,888383,891118,2735,10,N,N,-,-1,-1
MULIFE.txt,888937,891216,2279,10,N,N,-,-1,-1
MULIFE.txt,890382,891281,899,10,N,N,-,-1,-1
MULIFE.txt,890397,891317,920,10,N,N,-,-1,-1
MULIFE.txt,890441,891551,1110,10,N,N,-,-1,-1
MULIFE.txt,890531,891980,1449,10,N,N,-,-1,-1
MULIFE.txt,890660,892173,1513,10,N,N,-,-1,-1
MULIFE.txt,890876,892332,1456,10,N,N,-,-1,-1
MULIFE.txt,890923,892457,1534,10,N,N,-,-1,-1
MULIFE.txt,891035,892556,1521,10,N,N,-,-1,-1
MULIFE.txt,891121,892584,1463,10,N,N,-,-1,-1
MULIFE.txt,891219,892596,1377,10,N,N,-,-1,-1
MULIFE.txt,891282,892605,1323,10,N,N,-,-1,-1
MULIFE.txt,891318,892637,1319,10,N,N,-,-1,-1
MULIFE.txt,891552,892659,1107,10,N,N,-,-1,-1
MULIFE.txt,891981,892728,747,10,N,N,-,-1,-1
MULIFE.txt,892174,892850,676,10,N,N,-,-1,-1
MULIFE.txt,892335,892934,599,10,N,N,-,-1,-1
MULIFE.txt,892457,892990,533,10,N,N,-,-1,-1
MULIFE.txt,892564,893085,521,10,N,Y,1448312844411,173573,174472
MULIFE.txt,892585,893182,597,10,N,Y,1448312844411,173573,174472
MULIFE.txt,892599,893306,707,10,N,Y,1448312844411,173573,174472
MULIFE.txt,892608,893677,1069,10,N,Y,1448312844411,173573,174472
MULIFE.txt,892638,894068,1430,10,N,Y,1448312844411,173573,174472
MULIFE.txt,892660,894237,1577,10,N,Y,1448312844411,173573,174472
MULIFE.txt,892729,894276,1547,10,N,Y,1448312844411,173573,174472
MULIFE.txt,892851,894359,1508,10,N,Y,1448312844411,173573,174472
MULIFE.txt,892935,894486,1551,10,N,Y,1448312844411,173573,174472
MULIFE.txt,892991,894505,1514,10,N,Y,1448312844411,173573,174472
MULIFE.txt,893088,894745,1657,10,N,Y,1448312844411,173573,174472
MULIFE.txt,893185,894871,1686,10,N,Y,1448312844411,173573,174472
MULIFE.txt,893309,895189,1880,10,N,Y,1448312844411,173573,174472
MULIFE.txt,893680,895280,1600,10,N,Y,1448312844411,173573,174472
MULIFE.txt,894071,895581,1510,10,N,Y,1448312844411,173573,174472
MULIFE.txt,894240,895871,1631,10,N,N,-,-1,-1
MULIFE.txt,894277,896108,1831,10,N,N,-,-1,-1
MULIFE.txt,894360,896116,1756,10,N,N,-,-1,-1
MULIFE.txt,894487,896148,1661,10,N,N,-,-1,-1
MULIFE.txt,894506,896368,1862,10,N,N,-,-1,-1
MULIFE.txt,894748,896477,1729,10,N,N,-,-1,-1
MULIFE.txt,894872,896567,1695,10,N,N,-,-1,-1
MULIFE.txt,895190,896668,1478,10,N,N,-,-1,-1
MULIFE.txt,895283,896775,1492,10,N,N,-,-1,-1
MULIFE.txt,895582,896927,1345,10,N,N,-,-1,-1
MULIFE.txt,895874,896978,1104,10,N,N,-,-1,-1
MULIFE.txt,896109,897049,940,10,N,N,-,-1,-1
MULIFE.txt,896119,897091,972,10,N,N,-,-1,-1
MULIFE.txt,896149,897102,953,10,N,N,-,-1,-1
MULIFE.txt,896371,897449,1078,10,N,N,-,-1,-1
MULIFE.txt,896478,897502,1024,10,N,N,-,-1,-1
MULIFE.txt,896570,897585,1015,10,N,N,-,-1,-1
MULIFE.txt,896669,897730,1061,10,N,N,-,-1,-1
MULIFE.txt,896776,897895,1119,10,N,N,-,-1,-1
MULIFE.txt,896930,897916,986,10,N,N,-,-1,-1
MULIFE.txt,896979,897957,978,10,N,N,-,-1,-1
MULIFE.txt,897050,898248,1198,10,N,N,-,-1,-1
MULIFE.txt,897092,898485,1393,10,N,N,-,-1,-1
MULIFE.txt,897104,898619,1515,10,N,N,-,-1,-1
MULIFE.txt,897450,898644,1194,10,N,N,-,-1,-1
MULIFE.txt,897505,898689,1184,10,N,N,-,-1,-1
MULIFE.txt,897586,898709,1123,10,N,N,-,-1,-1
MULIFE.txt,897733,898839,1106,10,N,N,-,-1,-1
MULIFE.txt,897900,899011,1111,10,N,N,-,-1,-1
MULIFE.txt,897917,899092,1175,10,N,N,-,-1,-1
MULIFE.txt,897958,899153,1195,10,N,N,-,-1,-1
MULIFE.txt,898249,899208,959,10,N,N,-,-1,-1
MULIFE.txt,898488,899363,875,10,N,N,-,-1,-1
MULIFE.txt,898620,899407,787,10,N,N,-,-1,-1
MULIFE.txt,898647,899463,816,10,N,N,-,-1,-1
MULIFE.txt,898690,899646,956,10,N,N,-,-1,-1
MULIFE.txt,898711,899702,991,10,N,N,-,-1,-1
MULIFE.txt,898840,899825,985,10,N,N,-,-1,-1
MULIFE.txt,899012,899916,904,10,N,N,-,-1,-1
MULIFE.txt,899094,900088,994,10,N,N,-,-1,-1
MULIFE.txt,899156,900227,1071,10,N,N,-,-1,-1
MULIFE.txt,899209,900487,1278,10,N,N,-,-1,-1
MULIFE.txt,899364,900557,1193,10,N,N,-,-1,-1
MULIFE.txt,899410,900674,1264,10,N,N,-,-1,-1
MULIFE.txt,899464,900778,1314,10,N,N,-,-1,-1
MULIFE.txt,899647,900801,1154,10,N,N,-,-1,-1
MULIFE.txt,899704,900890,1186,10,N,N,-,-1,-1
MULIFE.txt,899826,901033,1207,10,N,N,-,-1,-1
MULIFE.txt,899919,901245,1326,10,N,N,-,-1,-1
MULIFE.txt,900091,901549,1458,10,N,N,-,-1,-1
MULIFE.txt,900230,901612,1382,10,N,N,-,-1,-1
MULIFE.txt,900488,901753,1265,10,N,N,-,-1,-1
MULIFE.txt,900560,901859,1299,10,N,Y,1448274893770,25386,26202
MULIFE.txt,900677,901916,1239,10,N,Y,1448274893770,25386,26202
MULIFE.txt,900783,901989,1206,10,N,Y,1448274893770,25386,26202
MULIFE.txt,900802,902185,1383,10,N,Y,1448274893770,25386,26202
MULIFE.txt,900891,902256,1365,10,N,Y,1448274893770,25386,26202
MULIFE.txt,901036,902424,1388,10,N,Y,1448274893770,25386,26202
MULIFE.txt,901246,902829,1583,10,N,Y,1448274893770,25386,26202
MULIFE.txt,901552,902872,1320,10,N,Y,1448274893770,25386,26202
MULIFE.txt,901614,902938,1324,10,N,Y,1448274893770,25386,26202
MULIFE.txt,901756,903051,1295,10,N,Y,1448274893770,25386,26202
MULIFE.txt,901860,903088,1228,10,N,Y,1448274893770,25386,26202
MULIFE.txt,901917,903105,1188,10,N,Y,1448274893770,25386,26202
MULIFE.txt,901990,903218,1228,10,N,Y,1448274893770,25386,26202
MULIFE.txt,902188,903246,1058,10,N,Y,1448274893770,25386,26202
MULIFE.txt,902259,903276,1017,10,N,Y,1448274893770,25386,26202
MULIFE.txt,902427,903297,870,10,N,Y,1448286880729,112151,113274
MULIFE.txt,902832,903494,662,10,N,Y,1448286880729,112151,113274
MULIFE.txt,902873,903687,814,10,N,Y,1448286880729,112151,113274
MULIFE.txt,902941,903761,820,10,N,Y,1448286880729,112151,113274
MULIFE.txt,903054,903774,720,10,N,Y,1448286880729,112151,113274
MULIFE.txt,903089,904044,955,10,N,Y,1448286880729,112151,113274
MULIFE.txt,903107,904147,1040,10,N,Y,1448286880729,112151,113274
MULIFE.txt,903220,904215,995,10,N,Y,1448286880729,112151,113274
MULIFE.txt,903247,904284,1037,10,N,Y,1448286880729,112151,113274
MULIFE.txt,903278,904436,1158,10,N,Y,1448286880729,112151,113274
MULIFE.txt,903298,904717,1419,10,N,Y,1448286880729,112151,113274
MULIFE.txt,903495,904764,1269,10,N,Y,1448286880729,112151,113274
MULIFE.txt,903688,904820,1132,10,N,Y,1448286880729,112151,113274
MULIFE.txt,903762,904900,1138,10,N,Y,1448286880729,112151,113274
MULIFE.txt,903775,905069,1294,10,N,Y,1448286880729,112151,113274
MULIFE.txt,904047,905153,1106,10,N,N,-,-1,-1
MULIFE.txt,904148,905176,1028,10,N,N,-,-1,-1
MULIFE.txt,904218,905226,1008,10,N,N,-,-1,-1
MULIFE.txt,904285,905248,963,10,N,N,-,-1,-1
MULIFE.txt,904439,905539,1100,10,N,N,-,-1,-1
MULIFE.txt,904720,905704,984,10,N,Y,1448274783410,21836,25159
MULIFE.txt,904765,905832,1067,10,Y,Y,1448274783410,21836,25159
MULIFE.txt,904821,905884,1063,10,Y,Y,1448274783410,21836,25159
MULIFE.txt,904901,905936,1035,10,Y,Y,1448274783410,21836,25159
MULIFE.txt,905070,906182,1112,10,Y,Y,1448274783410,21836,25159
MULIFE.txt,905154,906291,1137,10,Y,Y,1448274783410,21836,25159
MULIFE.txt,905179,906342,1163,10,Y,Y,1448274783410,21836,25159
MULIFE.txt,905227,906354,1127,10,N,Y,1448274783410,21836,25159
MULIFE.txt,905249,906415,1166,10,N,Y,1448274783410,21836,25159
MULIFE.txt,905542,906623,1081,10,N,Y,1448274783410,21836,25159
MULIFE.txt,905707,906861,1154,10,N,Y,1448274783410,21836,25159
MULIFE.txt,905833,906959,1126,10,N,Y,1448274783410,21836,25159
MULIFE.txt,905886,907137,1251,10,N,Y,1448274783410,21836,25159
MULIFE.txt,905939,907150,1211,10,N,N,-,-1,-1
MULIFE.txt,906185,907223,1038,10,N,N,-,-1,-1
MULIFE.txt,906294,907307,1013,10,N,N,-,-1,-1
MULIFE.txt,906344,907365,1021,10,N,N,-,-1,-1
MULIFE.txt,906355,907520,1165,10,N,N,-,-1,-1
MULIFE.txt,906416,907543,1127,10,N,N,-,-1,-1
MULIFE.txt,906624,907574,950,10,N,N,-,-1,-1
MULIFE.txt,906862,907628,766,10,N,N,-,-1,-1
MULIFE.txt,906961,907660,699,10,N,N,-,-1,-1
MULIFE.txt,907140,907709,569,10,N,N,-,-1,-1
MULIFE.txt,907151,907945,794,10,N,N,-,-1,-1
MULIFE.txt,907224,907999,775,10,N,N,-,-1,-1
MULIFE.txt,907310,908107,797,10,N,N,-,-1,-1
MULIFE.txt,907368,908276,908,10,N,N,-,-1,-1
MULIFE.txt,907521,908404,883,10,N,N,-,-1,-1
MULIFE.txt,907546,908660,1114,10,N,N,-,-1,-1
MULIFE.txt,907575,908813,1238,10,N,N,-,-1,-1
MULIFE.txt,907629,908926,1297,10,N,N,-,-1,-1
MULIFE.txt,907661,908991,1330,10,N,N,-,-1,-1
MULIFE.txt,907710,909138,1428,10,N,N,-,-1,-1
MULIFE.txt,907946,909193,1247,10,N,N,-,-1,-1
MULIFE.txt,908002,909334,1332,10,N,N,-,-1,-1
MULIFE.txt,908110,909457,1347,10,N,N,-,-1,-1
MULIFE.txt,908279,909537,1258,10,N,N,-,-1,-1
MULIFE.txt,908407,909561,1154,10,N,N,-,-1,-1
MULIFE.txt,908661,909806,1145,10,N,N,-,-1,-1
MULIFE.txt,908816,909861,1045,10,N,N,-,-1,-1
MULIFE.txt,908927,910068,1141,10,N,N,-,-1,-1
MULIFE.txt,908994,910349,1355,10,N,N,-,-1,-1
MULIFE.txt,909141,910415,1274,10,N,N,-,-1,-1
MULIFE.txt,909195,910590,1395,10,N,N,-,-1,-1
MULIFE.txt,909335,910629,1294,10,N,N,-,-1,-1
MULIFE.txt,909460,910811,1351,10,N,N,-,-1,-1
MULIFE.txt,909538,910841,1303,10,N,N,-,-1,-1
MULIFE.txt,909562,910856,1294,10,N,N,-,-1,-1
MULIFE.txt,909807,911008,1201,10,N,N,-,-1,-1
MULIFE.txt,909862,911175,1313,10,N,N,-,-1,-1
MULIFE.txt,910069,911252,1183,10,N,N,-,-1,-1
MULIFE.txt,910352,911342,990,10,N,N,-,-1,-1
MULIFE.txt,910416,911515,1099,10,N,N,-,-1,-1
MULIFE.txt,910591,911624,1033,10,N,N,-,-1,-1
MULIFE.txt,910630,911642,1012,10,N,N,-,-1,-1
MULIFE.txt,910812,911651,839,10,N,N,-,-1,-1
MULIFE.txt,910846,911849,1003,10,N,N,-,-1,-1
MULIFE.txt,910861,911991,1130,10,N,N,-,-1,-1
MULIFE.txt,911009,912043,1034,10,N,N,-,-1,-1
MULIFE.txt,911176,912172,996,10,N,N,-,-1,-1
MULIFE.txt,911253,912271,1018,10,N,N,-,-1,-1
MULIFE.txt,911345,912295,950,10,N,N,-,-1,-1
MULIFE.txt,911517,912448,931,10,N,N,-,-1,-1
MULIFE.txt,911627,912509,882,10,N,N,-,-1,-1
MULIFE.txt,911645,912559,914,10,N,N,-,-1,-1
MULIFE.txt,911652,912587,935,10,N,N,-,-1,-1
MULIFE.txt,911850,912725,875,10,N,N,-,-1,-1
MULIFE.txt,911994,912811,817,10,N,N,-,-1,-1
MULIFE.txt,912044,912881,837,10,N,N,-,-1,-1
MULIFE.txt,912173,912904,731,10,N,N,-,-1,-1
MULIFE.txt,912272,912920,648,10,N,N,-,-1,-1
MULIFE.txt,912296,912954,658,10,N,N,-,-1,-1
MULIFE.txt,912451,913023,572,10,N,N,-,-1,-1
MULIFE.txt,912510,913067,557,10,N,N,-,-1,-1
MULIFE.txt,912561,913101,540,10,N,N,-,-1,-1
MULIFE.txt,912588,913208,620,10,N,N,-,-1,-1
MULIFE.txt,912726,913377,651,10,N,N,-,-1,-1
MULIFE.txt,912814,913494,680,10,N,N,-,-1,-1
MULIFE.txt,912882,913527,645,10,N,N,-,-1,-1
MULIFE.txt,912905,913676,771,10,N,N,-,-1,-1
MULIFE.txt,912921,913703,782,10,N,N,-,-1,-1
MULIFE.txt,912955,913792,837,10,N,N,-,-1,-1
MULIFE.txt,913026,913921,895,10,N,N,-,-1,-1
MULIFE.txt,913068,913927,859,10,N,N,-,-1,-1
MULIFE.txt,913102,913994,892,10,N,N,-,-1,-1
MULIFE.txt,913209,914049,840,10,N,N,-,-1,-1
MULIFE.txt,913380,914083,703,10,N,N,-,-1,-1
MULIFE.txt,913496,914106,610,10,N,N,-,-1,-1
MULIFE.txt,913528,914137,609,10,N,N,-,-1,-1
MULIFE.txt,913679,914194,515,10,N,N,-,-1,-1
MULIFE.txt,913704,914319,615,10,N,N,-,-1,-1
MULIFE.txt,913795,914402,607,10,N,N,-,-1,-1
MULIFE.txt,913923,914443,520,10,N,N,-,-1,-1
MULIFE.txt,913930,914489,559,10,N,N,-,-1,-1
MULIFE.txt,913997,914527,530,10,N,N,-,-1,-1
MULIFE.txt,914050,914555,505,10,N,N,-,-1,-1
MULIFE.txt,914086,914764,678,10,N,N,-,-1,-1
MULIFE.txt,914107,914863,756,10,N,N,-,-1,-1
MULIFE.txt,914139,914979,840,10,N,N,-,-1,-1
MULIFE.txt,914196,915029,833,10,N,N,-,-1,-1
MULIFE.txt,914320,915046,726,10,N,N,-,-1,-1
MULIFE.txt,914405,915070,665,10,N,N,-,-1,-1
MULIFE.txt,914444,915162,718,10,N,N,-,-1,-1
MULIFE.txt,914490,915213,723,10,N,N,-,-1,-1
MULIFE.txt,914528,915381,853,10,N,N,-,-1,-1
MULIFE.txt,914556,915504,948,10,N,N,-,-1,-1
MULIFE.txt,914766,915627,861,10,N,N,-,-1,-1
MULIFE.txt,914864,915771,907,10,N,N,-,-1,-1
MULIFE.txt,914980,916139,1159,10,N,N,-,-1,-1
MULIFE.txt,915030,916250,1220,10,N,N,-,-1,-1
MULIFE.txt,915047,916408,1361,10,N,N,-,-1,-1
MULIFE.txt,915071,916487,1416,10,N,N,-,-1,-1
MULIFE.txt,915163,916588,1425,10,N,N,-,-1,-1
MULIFE.txt,915214,916814,1600,10,N,N,-,-1,-1
MULIFE.txt,915384,916879,1495,10,N,N,-,-1,-1
MULIFE.txt,915505,916913,1408,10,N,N,-,-1,-1
MULIFE.txt,915628,916989,1361,10,N,N,-,-1,-1
MULIFE.txt,915772,917164,1392,10,N,N,-,-1,-1
MULIFE.txt,916140,917367,1227,10,N,N,-,-1,-1
MULIFE.txt,916251,917658,1407,10,N,N,-,-1,-1
MULIFE.txt,916411,917881,1470,10,N,N,-,-1,-1
MULIFE.txt,916490,917986,1496,10,N,N,-,-1,-1
MULIFE.txt,916589,918055,1466,10,N,N,-,-1,-1
MULIFE.txt,916815,918194,1379,10,N,N,-,-1,-1
MULIFE.txt,916880,918215,1335,10,N,N,-,-1,-1
MULIFE.txt,916914,918250,1336,10,N,N,-,-1,-1
MULIFE.txt,916990,918349,1359,10,N,N,-,-1,-1
MULIFE.txt,917165,918481,1316,10,N,N,-,-1,-1
MULIFE.txt,917370,918503,1133,10,N,N,-,-1,-1
MULIFE.txt,917661,918588,927,10,N,N,-,-1,-1
MULIFE.txt,917882,918754,872,10,N,N,-,-1,-1
MULIFE.txt,917987,918850,863,10,N,N,-,-1,-1
MULIFE.txt,918057,919122,1065,10,N,N,-,-1,-1
MULIFE.txt,918197,919465,1268,10,N,N,-,-1,-1
MULIFE.txt,918216,919487,1271,10,N,N,-,-1,-1
MULIFE.txt,918252,919539,1287,10,N,N,-,-1,-1
MULIFE.txt,918350,919606,1256,10,N,N,-,-1,-1
MULIFE.txt,918482,919736,1254,10,N,N,-,-1,-1
MULIFE.txt,918504,919831,1327,10,N,N,-,-1,-1
MULIFE.txt,918589,920129,1540,10,N,N,-,-1,-1
MULIFE.txt,918757,920191,1434,10,N,N,-,-1,-1
MULIFE.txt,918851,920297,1446,10,N,N,-,-1,-1
MULIFE.txt,919123,920413,1290,10,N,N,-,-1,-1
MULIFE.txt,919468,920471,1003,10,N,N,-,-1,-1
MULIFE.txt,919490,920532,1042,10,N,N,-,-1,-1
MULIFE.txt,919540,920637,1097,10,N,N,-,-1,-1
MULIFE.txt,919607,920877,1270,10,N,N,-,-1,-1
MULIFE.txt,919737,920949,1212,10,N,N,-,-1,-1
MULIFE.txt,919834,920973,1139,10,N,N,-,-1,-1
MULIFE.txt,920130,921223,1093,10,N,N,-,-1,-1
MULIFE.txt,920192,921421,1229,10,N,N,-,-1,-1
MULIFE.txt,920300,921456,1156,10,N,N,-,-1,-1
MULIFE.txt,920414,921531,1117,10,N,N,-,-1,-1
MULIFE.txt,920474,921695,1221,10,N,N,-,-1,-1
MULIFE.txt,920535,921860,1325,10,N,N,-,-1,-1
MULIFE.txt,920640,922062,1422,10,N,N,-,-1,-1
MULIFE.txt,920880,922143,1263,10,N,N,-,-1,-1
MULIFE.txt,920950,922165,1215,10,N,N,-,-1,-1
MULIFE.txt,920974,922279,1305,10,N,N,-,-1,-1
MULIFE.txt,921226,922347,1121,10,N,N,-,-1,-1
MULIFE.txt,921422,922512,1090,10,N,N,-,-1,-1
MULIFE.txt,921459,922582,1123,10,N,N,-,-1,-1
MULIFE.txt,921532,922622,1090,10,N,N,-,-1,-1
MULIFE.txt,921696,922679,983,10,N,N,-,-1,-1
MULIFE.txt,921861,922770,909,10,N,N,-,-1,-1
MULIFE.txt,922065,922837,772,10,N,N,-,-1,-1
MULIFE.txt,922144,922936,792,10,N,N,-,-1,-1
MULIFE.txt,922167,923444,1277,10,N,N,-,-1,-1
MULIFE.txt,922281,923513,1232,10,N,N,-,-1,-1
MULIFE.txt,922350,923544,1194,10,N,N,-,-1,-1
MULIFE.txt,922513,923553,1040,10,N,N,-,-1,-1
MULIFE.txt,922583,923597,1014,10,N,N,-,-1,-1
MULIFE.txt,922624,923703,1079,10,N,N,-,-1,-1
MULIFE.txt,922681,923748,1067,10,N,N,-,-1,-1
MULIFE.txt,922771,924046,1275,10,N,N,-,-1,-1
MULIFE.txt,922838,924245,1407,10,N,N,-,-1,-1
MULIFE.txt,922939,924636,1697,10,N,N,-,-1,-1
MULIFE.txt,923447,925291,1844,10,N,N,-,-1,-1
MULIFE.txt,923514,925514,2000,10,N,N,-,-1,-1
MULIFE.txt,923545,925618,2073,10,N,N,-,-1,-1
MULIFE.txt,923556,925914,2358,10,N,N,-,-1,-1
MULIFE.txt,923598,925938,2340,10,N,N,-,-1,-1
MULIFE.txt,923704,926096,2392,10,N,N,-,-1,-1
MULIFE.txt,923749,926206,2457,10,N,N,-,-1,-1
MULIFE.txt,924048,926344,2296,10,N,N,-,-1,-1
MULIFE.txt,924248,926376,2128,10,N,N,-,-1,-1
MULIFE.txt,924639,926650,2011,10,N,N,-,-1,-1
MULIFE.txt,925294,926691,1397,10,N,N,-,-1,-1
MULIFE.txt,925517,927006,1489,10,N,N,-,-1,-1
MULIFE.txt,925619,927314,1695,10,N,N,-,-1,-1
MULIFE.txt,925915,927623,1708,10,N,N,-,-1,-1
MULIFE.txt,925941,928136,2195,10,N,N,-,-1,-1
MULIFE.txt,926097,928263,2166,10,N,N,-,-1,-1
MULIFE.txt,926209,928372,2163,10,N,N,-,-1,-1
MULIFE.txt,926345,928456,2111,10,N,N,-,-1,-1
MULIFE.txt,926379,928547,2168,10,N,N,-,-1,-1
MULIFE.txt,926655,928663,2008,10,N,N,-,-1,-1
MULIFE.txt,926692,928934,2242,10,N,N,-,-1,-1
MULIFE.txt,927007,929088,2081,10,N,N,-,-1,-1
MULIFE.txt,927315,929247,1932,10,N,N,-,-1,-1
MULIFE.txt,927624,929412,1788,10,N,N,-,-1,-1
MULIFE.txt,928138,929430,1292,10,N,N,-,-1,-1
MULIFE.txt,928266,929536,1270,10,N,N,-,-1,-1
MULIFE.txt,928373,929713,1340,10,N,N,-,-1,-1
MULIFE.txt,928457,929751,1294,10,N,N,-,-1,-1
MULIFE.txt,928548,929845,1297,10,N,N,-,-1,-1
MULIFE.txt,928664,930010,1346,10,N,N,-,-1,-1
MULIFE.txt,928935,930151,1216,10,N,N,-,-1,-1
MULIFE.txt,929091,930326,1235,10,N,N,-,-1,-1
MULIFE.txt,929250,930381,1131,10,N,N,-,-1,-1
MULIFE.txt,929414,930604,1190,10,N,N,-,-1,-1
MULIFE.txt,929431,930809,1378,10,N,N,-,-1,-1
MULIFE.txt,929537,930891,1354,10,N,N,-,-1,-1
MULIFE.txt,929714,930925,1211,10,N,N,-,-1,-1
MULIFE.txt,929752,930985,1233,10,N,N,-,-1,-1
MULIFE.txt,929846,931094,1248,10,N,N,-,-1,-1
MULIFE.txt,930013,931185,1172,10,N,N,-,-1,-1
MULIFE.txt,930152,931211,1059,10,N,N,-,-1,-1
MULIFE.txt,930327,931324,997,10,N,N,-,-1,-1
MULIFE.txt,930384,931593,1209,10,N,N,-,-1,-1
MULIFE.txt,930605,931790,1185,10,N,N,-,-1,-1
MULIFE.txt,930810,931894,1084,10,N,N,-,-1,-1
MULIFE.txt,930892,932101,1209,10,N,N,-,-1,-1
MULIFE.txt,930926,932268,1342,10,N,N,-,-1,-1
MULIFE.txt,930986,932314,1328,10,N,N,-,-1,-1
MULIFE.txt,931095,932411,1316,10,N,N,-,-1,-1
MULIFE.txt,931188,932509,1321,10,N,N,-,-1,-1
MULIFE.txt,931212,932606,1394,10,N,N,-,-1,-1
MULIFE.txt,931325,932697,1372,10,N,N,-,-1,-1
MULIFE.txt,931596,932773,1177,10,N,N,-,-1,-1
MULIFE.txt,931791,932786,995,10,N,N,-,-1,-1
MULIFE.txt,931895,932814,919,10,N,N,-,-1,-1
MULIFE.txt,932104,932985,881,10,N,N,-,-1,-1
MULIFE.txt,932269,933088,819,10,N,N,-,-1,-1
MULIFE.txt,932315,933194,879,10,N,N,-,-1,-1
MULIFE.txt,932414,933250,836,10,N,N,-,-1,-1
MULIFE.txt,932510,933353,843,10,N,N,-,-1,-1
MULIFE.txt,932607,933441,834,10,N,N,-,-1,-1
MULIFE.txt,932700,933568,868,10,N,N,-,-1,-1
MULIFE.txt,932774,933686,912,10,N,N,-,-1,-1
MULIFE.txt,932786,933716,930,10,N,N,-,-1,-1
MULIFE.txt,932817,933959,1142,10,N,N,-,-1,-1
MULIFE.txt,932985,933974,989,10,N,N,-,-1,-1
MULIFE.txt,933091,934099,1008,10,N,N,-,-1,-1
MULIFE.txt,933195,934210,1015,10,N,N,-,-1,-1
MULIFE.txt,933251,934351,1100,10,N,N,-,-1,-1
MULIFE.txt,933354,934618,1264,10,N,N,-,-1,-1
MULIFE.txt,933442,934679,1237,10,N,N,-,-1,-1
MULIFE.txt,933569,934919,1350,10,N,N,-,-1,-1
MULIFE.txt,933687,935042,1355,10,N,N,-,-1,-1
MULIFE.txt,933719,935166,1447,10,N,N,-,-1,-1
MULIFE.txt,933964,935469,1505,10,N,N,-,-1,-1
MULIFE.txt,933977,935655,1678,10,N,N,-,-1,-1
MULIFE.txt,934100,935899,1799,10,N,N,-,-1,-1
MULIFE.txt,934211,935977,1766,10,N,N,-,-1,-1
MULIFE.txt,934354,936098,1744,10,N,N,-,-1,-1
MULIFE.txt,934619,936126,1507,10,N,N,-,-1,-1
MULIFE.txt,934680,936343,1663,10,N,N,-,-1,-1
MULIFE.txt,934922,936491,1569,10,N,N,-,-1,-1
MULIFE.txt,935043,936570,1527,10,N,N,-,-1,-1
MULIFE.txt,935167,936613,1446,10,N,N,-,-1,-1
MULIFE.txt,935470,936882,1412,10,N,N,-,-1,-1
MULIFE.txt,935658,937196,1538,10,N,N,-,-1,-1
MULIFE.txt,935902,937250,1348,10,N,N,-,-1,-1
MULIFE.txt,935978,937271,1293,10,N,N,-,-1,-1
MULIFE.txt,936099,937292,1193,10,N,N,-,-1,-1
MULIFE.txt,936128,937320,1192,10,N,N,-,-1,-1
MULIFE.txt,936344,937325,981,10,N,N,-,-1,-1
MULIFE.txt,936492,937495,1003,10,N,N,-,-1,-1
MULIFE.txt,936571,937582,1011,10,N,N,-,-1,-1
MULIFE.txt,936614,937678,1064,10,N,N,-,-1,-1
MULIFE.txt,936885,937854,969,10,N,N,-,-1,-1
MULIFE.txt,937199,938200,1001,10,N,N,-,-1,-1
MULIFE.txt,937251,938336,1085,10,N,N,-,-1,-1
MULIFE.txt,937272,938390,1118,10,N,N,-,-1,-1
MULIFE.txt,937293,938476,1183,10,N,N,-,-1,-1
MULIFE.txt,937321,938657,1336,10,N,N,-,-1,-1
MULIFE.txt,937326,938694,1368,10,N,N,-,-1,-1
MULIFE.txt,937497,938778,1281,10,N,N,-,-1,-1
MULIFE.txt,937583,938858,1275,10,N,N,-,-1,-1
MULIFE.txt,937679,938966,1287,10,N,N,-,-1,-1
MULIFE.txt,937857,939048,1191,10,N,N,-,-1,-1
MULIFE.txt,938203,939085,882,10,N,N,-,-1,-1
MULIFE.txt,938337,939194,857,10,N,N,-,-1,-1
MULIFE.txt,938391,939565,1174,10,N,N,-,-1,-1
MULIFE.txt,938479,939610,1131,10,N,N,-,-1,-1
MULIFE.txt,938659,939695,1036,10,N,N,-,-1,-1
MULIFE.txt,938695,939715,1020,10,N,N,-,-1,-1
MULIFE.txt,938779,939804,1025,10,N,N,-,-1,-1
MULIFE.txt,938861,939845,984,10,N,N,-,-1,-1
MULIFE.txt,938967,939935,968,10,N,N,-,-1,-1
MULIFE.txt,939049,939966,917,10,N,N,-,-1,-1
MULIFE.txt,939088,940059,971,10,N,N,-,-1,-1
MULIFE.txt,939195,940190,995,10,N,N,-,-1,-1
MULIFE.txt,939568,940204,636,10,N,N,-,-1,-1
MULIFE.txt,939611,940401,790,10,N,N,-,-1,-1
MULIFE.txt,939698,940466,768,10,N,N,-,-1,-1
MULIFE.txt,939718,940502,784,10,N,N,-,-1,-1
MULIFE.txt,939805,940568,763,10,N,N,-,-1,-1
MULIFE.txt,939846,940660,814,10,N,N,-,-1,-1
MULIFE.txt,939938,940725,787,10,N,N,-,-1,-1
MULIFE.txt,939967,940807,840,10,N,N,-,-1,-1
MULIFE.txt,940060,940936,876,10,N,N,-,-1,-1
MULIFE.txt,940191,941050,859,10,N,N,-,-1,-1
MULIFE.txt,940205,941132,927,10,N,N,-,-1,-1
MULIFE.txt,940404,941165,761,10,N,N,-,-1,-1
MULIFE.txt,940467,941240,773,10,N,N,-,-1,-1
MULIFE.txt,940503,941248,745,10,N,N,-,-1,-1
MULIFE.txt,940570,941319,749,10,N,N,-,-1,-1
MULIFE.txt,940661,941321,660,10,N,N,-,-1,-1
MULIFE.txt,940728,941373,645,10,N,N,-,-1,-1
MULIFE.txt,940808,941413,605,10,N,N,-,-1,-1
MULIFE.txt,940939,941585,646,10,N,N,-,-1,-1
MULIFE.txt,941053,941781,728,10,N,N,-,-1,-1
MULIFE.txt,941133,941906,773,10,N,N,-,-1,-1
MULIFE.txt,941166,941918,752,10,N,N,-,-1,-1
MULIFE.txt,941243,942013,770,10,N,N,-,-1,-1
MULIFE.txt,941251,942046,795,10,N,N,-,-1,-1
MULIFE.txt,941320,942086,766,10,N,N,-,-1,-1
MULIFE.txt,941322,942323,1001,10,N,N,-,-1,-1
MULIFE.txt,941374,942638,1264,10,N,N,-,-1,-1
MULIFE.txt,941416,942678,1262,10,N,N,-,-1,-1
MULIFE.txt,941586,942726,1140,10,N,N,-,-1,-1
MULIFE.txt,941786,942795,1009,10,N,N,-,-1,-1
MULIFE.txt,941907,942897,990,10,N,N,-,-1,-1
MULIFE.txt,941919,942911,992,10,N,N,-,-1,-1
MULIFE.txt,942014,942954,940,10,N,N,-,-1,-1
MULIFE.txt,942047,943041,994,10,N,N,-,-1,-1
MULIFE.txt,942089,943061,972,10,N,N,-,-1,-1
MULIFE.txt,942325,943153,828,10,N,N,-,-1,-1
MULIFE.txt,942641,943278,637,10,N,N,-,-1,-1
MULIFE.txt,942679,943336,657,10,N,N,-,-1,-1
MULIFE.txt,942727,943513,786,10,N,N,-,-1,-1
MULIFE.txt,942798,943592,794,10,N,N,-,-1,-1
MULIFE.txt,942898,943743,845,10,N,N,-,-1,-1
MULIFE.txt,942912,943936,1024,10,N,N,-,-1,-1
MULIFE.txt,942955,944018,1063,10,N,N,-,-1,-1
MULIFE.txt,943042,944175,1133,10,N,N,-,-1,-1
MULIFE.txt,943062,944251,1189,10,N,N,-,-1,-1
MULIFE.txt,943154,944292,1138,10,N,N,-,-1,-1
MULIFE.txt,943279,944372,1093,10,N,N,-,-1,-1
MULIFE.txt,943337,944428,1091,10,N,N,-,-1,-1
MULIFE.txt,943516,944443,927,10,N,N,-,-1,-1
MULIFE.txt,943593,944538,945,10,N,N,-,-1,-1
MULIFE.txt,943746,944662,916,10,N,N,-,-1,-1
MULIFE.txt,943939,945514,1575,10,N,N,-,-1,-1
MULIFE.txt,944019,945599,1580,10,N,N,-,-1,-1
MULIFE.txt,944178,945676,1498,10,N,N,-,-1,-1
MULIFE.txt,944252,945813,1561,10,N,N,-,-1,-1
MULIFE.txt,944293,946057,1764,10,N,N,-,-1,-1
MULIFE.txt,944372,946099,1727,10,N,N,-,-1,-1
MULIFE.txt,944429,946127,1698,10,N,N,-,-1,-1
MULIFE.txt,944444,946303,1859,10,N,N,-,-1,-1
MULIFE.txt,944539,946430,1891,10,N,N,-,-1,-1
MULIFE.txt,944665,946624,1959,10,N,N,-,-1,-1
MULIFE.txt,945517,946737,1220,10,N,N,-,-1,-1
MULIFE.txt,945602,946757,1155,10,N,N,-,-1,-1
MULIFE.txt,945677,946925,1248,10,N,N,-,-1,-1
MULIFE.txt,945814,947066,1252,10,N,N,-,-1,-1
MULIFE.txt,946058,947413,1355,10,N,N,-,-1,-1
MULIFE.txt,946104,947646,1542,10,N,N,-,-1,-1
MULIFE.txt,946130,947776,1646,10,N,N,-,-1,-1
MULIFE.txt,946305,947809,1504,10,N,N,-,-1,-1
MULIFE.txt,946431,947871,1440,10,N,N,-,-1,-1
MULIFE.txt,946627,948007,1380,10,N,N,-,-1,-1
MULIFE.txt,946742,948155,1413,10,N,N,-,-1,-1
MULIFE.txt,946758,948225,1467,10,N,N,-,-1,-1
MULIFE.txt,946926,948260,1334,10,N,N,-,-1,-1
MULIFE.txt,947069,948312,1243,10,N,N,-,-1,-1
MULIFE.txt,947416,948590,1174,10,N,N,-,-1,-1
MULIFE.txt,947649,948705,1056,10,N,N,-,-1,-1
MULIFE.txt,947777,948802,1025,10,N,N,-,-1,-1
MULIFE.txt,947812,948890,1078,10,N,N,-,-1,-1
MULIFE.txt,947872,948934,1062,10,N,N,-,-1,-1
MULIFE.txt,948008,948970,962,10,N,N,-,-1,-1
MULIFE.txt,948158,949100,942,10,N,N,-,-1,-1
MULIFE.txt,948226,949127,901,10,N,N,-,-1,-1
MULIFE.txt,948261,949384,1123,10,N,N,-,-1,-1
MULIFE.txt,948313,949491,1178,10,N,N,-,-1,-1
MULIFE.txt,948591,949513,922,10,N,N,-,-1,-1
MULIFE.txt,948706,949580,874,10,N,N,-,-1,-1
MULIFE.txt,948803,949749,946,10,N,N,-,-1,-1
MULIFE.txt,948891,949806,915,10,N,N,-,-1,-1
MULIFE.txt,948935,949866,931,10,N,N,-,-1,-1
MULIFE.txt,948971,949980,1009,10,N,N,-,-1,-1
MULIFE.txt,949101,950134,1033,10,N,N,-,-1,-1
MULIFE.txt,949128,950162,1034,10,N,N,-,-1,-1
MULIFE.txt,949385,950287,902,10,N,N,-,-1,-1
MULIFE.txt,949492,950448,956,10,N,N,-,-1,-1
MULIFE.txt,949514,950536,1022,10,N,N,-,-1,-1
MULIFE.txt,949582,950568,986,10,N,N,-,-1,-1
MULIFE.txt,949750,951007,1257,10,N,N,-,-1,-1
MULIFE.txt,949809,951137,1328,10,N,N,-,-1,-1
MULIFE.txt,949867,951292,1425,10,N,N,-,-1,-1
MULIFE.txt,949983,951434,1451,10,N,N,-,-1,-1
MULIFE.txt,950135,951571,1436,10,N,N,-,-1,-1
MULIFE.txt,950163,952019,1856,10,N,N,-,-1,-1
MULIFE.txt,950288,952221,1933,10,N,N,-,-1,-1
MULIFE.txt,950449,952241,1792,10,N,N,-,-1,-1
MULIFE.txt,950539,952391,1852,10,N,N,-,-1,-1
MULIFE.txt,950569,952570,2001,10,N,N,-,-1,-1
MULIFE.txt,951010,952762,1752,10,N,N,-,-1,-1
MULIFE.txt,951140,952962,1822,10,N,N,-,-1,-1
MULIFE.txt,951293,953087,1794,10,N,N,-,-1,-1
MULIFE.txt,951435,953244,1809,10,N,N,-,-1,-1
MULIFE.txt,951572,953323,1751,10,N,N,-,-1,-1
MULIFE.txt,952022,953607,1585,10,N,N,-,-1,-1
MULIFE.txt,952224,953645,1421,10,N,N,-,-1,-1
MULIFE.txt,952242,953760,1518,10,N,Y,1448277167610,40886,47737
MULIFE.txt,952393,953779,1386,10,N,Y,1448277167610,40886,47737
MULIFE.txt,952571,953902,1331,10,N,Y,1448277167610,40886,47737
MULIFE.txt,952763,953970,1207,10,N,Y,1448277167610,40886,47737
MULIFE.txt,952963,954017,1054,10,N,Y,1448277167610,40886,47737
MULIFE.txt,953088,954042,954,10,N,Y,1448277167610,40886,47737
MULIFE.txt,953247,954293,1046,10,N,Y,1448277167610,40886,47737
MULIFE.txt,953324,954512,1188,10,N,Y,1448277167610,40886,47737
MULIFE.txt,953610,954766,1156,10,N,Y,1448277167610,40886,47737
MULIFE.txt,953646,954815,1169,10,N,Y,1448277167610,40886,47737
MULIFE.txt,953761,954953,1192,10,N,Y,1448277167610,40886,47737
MULIFE.txt,953781,955063,1282,10,N,Y,1448277167610,40886,47737
MULIFE.txt,953903,955172,1269,10,N,Y,1448277167610,40886,47737
MULIFE.txt,953971,955230,1259,10,N,Y,1448277167610,40886,47737
MULIFE.txt,954020,955401,1381,10,N,Y,1448277167610,40886,47737
MULIFE.txt,954043,955481,1438,10,N,Y,1437475017618,98942,100041
MULIFE.txt,954294,955627,1333,10,N,Y,1437475017618,98942,100041
MULIFE.txt,954513,955664,1151,10,N,Y,1437475017618,98942,100041
MULIFE.txt,954767,955814,1047,10,N,Y,1437475017618,98942,100041
MULIFE.txt,954817,955883,1066,10,N,Y,1437475017618,98942,100041
MULIFE.txt,954954,956064,1110,10,N,Y,1437475017618,98942,100041
MULIFE.txt,955066,956125,1059,10,N,Y,1437475017618,98942,100041
MULIFE.txt,955173,956303,1130,10,N,Y,1437475017618,98942,100041
MULIFE.txt,955232,956614,1382,10,N,Y,1437475017618,98942,100041
MULIFE.txt,955403,956992,1589,10,N,Y,1437475017618,98942,100041
MULIFE.txt,955482,957060,1578,10,Y,Y,1437475017618,98942,100041
MULIFE.txt,955628,957217,1589,10,Y,Y,1437475017618,98942,100041
MULIFE.txt,955665,957549,1884,10,Y,Y,1437475017618,98942,100041
MULIFE.txt,955815,957612,1797,10,Y,Y,1437475017618,98942,100041
MULIFE.txt,955886,957714,1828,10,Y,Y,1437475017618,98942,100041
MULIFE.txt,956065,957909,1844,10,N,Y,1437475017618,98942,100041
MULIFE.txt,956126,958375,2249,10,N,Y,1437475017618,98942,100041
MULIFE.txt,956304,958390,2086,10,N,Y,1437475017618,98942,100041
MULIFE.txt,956615,958723,2108,10,N,Y,1437475017618,98942,100041
MULIFE.txt,956995,958784,1789,10,N,Y,1437475017618,98942,100041
MULIFE.txt,957061,959117,2056,10,N,Y,1437475017618,98942,100041
MULIFE.txt,957218,959136,1918,10,N,Y,1437475017618,98942,100041
MULIFE.txt,957552,959327,1775,10,N,N,-,-1,-1
MULIFE.txt,957613,959340,1727,10,N,N,-,-1,-1
MULIFE.txt,957715,959486,1771,10,N,N,-,-1,-1
MULIFE.txt,957912,959644,1732,10,N,N,-,-1,-1
MULIFE.txt,958380,959855,1475,10,N,N,-,-1,-1
MULIFE.txt,958391,959973,1582,10,N,N,-,-1,-1
MULIFE.txt,958726,960234,1508,10,N,N,-,-1,-1
MULIFE.txt,958786,960432,1646,10,N,N,-,-1,-1
MULIFE.txt,959120,960439,1319,10,N,N,-,-1,-1
MULIFE.txt,959137,960656,1519,10,N,N,-,-1,-1
MULIFE.txt,959330,960850,1520,10,N,N,-,-1,-1
MULIFE.txt,959343,960894,1551,10,N,N,-,-1,-1
MULIFE.txt,959487,961050,1563,10,N,N,-,-1,-1
MULIFE.txt,959645,961316,1671,10,N,N,-,-1,-1
MULIFE.txt,959858,961410,1552,10,N,N,-,-1,-1
MULIFE.txt,959975,961498,1523,10,N,N,-,-1,-1
MULIFE.txt,960235,961597,1362,10,N,N,-,-1,-1
MULIFE.txt,960433,961848,1415,10,N,N,-,-1,-1
MULIFE.txt,960440,961980,1540,10,N,N,-,-1,-1
MULIFE.txt,960659,962168,1509,10,N,N,-,-1,-1
MULIFE.txt,960851,962645,1794,10,N,N,-,-1,-1
MULIFE.txt,960895,962689,1794,10,N,N,-,-1,-1
MULIFE.txt,961051,962875,1824,10,N,N,-,-1,-1
MULIFE.txt,961319,962900,1581,10,N,N,-,-1,-1
MULIFE.txt,961411,963009,1598,10,N,N,-,-1,-1
MULIFE.txt,961499,963127,1628,10,Y,N,-,-1,-1
MULIFE.txt,961598,963244,1646,10,Y,N,-,-1,-1
MULIFE.txt,961849,963717,1868,10,N,N,-,-1,-1
MULIFE.txt,961983,963722,1739,10,N,N,-,-1,-1
MULIFE.txt,962169,963848,1679,10,N,N,-,-1,-1
MULIFE.txt,962646,964158,1512,10,N,N,-,-1,-1
MULIFE.txt,962690,964385,1695,10,N,N,-,-1,-1
MULIFE.txt,962876,964482,1606,10,N,N,-,-1,-1
MULIFE.txt,962903,964594,1691,10,N,N,-,-1,-1
MULIFE.txt,963010,964788,1778,10,N,N,-,-1,-1
MULIFE.txt,963128,964979,1851,10,N,N,-,-1,-1
MULIFE.txt,963245,965260,2015,10,N,N,-,-1,-1
MULIFE.txt,963718,965366,1648,10,N,N,-,-1,-1
MULIFE.txt,963723,965563,1840,10,N,N,-,-1,-1
MULIFE.txt,963849,965967,2118,10,N,N,-,-1,-1
MULIFE.txt,964159,966044,1885,10,N,N,-,-1,-1
MULIFE.txt,964386,966053,1667,10,N,N,-,-1,-1
MULIFE.txt,964483,966168,1685,10,N,N,-,-1,-1
MULIFE.txt,964595,966235,1640,10,N,N,-,-1,-1
MULIFE.txt,964789,966309,1520,10,N,N,-,-1,-1
MULIFE.txt,964980,966364,1384,10,N,N,-,-1,-1
MULIFE.txt,965261,966399,1138,10,N,N,-,-1,-1
MULIFE.txt,965367,966495,1128,10,N,N,-,-1,-1
MULIFE.txt,965564,966705,1141,10,N,N,-,-1,-1
MULIFE.txt,965970,966908,938,10,N,N,-,-1,-1
MULIFE.txt,966047,966934,887,10,N,N,-,-1,-1
MULIFE.txt,966054,966983,929,10,N,N,-,-1,-1
MULIFE.txt,966170,967000,830,10,N,N,-,-1,-1
MULIFE.txt,966236,967112,876,10,N,N,-,-1,-1
MULIFE.txt,966310,967248,938,10,N,N,-,-1,-1
MULIFE.txt,966365,967399,1034,10,N,N,-,-1,-1
MULIFE.txt,966402,967471,1069,10,N,N,-,-1,-1
MULIFE.txt,966496,967682,1186,10,N,N,-,-1,-1
MULIFE.txt,966706,967700,994,10,N,N,-,-1,-1
MULIFE.txt,966909,967765,856,10,N,N,-,-1,-1
MULIFE.txt,966935,967771,836,10,N,N,-,-1,-1
MULIFE.txt,966984,967774,790,10,N,N,-,-1,-1
MULIFE.txt,967003,967947,944,10,N,N,-,-1,-1
MULIFE.txt,967115,968059,944,10,N,N,-,-1,-1
MULIFE.txt,967249,968096,847,10,N,N,-,-1,-1
MULIFE.txt,967400,968293,893,10,N,N,-,-1,-1
MULIFE.txt,967474,968569,1095,10,N,N,-,-1,-1
MULIFE.txt,967687,968583,896,10,N,N,-,-1,-1
MULIFE.txt,967703,968752,1049,10,N,N,-,-1,-1
MULIFE.txt,967766,968771,1005,10,N,N,-,-1,-1
MULIFE.txt,967772,968934,1162,10,N,N,-,-1,-1
MULIFE.txt,967775,968977,1202,10,N,N,-,-1,-1
MULIFE.txt,967949,968984,1035,10,N,N,-,-1,-1
MULIFE.txt,968061,969092,1031,10,N,N,-,-1,-1
MULIFE.txt,968097,969230,1133,10,N,N,-,-1,-1
MULIFE.txt,968294,969316,1022,10,N,N,-,-1,-1
MULIFE.txt,968570,969664,1094,10,N,N,-,-1,-1
MULIFE.txt,968584,970020,1436,10,N,N,-,-1,-1
MULIFE.txt,968757,970129,1372,10,N,N,-,-1,-1
MULIFE.txt,968772,970258,1486,10,N,N,-,-1,-1
MULIFE.txt,968935,970329,1394,10,N,N,-,-1,-1
MULIFE.txt,968980,970414,1434,10,N,N,-,-1,-1
MULIFE.txt,968985,970508,1523,10,N,N,-,-1,-1
MULIFE.txt,969094,970658,1564,10,N,N,-,-1,-1
MULIFE.txt,969231,970857,1626,10,N,Y,1448281491382,97818,98860
MULIFE.txt,969317,970918,1601,10,N,Y,1448281491382,97818,98860
MULIFE.txt,969666,970974,1308,10,N,Y,1448281491382,97818,98860
MULIFE.txt,970021,971095,1074,10,N,Y,1448281491382,97818,98860
MULIFE.txt,970130,971284,1154,10,N,Y,1448281491382,97818,98860
MULIFE.txt,970259,971325,1066,10,N,Y,1448281491382,97818,98860
MULIFE.txt,970334,971351,1017,10,N,Y,1448281491382,97818,98860
MULIFE.txt,970415,971510,1095,10,N,Y,1448281491382,97818,98860
MULIFE.txt,970509,972328,1819,10,N,Y,1448281491382,97818,98860
MULIFE.txt,970659,972405,1746,10,N,Y,1448281491382,97818,98860
MULIFE.txt,970858,972441,1583,10,N,Y,1448281491382,97818,98860
MULIFE.txt,970921,972823,1902,10,Y,Y,1448281491382,97818,98860
MULIFE.txt,970975,973150,2175,10,Y,Y,1448281491382,97818,98860
MULIFE.txt,971096,973283,2187,10,Y,Y,1448281491382,97818,98860
MULIFE.txt,971285,973830,2545,10,N,Y,1448281491382,97818,98860
MULIFE.txt,971326,974041,2715,10,N,Y,1448281491382,97818,98860
MULIFE.txt,971354,974360,3006,10,Y,Y,1448281491382,97818,98860
MULIFE.txt,971513,974478,2965,10,Y,Y,1448281491382,97818,98860
MULIFE.txt,972329,974676,2347,10,N,Y,1448281491382,97818,98860
MULIFE.txt,972406,974826,2420,10,N,Y,1448281491382,97818,98860
MULIFE.txt,972442,974850,2408,10,N,Y,1448281491382,97818,98860
MULIFE.txt,972824,975124,2300,10,N,Y,1448281491382,97818,98860
MULIFE.txt,973151,975219,2068,10,N,Y,1448281491382,97818,98860
MULIFE.txt,973284,975462,2178,10,N,Y,1448281491382,97818,98860
MULIFE.txt,973831,975481,1650,10,N,Y,1448281491382,97818,98860
MULIFE.txt,974044,975595,1551,10,N,Y,1448281491382,97818,98860
MULIFE.txt,974361,975781,1420,10,N,Y,1448281491382,97818,98860
MULIFE.txt,974479,975831,1352,10,N,Y,1448281491382,97818,98860
MULIFE.txt,974677,975939,1262,10,N,Y,1448281491382,97818,98860
MULIFE.txt,974827,976041,1214,10,N,N,-,-1,-1
MULIFE.txt,974851,976099,1248,10,N,N,-,-1,-1
MULIFE.txt,975125,976171,1046,10,N,N,-,-1,-1
MULIFE.txt,975222,976221,999,10,N,N,-,-1,-1
MULIFE.txt,975467,976252,785,10,N,N,-,-1,-1
MULIFE.txt,975482,976295,813,10,N,N,-,-1,-1
MULIFE.txt,975598,976330,732,10,N,N,-,-1,-1
MULIFE.txt,975782,976458,676,10,N,N,-,-1,-1
MULIFE.txt,975832,976496,664,10,N,N,-,-1,-1
MULIFE.txt,975940,976523,583,10,N,N,-,-1,-1
MULIFE.txt,976042,976746,704,10,N,N,-,-1,-1
MULIFE.txt,976100,976804,704,10,N,N,-,-1,-1
MULIFE.txt,976173,976893,720,10,N,N,-,-1,-1
MULIFE.txt,976222,976919,697,10,N,N,-,-1,-1
MULIFE.txt,976253,977249,996,10,N,N,-,-1,-1
MULIFE.txt,976298,977369,1071,10,N,N,-,-1,-1
MULIFE.txt,976331,977489,1158,10,N,N,-,-1,-1
MULIFE.txt,976460,977522,1062,10,N,N,-,-1,-1
MULIFE.txt,976497,977528,1031,10,N,N,-,-1,-1
MULIFE.txt,976524,977601,1077,10,N,N,-,-1,-1
MULIFE.txt,976747,977715,968,10,N,N,-,-1,-1
MULIFE.txt,976805,977775,970,10,N,N,-,-1,-1
MULIFE.txt,976894,977829,935,10,N,N,-,-1,-1
MULIFE.txt,976922,977893,971,10,N,N,-,-1,-1
MULIFE.txt,977250,977945,695,10,N,N,-,-1,-1
MULIFE.txt,977370,978001,631,10,N,N,-,-1,-1
MULIFE.txt,977490,978090,600,10,N,N,-,-1,-1
MULIFE.txt,977524,978133,609,10,N,N,-,-1,-1
MULIFE.txt,977529,978237,708,10,N,N,-,-1,-1
MULIFE.txt,977602,978289,687,10,N,N,-,-1,-1
MULIFE.txt,977716,978350,634,10,N,N,-,-1,-1
MULIFE.txt,977776,978611,835,10,N,N,-,-1,-1
MULIFE.txt,977830,978786,956,10,N,N,-,-1,-1
MULIFE.txt,977894,978901,1007,10,N,N,-,-1,-1
MULIFE.txt,977946,978979,1033,10,N,N,-,-1,-1
MULIFE.txt,978002,979021,1019,10,N,N,-,-1,-1
MULIFE.txt,978091,979028,937,10,N,N,-,-1,-1
MULIFE.txt,978134,979318,1184,10,N,N,-,-1,-1
MULIFE.txt,978238,979601,1363,10,N,N,-,-1,-1
MULIFE.txt,978290,979609,1319,10,N,N,-,-1,-1
MULIFE.txt,978353,979676,1323,10,N,N,-,-1,-1
MULIFE.txt,978612,979899,1287,10,N,N,-,-1,-1
MULIFE.txt,978789,980012,1223,10,N,N,-,-1,-1
MULIFE.txt,978904,980128,1224,10,N,N,-,-1,-1
MULIFE.txt,978980,980307,1327,10,N,N,-,-1,-1
MULIFE.txt,979022,980348,1326,10,N,N,-,-1,-1
MULIFE.txt,979029,980488,1459,10,N,N,-,-1,-1
MULIFE.txt,979319,980647,1328,10,N,N,-,-1,-1
MULIFE.txt,979603,980708,1105,10,N,N,-,-1,-1
MULIFE.txt,979610,980801,1191,10,N,N,-,-1,-1
MULIFE.txt,979679,980866,1187,10,N,N,-,-1,-1
MULIFE.txt,979900,980939,1039,10,N,N,-,-1,-1
MULIFE.txt,980013,981105,1092,10,N,N,-,-1,-1
MULIFE.txt,980129,981192,1063,10,N,N,-,-1,-1
MULIFE.txt,980308,981263,955,10,N,N,-,-1,-1
MULIFE.txt,980349,981282,933,10,N,N,-,-1,-1
MULIFE.txt,980490,981365,875,10,N,N,-,-1,-1
MULIFE.txt,980648,981430,782,10,N,N,-,-1,-1
MULIFE.txt,980710,981620,910,10,N,N,-,-1,-1
MULIFE.txt,980804,981736,932,10,N,N,-,-1,-1
MULIFE.txt,980867,981931,1064,10,N,N,-,-1,-1
MULIFE.txt,980940,982102,1162,10,N,N,-,-1,-1
MULIFE.txt,981106,982169,1063,10,Y,N,-,-1,-1
MULIFE.txt,981193,982246,1053,10,N,N,-,-1,-1
MULIFE.txt,981264,982286,1022,10,N,N,-,-1,-1
MULIFE.txt,981285,982327,1042,10,N,N,-,-1,-1
MULIFE.txt,981366,982356,990,10,N,N,-,-1,-1
MULIFE.txt,981433,982375,942,10,N,N,-,-1,-1
MULIFE.txt,981621,982451,830,10,N,N,-,-1,-1
MULIFE.txt,981737,982530,793,10,N,N,-,-1,-1
MULIFE.txt,981934,982607,673,10,N,N,-,-1,-1
MULIFE.txt,982103,982766,663,10,N,N,-,-1,-1
MULIFE.txt,982172,983329,1157,10,N,N,-,-1,-1
MULIFE.txt,982247,983342,1095,10,N,N,-,-1,-1
MULIFE.txt,982287,983364,1077,10,N,N,-,-1,-1
MULIFE.txt,982328,983393,1065,10,N,N,-,-1,-1
MULIFE.txt,982361,983901,1540,10,N,N,-,-1,-1
MULIFE.txt,982376,984018,1642,10,N,N,-,-1,-1
MULIFE.txt,982452,984084,1632,10,N,N,-,-1,-1
MULIFE.txt,982533,984105,1572,10,N,N,-,-1,-1
MULIFE.txt,982608,984133,1525,10,N,N,-,-1,-1
MULIFE.txt,982769,984192,1423,10,N,N,-,-1,-1
MULIFE.txt,983334,984209,875,10,N,N,-,-1,-1
MULIFE.txt,983347,984213,866,10,N,N,-,-1,-1
MULIFE.txt,983369,984223,854,10,N,N,-,-1,-1
MULIFE.txt,983396,984240,844,10,N,N,-,-1,-1
MULIFE.txt,983903,984251,348,10,N,N,-,-1,-1
MULIFE.txt,984023,984264,241,10,N,N,-,-1,-1
MULIFE.txt,984085,984307,222,10,N,N,-,-1,-1
MULIFE.txt,984107,984334,227,10,N,N,-,-1,-1
MULIFE.txt,984135,984369,234,10,N,N,-,-1,-1
MULIFE.txt,984193,984375,182,10,N,N,-,-1,-1
MULIFE.txt,984210,984386,176,10,N,N,-,-1,-1
MULIFE.txt,984215,984446,231,10,N,N,-,-1,-1
MULIFE.txt,984224,984457,233,10,N,N,-,-1,-1
MULIFE.txt,984241,984462,221,10,N,N,-,-1,-1
MULIFE.txt,984252,984467,215,10,N,N,-,-1,-1
MULIFE.txt,984265,984480,215,10,N,N,-,-1,-1
MULIFE.txt,984308,984560,252,10,N,N,-,-1,-1
MULIFE.txt,984335,984584,249,10,N,N,-,-1,-1
MULIFE.txt,984370,984591,221,10,N,N,-,-1,-1
MULIFE.txt,984376,984595,219,10,N,N,-,-1,-1
MULIFE.txt,984387,984617,230,10,N,N,-,-1,-1
MULIFE.txt,984447,984685,238,10,N,N,-,-1,-1
MULIFE.txt,984458,984709,251,10,N,N,-,-1,-1
MULIFE.txt,984463,984725,262,10,N,N,-,-1,-1
MULIFE.txt,984468,984729,261,10,N,N,-,-1,-1
MULIFE.txt,984481,984767,286,10,N,N,-,-1,-1
MULIFE.txt,984565,984803,238,10,N,N,-,-1,-1
MULIFE.txt,984585,984825,240,10,N,N,-,-1,-1
MULIFE.txt,984592,984865,273,10,N,N,-,-1,-1
MULIFE.txt,984598,984904,306,10,N,N,-,-1,-1
MULIFE.txt,984618,984957,339,10,N,N,-,-1,-1
MULIFE.txt,984686,984965,279,10,N,N,-,-1,-1
MULIFE.txt,984710,985017,307,10,N,N,-,-1,-1
MULIFE.txt,984726,985075,349,10,N,N,-,-1,-1
MULIFE.txt,984730,985102,372,10,N,N,-,-1,-1
MULIFE.txt,984768,985110,342,10,N,N,-,-1,-1
MULIFE.txt,984804,985137,333,10,N,N,-,-1,-1
MULIFE.txt,984826,985206,380,10,N,N,-,-1,-1
MULIFE.txt,984866,985217,351,10,N,N,-,-1,-1
MULIFE.txt,984905,985292,387,10,N,N,-,-1,-1
MULIFE.txt,984960,985298,338,10,N,N,-,-1,-1
MULIFE.txt,984966,985304,338,10,N,N,-,-1,-1
MULIFE.txt,985019,985314,295,10,N,N,-,-1,-1
MULIFE.txt,985076,985356,280,10,N,N,-,-1,-1
MULIFE.txt,985103,985420,317,10,N,N,-,-1,-1
MULIFE.txt,985110,985430,320,10,N,N,-,-1,-1
MULIFE.txt,985138,985434,296,10,N,N,-,-1,-1
MULIFE.txt,985207,985447,240,10,N,N,-,-1,-1
MULIFE.txt,985219,985492,273,10,N,N,-,-1,-1
MULIFE.txt,985294,985574,280,10,N,N,-,-1,-1
MULIFE.txt,985299,985593,294,10,N,N,-,-1,-1
MULIFE.txt,985307,985598,291,10,N,N,-,-1,-1
MULIFE.txt,985315,985605,290,10,N,N,-,-1,-1
MULIFE.txt,985357,985617,260,10,N,N,-,-1,-1
MULIFE.txt,985421,985681,260,10,N,N,-,-1,-1
MULIFE.txt,985431,985773,342,10,N,N,-,-1,-1
MULIFE.txt,985437,985784,347,10,N,N,-,-1,-1
MULIFE.txt,985448,985790,342,10,N,N,-,-1,-1
MULIFE.txt,985493,985795,302,10,N,N,-,-1,-1
MULIFE.txt,985575,985811,236,10,N,N,-,-1,-1
MULIFE.txt,985594,985842,248,10,N,N,-,-1,-1
MULIFE.txt,985599,986025,426,10,N,N,-,-1,-1
MULIFE.txt,985608,986072,464,10,N,N,-,-1,-1
MULIFE.txt,985618,986083,465,10,N,N,-,-1,-1
MULIFE.txt,985683,986118,435,10,N,N,-,-1,-1
MULIFE.txt,985774,986127,353,10,N,N,-,-1,-1
MULIFE.txt,985785,986138,353,10,N,N,-,-1,-1
MULIFE.txt,985791,986145,354,10,N,N,-,-1,-1
MULIFE.txt,985798,986200,402,10,N,N,-,-1,-1
MULIFE.txt,985812,986204,392,10,N,N,-,-1,-1
MULIFE.txt,985843,986209,366,10,N,N,-,-1,-1
MULIFE.txt,986026,986216,190,10,N,N,-,-1,-1
MULIFE.txt,986073,986274,201,10,N,N,-,-1,-1
MULIFE.txt,986088,986334,246,10,N,N,-,-1,-1
MULIFE.txt,986120,986345,225,10,N,N,-,-1,-1
MULIFE.txt,986128,986346,218,10,N,N,-,-1,-1
MULIFE.txt,986139,986350,211,10,N,N,-,-1,-1
MULIFE.txt,986148,986359,211,10,N,N,-,-1,-1
MULIFE.txt,986201,986382,181,10,N,N,-,-1,-1
MULIFE.txt,986205,986468,263,10,N,N,-,-1,-1
MULIFE.txt,986210,986479,269,10,N,N,-,-1,-1
MULIFE.txt,986219,986485,266,10,N,N,-,-1,-1
MULIFE.txt,986275,986489,214,10,N,N,-,-1,-1
MULIFE.txt,986335,986502,167,10,N,N,-,-1,-1
MULIFE.txt,986345,986533,188,10,N,N,-,-1,-1
MULIFE.txt,986347,986544,197,10,N,N,-,-1,-1
MULIFE.txt,986352,986550,198,10,N,N,-,-1,-1
MULIFE.txt,986360,986564,204,10,N,N,-,-1,-1
MULIFE.txt,986383,986603,220,10,N,N,-,-1,-1
MULIFE.txt,986469,986607,138,10,N,N,-,-1,-1
MULIFE.txt,986480,986617,137,10,N,N,-,-1,-1
MULIFE.txt,986486,986621,135,10,N,N,-,-1,-1
MULIFE.txt,986492,986634,142,10,N,N,-,-1,-1
MULIFE.txt,986503,986673,170,10,N,N,-,-1,-1
MULIFE.txt,986534,986689,155,10,N,N,-,-1,-1
MULIFE.txt,986545,986699,154,10,N,N,-,-1,-1
MULIFE.txt,986553,986766,213,10,N,N,-,-1,-1
MULIFE.txt,986565,986791,226,10,N,N,-,-1,-1
MULIFE.txt,986604,986799,195,10,N,N,-,-1,-1
MULIFE.txt,986608,986816,208,10,N,N,-,-1,-1
MULIFE.txt,986618,986825,207,10,N,N,-,-1,-1
MULIFE.txt,986624,986913,289,10,N,N,-,-1,-1
MULIFE.txt,986635,986970,335,10,N,N,-,-1,-1
MULIFE.txt,986674,986990,316,10,N,N,-,-1,-1
MULIFE.txt,986692,987002,310,10,N,N,-,-1,-1
MULIFE.txt,986700,987009,309,10,N,N,-,-1,-1
MULIFE.txt,986767,987014,247,10,N,N,-,-1,-1
MULIFE.txt,986792,987025,233,10,N,N,-,-1,-1
MULIFE.txt,986800,987090,290,10,N,N,-,-1,-1
MULIFE.txt,986819,987200,381,10,N,N,-,-1,-1
MULIFE.txt,986826,987205,379,10,N,N,-,-1,-1
MULIFE.txt,986914,987265,351,10,N,N,-,-1,-1
MULIFE.txt,986971,987330,359,10,N,N,-,-1,-1
MULIFE.txt,986991,987363,372,10,N,N,-,-1,-1
MULIFE.txt,987003,987440,437,10,N,N,-,-1,-1
MULIFE.txt,987010,987531,521,10,N,N,-,-1,-1
MULIFE.txt,987017,987540,523,10,N,N,-,-1,-1
MULIFE.txt,987026,987557,531,10,N,N,-,-1,-1
MULIFE.txt,987092,987558,466,10,N,N,-,-1,-1
MULIFE.txt,987201,987559,358,10,N,N,-,-1,-1
MULIFE.txt,987206,987606,400,10,N,N,-,-1,-1
MULIFE.txt,987270,987630,360,10,N,N,-,-1,-1
MULIFE.txt,987335,987641,306,10,N,N,-,-1,-1
MULIFE.txt,987366,987650,284,10,N,N,-,-1,-1
MULIFE.txt,987441,987688,247,10,N,N,-,-1,-1
MULIFE.txt,987532,987748,216,10,N,N,-,-1,-1
MULIFE.txt,987541,987760,219,10,N,N,-,-1,-1
MULIFE.txt,987557,987766,209,10,N,N,-,-1,-1
MULIFE.txt,987558,987777,219,10,N,N,-,-1,-1
MULIFE.txt,987561,987866,305,10,N,N,-,-1,-1
MULIFE.txt,987607,987889,282,10,N,N,-,-1,-1
MULIFE.txt,987631,987933,302,10,N,N,-,-1,-1
MULIFE.txt,987642,987941,299,10,N,N,-,-1,-1
MULIFE.txt,987652,987952,300,10,N,N,-,-1,-1
MULIFE.txt,987689,987959,270,10,N,N,-,-1,-1
MULIFE.txt,987750,988006,256,10,N,N,-,-1,-1
MULIFE.txt,987761,988091,330,10,N,N,-,-1,-1
MULIFE.txt,987769,988099,330,10,N,N,-,-1,-1
MULIFE.txt,987778,988103,325,10,N,N,-,-1,-1
MULIFE.txt,987867,988120,253,10,N,N,-,-1,-1
MULIFE.txt,987890,988139,249,10,N,N,-,-1,-1
MULIFE.txt,987934,988154,220,10,N,N,-,-1,-1
MULIFE.txt,987942,988167,225,10,N,N,-,-1,-1
MULIFE.txt,987953,988169,216,10,N,N,-,-1,-1
MULIFE.txt,987961,988173,212,10,N,N,-,-1,-1
MULIFE.txt,988009,988183,174,10,N,N,-,-1,-1
MULIFE.txt,988092,988217,125,10,N,N,-,-1,-1
MULIFE.txt,988100,988262,162,10,N,N,-,-1,-1
MULIFE.txt,988104,988323,219,10,N,N,-,-1,-1
MULIFE.txt,988123,988331,208,10,N,N,-,-1,-1
MULIFE.txt,988140,988336,196,10,N,N,-,-1,-1
MULIFE.txt,988157,988340,183,10,N,N,-,-1,-1
MULIFE.txt,988168,988341,173,10,N,N,-,-1,-1
MULIFE.txt,988170,988342,172,10,N,N,-,-1,-1
MULIFE.txt,988176,988359,183,10,N,N,-,-1,-1
MULIFE.txt,988184,988382,198,10,N,N,-,-1,-1
MULIFE.txt,988218,988411,193,10,N,N,-,-1,-1
MULIFE.txt,988263,988460,197,10,N,N,-,-1,-1
MULIFE.txt,988324,988464,140,10,N,N,-,-1,-1
MULIFE.txt,988332,988475,143,10,N,N,-,-1,-1
MULIFE.txt,988337,988487,150,10,N,N,-,-1,-1
MULIFE.txt,988340,988585,245,10,N,N,-,-1,-1
MULIFE.txt,988341,988591,250,10,N,N,-,-1,-1
MULIFE.txt,988344,988595,251,10,N,N,-,-1,-1
MULIFE.txt,988360,988615,255,10,N,N,-,-1,-1
MULIFE.txt,988383,988703,320,10,N,N,-,-1,-1
MULIFE.txt,988412,988712,300,10,N,N,-,-1,-1
MULIFE.txt,988461,988732,271,10,N,N,-,-1,-1
MULIFE.txt,988465,988738,273,10,N,N,-,-1,-1
MULIFE.txt,988477,988779,302,10,N,N,-,-1,-1
MULIFE.txt,988488,988790,302,10,N,N,-,-1,-1
MULIFE.txt,988586,988796,210,10,N,N,-,-1,-1
MULIFE.txt,988592,988800,208,10,N,N,-,-1,-1
MULIFE.txt,988597,988854,257,10,N,N,-,-1,-1
MULIFE.txt,988617,988858,241,10,N,N,-,-1,-1
MULIFE.txt,988704,988871,167,10,N,N,-,-1,-1
MULIFE.txt,988713,988923,210,10,N,N,-,-1,-1
MULIFE.txt,988733,988931,198,10,N,N,-,-1,-1
MULIFE.txt,988740,988943,203,10,N,N,-,-1,-1
MULIFE.txt,988780,988950,170,10,N,N,-,-1,-1
MULIFE.txt,988791,988954,163,10,N,N,-,-1,-1
MULIFE.txt,988797,988998,201,10,N,N,-,-1,-1
MULIFE.txt,988802,989014,212,10,N,N,-,-1,-1
MULIFE.txt,988855,989037,182,10,N,N,-,-1,-1
MULIFE.txt,988859,989045,186,10,N,N,-,-1,-1
MULIFE.txt,988873,989052,179,10,N,N,-,-1,-1
MULIFE.txt,988924,989086,162,10,N,N,-,-1,-1
MULIFE.txt,988933,989096,163,10,N,N,-,-1,-1
MULIFE.txt,988944,989100,156,10,N,N,-,-1,-1
MULIFE.txt,988951,989113,162,10,N,N,-,-1,-1
MULIFE.txt,988956,989119,163,10,N,N,-,-1,-1
MULIFE.txt,988999,989138,139,10,N,N,-,-1,-1
MULIFE.txt,989016,989142,126,10,N,N,-,-1,-1
MULIFE.txt,989038,989155,117,10,N,N,-,-1,-1
MULIFE.txt,989046,989200,154,10,N,N,-,-1,-1
MULIFE.txt,989054,989201,147,10,N,N,-,-1,-1
MULIFE.txt,989089,989303,214,10,N,N,-,-1,-1
MULIFE.txt,989097,989312,215,10,N,N,-,-1,-1
MULIFE.txt,989101,989324,223,10,N,N,-,-1,-1
MULIFE.txt,989114,989330,216,10,N,N,-,-1,-1
MULIFE.txt,989121,989336,215,10,N,N,-,-1,-1
MULIFE.txt,989139,989384,245,10,N,N,-,-1,-1
MULIFE.txt,989143,989392,249,10,N,N,-,-1,-1
MULIFE.txt,989160,989396,236,10,N,N,-,-1,-1
MULIFE.txt,989200,989406,206,10,N,N,-,-1,-1
MULIFE.txt,989204,989412,208,10,N,N,-,-1,-1
MULIFE.txt,989304,989478,174,10,N,N,-,-1,-1
MULIFE.txt,989314,989484,170,10,N,N,-,-1,-1
MULIFE.txt,989325,989499,174,10,N,N,-,-1,-1
MULIFE.txt,989331,989513,182,10,N,N,-,-1,-1
MULIFE.txt,989339,989519,180,10,N,N,-,-1,-1
MULIFE.txt,989385,989525,140,10,N,N,-,-1,-1
MULIFE.txt,989393,989530,137,10,N,N,-,-1,-1
MULIFE.txt,989397,989546,149,10,N,N,-,-1,-1
MULIFE.txt,989407,989564,157,10,N,N,-,-1,-1
MULIFE.txt,989415,989569,154,10,N,N,-,-1,-1
MULIFE.txt,989480,989576,96,10,N,N,-,-1,-1
MULIFE.txt,989485,989603,118,10,N,N,-,-1,-1
MULIFE.txt,989500,989627,127,10,N,N,-,-1,-1
MULIFE.txt,989515,989643,128,10,N,N,-,-1,-1
MULIFE.txt,989520,989673,153,10,N,N,-,-1,-1
MULIFE.txt,989526,989739,213,10,N,N,-,-1,-1
MULIFE.txt,989531,989759,228,10,N,N,-,-1,-1
MULIFE.txt,989547,989794,247,10,N,N,-,-1,-1
MULIFE.txt,989565,989819,254,10,N,N,-,-1,-1
MULIFE.txt,989570,989823,253,10,N,N,-,-1,-1
MULIFE.txt,989579,989828,249,10,N,N,-,-1,-1
MULIFE.txt,989604,989835,231,10,N,N,-,-1,-1
MULIFE.txt,989628,989870,242,10,N,N,-,-1,-1
MULIFE.txt,989645,989876,231,10,N,N,-,-1,-1
MULIFE.txt,989676,989883,207,10,N,N,-,-1,-1
MULIFE.txt,989740,989886,146,10,N,N,-,-1,-1
MULIFE.txt,989762,989905,143,10,N,N,-,-1,-1
MULIFE.txt,989796,989927,131,10,N,N,-,-1,-1
MULIFE.txt,989820,989934,114,10,N,N,-,-1,-1
MULIFE.txt,989824,989938,114,10,N,N,-,-1,-1
MULIFE.txt,989829,989967,138,10,N,N,-,-1,-1
MULIFE.txt,989838,989974,136,10,N,N,-,-1,-1
MULIFE.txt,989871,989979,108,10,N,N,-,-1,-1
MULIFE.txt,989879,989990,111,10,N,N,-,-1,-1
MULIFE.txt,989884,990009,125,10,N,N,-,-1,-1
MULIFE.txt,989887,990021,134,10,N,N,-,-1,-1
MULIFE.txt,989906,990105,199,10,N,N,-,-1,-1
MULIFE.txt,989930,990165,235,10,N,N,-,-1,-1
MULIFE.txt,989935,990173,238,10,N,N,-,-1,-1
MULIFE.txt,989939,990193,254,10,N,N,-,-1,-1
MULIFE.txt,989970,990228,258,10,N,N,-,-1,-1
MULIFE.txt,989975,990319,344,10,N,N,-,-1,-1
MULIFE.txt,989980,990352,372,10,N,N,-,-1,-1
MULIFE.txt,989991,990358,367,10,N,N,-,-1,-1
MULIFE.txt,990012,990362,350,10,N,N,-,-1,-1
MULIFE.txt,990022,990450,428,10,N,N,-,-1,-1
MULIFE.txt,990106,990483,377,10,N,N,-,-1,-1
MULIFE.txt,990166,990539,373,10,N,N,-,-1,-1
MULIFE.txt,990174,990568,394,10,N,N,-,-1,-1
MULIFE.txt,990194,990574,380,10,N,N,-,-1,-1
MULIFE.txt,990231,990631,400,10,N,N,-,-1,-1
MULIFE.txt,990320,990677,357,10,N,N,-,-1,-1
MULIFE.txt,990353,990681,328,10,N,N,-,-1,-1
MULIFE.txt,990359,990782,423,10,N,N,-,-1,-1
MULIFE.txt,990365,990818,453,10,N,N,-,-1,-1
MULIFE.txt,990451,990876,425,10,N,N,-,-1,-1
MULIFE.txt,990486,990916,430,10,N,N,-,-1,-1
MULIFE.txt,990540,990920,380,10,N,N,-,-1,-1
MULIFE.txt,990569,990974,405,10,N,N,-,-1,-1
MULIFE.txt,990577,991027,450,10,N,N,-,-1,-1
MULIFE.txt,990632,991040,408,10,N,N,-,-1,-1
MULIFE.txt,990678,991075,397,10,N,N,-,-1,-1
MULIFE.txt,990684,991090,406,10,N,N,-,-1,-1
MULIFE.txt,990783,991111,328,10,N,N,-,-1,-1
MULIFE.txt,990821,991237,416,10,N,N,-,-1,-1
MULIFE.txt,990877,991247,370,10,N,N,-,-1,-1
MULIFE.txt,990917,991252,335,10,N,N,-,-1,-1
MULIFE.txt,990928,991258,330,10,N,N,-,-1,-1
MULIFE.txt,990979,991262,283,10,N,N,-,-1,-1
MULIFE.txt,991027,991332,305,10,N,N,-,-1,-1
MULIFE.txt,991043,991381,338,10,N,N,-,-1,-1
MULIFE.txt,991076,991385,309,10,N,N,-,-1,-1
MULIFE.txt,991091,991426,335,10,N,N,-,-1,-1
MULIFE.txt,991114,991436,322,10,N,N,-,-1,-1
MULIFE.txt,991240,991469,229,10,N,N,-,-1,-1
MULIFE.txt,991248,991497,249,10,N,N,-,-1,-1
MULIFE.txt,991253,991508,255,10,N,N,-,-1,-1
MULIFE.txt,991259,991514,255,10,N,N,-,-1,-1
MULIFE.txt,991264,991518,254,10,N,N,-,-1,-1
MULIFE.txt,991335,991535,200,10,N,N,-,-1,-1
MULIFE.txt,991382,991619,237,10,N,N,-,-1,-1
MULIFE.txt,991387,991636,249,10,N,N,-,-1,-1
MULIFE.txt,991428,991640,212,10,N,N,-,-1,-1
MULIFE.txt,991437,991646,209,10,N,N,-,-1,-1
MULIFE.txt,991470,991656,186,10,N,N,-,-1,-1
MULIFE.txt,991498,991675,177,10,N,N,-,-1,-1
MULIFE.txt,991509,991694,185,10,N,N,-,-1,-1
MULIFE.txt,991515,991705,190,10,N,N,-,-1,-1
MULIFE.txt,991520,991717,197,10,N,N,-,-1,-1
MULIFE.txt,991536,991733,197,10,N,N,-,-1,-1
MULIFE.txt,991621,991778,157,10,N,N,-,-1,-1
MULIFE.txt,991637,991794,157,10,N,N,-,-1,-1
MULIFE.txt,991641,991832,191,10,N,N,-,-1,-1
MULIFE.txt,991648,991838,190,10,N,N,-,-1,-1
MULIFE.txt,991657,991881,224,10,N,N,-,-1,-1
MULIFE.txt,991676,991891,215,10,N,N,-,-1,-1
MULIFE.txt,991695,991909,214,10,N,N,-,-1,-1
MULIFE.txt,991708,991919,211,10,N,N,-,-1,-1
MULIFE.txt,991718,991943,225,10,N,N,-,-1,-1
MULIFE.txt,991733,991956,223,10,N,N,-,-1,-1
MULIFE.txt,991781,991975,194,10,N,N,-,-1,-1
MULIFE.txt,991795,991985,190,10,N,N,-,-1,-1
MULIFE.txt,991833,992014,181,10,N,N,-,-1,-1
MULIFE.txt,991839,992067,228,10,N,N,-,-1,-1
MULIFE.txt,991882,992072,190,10,N,N,-,-1,-1
MULIFE.txt,991894,992155,261,10,N,N,-,-1,-1
MULIFE.txt,991912,992168,256,10,N,N,-,-1,-1
MULIFE.txt,991920,992180,260,10,N,N,-,-1,-1
MULIFE.txt,991944,992202,258,10,N,N,-,-1,-1
MULIFE.txt,991957,992203,246,10,N,N,-,-1,-1
MULIFE.txt,991978,992266,288,10,N,N,-,-1,-1
MULIFE.txt,991986,992278,292,10,N,N,-,-1,-1
MULIFE.txt,992015,992285,270,10,N,N,-,-1,-1
MULIFE.txt,992068,992289,221,10,N,N,-,-1,-1
MULIFE.txt,992074,992374,300,10,N,N,-,-1,-1
MULIFE.txt,992156,992536,380,10,N,N,-,-1,-1
MULIFE.txt,992169,992541,372,10,N,N,-,-1,-1
MULIFE.txt,992182,992553,371,10,N,N,-,-1,-1
MULIFE.txt,992202,992557,355,10,N,N,-,-1,-1
MULIFE.txt,992205,992578,373,10,N,N,-,-1,-1
MULIFE.txt,992267,992620,353,10,N,N,-,-1,-1
MULIFE.txt,992279,992670,391,10,N,N,-,-1,-1
MULIFE.txt,992286,992713,427,10,N,N,-,-1,-1
MULIFE.txt,992292,992721,429,10,N,N,-,-1,-1
MULIFE.txt,992375,992733,358,10,N,N,-,-1,-1
MULIFE.txt,992537,992742,205,10,N,N,-,-1,-1
MULIFE.txt,992542,992748,206,10,N,N,-,-1,-1
MULIFE.txt,992554,992756,202,10,N,N,-,-1,-1
MULIFE.txt,992560,992802,242,10,N,N,-,-1,-1
MULIFE.txt,992579,992827,248,10,N,N,-,-1,-1
MULIFE.txt,992621,992838,217,10,N,N,-,-1,-1
MULIFE.txt,992671,992844,173,10,N,N,-,-1,-1
MULIFE.txt,992714,992848,134,10,N,N,-,-1,-1
MULIFE.txt,992722,992855,133,10,N,N,-,-1,-1
MULIFE.txt,992734,992921,187,10,N,N,-,-1,-1
MULIFE.txt,992743,992938,195,10,N,N,-,-1,-1
MULIFE.txt,992751,992952,201,10,N,N,-,-1,-1
MULIFE.txt,992757,992962,205,10,N,N,-,-1,-1
MULIFE.txt,992803,992982,179,10,N,N,-,-1,-1
MULIFE.txt,992828,993007,179,10,N,N,-,-1,-1
MULIFE.txt,992839,993012,173,10,N,N,-,-1,-1
MULIFE.txt,992845,993019,174,10,N,N,-,-1,-1
MULIFE.txt,992850,993047,197,10,N,N,-,-1,-1
MULIFE.txt,992856,993053,197,10,N,N,-,-1,-1
MULIFE.txt,992922,993059,137,10,N,N,-,-1,-1
MULIFE.txt,992939,993085,146,10,N,N,-,-1,-1
MULIFE.txt,992953,993091,138,10,N,N,-,-1,-1
MULIFE.txt,992967,993119,152,10,N,N,-,-1,-1
MULIFE.txt,992984,993120,136,10,N,N,-,-1,-1
MULIFE.txt,993008,993121,113,10,N,N,-,-1,-1
MULIFE.txt,993014,993127,113,10,N,N,-,-1,-1
MULIFE.txt,993020,993133,113,10,N,N,-,-1,-1
MULIFE.txt,993048,993162,114,10,N,N,-,-1,-1
MULIFE.txt,993055,993180,125,10,N,N,-,-1,-1
MULIFE.txt,993060,993189,129,10,N,N,-,-1,-1
MULIFE.txt,993086,993197,111,10,N,N,-,-1,-1
MULIFE.txt,993093,993202,109,10,N,N,-,-1,-1
MULIFE.txt,993119,993212,93,10,N,N,-,-1,-1
MULIFE.txt,993120,993218,98,10,N,N,-,-1,-1
MULIFE.txt,993122,993227,105,10,N,N,-,-1,-1
MULIFE.txt,993129,993236,107,10,N,N,-,-1,-1
MULIFE.txt,993134,993252,118,10,N,N,-,-1,-1
MULIFE.txt,993164,993258,94,10,N,N,-,-1,-1
MULIFE.txt,993181,993317,136,10,N,N,-,-1,-1
MULIFE.txt,993190,993336,146,10,N,N,-,-1,-1
MULIFE.txt,993199,993343,144,10,N,N,-,-1,-1
MULIFE.txt,993203,993420,217,10,N,N,-,-1,-1
MULIFE.txt,993213,993428,215,10,N,N,-,-1,-1
MULIFE.txt,993219,993445,226,10,N,N,-,-1,-1
MULIFE.txt,993228,993469,241,10,N,N,-,-1,-1
MULIFE.txt,993237,993488,251,10,N,N,-,-1,-1
MULIFE.txt,993253,993496,243,10,N,N,-,-1,-1
MULIFE.txt,993260,993507,247,10,N,N,-,-1,-1
MULIFE.txt,993318,993526,208,10,N,N,-,-1,-1
MULIFE.txt,993337,993534,197,10,N,N,-,-1,-1
MULIFE.txt,993345,993538,193,10,N,N,-,-1,-1
MULIFE.txt,993421,993543,122,10,N,N,-,-1,-1
MULIFE.txt,993429,993550,121,10,N,N,-,-1,-1
MULIFE.txt,993447,993560,113,10,N,N,-,-1,-1
MULIFE.txt,993472,993609,137,10,N,N,-,-1,-1
MULIFE.txt,993489,993634,145,10,N,N,-,-1,-1
MULIFE.txt,993497,993642,145,10,N,N,-,-1,-1
MULIFE.txt,993510,993664,154,10,N,N,-,-1,-1
MULIFE.txt,993527,993739,212,10,N,N,-,-1,-1
MULIFE.txt,993535,993784,249,10,N,N,-,-1,-1
MULIFE.txt,993539,993816,277,10,N,N,-,-1,-1
MULIFE.txt,993544,993839,295,10,N,N,-,-1,-1
MULIFE.txt,993553,993852,299,10,N,N,-,-1,-1
MULIFE.txt,993561,993871,310,10,N,N,-,-1,-1
MULIFE.txt,993610,993892,282,10,N,N,-,-1,-1
MULIFE.txt,993635,993909,274,10,N,N,-,-1,-1
MULIFE.txt,993643,993928,285,10,N,N,-,-1,-1
MULIFE.txt,993665,993938,273,10,N,N,-,-1,-1
MULIFE.txt,993740,993964,224,10,N,N,-,-1,-1
MULIFE.txt,993785,993974,189,10,N,N,-,-1,-1
MULIFE.txt,993817,993994,177,10,N,N,-,-1,-1
MULIFE.txt,993842,994002,160,10,N,N,-,-1,-1
MULIFE.txt,993855,994007,152,10,N,N,-,-1,-1
MULIFE.txt,993873,994015,142,10,N,N,-,-1,-1
MULIFE.txt,993893,994021,128,10,N,N,-,-1,-1
MULIFE.txt,993910,994039,129,10,N,N,-,-1,-1
MULIFE.txt,993930,994048,118,10,N,N,-,-1,-1
MULIFE.txt,993939,994058,119,10,N,N,-,-1,-1
MULIFE.txt,993966,994069,103,10,N,N,-,-1,-1
MULIFE.txt,993975,994133,158,10,N,N,-,-1,-1
MULIFE.txt,993995,994151,156,10,N,N,-,-1,-1
MULIFE.txt,994003,994159,156,10,N,N,-,-1,-1
MULIFE.txt,994008,994163,155,10,N,N,-,-1,-1
MULIFE.txt,994016,994168,152,10,N,N,-,-1,-1
MULIFE.txt,994023,994174,151,10,N,N,-,-1,-1
MULIFE.txt,994040,994191,151,10,N,N,-,-1,-1
MULIFE.txt,994049,994199,150,10,N,N,-,-1,-1
MULIFE.txt,994059,994203,144,10,N,N,-,-1,-1
MULIFE.txt,994072,994208,136,10,N,N,-,-1,-1
MULIFE.txt,994135,994215,80,10,N,N,-,-1,-1
MULIFE.txt,994152,994234,82,10,N,N,-,-1,-1
MULIFE.txt,994160,994242,82,10,N,N,-,-1,-1
MULIFE.txt,994164,994246,82,10,N,N,-,-1,-1
MULIFE.txt,994169,994251,82,10,N,N,-,-1,-1
MULIFE.txt,994176,994261,85,10,N,N,-,-1,-1
MULIFE.txt,994192,994278,86,10,N,N,-,-1,-1
MULIFE.txt,994200,994296,96,10,N,N,-,-1,-1
MULIFE.txt,994204,994305,101,10,N,N,-,-1,-1
MULIFE.txt,994209,994315,106,10,N,N,-,-1,-1
MULIFE.txt,994217,994328,111,10,N,N,-,-1,-1
MULIFE.txt,994235,994334,99,10,N,N,-,-1,-1
MULIFE.txt,994243,994352,109,10,N,N,-,-1,-1
MULIFE.txt,994247,994359,112,10,N,N,-,-1,-1
MULIFE.txt,994252,994372,120,10,N,N,-,-1,-1
MULIFE.txt,994262,994397,135,10,N,N,-,-1,-1
MULIFE.txt,994279,994405,126,10,N,N,-,-1,-1
MULIFE.txt,994298,994417,119,10,N,N,-,-1,-1
MULIFE.txt,994306,994423,117,10,N,N,-,-1,-1
MULIFE.txt,994316,994442,126,10,N,N,-,-1,-1
MULIFE.txt,994329,994450,121,10,N,N,-,-1,-1
MULIFE.txt,994336,994460,124,10,N,N,-,-1,-1
MULIFE.txt,994353,994541,188,10,N,N,-,-1,-1
MULIFE.txt,994360,994560,200,10,N,N,-,-1,-1
MULIFE.txt,994372,994576,204,10,N,N,-,-1,-1
MULIFE.txt,994398,994580,182,10,N,N,-,-1,-1
MULIFE.txt,994406,994601,195,10,N,N,-,-1,-1
MULIFE.txt,994418,994612,194,10,N,N,-,-1,-1
MULIFE.txt,994426,994620,194,10,N,N,-,-1,-1
MULIFE.txt,994443,994624,181,10,N,N,-,-1,-1
MULIFE.txt,994451,994644,193,10,N,N,-,-1,-1
MULIFE.txt,994462,994651,189,10,N,N,-,-1,-1
MULIFE.txt,994544,994677,133,10,N,N,-,-1,-1
MULIFE.txt,994561,994731,170,10,N,N,-,-1,-1
MULIFE.txt,994577,994742,165,10,N,N,-,-1,-1
MULIFE.txt,994582,994751,169,10,N,N,-,-1,-1
MULIFE.txt,994602,994803,201,10,N,N,-,-1,-1
MULIFE.txt,994613,994867,254,10,N,N,-,-1,-1
MULIFE.txt,994621,994886,265,10,N,N,-,-1,-1
MULIFE.txt,994625,994897,272,10,N,N,-,-1,-1
MULIFE.txt,994645,994930,285,10,N,N,-,-1,-1
MULIFE.txt,994652,994959,307,10,N,N,-,-1,-1
MULIFE.txt,994678,994963,285,10,N,N,-,-1,-1
MULIFE.txt,994732,994968,236,10,N,N,-,-1,-1
MULIFE.txt,994743,994995,252,10,N,N,-,-1,-1
MULIFE.txt,994756,995003,247,10,N,N,-,-1,-1
MULIFE.txt,994808,995007,199,10,N,N,-,-1,-1
MULIFE.txt,994870,995012,142,10,N,N,-,-1,-1
MULIFE.txt,994887,995041,154,10,N,N,-,-1,-1
MULIFE.txt,994899,995049,150,10,N,N,-,-1,-1
MULIFE.txt,994932,995085,153,10,N,N,-,-1,-1
MULIFE.txt,994960,995093,133,10,N,N,-,-1,-1
MULIFE.txt,994964,995110,146,10,N,N,-,-1,-1
MULIFE.txt,994969,995131,162,10,N,N,-,-1,-1
MULIFE.txt,994996,995139,143,10,N,N,-,-1,-1
MULIFE.txt,995004,995144,140,10,N,N,-,-1,-1
MULIFE.txt,995008,995152,144,10,N,N,-,-1,-1
MULIFE.txt,995013,995158,145,10,N,N,-,-1,-1
MULIFE.txt,995042,995177,135,10,N,N,-,-1,-1
MULIFE.txt,995050,995185,135,10,N,N,-,-1,-1
MULIFE.txt,995086,995196,110,10,N,N,-,-1,-1
MULIFE.txt,995094,995246,152,10,N,N,-,-1,-1
MULIFE.txt,995111,995264,153,10,N,N,-,-1,-1
MULIFE.txt,995132,995311,179,10,N,N,-,-1,-1
MULIFE.txt,995140,995318,178,10,N,N,-,-1,-1
MULIFE.txt,995145,995362,217,10,N,N,-,-1,-1
MULIFE.txt,995153,995373,220,10,N,N,-,-1,-1
MULIFE.txt,995161,995385,224,10,N,N,-,-1,-1
MULIFE.txt,995178,995418,240,10,N,N,-,-1,-1
MULIFE.txt,995186,995436,250,10,N,N,-,-1,-1
MULIFE.txt,995198,995474,276,10,N,N,-,-1,-1
MULIFE.txt,995247,995531,284,10,N,N,-,-1,-1
MULIFE.txt,995265,995549,284,10,N,N,-,-1,-1
MULIFE.txt,995313,995574,261,10,N,N,-,-1,-1
MULIFE.txt,995319,995601,282,10,N,N,-,-1,-1
MULIFE.txt,995365,995605,240,10,N,N,-,-1,-1
MULIFE.txt,995374,995617,243,10,N,N,-,-1,-1
MULIFE.txt,995388,995641,253,10,N,N,-,-1,-1
MULIFE.txt,995421,995649,228,10,N,N,-,-1,-1
MULIFE.txt,995437,995654,217,10,N,N,-,-1,-1
MULIFE.txt,995475,995656,181,10,N,N,-,-1,-1
MULIFE.txt,995533,995661,128,10,N,N,-,-1,-1
MULIFE.txt,995551,995707,156,10,N,N,-,-1,-1
MULIFE.txt,995577,995726,149,10,N,N,-,-1,-1
MULIFE.txt,995602,995742,140,10,N,N,-,-1,-1
MULIFE.txt,995606,995746,140,10,N,N,-,-1,-1
MULIFE.txt,995618,995764,146,10,N,N,-,-1,-1
MULIFE.txt,995642,995772,130,10,N,N,-,-1,-1
MULIFE.txt,995650,995790,140,10,N,N,-,-1,-1
MULIFE.txt,995655,995840,185,10,N,N,-,-1,-1
MULIFE.txt,995657,995919,262,10,N,N,-,-1,-1
MULIFE.txt,995663,995923,260,10,N,N,-,-1,-1
MULIFE.txt,995710,995928,218,10,N,N,-,-1,-1
MULIFE.txt,995727,995934,207,10,N,N,-,-1,-1
MULIFE.txt,995743,995947,204,10,N,N,-,-1,-1
MULIFE.txt,995748,995976,228,10,N,N,-,-1,-1
MULIFE.txt,995765,996027,262,10,N,N,-,-1,-1
MULIFE.txt,995773,996057,284,10,N,N,-,-1,-1
MULIFE.txt,995793,996062,269,10,N,N,-,-1,-1
MULIFE.txt,995841,996068,227,10,N,N,-,-1,-1
MULIFE.txt,995920,996072,152,10,N,N,-,-1,-1
MULIFE.txt,995924,996086,162,10,N,N,-,-1,-1
MULIFE.txt,995929,996118,189,10,N,N,-,-1,-1
MULIFE.txt,995937,996164,227,10,N,N,-,-1,-1
MULIFE.txt,995948,996207,259,10,N,N,-,-1,-1
MULIFE.txt,995977,996212,235,10,N,N,-,-1,-1
MULIFE.txt,996028,996218,190,10,N,N,-,-1,-1
MULIFE.txt,996058,996223,165,10,N,N,-,-1,-1
MULIFE.txt,996063,996247,184,10,N,N,-,-1,-1
MULIFE.txt,996069,996390,321,10,N,N,-,-1,-1
MULIFE.txt,996077,996436,359,10,N,N,-,-1,-1
MULIFE.txt,996087,996446,359,10,N,N,-,-1,-1
MULIFE.txt,996119,996451,332,10,N,N,-,-1,-1
MULIFE.txt,996165,996462,297,10,N,N,-,-1,-1
MULIFE.txt,996208,996515,307,10,N,N,-,-1,-1
MULIFE.txt,996213,996556,343,10,N,N,-,-1,-1
MULIFE.txt,996219,996567,348,10,N,N,-,-1,-1
MULIFE.txt,996226,996687,461,10,N,N,-,-1,-1
MULIFE.txt,996248,996693,445,10,N,N,-,-1,-1
MULIFE.txt,996392,996728,336,10,N,N,-,-1,-1
MULIFE.txt,996437,996740,303,10,N,N,-,-1,-1
MULIFE.txt,996447,996750,303,10,N,N,-,-1,-1
MULIFE.txt,996454,996890,436,10,N,N,-,-1,-1
MULIFE.txt,996463,996996,533,10,N,N,-,-1,-1
MULIFE.txt,996517,997004,487,10,N,N,-,-1,-1
MULIFE.txt,996559,997010,451,10,N,N,-,-1,-1
MULIFE.txt,996568,997018,450,10,N,N,-,-1,-1
MULIFE.txt,996688,997022,334,10,N,N,-,-1,-1
MULIFE.txt,996695,997028,333,10,N,N,-,-1,-1
MULIFE.txt,996730,997036,306,10,N,N,-,-1,-1
MULIFE.txt,996743,997135,392,10,N,N,-,-1,-1
MULIFE.txt,996751,997162,411,10,N,N,-,-1,-1
MULIFE.txt,996892,997173,281,10,N,N,-,-1,-1
MULIFE.txt,996997,997178,181,10,N,N,-,-1,-1
MULIFE.txt,997006,997184,178,10,N,N,-,-1,-1
MULIFE.txt,997011,997185,174,10,N,N,-,-1,-1
MULIFE.txt,997019,997186,167,10,N,N,-,-1,-1
MULIFE.txt,997023,997208,185,10,N,N,-,-1,-1
MULIFE.txt,997031,997293,262,10,N,N,-,-1,-1
MULIFE.txt,997037,997299,262,10,N,N,-,-1,-1
MULIFE.txt,997136,997306,170,10,N,N,-,-1,-1
MULIFE.txt,997163,997313,150,10,N,N,-,-1,-1
MULIFE.txt,997174,997342,168,10,N,N,-,-1,-1
MULIFE.txt,997179,997349,170,10,N,N,-,-1,-1
MULIFE.txt,997184,997418,234,10,N,N,-,-1,-1
MULIFE.txt,997185,997453,268,10,N,N,-,-1,-1
MULIFE.txt,997191,997464,273,10,N,N,-,-1,-1
MULIFE.txt,997209,997525,316,10,N,N,-,-1,-1
MULIFE.txt,997295,997577,282,10,N,N,-,-1,-1
MULIFE.txt,997300,997608,308,10,N,N,-,-1,-1
MULIFE.txt,997309,997637,328,10,N,N,-,-1,-1
MULIFE.txt,997314,997641,327,10,N,N,-,-1,-1
MULIFE.txt,997343,997646,303,10,N,N,-,-1,-1
MULIFE.txt,997350,997653,303,10,N,N,-,-1,-1
MULIFE.txt,997419,997657,238,10,N,N,-,-1,-1
MULIFE.txt,997454,997695,241,10,N,N,-,-1,-1
MULIFE.txt,997465,997704,239,10,N,N,-,-1,-1
MULIFE.txt,997526,997712,186,10,N,N,-,-1,-1
MULIFE.txt,997579,997727,148,10,N,N,-,-1,-1
MULIFE.txt,997609,997734,125,10,N,N,-,-1,-1
MULIFE.txt,997638,997748,110,10,N,N,-,-1,-1
MULIFE.txt,997642,997756,114,10,N,N,-,-1,-1
MULIFE.txt,997647,997784,137,10,N,N,-,-1,-1
MULIFE.txt,997654,997827,173,10,N,N,-,-1,-1
MULIFE.txt,997662,997835,173,10,N,N,-,-1,-1
MULIFE.txt,997696,997839,143,10,N,N,-,-1,-1
MULIFE.txt,997709,997852,143,10,N,N,-,-1,-1
MULIFE.txt,997717,997860,143,10,N,N,-,-1,-1
MULIFE.txt,997728,997955,227,10,N,N,-,-1,-1
MULIFE.txt,997739,997961,222,10,N,N,-,-1,-1
MULIFE.txt,997749,997967,218,10,N,N,-,-1,-1
MULIFE.txt,997759,997971,212,10,N,N,-,-1,-1
MULIFE.txt,997786,998014,228,10,N,N,-,-1,-1
MULIFE.txt,997828,998113,285,10,N,N,-,-1,-1
MULIFE.txt,997836,998128,292,10,N,N,-,-1,-1
MULIFE.txt,997840,998142,302,10,N,N,-,-1,-1
MULIFE.txt,997855,998148,293,10,N,N,-,-1,-1
MULIFE.txt,997862,998152,290,10,N,N,-,-1,-1
MULIFE.txt,997956,998166,210,10,N,N,-,-1,-1
MULIFE.txt,997962,998201,239,10,N,N,-,-1,-1
MULIFE.txt,997968,998229,261,10,N,N,-,-1,-1
MULIFE.txt,997973,998235,262,10,N,N,-,-1,-1
MULIFE.txt,998015,998252,237,10,N,N,-,-1,-1
MULIFE.txt,998114,998258,144,10,N,N,-,-1,-1
MULIFE.txt,998129,998332,203,10,N,N,-,-1,-1
MULIFE.txt,998143,998350,207,10,N,N,-,-1,-1
MULIFE.txt,998149,998361,212,10,N,N,-,-1,-1
MULIFE.txt,998157,998365,208,10,N,N,-,-1,-1
MULIFE.txt,998167,998416,249,10,N,N,-,-1,-1
MULIFE.txt,998202,998481,279,10,N,N,-,-1,-1
MULIFE.txt,998230,998495,265,10,N,N,-,-1,-1
MULIFE.txt,998236,998512,276,10,N,N,-,-1,-1
MULIFE.txt,998253,998521,268,10,N,N,-,-1,-1
MULIFE.txt,998263,998605,342,10,N,N,-,-1,-1
MULIFE.txt,998333,998643,310,10,N,N,-,-1,-1
MULIFE.txt,998351,998655,304,10,N,N,-,-1,-1
MULIFE.txt,998362,998661,299,10,N,N,-,-1,-1
MULIFE.txt,998370,998667,297,10,N,N,-,-1,-1
MULIFE.txt,998421,998684,263,10,N,N,-,-1,-1
MULIFE.txt,998484,998727,243,10,N,N,-,-1,-1
MULIFE.txt,998496,998775,279,10,N,N,-,-1,-1
MULIFE.txt,998513,998786,273,10,N,N,-,-1,-1
MULIFE.txt,998522,998793,271,10,N,N,-,-1,-1
MULIFE.txt,998607,998837,230,10,N,N,-,-1,-1
MULIFE.txt,998645,998854,209,10,N,N,-,-1,-1
MULIFE.txt,998656,998902,246,10,N,N,-,-1,-1
MULIFE.txt,998662,998978,316,10,N,N,-,-1,-1
MULIFE.txt,998672,998984,312,10,N,N,-,-1,-1
MULIFE.txt,998684,998988,304,10,N,N,-,-1,-1
MULIFE.txt,998728,998998,270,10,N,N,-,-1,-1
MULIFE.txt,998776,999043,267,10,N,N,-,-1,-1
MULIFE.txt,998787,999088,301,10,N,N,-,-1,-1
MULIFE.txt,998793,999094,301,10,N,N,-,-1,-1
MULIFE.txt,998838,999099,261,10,N,N,-,-1,-1
MULIFE.txt,998859,999100,241,10,N,N,-,-1,-1
MULIFE.txt,998903,999101,198,10,N,N,-,-1,-1
MULIFE.txt,998979,999106,127,10,N,N,-,-1,-1
MULIFE.txt,998985,999114,129,10,N,N,-,-1,-1
MULIFE.txt,998991,999163,172,10,N,N,-,-1,-1
MULIFE.txt,998999,999187,188,10,N,N,-,-1,-1
MULIFE.txt,999044,999197,153,10,N,N,-,-1,-1
MULIFE.txt,999090,999198,108,10,N,N,-,-1,-1
MULIFE.txt,999095,999199,104,10,N,N,-,-1,-1
MULIFE.txt,999099,999204,105,10,N,N,-,-1,-1
MULIFE.txt,999100,999216,116,10,N,N,-,-1,-1
MULIFE.txt,999102,999262,160,10,N,N,-,-1,-1
MULIFE.txt,999109,999274,165,10,N,N,-,-1,-1
MULIFE.txt,999115,999293,178,10,N,N,-,-1,-1
MULIFE.txt,999164,999314,150,10,N,N,-,-1,-1
MULIFE.txt,999188,999372,184,10,N,N,-,-1,-1
MULIFE.txt,999197,999385,188,10,N,N,-,-1,-1
MULIFE.txt,999198,999397,199,10,N,N,-,-1,-1
MULIFE.txt,999200,999431,231,10,N,N,-,-1,-1
MULIFE.txt,999206,999463,257,10,N,N,-,-1,-1
MULIFE.txt,999217,999468,251,10,N,N,-,-1,-1
MULIFE.txt,999263,999475,212,10,N,N,-,-1,-1
MULIFE.txt,999275,999497,222,10,N,N,-,-1,-1
MULIFE.txt,999294,999572,278,10,N,N,-,-1,-1
MULIFE.txt,999314,999653,339,10,N,N,-,-1,-1
MULIFE.txt,999375,999659,284,10,N,N,-,-1,-1
MULIFE.txt,999387,999691,304,10,N,N,-,-1,-1
MULIFE.txt,999398,999699,301,10,N,N,-,-1,-1
MULIFE.txt,999432,999710,278,10,N,N,-,-1,-1
MULIFE.txt,999464,999715,251,10,N,N,-,-1,-1
MULIFE.txt,999469,999736,267,10,N,N,-,-1,-1
MULIFE.txt,999477,999740,263,10,N,N,-,-1,-1
MULIFE.txt,999498,999745,247,10,N,N,-,-1,-1
MULIFE.txt,999575,999767,192,10,N,N,-,-1,-1
MULIFE.txt,999654,999768,114,10,N,N,-,-1,-1
MULIFE.txt,999664,999769,105,10,N,N,-,-1,-1
MULIFE.txt,999692,999785,93,10,N,N,-,-1,-1
MULIFE.txt,999700,999790,90,10,N,N,-,-1,-1
MULIFE.txt,999711,999812,101,10,N,N,-,-1,-1
MULIFE.txt,999716,999817,101,10,N,N,-,-1,-1
MULIFE.txt,999737,999840,103,10,N,N,-,-1,-1
MULIFE.txt,999741,999982,241,10,N,N,-,-1,-1
MULIFE.txt,999746,999993,247,10,N,N,-,-1,-1
MULIFE.txt,999767,999999,232,10,N,N,-,-1,-1
MULIFE.txt,999768,1000004,236,10,N,N,-,-1,-1
MULIFE.txt,999770,1000056,286,10,N,N,-,-1,-1
MULIFE.txt,999786,1000102,316,10,N,N,-,-1,-1
MULIFE.txt,999791,1000137,346,10,N,N,-,-1,-1
MULIFE.txt,999813,1000142,329,10,N,N,-,-1,-1
MULIFE.txt,999818,1000153,335,10,N,N,-,-1,-1
MULIFE.txt,999843,1000157,314,10,N,N,-,-1,-1
MULIFE.txt,999983,1000166,183,10,N,N,-,-1,-1
MULIFE.txt,999994,1000243,249,10,N,N,-,-1,-1
MULIFE.txt,1000000,1000270,270,10,N,N,-,-1,-1
MULIFE.txt,1000009,1000278,269,10,N,N,-,-1,-1
MULIFE.txt,1000057,1000289,232,10,N,N,-,-1,-1
MULIFE.txt,1000103,1000300,197,10,N,N,-,-1,-1
MULIFE.txt,1000138,1000322,184,10,N,N,-,-1,-1
MULIFE.txt,1000144,1000342,198,10,N,N,-,-1,-1
MULIFE.txt,1000154,1000346,192,10,N,N,-,-1,-1
MULIFE.txt,1000160,1000351,191,10,N,N,-,-1,-1
MULIFE.txt,1000167,1000360,193,10,N,N,-,-1,-1
MULIFE.txt,1000244,1000371,127,10,N,N,-,-1,-1
MULIFE.txt,1000271,1000410,139,10,N,N,-,-1,-1
MULIFE.txt,1000279,1000435,156,10,N,N,-,-1,-1
MULIFE.txt,1000292,1000447,155,10,N,N,-,-1,-1
MULIFE.txt,1000301,1000455,154,10,N,N,-,-1,-1
MULIFE.txt,1000324,1000466,142,10,N,N,-,-1,-1
MULIFE.txt,1000343,1000472,129,10,N,N,-,-1,-1
MULIFE.txt,1000347,1000484,137,10,N,N,-,-1,-1
MULIFE.txt,1000352,1000492,140,10,N,N,-,-1,-1
MULIFE.txt,1000363,1000504,141,10,N,N,-,-1,-1
MULIFE.txt,1000372,1000511,139,10,N,N,-,-1,-1
MULIFE.txt,1000411,1000522,111,10,N,N,-,-1,-1
MULIFE.txt,1000437,1000608,171,10,N,N,-,-1,-1
MULIFE.txt,1000448,1000684,236,10,N,N,-,-1,-1
MULIFE.txt,1000456,1000721,265,10,N,N,-,-1,-1
MULIFE.txt,1000467,1000727,260,10,N,N,-,-1,-1
MULIFE.txt,1000474,1000738,264,10,N,N,-,-1,-1
MULIFE.txt,1000485,1000815,330,10,N,N,-,-1,-1
MULIFE.txt,1000493,1000898,405,10,N,N,-,-1,-1
MULIFE.txt,1000505,1000907,402,10,N,N,-,-1,-1
MULIFE.txt,1000514,1001016,502,10,N,N,-,-1,-1
MULIFE.txt,1000523,1001093,570,10,N,N,-,-1,-1
MULIFE.txt,1000609,1001108,499,10,N,N,-,-1,-1
MULIFE.txt,1000685,1001113,428,10,N,N,-,-1,-1
MULIFE.txt,1000722,1001120,398,10,N,N,-,-1,-1
MULIFE.txt,1000730,1001124,394,10,N,N,-,-1,-1
MULIFE.txt,1000739,1001136,397,10,N,N,-,-1,-1
MULIFE.txt,1000816,1001152,336,10,N,N,-,-1,-1
MULIFE.txt,1000901,1001171,270,10,N,N,-,-1,-1
MULIFE.txt,1000908,1001268,360,10,N,N,-,-1,-1
MULIFE.txt,1001017,1001280,263,10,N,N,-,-1,-1
MULIFE.txt,1001094,1001285,191,10,N,N,-,-1,-1
MULIFE.txt,1001109,1001297,188,10,N,N,-,-1,-1
MULIFE.txt,1001114,1001313,199,10,N,N,-,-1,-1
MULIFE.txt,1001121,1001341,220,10,N,N,-,-1,-1
MULIFE.txt,1001129,1001362,233,10,N,N,-,-1,-1
MULIFE.txt,1001137,1001367,230,10,N,N,-,-1,-1
MULIFE.txt,1001153,1001374,221,10,N,N,-,-1,-1
MULIFE.txt,1001172,1001385,213,10,N,N,-,-1,-1
MULIFE.txt,1001269,1001415,146,10,N,N,-,-1,-1
MULIFE.txt,1001281,1001441,160,10,N,N,-,-1,-1
MULIFE.txt,1001285,1001452,167,10,N,N,-,-1,-1
MULIFE.txt,1001298,1001461,163,10,N,N,-,-1,-1
MULIFE.txt,1001314,1001472,158,10,N,N,-,-1,-1
MULIFE.txt,1001342,1001500,158,10,N,N,-,-1,-1
MULIFE.txt,1001363,1001517,154,10,N,N,-,-1,-1
MULIFE.txt,1001368,1001521,153,10,N,N,-,-1,-1
MULIFE.txt,1001377,1001527,150,10,N,N,-,-1,-1
MULIFE.txt,1001386,1001532,146,10,N,N,-,-1,-1
MULIFE.txt,1001416,1001533,117,10,N,N,-,-1,-1
MULIFE.txt,1001442,1001534,92,10,N,N,-,-1,-1
MULIFE.txt,1001453,1001538,85,10,N,N,-,-1,-1
MULIFE.txt,1001464,1001575,111,10,N,N,-,-1,-1
MULIFE.txt,1001473,1001603,130,10,N,N,-,-1,-1
MULIFE.txt,1001501,1001610,109,10,N,N,-,-1,-1
MULIFE.txt,1001518,1001648,130,10,N,N,-,-1,-1
MULIFE.txt,1001523,1001695,172,10,N,N,-,-1,-1
MULIFE.txt,1001528,1001714,186,10,N,N,-,-1,-1
MULIFE.txt,1001532,1001719,187,10,N,N,-,-1,-1
MULIFE.txt,1001533,1001726,193,10,N,N,-,-1,-1
MULIFE.txt,1001535,1001743,208,10,N,N,-,-1,-1
MULIFE.txt,1001541,1001754,213,10,N,N,-,-1,-1
MULIFE.txt,1001576,1001760,184,10,N,N,-,-1,-1
MULIFE.txt,1001606,1001764,158,10,N,N,-,-1,-1
MULIFE.txt,1001611,1001775,164,10,N,N,-,-1,-1
MULIFE.txt,1001649,1001855,206,10,N,N,-,-1,-1
MULIFE.txt,1001698,1001876,178,10,N,N,-,-1,-1
MULIFE.txt,1001715,1001884,169,10,N,N,-,-1,-1
MULIFE.txt,1001720,1001889,169,10,N,N,-,-1,-1
MULIFE.txt,1001729,1001896,167,10,N,N,-,-1,-1
MULIFE.txt,1001744,1001908,164,10,N,N,-,-1,-1
MULIFE.txt,1001755,1001939,184,10,N,N,-,-1,-1
MULIFE.txt,1001761,1001956,195,10,N,N,-,-1,-1
MULIFE.txt,1001767,1001961,194,10,N,N,-,-1,-1
MULIFE.txt,1001776,1001963,187,10,N,N,-,-1,-1
MULIFE.txt,1001856,1001972,116,10,N,N,-,-1,-1
MULIFE.txt,1001877,1001985,108,10,N,N,-,-1,-1
MULIFE.txt,1001885,1001995,110,10,N,N,-,-1,-1
MULIFE.txt,1001890,1002000,110,10,N,N,-,-1,-1
MULIFE.txt,1001899,1002013,114,10,N,N,-,-1,-1
MULIFE.txt,1001909,1002067,158,10,N,N,-,-1,-1
MULIFE.txt,1001940,1002115,175,10,N,N,-,-1,-1
MULIFE.txt,1001957,1002127,170,10,N,N,-,-1,-1
MULIFE.txt,1001962,1002157,195,10,N,N,-,-1,-1
MULIFE.txt,1001965,1002226,261,10,N,N,-,-1,-1
MULIFE.txt,1001973,1002237,264,10,N,N,-,-1,-1
MULIFE.txt,1001986,1002246,260,10,N,N,-,-1,-1
MULIFE.txt,1001996,1002256,260,10,N,N,-,-1,-1
MULIFE.txt,1002001,1002273,272,10,N,N,-,-1,-1
MULIFE.txt,1002018,1002300,282,10,N,N,-,-1,-1
MULIFE.txt,1002072,1002354,282,10,N,N,-,-1,-1
MULIFE.txt,1002118,1002371,253,10,N,N,-,-1,-1
MULIFE.txt,1002128,1002376,248,10,N,N,-,-1,-1
MULIFE.txt,1002158,1002385,227,10,N,N,-,-1,-1
MULIFE.txt,1002227,1002416,189,10,N,N,-,-1,-1
MULIFE.txt,1002238,1002477,239,10,N,N,-,-1,-1
MULIFE.txt,1002249,1002493,244,10,N,N,-,-1,-1
MULIFE.txt,1002257,1002504,247,10,N,N,-,-1,-1
MULIFE.txt,1002274,1002515,241,10,N,N,-,-1,-1
MULIFE.txt,1002301,1002563,262,10,N,N,-,-1,-1
MULIFE.txt,1002356,1002600,244,10,N,N,-,-1,-1
MULIFE.txt,1002372,1002642,270,10,N,N,-,-1,-1
MULIFE.txt,1002379,1002650,271,10,N,N,-,-1,-1
MULIFE.txt,1002386,1002661,275,10,N,N,-,-1,-1
MULIFE.txt,1002417,1002671,254,10,N,N,-,-1,-1
MULIFE.txt,1002479,1002738,259,10,N,N,-,-1,-1
MULIFE.txt,1002494,1002791,297,10,N,N,-,-1,-1
MULIFE.txt,1002507,1002796,289,10,N,N,-,-1,-1
MULIFE.txt,1002516,1002803,287,10,N,N,-,-1,-1
MULIFE.txt,1002564,1002813,249,10,N,N,-,-1,-1
MULIFE.txt,1002602,1002829,227,10,N,N,-,-1,-1
MULIFE.txt,1002643,1002849,206,10,N,N,-,-1,-1
MULIFE.txt,1002651,1002897,246,10,N,N,-,-1,-1
MULIFE.txt,1002664,1002917,253,10,N,N,-,-1,-1
MULIFE.txt,1002672,1002929,257,10,N,N,-,-1,-1
MULIFE.txt,1002739,1002970,231,10,N,N,-,-1,-1
MULIFE.txt,1002792,1003034,242,10,N,N,-,-1,-1
MULIFE.txt,1002797,1003041,244,10,N,N,-,-1,-1
MULIFE.txt,1002806,1003045,239,10,N,N,-,-1,-1
MULIFE.txt,1002814,1003050,236,10,N,N,-,-1,-1
MULIFE.txt,1002830,1003056,226,10,N,N,-,-1,-1
MULIFE.txt,1002850,1003060,210,10,N,N,-,-1,-1
MULIFE.txt,1002898,1003088,190,10,N,N,-,-1,-1
MULIFE.txt,1002920,1003092,172,10,N,N,-,-1,-1
MULIFE.txt,1002930,1003097,167,10,N,N,-,-1,-1
MULIFE.txt,1002971,1003101,130,10,N,N,-,-1,-1
MULIFE.txt,1003035,1003122,87,10,N,N,-,-1,-1
MULIFE.txt,1003042,1003129,87,10,N,N,-,-1,-1
MULIFE.txt,1003046,1003147,101,10,N,N,-,-1,-1
MULIFE.txt,1003051,1003168,117,10,N,N,-,-1,-1
MULIFE.txt,1003057,1003176,119,10,N,N,-,-1,-1
MULIFE.txt,1003063,1003181,118,10,N,N,-,-1,-1
MULIFE.txt,1003089,1003189,100,10,N,N,-,-1,-1
MULIFE.txt,1003093,1003195,102,10,N,N,-,-1,-1
MULIFE.txt,1003098,1003213,115,10,N,N,-,-1,-1
MULIFE.txt,1003101,1003221,120,10,N,N,-,-1,-1
MULIFE.txt,1003123,1003226,103,10,N,N,-,-1,-1
MULIFE.txt,1003130,1003233,103,10,N,N,-,-1,-1
MULIFE.txt,1003148,1003243,95,10,N,N,-,-1,-1
MULIFE.txt,1003169,1003279,110,10,N,N,-,-1,-1
MULIFE.txt,1003177,1003308,131,10,N,N,-,-1,-1
MULIFE.txt,1003182,1003316,134,10,N,N,-,-1,-1
MULIFE.txt,1003190,1003327,137,10,N,N,-,-1,-1
MULIFE.txt,1003197,1003349,152,10,N,N,-,-1,-1
MULIFE.txt,1003214,1003365,151,10,N,N,-,-1,-1
MULIFE.txt,1003222,1003386,164,10,N,N,-,-1,-1
MULIFE.txt,1003227,1003399,172,10,N,N,-,-1,-1
MULIFE.txt,1003236,1003414,178,10,N,N,-,-1,-1
MULIFE.txt,1003244,1003429,185,10,N,N,-,-1,-1
MULIFE.txt,1003280,1003440,160,10,N,N,-,-1,-1
MULIFE.txt,1003309,1003443,134,10,N,N,-,-1,-1
MULIFE.txt,1003317,1003445,128,10,N,N,-,-1,-1
MULIFE.txt,1003328,1003456,128,10,N,N,-,-1,-1
MULIFE.txt,1003350,1003541,191,10,N,N,-,-1,-1
MULIFE.txt,1003366,1003558,192,10,N,N,-,-1,-1
MULIFE.txt,1003387,1003577,190,10,N,N,-,-1,-1
MULIFE.txt,1003401,1003583,182,10,N,N,-,-1,-1
MULIFE.txt,1003415,1003590,175,10,N,N,-,-1,-1
MULIFE.txt,1003430,1003594,164,10,N,N,-,-1,-1
MULIFE.txt,1003441,1003604,163,10,N,N,-,-1,-1
MULIFE.txt,1003443,1003633,190,10,N,N,-,-1,-1
MULIFE.txt,1003447,1003651,204,10,N,N,-,-1,-1
MULIFE.txt,1003457,1003705,248,10,N,N,-,-1,-1
MULIFE.txt,1003544,1003713,169,10,N,N,-,-1,-1
MULIFE.txt,1003559,1003724,165,10,N,N,-,-1,-1
MULIFE.txt,1003579,1003736,157,10,N,N,-,-1,-1
MULIFE.txt,1003584,1003806,222,10,N,N,-,-1,-1
MULIFE.txt,1003591,1003835,244,10,N,N,-,-1,-1
MULIFE.txt,1003597,1003870,273,10,N,N,-,-1,-1
MULIFE.txt,1003605,1003881,276,10,N,N,-,-1,-1
MULIFE.txt,1003634,1003885,251,10,N,N,-,-1,-1
MULIFE.txt,1003652,1003989,337,10,N,N,-,-1,-1
MULIFE.txt,1003706,1004042,336,10,N,N,-,-1,-1
MULIFE.txt,1003714,1004067,353,10,N,N,-,-1,-1
MULIFE.txt,1003727,1004083,356,10,N,N,-,-1,-1
MULIFE.txt,1003737,1004088,351,10,N,N,-,-1,-1
MULIFE.txt,1003807,1004095,288,10,N,N,-,-1,-1
MULIFE.txt,1003836,1004104,268,10,N,N,-,-1,-1
MULIFE.txt,1003871,1004143,272,10,N,N,-,-1,-1
MULIFE.txt,1003882,1004185,303,10,N,N,-,-1,-1
MULIFE.txt,1003890,1004196,306,10,N,N,-,-1,-1
MULIFE.txt,1003990,1004235,245,10,N,N,-,-1,-1
MULIFE.txt,1004043,1004269,226,10,N,N,-,-1,-1
MULIFE.txt,1004069,1004284,215,10,N,N,-,-1,-1
MULIFE.txt,1004084,1004285,201,10,N,N,-,-1,-1
MULIFE.txt,1004089,1004286,197,10,N,N,-,-1,-1
MULIFE.txt,1004098,1004295,197,10,N,N,-,-1,-1
MULIFE.txt,1004105,1004436,331,10,N,N,-,-1,-1
MULIFE.txt,1004144,1004483,339,10,N,N,-,-1,-1
MULIFE.txt,1004186,1004490,304,10,N,N,-,-1,-1
MULIFE.txt,1004199,1004499,300,10,N,N,-,-1,-1
MULIFE.txt,1004236,1004512,276,10,N,N,-,-1,-1
MULIFE.txt,1004270,1004559,289,10,N,N,-,-1,-1
MULIFE.txt,1004284,1004572,288,10,N,N,-,-1,-1
MULIFE.txt,1004285,1004614,329,10,N,N,-,-1,-1
MULIFE.txt,1004289,1004650,361,10,N,N,-,-1,-1
MULIFE.txt,1004296,1004654,358,10,N,N,-,-1,-1
MULIFE.txt,1004437,1004659,222,10,N,N,-,-1,-1
MULIFE.txt,1004484,1004665,181,10,N,N,-,-1,-1
MULIFE.txt,1004491,1004676,185,10,N,N,-,-1,-1
MULIFE.txt,1004499,1004798,299,10,N,N,-,-1,-1
MULIFE.txt,1004513,1004803,290,10,N,N,-,-1,-1
MULIFE.txt,1004560,1004825,265,10,N,N,-,-1,-1
MULIFE.txt,1004573,1004863,290,10,N,N,-,-1,-1
MULIFE.txt,1004615,1004894,279,10,N,N,-,-1,-1
MULIFE.txt,1004651,1004932,281,10,N,N,-,-1,-1
MULIFE.txt,1004655,1004940,285,10,N,N,-,-1,-1
MULIFE.txt,1004660,1004959,299,10,N,N,-,-1,-1
MULIFE.txt,1004668,1004986,318,10,N,N,-,-1,-1
MULIFE.txt,1004677,1004994,317,10,N,N,-,-1,-1
MULIFE.txt,1004799,1005004,205,10,N,N,-,-1,-1
MULIFE.txt,1004804,1005050,246,10,N,N,-,-1,-1
MULIFE.txt,1004826,1005055,229,10,N,N,-,-1,-1
MULIFE.txt,1004864,1005065,201,10,N,N,-,-1,-1
MULIFE.txt,1004895,1005069,174,10,N,N,-,-1,-1
MULIFE.txt,1004933,1005087,154,10,N,N,-,-1,-1
MULIFE.txt,1004941,1005155,214,10,N,N,-,-1,-1
MULIFE.txt,1004962,1005217,255,10,N,N,-,-1,-1
MULIFE.txt,1004987,1005242,255,10,N,N,-,-1,-1
MULIFE.txt,1004997,1005260,263,10,N,N,-,-1,-1
MULIFE.txt,1005005,1005272,267,10,N,N,-,-1,-1
MULIFE.txt,1005051,1005342,291,10,N,N,-,-1,-1
MULIFE.txt,1005056,1005366,310,10,N,N,-,-1,-1
MULIFE.txt,1005065,1005406,341,10,N,N,-,-1,-1
MULIFE.txt,1005072,1005418,346,10,N,N,-,-1,-1
MULIFE.txt,1005090,1005469,379,10,N,N,-,-1,-1
MULIFE.txt,1005157,1005519,362,10,N,N,-,-1,-1
MULIFE.txt,1005218,1005531,313,10,N,N,-,-1,-1
MULIFE.txt,1005243,1005564,321,10,N,N,-,-1,-1
MULIFE.txt,1005262,1005642,380,10,N,N,-,-1,-1
MULIFE.txt,1005275,1005649,374,10,N,N,-,-1,-1
MULIFE.txt,1005343,1005654,311,10,N,N,-,-1,-1
MULIFE.txt,1005368,1005682,314,10,N,N,-,-1,-1
MULIFE.txt,1005408,1005693,285,10,N,N,-,-1,-1
MULIFE.txt,1005423,1005717,294,10,N,N,-,-1,-1
MULIFE.txt,1005470,1005752,282,10,N,N,-,-1,-1
MULIFE.txt,1005524,1005759,235,10,N,N,-,-1,-1
MULIFE.txt,1005532,1005766,234,10,N,N,-,-1,-1
MULIFE.txt,1005564,1005770,206,10,N,N,-,-1,-1
MULIFE.txt,1005645,1005811,166,10,N,N,-,-1,-1
MULIFE.txt,1005650,1005825,175,10,N,N,-,-1,-1
MULIFE.txt,1005655,1005849,194,10,N,N,-,-1,-1
MULIFE.txt,1005683,1005874,191,10,N,N,-,-1,-1
MULIFE.txt,1005694,1005885,191,10,N,N,-,-1,-1
MULIFE.txt,1005718,1005892,174,10,N,N,-,-1,-1
MULIFE.txt,1005753,1005915,162,10,N,N,-,-1,-1
MULIFE.txt,1005762,1005966,204,10,N,N,-,-1,-1
MULIFE.txt,1005767,1005982,215,10,N,N,-,-1,-1
MULIFE.txt,1005771,1005992,221,10,N,N,-,-1,-1
MULIFE.txt,1005812,1005996,184,10,N,N,-,-1,-1
MULIFE.txt,1005827,1006006,179,10,N,N,-,-1,-1
MULIFE.txt,1005850,1006037,187,10,N,N,-,-1,-1
MULIFE.txt,1005875,1006118,243,10,N,N,-,-1,-1
MULIFE.txt,1005886,1006125,239,10,N,N,-,-1,-1
MULIFE.txt,1005897,1006136,239,10,N,N,-,-1,-1
MULIFE.txt,1005916,1006162,246,10,N,N,-,-1,-1
MULIFE.txt,1005968,1006196,228,10,N,N,-,-1,-1
MULIFE.txt,1005983,1006220,237,10,N,N,-,-1,-1
MULIFE.txt,1005993,1006243,250,10,N,N,-,-1,-1
MULIFE.txt,1005999,1006259,260,10,N,N,-,-1,-1
MULIFE.txt,1006007,1006292,285,10,N,N,-,-1,-1
MULIFE.txt,1006038,1006339,301,10,N,N,-,-1,-1
MULIFE.txt,1006120,1006343,223,10,N,N,-,-1,-1
MULIFE.txt,1006126,1006399,273,10,N,N,-,-1,-1
MULIFE.txt,1006137,1006415,278,10,N,N,-,-1,-1
MULIFE.txt,1006163,1006437,274,10,N,N,-,-1,-1
MULIFE.txt,1006197,1006460,263,10,N,N,-,-1,-1
MULIFE.txt,1006225,1006472,247,10,N,N,-,-1,-1
MULIFE.txt,1006248,1006481,233,10,N,N,-,-1,-1
MULIFE.txt,1006260,1006502,242,10,N,N,-,-1,-1
MULIFE.txt,1006293,1006527,234,10,N,N,-,-1,-1
MULIFE.txt,1006340,1006551,211,10,N,N,-,-1,-1
MULIFE.txt,1006348,1006562,214,10,N,N,-,-1,-1
MULIFE.txt,1006400,1006571,171,10,N,N,-,-1,-1
MULIFE.txt,1006416,1006610,194,10,N,N,-,-1,-1
MULIFE.txt,1006438,1006632,194,10,N,N,-,-1,-1
MULIFE.txt,1006462,1006636,174,10,N,N,-,-1,-1
MULIFE.txt,1006473,1006641,168,10,N,N,-,-1,-1
MULIFE.txt,1006484,1006651,167,10,N,N,-,-1,-1
MULIFE.txt,1006505,1006666,161,10,N,N,-,-1,-1
MULIFE.txt,1006528,1006686,158,10,N,N,-,-1,-1
MULIFE.txt,1006552,1006769,217,10,N,N,-,-1,-1
MULIFE.txt,1006563,1006776,213,10,N,N,-,-1,-1
MULIFE.txt,1006573,1006779,206,10,N,N,-,-1,-1
MULIFE.txt,1006611,1006893,282,10,N,N,-,-1,-1
MULIFE.txt,1006633,1006924,291,10,N,N,-,-1,-1
MULIFE.txt,1006637,1006935,298,10,N,N,-,-1,-1
MULIFE.txt,1006642,1006942,300,10,N,N,-,-1,-1
MULIFE.txt,1006654,1006947,293,10,N,N,-,-1,-1
MULIFE.txt,1006669,1007097,428,10,N,N,-,-1,-1
MULIFE.txt,1006687,1007108,421,10,N,N,-,-1,-1
MULIFE.txt,1006772,1007113,341,10,N,N,-,-1,-1
MULIFE.txt,1006777,1007114,337,10,N,N,-,-1,-1
MULIFE.txt,1006780,1007115,335,10,N,N,-,-1,-1
MULIFE.txt,1006894,1007120,226,10,N,N,-,-1,-1
MULIFE.txt,1006925,1007128,203,10,N,N,-,-1,-1
MULIFE.txt,1006936,1007223,287,10,N,N,-,-1,-1
MULIFE.txt,1006943,1007245,302,10,N,N,-,-1,-1
MULIFE.txt,1006950,1007272,322,10,N,N,-,-1,-1
MULIFE.txt,1007098,1007283,185,10,N,N,-,-1,-1
MULIFE.txt,1007109,1007292,183,10,N,N,-,-1,-1
MULIFE.txt,1007113,1007304,191,10,N,N,-,-1,-1
MULIFE.txt,1007114,1007350,236,10,N,N,-,-1,-1
MULIFE.txt,1007116,1007374,258,10,N,N,-,-1,-1
MULIFE.txt,1007123,1007424,301,10,N,N,-,-1,-1
MULIFE.txt,1007129,1007447,318,10,N,N,-,-1,-1
MULIFE.txt,1007224,1007514,290,10,N,N,-,-1,-1
MULIFE.txt,1007246,1007566,320,10,N,N,-,-1,-1
MULIFE.txt,1007273,1007574,301,10,N,N,-,-1,-1
MULIFE.txt,1007284,1007578,294,10,N,N,-,-1,-1
MULIFE.txt,1007295,1007585,290,10,N,N,-,-1,-1
MULIFE.txt,1007305,1007592,287,10,N,N,-,-1,-1
MULIFE.txt,1007351,1007621,270,10,N,N,-,-1,-1
MULIFE.txt,1007375,1007694,319,10,N,N,-,-1,-1
MULIFE.txt,1007425,1007713,288,10,N,N,-,-1,-1
MULIFE.txt,1007448,1007745,297,10,N,N,-,-1,-1
MULIFE.txt,1007515,1007762,247,10,N,N,-,-1,-1
MULIFE.txt,1007567,1007766,199,10,N,N,-,-1,-1
MULIFE.txt,1007575,1007794,219,10,N,N,-,-1,-1
MULIFE.txt,1007581,1007818,237,10,N,N,-,-1,-1
MULIFE.txt,1007586,1007834,248,10,N,N,-,-1,-1
MULIFE.txt,1007597,1007839,242,10,N,N,-,-1,-1
MULIFE.txt,1007623,1007858,235,10,N,N,-,-1,-1
MULIFE.txt,1007697,1007884,187,10,N,N,-,-1,-1
MULIFE.txt,1007714,1007894,180,10,N,N,-,-1,-1
MULIFE.txt,1007746,1007905,159,10,N,N,-,-1,-1
MULIFE.txt,1007763,1007912,149,10,N,N,-,-1,-1
MULIFE.txt,1007769,1007930,161,10,N,N,-,-1,-1
MULIFE.txt,1007795,1007953,158,10,N,N,-,-1,-1
MULIFE.txt,1007819,1007964,145,10,N,N,-,-1,-1
MULIFE.txt,1007835,1007978,143,10,N,N,-,-1,-1
MULIFE.txt,1007842,1007995,153,10,N,N,-,-1,-1
MULIFE.txt,1007859,1008028,169,10,N,N,-,-1,-1
MULIFE.txt,1007885,1008047,162,10,N,N,-,-1,-1
MULIFE.txt,1007895,1008083,188,10,N,N,-,-1,-1
MULIFE.txt,1007906,1008094,188,10,N,N,-,-1,-1
MULIFE.txt,1007915,1008098,183,10,N,N,-,-1,-1
MULIFE.txt,1007931,1008099,168,10,N,N,-,-1,-1
MULIFE.txt,1007955,1008100,145,10,N,N,-,-1,-1
MULIFE.txt,1007964,1008106,142,10,N,N,-,-1,-1
MULIFE.txt,1007979,1008125,146,10,N,N,-,-1,-1
MULIFE.txt,1007997,1008152,155,10,N,N,-,-1,-1
MULIFE.txt,1008031,1008157,126,10,N,N,-,-1,-1
MULIFE.txt,1008048,1008163,115,10,N,N,-,-1,-1
MULIFE.txt,1008084,1008174,90,10,N,N,-,-1,-1
MULIFE.txt,1008095,1008181,86,10,N,N,-,-1,-1
MULIFE.txt,1008098,1008240,142,10,N,N,-,-1,-1
MULIFE.txt,1008099,1008259,160,10,N,N,-,-1,-1
MULIFE.txt,1008101,1008292,191,10,N,N,-,-1,-1
MULIFE.txt,1008109,1008303,194,10,N,N,-,-1,-1
MULIFE.txt,1008126,1008309,183,10,N,N,-,-1,-1
MULIFE.txt,1008153,1008313,160,10,N,N,-,-1,-1
MULIFE.txt,1008158,1008325,167,10,N,N,-,-1,-1
MULIFE.txt,1008164,1008358,194,10,N,N,-,-1,-1
MULIFE.txt,1008175,1008383,208,10,N,N,-,-1,-1
MULIFE.txt,1008183,1008414,231,10,N,N,-,-1,-1
MULIFE.txt,1008243,1008426,183,10,N,N,-,-1,-1
MULIFE.txt,1008260,1008431,171,10,N,N,-,-1,-1
MULIFE.txt,1008293,1008432,139,10,N,N,-,-1,-1
MULIFE.txt,1008304,1008433,129,10,N,N,-,-1,-1
MULIFE.txt,1008310,1008437,127,10,N,N,-,-1,-1
MULIFE.txt,1008316,1008458,142,10,N,N,-,-1,-1
MULIFE.txt,1008326,1008498,172,10,N,N,-,-1,-1
MULIFE.txt,1008359,1008521,162,10,N,N,-,-1,-1
MULIFE.txt,1008384,1008532,148,10,N,N,-,-1,-1
MULIFE.txt,1008416,1008602,186,10,N,N,-,-1,-1
MULIFE.txt,1008427,1008627,200,10,N,N,-,-1,-1
MULIFE.txt,1008431,1008631,200,10,N,N,-,-1,-1
MULIFE.txt,1008432,1008636,204,10,N,N,-,-1,-1
MULIFE.txt,1008434,1008642,208,10,N,N,-,-1,-1
MULIFE.txt,1008440,1008647,207,10,N,N,-,-1,-1
MULIFE.txt,1008461,1008653,192,10,N,N,-,-1,-1
MULIFE.txt,1008500,1008657,157,10,N,N,-,-1,-1
MULIFE.txt,1008522,1008661,139,10,N,N,-,-1,-1
MULIFE.txt,1008533,1008671,138,10,N,N,-,-1,-1
MULIFE.txt,1008603,1008801,198,10,N,N,-,-1,-1
MULIFE.txt,1008628,1008821,193,10,N,N,-,-1,-1
MULIFE.txt,1008632,1008847,215,10,N,N,-,-1,-1
MULIFE.txt,1008637,1008858,221,10,N,N,-,-1,-1
MULIFE.txt,1008643,1008868,225,10,N,N,-,-1,-1
MULIFE.txt,1008648,1008921,273,10,N,N,-,-1,-1
MULIFE.txt,1008654,1008976,322,10,N,N,-,-1,-1
MULIFE.txt,1008658,1008996,338,10,N,N,-,-1,-1
MULIFE.txt,1008664,1009106,442,10,N,N,-,-1,-1
MULIFE.txt,1008672,1009141,469,10,N,N,-,-1,-1
MULIFE.txt,1008802,1009153,351,10,N,N,-,-1,-1
MULIFE.txt,1008822,1009162,340,10,N,N,-,-1,-1
MULIFE.txt,1008848,1009306,458,10,N,N,-,-1,-1
MULIFE.txt,1008859,1009340,481,10,N,N,-,-1,-1
MULIFE.txt,1008873,1009345,472,10,N,N,-,-1,-1
MULIFE.txt,1008926,1009358,432,10,N,N,-,-1,-1
MULIFE.txt,1008981,1009443,462,10,N,N,-,-1,-1
MULIFE.txt,1008999,1009478,479,10,N,N,-,-1,-1
MULIFE.txt,1009107,1009482,375,10,N,N,-,-1,-1
MULIFE.txt,1009142,1009487,345,10,N,N,-,-1,-1
MULIFE.txt,1009154,1009496,342,10,N,N,-,-1,-1
MULIFE.txt,1009165,1009504,339,10,N,N,-,-1,-1
MULIFE.txt,1009308,1009546,238,10,N,N,-,-1,-1
MULIFE.txt,1009342,1009561,219,10,N,N,-,-1,-1
MULIFE.txt,1009346,1009587,241,10,N,N,-,-1,-1
MULIFE.txt,1009361,1009602,241,10,N,N,-,-1,-1
MULIFE.txt,1009444,1009636,192,10,N,N,-,-1,-1
MULIFE.txt,1009479,1009656,177,10,N,N,-,-1,-1
MULIFE.txt,1009483,1009691,208,10,N,N,-,-1,-1
MULIFE.txt,1009488,1009695,207,10,N,N,-,-1,-1
MULIFE.txt,1009499,1009701,202,10,N,N,-,-1,-1
MULIFE.txt,1009505,1009710,205,10,N,N,-,-1,-1
MULIFE.txt,1009547,1009719,172,10,N,N,-,-1,-1
MULIFE.txt,1009562,1009751,189,10,N,N,-,-1,-1
MULIFE.txt,1009592,1009775,183,10,N,N,-,-1,-1
MULIFE.txt,1009603,1009831,228,10,N,N,-,-1,-1
MULIFE.txt,1009637,1009840,203,10,N,N,-,-1,-1
MULIFE.txt,1009658,1009849,191,10,N,N,-,-1,-1
MULIFE.txt,1009692,1009855,163,10,N,N,-,-1,-1
MULIFE.txt,1009697,1009864,167,10,N,N,-,-1,-1
MULIFE.txt,1009702,1009874,172,10,N,N,-,-1,-1
MULIFE.txt,1009713,1009893,180,10,N,N,-,-1,-1
MULIFE.txt,1009720,1009900,180,10,N,N,-,-1,-1
MULIFE.txt,1009752,1009909,157,10,N,N,-,-1,-1
MULIFE.txt,1009777,1009920,143,10,N,N,-,-1,-1
MULIFE.txt,1009834,1009958,124,10,N,N,-,-1,-1
MULIFE.txt,1009841,1009978,137,10,N,N,-,-1,-1
MULIFE.txt,1009850,1010000,150,10,N,N,-,-1,-1
MULIFE.txt,1009856,1010012,156,10,N,N,-,-1,-1
MULIFE.txt,1009866,1010021,155,10,N,N,-,-1,-1
MULIFE.txt,1009875,1010040,165,10,N,N,-,-1,-1
MULIFE.txt,1009895,1010057,162,10,N,N,-,-1,-1
MULIFE.txt,1009901,1010093,192,10,N,N,-,-1,-1
MULIFE.txt,1009912,1010097,185,10,N,N,-,-1,-1
MULIFE.txt,1009921,1010102,181,10,N,N,-,-1,-1
MULIFE.txt,1009959,1010108,149,10,N,N,-,-1,-1
MULIFE.txt,1009979,1010120,141,10,N,N,-,-1,-1
MULIFE.txt,1010001,1010124,123,10,N,N,-,-1,-1
MULIFE.txt,1010013,1010131,118,10,N,N,-,-1,-1
MULIFE.txt,1010024,1010181,157,10,N,N,-,-1,-1
MULIFE.txt,1010041,1010192,151,10,N,N,-,-1,-1
MULIFE.txt,1010058,1010198,140,10,N,N,-,-1,-1
MULIFE.txt,1010094,1010222,128,10,N,N,-,-1,-1
MULIFE.txt,1010098,1010266,168,10,N,N,-,-1,-1
MULIFE.txt,1010103,1010304,201,10,N,N,-,-1,-1
MULIFE.txt,1010109,1010336,227,10,N,N,-,-1,-1
MULIFE.txt,1010121,1010340,219,10,N,N,-,-1,-1
MULIFE.txt,1010125,1010354,229,10,N,N,-,-1,-1
MULIFE.txt,1010136,1010367,231,10,N,N,-,-1,-1
MULIFE.txt,1010182,1010403,221,10,N,N,-,-1,-1
MULIFE.txt,1010193,1010527,334,10,N,N,-,-1,-1
MULIFE.txt,1010201,1010551,350,10,N,N,-,-1,-1
MULIFE.txt,1010223,1010555,332,10,N,N,-,-1,-1
MULIFE.txt,1010267,1010560,293,10,N,N,-,-1,-1
MULIFE.txt,1010306,1010566,260,10,N,N,-,-1,-1
MULIFE.txt,1010337,1010570,233,10,N,N,-,-1,-1
MULIFE.txt,1010341,1010649,308,10,N,N,-,-1,-1
MULIFE.txt,1010357,1010779,422,10,N,N,-,-1,-1
MULIFE.txt,1010368,1010805,437,10,N,N,-,-1,-1
MULIFE.txt,1010404,1010816,412,10,N,N,-,-1,-1
MULIFE.txt,1010529,1010822,293,10,N,N,-,-1,-1
MULIFE.txt,1010552,1010826,274,10,N,N,-,-1,-1
MULIFE.txt,1010556,1010831,275,10,N,N,-,-1,-1
MULIFE.txt,1010561,1010863,302,10,N,N,-,-1,-1
MULIFE.txt,1010567,1010887,320,10,N,N,-,-1,-1
MULIFE.txt,1010575,1010891,316,10,N,N,-,-1,-1
MULIFE.txt,1010651,1010896,245,10,N,N,-,-1,-1
MULIFE.txt,1010780,1010901,121,10,N,N,-,-1,-1
MULIFE.txt,1010806,1010902,96,10,N,N,-,-1,-1
MULIFE.txt,1010817,1010903,86,10,N,N,-,-1,-1
MULIFE.txt,1010823,1010907,84,10,N,N,-,-1,-1
MULIFE.txt,1010827,1010912,85,10,N,N,-,-1,-1
MULIFE.txt,1010833,1010921,88,10,N,N,-,-1,-1
MULIFE.txt,1010865,1010956,91,10,N,N,-,-1,-1
MULIFE.txt,1010888,1011022,134,10,N,N,-,-1,-1
MULIFE.txt,1010892,1011067,175,10,N,N,-,-1,-1
MULIFE.txt,1010897,1011072,175,10,N,N,-,-1,-1
MULIFE.txt,1010901,1011079,178,10,N,N,-,-1,-1
MULIFE.txt,1010902,1011159,257,10,N,N,-,-1,-1
MULIFE.txt,1010904,1011242,338,10,N,N,-,-1,-1
MULIFE.txt,1010908,1011320,412,10,N,N,-,-1,-1
MULIFE.txt,1010914,1011335,421,10,N,N,-,-1,-1
MULIFE.txt,1010922,1011347,425,10,N,N,-,-1,-1
MULIFE.txt,1010957,1011351,394,10,N,N,-,-1,-1
MULIFE.txt,1011024,1011431,407,10,N,N,-,-1,-1
MULIFE.txt,1011068,1011509,441,10,N,N,-,-1,-1
MULIFE.txt,1011073,1011543,470,10,N,N,-,-1,-1
MULIFE.txt,1011084,1011548,464,10,N,N,-,-1,-1
MULIFE.txt,1011162,1011554,392,10,N,N,-,-1,-1
MULIFE.txt,1011243,1011605,362,10,N,N,-,-1,-1
MULIFE.txt,1011321,1011725,404,10,N,N,-,-1,-1
MULIFE.txt,1011336,1011764,428,10,N,N,-,-1,-1
MULIFE.txt,1011348,1011771,423,10,N,N,-,-1,-1
MULIFE.txt,1011353,1011778,425,10,N,N,-,-1,-1
MULIFE.txt,1011432,1011844,412,10,N,N,-,-1,-1
MULIFE.txt,1011510,1011875,365,10,N,N,-,-1,-1
MULIFE.txt,1011544,1011889,345,10,N,N,-,-1,-1
MULIFE.txt,1011549,1011921,372,10,N,N,-,-1,-1
MULIFE.txt,1011556,1011932,376,10,N,N,-,-1,-1
MULIFE.txt,1011606,1011936,330,10,N,N,-,-1,-1
MULIFE.txt,1011726,1011941,215,10,N,N,-,-1,-1
MULIFE.txt,1011767,1011954,187,10,N,N,-,-1,-1
MULIFE.txt,1011772,1012137,365,10,N,N,-,-1,-1
MULIFE.txt,1011781,1012160,379,10,N,N,-,-1,-1
MULIFE.txt,1011846,1012192,346,10,N,N,-,-1,-1
MULIFE.txt,1011875,1012198,323,10,N,N,-,-1,-1
MULIFE.txt,1011890,1012205,315,10,N,N,-,-1,-1
MULIFE.txt,1011923,1012209,286,10,N,N,-,-1,-1
MULIFE.txt,1011933,1012226,293,10,N,N,-,-1,-1
MULIFE.txt,1011937,1012245,308,10,N,N,-,-1,-1
MULIFE.txt,1011944,1012271,327,10,N,N,-,-1,-1
MULIFE.txt,1011955,1012276,321,10,N,N,-,-1,-1
MULIFE.txt,1012138,1012282,144,10,N,N,-,-1,-1
MULIFE.txt,1012162,1012286,124,10,N,N,-,-1,-1
MULIFE.txt,1012194,1012361,167,10,N,N,-,-1,-1
MULIFE.txt,1012199,1012373,174,10,N,N,-,-1,-1
MULIFE.txt,1012206,1012380,174,10,N,N,-,-1,-1
MULIFE.txt,1012214,1012384,170,10,N,N,-,-1,-1
MULIFE.txt,1012227,1012406,179,10,N,N,-,-1,-1
MULIFE.txt,1012247,1012418,171,10,N,N,-,-1,-1
MULIFE.txt,1012272,1012440,168,10,N,N,-,-1,-1
MULIFE.txt,1012277,1012492,215,10,N,N,-,-1,-1
MULIFE.txt,1012283,1012502,219,10,N,N,-,-1,-1
MULIFE.txt,1012291,1012507,216,10,N,N,-,-1,-1
MULIFE.txt,1012363,1012518,155,10,N,N,-,-1,-1
MULIFE.txt,1012374,1012540,166,10,N,N,-,-1,-1
MULIFE.txt,1012381,1012566,185,10,N,N,-,-1,-1
MULIFE.txt,1012389,1012571,182,10,N,N,-,-1,-1
MULIFE.txt,1012408,1012577,169,10,N,N,-,-1,-1
MULIFE.txt,1012419,1012598,179,10,N,N,-,-1,-1
MULIFE.txt,1012441,1012628,187,10,N,N,-,-1,-1
MULIFE.txt,1012493,1012651,158,10,N,N,-,-1,-1
MULIFE.txt,1012503,1012675,172,10,N,N,-,-1,-1
MULIFE.txt,1012510,1012747,237,10,N,N,-,-1,-1
MULIFE.txt,1012519,1012773,254,10,N,N,-,-1,-1
MULIFE.txt,1012541,1012784,243,10,N,N,-,-1,-1
MULIFE.txt,1012567,1012797,230,10,N,N,-,-1,-1
MULIFE.txt,1012572,1012801,229,10,N,N,-,-1,-1
MULIFE.txt,1012582,1012821,239,10,N,N,-,-1,-1
MULIFE.txt,1012598,1012890,292,10,N,N,-,-1,-1
MULIFE.txt,1012633,1012935,302,10,N,N,-,-1,-1
MULIFE.txt,1012653,1012948,295,10,N,N,-,-1,-1
MULIFE.txt,1012678,1012988,310,10,N,N,-,-1,-1
MULIFE.txt,1012750,1013106,356,10,N,N,-,-1,-1
MULIFE.txt,1012774,1013117,343,10,N,N,-,-1,-1
MULIFE.txt,1012785,1013134,349,10,N,N,-,-1,-1
MULIFE.txt,1012798,1013159,361,10,N,N,-,-1,-1
MULIFE.txt,1012802,1013312,510,10,N,N,-,-1,-1
MULIFE.txt,1012824,1013423,599,10,N,N,-,-1,-1
MULIFE.txt,1012891,1013435,544,10,N,N,-,-1,-1
MULIFE.txt,1012940,1013442,502,10,N,N,-,-1,-1
MULIFE.txt,1012949,1013446,497,10,N,N,-,-1,-1
MULIFE.txt,1012989,1013467,478,10,N,N,-,-1,-1
MULIFE.txt,1013107,1013496,389,10,N,N,-,-1,-1
MULIFE.txt,1013118,1013503,385,10,N,N,-,-1,-1
MULIFE.txt,1013135,1013526,391,10,N,N,-,-1,-1
MULIFE.txt,1013160,1013655,495,10,N,N,-,-1,-1
MULIFE.txt,1013313,1013667,354,10,N,N,-,-1,-1
MULIFE.txt,1013425,1013674,249,10,N,N,-,-1,-1
MULIFE.txt,1013436,1013678,242,10,N,N,-,-1,-1
MULIFE.txt,1013443,1013685,242,10,N,N,-,-1,-1
MULIFE.txt,1013449,1013689,240,10,N,N,-,-1,-1
MULIFE.txt,1013468,1013728,260,10,N,N,-,-1,-1
MULIFE.txt,1013499,1013871,372,10,N,N,-,-1,-1
MULIFE.txt,1013504,1013882,378,10,N,N,-,-1,-1
MULIFE.txt,1013527,1013890,363,10,N,N,-,-1,-1
MULIFE.txt,1013656,1013894,238,10,N,N,-,-1,-1
MULIFE.txt,1013668,1013907,239,10,N,N,-,-1,-1
MULIFE.txt,1013675,1014076,401,10,N,N,-,-1,-1
MULIFE.txt,1013681,1014087,406,10,N,N,-,-1,-1
MULIFE.txt,1013686,1014094,408,10,N,N,-,-1,-1
MULIFE.txt,1013690,1014098,408,10,N,N,-,-1,-1
MULIFE.txt,1013729,1014123,394,10,N,N,-,-1,-1
MULIFE.txt,1013872,1014194,322,10,N,N,-,-1,-1
MULIFE.txt,1013883,1014245,362,10,N,N,-,-1,-1
MULIFE.txt,1013891,1014256,365,10,N,N,-,-1,-1
MULIFE.txt,1013897,1014263,366,10,N,N,-,-1,-1
MULIFE.txt,1013908,1014268,360,10,N,N,-,-1,-1
MULIFE.txt,1014077,1014281,204,10,N,N,-,-1,-1
MULIFE.txt,1014088,1014331,243,10,N,N,-,-1,-1
MULIFE.txt,1014095,1014382,287,10,N,N,-,-1,-1
MULIFE.txt,1014101,1014393,292,10,N,N,-,-1,-1
MULIFE.txt,1014124,1014399,275,10,N,N,-,-1,-1
MULIFE.txt,1014196,1014400,204,10,N,N,-,-1,-1
MULIFE.txt,1014246,1014401,155,10,N,N,-,-1,-1
MULIFE.txt,1014257,1014405,148,10,N,N,-,-1,-1
MULIFE.txt,1014264,1014416,152,10,N,N,-,-1,-1
MULIFE.txt,1014273,1014602,329,10,N,N,-,-1,-1
MULIFE.txt,1014282,1014606,324,10,N,N,-,-1,-1
MULIFE.txt,1014332,1014618,286,10,N,N,-,-1,-1
MULIFE.txt,1014383,1014622,239,10,N,N,-,-1,-1
MULIFE.txt,1014394,1014633,239,10,N,N,-,-1,-1
MULIFE.txt,1014399,1014796,397,10,N,N,-,-1,-1
MULIFE.txt,1014400,1014807,407,10,N,N,-,-1,-1
MULIFE.txt,1014402,1014815,413,10,N,N,-,-1,-1
MULIFE.txt,1014408,1014819,411,10,N,N,-,-1,-1
MULIFE.txt,1014417,1014856,439,10,N,N,-,-1,-1
MULIFE.txt,1014603,1014943,340,10,N,N,-,-1,-1
MULIFE.txt,1014607,1014994,387,10,N,N,-,-1,-1
MULIFE.txt,1014619,1015005,386,10,N,N,-,-1,-1
MULIFE.txt,1014625,1015012,387,10,N,N,-,-1,-1
MULIFE.txt,1014634,1015016,382,10,N,N,-,-1,-1
MULIFE.txt,1014797,1015027,230,10,N,N,-,-1,-1
MULIFE.txt,1014808,1015058,250,10,N,N,-,-1,-1
MULIFE.txt,1014816,1015065,249,10,N,N,-,-1,-1
MULIFE.txt,1014822,1015086,264,10,N,N,-,-1,-1
MULIFE.txt,1014857,1015224,367,10,N,N,-,-1,-1
MULIFE.txt,1014945,1015233,288,10,N,N,-,-1,-1
MULIFE.txt,1014995,1015237,242,10,N,N,-,-1,-1
MULIFE.txt,1015006,1015244,238,10,N,N,-,-1,-1
MULIFE.txt,1015013,1015248,235,10,N,N,-,-1,-1
MULIFE.txt,1015019,1015278,259,10,N,N,-,-1,-1
MULIFE.txt,1015028,1015370,342,10,N,N,-,-1,-1
MULIFE.txt,1015061,1015439,378,10,N,N,-,-1,-1
MULIFE.txt,1015066,1015446,380,10,N,N,-,-1,-1
MULIFE.txt,1015087,1015450,363,10,N,N,-,-1,-1
MULIFE.txt,1015225,1015462,237,10,N,N,-,-1,-1
MULIFE.txt,1015234,1015585,351,10,N,N,-,-1,-1
MULIFE.txt,1015240,1015589,349,10,N,N,-,-1,-1
MULIFE.txt,1015245,1015601,356,10,N,N,-,-1,-1
MULIFE.txt,1015249,1015605,356,10,N,N,-,-1,-1
MULIFE.txt,1015279,1015618,339,10,N,N,-,-1,-1
MULIFE.txt,1015371,1015648,277,10,N,N,-,-1,-1
MULIFE.txt,1015440,1015673,233,10,N,N,-,-1,-1
MULIFE.txt,1015447,1015696,249,10,N,N,-,-1,-1
MULIFE.txt,1015453,1015738,285,10,N,N,-,-1,-1
MULIFE.txt,1015463,1015913,450,10,N,N,-,-1,-1
MULIFE.txt,1015586,1015964,378,10,N,N,-,-1,-1
MULIFE.txt,1015591,1015971,380,10,N,N,-,-1,-1
MULIFE.txt,1015602,1015975,373,10,N,N,-,-1,-1
MULIFE.txt,1015610,1015985,375,10,N,N,-,-1,-1
MULIFE.txt,1015619,1015989,370,10,N,N,-,-1,-1
MULIFE.txt,1015649,1015994,345,10,N,N,-,-1,-1
MULIFE.txt,1015675,1016001,326,10,N,N,-,-1,-1
MULIFE.txt,1015697,1016005,308,10,N,N,-,-1,-1
MULIFE.txt,1015739,1016059,320,10,N,N,-,-1,-1
MULIFE.txt,1015914,1016092,178,10,N,N,-,-1,-1
MULIFE.txt,1015965,1016126,161,10,N,N,-,-1,-1
MULIFE.txt,1015972,1016139,167,10,N,N,-,-1,-1
MULIFE.txt,1015976,1016209,233,10,N,N,-,-1,-1
MULIFE.txt,1015986,1016275,289,10,N,N,-,-1,-1
MULIFE.txt,1015990,1016363,373,10,N,N,-,-1,-1
MULIFE.txt,1015995,1016374,379,10,N,N,-,-1,-1
MULIFE.txt,1016002,1016382,380,10,N,N,-,-1,-1
MULIFE.txt,1016010,1016386,376,10,N,N,-,-1,-1
MULIFE.txt,1016064,1016406,342,10,N,N,-,-1,-1
MULIFE.txt,1016094,1016421,327,10,N,N,-,-1,-1
MULIFE.txt,1016131,1016584,453,10,N,N,-,-1,-1
MULIFE.txt,1016140,1016595,455,10,N,N,-,-1,-1
MULIFE.txt,1016210,1016602,392,10,N,N,-,-1,-1
MULIFE.txt,1016276,1016606,330,10,N,N,-,-1,-1
MULIFE.txt,1016364,1016631,267,10,N,N,-,-1,-1
MULIFE.txt,1016375,1016657,282,10,N,N,-,-1,-1
MULIFE.txt,1016383,1016677,294,10,N,N,-,-1,-1
MULIFE.txt,1016391,1016799,408,10,N,N,-,-1,-1
MULIFE.txt,1016407,1016851,444,10,N,N,-,-1,-1
MULIFE.txt,1016423,1016862,439,10,N,N,-,-1,-1
MULIFE.txt,1016585,1016869,284,10,N,N,-,-1,-1
MULIFE.txt,1016596,1016873,277,10,N,N,-,-1,-1
MULIFE.txt,1016603,1016903,300,10,N,N,-,-1,-1
MULIFE.txt,1016609,1017019,410,10,N,N,-,-1,-1
MULIFE.txt,1016632,1017072,440,10,N,N,-,-1,-1
MULIFE.txt,1016658,1017084,426,10,N,N,-,-1,-1
MULIFE.txt,1016679,1017091,412,10,N,N,-,-1,-1
MULIFE.txt,1016800,1017095,295,10,N,N,-,-1,-1
MULIFE.txt,1016852,1017114,262,10,N,N,-,-1,-1
MULIFE.txt,1016863,1017290,427,10,N,N,-,-1,-1
MULIFE.txt,1016870,1017301,431,10,N,N,-,-1,-1
MULIFE.txt,1016876,1017309,433,10,N,N,-,-1,-1
MULIFE.txt,1016905,1017313,408,10,N,N,-,-1,-1
MULIFE.txt,1017020,1017323,303,10,N,N,-,-1,-1
MULIFE.txt,1017073,1017360,287,10,N,N,-,-1,-1
MULIFE.txt,1017085,1017503,418,10,N,N,-,-1,-1
MULIFE.txt,1017092,1017526,434,10,N,N,-,-1,-1
MULIFE.txt,1017098,1017544,446,10,N,N,-,-1,-1
MULIFE.txt,1017115,1017548,433,10,N,N,-,-1,-1
MULIFE.txt,1017291,1017563,272,10,N,N,-,-1,-1
MULIFE.txt,1017302,1017644,342,10,N,N,-,-1,-1
MULIFE.txt,1017310,1017710,400,10,N,N,-,-1,-1
MULIFE.txt,1017316,1017721,405,10,N,N,-,-1,-1
MULIFE.txt,1017324,1017728,404,10,N,N,-,-1,-1
MULIFE.txt,1017361,1017733,372,10,N,N,-,-1,-1
MULIFE.txt,1017504,1017747,243,10,N,N,-,-1,-1
MULIFE.txt,1017528,1017754,226,10,N,N,-,-1,-1
MULIFE.txt,1017545,1017775,230,10,N,N,-,-1,-1
MULIFE.txt,1017551,1017829,278,10,N,N,-,-1,-1
MULIFE.txt,1017564,1017910,346,10,N,N,-,-1,-1
MULIFE.txt,1017645,1017961,316,10,N,N,-,-1,-1
MULIFE.txt,1017711,1017972,261,10,N,N,-,-1,-1
MULIFE.txt,1017722,1017979,257,10,N,N,-,-1,-1
MULIFE.txt,1017729,1017984,255,10,N,N,-,-1,-1
MULIFE.txt,1017738,1017990,252,10,N,N,-,-1,-1
MULIFE.txt,1017750,1017993,243,10,N,N,-,-1,-1
MULIFE.txt,1017755,1017994,239,10,N,N,-,-1,-1
MULIFE.txt,1017776,1018010,234,10,N,N,-,-1,-1
MULIFE.txt,1017830,1018067,237,10,N,N,-,-1,-1
MULIFE.txt,1017912,1018131,219,10,N,N,-,-1,-1
MULIFE.txt,1017962,1018180,218,10,N,N,-,-1,-1
MULIFE.txt,1017973,1018192,219,10,N,N,-,-1,-1
MULIFE.txt,1017980,1018199,219,10,N,N,-,-1,-1
MULIFE.txt,1017986,1018203,217,10,N,N,-,-1,-1
MULIFE.txt,1017991,1018239,248,10,N,N,-,-1,-1
MULIFE.txt,1017993,1018396,403,10,N,N,-,-1,-1
MULIFE.txt,1017995,1018400,405,10,N,N,-,-1,-1
MULIFE.txt,1018011,1018406,395,10,N,N,-,-1,-1
MULIFE.txt,1018068,1018413,345,10,N,N,-,-1,-1
MULIFE.txt,1018132,1018418,286,10,N,N,-,-1,-1
MULIFE.txt,1018181,1018430,249,10,N,N,-,-1,-1
MULIFE.txt,1018193,1018512,319,10,N,N,-,-1,-1
MULIFE.txt,1018200,1018563,363,10,N,N,-,-1,-1
MULIFE.txt,1018206,1018567,361,10,N,N,-,-1,-1
MULIFE.txt,1018240,1018573,333,10,N,N,-,-1,-1
MULIFE.txt,1018397,1018580,183,10,N,N,-,-1,-1
MULIFE.txt,1018402,1018584,182,10,N,N,-,-1,-1
MULIFE.txt,1018407,1018630,223,10,N,N,-,-1,-1
MULIFE.txt,1018414,1018708,294,10,N,N,-,-1,-1
MULIFE.txt,1018421,1018843,422,10,N,N,-,-1,-1
MULIFE.txt,1018431,1018854,423,10,N,N,-,-1,-1
MULIFE.txt,1018513,1018861,348,10,N,N,-,-1,-1
MULIFE.txt,1018564,1018866,302,10,N,N,-,-1,-1
MULIFE.txt,1018569,1018878,309,10,N,N,-,-1,-1
MULIFE.txt,1018574,1018885,311,10,N,N,-,-1,-1
MULIFE.txt,1018581,1018991,410,10,N,N,-,-1,-1
MULIFE.txt,1018587,1018992,405,10,N,N,-,-1,-1
MULIFE.txt,1018631,1019163,532,10,N,N,-,-1,-1
MULIFE.txt,1018709,1019175,466,10,N,N,-,-1,-1
MULIFE.txt,1018844,1019182,338,10,N,N,-,-1,-1
MULIFE.txt,1018855,1019186,331,10,N,N,-,-1,-1
MULIFE.txt,1018862,1019193,331,10,N,N,-,-1,-1
MULIFE.txt,1018869,1019197,328,10,N,N,-,-1,-1
MULIFE.txt,1018881,1019423,542,10,N,N,-,-1,-1
MULIFE.txt,1018886,1019440,554,10,N,N,-,-1,-1
MULIFE.txt,1018991,1019444,453,10,N,N,-,-1,-1
MULIFE.txt,1018993,1019530,537,10,N,N,-,-1,-1
MULIFE.txt,1019164,1019560,396,10,N,N,-,-1,-1
MULIFE.txt,1019176,1019589,413,10,N,N,-,-1,-1
MULIFE.txt,1019183,1019602,419,10,N,N,-,-1,-1
MULIFE.txt,1019189,1019614,425,10,N,N,-,-1,-1
MULIFE.txt,1019194,1019634,440,10,N,N,-,-1,-1
MULIFE.txt,1019198,1019705,507,10,N,N,-,-1,-1
MULIFE.txt,1019424,1019750,326,10,N,N,-,-1,-1
MULIFE.txt,1019441,1019767,326,10,N,N,-,-1,-1
MULIFE.txt,1019449,1019796,347,10,N,N,-,-1,-1
MULIFE.txt,1019532,1019928,396,10,N,N,-,-1,-1
MULIFE.txt,1019563,1019988,425,10,N,N,-,-1,-1
MULIFE.txt,1019592,1019999,407,10,N,N,-,-1,-1
MULIFE.txt,1019603,1020005,402,10,N,N,-,-1,-1
MULIFE.txt,1019615,1020019,404,10,N,N,-,-1,-1
MULIFE.txt,1019637,1020138,501,10,N,N,-,-1,-1
MULIFE.txt,1019706,1020198,492,10,N,N,-,-1,-1
MULIFE.txt,1019753,1020209,456,10,N,N,-,-1,-1
MULIFE.txt,1019768,1020216,448,10,N,N,-,-1,-1
MULIFE.txt,1019797,1020232,435,10,N,N,-,-1,-1
MULIFE.txt,1019930,1020353,423,10,N,N,-,-1,-1
MULIFE.txt,1019989,1020397,408,10,N,N,-,-1,-1
MULIFE.txt,1020000,1020409,409,10,N,N,-,-1,-1
MULIFE.txt,1020008,1020415,407,10,N,N,-,-1,-1
MULIFE.txt,1020020,1020427,407,10,N,N,-,-1,-1
MULIFE.txt,1020139,1020633,494,10,N,N,-,-1,-1
MULIFE.txt,1020199,1020647,448,10,N,N,-,-1,-1
MULIFE.txt,1020210,1020651,441,10,N,N,-,-1,-1
MULIFE.txt,1020219,1020661,442,10,N,N,-,-1,-1
MULIFE.txt,1020233,1020675,442,10,N,N,-,-1,-1
MULIFE.txt,1020354,1020737,383,10,N,N,-,-1,-1
MULIFE.txt,1020399,1020757,358,10,N,N,-,-1,-1
MULIFE.txt,1020410,1020823,413,10,N,N,-,-1,-1
MULIFE.txt,1020418,1020834,416,10,N,N,-,-1,-1
MULIFE.txt,1020428,1020840,412,10,N,N,-,-1,-1
MULIFE.txt,1020634,1020854,220,10,N,N,-,-1,-1
MULIFE.txt,1020648,1020888,240,10,N,N,-,-1,-1
MULIFE.txt,1020652,1020936,284,10,N,N,-,-1,-1
MULIFE.txt,1020664,1021037,373,10,N,N,-,-1,-1
MULIFE.txt,1020676,1021042,366,10,N,N,-,-1,-1
MULIFE.txt,1020738,1021049,311,10,N,N,-,-1,-1
MULIFE.txt,1020758,1021053,295,10,N,N,-,-1,-1
MULIFE.txt,1020824,1021058,234,10,N,N,-,-1,-1
MULIFE.txt,1020835,1021081,246,10,N,N,-,-1,-1
MULIFE.txt,1020843,1021130,287,10,N,N,-,-1,-1
MULIFE.txt,1020855,1021181,326,10,N,N,-,-1,-1
MULIFE.txt,1020889,1021232,343,10,N,N,-,-1,-1
MULIFE.txt,1020937,1021243,306,10,N,N,-,-1,-1
MULIFE.txt,1021038,1021249,211,10,N,N,-,-1,-1
MULIFE.txt,1021043,1021250,207,10,N,N,-,-1,-1
MULIFE.txt,1021050,1021251,201,10,N,N,-,-1,-1
MULIFE.txt,1021054,1021255,201,10,N,N,-,-1,-1
MULIFE.txt,1021061,1021260,199,10,N,N,-,-1,-1
MULIFE.txt,1021082,1021313,231,10,N,N,-,-1,-1
MULIFE.txt,1021132,1021437,305,10,N,N,-,-1,-1
MULIFE.txt,1021182,1021508,326,10,N,N,-,-1,-1
MULIFE.txt,1021233,1021524,291,10,N,N,-,-1,-1
MULIFE.txt,1021244,1021553,309,10,N,N,-,-1,-1
MULIFE.txt,1021249,1021565,316,10,N,N,-,-1,-1
MULIFE.txt,1021250,1021572,322,10,N,N,-,-1,-1
MULIFE.txt,1021252,1021640,388,10,N,N,-,-1,-1
MULIFE.txt,1021256,1021719,463,10,N,N,-,-1,-1
MULIFE.txt,1021263,1021742,479,10,N,N,-,-1,-1
MULIFE.txt,1021314,1021754,440,10,N,N,-,-1,-1
MULIFE.txt,1021438,1021759,321,10,N,N,-,-1,-1
MULIFE.txt,1021509,1021761,252,10,N,N,-,-1,-1
MULIFE.txt,1021525,1021775,250,10,N,N,-,-1,-1
MULIFE.txt,1021555,1021801,246,10,N,N,-,-1,-1
MULIFE.txt,1021566,1021854,288,10,N,N,-,-1,-1
MULIFE.txt,1021573,1021878,305,10,N,N,-,-1,-1
MULIFE.txt,1021642,1021889,247,10,N,N,-,-1,-1
MULIFE.txt,1021720,1021895,175,10,N,N,-,-1,-1
MULIFE.txt,1021743,1021909,166,10,N,N,-,-1,-1
MULIFE.txt,1021755,1021945,190,10,N,N,-,-1,-1
MULIFE.txt,1021759,1022053,294,10,N,N,-,-1,-1
MULIFE.txt,1021764,1022076,312,10,N,N,-,-1,-1
MULIFE.txt,1021776,1022087,311,10,N,N,-,-1,-1
MULIFE.txt,1021802,1022093,291,10,N,N,-,-1,-1
MULIFE.txt,1021855,1022106,251,10,N,N,-,-1,-1
MULIFE.txt,1021879,1022134,255,10,N,N,-,-1,-1
MULIFE.txt,1021890,1022233,343,10,N,N,-,-1,-1
MULIFE.txt,1021898,1022256,358,10,N,N,-,-1,-1
MULIFE.txt,1021910,1022273,363,10,N,N,-,-1,-1
MULIFE.txt,1021946,1022291,345,10,N,N,-,-1,-1
MULIFE.txt,1022054,1022351,297,10,N,N,-,-1,-1
MULIFE.txt,1022077,1022366,289,10,N,N,-,-1,-1
MULIFE.txt,1022088,1022375,287,10,N,N,-,-1,-1
MULIFE.txt,1022096,1022428,332,10,N,N,-,-1,-1
MULIFE.txt,1022107,1022485,378,10,N,N,-,-1,-1
MULIFE.txt,1022135,1022489,354,10,N,N,-,-1,-1
MULIFE.txt,1022234,1022500,266,10,N,N,-,-1,-1
MULIFE.txt,1022257,1022762,505,10,N,N,-,-1,-1
MULIFE.txt,1022276,1022814,538,10,N,N,-,-1,-1
MULIFE.txt,1022292,1022819,527,10,N,N,-,-1,-1
MULIFE.txt,1022352,1022828,476,10,N,N,-,-1,-1
MULIFE.txt,1022369,1022832,463,10,N,N,-,-1,-1
MULIFE.txt,1022376,1022840,464,10,N,N,-,-1,-1
MULIFE.txt,1022429,1022877,448,10,N,N,-,-1,-1
MULIFE.txt,1022486,1022893,407,10,N,N,-,-1,-1
MULIFE.txt,1022492,1023008,516,10,N,N,-,-1,-1
MULIFE.txt,1022501,1023015,514,10,N,N,-,-1,-1
MULIFE.txt,1022763,1023023,260,10,N,N,-,-1,-1
MULIFE.txt,1022815,1023066,251,10,N,N,-,-1,-1
MULIFE.txt,1022820,1023105,285,10,N,N,-,-1,-1
MULIFE.txt,1022829,1023152,323,10,N,N,-,-1,-1
MULIFE.txt,1022835,1023157,322,10,N,N,-,-1,-1
MULIFE.txt,1022841,1023165,324,10,N,N,-,-1,-1
MULIFE.txt,1022878,1023170,292,10,N,N,-,-1,-1
MULIFE.txt,1022894,1023177,283,10,N,N,-,-1,-1
MULIFE.txt,1023009,1023196,187,10,N,N,-,-1,-1
MULIFE.txt,1023018,1023225,207,10,N,N,-,-1,-1
MULIFE.txt,1023024,1023258,234,10,N,N,-,-1,-1
MULIFE.txt,1023067,1023269,202,10,N,N,-,-1,-1
MULIFE.txt,1023106,1023295,189,10,N,N,-,-1,-1
MULIFE.txt,1023153,1023303,150,10,N,N,-,-1,-1
MULIFE.txt,1023158,1023430,272,10,N,N,-,-1,-1
MULIFE.txt,1023166,1023450,284,10,N,N,-,-1,-1
MULIFE.txt,1023175,1023486,311,10,N,N,-,-1,-1
MULIFE.txt,1023177,1023513,336,10,N,N,-,-1,-1
MULIFE.txt,1023196,1023543,347,10,N,N,-,-1,-1
MULIFE.txt,1023230,1023569,339,10,N,N,-,-1,-1
MULIFE.txt,1023261,1023640,379,10,N,N,-,-1,-1
MULIFE.txt,1023270,1023664,394,10,N,N,-,-1,-1
MULIFE.txt,1023296,1023675,379,10,N,N,-,-1,-1
MULIFE.txt,1023304,1023681,377,10,N,N,-,-1,-1
MULIFE.txt,1023431,1023691,260,10,N,N,-,-1,-1
MULIFE.txt,1023452,1023719,267,10,N,N,-,-1,-1
MULIFE.txt,1023488,1023742,254,10,N,N,-,-1,-1
MULIFE.txt,1023514,1023798,284,10,N,N,-,-1,-1
MULIFE.txt,1023544,1023817,273,10,N,N,-,-1,-1
MULIFE.txt,1023571,1023831,260,10,N,N,-,-1,-1
MULIFE.txt,1023641,1023862,221,10,N,N,-,-1,-1
MULIFE.txt,1023665,1023890,225,10,N,N,-,-1,-1
MULIFE.txt,1023676,1024001,325,10,N,N,-,-1,-1
MULIFE.txt,1023684,1024048,364,10,N,N,-,-1,-1
MULIFE.txt,1023692,1024052,360,10,N,N,-,-1,-1
MULIFE.txt,1023720,1024057,337,10,N,N,-,-1,-1
MULIFE.txt,1023744,1024065,321,10,N,N,-,-1,-1
MULIFE.txt,1023799,1024083,284,10,N,N,-,-1,-1
MULIFE.txt,1023820,1024104,284,10,N,N,-,-1,-1
MULIFE.txt,1023832,1024127,295,10,N,N,-,-1,-1
MULIFE.txt,1023863,1024139,276,10,N,N,-,-1,-1
MULIFE.txt,1023891,1024146,255,10,N,N,-,-1,-1
MULIFE.txt,1024002,1024150,148,10,N,N,-,-1,-1
MULIFE.txt,1024049,1024169,120,10,N,N,-,-1,-1
MULIFE.txt,1024053,1024215,162,10,N,N,-,-1,-1
MULIFE.txt,1024060,1024264,204,10,N,N,-,-1,-1
MULIFE.txt,1024066,1024312,246,10,N,N,-,-1,-1
MULIFE.txt,1024084,1024324,240,10,N,N,-,-1,-1
MULIFE.txt,1024105,1024330,225,10,N,N,-,-1,-1
MULIFE.txt,1024129,1024352,223,10,N,N,-,-1,-1
MULIFE.txt,1024140,1024429,289,10,N,N,-,-1,-1
MULIFE.txt,1024147,1024492,345,10,N,N,-,-1,-1
MULIFE.txt,1024153,1024497,344,10,N,N,-,-1,-1
MULIFE.txt,1024172,1024504,332,10,N,N,-,-1,-1
MULIFE.txt,1024216,1024509,293,10,N,N,-,-1,-1
MULIFE.txt,1024265,1024515,250,10,N,N,-,-1,-1
MULIFE.txt,1024313,1024548,235,10,N,N,-,-1,-1
MULIFE.txt,1024325,1024574,249,10,N,N,-,-1,-1
MULIFE.txt,1024333,1024579,246,10,N,N,-,-1,-1
MULIFE.txt,1024353,1024590,237,10,N,N,-,-1,-1
MULIFE.txt,1024430,1024594,164,10,N,N,-,-1,-1
MULIFE.txt,1024493,1024604,111,10,N,N,-,-1,-1
MULIFE.txt,1024498,1024697,199,10,N,N,-,-1,-1
MULIFE.txt,1024505,1024779,274,10,N,N,-,-1,-1
MULIFE.txt,1024511,1024785,274,10,N,N,-,-1,-1
MULIFE.txt,1024518,1024792,274,10,N,N,-,-1,-1
MULIFE.txt,1024549,1024805,256,10,N,N,-,-1,-1
MULIFE.txt,1024575,1024905,330,10,N,N,-,-1,-1
MULIFE.txt,1024580,1024943,363,10,N,N,-,-1,-1
MULIFE.txt,1024591,1024957,366,10,N,N,-,-1,-1
MULIFE.txt,1024597,1024980,383,10,N,N,-,-1,-1
MULIFE.txt,1024605,1024997,392,10,N,N,-,-1,-1
MULIFE.txt,1024698,1025015,317,10,N,N,-,-1,-1
MULIFE.txt,1024781,1025125,344,10,N,N,-,-1,-1
MULIFE.txt,1024786,1025141,355,10,N,N,-,-1,-1
MULIFE.txt,1024795,1025144,349,10,N,N,-,-1,-1
MULIFE.txt,1024806,1025154,348,10,N,N,-,-1,-1
MULIFE.txt,1024907,1025172,265,10,N,N,-,-1,-1
MULIFE.txt,1024943,1025196,253,10,N,N,-,-1,-1
MULIFE.txt,1024958,1025197,239,10,N,N,-,-1,-1
MULIFE.txt,1024982,1025215,233,10,N,N,-,-1,-1
MULIFE.txt,1025002,1025224,222,10,N,N,-,-1,-1
MULIFE.txt,1025016,1025274,258,10,N,N,-,-1,-1
MULIFE.txt,1025126,1025278,152,10,N,N,-,-1,-1
MULIFE.txt,1025142,1025283,141,10,N,N,-,-1,-1
MULIFE.txt,1025144,1025285,141,10,N,N,-,-1,-1
MULIFE.txt,1025155,1025288,133,10,N,N,-,-1,-1
MULIFE.txt,1025173,1025289,116,10,N,N,-,-1,-1
MULIFE.txt,1025196,1025290,94,10,N,N,-,-1,-1
MULIFE.txt,1025198,1025295,97,10,N,N,-,-1,-1
MULIFE.txt,1025216,1025330,114,10,N,N,-,-1,-1
MULIFE.txt,1025225,1025331,106,10,N,N,-,-1,-1
MULIFE.txt,1025275,1025376,101,10,N,N,-,-1,-1
MULIFE.txt,1025279,1025411,132,10,N,N,-,-1,-1
MULIFE.txt,1025284,1025434,150,10,N,N,-,-1,-1
MULIFE.txt,1025286,1025439,153,10,N,N,-,-1,-1
MULIFE.txt,1025288,1025445,157,10,N,N,-,-1,-1
MULIFE.txt,1025289,1025449,160,10,N,N,-,-1,-1
MULIFE.txt,1025291,1025455,164,10,N,N,-,-1,-1
MULIFE.txt,1025298,1025494,196,10,N,N,-,-1,-1
MULIFE.txt,1025330,1025516,186,10,N,N,-,-1,-1
MULIFE.txt,1025334,1025554,220,10,N,N,-,-1,-1
MULIFE.txt,1025377,1025598,221,10,N,N,-,-1,-1
MULIFE.txt,1025412,1025623,211,10,N,N,-,-1,-1
MULIFE.txt,1025435,1025663,228,10,N,N,-,-1,-1
MULIFE.txt,1025441,1025682,241,10,N,N,-,-1,-1
MULIFE.txt,1025446,1025686,240,10,N,N,-,-1,-1
MULIFE.txt,1025449,1025733,284,10,N,N,-,-1,-1
MULIFE.txt,1025458,1025909,451,10,N,N,-,-1,-1
MULIFE.txt,1025495,1025913,418,10,N,N,-,-1,-1
MULIFE.txt,1025516,1025918,402,10,N,N,-,-1,-1
MULIFE.txt,1025555,1025925,370,10,N,N,-,-1,-1
MULIFE.txt,1025600,1025933,333,10,N,N,-,-1,-1
MULIFE.txt,1025624,1025985,361,10,N,N,-,-1,-1
MULIFE.txt,1025664,1026017,353,10,N,N,-,-1,-1
MULIFE.txt,1025683,1026022,339,10,N,N,-,-1,-1
MULIFE.txt,1025689,1026028,339,10,N,N,-,-1,-1
MULIFE.txt,1025734,1026033,299,10,N,N,-,-1,-1
MULIFE.txt,1025910,1026044,134,10,N,N,-,-1,-1
MULIFE.txt,1025914,1026103,189,10,N,N,-,-1,-1
MULIFE.txt,1025919,1026126,207,10,N,N,-,-1,-1
MULIFE.txt,1025928,1026143,215,10,N,N,-,-1,-1
MULIFE.txt,1025934,1026149,215,10,N,N,-,-1,-1
MULIFE.txt,1025986,1026165,179,10,N,N,-,-1,-1
MULIFE.txt,1026018,1026231,213,10,N,N,-,-1,-1
MULIFE.txt,1026023,1026267,244,10,N,N,-,-1,-1
MULIFE.txt,1026029,1026311,282,10,N,N,-,-1,-1
MULIFE.txt,1026036,1026334,298,10,N,N,-,-1,-1
MULIFE.txt,1026045,1026384,339,10,N,N,-,-1,-1
MULIFE.txt,1026104,1026389,285,10,N,N,-,-1,-1
MULIFE.txt,1026128,1026395,267,10,N,N,-,-1,-1
MULIFE.txt,1026144,1026406,262,10,N,N,-,-1,-1
MULIFE.txt,1026152,1026438,286,10,N,N,-,-1,-1
MULIFE.txt,1026166,1026457,291,10,N,N,-,-1,-1
MULIFE.txt,1026232,1026483,251,10,N,N,-,-1,-1
MULIFE.txt,1026268,1026488,220,10,N,N,-,-1,-1
MULIFE.txt,1026311,1026506,195,10,N,N,-,-1,-1
MULIFE.txt,1026335,1026653,318,10,N,N,-,-1,-1
MULIFE.txt,1026385,1026658,273,10,N,N,-,-1,-1
MULIFE.txt,1026390,1026670,280,10,N,N,-,-1,-1
MULIFE.txt,1026398,1026683,285,10,N,N,-,-1,-1
MULIFE.txt,1026407,1026696,289,10,N,N,-,-1,-1
MULIFE.txt,1026439,1026702,263,10,N,N,-,-1,-1
MULIFE.txt,1026458,1026753,295,10,N,N,-,-1,-1
MULIFE.txt,1026484,1026807,323,10,N,N,-,-1,-1
MULIFE.txt,1026489,1026830,341,10,N,N,-,-1,-1
MULIFE.txt,1026507,1026859,352,10,N,N,-,-1,-1
MULIFE.txt,1026654,1026865,211,10,N,N,-,-1,-1
MULIFE.txt,1026659,1026878,219,10,N,N,-,-1,-1
MULIFE.txt,1026671,1026939,268,10,N,N,-,-1,-1
MULIFE.txt,1026685,1026972,287,10,N,N,-,-1,-1
MULIFE.txt,1026697,1026979,282,10,N,N,-,-1,-1
MULIFE.txt,1026707,1026989,282,10,N,N,-,-1,-1
MULIFE.txt,1026754,1027031,277,10,N,N,-,-1,-1
MULIFE.txt,1026808,1027045,237,10,N,N,-,-1,-1
MULIFE.txt,1026831,1027066,235,10,N,N,-,-1,-1
MULIFE.txt,1026860,1027083,223,10,N,N,-,-1,-1
MULIFE.txt,1026868,1027124,256,10,N,N,-,-1,-1
MULIFE.txt,1026881,1027156,275,10,N,N,-,-1,-1
MULIFE.txt,1026940,1027161,221,10,N,N,-,-1,-1
MULIFE.txt,1026973,1027169,196,10,N,N,-,-1,-1
MULIFE.txt,1026980,1027173,193,10,N,N,-,-1,-1
MULIFE.txt,1026992,1027192,200,10,N,N,-,-1,-1
MULIFE.txt,1027032,1027209,177,10,N,N,-,-1,-1
MULIFE.txt,1027046,1027269,223,10,N,N,-,-1,-1
MULIFE.txt,1027067,1027277,210,10,N,N,-,-1,-1
MULIFE.txt,1027084,1027282,198,10,N,N,-,-1,-1
MULIFE.txt,1027125,1027293,168,10,N,N,-,-1,-1
MULIFE.txt,1027157,1027297,140,10,N,N,-,-1,-1
MULIFE.txt,1027162,1027354,192,10,N,N,-,-1,-1
MULIFE.txt,1027170,1027382,212,10,N,N,-,-1,-1
MULIFE.txt,1027176,1027390,214,10,N,N,-,-1,-1
MULIFE.txt,1027194,1027403,209,10,N,N,-,-1,-1
MULIFE.txt,1027210,1027435,225,10,N,N,-,-1,-1
MULIFE.txt,1027270,1027475,205,10,N,N,-,-1,-1
MULIFE.txt,1027278,1027479,201,10,N,N,-,-1,-1
MULIFE.txt,1027283,1027504,221,10,N,N,-,-1,-1
MULIFE.txt,1027294,1027536,242,10,N,N,-,-1,-1
MULIFE.txt,1027299,1027540,241,10,N,N,-,-1,-1
MULIFE.txt,1027355,1027547,192,10,N,N,-,-1,-1
MULIFE.txt,1027383,1027553,170,10,N,N,-,-1,-1
MULIFE.txt,1027391,1027557,166,10,N,N,-,-1,-1
MULIFE.txt,1027405,1027570,165,10,N,N,-,-1,-1
MULIFE.txt,1027436,1027609,173,10,N,N,-,-1,-1
MULIFE.txt,1027476,1027641,165,10,N,N,-,-1,-1
MULIFE.txt,1027481,1027646,165,10,N,N,-,-1,-1
MULIFE.txt,1027505,1027651,146,10,N,N,-,-1,-1
MULIFE.txt,1027537,1027657,120,10,N,N,-,-1,-1
MULIFE.txt,1027543,1027733,190,10,N,N,-,-1,-1
MULIFE.txt,1027548,1027738,190,10,N,N,-,-1,-1
MULIFE.txt,1027554,1027743,189,10,N,N,-,-1,-1
MULIFE.txt,1027559,1027751,192,10,N,N,-,-1,-1
MULIFE.txt,1027571,1027756,185,10,N,N,-,-1,-1
MULIFE.txt,1027610,1027757,147,10,N,N,-,-1,-1
MULIFE.txt,1027642,1027777,135,10,N,N,-,-1,-1
MULIFE.txt,1027647,1027846,199,10,N,N,-,-1,-1
MULIFE.txt,1027652,1027857,205,10,N,N,-,-1,-1
MULIFE.txt,1027658,1027864,206,10,N,N,-,-1,-1
MULIFE.txt,1027734,1027868,134,10,N,N,-,-1,-1
MULIFE.txt,1027739,1027887,148,10,N,N,-,-1,-1
MULIFE.txt,1027744,1027936,192,10,N,N,-,-1,-1
MULIFE.txt,1027752,1027947,195,10,N,N,-,-1,-1
MULIFE.txt,1027756,1027954,198,10,N,N,-,-1,-1
MULIFE.txt,1027760,1027958,198,10,N,N,-,-1,-1
MULIFE.txt,1027779,1027969,190,10,N,N,-,-1,-1
MULIFE.txt,1027847,1028008,161,10,N,N,-,-1,-1
MULIFE.txt,1027858,1028019,161,10,N,N,-,-1,-1
MULIFE.txt,1027865,1028026,161,10,N,N,-,-1,-1
MULIFE.txt,1027871,1028059,188,10,N,N,-,-1,-1
MULIFE.txt,1027890,1028070,180,10,N,N,-,-1,-1
MULIFE.txt,1027937,1028094,157,10,N,N,-,-1,-1
MULIFE.txt,1027948,1028105,157,10,N,N,-,-1,-1
MULIFE.txt,1027955,1028113,158,10,N,N,-,-1,-1
MULIFE.txt,1027961,1028133,172,10,N,N,-,-1,-1
MULIFE.txt,1027970,1028150,180,10,N,N,-,-1,-1
MULIFE.txt,1028009,1028171,162,10,N,N,-,-1,-1
MULIFE.txt,1028020,1028183,163,10,N,N,-,-1,-1
MULIFE.txt,1028027,1028189,162,10,N,N,-,-1,-1
MULIFE.txt,1028060,1028193,133,10,N,N,-,-1,-1
MULIFE.txt,1028072,1028212,140,10,N,N,-,-1,-1
MULIFE.txt,1028095,1028223,128,10,N,N,-,-1,-1
MULIFE.txt,1028107,1028229,122,10,N,N,-,-1,-1
MULIFE.txt,1028114,1028237,123,10,N,N,-,-1,-1
MULIFE.txt,1028134,1028299,165,10,N,N,-,-1,-1
MULIFE.txt,1028151,1028317,166,10,N,N,-,-1,-1
MULIFE.txt,1028173,1028359,186,10,N,N,-,-1,-1
MULIFE.txt,1028184,1028403,219,10,N,N,-,-1,-1
MULIFE.txt,1028190,1028518,328,10,N,N,-,-1,-1
MULIFE.txt,1028195,1028523,328,10,N,N,-,-1,-1
MULIFE.txt,1028213,1028530,317,10,N,N,-,-1,-1
MULIFE.txt,1028224,1028610,386,10,N,N,-,-1,-1
MULIFE.txt,1028232,1028617,385,10,N,N,-,-1,-1
MULIFE.txt,1028238,1028776,538,10,N,N,-,-1,-1
MULIFE.txt,1028301,1028783,482,10,N,N,-,-1,-1
MULIFE.txt,1028318,1028795,477,10,N,N,-,-1,-1
MULIFE.txt,1028362,1028846,484,10,N,N,-,-1,-1
MULIFE.txt,1028405,1028888,483,10,N,N,-,-1,-1
MULIFE.txt,1028519,1028894,375,10,N,N,-,-1,-1
MULIFE.txt,1028524,1028917,393,10,N,N,-,-1,-1
MULIFE.txt,1028533,1028931,398,10,N,N,-,-1,-1
MULIFE.txt,1028613,1028960,347,10,N,N,-,-1,-1
MULIFE.txt,1028618,1028977,359,10,N,N,-,-1,-1
MULIFE.txt,1028777,1028998,221,10,N,N,-,-1,-1
MULIFE.txt,1028786,1029005,219,10,N,N,-,-1,-1
MULIFE.txt,1028796,1029012,216,10,N,N,-,-1,-1
MULIFE.txt,1028847,1029018,171,10,N,N,-,-1,-1
MULIFE.txt,1028889,1029024,135,10,N,N,-,-1,-1
MULIFE.txt,1028897,1029029,132,10,N,N,-,-1,-1
MULIFE.txt,1028918,1029043,125,10,N,N,-,-1,-1
MULIFE.txt,1028933,1029090,157,10,N,N,-,-1,-1
MULIFE.txt,1028962,1029103,141,10,N,N,-,-1,-1
MULIFE.txt,1028978,1029158,180,10,N,N,-,-1,-1
MULIFE.txt,1029001,1029196,195,10,N,N,-,-1,-1
MULIFE.txt,1029006,1029201,195,10,N,N,-,-1,-1
MULIFE.txt,1029013,1029218,205,10,N,N,-,-1,-1
MULIFE.txt,1029020,1029241,221,10,N,N,-,-1,-1
MULIFE.txt,1029025,1029285,260,10,N,N,-,-1,-1
MULIFE.txt,1029030,1029291,261,10,N,N,-,-1,-1
MULIFE.txt,1029044,1029317,273,10,N,N,-,-1,-1
MULIFE.txt,1029091,1029359,268,10,N,N,-,-1,-1
MULIFE.txt,1029106,1029364,258,10,N,N,-,-1,-1
MULIFE.txt,1029159,1029371,212,10,N,N,-,-1,-1
MULIFE.txt,1029197,1029419,222,10,N,N,-,-1,-1
MULIFE.txt,1029202,1029427,225,10,N,N,-,-1,-1
MULIFE.txt,1029219,1029432,213,10,N,N,-,-1,-1
MULIFE.txt,1029243,1029438,195,10,N,N,-,-1,-1
MULIFE.txt,1029286,1029469,183,10,N,N,-,-1,-1
MULIFE.txt,1029294,1029475,181,10,N,N,-,-1,-1
MULIFE.txt,1029319,1029480,161,10,N,N,-,-1,-1
MULIFE.txt,1029360,1029491,131,10,N,N,-,-1,-1
MULIFE.txt,1029365,1029523,158,10,N,N,-,-1,-1
MULIFE.txt,1029373,1029569,196,10,N,N,-,-1,-1
MULIFE.txt,1029420,1029578,158,10,N,N,-,-1,-1
MULIFE.txt,1029428,1029596,168,10,N,N,-,-1,-1
MULIFE.txt,1029433,1029608,175,10,N,N,-,-1,-1
MULIFE.txt,1029440,1029638,198,10,N,N,-,-1,-1
MULIFE.txt,1029470,1029649,179,10,N,N,-,-1,-1
MULIFE.txt,1029475,1029668,193,10,N,N,-,-1,-1
MULIFE.txt,1029481,1029676,195,10,N,N,-,-1,-1
MULIFE.txt,1029493,1029683,190,10,N,N,-,-1,-1
MULIFE.txt,1029526,1029689,163,10,N,N,-,-1,-1
MULIFE.txt,1029570,1029690,120,10,N,N,-,-1,-1
MULIFE.txt,1029579,1029695,116,10,N,N,-,-1,-1
MULIFE.txt,1029597,1029703,106,10,N,N,-,-1,-1
MULIFE.txt,1029609,1029743,134,10,N,N,-,-1,-1
MULIFE.txt,1029641,1029783,142,10,N,N,-,-1,-1
MULIFE.txt,1029650,1029791,141,10,N,N,-,-1,-1
MULIFE.txt,1029669,1029803,134,10,N,N,-,-1,-1
MULIFE.txt,1029679,1029826,147,10,N,N,-,-1,-1
MULIFE.txt,1029684,1029834,150,10,N,N,-,-1,-1
MULIFE.txt,1029689,1029840,151,10,N,N,-,-1,-1
MULIFE.txt,1029691,1029866,175,10,N,N,-,-1,-1
MULIFE.txt,1029698,1029875,177,10,N,N,-,-1,-1
MULIFE.txt,1029704,1029880,176,10,N,N,-,-1,-1
MULIFE.txt,1029744,1029889,145,10,N,N,-,-1,-1
MULIFE.txt,1029784,1029951,167,10,N,N,-,-1,-1
MULIFE.txt,1029792,1029999,207,10,N,N,-,-1,-1
MULIFE.txt,1029804,1030005,201,10,N,N,-,-1,-1
MULIFE.txt,1029827,1030009,182,10,N,N,-,-1,-1
MULIFE.txt,1029836,1030063,227,10,N,N,-,-1,-1
MULIFE.txt,1029841,1030119,278,10,N,N,-,-1,-1
MULIFE.txt,1029867,1030134,267,10,N,N,-,-1,-1
MULIFE.txt,1029876,1030266,390,10,N,N,-,-1,-1
MULIFE.txt,1029883,1030305,422,10,N,N,-,-1,-1
MULIFE.txt,1029890,1030324,434,10,N,N,-,-1,-1
MULIFE.txt,1029953,1030401,448,10,N,N,-,-1,-1
MULIFE.txt,1030000,1030448,448,10,N,N,-,-1,-1
MULIFE.txt,1030006,1030459,453,10,N,N,-,-1,-1
MULIFE.txt,1030014,1030463,449,10,N,N,-,-1,-1
MULIFE.txt,1030068,1030518,450,10,N,N,-,-1,-1
MULIFE.txt,1030124,1030566,442,10,N,N,-,-1,-1
MULIFE.txt,1030135,1030658,523,10,N,N,-,-1,-1
MULIFE.txt,1030267,1030687,420,10,N,N,-,-1,-1
MULIFE.txt,1030308,1030692,384,10,N,N,-,-1,-1
MULIFE.txt,1030327,1030698,371,10,N,N,-,-1,-1
MULIFE.txt,1030402,1030707,305,10,N,N,-,-1,-1
MULIFE.txt,1030449,1030740,291,10,N,N,-,-1,-1
MULIFE.txt,1030460,1030749,289,10,N,N,-,-1,-1
MULIFE.txt,1030466,1030799,333,10,N,N,-,-1,-1
MULIFE.txt,1030519,1030803,284,10,N,N,-,-1,-1
MULIFE.txt,1030567,1030808,241,10,N,N,-,-1,-1
MULIFE.txt,1030659,1030819,160,10,N,N,-,-1,-1
MULIFE.txt,1030688,1030858,170,10,N,N,-,-1,-1
MULIFE.txt,1030693,1030900,207,10,N,N,-,-1,-1
MULIFE.txt,1030701,1030906,205,10,N,N,-,-1,-1
MULIFE.txt,1030708,1030910,202,10,N,N,-,-1,-1
MULIFE.txt,1030741,1030936,195,10,N,N,-,-1,-1
MULIFE.txt,1030750,1031040,290,10,N,N,-,-1,-1
MULIFE.txt,1030800,1031052,252,10,N,N,-,-1,-1
MULIFE.txt,1030804,1031095,291,10,N,N,-,-1,-1
MULIFE.txt,1030811,1031106,295,10,N,N,-,-1,-1
MULIFE.txt,1030820,1031212,392,10,N,N,-,-1,-1
MULIFE.txt,1030859,1031219,360,10,N,N,-,-1,-1
MULIFE.txt,1030901,1031226,325,10,N,N,-,-1,-1
MULIFE.txt,1030907,1031269,362,10,N,N,-,-1,-1
MULIFE.txt,1030913,1031274,361,10,N,N,-,-1,-1
MULIFE.txt,1030939,1031281,342,10,N,N,-,-1,-1
MULIFE.txt,1031042,1031305,263,10,N,N,-,-1,-1
MULIFE.txt,1031055,1031316,261,10,N,N,-,-1,-1
MULIFE.txt,1031096,1031323,227,10,N,N,-,-1,-1
MULIFE.txt,1031109,1031327,218,10,N,N,-,-1,-1
MULIFE.txt,1031215,1031336,121,10,N,N,-,-1,-1
MULIFE.txt,1031220,1031377,157,10,N,N,-,-1,-1
MULIFE.txt,1031229,1031412,183,10,N,N,-,-1,-1
MULIFE.txt,1031270,1031417,147,10,N,N,-,-1,-1
MULIFE.txt,1031275,1031424,149,10,N,N,-,-1,-1
MULIFE.txt,1031284,1031428,144,10,N,N,-,-1,-1
MULIFE.txt,1031306,1031443,137,10,N,N,-,-1,-1
MULIFE.txt,1031317,1031484,167,10,N,N,-,-1,-1
MULIFE.txt,1031324,1031558,234,10,N,N,-,-1,-1
MULIFE.txt,1031330,1031586,256,10,N,N,-,-1,-1
MULIFE.txt,1031337,1031591,254,10,N,N,-,-1,-1
MULIFE.txt,1031378,1031598,220,10,N,N,-,-1,-1
MULIFE.txt,1031413,1031619,206,10,N,N,-,-1,-1
MULIFE.txt,1031418,1031644,226,10,N,N,-,-1,-1
MULIFE.txt,1031425,1031657,232,10,N,N,-,-1,-1
MULIFE.txt,1031431,1031701,270,10,N,N,-,-1,-1
MULIFE.txt,1031444,1031712,268,10,N,N,-,-1,-1
MULIFE.txt,1031485,1031722,237,10,N,N,-,-1,-1
MULIFE.txt,1031559,1031767,208,10,N,N,-,-1,-1
MULIFE.txt,1031587,1031780,193,10,N,N,-,-1,-1
MULIFE.txt,1031592,1031790,198,10,N,N,-,-1,-1
MULIFE.txt,1031601,1031795,194,10,N,N,-,-1,-1
MULIFE.txt,1031621,1031802,181,10,N,N,-,-1,-1
MULIFE.txt,1031645,1031810,165,10,N,N,-,-1,-1
MULIFE.txt,1031660,1031825,165,10,N,N,-,-1,-1
MULIFE.txt,1031702,1031846,144,10,N,N,-,-1,-1
MULIFE.txt,1031717,1031850,133,10,N,N,-,-1,-1
MULIFE.txt,1031723,1031855,132,10,N,N,-,-1,-1
MULIFE.txt,1031768,1031864,96,10,N,N,-,-1,-1
MULIFE.txt,1031783,1031878,95,10,N,N,-,-1,-1
MULIFE.txt,1031791,1031889,98,10,N,N,-,-1,-1
MULIFE.txt,1031796,1031895,99,10,N,N,-,-1,-1
MULIFE.txt,1031805,1031949,144,10,N,N,-,-1,-1
MULIFE.txt,1031811,1031960,149,10,N,N,-,-1,-1
MULIFE.txt,1031828,1031966,138,10,N,N,-,-1,-1
MULIFE.txt,1031847,1031984,137,10,N,N,-,-1,-1
MULIFE.txt,1031851,1031994,143,10,N,N,-,-1,-1
MULIFE.txt,1031856,1031998,142,10,N,N,-,-1,-1
MULIFE.txt,1031867,1032051,184,10,N,N,-,-1,-1
MULIFE.txt,1031879,1032056,177,10,N,N,-,-1,-1
MULIFE.txt,1031890,1032064,174,10,N,N,-,-1,-1
MULIFE.txt,1031896,1032112,216,10,N,N,-,-1,-1
MULIFE.txt,1031950,1032126,176,10,N,N,-,-1,-1
MULIFE.txt,1031961,1032131,170,10,N,N,-,-1,-1
MULIFE.txt,1031969,1032144,175,10,N,N,-,-1,-1
MULIFE.txt,1031985,1032170,185,10,N,N,-,-1,-1
MULIFE.txt,1031995,1032215,220,10,N,N,-,-1,-1
MULIFE.txt,1032001,1032232,231,10,N,N,-,-1,-1
MULIFE.txt,1032052,1032261,209,10,N,N,-,-1,-1
MULIFE.txt,1032057,1032316,259,10,N,N,-,-1,-1
MULIFE.txt,1032067,1032320,253,10,N,N,-,-1,-1
MULIFE.txt,1032113,1032329,216,10,N,N,-,-1,-1
MULIFE.txt,1032127,1032399,272,10,N,N,-,-1,-1
MULIFE.txt,1032132,1032428,296,10,N,N,-,-1,-1
MULIFE.txt,1032145,1032440,295,10,N,N,-,-1,-1
MULIFE.txt,1032172,1032447,275,10,N,N,-,-1,-1
MULIFE.txt,1032216,1032451,235,10,N,N,-,-1,-1
MULIFE.txt,1032233,1032468,235,10,N,N,-,-1,-1
MULIFE.txt,1032262,1032515,253,10,N,N,-,-1,-1
MULIFE.txt,1032317,1032523,206,10,N,N,-,-1,-1
MULIFE.txt,1032323,1032528,205,10,N,N,-,-1,-1
MULIFE.txt,1032330,1032535,205,10,N,N,-,-1,-1
MULIFE.txt,1032401,1032561,160,10,N,N,-,-1,-1
MULIFE.txt,1032429,1032573,144,10,N,N,-,-1,-1
MULIFE.txt,1032441,1032579,138,10,N,N,-,-1,-1
MULIFE.txt,1032448,1032622,174,10,N,N,-,-1,-1
MULIFE.txt,1032454,1032633,179,10,N,N,-,-1,-1
MULIFE.txt,1032471,1032639,168,10,N,N,-,-1,-1
MULIFE.txt,1032516,1032643,127,10,N,N,-,-1,-1
MULIFE.txt,1032524,1032667,143,10,N,N,-,-1,-1
MULIFE.txt,1032529,1032678,149,10,N,N,-,-1,-1
MULIFE.txt,1032538,1032682,144,10,N,N,-,-1,-1
MULIFE.txt,1032562,1032767,205,10,N,N,-,-1,-1
MULIFE.txt,1032574,1032790,216,10,N,N,-,-1,-1
MULIFE.txt,1032582,1032802,220,10,N,N,-,-1,-1
MULIFE.txt,1032623,1032808,185,10,N,N,-,-1,-1
MULIFE.txt,1032634,1032812,178,10,N,N,-,-1,-1
MULIFE.txt,1032640,1032826,186,10,N,N,-,-1,-1
MULIFE.txt,1032646,1032872,226,10,N,N,-,-1,-1
MULIFE.txt,1032668,1032912,244,10,N,N,-,-1,-1
MULIFE.txt,1032679,1032917,238,10,N,N,-,-1,-1
MULIFE.txt,1032685,1032924,239,10,N,N,-,-1,-1
MULIFE.txt,1032768,1032937,169,10,N,N,-,-1,-1
MULIFE.txt,1032791,1033005,214,10,N,N,-,-1,-1
MULIFE.txt,1032803,1033058,255,10,N,N,-,-1,-1
MULIFE.txt,1032809,1033070,261,10,N,N,-,-1,-1
MULIFE.txt,1032815,1033076,261,10,N,N,-,-1,-1
MULIFE.txt,1032827,1033081,254,10,N,N,-,-1,-1
MULIFE.txt,1032874,1033089,215,10,N,N,-,-1,-1
MULIFE.txt,1032913,1033141,228,10,N,N,-,-1,-1
MULIFE.txt,1032918,1033185,267,10,N,N,-,-1,-1
MULIFE.txt,1032927,1033189,262,10,N,N,-,-1,-1
MULIFE.txt,1032938,1033198,260,10,N,N,-,-1,-1
MULIFE.txt,1033006,1033221,215,10,N,N,-,-1,-1
MULIFE.txt,1033060,1033329,269,10,N,N,-,-1,-1
MULIFE.txt,1033071,1033380,309,10,N,N,-,-1,-1
MULIFE.txt,1033077,1033438,361,10,N,N,-,-1,-1
MULIFE.txt,1033084,1033464,380,10,N,N,-,-1,-1
MULIFE.txt,1033090,1033481,391,10,N,N,-,-1,-1
MULIFE.txt,1033142,1033499,357,10,N,N,-,-1,-1
MULIFE.txt,1033186,1033506,320,10,N,N,-,-1,-1
MULIFE.txt,1033192,1033513,321,10,N,N,-,-1,-1
MULIFE.txt,1033199,1033517,318,10,N,N,-,-1,-1
MULIFE.txt,1033223,1033538,315,10,N,N,-,-1,-1
MULIFE.txt,1033334,1033542,208,10,N,N,-,-1,-1
MULIFE.txt,1033381,1033547,166,10,N,N,-,-1,-1
MULIFE.txt,1033443,1033553,110,10,N,N,-,-1,-1
MULIFE.txt,1033466,1033557,91,10,N,N,-,-1,-1
MULIFE.txt,1033482,1033580,98,10,N,N,-,-1,-1
MULIFE.txt,1033502,1033584,82,10,N,N,-,-1,-1
MULIFE.txt,1033507,1033595,88,10,N,N,-,-1,-1
MULIFE.txt,1033514,1033601,87,10,N,N,-,-1,-1
MULIFE.txt,1033520,1033624,104,10,N,N,-,-1,-1
MULIFE.txt,1033539,1033667,128,10,N,N,-,-1,-1
MULIFE.txt,1033543,1033722,179,10,N,N,-,-1,-1
MULIFE.txt,1033548,1033729,181,10,N,N,-,-1,-1
MULIFE.txt,1033554,1033777,223,10,N,N,-,-1,-1
MULIFE.txt,1033559,1033841,282,10,N,N,-,-1,-1
MULIFE.txt,1033581,1033852,271,10,N,N,-,-1,-1
MULIFE.txt,1033585,1033859,274,10,N,N,-,-1,-1
MULIFE.txt,1033595,1033863,268,10,N,N,-,-1,-1
MULIFE.txt,1033604,1033898,294,10,N,N,-,-1,-1
MULIFE.txt,1033627,1033929,302,10,N,N,-,-1,-1
MULIFE.txt,1033668,1034006,338,10,N,N,-,-1,-1
MULIFE.txt,1033723,1034041,318,10,N,N,-,-1,-1
MULIFE.txt,1033732,1034098,366,10,N,N,-,-1,-1
MULIFE.txt,1033778,1034105,327,10,N,N,-,-1,-1
MULIFE.txt,1033842,1034109,267,10,N,N,-,-1,-1
MULIFE.txt,1033853,1034154,301,10,N,N,-,-1,-1
MULIFE.txt,1033860,1034229,369,10,N,N,-,-1,-1
MULIFE.txt,1033868,1034233,365,10,N,N,-,-1,-1
MULIFE.txt,1033901,1034238,337,10,N,N,-,-1,-1
MULIFE.txt,1033931,1034244,313,10,N,N,-,-1,-1
MULIFE.txt,1034009,1034247,238,10,N,N,-,-1,-1
MULIFE.txt,1034044,1034283,239,10,N,N,-,-1,-1
MULIFE.txt,1034099,1034307,208,10,N,N,-,-1,-1
MULIFE.txt,1034106,1034342,236,10,N,N,-,-1,-1
MULIFE.txt,1034112,1034368,256,10,N,N,-,-1,-1
MULIFE.txt,1034155,1034373,218,10,N,N,-,-1,-1
MULIFE.txt,1034230,1034375,145,10,N,N,-,-1,-1
MULIFE.txt,1034234,1034379,145,10,N,N,-,-1,-1
MULIFE.txt,1034239,1034383,144,10,N,N,-,-1,-1
MULIFE.txt,1034244,1034416,172,10,N,N,-,-1,-1
MULIFE.txt,1034252,1034450,198,10,N,N,-,-1,-1
MULIFE.txt,1034286,1034456,170,10,N,N,-,-1,-1
MULIFE.txt,1034312,1034479,167,10,N,N,-,-1,-1
MULIFE.txt,1034344,1034515,171,10,N,N,-,-1,-1
MULIFE.txt,1034369,1034520,151,10,N,N,-,-1,-1
MULIFE.txt,1034374,1034521,147,10,N,N,-,-1,-1
MULIFE.txt,1034376,1034522,146,10,N,N,-,-1,-1
MULIFE.txt,1034380,1034531,151,10,N,N,-,-1,-1
MULIFE.txt,1034386,1034575,189,10,N,N,-,-1,-1
MULIFE.txt,1034417,1034625,208,10,N,N,-,-1,-1
MULIFE.txt,1034451,1034661,210,10,N,N,-,-1,-1
MULIFE.txt,1034459,1034667,208,10,N,N,-,-1,-1
MULIFE.txt,1034480,1034689,209,10,N,N,-,-1,-1
MULIFE.txt,1034516,1034731,215,10,N,N,-,-1,-1
MULIFE.txt,1034520,1034735,215,10,N,N,-,-1,-1
MULIFE.txt,1034521,1034749,228,10,N,N,-,-1,-1
MULIFE.txt,1034525,1034784,259,10,N,N,-,-1,-1
MULIFE.txt,1034532,1034790,258,10,N,N,-,-1,-1
MULIFE.txt,1034580,1034794,214,10,N,N,-,-1,-1
MULIFE.txt,1034626,1034849,223,10,N,N,-,-1,-1
MULIFE.txt,1034662,1034918,256,10,N,N,-,-1,-1
MULIFE.txt,1034672,1034955,283,10,N,N,-,-1,-1
MULIFE.txt,1034690,1034964,274,10,N,N,-,-1,-1
MULIFE.txt,1034732,1034965,233,10,N,N,-,-1,-1
MULIFE.txt,1034738,1034966,228,10,N,N,-,-1,-1
MULIFE.txt,1034750,1034970,220,10,N,N,-,-1,-1
MULIFE.txt,1034785,1034982,197,10,N,N,-,-1,-1
MULIFE.txt,1034791,1035006,215,10,N,N,-,-1,-1
MULIFE.txt,1034799,1035051,252,10,N,N,-,-1,-1
MULIFE.txt,1034850,1035067,217,10,N,N,-,-1,-1
MULIFE.txt,1034919,1035079,160,10,N,N,-,-1,-1
MULIFE.txt,1034956,1035154,198,10,N,N,-,-1,-1
MULIFE.txt,1034964,1035171,207,10,N,N,-,-1,-1
MULIFE.txt,1034965,1035177,212,10,N,N,-,-1,-1
MULIFE.txt,1034967,1035188,221,10,N,N,-,-1,-1
MULIFE.txt,1034975,1035210,235,10,N,N,-,-1,-1
MULIFE.txt,1034983,1035311,328,10,N,N,-,-1,-1
MULIFE.txt,1035008,1035319,311,10,N,N,-,-1,-1
MULIFE.txt,1035052,1035331,279,10,N,N,-,-1,-1
MULIFE.txt,1035072,1035338,266,10,N,N,-,-1,-1
MULIFE.txt,1035080,1035390,310,10,N,N,-,-1,-1
MULIFE.txt,1035155,1035416,261,10,N,N,-,-1,-1
MULIFE.txt,1035172,1035457,285,10,N,N,-,-1,-1
MULIFE.txt,1035179,1035566,387,10,N,N,-,-1,-1
MULIFE.txt,1035193,1035618,425,10,N,N,-,-1,-1
MULIFE.txt,1035212,1035630,418,10,N,N,-,-1,-1
MULIFE.txt,1035312,1035638,326,10,N,N,-,-1,-1
MULIFE.txt,1035321,1035642,321,10,N,N,-,-1,-1
MULIFE.txt,1035332,1035653,321,10,N,N,-,-1,-1
MULIFE.txt,1035341,1035672,331,10,N,N,-,-1,-1
MULIFE.txt,1035391,1035693,302,10,N,N,-,-1,-1
MULIFE.txt,1035417,1035699,282,10,N,N,-,-1,-1
MULIFE.txt,1035458,1035709,251,10,N,N,-,-1,-1
MULIFE.txt,1035567,1035764,197,10,N,N,-,-1,-1
MULIFE.txt,1035619,1035801,182,10,N,N,-,-1,-1
MULIFE.txt,1035631,1035813,182,10,N,N,-,-1,-1
MULIFE.txt,1035639,1035851,212,10,N,N,-,-1,-1
MULIFE.txt,1035645,1035878,233,10,N,N,-,-1,-1
MULIFE.txt,1035654,1035897,243,10,N,N,-,-1,-1
MULIFE.txt,1035673,1035912,239,10,N,N,-,-1,-1
MULIFE.txt,1035694,1035916,222,10,N,N,-,-1,-1
MULIFE.txt,1035700,1035927,227,10,N,N,-,-1,-1
MULIFE.txt,1035714,1035945,231,10,N,N,-,-1,-1
MULIFE.txt,1035769,1035965,196,10,N,N,-,-1,-1
MULIFE.txt,1035806,1035969,163,10,N,N,-,-1,-1
MULIFE.txt,1035814,1035974,160,10,N,N,-,-1,-1
MULIFE.txt,1035852,1035983,131,10,N,N,-,-1,-1
MULIFE.txt,1035879,1035994,115,10,N,N,-,-1,-1
MULIFE.txt,1035898,1036035,137,10,N,N,-,-1,-1
MULIFE.txt,1035913,1036052,139,10,N,N,-,-1,-1
MULIFE.txt,1035919,1036065,146,10,N,N,-,-1,-1
MULIFE.txt,1035928,1036128,200,10,N,N,-,-1,-1
MULIFE.txt,1035946,1036134,188,10,N,N,-,-1,-1
MULIFE.txt,1035966,1036146,180,10,N,N,-,-1,-1
MULIFE.txt,1035970,1036252,282,10,N,N,-,-1,-1
MULIFE.txt,1035975,1036316,341,10,N,N,-,-1,-1
MULIFE.txt,1035986,1036333,347,10,N,N,-,-1,-1
MULIFE.txt,1035995,1036342,347,10,N,N,-,-1,-1
MULIFE.txt,1036036,1036374,338,10,N,N,-,-1,-1
MULIFE.txt,1036054,1036407,353,10,N,N,-,-1,-1
MULIFE.txt,1036066,1036413,347,10,N,N,-,-1,-1
MULIFE.txt,1036129,1036417,288,10,N,N,-,-1,-1
MULIFE.txt,1036137,1036454,317,10,N,N,-,-1,-1
MULIFE.txt,1036147,1036464,317,10,N,N,-,-1,-1
MULIFE.txt,1036253,1036487,234,10,N,N,-,-1,-1
MULIFE.txt,1036317,1036516,199,10,N,N,-,-1,-1
MULIFE.txt,1036336,1036528,192,10,N,N,-,-1,-1
MULIFE.txt,1036343,1036534,191,10,N,N,-,-1,-1
MULIFE.txt,1036375,1036544,169,10,N,N,-,-1,-1
MULIFE.txt,1036408,1036576,168,10,N,N,-,-1,-1
MULIFE.txt,1036414,1036612,198,10,N,N,-,-1,-1
MULIFE.txt,1036418,1036618,200,10,N,N,-,-1,-1
MULIFE.txt,1036457,1036629,172,10,N,N,-,-1,-1
MULIFE.txt,1036465,1036633,168,10,N,N,-,-1,-1
MULIFE.txt,1036489,1036660,171,10,N,N,-,-1,-1
MULIFE.txt,1036518,1036686,168,10,N,N,-,-1,-1
MULIFE.txt,1036529,1036705,176,10,N,N,-,-1,-1
MULIFE.txt,1036537,1036734,197,10,N,N,-,-1,-1
MULIFE.txt,1036545,1036743,198,10,N,N,-,-1,-1
MULIFE.txt,1036577,1036754,177,10,N,N,-,-1,-1
MULIFE.txt,1036613,1036763,150,10,N,N,-,-1,-1
MULIFE.txt,1036619,1036769,150,10,N,N,-,-1,-1
MULIFE.txt,1036630,1036783,153,10,N,N,-,-1,-1
MULIFE.txt,1036636,1036798,162,10,N,N,-,-1,-1
MULIFE.txt,1036662,1036825,163,10,N,N,-,-1,-1
MULIFE.txt,1036687,1036837,150,10,N,N,-,-1,-1
MULIFE.txt,1036708,1036844,136,10,N,N,-,-1,-1
MULIFE.txt,1036735,1036848,113,10,N,N,-,-1,-1
MULIFE.txt,1036744,1036889,145,10,N,N,-,-1,-1
MULIFE.txt,1036755,1036894,139,10,N,N,-,-1,-1
MULIFE.txt,1036764,1036908,144,10,N,N,-,-1,-1
MULIFE.txt,1036772,1036913,141,10,N,N,-,-1,-1
MULIFE.txt,1036784,1036917,133,10,N,N,-,-1,-1
MULIFE.txt,1036801,1036922,121,10,N,N,-,-1,-1
MULIFE.txt,1036826,1036956,130,10,N,N,-,-1,-1
MULIFE.txt,1036838,1036979,141,10,N,N,-,-1,-1
MULIFE.txt,1036845,1036984,139,10,N,N,-,-1,-1
MULIFE.txt,1036851,1037001,150,10,N,N,-,-1,-1
MULIFE.txt,1036890,1037026,136,10,N,N,-,-1,-1
MULIFE.txt,1036895,1037035,140,10,N,N,-,-1,-1
MULIFE.txt,1036909,1037040,131,10,N,N,-,-1,-1
MULIFE.txt,1036914,1037045,131,10,N,N,-,-1,-1
MULIFE.txt,1036918,1037064,146,10,N,N,-,-1,-1
MULIFE.txt,1036927,1037069,142,10,N,N,-,-1,-1
MULIFE.txt,1036958,1037075,117,10,N,N,-,-1,-1
MULIFE.txt,1036980,1037079,99,10,N,N,-,-1,-1
MULIFE.txt,1036985,1037094,109,10,N,N,-,-1,-1
MULIFE.txt,1037002,1037099,97,10,N,N,-,-1,-1
MULIFE.txt,1037028,1037106,78,10,N,N,-,-1,-1
MULIFE.txt,1037036,1037125,89,10,N,N,-,-1,-1
MULIFE.txt,1037041,1037147,106,10,N,N,-,-1,-1
MULIFE.txt,1037046,1037166,120,10,N,N,-,-1,-1
MULIFE.txt,1037065,1037177,112,10,N,N,-,-1,-1
MULIFE.txt,1037071,1037184,113,10,N,N,-,-1,-1
MULIFE.txt,1037076,1037202,126,10,N,N,-,-1,-1
MULIFE.txt,1037080,1037210,130,10,N,N,-,-1,-1
MULIFE.txt,1037095,1037215,120,10,N,N,-,-1,-1
MULIFE.txt,1037101,1037222,121,10,N,N,-,-1,-1
MULIFE.txt,1037107,1037232,125,10,N,N,-,-1,-1
MULIFE.txt,1037126,1037267,141,10,N,N,-,-1,-1
MULIFE.txt,1037150,1037318,168,10,N,N,-,-1,-1
MULIFE.txt,1037167,1037322,155,10,N,N,-,-1,-1
MULIFE.txt,1037178,1037333,155,10,N,N,-,-1,-1
MULIFE.txt,1037186,1037337,151,10,N,N,-,-1,-1
MULIFE.txt,1037203,1037349,146,10,N,N,-,-1,-1
MULIFE.txt,1037211,1037410,199,10,N,N,-,-1,-1
MULIFE.txt,1037216,1037450,234,10,N,N,-,-1,-1
MULIFE.txt,1037224,1037506,282,10,N,N,-,-1,-1
MULIFE.txt,1037233,1037529,296,10,N,N,-,-1,-1
MULIFE.txt,1037268,1037541,273,10,N,N,-,-1,-1
MULIFE.txt,1037319,1037547,228,10,N,N,-,-1,-1
MULIFE.txt,1037324,1037551,227,10,N,N,-,-1,-1
MULIFE.txt,1037334,1037560,226,10,N,N,-,-1,-1
MULIFE.txt,1037340,1037579,239,10,N,N,-,-1,-1
MULIFE.txt,1037350,1037623,273,10,N,N,-,-1,-1
MULIFE.txt,1037412,1037630,218,10,N,N,-,-1,-1
MULIFE.txt,1037450,1037656,206,10,N,N,-,-1,-1
MULIFE.txt,1037507,1037662,155,10,N,N,-,-1,-1
MULIFE.txt,1037531,1037666,135,10,N,N,-,-1,-1
MULIFE.txt,1037542,1037676,134,10,N,N,-,-1,-1
MULIFE.txt,1037548,1037750,202,10,N,N,-,-1,-1
MULIFE.txt,1037554,1037770,216,10,N,N,-,-1,-1
MULIFE.txt,1037561,1037830,269,10,N,N,-,-1,-1
MULIFE.txt,1037580,1037837,257,10,N,N,-,-1,-1
MULIFE.txt,1037625,1037841,216,10,N,N,-,-1,-1
MULIFE.txt,1037631,1037871,240,10,N,N,-,-1,-1
MULIFE.txt,1037657,1037903,246,10,N,N,-,-1,-1
MULIFE.txt,1037663,1037952,289,10,N,N,-,-1,-1
MULIFE.txt,1037668,1037957,289,10,N,N,-,-1,-1
MULIFE.txt,1037677,1037965,288,10,N,N,-,-1,-1
MULIFE.txt,1037751,1038017,266,10,N,N,-,-1,-1
MULIFE.txt,1037771,1038025,254,10,N,N,-,-1,-1
MULIFE.txt,1037831,1038030,199,10,N,N,-,-1,-1
MULIFE.txt,1037838,1038036,198,10,N,N,-,-1,-1
MULIFE.txt,1037844,1038037,193,10,N,N,-,-1,-1
MULIFE.txt,1037873,1038038,165,10,N,N,-,-1,-1
MULIFE.txt,1037905,1038043,138,10,N,N,-,-1,-1
MULIFE.txt,1037953,1038084,131,10,N,N,-,-1,-1
MULIFE.txt,1037958,1038089,131,10,N,N,-,-1,-1
MULIFE.txt,1037967,1038095,128,10,N,N,-,-1,-1
MULIFE.txt,1038018,1038099,81,10,N,N,-,-1,-1
MULIFE.txt,1038026,1038108,82,10,N,N,-,-1,-1
MULIFE.txt,1038031,1038141,110,10,N,N,-,-1,-1
MULIFE.txt,1038036,1038189,153,10,N,N,-,-1,-1
MULIFE.txt,1038037,1038204,167,10,N,N,-,-1,-1
MULIFE.txt,1038039,1038219,180,10,N,N,-,-1,-1
MULIFE.txt,1038045,1038247,202,10,N,N,-,-1,-1
MULIFE.txt,1038085,1038258,173,10,N,N,-,-1,-1
MULIFE.txt,1038090,1038264,174,10,N,N,-,-1,-1
MULIFE.txt,1038096,1038315,219,10,N,N,-,-1,-1
MULIFE.txt,1038101,1038330,229,10,N,N,-,-1,-1
MULIFE.txt,1038109,1038391,282,10,N,N,-,-1,-1
MULIFE.txt,1038142,1038417,275,10,N,N,-,-1,-1
MULIFE.txt,1038190,1038428,238,10,N,N,-,-1,-1
MULIFE.txt,1038206,1038434,228,10,N,N,-,-1,-1
MULIFE.txt,1038220,1038439,219,10,N,N,-,-1,-1
MULIFE.txt,1038248,1038530,282,10,N,N,-,-1,-1
MULIFE.txt,1038259,1038553,294,10,N,N,-,-1,-1
MULIFE.txt,1038269,1038558,289,10,N,N,-,-1,-1
MULIFE.txt,1038316,1038568,252,10,N,N,-,-1,-1
MULIFE.txt,1038335,1038572,237,10,N,N,-,-1,-1
MULIFE.txt,1038392,1038629,237,10,N,N,-,-1,-1
MULIFE.txt,1038418,1038655,237,10,N,N,-,-1,-1
MULIFE.txt,1038429,1038666,237,10,N,N,-,-1,-1
MULIFE.txt,1038435,1038676,241,10,N,N,-,-1,-1
MULIFE.txt,1038442,1038706,264,10,N,N,-,-1,-1
MULIFE.txt,1038531,1038715,184,10,N,N,-,-1,-1
MULIFE.txt,1038554,1038732,178,10,N,N,-,-1,-1
MULIFE.txt,1038559,1038788,229,10,N,N,-,-1,-1
MULIFE.txt,1038569,1038799,230,10,N,N,-,-1,-1
MULIFE.txt,1038577,1038851,274,10,N,N,-,-1,-1
MULIFE.txt,1038630,1038908,278,10,N,N,-,-1,-1
MULIFE.txt,1038656,1038967,311,10,N,N,-,-1,-1
MULIFE.txt,1038667,1039013,346,10,N,N,-,-1,-1
MULIFE.txt,1038679,1039062,383,10,N,N,-,-1,-1
MULIFE.txt,1038707,1039099,392,10,N,N,-,-1,-1
MULIFE.txt,1038716,1039104,388,10,N,N,-,-1,-1
MULIFE.txt,1038735,1039111,376,10,N,N,-,-1,-1
MULIFE.txt,1038789,1039136,347,10,N,N,-,-1,-1
MULIFE.txt,1038804,1039255,451,10,N,N,-,-1,-1
MULIFE.txt,1038852,1039265,413,10,N,N,-,-1,-1
MULIFE.txt,1038909,1039287,378,10,N,N,-,-1,-1
MULIFE.txt,1038972,1039336,364,10,N,N,-,-1,-1
MULIFE.txt,1039014,1039347,333,10,N,N,-,-1,-1
MULIFE.txt,1039063,1039354,291,10,N,N,-,-1,-1
MULIFE.txt,1039100,1039359,259,10,N,N,-,-1,-1
MULIFE.txt,1039105,1039372,267,10,N,N,-,-1,-1
MULIFE.txt,1039114,1039424,310,10,N,N,-,-1,-1
MULIFE.txt,1039139,1039477,338,10,N,N,-,-1,-1
MULIFE.txt,1039258,1039481,223,10,N,N,-,-1,-1
MULIFE.txt,1039266,1039486,220,10,N,N,-,-1,-1
MULIFE.txt,1039289,1039493,204,10,N,N,-,-1,-1
MULIFE.txt,1039337,1039497,160,10,N,N,-,-1,-1
MULIFE.txt,1039348,1039509,161,10,N,N,-,-1,-1
MULIFE.txt,1039355,1039579,224,10,N,N,-,-1,-1
MULIFE.txt,1039364,1039590,226,10,N,N,-,-1,-1
MULIFE.txt,1039373,1039596,223,10,N,N,-,-1,-1
MULIFE.txt,1039425,1039629,204,10,N,N,-,-1,-1
MULIFE.txt,1039478,1039641,163,10,N,N,-,-1,-1
MULIFE.txt,1039482,1039647,165,10,N,N,-,-1,-1
MULIFE.txt,1039487,1039657,170,10,N,N,-,-1,-1
MULIFE.txt,1039494,1039719,225,10,N,N,-,-1,-1
MULIFE.txt,1039500,1039728,228,10,N,N,-,-1,-1
MULIFE.txt,1039510,1039739,229,10,N,N,-,-1,-1
MULIFE.txt,1039580,1039745,165,10,N,N,-,-1,-1
MULIFE.txt,1039591,1039799,208,10,N,N,-,-1,-1
MULIFE.txt,1039599,1039810,211,10,N,N,-,-1,-1
MULIFE.txt,1039631,1039836,205,10,N,N,-,-1,-1
MULIFE.txt,1039642,1039908,266,10,N,N,-,-1,-1
MULIFE.txt,1039650,1039959,309,10,N,N,-,-1,-1
MULIFE.txt,1039658,1040038,380,10,N,N,-,-1,-1
MULIFE.txt,1039720,1040083,363,10,N,N,-,-1,-1
MULIFE.txt,1039729,1040089,360,10,N,N,-,-1,-1
MULIFE.txt,1039740,1040090,350,10,N,N,-,-1,-1
MULIFE.txt,1039750,1040094,344,10,N,N,-,-1,-1
MULIFE.txt,1039800,1040098,298,10,N,N,-,-1,-1
MULIFE.txt,1039811,1040108,297,10,N,N,-,-1,-1
MULIFE.txt,1039837,1040109,272,10,N,N,-,-1,-1
MULIFE.txt,1039909,1040110,201,10,N,N,-,-1,-1
MULIFE.txt,1039960,1040122,162,10,N,N,-,-1,-1
MULIFE.txt,1040039,1040147,108,10,N,N,-,-1,-1
MULIFE.txt,1040085,1040166,81,10,N,N,-,-1,-1
MULIFE.txt,1040089,1040172,83,10,N,N,-,-1,-1
MULIFE.txt,1040091,1040186,95,10,N,N,-,-1,-1
MULIFE.txt,1040095,1040192,97,10,N,N,-,-1,-1
MULIFE.txt,1040099,1040204,105,10,N,N,-,-1,-1
MULIFE.txt,1040108,1040209,101,10,N,N,-,-1,-1
MULIFE.txt,1040109,1040219,110,10,N,N,-,-1,-1
MULIFE.txt,1040115,1040224,109,10,N,N,-,-1,-1
MULIFE.txt,1040123,1040234,111,10,N,N,-,-1,-1
MULIFE.txt,1040149,1040239,90,10,N,N,-,-1,-1
MULIFE.txt,1040167,1040243,76,10,N,N,-,-1,-1
MULIFE.txt,1040173,1040244,71,10,N,N,-,-1,-1
MULIFE.txt,1040188,1040250,62,10,N,N,-,-1,-1
MULIFE.txt,1040193,1040258,65,10,N,N,-,-1,-1
MULIFE.txt,1040205,1040290,85,10,N,N,-,-1,-1
MULIFE.txt,1040210,1040349,139,10,N,N,-,-1,-1
MULIFE.txt,1040220,1040354,134,10,N,N,-,-1,-1
MULIFE.txt,1040226,1040361,135,10,N,N,-,-1,-1
MULIFE.txt,1040235,1040366,131,10,N,N,-,-1,-1
MULIFE.txt,1040240,1040378,138,10,N,N,-,-1,-1
MULIFE.txt,1040243,1040399,156,10,N,N,-,-1,-1
MULIFE.txt,1040245,1040438,193,10,N,N,-,-1,-1
MULIFE.txt,1040253,1040463,210,10,N,N,-,-1,-1
MULIFE.txt,1040259,1040500,241,10,N,N,-,-1,-1
MULIFE.txt,1040291,1040517,226,10,N,N,-,-1,-1
MULIFE.txt,1040350,1040558,208,10,N,N,-,-1,-1
MULIFE.txt,1040355,1040567,212,10,N,N,-,-1,-1
MULIFE.txt,1040362,1040589,227,10,N,N,-,-1,-1
MULIFE.txt,1040369,1040671,302,10,N,N,-,-1,-1
MULIFE.txt,1040379,1040718,339,10,N,N,-,-1,-1
MULIFE.txt,1040400,1040734,334,10,N,N,-,-1,-1
MULIFE.txt,1040439,1040738,299,10,N,N,-,-1,-1
MULIFE.txt,1040464,1040762,298,10,N,N,-,-1,-1
MULIFE.txt,1040501,1040788,287,10,N,N,-,-1,-1
MULIFE.txt,1040518,1040807,289,10,N,N,-,-1,-1
MULIFE.txt,1040561,1040823,262,10,N,N,-,-1,-1
MULIFE.txt,1040570,1040824,254,10,N,N,-,-1,-1
MULIFE.txt,1040590,1040825,235,10,N,N,-,-1,-1
MULIFE.txt,1040673,1040837,164,10,N,N,-,-1,-1
MULIFE.txt,1040719,1040888,169,10,N,N,-,-1,-1
MULIFE.txt,1040735,1040925,190,10,N,N,-,-1,-1
MULIFE.txt,1040741,1040968,227,10,N,N,-,-1,-1
MULIFE.txt,1040763,1040973,210,10,N,N,-,-1,-1
MULIFE.txt,1040789,1040988,199,10,N,N,-,-1,-1
MULIFE.txt,1040809,1041007,198,10,N,N,-,-1,-1
MULIFE.txt,1040823,1041042,219,10,N,N,-,-1,-1
MULIFE.txt,1040824,1041060,236,10,N,N,-,-1,-1
MULIFE.txt,1040830,1041070,240,10,N,N,-,-1,-1
MULIFE.txt,1040838,1041086,248,10,N,N,-,-1,-1
MULIFE.txt,1040889,1041151,262,10,N,N,-,-1,-1
MULIFE.txt,1040926,1041169,243,10,N,N,-,-1,-1
MULIFE.txt,1040969,1041173,204,10,N,N,-,-1,-1
MULIFE.txt,1040978,1041195,217,10,N,N,-,-1,-1
MULIFE.txt,1040989,1041248,259,10,N,N,-,-1,-1
MULIFE.txt,1041008,1041320,312,10,N,N,-,-1,-1
MULIFE.txt,1041044,1041326,282,10,N,N,-,-1,-1
MULIFE.txt,1041061,1041330,269,10,N,N,-,-1,-1
MULIFE.txt,1041073,1041348,275,10,N,N,-,-1,-1
MULIFE.txt,1041087,1041445,358,10,N,N,-,-1,-1
MULIFE.txt,1041152,1041475,323,10,N,N,-,-1,-1
MULIFE.txt,1041170,1041498,328,10,N,N,-,-1,-1
MULIFE.txt,1041174,1041502,328,10,N,N,-,-1,-1
MULIFE.txt,1041196,1041508,312,10,N,N,-,-1,-1
MULIFE.txt,1041250,1041517,267,10,N,N,-,-1,-1
MULIFE.txt,1041321,1041593,272,10,N,N,-,-1,-1
MULIFE.txt,1041327,1041622,295,10,N,N,-,-1,-1
MULIFE.txt,1041333,1041646,313,10,N,N,-,-1,-1
MULIFE.txt,1041349,1041657,308,10,N,N,-,-1,-1
MULIFE.txt,1041446,1041664,218,10,N,N,-,-1,-1
MULIFE.txt,1041476,1041668,192,10,N,N,-,-1,-1
MULIFE.txt,1041499,1041678,179,10,N,N,-,-1,-1
MULIFE.txt,1041504,1041822,318,10,N,N,-,-1,-1
MULIFE.txt,1041509,1041841,332,10,N,N,-,-1,-1
MULIFE.txt,1041520,1041903,383,10,N,N,-,-1,-1
MULIFE.txt,1041595,1041909,314,10,N,N,-,-1,-1
MULIFE.txt,1041623,1041915,292,10,N,N,-,-1,-1
MULIFE.txt,1041647,1041919,272,10,N,N,-,-1,-1
MULIFE.txt,1041658,1041973,315,10,N,N,-,-1,-1
MULIFE.txt,1041665,1042028,363,10,N,N,-,-1,-1
MULIFE.txt,1041671,1042036,365,10,N,N,-,-1,-1
MULIFE.txt,1041679,1042056,377,10,N,N,-,-1,-1
MULIFE.txt,1041823,1042067,244,10,N,N,-,-1,-1
MULIFE.txt,1041842,1042081,239,10,N,N,-,-1,-1
MULIFE.txt,1041905,1042092,187,10,N,N,-,-1,-1
MULIFE.txt,1041910,1042098,188,10,N,N,-,-1,-1
MULIFE.txt,1041916,1042105,189,10,N,N,-,-1,-1
MULIFE.txt,1041924,1042120,196,10,N,N,-,-1,-1
MULIFE.txt,1041978,1042144,166,10,N,N,-,-1,-1
MULIFE.txt,1042031,1042174,143,10,N,N,-,-1,-1
MULIFE.txt,1042037,1042197,160,10,N,N,-,-1,-1
MULIFE.txt,1042057,1042202,145,10,N,N,-,-1,-1
MULIFE.txt,1042069,1042209,140,10,N,N,-,-1,-1
MULIFE.txt,1042082,1042220,138,10,N,N,-,-1,-1
MULIFE.txt,1042093,1042263,170,10,N,N,-,-1,-1
MULIFE.txt,1042099,1042284,185,10,N,N,-,-1,-1
MULIFE.txt,1042106,1042351,245,10,N,N,-,-1,-1
MULIFE.txt,1042121,1042357,236,10,N,N,-,-1,-1
MULIFE.txt,1042146,1042364,218,10,N,N,-,-1,-1
MULIFE.txt,1042175,1042372,197,10,N,N,-,-1,-1
MULIFE.txt,1042198,1042456,258,10,N,N,-,-1,-1
MULIFE.txt,1042203,1042473,270,10,N,N,-,-1,-1
MULIFE.txt,1042212,1042478,266,10,N,N,-,-1,-1
MULIFE.txt,1042221,1042491,270,10,N,N,-,-1,-1
MULIFE.txt,1042264,1042523,259,10,N,N,-,-1,-1
MULIFE.txt,1042285,1042586,301,10,N,N,-,-1,-1
MULIFE.txt,1042353,1042590,237,10,N,N,-,-1,-1
MULIFE.txt,1042358,1042601,243,10,N,N,-,-1,-1
MULIFE.txt,1042367,1042621,254,10,N,N,-,-1,-1
MULIFE.txt,1042373,1042674,301,10,N,N,-,-1,-1
MULIFE.txt,1042457,1042685,228,10,N,N,-,-1,-1
MULIFE.txt,1042474,1042690,216,10,N,N,-,-1,-1
MULIFE.txt,1042481,1042691,210,10,N,N,-,-1,-1
MULIFE.txt,1042492,1042692,200,10,N,N,-,-1,-1
MULIFE.txt,1042524,1042715,191,10,N,N,-,-1,-1
MULIFE.txt,1042587,1042768,181,10,N,N,-,-1,-1
MULIFE.txt,1042592,1042779,187,10,N,N,-,-1,-1
MULIFE.txt,1042602,1042785,183,10,N,N,-,-1,-1
MULIFE.txt,1042622,1042810,188,10,N,N,-,-1,-1
MULIFE.txt,1042675,1042836,161,10,N,N,-,-1,-1
MULIFE.txt,1042686,1042855,169,10,N,N,-,-1,-1
MULIFE.txt,1042690,1042867,177,10,N,N,-,-1,-1
MULIFE.txt,1042691,1042873,182,10,N,N,-,-1,-1
MULIFE.txt,1042695,1042942,247,10,N,N,-,-1,-1
MULIFE.txt,1042716,1042963,247,10,N,N,-,-1,-1
MULIFE.txt,1042769,1042974,205,10,N,N,-,-1,-1
MULIFE.txt,1042780,1042980,200,10,N,N,-,-1,-1
MULIFE.txt,1042788,1042985,197,10,N,N,-,-1,-1
MULIFE.txt,1042811,1043011,200,10,N,N,-,-1,-1
MULIFE.txt,1042837,1043061,224,10,N,N,-,-1,-1
MULIFE.txt,1042857,1043077,220,10,N,N,-,-1,-1
MULIFE.txt,1042868,1043088,220,10,N,N,-,-1,-1
MULIFE.txt,1042876,1043110,234,10,N,N,-,-1,-1
MULIFE.txt,1042943,1043126,183,10,N,N,-,-1,-1
MULIFE.txt,1042964,1043166,202,10,N,N,-,-1,-1
MULIFE.txt,1042975,1043251,276,10,N,N,-,-1,-1
MULIFE.txt,1042981,1043262,281,10,N,N,-,-1,-1
MULIFE.txt,1042990,1043275,285,10,N,N,-,-1,-1
MULIFE.txt,1043012,1043309,297,10,N,N,-,-1,-1
MULIFE.txt,1043064,1043351,287,10,N,N,-,-1,-1
MULIFE.txt,1043078,1043376,298,10,N,N,-,-1,-1
MULIFE.txt,1043089,1043391,302,10,N,N,-,-1,-1
MULIFE.txt,1043111,1043407,296,10,N,N,-,-1,-1
MULIFE.txt,1043129,1043417,288,10,N,N,-,-1,-1
MULIFE.txt,1043167,1043427,260,10,N,N,-,-1,-1
MULIFE.txt,1043252,1043453,201,10,N,N,-,-1,-1
MULIFE.txt,1043267,1043481,214,10,N,N,-,-1,-1
MULIFE.txt,1043276,1043513,237,10,N,N,-,-1,-1
MULIFE.txt,1043310,1043518,208,10,N,N,-,-1,-1
MULIFE.txt,1043352,1043532,180,10,N,N,-,-1,-1
MULIFE.txt,1043377,1043544,167,10,N,N,-,-1,-1
MULIFE.txt,1043393,1043584,191,10,N,N,-,-1,-1
MULIFE.txt,1043408,1043606,198,10,N,N,-,-1,-1
MULIFE.txt,1043418,1043642,224,10,N,N,-,-1,-1
MULIFE.txt,1043432,1043647,215,10,N,N,-,-1,-1
MULIFE.txt,1043456,1043657,201,10,N,N,-,-1,-1
MULIFE.txt,1043484,1043672,188,10,N,N,-,-1,-1
MULIFE.txt,1043514,1043709,195,10,N,N,-,-1,-1
MULIFE.txt,1043523,1043714,191,10,N,N,-,-1,-1
MULIFE.txt,1043534,1043724,190,10,N,N,-,-1,-1
MULIFE.txt,1043545,1043743,198,10,N,N,-,-1,-1
MULIFE.txt,1043585,1043748,163,10,N,N,-,-1,-1
MULIFE.txt,1043607,1043753,146,10,N,N,-,-1,-1
MULIFE.txt,1043643,1043759,116,10,N,N,-,-1,-1
MULIFE.txt,1043648,1043790,142,10,N,N,-,-1,-1
MULIFE.txt,1043659,1043797,138,10,N,N,-,-1,-1
MULIFE.txt,1043673,1043808,135,10,N,N,-,-1,-1
MULIFE.txt,1043710,1043813,103,10,N,N,-,-1,-1
MULIFE.txt,1043715,1043841,126,10,N,N,-,-1,-1
MULIFE.txt,1043726,1043846,120,10,N,N,-,-1,-1
MULIFE.txt,1043744,1043858,114,10,N,N,-,-1,-1
MULIFE.txt,1043749,1043862,113,10,N,N,-,-1,-1
MULIFE.txt,1043754,1043905,151,10,N,N,-,-1,-1
MULIFE.txt,1043761,1043910,149,10,N,N,-,-1,-1
MULIFE.txt,1043793,1043920,127,10,N,N,-,-1,-1
MULIFE.txt,1043798,1043950,152,10,N,N,-,-1,-1
MULIFE.txt,1043809,1043954,145,10,N,N,-,-1,-1
MULIFE.txt,1043815,1043966,151,10,N,N,-,-1,-1
MULIFE.txt,1043842,1043971,129,10,N,N,-,-1,-1
MULIFE.txt,1043849,1043984,135,10,N,N,-,-1,-1
MULIFE.txt,1043859,1044028,169,10,N,N,-,-1,-1
MULIFE.txt,1043864,1044033,169,10,N,N,-,-1,-1
MULIFE.txt,1043906,1044044,138,10,N,N,-,-1,-1
MULIFE.txt,1043911,1044056,145,10,N,N,-,-1,-1
MULIFE.txt,1043922,1044110,188,10,N,N,-,-1,-1
MULIFE.txt,1043951,1044132,181,10,N,N,-,-1,-1
MULIFE.txt,1043957,1044176,219,10,N,N,-,-1,-1
MULIFE.txt,1043967,1044193,226,10,N,N,-,-1,-1
MULIFE.txt,1043974,1044206,232,10,N,N,-,-1,-1
MULIFE.txt,1043985,1044230,245,10,N,N,-,-1,-1
MULIFE.txt,1044029,1044323,294,10,N,N,-,-1,-1
MULIFE.txt,1044035,1044334,299,10,N,N,-,-1,-1
MULIFE.txt,1044049,1044340,291,10,N,N,-,-1,-1
MULIFE.txt,1044057,1044360,303,10,N,N,-,-1,-1
MULIFE.txt,1044111,1044443,332,10,N,N,-,-1,-1
MULIFE.txt,1044133,1044459,326,10,N,N,-,-1,-1
MULIFE.txt,1044177,1044501,324,10,N,N,-,-1,-1
MULIFE.txt,1044198,1044541,343,10,N,N,-,-1,-1
MULIFE.txt,1044207,1044552,345,10,N,N,-,-1,-1
MULIFE.txt,1044232,1044557,325,10,N,N,-,-1,-1
MULIFE.txt,1044324,1044560,236,10,N,N,-,-1,-1
MULIFE.txt,1044335,1044565,230,10,N,N,-,-1,-1
MULIFE.txt,1044343,1044578,235,10,N,N,-,-1,-1
MULIFE.txt,1044363,1044595,232,10,N,N,-,-1,-1
MULIFE.txt,1044444,1044630,186,10,N,N,-,-1,-1
MULIFE.txt,1044462,1044671,209,10,N,N,-,-1,-1
MULIFE.txt,1044502,1044683,181,10,N,N,-,-1,-1
MULIFE.txt,1044542,1044692,150,10,N,N,-,-1,-1
MULIFE.txt,1044553,1044743,190,10,N,N,-,-1,-1
MULIFE.txt,1044557,1044782,225,10,N,N,-,-1,-1
MULIFE.txt,1044561,1044794,233,10,N,N,-,-1,-1
MULIFE.txt,1044568,1044846,278,10,N,N,-,-1,-1
MULIFE.txt,1044579,1044856,277,10,N,N,-,-1,-1
MULIFE.txt,1044596,1044975,379,10,N,N,-,-1,-1
MULIFE.txt,1044631,1045049,418,10,N,N,-,-1,-1
MULIFE.txt,1044673,1045060,387,10,N,N,-,-1,-1
MULIFE.txt,1044684,1045066,382,10,N,N,-,-1,-1
MULIFE.txt,1044697,1045080,383,10,N,N,-,-1,-1
MULIFE.txt,1044744,1045087,343,10,N,N,-,-1,-1
MULIFE.txt,1044787,1045108,321,10,N,N,-,-1,-1
MULIFE.txt,1044795,1045113,318,10,N,N,-,-1,-1
MULIFE.txt,1044847,1045123,276,10,N,N,-,-1,-1
MULIFE.txt,1044857,1045141,284,10,N,N,-,-1,-1
MULIFE.txt,1044976,1045158,182,10,N,N,-,-1,-1
MULIFE.txt,1045050,1045184,134,10,N,N,-,-1,-1
MULIFE.txt,1045061,1045200,139,10,N,N,-,-1,-1
MULIFE.txt,1045069,1045204,135,10,N,N,-,-1,-1
MULIFE.txt,1045081,1045230,149,10,N,N,-,-1,-1
MULIFE.txt,1045088,1045276,188,10,N,N,-,-1,-1
MULIFE.txt,1045109,1045283,174,10,N,N,-,-1,-1
MULIFE.txt,1045114,1045288,174,10,N,N,-,-1,-1
MULIFE.txt,1045126,1045294,168,10,N,N,-,-1,-1
MULIFE.txt,1045143,1045298,155,10,N,N,-,-1,-1
MULIFE.txt,1045159,1045328,169,10,N,N,-,-1,-1
MULIFE.txt,1045185,1045345,160,10,N,N,-,-1,-1
MULIFE.txt,1045201,1045367,166,10,N,N,-,-1,-1
MULIFE.txt,1045206,1045372,166,10,N,N,-,-1,-1
MULIFE.txt,1045231,1045383,152,10,N,N,-,-1,-1
MULIFE.txt,1045279,1045387,108,10,N,N,-,-1,-1
MULIFE.txt,1045284,1045392,108,10,N,N,-,-1,-1
MULIFE.txt,1045289,1045416,127,10,N,N,-,-1,-1
MULIFE.txt,1045295,1045440,145,10,N,N,-,-1,-1
MULIFE.txt,1045299,1045467,168,10,N,N,-,-1,-1
MULIFE.txt,1045331,1045478,147,10,N,N,-,-1,-1
MULIFE.txt,1045348,1045483,135,10,N,N,-,-1,-1
MULIFE.txt,1045368,1045506,138,10,N,N,-,-1,-1
MULIFE.txt,1045373,1045528,155,10,N,N,-,-1,-1
MULIFE.txt,1045384,1045596,212,10,N,N,-,-1,-1
MULIFE.txt,1045388,1045611,223,10,N,N,-,-1,-1
MULIFE.txt,1045395,1045623,228,10,N,N,-,-1,-1
MULIFE.txt,1045417,1045638,221,10,N,N,-,-1,-1
MULIFE.txt,1045441,1045645,204,10,N,N,-,-1,-1
MULIFE.txt,1045468,1045656,188,10,N,N,-,-1,-1
MULIFE.txt,1045479,1045678,199,10,N,N,-,-1,-1
MULIFE.txt,1045483,1045683,200,10,N,N,-,-1,-1
MULIFE.txt,1045507,1045693,186,10,N,N,-,-1,-1
MULIFE.txt,1045529,1045734,205,10,N,N,-,-1,-1
MULIFE.txt,1045597,1045750,153,10,N,N,-,-1,-1
MULIFE.txt,1045613,1045754,141,10,N,N,-,-1,-1
MULIFE.txt,1045624,1045759,135,10,N,N,-,-1,-1
MULIFE.txt,1045639,1045766,127,10,N,N,-,-1,-1
MULIFE.txt,1045646,1045770,124,10,N,N,-,-1,-1
MULIFE.txt,1045657,1045779,122,10,N,N,-,-1,-1
MULIFE.txt,1045679,1045796,117,10,N,N,-,-1,-1
MULIFE.txt,1045684,1045800,116,10,N,N,-,-1,-1
MULIFE.txt,1045696,1045817,121,10,N,N,-,-1,-1
MULIFE.txt,1045737,1045821,84,10,N,N,-,-1,-1
MULIFE.txt,1045751,1045832,81,10,N,N,-,-1,-1
MULIFE.txt,1045755,1045836,81,10,N,N,-,-1,-1
MULIFE.txt,1045760,1045848,88,10,N,N,-,-1,-1
MULIFE.txt,1045767,1045906,139,10,N,N,-,-1,-1
MULIFE.txt,1045772,1045926,154,10,N,N,-,-1,-1
MULIFE.txt,1045780,1045954,174,10,N,N,-,-1,-1
MULIFE.txt,1045797,1045959,162,10,N,N,-,-1,-1
MULIFE.txt,1045802,1045971,169,10,N,N,-,-1,-1
MULIFE.txt,1045818,1045975,157,10,N,N,-,-1,-1
MULIFE.txt,1045822,1045992,170,10,N,N,-,-1,-1
MULIFE.txt,1045833,1045999,166,10,N,N,-,-1,-1
MULIFE.txt,1045839,1046005,166,10,N,N,-,-1,-1
MULIFE.txt,1045849,1046020,171,10,N,N,-,-1,-1
MULIFE.txt,1045907,1046039,132,10,N,N,-,-1,-1
MULIFE.txt,1045929,1046045,116,10,N,N,-,-1,-1
MULIFE.txt,1045955,1046050,95,10,N,N,-,-1,-1
MULIFE.txt,1045960,1046057,97,10,N,N,-,-1,-1
MULIFE.txt,1045972,1046068,96,10,N,N,-,-1,-1
MULIFE.txt,1045978,1046075,97,10,N,N,-,-1,-1
MULIFE.txt,1045994,1046108,114,10,N,N,-,-1,-1
MULIFE.txt,1046000,1046121,121,10,N,N,-,-1,-1
MULIFE.txt,1046006,1046128,122,10,N,N,-,-1,-1
MULIFE.txt,1046023,1046132,109,10,N,N,-,-1,-1
MULIFE.txt,1046041,1046152,111,10,N,N,-,-1,-1
MULIFE.txt,1046046,1046157,111,10,N,N,-,-1,-1
MULIFE.txt,1046051,1046167,116,10,N,N,-,-1,-1
MULIFE.txt,1046058,1046180,122,10,N,N,-,-1,-1
MULIFE.txt,1046069,1046184,115,10,N,N,-,-1,-1
MULIFE.txt,1046078,1046191,113,10,N,N,-,-1,-1
MULIFE.txt,1046109,1046221,112,10,N,N,-,-1,-1
MULIFE.txt,1046122,1046222,100,10,N,N,-,-1,-1
MULIFE.txt,1046129,1046291,162,10,N,N,-,-1,-1
MULIFE.txt,1046134,1046298,164,10,N,N,-,-1,-1
MULIFE.txt,1046153,1046304,151,10,N,N,-,-1,-1
MULIFE.txt,1046158,1046479,321,10,N,N,-,-1,-1
MULIFE.txt,1046170,1046491,321,10,N,N,-,-1,-1
MULIFE.txt,1046181,1046497,316,10,N,N,-,-1,-1
MULIFE.txt,1046185,1046507,322,10,N,N,-,-1,-1
MULIFE.txt,1046196,1046547,351,10,N,N,-,-1,-1
MULIFE.txt,1046221,1046566,345,10,N,N,-,-1,-1
MULIFE.txt,1046225,1046656,431,10,N,N,-,-1,-1
MULIFE.txt,1046293,1046667,374,10,N,N,-,-1,-1
MULIFE.txt,1046299,1046673,374,10,N,N,-,-1,-1
MULIFE.txt,1046307,1046677,370,10,N,N,-,-1,-1
MULIFE.txt,1046480,1046685,205,10,N,N,-,-1,-1
MULIFE.txt,1046492,1046715,223,10,N,N,-,-1,-1
MULIFE.txt,1046500,1046784,284,10,N,N,-,-1,-1
MULIFE.txt,1046508,1046791,283,10,N,N,-,-1,-1
MULIFE.txt,1046548,1046797,249,10,N,N,-,-1,-1
MULIFE.txt,1046568,1046801,233,10,N,N,-,-1,-1
MULIFE.txt,1046657,1046821,164,10,N,N,-,-1,-1
MULIFE.txt,1046668,1046854,186,10,N,N,-,-1,-1
MULIFE.txt,1046674,1046877,203,10,N,N,-,-1,-1
MULIFE.txt,1046680,1046885,205,10,N,N,-,-1,-1
MULIFE.txt,1046686,1046898,212,10,N,N,-,-1,-1
MULIFE.txt,1046716,1046914,198,10,N,N,-,-1,-1
MULIFE.txt,1046786,1046944,158,10,N,N,-,-1,-1
MULIFE.txt,1046792,1046957,165,10,N,N,-,-1,-1
MULIFE.txt,1046798,1046963,165,10,N,N,-,-1,-1
MULIFE.txt,1046804,1046968,164,10,N,N,-,-1,-1
MULIFE.txt,1046823,1047014,191,10,N,N,-,-1,-1
MULIFE.txt,1046856,1047025,169,10,N,N,-,-1,-1
MULIFE.txt,1046878,1047030,152,10,N,N,-,-1,-1
MULIFE.txt,1046888,1047031,143,10,N,N,-,-1,-1
MULIFE.txt,1046899,1047032,133,10,N,N,-,-1,-1
MULIFE.txt,1046916,1047037,121,10,N,N,-,-1,-1
MULIFE.txt,1046947,1047103,156,10,N,N,-,-1,-1
MULIFE.txt,1046958,1047116,158,10,N,N,-,-1,-1
MULIFE.txt,1046964,1047123,159,10,N,N,-,-1,-1
MULIFE.txt,1046970,1047128,158,10,N,N,-,-1,-1
MULIFE.txt,1047015,1047169,154,10,N,N,-,-1,-1
MULIFE.txt,1047026,1047185,159,10,N,N,-,-1,-1
MULIFE.txt,1047030,1047190,160,10,N,N,-,-1,-1
MULIFE.txt,1047031,1047213,182,10,N,N,-,-1,-1
MULIFE.txt,1047033,1047240,207,10,N,N,-,-1,-1
MULIFE.txt,1047039,1047251,212,10,N,N,-,-1,-1
MULIFE.txt,1047104,1047256,152,10,N,N,-,-1,-1
MULIFE.txt,1047117,1047257,140,10,N,N,-,-1,-1
MULIFE.txt,1047124,1047262,138,10,N,N,-,-1,-1
MULIFE.txt,1047130,1047286,156,10,N,N,-,-1,-1
MULIFE.txt,1047170,1047313,143,10,N,N,-,-1,-1
MULIFE.txt,1047186,1047334,148,10,N,N,-,-1,-1
MULIFE.txt,1047192,1047410,218,10,N,N,-,-1,-1
MULIFE.txt,1047214,1047458,244,10,N,N,-,-1,-1
MULIFE.txt,1047241,1047475,234,10,N,N,-,-1,-1
MULIFE.txt,1047252,1047476,224,10,N,N,-,-1,-1
MULIFE.txt,1047256,1047477,221,10,N,N,-,-1,-1
MULIFE.txt,1047258,1047482,224,10,N,N,-,-1,-1
MULIFE.txt,1047264,1047583,319,10,N,N,-,-1,-1
MULIFE.txt,1047287,1047602,315,10,N,N,-,-1,-1
MULIFE.txt,1047314,1047610,296,10,N,N,-,-1,-1
MULIFE.txt,1047336,1047616,280,10,N,N,-,-1,-1
MULIFE.txt,1047411,1047625,214,10,N,N,-,-1,-1
MULIFE.txt,1047459,1047634,175,10,N,N,-,-1,-1
MULIFE.txt,1047475,1047657,182,10,N,N,-,-1,-1
MULIFE.txt,1047476,1047685,209,10,N,N,-,-1,-1
MULIFE.txt,1047478,1047687,209,10,N,N,-,-1,-1
MULIFE.txt,1047485,1047696,211,10,N,N,-,-1,-1
MULIFE.txt,1047586,1047700,114,10,N,N,-,-1,-1
MULIFE.txt,1047603,1047725,122,10,N,N,-,-1,-1
MULIFE.txt,1047611,1047751,140,10,N,N,-,-1,-1
MULIFE.txt,1047617,1047755,138,10,N,N,-,-1,-1
MULIFE.txt,1047626,1047760,134,10,N,N,-,-1,-1
MULIFE.txt,1047635,1047765,130,10,N,N,-,-1,-1
MULIFE.txt,1047659,1047772,113,10,N,N,-,-1,-1
MULIFE.txt,1047685,1047791,106,10,N,N,-,-1,-1
MULIFE.txt,1047688,1047811,123,10,N,N,-,-1,-1
MULIFE.txt,1047697,1047817,120,10,N,N,-,-1,-1
MULIFE.txt,1047703,1047881,178,10,N,N,-,-1,-1
MULIFE.txt,1047727,1047934,207,10,N,N,-,-1,-1
MULIFE.txt,1047752,1047970,218,10,N,N,-,-1,-1
MULIFE.txt,1047756,1047980,224,10,N,N,-,-1,-1
MULIFE.txt,1047761,1047998,237,10,N,N,-,-1,-1
MULIFE.txt,1047765,1048019,254,10,N,N,-,-1,-1
MULIFE.txt,1047774,1048058,284,10,N,N,-,-1,-1
MULIFE.txt,1047792,1048073,281,10,N,N,-,-1,-1
MULIFE.txt,1047812,1048091,279,10,N,N,-,-1,-1
MULIFE.txt,1047820,1048093,273,10,N,N,-,-1,-1
MULIFE.txt,1047886,1048124,238,10,N,N,-,-1,-1
MULIFE.txt,1047939,1048170,231,10,N,N,-,-1,-1
MULIFE.txt,1047973,1048185,212,10,N,N,-,-1,-1
MULIFE.txt,1047981,1048190,209,10,N,N,-,-1,-1
MULIFE.txt,1047999,1048218,219,10,N,N,-,-1,-1
MULIFE.txt,1048020,1048250,230,10,N,N,-,-1,-1
MULIFE.txt,1048059,1048257,198,10,N,N,-,-1,-1
MULIFE.txt,1048074,1048262,188,10,N,N,-,-1,-1
MULIFE.txt,1048091,1048281,190,10,N,N,-,-1,-1
MULIFE.txt,1048094,1048333,239,10,N,N,-,-1,-1
MULIFE.txt,1048125,1048365,240,10,N,N,-,-1,-1
MULIFE.txt,1048172,1048370,198,10,N,N,-,-1,-1
MULIFE.txt,1048186,1048390,204,10,N,N,-,-1,-1
MULIFE.txt,1048195,1048544,349,10,N,N,-,-1,-1
MULIFE.txt,1048221,1048564,343,10,N,N,-,-1,-1
MULIFE.txt,1048252,1048570,318,10,N,N,-,-1,-1
MULIFE.txt,1048258,1048574,316,10,N,N,-,-1,-1
MULIFE.txt,1048265,1048585,320,10,N,N,-,-1,-1
MULIFE.txt,1048282,1048623,341,10,N,N,-,-1,-1
MULIFE.txt,1048334,1048692,358,10,N,N,-,-1,-1
MULIFE.txt,1048366,1048719,353,10,N,N,-,-1,-1
MULIFE.txt,1048371,1048734,363,10,N,N,-,-1,-1
MULIFE.txt,1048391,1048766,375,10,N,N,-,-1,-1
MULIFE.txt,1048545,1048795,250,10,N,N,-,-1,-1
MULIFE.txt,1048565,1048801,236,10,N,N,-,-1,-1
MULIFE.txt,1048571,1048805,234,10,N,N,-,-1,-1
MULIFE.txt,1048577,1048822,245,10,N,N,-,-1,-1
MULIFE.txt,1048586,1048831,245,10,N,N,-,-1,-1
MULIFE.txt,1048624,1048842,218,10,N,N,-,-1,-1
MULIFE.txt,1048693,1048849,156,10,N,N,-,-1,-1
MULIFE.txt,1048720,1048856,136,10,N,N,-,-1,-1
MULIFE.txt,1048735,1048881,146,10,N,N,-,-1,-1
MULIFE.txt,1048767,1048997,230,10,N,N,-,-1,-1
MULIFE.txt,1048796,1049040,244,10,N,N,-,-1,-1
MULIFE.txt,1048802,1049045,243,10,N,N,-,-1,-1
MULIFE.txt,1048810,1049053,243,10,N,N,-,-1,-1
MULIFE.txt,1048825,1049058,233,10,N,N,-,-1,-1
MULIFE.txt,1048832,1049091,259,10,N,N,-,-1,-1
MULIFE.txt,1048845,1049111,266,10,N,N,-,-1,-1
MULIFE.txt,1048850,1049122,272,10,N,N,-,-1,-1
MULIFE.txt,1048859,1049126,267,10,N,N,-,-1,-1
MULIFE.txt,1048882,1049136,254,10,N,N,-,-1,-1
MULIFE.txt,1048999,1049157,158,10,N,N,-,-1,-1
MULIFE.txt,1049041,1049250,209,10,N,N,-,-1,-1
MULIFE.txt,1049046,1049255,209,10,N,N,-,-1,-1
MULIFE.txt,1049054,1049284,230,10,N,N,-,-1,-1
MULIFE.txt,1049061,1049289,228,10,N,N,-,-1,-1
MULIFE.txt,1049093,1049298,205,10,N,N,-,-1,-1
MULIFE.txt,1049112,1049299,187,10,N,N,-,-1,-1
MULIFE.txt,1049123,1049303,180,10,N,N,-,-1,-1
MULIFE.txt,1049129,1049317,188,10,N,N,-,-1,-1
MULIFE.txt,1049137,1049335,198,10,N,N,-,-1,-1
MULIFE.txt,1049159,1049352,193,10,N,N,-,-1,-1
MULIFE.txt,1049251,1049402,151,10,N,N,-,-1,-1
MULIFE.txt,1049256,1049456,200,10,N,N,-,-1,-1
MULIFE.txt,1049285,1049495,210,10,N,N,-,-1,-1
MULIFE.txt,1049290,1049496,206,10,N,N,-,-1,-1
MULIFE.txt,1049298,1049515,217,10,N,N,-,-1,-1
MULIFE.txt,1049300,1049543,243,10,N,N,-,-1,-1
MULIFE.txt,1049306,1049647,341,10,N,N,-,-1,-1
MULIFE.txt,1049318,1049686,368,10,N,N,-,-1,-1
MULIFE.txt,1049337,1049721,384,10,N,N,-,-1,-1
MULIFE.txt,1049353,1049726,373,10,N,N,-,-1,-1
MULIFE.txt,1049404,1049734,330,10,N,N,-,-1,-1
MULIFE.txt,1049457,1049738,281,10,N,N,-,-1,-1
MULIFE.txt,1049495,1049775,280,10,N,N,-,-1,-1
MULIFE.txt,1049497,1049789,292,10,N,N,-,-1,-1
MULIFE.txt,1049518,1049866,348,10,N,N,-,-1,-1
MULIFE.txt,1049544,1049907,363,10,N,N,-,-1,-1
MULIFE.txt,1049648,1049921,273,10,N,N,-,-1,-1
MULIFE.txt,1049687,1049972,285,10,N,N,-,-1,-1
MULIFE.txt,1049722,1049988,266,10,N,N,-,-1,-1
MULIFE.txt,1049727,1049992,265,10,N,N,-,-1,-1
MULIFE.txt,1049735,1050023,288,10,N,N,-,-1,-1
MULIFE.txt,1049743,1050043,300,10,N,N,-,-1,-1
MULIFE.txt,1049776,1050064,288,10,N,N,-,-1,-1
MULIFE.txt,1049790,1050080,290,10,N,N,-,-1,-1
MULIFE.txt,1049867,1050084,217,10,N,N,-,-1,-1
MULIFE.txt,1049908,1050090,182,10,N,N,-,-1,-1
MULIFE.txt,1049922,1050112,190,10,N,N,-,-1,-1
MULIFE.txt,1049973,1050149,176,10,N,N,-,-1,-1
MULIFE.txt,1049989,1050178,189,10,N,N,-,-1,-1
MULIFE.txt,1049995,1050210,215,10,N,N,-,-1,-1
MULIFE.txt,1050026,1050224,198,10,N,N,-,-1,-1
MULIFE.txt,1050044,1050236,192,10,N,N,-,-1,-1
MULIFE.txt,1050065,1050246,181,10,N,N,-,-1,-1
MULIFE.txt,1050081,1050254,173,10,N,N,-,-1,-1
MULIFE.txt,1050085,1050283,198,10,N,N,-,-1,-1
MULIFE.txt,1050093,1050379,286,10,N,N,-,-1,-1
MULIFE.txt,1050115,1050406,291,10,N,N,-,-1,-1
MULIFE.txt,1050152,1050434,282,10,N,N,-,-1,-1
MULIFE.txt,1050181,1050484,303,10,N,N,-,-1,-1
MULIFE.txt,1050212,1050499,287,10,N,N,-,-1,-1
MULIFE.txt,1050227,1050510,283,10,N,N,-,-1,-1
MULIFE.txt,1050237,1050516,279,10,N,N,-,-1,-1
MULIFE.txt,1050249,1050520,271,10,N,N,-,-1,-1
MULIFE.txt,1050255,1050544,289,10,N,N,-,-1,-1
MULIFE.txt,1050285,1050554,269,10,N,N,-,-1,-1
MULIFE.txt,1050380,1050591,211,10,N,N,-,-1,-1
MULIFE.txt,1050407,1050609,202,10,N,N,-,-1,-1
MULIFE.txt,1050435,1050670,235,10,N,N,-,-1,-1
MULIFE.txt,1050485,1050695,210,10,N,N,-,-1,-1
MULIFE.txt,1050500,1050707,207,10,N,N,-,-1,-1
MULIFE.txt,1050511,1050713,202,10,N,N,-,-1,-1
MULIFE.txt,1050517,1050717,200,10,N,N,-,-1,-1
MULIFE.txt,1050525,1050728,203,10,N,N,-,-1,-1
MULIFE.txt,1050546,1050741,195,10,N,N,-,-1,-1
MULIFE.txt,1050555,1050757,202,10,N,N,-,-1,-1
MULIFE.txt,1050594,1050776,182,10,N,N,-,-1,-1
MULIFE.txt,1050612,1050797,185,10,N,N,-,-1,-1
MULIFE.txt,1050671,1050847,176,10,N,N,-,-1,-1
MULIFE.txt,1050697,1050870,173,10,N,N,-,-1,-1
MULIFE.txt,1050708,1050875,167,10,N,N,-,-1,-1
MULIFE.txt,1050714,1050885,171,10,N,N,-,-1,-1
MULIFE.txt,1050720,1050938,218,10,N,N,-,-1,-1
MULIFE.txt,1050729,1050942,213,10,N,N,-,-1,-1
MULIFE.txt,1050742,1050947,205,10,N,N,-,-1,-1
MULIFE.txt,1050758,1050953,195,10,N,N,-,-1,-1
MULIFE.txt,1050779,1050957,178,10,N,N,-,-1,-1
MULIFE.txt,1050800,1051002,202,10,N,N,-,-1,-1
MULIFE.txt,1050848,1051025,177,10,N,N,-,-1,-1
MULIFE.txt,1050872,1051043,171,10,N,N,-,-1,-1
MULIFE.txt,1050876,1051047,171,10,N,N,-,-1,-1
MULIFE.txt,1050886,1051074,188,10,N,N,-,-1,-1
MULIFE.txt,1050939,1051078,139,10,N,N,-,-1,-1
MULIFE.txt,1050943,1051089,146,10,N,N,-,-1,-1
MULIFE.txt,1050948,1051093,145,10,N,N,-,-1,-1
MULIFE.txt,1050954,1051100,146,10,N,N,-,-1,-1
MULIFE.txt,1050960,1051103,143,10,N,N,-,-1,-1
MULIFE.txt,1051003,1051108,105,10,N,N,-,-1,-1
MULIFE.txt,1051026,1051112,86,10,N,N,-,-1,-1
MULIFE.txt,1051044,1051154,110,10,N,N,-,-1,-1
MULIFE.txt,1051050,1051193,143,10,N,N,-,-1,-1
MULIFE.txt,1051075,1051234,159,10,N,N,-,-1,-1
MULIFE.txt,1051080,1051288,208,10,N,N,-,-1,-1
MULIFE.txt,1051090,1051306,216,10,N,N,-,-1,-1
MULIFE.txt,1051098,1051319,221,10,N,N,-,-1,-1
MULIFE.txt,1051100,1051325,225,10,N,N,-,-1,-1
MULIFE.txt,1051103,1051330,227,10,N,N,-,-1,-1
MULIFE.txt,1051108,1051389,281,10,N,N,-,-1,-1
MULIFE.txt,1051112,1051402,290,10,N,N,-,-1,-1
MULIFE.txt,1051155,1051408,253,10,N,N,-,-1,-1
MULIFE.txt,1051198,1051413,215,10,N,N,-,-1,-1
MULIFE.txt,1051236,1051434,198,10,N,N,-,-1,-1
MULIFE.txt,1051289,1051459,170,10,N,N,-,-1,-1
MULIFE.txt,1051309,1051484,175,10,N,N,-,-1,-1
MULIFE.txt,1051320,1051540,220,10,N,N,-,-1,-1
MULIFE.txt,1051326,1051544,218,10,N,N,-,-1,-1
MULIFE.txt,1051332,1051555,223,10,N,N,-,-1,-1
MULIFE.txt,1051390,1051583,193,10,N,N,-,-1,-1
MULIFE.txt,1051403,1051630,227,10,N,N,-,-1,-1
MULIFE.txt,1051409,1051641,232,10,N,N,-,-1,-1
MULIFE.txt,1051416,1051647,231,10,N,N,-,-1,-1
MULIFE.txt,1051437,1051658,221,10,N,N,-,-1,-1
MULIFE.txt,1051460,1051677,217,10,N,N,-,-1,-1
MULIFE.txt,1051485,1051744,259,10,N,N,-,-1,-1
MULIFE.txt,1051541,1051748,207,10,N,N,-,-1,-1
MULIFE.txt,1051546,1051753,207,10,N,N,-,-1,-1
MULIFE.txt,1051558,1051759,201,10,N,N,-,-1,-1
MULIFE.txt,1051584,1051769,185,10,N,N,-,-1,-1
MULIFE.txt,1051631,1051837,206,10,N,N,-,-1,-1
MULIFE.txt,1051642,1051857,215,10,N,N,-,-1,-1
MULIFE.txt,1051650,1051861,211,10,N,N,-,-1,-1
MULIFE.txt,1051659,1051867,208,10,N,N,-,-1,-1
MULIFE.txt,1051678,1051873,195,10,N,N,-,-1,-1
MULIFE.txt,1051745,1051877,132,10,N,N,-,-1,-1
MULIFE.txt,1051749,1051889,140,10,N,N,-,-1,-1
MULIFE.txt,1051754,1051996,242,10,N,N,-,-1,-1
MULIFE.txt,1051762,1052064,302,10,N,N,-,-1,-1
MULIFE.txt,1051770,1052075,305,10,N,N,-,-1,-1
MULIFE.txt,1051838,1052081,243,10,N,N,-,-1,-1
MULIFE.txt,1051858,1052103,245,10,N,N,-,-1,-1
MULIFE.txt,1051863,1052154,291,10,N,N,-,-1,-1
MULIFE.txt,1051868,1052173,305,10,N,N,-,-1,-1
MULIFE.txt,1051874,1052182,308,10,N,N,-,-1,-1
MULIFE.txt,1051882,1052193,311,10,N,N,-,-1,-1
MULIFE.txt,1051890,1052199,309,10,N,N,-,-1,-1
MULIFE.txt,1051997,1052236,239,10,N,N,-,-1,-1
MULIFE.txt,1052065,1052260,195,10,N,N,-,-1,-1
MULIFE.txt,1052076,1052264,188,10,N,N,-,-1,-1
MULIFE.txt,1052084,1052274,190,10,N,N,-,-1,-1
MULIFE.txt,1052105,1052287,182,10,N,N,-,-1,-1
MULIFE.txt,1052155,1052298,143,10,N,N,-,-1,-1
MULIFE.txt,1052174,1052303,129,10,N,N,-,-1,-1
MULIFE.txt,1052183,1052304,121,10,N,N,-,-1,-1
MULIFE.txt,1052194,1052305,111,10,N,N,-,-1,-1
MULIFE.txt,1052201,1052309,108,10,N,N,-,-1,-1
MULIFE.txt,1052239,1052330,91,10,N,N,-,-1,-1
MULIFE.txt,1052261,1052355,94,10,N,N,-,-1,-1
MULIFE.txt,1052265,1052371,106,10,N,N,-,-1,-1
MULIFE.txt,1052276,1052376,100,10,N,N,-,-1,-1
MULIFE.txt,1052288,1052389,101,10,N,N,-,-1,-1
MULIFE.txt,1052299,1052412,113,10,N,N,-,-1,-1
MULIFE.txt,1052303,1052418,115,10,N,N,-,-1,-1
MULIFE.txt,1052304,1052423,119,10,N,N,-,-1,-1
MULIFE.txt,1052306,1052432,126,10,N,N,-,-1,-1
MULIFE.txt,1052311,1052457,146,10,N,N,-,-1,-1
MULIFE.txt,1052331,1052482,151,10,N,N,-,-1,-1
MULIFE.txt,1052356,1052493,137,10,N,N,-,-1,-1
MULIFE.txt,1052372,1052502,130,10,N,N,-,-1,-1
MULIFE.txt,1052378,1052526,148,10,N,N,-,-1,-1
MULIFE.txt,1052390,1052551,161,10,N,N,-,-1,-1
MULIFE.txt,1052415,1052570,155,10,N,N,-,-1,-1
MULIFE.txt,1052419,1052577,158,10,N,N,-,-1,-1
MULIFE.txt,1052424,1052600,176,10,N,N,-,-1,-1
MULIFE.txt,1052434,1052604,170,10,N,N,-,-1,-1
MULIFE.txt,1052458,1052638,180,10,N,N,-,-1,-1
MULIFE.txt,1052483,1052664,181,10,N,N,-,-1,-1
MULIFE.txt,1052494,1052675,181,10,N,N,-,-1,-1
MULIFE.txt,1052505,1052680,175,10,N,N,-,-1,-1
MULIFE.txt,1052527,1052681,154,10,N,N,-,-1,-1
MULIFE.txt,1052552,1052685,133,10,N,N,-,-1,-1
MULIFE.txt,1052573,1052704,131,10,N,N,-,-1,-1
MULIFE.txt,1052578,1052720,142,10,N,N,-,-1,-1
MULIFE.txt,1052601,1052724,123,10,N,N,-,-1,-1
MULIFE.txt,1052605,1052820,215,10,N,N,-,-1,-1
MULIFE.txt,1052639,1052824,185,10,N,N,-,-1,-1
MULIFE.txt,1052665,1052829,164,10,N,N,-,-1,-1
MULIFE.txt,1052676,1052836,160,10,N,N,-,-1,-1
MULIFE.txt,1052680,1052840,160,10,N,N,-,-1,-1
MULIFE.txt,1052682,1052853,171,10,N,N,-,-1,-1
MULIFE.txt,1052688,1052875,187,10,N,N,-,-1,-1
MULIFE.txt,1052705,1052878,173,10,N,N,-,-1,-1
MULIFE.txt,1052721,1052898,177,10,N,N,-,-1,-1
MULIFE.txt,1052729,1052910,181,10,N,N,-,-1,-1
MULIFE.txt,1052821,1052943,122,10,N,N,-,-1,-1
MULIFE.txt,1052825,1052954,129,10,N,N,-,-1,-1
MULIFE.txt,1052830,1052960,130,10,N,N,-,-1,-1
MULIFE.txt,1052837,1052964,127,10,N,N,-,-1,-1
MULIFE.txt,1052843,1052983,140,10,N,N,-,-1,-1
MULIFE.txt,1052854,1053009,155,10,N,N,-,-1,-1
MULIFE.txt,1052875,1053013,138,10,N,N,-,-1,-1
MULIFE.txt,1052880,1053026,146,10,N,N,-,-1,-1
MULIFE.txt,1052901,1053043,142,10,N,N,-,-1,-1
MULIFE.txt,1052911,1053069,158,10,N,N,-,-1,-1
MULIFE.txt,1052944,1053073,129,10,N,N,-,-1,-1
MULIFE.txt,1052955,1053078,123,10,N,N,-,-1,-1
MULIFE.txt,1052961,1053087,126,10,N,N,-,-1,-1
MULIFE.txt,1052967,1053103,136,10,N,N,-,-1,-1
MULIFE.txt,1052984,1053126,142,10,N,N,-,-1,-1
MULIFE.txt,1053010,1053143,133,10,N,N,-,-1,-1
MULIFE.txt,1053014,1053148,134,10,N,N,-,-1,-1
MULIFE.txt,1053029,1053168,139,10,N,N,-,-1,-1
MULIFE.txt,1053044,1053194,150,10,N,N,-,-1,-1
MULIFE.txt,1053070,1053210,140,10,N,N,-,-1,-1
MULIFE.txt,1053074,1053215,141,10,N,N,-,-1,-1
MULIFE.txt,1053079,1053236,157,10,N,N,-,-1,-1
MULIFE.txt,1053090,1053262,172,10,N,N,-,-1,-1
MULIFE.txt,1053104,1053278,174,10,N,N,-,-1,-1
MULIFE.txt,1053128,1053282,154,10,N,N,-,-1,-1
MULIFE.txt,1053144,1053290,146,10,N,N,-,-1,-1
MULIFE.txt,1053151,1053313,162,10,N,N,-,-1,-1
MULIFE.txt,1053169,1053325,156,10,N,N,-,-1,-1
MULIFE.txt,1053195,1053332,137,10,N,N,-,-1,-1
MULIFE.txt,1053211,1053352,141,10,N,N,-,-1,-1
MULIFE.txt,1053218,1053373,155,10,N,N,-,-1,-1
MULIFE.txt,1053237,1053411,174,10,N,N,-,-1,-1
MULIFE.txt,1053263,1053434,171,10,N,N,-,-1,-1
MULIFE.txt,1053279,1053453,174,10,N,N,-,-1,-1
MULIFE.txt,1053285,1053457,172,10,N,N,-,-1,-1
MULIFE.txt,1053291,1053466,175,10,N,N,-,-1,-1
MULIFE.txt,1053314,1053490,176,10,N,N,-,-1,-1
MULIFE.txt,1053326,1053506,180,10,N,N,-,-1,-1
MULIFE.txt,1053335,1053510,175,10,N,N,-,-1,-1
MULIFE.txt,1053353,1053530,177,10,N,N,-,-1,-1
MULIFE.txt,1053374,1053559,185,10,N,N,-,-1,-1
MULIFE.txt,1053412,1053576,164,10,N,N,-,-1,-1
MULIFE.txt,1053436,1053599,163,10,N,N,-,-1,-1
MULIFE.txt,1053454,1053618,164,10,N,N,-,-1,-1
MULIFE.txt,1053460,1053628,168,10,N,N,-,-1,-1
MULIFE.txt,1053467,1053668,201,10,N,N,-,-1,-1
MULIFE.txt,1053492,1053690,198,10,N,N,-,-1,-1
MULIFE.txt,1053507,1053701,194,10,N,N,-,-1,-1
MULIFE.txt,1053511,1053710,199,10,N,N,-,-1,-1
MULIFE.txt,1053531,1053719,188,10,N,N,-,-1,-1
MULIFE.txt,1053560,1053740,180,10,N,N,-,-1,-1
MULIFE.txt,1053577,1053808,231,10,N,N,-,-1,-1
MULIFE.txt,1053600,1053839,239,10,N,N,-,-1,-1
MULIFE.txt,1053621,1053860,239,10,N,N,-,-1,-1
MULIFE.txt,1053629,1053874,245,10,N,N,-,-1,-1
MULIFE.txt,1053669,1053883,214,10,N,N,-,-1,-1
MULIFE.txt,1053691,1053891,200,10,N,N,-,-1,-1
MULIFE.txt,1053702,1053944,242,10,N,N,-,-1,-1
MULIFE.txt,1053713,1053961,248,10,N,N,-,-1,-1
MULIFE.txt,1053720,1054002,282,10,N,N,-,-1,-1
MULIFE.txt,1053742,1054013,271,10,N,N,-,-1,-1
MULIFE.txt,1053809,1054022,213,10,N,N,-,-1,-1
MULIFE.txt,1053840,1054044,204,10,N,N,-,-1,-1
MULIFE.txt,1053861,1054069,208,10,N,N,-,-1,-1
MULIFE.txt,1053875,1054090,215,10,N,N,-,-1,-1
MULIFE.txt,1053886,1054131,245,10,N,N,-,-1,-1
MULIFE.txt,1053892,1054142,250,10,N,N,-,-1,-1
MULIFE.txt,1053945,1054148,203,10,N,N,-,-1,-1
MULIFE.txt,1053962,1054202,240,10,N,N,-,-1,-1
MULIFE.txt,1054003,1054238,235,10,N,N,-,-1,-1
MULIFE.txt,1054014,1054270,256,10,N,N,-,-1,-1
MULIFE.txt,1054025,1054323,298,10,N,N,-,-1,-1
MULIFE.txt,1054046,1054333,287,10,N,N,-,-1,-1
MULIFE.txt,1054070,1054377,307,10,N,N,-,-1,-1
MULIFE.txt,1054092,1054423,331,10,N,N,-,-1,-1
MULIFE.txt,1054132,1054433,301,10,N,N,-,-1,-1
MULIFE.txt,1054143,1054439,296,10,N,N,-,-1,-1
MULIFE.txt,1054153,1054444,291,10,N,N,-,-1,-1
MULIFE.txt,1054207,1054462,255,10,N,N,-,-1,-1
MULIFE.txt,1054241,1054496,255,10,N,N,-,-1,-1
MULIFE.txt,1054272,1054502,230,10,N,N,-,-1,-1
MULIFE.txt,1054324,1054512,188,10,N,N,-,-1,-1
MULIFE.txt,1054335,1054519,184,10,N,N,-,-1,-1
MULIFE.txt,1054378,1054543,165,10,N,N,-,-1,-1
MULIFE.txt,1054424,1054587,163,10,N,N,-,-1,-1
MULIFE.txt,1054434,1054591,157,10,N,N,-,-1,-1
MULIFE.txt,1054441,1054597,156,10,N,N,-,-1,-1
MULIFE.txt,1054449,1054603,154,10,N,N,-,-1,-1
MULIFE.txt,1054465,1054607,142,10,N,N,-,-1,-1
MULIFE.txt,1054498,1054612,114,10,N,N,-,-1,-1
MULIFE.txt,1054503,1054644,141,10,N,N,-,-1,-1
MULIFE.txt,1054513,1054650,137,10,N,N,-,-1,-1
MULIFE.txt,1054522,1054660,138,10,N,N,-,-1,-1
MULIFE.txt,1054544,1054672,128,10,N,N,-,-1,-1
MULIFE.txt,1054588,1054676,88,10,N,N,-,-1,-1
MULIFE.txt,1054593,1054683,90,10,N,N,-,-1,-1
MULIFE.txt,1054598,1054693,95,10,N,N,-,-1,-1
MULIFE.txt,1054604,1054716,112,10,N,N,-,-1,-1
MULIFE.txt,1054608,1054720,112,10,N,N,-,-1,-1
MULIFE.txt,1054615,1054726,111,10,N,N,-,-1,-1
MULIFE.txt,1054646,1054727,81,10,N,N,-,-1,-1
MULIFE.txt,1054651,1054731,80,10,N,N,-,-1,-1
MULIFE.txt,1054661,1054748,87,10,N,N,-,-1,-1
MULIFE.txt,1054673,1054765,92,10,N,N,-,-1,-1
MULIFE.txt,1054677,1054811,134,10,N,N,-,-1,-1
MULIFE.txt,1054686,1054822,136,10,N,N,-,-1,-1
MULIFE.txt,1054694,1054828,134,10,N,N,-,-1,-1
MULIFE.txt,1054717,1054846,129,10,N,N,-,-1,-1
MULIFE.txt,1054722,1054860,138,10,N,N,-,-1,-1
MULIFE.txt,1054726,1054897,171,10,N,N,-,-1,-1
MULIFE.txt,1054728,1054908,180,10,N,N,-,-1,-1
MULIFE.txt,1054734,1054915,181,10,N,N,-,-1,-1
MULIFE.txt,1054749,1054952,203,10,N,N,-,-1,-1
MULIFE.txt,1054768,1055025,257,10,N,N,-,-1,-1
MULIFE.txt,1054812,1055036,224,10,N,N,-,-1,-1
MULIFE.txt,1054823,1055046,223,10,N,N,-,-1,-1
MULIFE.txt,1054831,1055104,273,10,N,N,-,-1,-1
MULIFE.txt,1054847,1055125,278,10,N,N,-,-1,-1
MULIFE.txt,1054862,1055170,308,10,N,N,-,-1,-1
MULIFE.txt,1054898,1055181,283,10,N,N,-,-1,-1
MULIFE.txt,1054909,1055203,294,10,N,N,-,-1,-1
MULIFE.txt,1054920,1055229,309,10,N,N,-,-1,-1
MULIFE.txt,1054954,1055274,320,10,N,N,-,-1,-1
MULIFE.txt,1055026,1055306,280,10,N,N,-,-1,-1
MULIFE.txt,1055037,1055328,291,10,N,N,-,-1,-1
MULIFE.txt,1055049,1055329,280,10,N,N,-,-1,-1
MULIFE.txt,1055107,1055333,226,10,N,N,-,-1,-1
MULIFE.txt,1055128,1055349,221,10,N,N,-,-1,-1
MULIFE.txt,1055171,1055404,233,10,N,N,-,-1,-1
MULIFE.txt,1055182,1055425,243,10,N,N,-,-1,-1
MULIFE.txt,1055204,1055456,252,10,N,N,-,-1,-1
MULIFE.txt,1055232,1055514,282,10,N,N,-,-1,-1
MULIFE.txt,1055275,1055540,265,10,N,N,-,-1,-1
MULIFE.txt,1055307,1055557,250,10,N,N,-,-1,-1
MULIFE.txt,1055328,1055571,243,10,N,N,-,-1,-1
MULIFE.txt,1055330,1055590,260,10,N,N,-,-1,-1
MULIFE.txt,1055338,1055607,269,10,N,N,-,-1,-1
MULIFE.txt,1055350,1055627,277,10,N,N,-,-1,-1
MULIFE.txt,1055406,1055640,234,10,N,N,-,-1,-1
MULIFE.txt,1055426,1055661,235,10,N,N,-,-1,-1
MULIFE.txt,1055457,1055663,206,10,N,N,-,-1,-1
MULIFE.txt,1055517,1055679,162,10,N,N,-,-1,-1
MULIFE.txt,1055542,1055684,142,10,N,N,-,-1,-1
MULIFE.txt,1055558,1055689,131,10,N,N,-,-1,-1
MULIFE.txt,1055574,1055695,121,10,N,N,-,-1,-1
MULIFE.txt,1055591,1055699,108,10,N,N,-,-1,-1
MULIFE.txt,1055610,1055705,95,10,N,N,-,-1,-1
MULIFE.txt,1055628,1055717,89,10,N,N,-,-1,-1
MULIFE.txt,1055642,1055758,116,10,N,N,-,-1,-1
MULIFE.txt,1055662,1055786,124,10,N,N,-,-1,-1
MULIFE.txt,1055664,1055803,139,10,N,N,-,-1,-1
MULIFE.txt,1055681,1055807,126,10,N,N,-,-1,-1
MULIFE.txt,1055685,1055827,142,10,N,N,-,-1,-1
MULIFE.txt,1055690,1055849,159,10,N,N,-,-1,-1
MULIFE.txt,1055696,1055871,175,10,N,N,-,-1,-1
MULIFE.txt,1055700,1055906,206,10,N,N,-,-1,-1
MULIFE.txt,1055708,1055924,216,10,N,N,-,-1,-1
MULIFE.txt,1055718,1055928,210,10,N,N,-,-1,-1
MULIFE.txt,1055759,1055958,199,10,N,N,-,-1,-1
MULIFE.txt,1055787,1055968,181,10,N,N,-,-1,-1
MULIFE.txt,1055804,1055975,171,10,N,N,-,-1,-1
MULIFE.txt,1055810,1055982,172,10,N,N,-,-1,-1
MULIFE.txt,1055829,1056017,188,10,N,N,-,-1,-1
MULIFE.txt,1055850,1056106,256,10,N,N,-,-1,-1
MULIFE.txt,1055873,1056123,250,10,N,N,-,-1,-1
MULIFE.txt,1055909,1056136,227,10,N,N,-,-1,-1
MULIFE.txt,1055925,1056309,384,10,N,N,-,-1,-1
MULIFE.txt,1055930,1056339,409,10,N,N,-,-1,-1
MULIFE.txt,1055959,1056359,400,10,N,N,-,-1,-1
MULIFE.txt,1055969,1056365,396,10,N,N,-,-1,-1
MULIFE.txt,1055976,1056445,469,10,N,N,-,-1,-1
MULIFE.txt,1055984,1056461,477,10,N,N,-,-1,-1
MULIFE.txt,1056020,1056476,456,10,N,N,-,-1,-1
MULIFE.txt,1056107,1056504,397,10,N,N,-,-1,-1
MULIFE.txt,1056124,1056525,401,10,N,N,-,-1,-1
MULIFE.txt,1056138,1056559,421,10,N,N,-,-1,-1
MULIFE.txt,1056310,1056597,287,10,N,N,-,-1,-1
MULIFE.txt,1056340,1056624,284,10,N,N,-,-1,-1
MULIFE.txt,1056360,1056647,287,10,N,N,-,-1,-1
MULIFE.txt,1056368,1056664,296,10,N,N,-,-1,-1
MULIFE.txt,1056446,1056668,222,10,N,N,-,-1,-1
MULIFE.txt,1056462,1056688,226,10,N,N,-,-1,-1
MULIFE.txt,1056477,1056708,231,10,N,N,-,-1,-1
MULIFE.txt,1056505,1056712,207,10,N,N,-,-1,-1
MULIFE.txt,1056526,1056722,196,10,N,N,-,-1,-1
MULIFE.txt,1056560,1056744,184,10,N,N,-,-1,-1
MULIFE.txt,1056598,1056748,150,10,N,N,-,-1,-1
MULIFE.txt,1056625,1056758,133,10,N,N,-,-1,-1
MULIFE.txt,1056649,1056768,119,10,N,N,-,-1,-1
MULIFE.txt,1056665,1056896,231,10,N,N,-,-1,-1
MULIFE.txt,1056671,1056917,246,10,N,N,-,-1,-1
MULIFE.txt,1056690,1056950,260,10,N,N,-,-1,-1
MULIFE.txt,1056709,1056961,252,10,N,N,-,-1,-1
MULIFE.txt,1056713,1056967,254,10,N,N,-,-1,-1
MULIFE.txt,1056724,1056992,268,10,N,N,-,-1,-1
MULIFE.txt,1056745,1057017,272,10,N,N,-,-1,-1
MULIFE.txt,1056749,1057030,281,10,N,N,-,-1,-1
MULIFE.txt,1056761,1057051,290,10,N,N,-,-1,-1
MULIFE.txt,1056769,1057071,302,10,N,N,-,-1,-1
MULIFE.txt,1056897,1057090,193,10,N,N,-,-1,-1
MULIFE.txt,1056918,1057112,194,10,N,N,-,-1,-1
MULIFE.txt,1056951,1057137,186,10,N,N,-,-1,-1
MULIFE.txt,1056962,1057142,180,10,N,N,-,-1,-1
MULIFE.txt,1056970,1057152,182,10,N,N,-,-1,-1
MULIFE.txt,1056994,1057156,162,10,N,N,-,-1,-1
MULIFE.txt,1057018,1057179,161,10,N,N,-,-1,-1
MULIFE.txt,1057032,1057183,151,10,N,N,-,-1,-1
MULIFE.txt,1057053,1057215,162,10,N,N,-,-1,-1
MULIFE.txt,1057073,1057238,165,10,N,N,-,-1,-1
MULIFE.txt,1057092,1057286,194,10,N,N,-,-1,-1
MULIFE.txt,1057114,1057314,200,10,N,N,-,-1,-1
MULIFE.txt,1057139,1057347,208,10,N,N,-,-1,-1
MULIFE.txt,1057143,1057362,219,10,N,N,-,-1,-1
MULIFE.txt,1057153,1057378,225,10,N,N,-,-1,-1
MULIFE.txt,1057157,1057394,237,10,N,N,-,-1,-1
MULIFE.txt,1057180,1057405,225,10,N,N,-,-1,-1
MULIFE.txt,1057185,1057417,232,10,N,N,-,-1,-1
MULIFE.txt,1057218,1057430,212,10,N,N,-,-1,-1
MULIFE.txt,1057239,1057439,200,10,N,N,-,-1,-1
MULIFE.txt,1057287,1057446,159,10,N,N,-,-1,-1
MULIFE.txt,1057316,1057468,152,10,N,N,-,-1,-1
MULIFE.txt,1057348,1057474,126,10,N,N,-,-1,-1
MULIFE.txt,1057363,1057483,120,10,N,N,-,-1,-1
MULIFE.txt,1057383,1057487,104,10,N,N,-,-1,-1
MULIFE.txt,1057396,1057538,142,10,N,N,-,-1,-1
MULIFE.txt,1057407,1057577,170,10,N,N,-,-1,-1
MULIFE.txt,1057419,1057607,188,10,N,N,-,-1,-1
MULIFE.txt,1057432,1057655,223,10,N,N,-,-1,-1
MULIFE.txt,1057440,1057660,220,10,N,N,-,-1,-1
MULIFE.txt,1057451,1057670,219,10,N,N,-,-1,-1
MULIFE.txt,1057469,1057683,214,10,N,N,-,-1,-1
MULIFE.txt,1057479,1057687,208,10,N,N,-,-1,-1
MULIFE.txt,1057484,1057694,210,10,N,N,-,-1,-1
MULIFE.txt,1057492,1057761,269,10,N,N,-,-1,-1
MULIFE.txt,1057539,1057774,235,10,N,N,-,-1,-1
MULIFE.txt,1057582,1057780,198,10,N,N,-,-1,-1
MULIFE.txt,1057609,1057784,175,10,N,N,-,-1,-1
MULIFE.txt,1057656,1057826,170,10,N,N,-,-1,-1
MULIFE.txt,1057661,1057890,229,10,N,N,-,-1,-1
MULIFE.txt,1057673,1057909,236,10,N,N,-,-1,-1
MULIFE.txt,1057684,1057913,229,10,N,N,-,-1,-1
MULIFE.txt,1057688,1057929,241,10,N,N,-,-1,-1
MULIFE.txt,1057696,1057977,281,10,N,N,-,-1,-1
MULIFE.txt,1057764,1057990,226,10,N,N,-,-1,-1
MULIFE.txt,1057775,1057999,224,10,N,N,-,-1,-1
MULIFE.txt,1057781,1058010,229,10,N,N,-,-1,-1
MULIFE.txt,1057786,1058098,312,10,N,N,-,-1,-1
MULIFE.txt,1057827,1058124,297,10,N,N,-,-1,-1
MULIFE.txt,1057891,1058152,261,10,N,N,-,-1,-1
MULIFE.txt,1057910,1058168,258,10,N,N,-,-1,-1
MULIFE.txt,1057915,1058172,257,10,N,N,-,-1,-1
MULIFE.txt,1057930,1058182,252,10,N,N,-,-1,-1
MULIFE.txt,1057980,1058214,234,10,N,N,-,-1,-1
MULIFE.txt,1057991,1058255,264,10,N,N,-,-1,-1
MULIFE.txt,1058002,1058296,294,10,N,N,-,-1,-1
MULIFE.txt,1058011,1058313,302,10,N,N,-,-1,-1
MULIFE.txt,1058099,1058318,219,10,N,N,-,-1,-1
MULIFE.txt,1058125,1058340,215,10,N,N,-,-1,-1
MULIFE.txt,1058153,1058353,200,10,N,N,-,-1,-1
MULIFE.txt,1058169,1058357,188,10,N,N,-,-1,-1
MULIFE.txt,1058175,1058367,192,10,N,N,-,-1,-1
MULIFE.txt,1058183,1058371,188,10,N,N,-,-1,-1
MULIFE.txt,1058215,1058393,178,10,N,N,-,-1,-1
MULIFE.txt,1058256,1058397,141,10,N,N,-,-1,-1
MULIFE.txt,1058297,1058402,105,10,N,N,-,-1,-1
MULIFE.txt,1058314,1058408,94,10,N,N,-,-1,-1
MULIFE.txt,1058321,1058412,91,10,N,N,-,-1,-1
MULIFE.txt,1058342,1058430,88,10,N,N,-,-1,-1
MULIFE.txt,1058354,1058447,93,10,N,N,-,-1,-1
MULIFE.txt,1058358,1058463,105,10,N,N,-,-1,-1
MULIFE.txt,1058368,1058467,99,10,N,N,-,-1,-1
MULIFE.txt,1058372,1058482,110,10,N,N,-,-1,-1
MULIFE.txt,1058394,1058498,104,10,N,N,-,-1,-1
MULIFE.txt,1058398,1058502,104,10,N,N,-,-1,-1
MULIFE.txt,1058403,1058539,136,10,N,N,-,-1,-1
MULIFE.txt,1058409,1058552,143,10,N,N,-,-1,-1
MULIFE.txt,1058414,1058558,144,10,N,N,-,-1,-1
MULIFE.txt,1058433,1058591,158,10,N,N,-,-1,-1
MULIFE.txt,1058448,1058604,156,10,N,N,-,-1,-1
MULIFE.txt,1058464,1058610,146,10,N,N,-,-1,-1
MULIFE.txt,1058469,1058614,145,10,N,N,-,-1,-1
MULIFE.txt,1058483,1058639,156,10,N,N,-,-1,-1
MULIFE.txt,1058499,1058657,158,10,N,N,-,-1,-1
MULIFE.txt,1058504,1058661,157,10,N,N,-,-1,-1
MULIFE.txt,1058542,1058679,137,10,N,N,-,-1,-1
MULIFE.txt,1058553,1058683,130,10,N,N,-,-1,-1
MULIFE.txt,1058560,1058711,151,10,N,N,-,-1,-1
MULIFE.txt,1058592,1058722,130,10,N,N,-,-1,-1
MULIFE.txt,1058605,1058732,127,10,N,N,-,-1,-1
MULIFE.txt,1058611,1058743,132,10,N,N,-,-1,-1
MULIFE.txt,1058616,1058749,133,10,N,N,-,-1,-1
MULIFE.txt,1058640,1058753,113,10,N,N,-,-1,-1
MULIFE.txt,1058658,1058777,119,10,N,N,-,-1,-1
MULIFE.txt,1058666,1058789,123,10,N,N,-,-1,-1
MULIFE.txt,1058680,1058793,113,10,N,N,-,-1,-1
MULIFE.txt,1058685,1058804,119,10,N,N,-,-1,-1
MULIFE.txt,1058712,1058820,108,10,N,N,-,-1,-1
MULIFE.txt,1058724,1058825,101,10,N,N,-,-1,-1
MULIFE.txt,1058733,1058841,108,10,N,N,-,-1,-1
MULIFE.txt,1058744,1058852,108,10,N,N,-,-1,-1
MULIFE.txt,1058750,1058876,126,10,N,N,-,-1,-1
MULIFE.txt,1058755,1058882,127,10,N,N,-,-1,-1
MULIFE.txt,1058780,1058888,108,10,N,N,-,-1,-1
MULIFE.txt,1058790,1058892,102,10,N,N,-,-1,-1
MULIFE.txt,1058796,1058921,125,10,N,N,-,-1,-1
MULIFE.txt,1058805,1058933,128,10,N,N,-,-1,-1
MULIFE.txt,1058821,1058943,122,10,N,N,-,-1,-1
MULIFE.txt,1058827,1058969,142,10,N,N,-,-1,-1
MULIFE.txt,1058842,1058973,131,10,N,N,-,-1,-1
MULIFE.txt,1058854,1058983,129,10,N,N,-,-1,-1
MULIFE.txt,1058878,1058987,109,10,N,N,-,-1,-1
MULIFE.txt,1058883,1059013,130,10,N,N,-,-1,-1
MULIFE.txt,1058889,1059025,136,10,N,N,-,-1,-1
MULIFE.txt,1058895,1059031,136,10,N,N,-,-1,-1
MULIFE.txt,1058922,1059035,113,10,N,N,-,-1,-1
MULIFE.txt,1058934,1059057,123,10,N,N,-,-1,-1
MULIFE.txt,1058946,1059061,115,10,N,N,-,-1,-1
MULIFE.txt,1058970,1059066,96,10,N,N,-,-1,-1
MULIFE.txt,1058974,1059072,98,10,N,N,-,-1,-1
MULIFE.txt,1058984,1059080,96,10,N,N,-,-1,-1
MULIFE.txt,1058990,1059110,120,10,N,N,-,-1,-1
MULIFE.txt,1059014,1059127,113,10,N,N,-,-1,-1
MULIFE.txt,1059026,1059131,105,10,N,N,-,-1,-1
MULIFE.txt,1059032,1059149,117,10,N,N,-,-1,-1
MULIFE.txt,1059038,1059153,115,10,N,N,-,-1,-1
MULIFE.txt,1059058,1059163,105,10,N,N,-,-1,-1
MULIFE.txt,1059062,1059167,105,10,N,N,-,-1,-1
MULIFE.txt,1059067,1059175,108,10,N,N,-,-1,-1
MULIFE.txt,1059073,1059193,120,10,N,N,-,-1,-1
MULIFE.txt,1059081,1059216,135,10,N,N,-,-1,-1
MULIFE.txt,1059111,1059232,121,10,N,N,-,-1,-1
MULIFE.txt,1059128,1059252,124,10,N,N,-,-1,-1
MULIFE.txt,1059134,1059262,128,10,N,N,-,-1,-1
MULIFE.txt,1059150,1059281,131,10,N,N,-,-1,-1
MULIFE.txt,1059154,1059293,139,10,N,N,-,-1,-1
MULIFE.txt,1059164,1059299,135,10,N,N,-,-1,-1
MULIFE.txt,1059170,1059324,154,10,N,N,-,-1,-1
MULIFE.txt,1059176,1059357,181,10,N,N,-,-1,-1
MULIFE.txt,1059194,1059361,167,10,N,N,-,-1,-1
MULIFE.txt,1059217,1059366,149,10,N,N,-,-1,-1
MULIFE.txt,1059235,1059373,138,10,N,N,-,-1,-1
MULIFE.txt,1059255,1059377,122,10,N,N,-,-1,-1
MULIFE.txt,1059263,1059402,139,10,N,N,-,-1,-1
MULIFE.txt,1059282,1059435,153,10,N,N,-,-1,-1
MULIFE.txt,1059294,1059439,145,10,N,N,-,-1,-1
MULIFE.txt,1059302,1059450,148,10,N,N,-,-1,-1
MULIFE.txt,1059325,1059469,144,10,N,N,-,-1,-1
MULIFE.txt,1059358,1059502,144,10,N,N,-,-1,-1
MULIFE.txt,1059362,1059506,144,10,N,N,-,-1,-1
MULIFE.txt,1059367,1059511,144,10,N,N,-,-1,-1
MULIFE.txt,1059374,1059517,143,10,N,N,-,-1,-1
MULIFE.txt,1059380,1059531,151,10,N,N,-,-1,-1
MULIFE.txt,1059403,1059579,176,10,N,N,-,-1,-1
MULIFE.txt,1059436,1059596,160,10,N,N,-,-1,-1
MULIFE.txt,1059440,1059640,200,10,N,N,-,-1,-1
MULIFE.txt,1059453,1059651,198,10,N,N,-,-1,-1
MULIFE.txt,1059470,1059684,214,10,N,N,-,-1,-1
MULIFE.txt,1059503,1059713,210,10,N,N,-,-1,-1
MULIFE.txt,1059507,1059818,311,10,N,N,-,-1,-1
MULIFE.txt,1059512,1059845,333,10,N,N,-,-1,-1
MULIFE.txt,1059520,1059850,330,10,N,N,-,-1,-1
MULIFE.txt,1059532,1059864,332,10,N,N,-,-1,-1
MULIFE.txt,1059580,1059874,294,10,N,N,-,-1,-1
MULIFE.txt,1059601,1059897,296,10,N,N,-,-1,-1
MULIFE.txt,1059643,1059956,313,10,N,N,-,-1,-1
MULIFE.txt,1059652,1059990,338,10,N,N,-,-1,-1
MULIFE.txt,1059689,1059998,309,10,N,N,-,-1,-1
MULIFE.txt,1059714,1059999,285,10,N,N,-,-1,-1
MULIFE.txt,1059819,1060024,205,10,N,N,-,-1,-1
MULIFE.txt,1059846,1060035,189,10,N,N,-,-1,-1
MULIFE.txt,1059851,1060042,191,10,N,N,-,-1,-1
MULIFE.txt,1059867,1060046,179,10,N,N,-,-1,-1
MULIFE.txt,1059875,1060106,231,10,N,N,-,-1,-1
MULIFE.txt,1059899,1060185,286,10,N,N,-,-1,-1
MULIFE.txt,1059957,1060197,240,10,N,N,-,-1,-1
MULIFE.txt,1059991,1060203,212,10,N,N,-,-1,-1
MULIFE.txt,1059998,1060208,210,10,N,N,-,-1,-1
MULIFE.txt,1060001,1060243,242,10,N,N,-,-1,-1
MULIFE.txt,1060025,1060304,279,10,N,N,-,-1,-1
MULIFE.txt,1060036,1060321,285,10,N,N,-,-1,-1
MULIFE.txt,1060043,1060326,283,10,N,N,-,-1,-1
MULIFE.txt,1060051,1060355,304,10,N,N,-,-1,-1
MULIFE.txt,1060107,1060417,310,10,N,N,-,-1,-1
MULIFE.txt,1060187,1060421,234,10,N,N,-,-1,-1
MULIFE.txt,1060198,1060431,233,10,N,N,-,-1,-1
MULIFE.txt,1060204,1060436,232,10,N,N,-,-1,-1
MULIFE.txt,1060211,1060494,283,10,N,N,-,-1,-1
MULIFE.txt,1060245,1060548,303,10,N,N,-,-1,-1
MULIFE.txt,1060305,1060572,267,10,N,N,-,-1,-1
MULIFE.txt,1060322,1060606,284,10,N,N,-,-1,-1
MULIFE.txt,1060329,1060642,313,10,N,N,-,-1,-1
MULIFE.txt,1060356,1060677,321,10,N,N,-,-1,-1
MULIFE.txt,1060418,1060689,271,10,N,N,-,-1,-1
MULIFE.txt,1060422,1060694,272,10,N,N,-,-1,-1
MULIFE.txt,1060432,1060715,283,10,N,N,-,-1,-1
MULIFE.txt,1060441,1060749,308,10,N,N,-,-1,-1
MULIFE.txt,1060499,1060760,261,10,N,N,-,-1,-1
MULIFE.txt,1060551,1060765,214,10,N,N,-,-1,-1
MULIFE.txt,1060573,1060783,210,10,N,N,-,-1,-1
MULIFE.txt,1060611,1060824,213,10,N,N,-,-1,-1
MULIFE.txt,1060645,1060829,184,10,N,N,-,-1,-1
MULIFE.txt,1060680,1060835,155,10,N,N,-,-1,-1
MULIFE.txt,1060690,1060840,150,10,N,N,-,-1,-1
MULIFE.txt,1060696,1060865,169,10,N,N,-,-1,-1
MULIFE.txt,1060716,1060896,180,10,N,N,-,-1,-1
MULIFE.txt,1060750,1060901,151,10,N,N,-,-1,-1
MULIFE.txt,1060761,1060907,146,10,N,N,-,-1,-1
MULIFE.txt,1060767,1060912,145,10,N,N,-,-1,-1
MULIFE.txt,1060784,1060940,156,10,N,N,-,-1,-1
MULIFE.txt,1060825,1060965,140,10,N,N,-,-1,-1
MULIFE.txt,1060830,1060981,151,10,N,N,-,-1,-1
MULIFE.txt,1060836,1061015,179,10,N,N,-,-1,-1
MULIFE.txt,1060842,1061040,198,10,N,N,-,-1,-1
MULIFE.txt,1060866,1061051,185,10,N,N,-,-1,-1
MULIFE.txt,1060897,1061057,160,10,N,N,-,-1,-1
MULIFE.txt,1060902,1061084,182,10,N,N,-,-1,-1
MULIFE.txt,1060908,1061109,201,10,N,N,-,-1,-1
MULIFE.txt,1060914,1061125,211,10,N,N,-,-1,-1
MULIFE.txt,1060941,1061150,209,10,N,N,-,-1,-1
MULIFE.txt,1060966,1061175,209,10,N,N,-,-1,-1
MULIFE.txt,1060983,1061186,203,10,N,N,-,-1,-1
MULIFE.txt,1061018,1061192,174,10,N,N,-,-1,-1
MULIFE.txt,1061041,1061221,180,10,N,N,-,-1,-1
MULIFE.txt,1061052,1061246,194,10,N,N,-,-1,-1
MULIFE.txt,1061059,1061257,198,10,N,N,-,-1,-1
MULIFE.txt,1061085,1061263,178,10,N,N,-,-1,-1
MULIFE.txt,1061110,1061267,157,10,N,N,-,-1,-1
MULIFE.txt,1061127,1061290,163,10,N,N,-,-1,-1
MULIFE.txt,1061151,1061316,165,10,N,N,-,-1,-1
MULIFE.txt,1061176,1061327,151,10,N,N,-,-1,-1
MULIFE.txt,1061187,1061333,146,10,N,N,-,-1,-1
MULIFE.txt,1061194,1061337,143,10,N,N,-,-1,-1
MULIFE.txt,1061222,1061365,143,10,N,N,-,-1,-1
MULIFE.txt,1061247,1061390,143,10,N,N,-,-1,-1
MULIFE.txt,1061258,1061406,148,10,N,N,-,-1,-1
MULIFE.txt,1061264,1061410,146,10,N,N,-,-1,-1
MULIFE.txt,1061269,1061440,171,10,N,N,-,-1,-1
MULIFE.txt,1061291,1061465,174,10,N,N,-,-1,-1
MULIFE.txt,1061317,1061476,159,10,N,N,-,-1,-1
MULIFE.txt,1061328,1061486,158,10,N,N,-,-1,-1
MULIFE.txt,1061334,1061499,165,10,N,N,-,-1,-1
MULIFE.txt,1061339,1061541,202,10,N,N,-,-1,-1
MULIFE.txt,1061366,1061568,202,10,N,N,-,-1,-1
MULIFE.txt,1061391,1061586,195,10,N,N,-,-1,-1
MULIFE.txt,1061407,1061595,188,10,N,N,-,-1,-1
MULIFE.txt,1061412,1061606,194,10,N,N,-,-1,-1
MULIFE.txt,1061443,1061615,172,10,N,N,-,-1,-1
MULIFE.txt,1061466,1061621,155,10,N,N,-,-1,-1
MULIFE.txt,1061477,1061639,162,10,N,N,-,-1,-1
MULIFE.txt,1061489,1061661,172,10,N,N,-,-1,-1
MULIFE.txt,1061500,1061731,231,10,N,N,-,-1,-1
MULIFE.txt,1061542,1061736,194,10,N,N,-,-1,-1
MULIFE.txt,1061569,1061744,175,10,N,N,-,-1,-1
MULIFE.txt,1061588,1061748,160,10,N,N,-,-1,-1
MULIFE.txt,1061596,1061753,157,10,N,N,-,-1,-1
MULIFE.txt,1061607,1061770,163,10,N,N,-,-1,-1
MULIFE.txt,1061616,1061931,315,10,N,N,-,-1,-1
MULIFE.txt,1061624,1061948,324,10,N,N,-,-1,-1
MULIFE.txt,1061642,1061953,311,10,N,N,-,-1,-1
MULIFE.txt,1061662,1061972,310,10,N,N,-,-1,-1
MULIFE.txt,1061732,1062107,375,10,N,N,-,-1,-1
MULIFE.txt,1061737,1062118,381,10,N,N,-,-1,-1
MULIFE.txt,1061745,1062142,397,10,N,N,-,-1,-1
MULIFE.txt,1061749,1062176,427,10,N,N,-,-1,-1
MULIFE.txt,1061756,1062217,461,10,N,N,-,-1,-1
MULIFE.txt,1061771,1062223,452,10,N,N,-,-1,-1
MULIFE.txt,1061932,1062242,310,10,N,N,-,-1,-1
MULIFE.txt,1061949,1062246,297,10,N,N,-,-1,-1
MULIFE.txt,1061956,1062274,318,10,N,N,-,-1,-1
MULIFE.txt,1061973,1062317,344,10,N,N,-,-1,-1
MULIFE.txt,1062108,1062329,221,10,N,N,-,-1,-1
MULIFE.txt,1062121,1062338,217,10,N,N,-,-1,-1
MULIFE.txt,1062144,1062366,222,10,N,N,-,-1,-1
MULIFE.txt,1062178,1062378,200,10,N,N,-,-1,-1
MULIFE.txt,1062219,1062384,165,10,N,N,-,-1,-1
MULIFE.txt,1062224,1062388,164,10,N,N,-,-1,-1
MULIFE.txt,1062243,1062406,163,10,N,N,-,-1,-1
MULIFE.txt,1062251,1062476,225,10,N,N,-,-1,-1
MULIFE.txt,1062275,1062480,205,10,N,N,-,-1,-1
MULIFE.txt,1062319,1062485,166,10,N,N,-,-1,-1
MULIFE.txt,1062330,1062490,160,10,N,N,-,-1,-1
MULIFE.txt,1062341,1062491,150,10,N,N,-,-1,-1
MULIFE.txt,1062368,1062492,124,10,N,N,-,-1,-1
MULIFE.txt,1062379,1062497,118,10,N,N,-,-1,-1
MULIFE.txt,1062385,1062517,132,10,N,N,-,-1,-1
MULIFE.txt,1062391,1062590,199,10,N,N,-,-1,-1
MULIFE.txt,1062407,1062594,187,10,N,N,-,-1,-1
MULIFE.txt,1062477,1062608,131,10,N,N,-,-1,-1
MULIFE.txt,1062481,1062724,243,10,N,N,-,-1,-1
MULIFE.txt,1062486,1062735,249,10,N,N,-,-1,-1
MULIFE.txt,1062490,1062765,275,10,N,N,-,-1,-1
MULIFE.txt,1062491,1062818,327,10,N,N,-,-1,-1
MULIFE.txt,1062493,1062843,350,10,N,N,-,-1,-1
MULIFE.txt,1062500,1062854,354,10,N,N,-,-1,-1
MULIFE.txt,1062518,1062864,346,10,N,N,-,-1,-1
MULIFE.txt,1062591,1062885,294,10,N,N,-,-1,-1
MULIFE.txt,1062596,1063013,417,10,N,N,-,-1,-1
MULIFE.txt,1062611,1063037,426,10,N,N,-,-1,-1
MULIFE.txt,1062727,1063043,316,10,N,N,-,-1,-1
MULIFE.txt,1062736,1063049,313,10,N,N,-,-1,-1
MULIFE.txt,1062766,1063054,288,10,N,N,-,-1,-1
MULIFE.txt,1062819,1063159,340,10,N,N,-,-1,-1
MULIFE.txt,1062844,1063184,340,10,N,N,-,-1,-1
MULIFE.txt,1062855,1063194,339,10,N,N,-,-1,-1
MULIFE.txt,1062867,1063199,332,10,N,N,-,-1,-1
MULIFE.txt,1062888,1063283,395,10,N,N,-,-1,-1
MULIFE.txt,1063014,1063305,291,10,N,N,-,-1,-1
MULIFE.txt,1063039,1063309,270,10,N,N,-,-1,-1
MULIFE.txt,1063044,1063315,271,10,N,N,-,-1,-1
MULIFE.txt,1063050,1063324,274,10,N,N,-,-1,-1
MULIFE.txt,1063057,1063432,375,10,N,N,-,-1,-1
MULIFE.txt,1063160,1063455,295,10,N,N,-,-1,-1
MULIFE.txt,1063185,1063459,274,10,N,N,-,-1,-1
MULIFE.txt,1063195,1063465,270,10,N,N,-,-1,-1
MULIFE.txt,1063202,1063474,272,10,N,N,-,-1,-1
MULIFE.txt,1063284,1063495,211,10,N,N,-,-1,-1
MULIFE.txt,1063306,1063521,215,10,N,N,-,-1,-1
MULIFE.txt,1063311,1063525,214,10,N,N,-,-1,-1
MULIFE.txt,1063316,1063538,222,10,N,N,-,-1,-1
MULIFE.txt,1063327,1063564,237,10,N,N,-,-1,-1
MULIFE.txt,1063433,1063588,155,10,N,N,-,-1,-1
MULIFE.txt,1063456,1063599,143,10,N,N,-,-1,-1
MULIFE.txt,1063461,1063605,144,10,N,N,-,-1,-1
MULIFE.txt,1063466,1063609,143,10,N,N,-,-1,-1
MULIFE.txt,1063477,1063628,151,10,N,N,-,-1,-1
MULIFE.txt,1063496,1063654,158,10,N,N,-,-1,-1
MULIFE.txt,1063522,1063665,143,10,N,N,-,-1,-1
MULIFE.txt,1063526,1063674,148,10,N,N,-,-1,-1
MULIFE.txt,1063541,1063700,159,10,N,N,-,-1,-1
MULIFE.txt,1063565,1063725,160,10,N,N,-,-1,-1
MULIFE.txt,1063589,1063736,147,10,N,N,-,-1,-1
MULIFE.txt,1063600,1063746,146,10,N,N,-,-1,-1
MULIFE.txt,1063606,1063774,168,10,N,N,-,-1,-1
MULIFE.txt,1063612,1063799,187,10,N,N,-,-1,-1
MULIFE.txt,1063629,1063810,181,10,N,N,-,-1,-1
MULIFE.txt,1063655,1063816,161,10,N,N,-,-1,-1
MULIFE.txt,1063666,1063821,155,10,N,N,-,-1,-1
MULIFE.txt,1063677,1063853,176,10,N,N,-,-1,-1
MULIFE.txt,1063701,1063878,177,10,N,N,-,-1,-1
MULIFE.txt,1063726,1063882,156,10,N,N,-,-1,-1
MULIFE.txt,1063737,1063894,157,10,N,N,-,-1,-1
MULIFE.txt,1063748,1063898,150,10,N,N,-,-1,-1
MULIFE.txt,1063775,1063920,145,10,N,N,-,-1,-1
MULIFE.txt,1063800,1063945,145,10,N,N,-,-1,-1
MULIFE.txt,1063811,1063961,150,10,N,N,-,-1,-1
MULIFE.txt,1063817,1063966,149,10,N,N,-,-1,-1
MULIFE.txt,1063823,1064009,186,10,N,N,-,-1,-1
MULIFE.txt,1063856,1064024,168,10,N,N,-,-1,-1
MULIFE.txt,1063879,1064028,149,10,N,N,-,-1,-1
MULIFE.txt,1063883,1064038,155,10,N,N,-,-1,-1
MULIFE.txt,1063895,1064091,196,10,N,N,-,-1,-1
MULIFE.txt,1063900,1064115,215,10,N,N,-,-1,-1
MULIFE.txt,1063921,1064126,205,10,N,N,-,-1,-1
MULIFE.txt,1063946,1064157,211,10,N,N,-,-1,-1
MULIFE.txt,1063962,1064167,205,10,N,N,-,-1,-1
MULIFE.txt,1063968,1064215,247,10,N,N,-,-1,-1
MULIFE.txt,1064010,1064298,288,10,N,N,-,-1,-1
MULIFE.txt,1064025,1064303,278,10,N,N,-,-1,-1
MULIFE.txt,1064029,1064309,280,10,N,N,-,-1,-1
MULIFE.txt,1064043,1064314,271,10,N,N,-,-1,-1
MULIFE.txt,1064096,1064334,238,10,N,N,-,-1,-1
MULIFE.txt,1064120,1064359,239,10,N,N,-,-1,-1
MULIFE.txt,1064127,1064400,273,10,N,N,-,-1,-1
MULIFE.txt,1064157,1064421,264,10,N,N,-,-1,-1
MULIFE.txt,1064168,1064426,258,10,N,N,-,-1,-1
MULIFE.txt,1064216,1064431,215,10,N,N,-,-1,-1
MULIFE.txt,1064299,1064437,138,10,N,N,-,-1,-1
MULIFE.txt,1064305,1064472,167,10,N,N,-,-1,-1
MULIFE.txt,1064310,1064513,203,10,N,N,-,-1,-1
MULIFE.txt,1064317,1064541,224,10,N,N,-,-1,-1
MULIFE.txt,1064337,1064556,219,10,N,N,-,-1,-1
MULIFE.txt,1064360,1064594,234,10,N,N,-,-1,-1
MULIFE.txt,1064401,1064664,263,10,N,N,-,-1,-1
MULIFE.txt,1064422,1064674,252,10,N,N,-,-1,-1
MULIFE.txt,1064427,1064679,252,10,N,N,-,-1,-1
MULIFE.txt,1064432,1064680,248,10,N,N,-,-1,-1
MULIFE.txt,1064440,1064681,241,10,N,N,-,-1,-1
MULIFE.txt,1064474,1064733,259,10,N,N,-,-1,-1
MULIFE.txt,1064515,1064738,223,10,N,N,-,-1,-1
MULIFE.txt,1064542,1064750,208,10,N,N,-,-1,-1
MULIFE.txt,1064559,1064778,219,10,N,N,-,-1,-1
MULIFE.txt,1064595,1064783,188,10,N,N,-,-1,-1
MULIFE.txt,1064665,1064789,124,10,N,N,-,-1,-1
MULIFE.txt,1064675,1064821,146,10,N,N,-,-1,-1
MULIFE.txt,1064679,1064857,178,10,N,N,-,-1,-1
MULIFE.txt,1064680,1064863,183,10,N,N,-,-1,-1
MULIFE.txt,1064684,1064873,189,10,N,N,-,-1,-1
MULIFE.txt,1064734,1064899,165,10,N,N,-,-1,-1
MULIFE.txt,1064739,1064995,256,10,N,N,-,-1,-1
MULIFE.txt,1064752,1065003,251,10,N,N,-,-1,-1
MULIFE.txt,1064779,1065010,231,10,N,N,-,-1,-1
MULIFE.txt,1064784,1065015,231,10,N,N,-,-1,-1
MULIFE.txt,1064794,1065022,228,10,N,N,-,-1,-1
MULIFE.txt,1064824,1065031,207,10,N,N,-,-1,-1
MULIFE.txt,1064859,1065074,215,10,N,N,-,-1,-1
MULIFE.txt,1064864,1065185,321,10,N,N,-,-1,-1
MULIFE.txt,1064876,1065367,491,10,N,N,-,-1,-1
MULIFE.txt,1064900,1065378,478,10,N,N,-,-1,-1
MULIFE.txt,1064996,1065386,390,10,N,N,-,-1,-1
MULIFE.txt,1065006,1065391,385,10,N,N,-,-1,-1
MULIFE.txt,1065011,1065402,391,10,N,N,-,-1,-1
MULIFE.txt,1065016,1065563,547,10,N,N,-,-1,-1
MULIFE.txt,1065025,1065590,565,10,N,N,-,-1,-1
MULIFE.txt,1065031,1065607,576,10,N,N,-,-1,-1
MULIFE.txt,1065075,1065611,536,10,N,N,-,-1,-1
MULIFE.txt,1065186,1065633,447,10,N,N,-,-1,-1
MULIFE.txt,1065368,1065645,277,10,N,N,-,-1,-1
MULIFE.txt,1065379,1065666,287,10,N,N,-,-1,-1
MULIFE.txt,1065387,1065691,304,10,N,N,-,-1,-1
MULIFE.txt,1065394,1065742,348,10,N,N,-,-1,-1
MULIFE.txt,1065403,1065761,358,10,N,N,-,-1,-1
MULIFE.txt,1065564,1065800,236,10,N,N,-,-1,-1
MULIFE.txt,1065591,1065812,221,10,N,N,-,-1,-1
MULIFE.txt,1065608,1065818,210,10,N,N,-,-1,-1
MULIFE.txt,1065616,1065840,224,10,N,N,-,-1,-1
MULIFE.txt,1065636,1065900,264,10,N,N,-,-1,-1
MULIFE.txt,1065646,1065910,264,10,N,N,-,-1,-1
MULIFE.txt,1065667,1065918,251,10,N,N,-,-1,-1
MULIFE.txt,1065696,1065977,281,10,N,N,-,-1,-1
MULIFE.txt,1065743,1065981,238,10,N,N,-,-1,-1
MULIFE.txt,1065763,1065991,228,10,N,N,-,-1,-1
MULIFE.txt,1065802,1065995,193,10,N,N,-,-1,-1
MULIFE.txt,1065813,1066065,252,10,N,N,-,-1,-1
MULIFE.txt,1065821,1066083,262,10,N,N,-,-1,-1
MULIFE.txt,1065843,1066087,244,10,N,N,-,-1,-1
MULIFE.txt,1065901,1066112,211,10,N,N,-,-1,-1
MULIFE.txt,1065911,1066185,274,10,N,N,-,-1,-1
MULIFE.txt,1065921,1066197,276,10,N,N,-,-1,-1
MULIFE.txt,1065978,1066203,225,10,N,N,-,-1,-1
MULIFE.txt,1065982,1066207,225,10,N,N,-,-1,-1
MULIFE.txt,1065992,1066227,235,10,N,N,-,-1,-1
MULIFE.txt,1065998,1066282,284,10,N,N,-,-1,-1
MULIFE.txt,1066067,1066299,232,10,N,N,-,-1,-1
MULIFE.txt,1066084,1066303,219,10,N,N,-,-1,-1
MULIFE.txt,1066090,1066321,231,10,N,N,-,-1,-1
MULIFE.txt,1066113,1066332,219,10,N,N,-,-1,-1
MULIFE.txt,1066186,1066369,183,10,N,N,-,-1,-1
MULIFE.txt,1066198,1066390,192,10,N,N,-,-1,-1
MULIFE.txt,1066204,1066416,212,10,N,N,-,-1,-1
MULIFE.txt,1066210,1066432,222,10,N,N,-,-1,-1
MULIFE.txt,1066228,1066476,248,10,N,N,-,-1,-1
MULIFE.txt,1066284,1066496,212,10,N,N,-,-1,-1
MULIFE.txt,1066300,1066522,222,10,N,N,-,-1,-1
MULIFE.txt,1066306,1066533,227,10,N,N,-,-1,-1
MULIFE.txt,1066322,1066539,217,10,N,N,-,-1,-1
MULIFE.txt,1066335,1066564,229,10,N,N,-,-1,-1
MULIFE.txt,1066371,1066590,219,10,N,N,-,-1,-1
MULIFE.txt,1066391,1066601,210,10,N,N,-,-1,-1
MULIFE.txt,1066417,1066607,190,10,N,N,-,-1,-1
MULIFE.txt,1066435,1066628,193,10,N,N,-,-1,-1
MULIFE.txt,1066477,1066654,177,10,N,N,-,-1,-1
MULIFE.txt,1066497,1066665,168,10,N,N,-,-1,-1
MULIFE.txt,1066523,1066671,148,10,N,N,-,-1,-1
MULIFE.txt,1066534,1066694,160,10,N,N,-,-1,-1
MULIFE.txt,1066544,1066719,175,10,N,N,-,-1,-1
MULIFE.txt,1066565,1066730,165,10,N,N,-,-1,-1
MULIFE.txt,1066591,1066760,169,10,N,N,-,-1,-1
MULIFE.txt,1066602,1066786,184,10,N,N,-,-1,-1
MULIFE.txt,1066609,1066824,215,10,N,N,-,-1,-1
MULIFE.txt,1066629,1066849,220,10,N,N,-,-1,-1
MULIFE.txt,1066655,1066860,205,10,N,N,-,-1,-1
MULIFE.txt,1066666,1066866,200,10,N,N,-,-1,-1
MULIFE.txt,1066673,1066889,216,10,N,N,-,-1,-1
MULIFE.txt,1066695,1066915,220,10,N,N,-,-1,-1
MULIFE.txt,1066720,1066931,211,10,N,N,-,-1,-1
MULIFE.txt,1066731,1066954,223,10,N,N,-,-1,-1
MULIFE.txt,1066761,1066995,234,10,N,N,-,-1,-1
MULIFE.txt,1066787,1067000,213,10,N,N,-,-1,-1
MULIFE.txt,1066825,1067007,182,10,N,N,-,-1,-1
MULIFE.txt,1066850,1067013,163,10,N,N,-,-1,-1
MULIFE.txt,1066861,1067017,156,10,N,N,-,-1,-1
MULIFE.txt,1066868,1067039,171,10,N,N,-,-1,-1
MULIFE.txt,1066890,1067064,174,10,N,N,-,-1,-1
MULIFE.txt,1066916,1067075,159,10,N,N,-,-1,-1
MULIFE.txt,1066933,1067107,174,10,N,N,-,-1,-1
MULIFE.txt,1066955,1067133,178,10,N,N,-,-1,-1
MULIFE.txt,1066996,1067144,148,10,N,N,-,-1,-1
MULIFE.txt,1067003,1067174,171,10,N,N,-,-1,-1
MULIFE.txt,1067008,1067199,191,10,N,N,-,-1,-1
MULIFE.txt,1067014,1067215,201,10,N,N,-,-1,-1
MULIFE.txt,1067019,1067248,229,10,N,N,-,-1,-1
MULIFE.txt,1067040,1067273,233,10,N,N,-,-1,-1
MULIFE.txt,1067065,1067277,212,10,N,N,-,-1,-1
MULIFE.txt,1067076,1067287,211,10,N,N,-,-1,-1
MULIFE.txt,1067108,1067326,218,10,N,N,-,-1,-1
MULIFE.txt,1067134,1067349,215,10,N,N,-,-1,-1
MULIFE.txt,1067145,1067362,217,10,N,N,-,-1,-1
MULIFE.txt,1067175,1067368,193,10,N,N,-,-1,-1
MULIFE.txt,1067200,1067384,184,10,N,N,-,-1,-1
MULIFE.txt,1067217,1067424,207,10,N,N,-,-1,-1
MULIFE.txt,1067251,1067456,205,10,N,N,-,-1,-1
MULIFE.txt,1067274,1067475,201,10,N,N,-,-1,-1
MULIFE.txt,1067278,1067490,212,10,N,N,-,-1,-1
MULIFE.txt,1067289,1067512,223,10,N,N,-,-1,-1
MULIFE.txt,1067327,1067524,197,10,N,N,-,-1,-1
MULIFE.txt,1067350,1067533,183,10,N,N,-,-1,-1
MULIFE.txt,1067363,1067556,193,10,N,N,-,-1,-1
MULIFE.txt,1067373,1067581,208,10,N,N,-,-1,-1
MULIFE.txt,1067384,1067600,216,10,N,N,-,-1,-1
MULIFE.txt,1067429,1067623,194,10,N,N,-,-1,-1
MULIFE.txt,1067461,1067648,187,10,N,N,-,-1,-1
MULIFE.txt,1067478,1067659,181,10,N,N,-,-1,-1
MULIFE.txt,1067491,1067665,174,10,N,N,-,-1,-1
MULIFE.txt,1067514,1067669,155,10,N,N,-,-1,-1
MULIFE.txt,1067525,1067695,170,10,N,N,-,-1,-1
MULIFE.txt,1067536,1067718,182,10,N,N,-,-1,-1
MULIFE.txt,1067557,1067737,180,10,N,N,-,-1,-1
MULIFE.txt,1067582,1067759,177,10,N,N,-,-1,-1
MULIFE.txt,1067603,1067835,232,10,N,N,-,-1,-1
MULIFE.txt,1067624,1067856,232,10,N,N,-,-1,-1
MULIFE.txt,1067649,1067907,258,10,N,N,-,-1,-1
MULIFE.txt,1067660,1067928,268,10,N,N,-,-1,-1
MULIFE.txt,1067666,1067975,309,10,N,N,-,-1,-1
MULIFE.txt,1067672,1068027,355,10,N,N,-,-1,-1
MULIFE.txt,1067696,1068042,346,10,N,N,-,-1,-1
MULIFE.txt,1067719,1068051,332,10,N,N,-,-1,-1
MULIFE.txt,1067740,1068066,326,10,N,N,-,-1,-1
MULIFE.txt,1067762,1068095,333,10,N,N,-,-1,-1
MULIFE.txt,1067836,1068122,286,10,N,N,-,-1,-1
MULIFE.txt,1067857,1068128,271,10,N,N,-,-1,-1
MULIFE.txt,1067908,1068133,225,10,N,N,-,-1,-1
MULIFE.txt,1067931,1068139,208,10,N,N,-,-1,-1
MULIFE.txt,1067976,1068174,198,10,N,N,-,-1,-1
MULIFE.txt,1068028,1068232,204,10,N,N,-,-1,-1
MULIFE.txt,1068043,1068298,255,10,N,N,-,-1,-1
MULIFE.txt,1068056,1068311,255,10,N,N,-,-1,-1
MULIFE.txt,1068067,1068317,250,10,N,N,-,-1,-1
MULIFE.txt,1068096,1068349,253,10,N,N,-,-1,-1
MULIFE.txt,1068124,1068415,291,10,N,N,-,-1,-1
MULIFE.txt,1068129,1068433,304,10,N,N,-,-1,-1
MULIFE.txt,1068134,1068465,331,10,N,N,-,-1,-1
MULIFE.txt,1068142,1068531,389,10,N,N,-,-1,-1
MULIFE.txt,1068177,1068544,367,10,N,N,-,-1,-1
MULIFE.txt,1068233,1068549,316,10,N,N,-,-1,-1
MULIFE.txt,1068299,1068551,252,10,N,N,-,-1,-1
MULIFE.txt,1068312,1068575,263,10,N,N,-,-1,-1
MULIFE.txt,1068320,1068601,281,10,N,N,-,-1,-1
MULIFE.txt,1068351,1068613,262,10,N,N,-,-1,-1
MULIFE.txt,1068417,1068619,202,10,N,N,-,-1,-1
MULIFE.txt,1068436,1068645,209,10,N,N,-,-1,-1
MULIFE.txt,1068467,1068713,246,10,N,N,-,-1,-1
MULIFE.txt,1068533,1068725,192,10,N,N,-,-1,-1
MULIFE.txt,1068545,1068731,186,10,N,N,-,-1,-1
MULIFE.txt,1068549,1068759,210,10,N,N,-,-1,-1
MULIFE.txt,1068554,1068766,212,10,N,N,-,-1,-1
MULIFE.txt,1068576,1068805,229,10,N,N,-,-1,-1
MULIFE.txt,1068602,1068836,234,10,N,N,-,-1,-1
MULIFE.txt,1068614,1068874,260,10,N,N,-,-1,-1
MULIFE.txt,1068622,1068880,258,10,N,N,-,-1,-1
MULIFE.txt,1068646,1068884,238,10,N,N,-,-1,-1
MULIFE.txt,1068714,1068925,211,10,N,N,-,-1,-1
MULIFE.txt,1068726,1068960,234,10,N,N,-,-1,-1
MULIFE.txt,1068736,1068976,240,10,N,N,-,-1,-1
MULIFE.txt,1068760,1068984,224,10,N,N,-,-1,-1
MULIFE.txt,1068769,1068991,222,10,N,N,-,-1,-1
MULIFE.txt,1068807,1068997,190,10,N,N,-,-1,-1
MULIFE.txt,1068839,1069043,204,10,N,N,-,-1,-1
MULIFE.txt,1068877,1069065,188,10,N,N,-,-1,-1
MULIFE.txt,1068881,1069069,188,10,N,N,-,-1,-1
MULIFE.txt,1068887,1069073,186,10,N,N,-,-1,-1
MULIFE.txt,1068928,1069123,195,10,N,N,-,-1,-1
MULIFE.txt,1068961,1069152,191,10,N,N,-,-1,-1
MULIFE.txt,1068977,1069214,237,10,N,N,-,-1,-1
MULIFE.txt,1068985,1069218,233,10,N,N,-,-1,-1
MULIFE.txt,1068992,1069222,230,10,N,N,-,-1,-1
MULIFE.txt,1069000,1069294,294,10,N,N,-,-1,-1
MULIFE.txt,1069044,1069303,259,10,N,N,-,-1,-1
MULIFE.txt,1069066,1069310,244,10,N,N,-,-1,-1
MULIFE.txt,1069070,1069316,246,10,N,N,-,-1,-1
MULIFE.txt,1069076,1069387,311,10,N,N,-,-1,-1
MULIFE.txt,1069124,1069418,294,10,N,N,-,-1,-1
MULIFE.txt,1069155,1069515,360,10,N,N,-,-1,-1
MULIFE.txt,1069215,1069538,323,10,N,N,-,-1,-1
MULIFE.txt,1069219,1069542,323,10,N,N,-,-1,-1
MULIFE.txt,1069225,1069546,321,10,N,N,-,-1,-1
MULIFE.txt,1069295,1069600,305,10,N,N,-,-1,-1
MULIFE.txt,1069304,1069624,320,10,N,N,-,-1,-1
MULIFE.txt,1069311,1069637,326,10,N,N,-,-1,-1
MULIFE.txt,1069319,1069652,333,10,N,N,-,-1,-1
MULIFE.txt,1069388,1069703,315,10,N,N,-,-1,-1
MULIFE.txt,1069421,1069733,312,10,N,N,-,-1,-1
MULIFE.txt,1069516,1069801,285,10,N,N,-,-1,-1
MULIFE.txt,1069539,1069825,286,10,N,N,-,-1,-1
MULIFE.txt,1069543,1069829,286,10,N,N,-,-1,-1
MULIFE.txt,1069549,1069833,284,10,N,N,-,-1,-1
MULIFE.txt,1069601,1069899,298,10,N,N,-,-1,-1
MULIFE.txt,1069629,1069932,303,10,N,N,-,-1,-1
MULIFE.txt,1069640,1070021,381,10,N,N,-,-1,-1
MULIFE.txt,1069655,1070044,389,10,N,N,-,-1,-1
MULIFE.txt,1069704,1070048,344,10,N,N,-,-1,-1
MULIFE.txt,1069736,1070053,317,10,N,N,-,-1,-1
MULIFE.txt,1069802,1070093,291,10,N,N,-,-1,-1
MULIFE.txt,1069826,1070099,273,10,N,N,-,-1,-1
MULIFE.txt,1069830,1070133,303,10,N,N,-,-1,-1
MULIFE.txt,1069836,1070166,330,10,N,N,-,-1,-1
MULIFE.txt,1069900,1070190,290,10,N,N,-,-1,-1
MULIFE.txt,1069935,1070194,259,10,N,N,-,-1,-1
MULIFE.txt,1070022,1070198,176,10,N,N,-,-1,-1
MULIFE.txt,1070045,1070273,228,10,N,N,-,-1,-1
MULIFE.txt,1070049,1070335,286,10,N,N,-,-1,-1
MULIFE.txt,1070056,1070366,310,10,N,N,-,-1,-1
MULIFE.txt,1070094,1070413,319,10,N,N,-,-1,-1
MULIFE.txt,1070102,1070420,318,10,N,N,-,-1,-1
MULIFE.txt,1070134,1070526,392,10,N,N,-,-1,-1
MULIFE.txt,1070167,1070535,368,10,N,N,-,-1,-1
MULIFE.txt,1070191,1070540,349,10,N,N,-,-1,-1
MULIFE.txt,1070195,1070544,349,10,N,N,-,-1,-1
MULIFE.txt,1070201,1070550,349,10,N,N,-,-1,-1
MULIFE.txt,1070276,1070601,325,10,N,N,-,-1,-1
MULIFE.txt,1070336,1070670,334,10,N,N,-,-1,-1
MULIFE.txt,1070369,1070680,311,10,N,N,-,-1,-1
MULIFE.txt,1070414,1070685,271,10,N,N,-,-1,-1
MULIFE.txt,1070423,1070689,266,10,N,N,-,-1,-1
MULIFE.txt,1070527,1070745,218,10,N,N,-,-1,-1
MULIFE.txt,1070537,1070748,211,10,N,N,-,-1,-1
MULIFE.txt,1070541,1070749,208,10,N,N,-,-1,-1
MULIFE.txt,1070545,1070755,210,10,N,N,-,-1,-1
MULIFE.txt,1070555,1070826,271,10,N,N,-,-1,-1
MULIFE.txt,1070602,1070830,228,10,N,N,-,-1,-1
MULIFE.txt,1070673,1070834,161,10,N,N,-,-1,-1
MULIFE.txt,1070681,1070887,206,10,N,N,-,-1,-1
MULIFE.txt,1070686,1070895,209,10,N,N,-,-1,-1
MULIFE.txt,1070691,1070902,211,10,N,N,-,-1,-1
MULIFE.txt,1070746,1070908,162,10,N,N,-,-1,-1
MULIFE.txt,1070748,1070965,217,10,N,N,-,-1,-1
MULIFE.txt,1070749,1070990,241,10,N,N,-,-1,-1
MULIFE.txt,1070757,1070993,236,10,N,N,-,-1,-1
MULIFE.txt,1070827,1070994,167,10,N,N,-,-1,-1
MULIFE.txt,1070831,1070995,164,10,N,N,-,-1,-1
MULIFE.txt,1070836,1071000,164,10,N,N,-,-1,-1
MULIFE.txt,1070888,1071040,152,10,N,N,-,-1,-1
MULIFE.txt,1070896,1071049,153,10,N,N,-,-1,-1
MULIFE.txt,1070903,1071110,207,10,N,N,-,-1,-1
MULIFE.txt,1070910,1071170,260,10,N,N,-,-1,-1
MULIFE.txt,1070966,1071183,217,10,N,N,-,-1,-1
MULIFE.txt,1070991,1071191,200,10,N,N,-,-1,-1
MULIFE.txt,1070993,1071195,202,10,N,N,-,-1,-1
MULIFE.txt,1070994,1071208,214,10,N,N,-,-1,-1
MULIFE.txt,1070996,1071216,220,10,N,N,-,-1,-1
MULIFE.txt,1071002,1071220,218,10,N,N,-,-1,-1
MULIFE.txt,1071043,1071265,222,10,N,N,-,-1,-1
MULIFE.txt,1071051,1071309,258,10,N,N,-,-1,-1
MULIFE.txt,1071112,1071355,243,10,N,N,-,-1,-1
MULIFE.txt,1071173,1071359,186,10,N,N,-,-1,-1
MULIFE.txt,1071184,1071363,179,10,N,N,-,-1,-1
MULIFE.txt,1071192,1071419,227,10,N,N,-,-1,-1
MULIFE.txt,1071198,1071441,243,10,N,N,-,-1,-1
MULIFE.txt,1071209,1071548,339,10,N,N,-,-1,-1
MULIFE.txt,1071217,1071558,341,10,N,N,-,-1,-1
MULIFE.txt,1071222,1071567,345,10,N,N,-,-1,-1
MULIFE.txt,1071267,1071573,306,10,N,N,-,-1,-1
MULIFE.txt,1071310,1071624,314,10,N,N,-,-1,-1
MULIFE.txt,1071356,1071647,291,10,N,N,-,-1,-1
MULIFE.txt,1071360,1071654,294,10,N,N,-,-1,-1
MULIFE.txt,1071365,1071658,293,10,N,N,-,-1,-1
MULIFE.txt,1071420,1071695,275,10,N,N,-,-1,-1
MULIFE.txt,1071443,1071727,284,10,N,N,-,-1,-1
MULIFE.txt,1071551,1071797,246,10,N,N,-,-1,-1
MULIFE.txt,1071559,1071831,272,10,N,N,-,-1,-1
MULIFE.txt,1071568,1071838,270,10,N,N,-,-1,-1
MULIFE.txt,1071575,1071868,293,10,N,N,-,-1,-1
MULIFE.txt,1071625,1071893,268,10,N,N,-,-1,-1
MULIFE.txt,1071650,1071899,249,10,N,N,-,-1,-1
MULIFE.txt,1071655,1071937,282,10,N,N,-,-1,-1
MULIFE.txt,1071660,1071969,309,10,N,N,-,-1,-1
MULIFE.txt,1071698,1071998,300,10,N,N,-,-1,-1
MULIFE.txt,1071729,1072032,303,10,N,N,-,-1,-1
MULIFE.txt,1071798,1072036,238,10,N,N,-,-1,-1
MULIFE.txt,1071832,1072041,209,10,N,N,-,-1,-1
MULIFE.txt,1071840,1072074,234,10,N,N,-,-1,-1
MULIFE.txt,1071869,1072106,237,10,N,N,-,-1,-1
MULIFE.txt,1071894,1072145,251,10,N,N,-,-1,-1
MULIFE.txt,1071899,1072178,279,10,N,N,-,-1,-1
MULIFE.txt,1071940,1072222,282,10,N,N,-,-1,-1
MULIFE.txt,1071971,1072245,274,10,N,N,-,-1,-1
MULIFE.txt,1071999,1072248,249,10,N,N,-,-1,-1
MULIFE.txt,1072033,1072250,217,10,N,N,-,-1,-1
MULIFE.txt,1072037,1072254,217,10,N,N,-,-1,-1
MULIFE.txt,1072043,1072291,248,10,N,N,-,-1,-1
MULIFE.txt,1072075,1072323,248,10,N,N,-,-1,-1
MULIFE.txt,1072108,1072361,253,10,N,N,-,-1,-1
MULIFE.txt,1072148,1072393,245,10,N,N,-,-1,-1
MULIFE.txt,1072180,1072427,247,10,N,N,-,-1,-1
MULIFE.txt,1072223,1072459,236,10,N,N,-,-1,-1
MULIFE.txt,1072246,1072484,238,10,N,N,-,-1,-1
MULIFE.txt,1072248,1072510,262,10,N,N,-,-1,-1
MULIFE.txt,1072251,1072514,263,10,N,N,-,-1,-1
MULIFE.txt,1072256,1072518,262,10,N,N,-,-1,-1
MULIFE.txt,1072294,1072533,239,10,N,N,-,-1,-1
MULIFE.txt,1072325,1072577,252,10,N,N,-,-1,-1
MULIFE.txt,1072364,1072601,237,10,N,N,-,-1,-1
MULIFE.txt,1072395,1072605,210,10,N,N,-,-1,-1
MULIFE.txt,1072428,1072610,182,10,N,N,-,-1,-1
MULIFE.txt,1072461,1072642,181,10,N,N,-,-1,-1
MULIFE.txt,1072485,1072674,189,10,N,N,-,-1,-1
MULIFE.txt,1072511,1072729,218,10,N,N,-,-1,-1
MULIFE.txt,1072515,1072744,229,10,N,N,-,-1,-1
MULIFE.txt,1072523,1072751,228,10,N,N,-,-1,-1
MULIFE.txt,1072536,1072820,284,10,N,N,-,-1,-1
MULIFE.txt,1072579,1072892,313,10,N,N,-,-1,-1
MULIFE.txt,1072602,1072916,314,10,N,N,-,-1,-1
MULIFE.txt,1072606,1072924,318,10,N,N,-,-1,-1
MULIFE.txt,1072613,1072929,316,10,N,N,-,-1,-1
MULIFE.txt,1072643,1072934,291,10,N,N,-,-1,-1
MULIFE.txt,1072677,1072940,263,10,N,N,-,-1,-1
MULIFE.txt,1072730,1072988,258,10,N,N,-,-1,-1
MULIFE.txt,1072745,1073010,265,10,N,N,-,-1,-1
MULIFE.txt,1072754,1073017,263,10,N,N,-,-1,-1
MULIFE.txt,1072823,1073057,234,10,N,N,-,-1,-1
MULIFE.txt,1072893,1073065,172,10,N,N,-,-1,-1
MULIFE.txt,1072917,1073111,194,10,N,N,-,-1,-1
MULIFE.txt,1072925,1073134,209,10,N,N,-,-1,-1
MULIFE.txt,1072930,1073140,210,10,N,N,-,-1,-1
MULIFE.txt,1072935,1073198,263,10,N,N,-,-1,-1
MULIFE.txt,1072943,1073220,277,10,N,N,-,-1,-1
MULIFE.txt,1072989,1073259,270,10,N,N,-,-1,-1
MULIFE.txt,1073011,1073282,271,10,N,N,-,-1,-1
MULIFE.txt,1073020,1073310,290,10,N,N,-,-1,-1
MULIFE.txt,1073059,1073343,284,10,N,N,-,-1,-1
MULIFE.txt,1073068,1073382,314,10,N,N,-,-1,-1
MULIFE.txt,1073112,1073434,322,10,N,N,-,-1,-1
MULIFE.txt,1073135,1073478,343,10,N,N,-,-1,-1
MULIFE.txt,1073143,1073534,391,10,N,N,-,-1,-1
MULIFE.txt,1073199,1073538,339,10,N,N,-,-1,-1
MULIFE.txt,1073223,1073542,319,10,N,N,-,-1,-1
MULIFE.txt,1073261,1073625,364,10,N,N,-,-1,-1
MULIFE.txt,1073285,1073633,348,10,N,N,-,-1,-1
MULIFE.txt,1073311,1073640,329,10,N,N,-,-1,-1
MULIFE.txt,1073346,1073646,300,10,N,N,-,-1,-1
MULIFE.txt,1073384,1073769,385,10,N,N,-,-1,-1
MULIFE.txt,1073437,1073804,367,10,N,N,-,-1,-1
MULIFE.txt,1073480,1073812,332,10,N,N,-,-1,-1
MULIFE.txt,1073535,1073936,401,10,N,N,-,-1,-1
MULIFE.txt,1073539,1073979,440,10,N,N,-,-1,-1
MULIFE.txt,1073545,1074101,556,10,N,N,-,-1,-1
MULIFE.txt,1073626,1074140,514,10,N,N,-,-1,-1
MULIFE.txt,1073634,1074173,539,10,N,N,-,-1,-1
MULIFE.txt,1073641,1074221,580,10,N,N,-,-1,-1
MULIFE.txt,1073649,1074261,612,10,N,N,-,-1,-1
MULIFE.txt,1073771,1074285,514,10,N,N,-,-1,-1
MULIFE.txt,1073806,1074292,486,10,N,N,-,-1,-1
MULIFE.txt,1073815,1074360,545,10,N,N,-,-1,-1
MULIFE.txt,1073937,1074367,430,10,N,N,-,-1,-1
MULIFE.txt,1073982,1074418,436,10,N,N,-,-1,-1
MULIFE.txt,1074102,1074471,369,10,N,N,-,-1,-1
MULIFE.txt,1074143,1074526,383,10,N,N,-,-1,-1
MULIFE.txt,1074174,1074560,386,10,N,N,-,-1,-1
MULIFE.txt,1074223,1074629,406,10,N,N,-,-1,-1
MULIFE.txt,1074262,1074660,398,10,N,N,-,-1,-1
MULIFE.txt,1074286,1074714,428,10,N,N,-,-1,-1
MULIFE.txt,1074295,1074718,423,10,N,N,-,-1,-1
MULIFE.txt,1074361,1074799,438,10,N,N,-,-1,-1
MULIFE.txt,1074370,1074839,469,10,N,N,-,-1,-1
MULIFE.txt,1074421,1074885,464,10,N,N,-,-1,-1
MULIFE.txt,1074476,1074891,415,10,N,N,-,-1,-1
MULIFE.txt,1074531,1074930,399,10,N,N,-,-1,-1
MULIFE.txt,1074565,1074948,383,10,N,N,-,-1,-1
MULIFE.txt,1074630,1074967,337,10,N,N,-,-1,-1
MULIFE.txt,1074663,1074977,314,10,N,N,-,-1,-1
MULIFE.txt,1074715,1074985,270,10,N,N,-,-1,-1
MULIFE.txt,1074721,1074991,270,10,N,N,-,-1,-1
MULIFE.txt,1074801,1075050,249,10,N,N,-,-1,-1
MULIFE.txt,1074842,1075108,266,10,N,N,-,-1,-1
MULIFE.txt,1074886,1075152,266,10,N,N,-,-1,-1
MULIFE.txt,1074894,1075156,262,10,N,N,-,-1,-1
MULIFE.txt,1074931,1075160,229,10,N,N,-,-1,-1
MULIFE.txt,1074949,1075191,242,10,N,N,-,-1,-1
MULIFE.txt,1074969,1075206,237,10,N,N,-,-1,-1
MULIFE.txt,1074978,1075214,236,10,N,N,-,-1,-1
MULIFE.txt,1074986,1075218,232,10,N,N,-,-1,-1
MULIFE.txt,1074994,1075238,244,10,N,N,-,-1,-1
MULIFE.txt,1075051,1075240,189,10,N,N,-,-1,-1
MULIFE.txt,1075111,1075274,163,10,N,N,-,-1,-1
MULIFE.txt,1075153,1075282,129,10,N,N,-,-1,-1
MULIFE.txt,1075157,1075344,187,10,N,N,-,-1,-1
MULIFE.txt,1075163,1075352,189,10,N,N,-,-1,-1
MULIFE.txt,1075192,1075359,167,10,N,N,-,-1,-1
MULIFE.txt,1075207,1075363,156,10,N,N,-,-1,-1
MULIFE.txt,1075215,1075430,215,10,N,N,-,-1,-1
MULIFE.txt,1075221,1075472,251,10,N,N,-,-1,-1
MULIFE.txt,1075238,1075512,274,10,N,N,-,-1,-1
MULIFE.txt,1075241,1075529,288,10,N,N,-,-1,-1
MULIFE.txt,1075275,1075605,330,10,N,N,-,-1,-1
MULIFE.txt,1075284,1075655,371,10,N,N,-,-1,-1
MULIFE.txt,1075345,1075692,347,10,N,N,-,-1,-1
MULIFE.txt,1075353,1075695,342,10,N,N,-,-1,-1
MULIFE.txt,1075360,1075696,336,10,N,N,-,-1,-1
MULIFE.txt,1075365,1075697,332,10,N,N,-,-1,-1
MULIFE.txt,1075432,1075701,269,10,N,N,-,-1,-1
MULIFE.txt,1075474,1075766,292,10,N,N,-,-1,-1
MULIFE.txt,1075514,1075836,322,10,N,N,-,-1,-1
MULIFE.txt,1075530,1075886,356,10,N,N,-,-1,-1
MULIFE.txt,1075607,1075895,288,10,N,N,-,-1,-1
MULIFE.txt,1075656,1075950,294,10,N,N,-,-1,-1
MULIFE.txt,1075693,1075971,278,10,N,N,-,-1,-1
MULIFE.txt,1075695,1076000,305,10,N,N,-,-1,-1
MULIFE.txt,1075696,1076003,307,10,N,N,-,-1,-1
MULIFE.txt,1075698,1076004,306,10,N,N,-,-1,-1
MULIFE.txt,1075703,1076005,302,10,N,N,-,-1,-1
MULIFE.txt,1075767,1076009,242,10,N,N,-,-1,-1
MULIFE.txt,1075839,1076054,215,10,N,N,-,-1,-1
MULIFE.txt,1075889,1076061,172,10,N,N,-,-1,-1
MULIFE.txt,1075897,1076080,183,10,N,N,-,-1,-1
MULIFE.txt,1075951,1076215,264,10,N,N,-,-1,-1
MULIFE.txt,1075973,1076222,249,10,N,N,-,-1,-1
MULIFE.txt,1076001,1076265,264,10,N,N,-,-1,-1
MULIFE.txt,1076003,1076272,269,10,N,N,-,-1,-1
MULIFE.txt,1076004,1076324,320,10,N,N,-,-1,-1
MULIFE.txt,1076006,1076375,369,10,N,N,-,-1,-1
MULIFE.txt,1076011,1076379,368,10,N,N,-,-1,-1
MULIFE.txt,1076055,1076395,340,10,N,N,-,-1,-1
MULIFE.txt,1076066,1076475,409,10,N,N,-,-1,-1
MULIFE.txt,1076081,1076481,400,10,N,N,-,-1,-1
MULIFE.txt,1076216,1076485,269,10,N,N,-,-1,-1
MULIFE.txt,1076225,1076523,298,10,N,N,-,-1,-1
MULIFE.txt,1076266,1076607,341,10,N,N,-,-1,-1
MULIFE.txt,1076275,1076637,362,10,N,N,-,-1,-1
MULIFE.txt,1076327,1076681,354,10,N,N,-,-1,-1
MULIFE.txt,1076376,1076689,313,10,N,N,-,-1,-1
MULIFE.txt,1076382,1076746,364,10,N,N,-,-1,-1
MULIFE.txt,1076396,1076776,380,10,N,N,-,-1,-1
MULIFE.txt,1076476,1076825,349,10,N,N,-,-1,-1
MULIFE.txt,1076482,1076849,367,10,N,N,-,-1,-1
MULIFE.txt,1076488,1076855,367,10,N,N,-,-1,-1
MULIFE.txt,1076524,1076910,386,10,N,N,-,-1,-1
MULIFE.txt,1076608,1076942,334,10,N,N,-,-1,-1
MULIFE.txt,1076640,1077037,397,10,N,N,-,-1,-1
MULIFE.txt,1076683,1077078,395,10,N,N,-,-1,-1
MULIFE.txt,1076692,1077094,402,10,N,N,-,-1,-1
MULIFE.txt,1076747,1077101,354,10,N,N,-,-1,-1
MULIFE.txt,1076779,1077120,341,10,N,N,-,-1,-1
MULIFE.txt,1076826,1077190,364,10,N,N,-,-1,-1
MULIFE.txt,1076850,1077212,362,10,N,N,-,-1,-1
MULIFE.txt,1076858,1077278,420,10,N,N,-,-1,-1
MULIFE.txt,1076911,1077282,371,10,N,N,-,-1,-1
MULIFE.txt,1076945,1077286,341,10,N,N,-,-1,-1
MULIFE.txt,1077040,1077394,354,10,N,N,-,-1,-1
MULIFE.txt,1077080,1077418,338,10,N,N,-,-1,-1
MULIFE.txt,1077095,1077423,328,10,N,N,-,-1,-1
MULIFE.txt,1077104,1077427,323,10,N,N,-,-1,-1
MULIFE.txt,1077121,1077468,347,10,N,N,-,-1,-1
MULIFE.txt,1077191,1077499,308,10,N,N,-,-1,-1
MULIFE.txt,1077215,1077535,320,10,N,N,-,-1,-1
MULIFE.txt,1077279,1077566,287,10,N,N,-,-1,-1
MULIFE.txt,1077283,1077615,332,10,N,N,-,-1,-1
MULIFE.txt,1077289,1077631,342,10,N,N,-,-1,-1
MULIFE.txt,1077396,1077648,252,10,N,N,-,-1,-1
MULIFE.txt,1077419,1077667,248,10,N,N,-,-1,-1
MULIFE.txt,1077424,1077672,248,10,N,N,-,-1,-1
MULIFE.txt,1077430,1077678,248,10,N,N,-,-1,-1
MULIFE.txt,1077470,1077683,213,10,N,N,-,-1,-1
MULIFE.txt,1077502,1077684,182,10,N,N,-,-1,-1
MULIFE.txt,1077536,1077688,152,10,N,N,-,-1,-1
MULIFE.txt,1077571,1077699,128,10,N,N,-,-1,-1
MULIFE.txt,1077616,1077722,106,10,N,N,-,-1,-1
MULIFE.txt,1077632,1077806,174,10,N,N,-,-1,-1
MULIFE.txt,1077649,1077829,180,10,N,N,-,-1,-1
MULIFE.txt,1077668,1077833,165,10,N,N,-,-1,-1
MULIFE.txt,1077674,1077839,165,10,N,N,-,-1,-1
MULIFE.txt,1077679,1077845,166,10,N,N,-,-1,-1
MULIFE.txt,1077683,1077850,167,10,N,N,-,-1,-1
MULIFE.txt,1077685,1077863,178,10,N,N,-,-1,-1
MULIFE.txt,1077693,1077928,235,10,N,N,-,-1,-1
MULIFE.txt,1077700,1077959,259,10,N,N,-,-1,-1
MULIFE.txt,1077724,1077982,258,10,N,N,-,-1,-1
MULIFE.txt,1077807,1077994,187,10,N,N,-,-1,-1
MULIFE.txt,1077830,1078024,194,10,N,N,-,-1,-1
MULIFE.txt,1077835,1078112,277,10,N,N,-,-1,-1
MULIFE.txt,1077840,1078117,277,10,N,N,-,-1,-1
MULIFE.txt,1077846,1078128,282,10,N,N,-,-1,-1
MULIFE.txt,1077855,1078132,277,10,N,N,-,-1,-1
MULIFE.txt,1077864,1078235,371,10,N,N,-,-1,-1
MULIFE.txt,1077929,1078251,322,10,N,N,-,-1,-1
MULIFE.txt,1077960,1078270,310,10,N,N,-,-1,-1
MULIFE.txt,1077984,1078300,316,10,N,N,-,-1,-1
MULIFE.txt,1077995,1078368,373,10,N,N,-,-1,-1
MULIFE.txt,1078026,1078375,349,10,N,N,-,-1,-1
MULIFE.txt,1078113,1078391,278,10,N,N,-,-1,-1
MULIFE.txt,1078119,1078409,290,10,N,N,-,-1,-1
MULIFE.txt,1078129,1078443,314,10,N,N,-,-1,-1
MULIFE.txt,1078137,1078450,313,10,N,N,-,-1,-1
MULIFE.txt,1078238,1078465,227,10,N,N,-,-1,-1
MULIFE.txt,1078252,1078496,244,10,N,N,-,-1,-1
MULIFE.txt,1078271,1078501,230,10,N,N,-,-1,-1
MULIFE.txt,1078303,1078513,210,10,N,N,-,-1,-1
MULIFE.txt,1078371,1078517,146,10,N,N,-,-1,-1
MULIFE.txt,1078376,1078556,180,10,N,N,-,-1,-1
MULIFE.txt,1078393,1078561,168,10,N,N,-,-1,-1
MULIFE.txt,1078411,1078571,160,10,N,N,-,-1,-1
MULIFE.txt,1078446,1078575,129,10,N,N,-,-1,-1
MULIFE.txt,1078451,1078607,156,10,N,N,-,-1,-1
MULIFE.txt,1078467,1078614,147,10,N,N,-,-1,-1
MULIFE.txt,1078497,1078624,127,10,N,N,-,-1,-1
MULIFE.txt,1078504,1078629,125,10,N,N,-,-1,-1
MULIFE.txt,1078514,1078649,135,10,N,N,-,-1,-1
MULIFE.txt,1078519,1078654,135,10,N,N,-,-1,-1
MULIFE.txt,1078557,1078659,102,10,N,N,-,-1,-1
MULIFE.txt,1078562,1078665,103,10,N,N,-,-1,-1
MULIFE.txt,1078572,1078669,97,10,N,N,-,-1,-1
MULIFE.txt,1078577,1078689,112,10,N,N,-,-1,-1
MULIFE.txt,1078610,1078694,84,10,N,N,-,-1,-1
MULIFE.txt,1078615,1078699,84,10,N,N,-,-1,-1
MULIFE.txt,1078625,1078705,80,10,N,N,-,-1,-1
MULIFE.txt,1078632,1078709,77,10,N,N,-,-1,-1
MULIFE.txt,1078650,1078730,80,10,N,N,-,-1,-1
MULIFE.txt,1078655,1078735,80,10,N,N,-,-1,-1
MULIFE.txt,1078660,1078740,80,10,N,N,-,-1,-1
MULIFE.txt,1078666,1078746,80,10,N,N,-,-1,-1
MULIFE.txt,1078671,1078750,79,10,N,N,-,-1,-1
MULIFE.txt,1078690,1078772,82,10,N,N,-,-1,-1
MULIFE.txt,1078695,1078777,82,10,N,N,-,-1,-1
MULIFE.txt,1078700,1078782,82,10,N,N,-,-1,-1
MULIFE.txt,1078706,1078808,102,10,N,N,-,-1,-1
MULIFE.txt,1078711,1078812,101,10,N,N,-,-1,-1
MULIFE.txt,1078731,1078823,92,10,N,N,-,-1,-1
MULIFE.txt,1078736,1078835,99,10,N,N,-,-1,-1
MULIFE.txt,1078741,1078839,98,10,N,N,-,-1,-1
MULIFE.txt,1078747,1078867,120,10,N,N,-,-1,-1
MULIFE.txt,1078752,1078872,120,10,N,N,-,-1,-1
MULIFE.txt,1078773,1078879,106,10,N,N,-,-1,-1
MULIFE.txt,1078778,1078891,113,10,N,N,-,-1,-1
MULIFE.txt,1078785,1078910,125,10,N,N,-,-1,-1
MULIFE.txt,1078809,1078915,106,10,N,N,-,-1,-1
MULIFE.txt,1078815,1078925,110,10,N,N,-,-1,-1
MULIFE.txt,1078824,1078929,105,10,N,N,-,-1,-1
MULIFE.txt,1078836,1078949,113,10,N,N,-,-1,-1
MULIFE.txt,1078841,1078954,113,10,N,N,-,-1,-1
MULIFE.txt,1078868,1078959,91,10,N,N,-,-1,-1
MULIFE.txt,1078875,1078960,85,10,N,N,-,-1,-1
MULIFE.txt,1078880,1078964,84,10,N,N,-,-1,-1
MULIFE.txt,1078892,1078968,76,10,N,N,-,-1,-1
MULIFE.txt,1078911,1079004,93,10,N,N,-,-1,-1
MULIFE.txt,1078916,1079011,95,10,N,N,-,-1,-1
MULIFE.txt,1078926,1079016,90,10,N,N,-,-1,-1
MULIFE.txt,1078931,1079022,91,10,N,N,-,-1,-1
MULIFE.txt,1078950,1079026,76,10,N,N,-,-1,-1
MULIFE.txt,1078955,1079056,101,10,N,N,-,-1,-1
MULIFE.txt,1078959,1079070,111,10,N,N,-,-1,-1
MULIFE.txt,1078961,1079102,141,10,N,N,-,-1,-1
MULIFE.txt,1078965,1079109,144,10,N,N,-,-1,-1
MULIFE.txt,1078970,1079114,144,10,N,N,-,-1,-1
MULIFE.txt,1079007,1079123,116,10,N,N,-,-1,-1
MULIFE.txt,1079012,1079162,150,10,N,N,-,-1,-1
MULIFE.txt,1079017,1079167,150,10,N,N,-,-1,-1
MULIFE.txt,1079023,1079172,149,10,N,N,-,-1,-1
MULIFE.txt,1079031,1079178,147,10,N,N,-,-1,-1
MULIFE.txt,1079057,1079182,125,10,N,N,-,-1,-1
MULIFE.txt,1079072,1079221,149,10,N,N,-,-1,-1
MULIFE.txt,1079105,1079226,121,10,N,N,-,-1,-1
MULIFE.txt,1079110,1079236,126,10,N,N,-,-1,-1
MULIFE.txt,1079115,1079240,125,10,N,N,-,-1,-1
MULIFE.txt,1079125,1079285,160,10,N,N,-,-1,-1
MULIFE.txt,1079163,1079289,126,10,N,N,-,-1,-1
MULIFE.txt,1079168,1079304,136,10,N,N,-,-1,-1
MULIFE.txt,1079173,1079311,138,10,N,N,-,-1,-1
MULIFE.txt,1079179,1079327,148,10,N,N,-,-1,-1
MULIFE.txt,1079184,1079351,167,10,N,N,-,-1,-1
MULIFE.txt,1079222,1079362,140,10,N,N,-,-1,-1
MULIFE.txt,1079227,1079369,142,10,N,N,-,-1,-1
MULIFE.txt,1079237,1079417,180,10,N,N,-,-1,-1
MULIFE.txt,1079242,1079433,191,10,N,N,-,-1,-1
MULIFE.txt,1079286,1079444,158,10,N,N,-,-1,-1
MULIFE.txt,1079290,1079450,160,10,N,N,-,-1,-1
MULIFE.txt,1079306,1079458,152,10,N,N,-,-1,-1
MULIFE.txt,1079312,1079484,172,10,N,N,-,-1,-1
MULIFE.txt,1079328,1079510,182,10,N,N,-,-1,-1
MULIFE.txt,1079352,1079537,185,10,N,N,-,-1,-1
MULIFE.txt,1079364,1079542,178,10,N,N,-,-1,-1
MULIFE.txt,1079370,1079547,177,10,N,N,-,-1,-1
MULIFE.txt,1079418,1079553,135,10,N,N,-,-1,-1
MULIFE.txt,1079434,1079557,123,10,N,N,-,-1,-1
MULIFE.txt,1079445,1079566,121,10,N,N,-,-1,-1
MULIFE.txt,1079452,1079590,138,10,N,N,-,-1,-1
MULIFE.txt,1079459,1079610,151,10,N,N,-,-1,-1
MULIFE.txt,1079486,1079620,134,10,N,N,-,-1,-1
MULIFE.txt,1079511,1079677,166,10,N,N,-,-1,-1
MULIFE.txt,1079538,1079681,143,10,N,N,-,-1,-1
MULIFE.txt,1079543,1079687,144,10,N,N,-,-1,-1
MULIFE.txt,1079548,1079693,145,10,N,N,-,-1,-1
MULIFE.txt,1079554,1079697,143,10,N,N,-,-1,-1
MULIFE.txt,1079559,1079708,149,10,N,N,-,-1,-1
MULIFE.txt,1079567,1079744,177,10,N,N,-,-1,-1
MULIFE.txt,1079592,1079759,167,10,N,N,-,-1,-1
MULIFE.txt,1079613,1079763,150,10,N,N,-,-1,-1
MULIFE.txt,1079621,1079801,180,10,N,N,-,-1,-1
MULIFE.txt,1079678,1079814,136,10,N,N,-,-1,-1
MULIFE.txt,1079683,1079835,152,10,N,N,-,-1,-1
MULIFE.txt,1079688,1079873,185,10,N,N,-,-1,-1
MULIFE.txt,1079694,1079887,193,10,N,N,-,-1,-1
MULIFE.txt,1079700,1079898,198,10,N,N,-,-1,-1
MULIFE.txt,1079709,1079916,207,10,N,N,-,-1,-1
MULIFE.txt,1079745,1079937,192,10,N,N,-,-1,-1
MULIFE.txt,1079760,1079952,192,10,N,N,-,-1,-1
MULIFE.txt,1079768,1079961,193,10,N,N,-,-1,-1
MULIFE.txt,1079804,1079972,168,10,N,N,-,-1,-1
MULIFE.txt,1079815,1079981,166,10,N,N,-,-1,-1
MULIFE.txt,1079836,1079987,151,10,N,N,-,-1,-1
MULIFE.txt,1079874,1080003,129,10,N,N,-,-1,-1
MULIFE.txt,1079890,1080038,148,10,N,N,-,-1,-1
MULIFE.txt,1079899,1080064,165,10,N,N,-,-1,-1
MULIFE.txt,1079917,1080079,162,10,N,N,-,-1,-1
MULIFE.txt,1079938,1080080,142,10,N,N,-,-1,-1
MULIFE.txt,1079954,1080081,127,10,N,N,-,-1,-1
MULIFE.txt,1079962,1080085,123,10,N,N,-,-1,-1
MULIFE.txt,1079973,1080098,125,10,N,N,-,-1,-1
MULIFE.txt,1079982,1080138,156,10,N,N,-,-1,-1
MULIFE.txt,1079990,1080182,192,10,N,N,-,-1,-1
MULIFE.txt,1080004,1080190,186,10,N,N,-,-1,-1
MULIFE.txt,1080039,1080245,206,10,N,N,-,-1,-1
MULIFE.txt,1080065,1080256,191,10,N,N,-,-1,-1
MULIFE.txt,1080079,1080262,183,10,N,N,-,-1,-1
MULIFE.txt,1080080,1080266,186,10,N,N,-,-1,-1
MULIFE.txt,1080082,1080299,217,10,N,N,-,-1,-1
MULIFE.txt,1080090,1080353,263,10,N,N,-,-1,-1
MULIFE.txt,1080099,1080394,295,10,N,N,-,-1,-1
MULIFE.txt,1080139,1080405,266,10,N,N,-,-1,-1
MULIFE.txt,1080183,1080412,229,10,N,N,-,-1,-1
MULIFE.txt,1080192,1080416,224,10,N,N,-,-1,-1
MULIFE.txt,1080246,1080443,197,10,N,N,-,-1,-1
MULIFE.txt,1080257,1080465,208,10,N,N,-,-1,-1
MULIFE.txt,1080263,1080507,244,10,N,N,-,-1,-1
MULIFE.txt,1080267,1080522,255,10,N,N,-,-1,-1
MULIFE.txt,1080302,1080523,221,10,N,N,-,-1,-1
MULIFE.txt,1080356,1080524,168,10,N,N,-,-1,-1
MULIFE.txt,1080395,1080528,133,10,N,N,-,-1,-1
MULIFE.txt,1080406,1080560,154,10,N,N,-,-1,-1
MULIFE.txt,1080413,1080572,159,10,N,N,-,-1,-1
MULIFE.txt,1080419,1080578,159,10,N,N,-,-1,-1
MULIFE.txt,1080444,1080582,138,10,N,N,-,-1,-1
MULIFE.txt,1080468,1080624,156,10,N,N,-,-1,-1
MULIFE.txt,1080508,1080635,127,10,N,N,-,-1,-1
MULIFE.txt,1080522,1080640,118,10,N,N,-,-1,-1
MULIFE.txt,1080523,1080641,118,10,N,N,-,-1,-1
MULIFE.txt,1080525,1080642,117,10,N,N,-,-1,-1
MULIFE.txt,1080531,1080646,115,10,N,N,-,-1,-1
MULIFE.txt,1080562,1080671,109,10,N,N,-,-1,-1
MULIFE.txt,1080573,1080683,110,10,N,N,-,-1,-1
MULIFE.txt,1080579,1080689,110,10,N,N,-,-1,-1
MULIFE.txt,1080585,1080693,108,10,N,N,-,-1,-1
MULIFE.txt,1080625,1080725,100,10,N,N,-,-1,-1
MULIFE.txt,1080636,1080726,90,10,N,N,-,-1,-1
MULIFE.txt,1080640,1080731,91,10,N,N,-,-1,-1
MULIFE.txt,1080641,1080760,119,10,N,N,-,-1,-1
MULIFE.txt,1080643,1080779,136,10,N,N,-,-1,-1
MULIFE.txt,1080649,1080791,142,10,N,N,-,-1,-1
MULIFE.txt,1080672,1080795,123,10,N,N,-,-1,-1
MULIFE.txt,1080684,1080801,117,10,N,N,-,-1,-1
MULIFE.txt,1080690,1080810,120,10,N,N,-,-1,-1
MULIFE.txt,1080696,1080816,120,10,N,N,-,-1,-1
MULIFE.txt,1080725,1080848,123,10,N,N,-,-1,-1
MULIFE.txt,1080726,1080862,136,10,N,N,-,-1,-1
MULIFE.txt,1080736,1080871,135,10,N,N,-,-1,-1
MULIFE.txt,1080763,1080905,142,10,N,N,-,-1,-1
MULIFE.txt,1080780,1080921,141,10,N,N,-,-1,-1
MULIFE.txt,1080792,1080925,133,10,N,N,-,-1,-1
MULIFE.txt,1080797,1080938,141,10,N,N,-,-1,-1
MULIFE.txt,1080802,1080944,142,10,N,N,-,-1,-1
MULIFE.txt,1080811,1080962,151,10,N,N,-,-1,-1
MULIFE.txt,1080819,1080972,153,10,N,N,-,-1,-1
MULIFE.txt,1080851,1080976,125,10,N,N,-,-1,-1
MULIFE.txt,1080863,1080985,122,10,N,N,-,-1,-1
MULIFE.txt,1080873,1080986,113,10,N,N,-,-1,-1
MULIFE.txt,1080908,1080987,79,10,N,N,-,-1,-1
MULIFE.txt,1080922,1081004,82,10,N,N,-,-1,-1
MULIFE.txt,1080926,1081076,150,10,N,N,-,-1,-1
MULIFE.txt,1080939,1081080,141,10,N,N,-,-1,-1
MULIFE.txt,1080946,1081085,139,10,N,N,-,-1,-1
MULIFE.txt,1080964,1081091,127,10,N,N,-,-1,-1
MULIFE.txt,1080973,1081095,122,10,N,N,-,-1,-1
MULIFE.txt,1080977,1081112,135,10,N,N,-,-1,-1
MULIFE.txt,1080985,1081160,175,10,N,N,-,-1,-1
MULIFE.txt,1080986,1081164,178,10,N,N,-,-1,-1
MULIFE.txt,1080989,1081175,186,10,N,N,-,-1,-1
MULIFE.txt,1081005,1081176,171,10,N,N,-,-1,-1
MULIFE.txt,1081077,1081177,100,10,N,N,-,-1,-1
MULIFE.txt,1081081,1081181,100,10,N,N,-,-1,-1
MULIFE.txt,1081086,1081206,120,10,N,N,-,-1,-1
MULIFE.txt,1081092,1081210,118,10,N,N,-,-1,-1
MULIFE.txt,1081097,1081224,127,10,N,N,-,-1,-1
MULIFE.txt,1081113,1081228,115,10,N,N,-,-1,-1
MULIFE.txt,1081161,1081283,122,10,N,N,-,-1,-1
MULIFE.txt,1081167,1081316,149,10,N,N,-,-1,-1
MULIFE.txt,1081175,1081380,205,10,N,N,-,-1,-1
MULIFE.txt,1081176,1081385,209,10,N,N,-,-1,-1
MULIFE.txt,1081178,1081396,218,10,N,N,-,-1,-1
MULIFE.txt,1081183,1081400,217,10,N,N,-,-1,-1
MULIFE.txt,1081207,1081411,204,10,N,N,-,-1,-1
MULIFE.txt,1081211,1081479,268,10,N,N,-,-1,-1
MULIFE.txt,1081225,1081496,271,10,N,N,-,-1,-1
MULIFE.txt,1081231,1081500,269,10,N,N,-,-1,-1
MULIFE.txt,1081284,1081622,338,10,N,N,-,-1,-1
MULIFE.txt,1081319,1081638,319,10,N,N,-,-1,-1
MULIFE.txt,1081382,1081642,260,10,N,N,-,-1,-1
MULIFE.txt,1081386,1081698,312,10,N,N,-,-1,-1
MULIFE.txt,1081397,1081746,349,10,N,N,-,-1,-1
MULIFE.txt,1081403,1081778,375,10,N,N,-,-1,-1
MULIFE.txt,1081412,1081927,515,10,N,N,-,-1,-1
MULIFE.txt,1081480,1081952,472,10,N,N,-,-1,-1
MULIFE.txt,1081497,1081957,460,10,N,N,-,-1,-1
MULIFE.txt,1081503,1081964,461,10,N,N,-,-1,-1
MULIFE.txt,1081623,1081969,346,10,N,N,-,-1,-1
MULIFE.txt,1081639,1081990,351,10,N,N,-,-1,-1
MULIFE.txt,1081647,1082071,424,10,N,N,-,-1,-1
MULIFE.txt,1081703,1082088,385,10,N,N,-,-1,-1
MULIFE.txt,1081751,1082093,342,10,N,N,-,-1,-1
MULIFE.txt,1081781,1082118,337,10,N,N,-,-1,-1
MULIFE.txt,1081928,1082232,304,10,N,N,-,-1,-1
MULIFE.txt,1081953,1082237,284,10,N,N,-,-1,-1
MULIFE.txt,1081958,1082246,288,10,N,N,-,-1,-1
MULIFE.txt,1081965,1082331,366,10,N,N,-,-1,-1
MULIFE.txt,1081971,1082469,498,10,N,N,-,-1,-1
MULIFE.txt,1081991,1082508,517,10,N,N,-,-1,-1
MULIFE.txt,1082072,1082525,453,10,N,N,-,-1,-1
MULIFE.txt,1082089,1082529,440,10,N,N,-,-1,-1
MULIFE.txt,1082096,1082539,443,10,N,N,-,-1,-1
MULIFE.txt,1082119,1082543,424,10,N,N,-,-1,-1
MULIFE.txt,1082233,1082548,315,10,N,N,-,-1,-1
MULIFE.txt,1082239,1082674,435,10,N,N,-,-1,-1
MULIFE.txt,1082247,1082785,538,10,N,N,-,-1,-1
MULIFE.txt,1082332,1082794,462,10,N,N,-,-1,-1
MULIFE.txt,1082471,1082795,324,10,N,N,-,-1,-1
MULIFE.txt,1082510,1082808,298,10,N,N,-,-1,-1
MULIFE.txt,1082526,1082846,320,10,N,N,-,-1,-1
MULIFE.txt,1082530,1082871,341,10,N,N,-,-1,-1
MULIFE.txt,1082540,1082908,368,10,N,N,-,-1,-1
MULIFE.txt,1082544,1082943,399,10,N,N,-,-1,-1
MULIFE.txt,1082550,1082954,404,10,N,N,-,-1,-1
MULIFE.txt,1082675,1082966,291,10,N,N,-,-1,-1
MULIFE.txt,1082786,1082994,208,10,N,N,-,-1,-1
MULIFE.txt,1082794,1083047,253,10,N,N,-,-1,-1
MULIFE.txt,1082797,1083059,262,10,N,N,-,-1,-1
MULIFE.txt,1082809,1083065,256,10,N,N,-,-1,-1
MULIFE.txt,1082847,1083069,222,10,N,N,-,-1,-1
MULIFE.txt,1082872,1083078,206,10,N,N,-,-1,-1
MULIFE.txt,1082909,1083153,244,10,N,N,-,-1,-1
MULIFE.txt,1082944,1083189,245,10,N,N,-,-1,-1
MULIFE.txt,1082956,1083211,255,10,N,N,-,-1,-1
MULIFE.txt,1082967,1083235,268,10,N,N,-,-1,-1
MULIFE.txt,1082995,1083254,259,10,N,N,-,-1,-1
MULIFE.txt,1083048,1083265,217,10,N,N,-,-1,-1
MULIFE.txt,1083060,1083321,261,10,N,N,-,-1,-1
MULIFE.txt,1083066,1083343,277,10,N,N,-,-1,-1
MULIFE.txt,1083072,1083387,315,10,N,N,-,-1,-1
MULIFE.txt,1083079,1083399,320,10,N,N,-,-1,-1
MULIFE.txt,1083154,1083405,251,10,N,N,-,-1,-1
MULIFE.txt,1083190,1083409,219,10,N,N,-,-1,-1
MULIFE.txt,1083212,1083414,202,10,N,N,-,-1,-1
MULIFE.txt,1083237,1083424,187,10,N,N,-,-1,-1
MULIFE.txt,1083257,1083471,214,10,N,N,-,-1,-1
MULIFE.txt,1083266,1083521,255,10,N,N,-,-1,-1
MULIFE.txt,1083322,1083538,216,10,N,N,-,-1,-1
MULIFE.txt,1083344,1083542,198,10,N,N,-,-1,-1
MULIFE.txt,1083388,1083552,164,10,N,N,-,-1,-1
MULIFE.txt,1083400,1083570,170,10,N,N,-,-1,-1
MULIFE.txt,1083406,1083597,191,10,N,N,-,-1,-1
MULIFE.txt,1083410,1083680,270,10,N,N,-,-1,-1
MULIFE.txt,1083417,1083693,276,10,N,N,-,-1,-1
MULIFE.txt,1083425,1083697,272,10,N,N,-,-1,-1
MULIFE.txt,1083472,1083707,235,10,N,N,-,-1,-1
MULIFE.txt,1083523,1083747,224,10,N,N,-,-1,-1
MULIFE.txt,1083539,1083781,242,10,N,N,-,-1,-1
MULIFE.txt,1083545,1083798,253,10,N,N,-,-1,-1
MULIFE.txt,1083553,1083802,249,10,N,N,-,-1,-1
MULIFE.txt,1083571,1083814,243,10,N,N,-,-1,-1
MULIFE.txt,1083598,1083863,265,10,N,N,-,-1,-1
MULIFE.txt,1083681,1083911,230,10,N,N,-,-1,-1
MULIFE.txt,1083693,1083929,236,10,N,N,-,-1,-1
MULIFE.txt,1083699,1083968,269,10,N,N,-,-1,-1
MULIFE.txt,1083708,1084004,296,10,N,N,-,-1,-1
MULIFE.txt,1083748,1084015,267,10,N,N,-,-1,-1
MULIFE.txt,1083782,1084020,238,10,N,N,-,-1,-1
MULIFE.txt,1083799,1084029,230,10,N,N,-,-1,-1
MULIFE.txt,1083807,1084060,253,10,N,N,-,-1,-1
MULIFE.txt,1083815,1084076,261,10,N,N,-,-1,-1
MULIFE.txt,1083864,1084086,222,10,N,N,-,-1,-1
MULIFE.txt,1083913,1084090,177,10,N,N,-,-1,-1
MULIFE.txt,1083930,1084112,182,10,N,N,-,-1,-1
MULIFE.txt,1083969,1084133,164,10,N,N,-,-1,-1
MULIFE.txt,1084005,1084151,146,10,N,N,-,-1,-1
MULIFE.txt,1084016,1084162,146,10,N,N,-,-1,-1
MULIFE.txt,1084022,1084168,146,10,N,N,-,-1,-1
MULIFE.txt,1084030,1084172,142,10,N,N,-,-1,-1
MULIFE.txt,1084061,1084218,157,10,N,N,-,-1,-1
MULIFE.txt,1084077,1084267,190,10,N,N,-,-1,-1
MULIFE.txt,1084087,1084279,192,10,N,N,-,-1,-1
MULIFE.txt,1084092,1084285,193,10,N,N,-,-1,-1
MULIFE.txt,1084114,1084289,175,10,N,N,-,-1,-1
MULIFE.txt,1084134,1084300,166,10,N,N,-,-1,-1
MULIFE.txt,1084152,1084323,171,10,N,N,-,-1,-1
MULIFE.txt,1084163,1084341,178,10,N,N,-,-1,-1
MULIFE.txt,1084169,1084345,176,10,N,N,-,-1,-1
MULIFE.txt,1084174,1084373,199,10,N,N,-,-1,-1
MULIFE.txt,1084219,1084427,208,10,N,N,-,-1,-1
MULIFE.txt,1084268,1084438,170,10,N,N,-,-1,-1
MULIFE.txt,1084280,1084444,164,10,N,N,-,-1,-1
MULIFE.txt,1084286,1084448,162,10,N,N,-,-1,-1
MULIFE.txt,1084291,1084471,180,10,N,N,-,-1,-1
MULIFE.txt,1084301,1084521,220,10,N,N,-,-1,-1
MULIFE.txt,1084326,1084535,209,10,N,N,-,-1,-1
MULIFE.txt,1084342,1084555,213,10,N,N,-,-1,-1
MULIFE.txt,1084348,1084642,294,10,N,N,-,-1,-1
MULIFE.txt,1084374,1084700,326,10,N,N,-,-1,-1
MULIFE.txt,1084428,1084705,277,10,N,N,-,-1,-1
MULIFE.txt,1084439,1084712,273,10,N,N,-,-1,-1
MULIFE.txt,1084445,1084717,272,10,N,N,-,-1,-1
MULIFE.txt,1084450,1084722,272,10,N,N,-,-1,-1
MULIFE.txt,1084472,1084808,336,10,N,N,-,-1,-1
MULIFE.txt,1084523,1084865,342,10,N,N,-,-1,-1
MULIFE.txt,1084537,1084877,340,10,N,N,-,-1,-1
MULIFE.txt,1084557,1084881,324,10,N,N,-,-1,-1
MULIFE.txt,1084643,1084886,243,10,N,N,-,-1,-1
MULIFE.txt,1084701,1084897,196,10,N,N,-,-1,-1
MULIFE.txt,1084706,1084976,270,10,N,N,-,-1,-1
MULIFE.txt,1084713,1085025,312,10,N,N,-,-1,-1
MULIFE.txt,1084718,1085032,314,10,N,N,-,-1,-1
MULIFE.txt,1084724,1085036,312,10,N,N,-,-1,-1
MULIFE.txt,1084809,1085044,235,10,N,N,-,-1,-1
MULIFE.txt,1084867,1085094,227,10,N,N,-,-1,-1
MULIFE.txt,1084878,1085116,238,10,N,N,-,-1,-1
MULIFE.txt,1084882,1085127,245,10,N,N,-,-1,-1
MULIFE.txt,1084889,1085131,242,10,N,N,-,-1,-1
MULIFE.txt,1084898,1085136,238,10,N,N,-,-1,-1
MULIFE.txt,1084977,1085142,165,10,N,N,-,-1,-1
MULIFE.txt,1085026,1085148,122,10,N,N,-,-1,-1
MULIFE.txt,1085033,1085159,126,10,N,N,-,-1,-1
MULIFE.txt,1085038,1085196,158,10,N,N,-,-1,-1
MULIFE.txt,1085045,1085222,177,10,N,N,-,-1,-1
MULIFE.txt,1085095,1085233,138,10,N,N,-,-1,-1
MULIFE.txt,1085117,1085237,120,10,N,N,-,-1,-1
MULIFE.txt,1085128,1085242,114,10,N,N,-,-1,-1
MULIFE.txt,1085132,1085258,126,10,N,N,-,-1,-1
MULIFE.txt,1085137,1085284,147,10,N,N,-,-1,-1
MULIFE.txt,1085143,1085289,146,10,N,N,-,-1,-1
MULIFE.txt,1085150,1085296,146,10,N,N,-,-1,-1
MULIFE.txt,1085160,1085302,142,10,N,N,-,-1,-1
MULIFE.txt,1085197,1085306,109,10,N,N,-,-1,-1
MULIFE.txt,1085223,1085311,88,10,N,N,-,-1,-1
MULIFE.txt,1085234,1085332,98,10,N,N,-,-1,-1
MULIFE.txt,1085238,1085378,140,10,N,N,-,-1,-1
MULIFE.txt,1085244,1085384,140,10,N,N,-,-1,-1
MULIFE.txt,1085260,1085389,129,10,N,N,-,-1,-1
MULIFE.txt,1085285,1085395,110,10,N,N,-,-1,-1
MULIFE.txt,1085292,1085399,107,10,N,N,-,-1,-1
MULIFE.txt,1085297,1085404,107,10,N,N,-,-1,-1
MULIFE.txt,1085303,1085418,115,10,N,N,-,-1,-1
MULIFE.txt,1085307,1085423,116,10,N,N,-,-1,-1
MULIFE.txt,1085314,1085433,119,10,N,N,-,-1,-1
MULIFE.txt,1085333,1085437,104,10,N,N,-,-1,-1
MULIFE.txt,1085380,1085442,62,10,N,N,-,-1,-1
MULIFE.txt,1085385,1085466,81,10,N,N,-,-1,-1
MULIFE.txt,1085390,1085471,81,10,N,N,-,-1,-1
MULIFE.txt,1085396,1085483,87,10,N,N,-,-1,-1
MULIFE.txt,1085400,1085487,87,10,N,N,-,-1,-1
MULIFE.txt,1085406,1085492,86,10,N,N,-,-1,-1
MULIFE.txt,1085419,1085511,92,10,N,N,-,-1,-1
MULIFE.txt,1085424,1085542,118,10,N,N,-,-1,-1
MULIFE.txt,1085434,1085553,119,10,N,N,-,-1,-1
MULIFE.txt,1085438,1085559,121,10,N,N,-,-1,-1
MULIFE.txt,1085444,1085563,119,10,N,N,-,-1,-1
MULIFE.txt,1085467,1085592,125,10,N,N,-,-1,-1
MULIFE.txt,1085472,1085605,133,10,N,N,-,-1,-1
MULIFE.txt,1085484,1085611,127,10,N,N,-,-1,-1
MULIFE.txt,1085488,1085615,127,10,N,N,-,-1,-1
MULIFE.txt,1085494,1085647,153,10,N,N,-,-1,-1
MULIFE.txt,1085512,1085660,148,10,N,N,-,-1,-1
MULIFE.txt,1085543,1085666,123,10,N,N,-,-1,-1
MULIFE.txt,1085554,1085669,115,10,N,N,-,-1,-1
MULIFE.txt,1085560,1085671,111,10,N,N,-,-1,-1
MULIFE.txt,1085565,1085684,119,10,N,N,-,-1,-1
MULIFE.txt,1085595,1085734,139,10,N,N,-,-1,-1
MULIFE.txt,1085606,1085747,141,10,N,N,-,-1,-1
MULIFE.txt,1085612,1085798,186,10,N,N,-,-1,-1
MULIFE.txt,1085617,1085849,232,10,N,N,-,-1,-1
MULIFE.txt,1085650,1085879,229,10,N,N,-,-1,-1
MULIFE.txt,1085661,1085922,261,10,N,N,-,-1,-1
MULIFE.txt,1085667,1085990,323,10,N,N,-,-1,-1
MULIFE.txt,1085669,1086014,345,10,N,N,-,-1,-1
MULIFE.txt,1085674,1086026,352,10,N,N,-,-1,-1
MULIFE.txt,1085685,1086032,347,10,N,N,-,-1,-1
MULIFE.txt,1085735,1086067,332,10,N,N,-,-1,-1
MULIFE.txt,1085752,1086099,347,10,N,N,-,-1,-1
MULIFE.txt,1085799,1086103,304,10,N,N,-,-1,-1
MULIFE.txt,1085854,1086110,256,10,N,N,-,-1,-1
MULIFE.txt,1085880,1086148,268,10,N,N,-,-1,-1
MULIFE.txt,1085923,1086154,231,10,N,N,-,-1,-1
MULIFE.txt,1085991,1086186,195,10,N,N,-,-1,-1
MULIFE.txt,1086016,1086192,176,10,N,N,-,-1,-1
MULIFE.txt,1086027,1086202,175,10,N,N,-,-1,-1
MULIFE.txt,1086035,1086208,173,10,N,N,-,-1,-1
MULIFE.txt,1086069,1086212,143,10,N,N,-,-1,-1
MULIFE.txt,1086100,1086233,133,10,N,N,-,-1,-1
MULIFE.txt,1086106,1086237,131,10,N,N,-,-1,-1
MULIFE.txt,1086111,1086249,138,10,N,N,-,-1,-1
MULIFE.txt,1086150,1086255,105,10,N,N,-,-1,-1
MULIFE.txt,1086155,1086260,105,10,N,N,-,-1,-1
MULIFE.txt,1086189,1086297,108,10,N,N,-,-1,-1
MULIFE.txt,1086193,1086301,108,10,N,N,-,-1,-1
MULIFE.txt,1086204,1086306,102,10,N,N,-,-1,-1
MULIFE.txt,1086209,1086308,99,10,N,N,-,-1,-1
MULIFE.txt,1086213,1086311,98,10,N,N,-,-1,-1
MULIFE.txt,1086234,1086312,78,10,N,N,-,-1,-1
MULIFE.txt,1086240,1086313,73,10,N,N,-,-1,-1
MULIFE.txt,1086251,1086319,68,10,N,N,-,-1,-1
MULIFE.txt,1086256,1086323,67,10,N,N,-,-1,-1
MULIFE.txt,1086261,1086360,99,10,N,N,-,-1,-1
MULIFE.txt,1086298,1086371,73,10,N,N,-,-1,-1
MULIFE.txt,1086302,1086377,75,10,N,N,-,-1,-1
MULIFE.txt,1086307,1086422,115,10,N,N,-,-1,-1
MULIFE.txt,1086309,1086430,121,10,N,N,-,-1,-1
MULIFE.txt,1086311,1086452,141,10,N,N,-,-1,-1
MULIFE.txt,1086312,1086518,206,10,N,N,-,-1,-1
MULIFE.txt,1086315,1086538,223,10,N,N,-,-1,-1
MULIFE.txt,1086320,1086542,222,10,N,N,-,-1,-1
MULIFE.txt,1086324,1086547,223,10,N,N,-,-1,-1
MULIFE.txt,1086361,1086556,195,10,N,N,-,-1,-1
MULIFE.txt,1086372,1086576,204,10,N,N,-,-1,-1
MULIFE.txt,1086379,1086595,216,10,N,N,-,-1,-1
MULIFE.txt,1086423,1086643,220,10,N,N,-,-1,-1
MULIFE.txt,1086431,1086654,223,10,N,N,-,-1,-1
MULIFE.txt,1086453,1086660,207,10,N,N,-,-1,-1
MULIFE.txt,1086520,1086664,144,10,N,N,-,-1,-1
MULIFE.txt,1086539,1086691,152,10,N,N,-,-1,-1
MULIFE.txt,1086543,1086764,221,10,N,N,-,-1,-1
MULIFE.txt,1086548,1086781,233,10,N,N,-,-1,-1
MULIFE.txt,1086559,1086785,226,10,N,N,-,-1,-1
MULIFE.txt,1086579,1086922,343,10,N,N,-,-1,-1
MULIFE.txt,1086596,1086936,340,10,N,N,-,-1,-1
MULIFE.txt,1086644,1086941,297,10,N,N,-,-1,-1
MULIFE.txt,1086655,1087042,387,10,N,N,-,-1,-1
MULIFE.txt,1086661,1087053,392,10,N,N,-,-1,-1
MULIFE.txt,1086667,1087057,390,10,N,N,-,-1,-1
MULIFE.txt,1086692,1087062,370,10,N,N,-,-1,-1
MULIFE.txt,1086765,1087187,422,10,N,N,-,-1,-1
MULIFE.txt,1086782,1087197,415,10,N,N,-,-1,-1
MULIFE.txt,1086788,1087201,413,10,N,N,-,-1,-1
MULIFE.txt,1086923,1087206,283,10,N,N,-,-1,-1
MULIFE.txt,1086937,1087232,295,10,N,N,-,-1,-1
MULIFE.txt,1086944,1087290,346,10,N,N,-,-1,-1
MULIFE.txt,1087043,1087325,282,10,N,N,-,-1,-1
MULIFE.txt,1087054,1087336,282,10,N,N,-,-1,-1
MULIFE.txt,1087058,1087342,284,10,N,N,-,-1,-1
MULIFE.txt,1087065,1087346,281,10,N,N,-,-1,-1
MULIFE.txt,1087188,1087351,163,10,N,N,-,-1,-1
MULIFE.txt,1087198,1087362,164,10,N,N,-,-1,-1
MULIFE.txt,1087202,1087411,209,10,N,N,-,-1,-1
MULIFE.txt,1087209,1087435,226,10,N,N,-,-1,-1
MULIFE.txt,1087233,1087465,232,10,N,N,-,-1,-1
MULIFE.txt,1087291,1087476,185,10,N,N,-,-1,-1
MULIFE.txt,1087326,1087482,156,10,N,N,-,-1,-1
MULIFE.txt,1087337,1087486,149,10,N,N,-,-1,-1
MULIFE.txt,1087343,1087491,148,10,N,N,-,-1,-1
MULIFE.txt,1087347,1087529,182,10,N,N,-,-1,-1
MULIFE.txt,1087354,1087555,201,10,N,N,-,-1,-1
MULIFE.txt,1087363,1087580,217,10,N,N,-,-1,-1
MULIFE.txt,1087412,1087595,183,10,N,N,-,-1,-1
MULIFE.txt,1087436,1087601,165,10,N,N,-,-1,-1
MULIFE.txt,1087466,1087623,157,10,N,N,-,-1,-1
MULIFE.txt,1087477,1087648,171,10,N,N,-,-1,-1
MULIFE.txt,1087483,1087667,184,10,N,N,-,-1,-1
MULIFE.txt,1087487,1087680,193,10,N,N,-,-1,-1
MULIFE.txt,1087493,1087717,224,10,N,N,-,-1,-1
MULIFE.txt,1087531,1087735,204,10,N,N,-,-1,-1
MULIFE.txt,1087556,1087785,229,10,N,N,-,-1,-1
MULIFE.txt,1087581,1087801,220,10,N,N,-,-1,-1
MULIFE.txt,1087595,1087813,218,10,N,N,-,-1,-1
MULIFE.txt,1087604,1087909,305,10,N,N,-,-1,-1
MULIFE.txt,1087624,1087939,315,10,N,N,-,-1,-1
MULIFE.txt,1087649,1087988,339,10,N,N,-,-1,-1
MULIFE.txt,1087672,1087999,327,10,N,N,-,-1,-1
MULIFE.txt,1087681,1088027,346,10,N,N,-,-1,-1
MULIFE.txt,1087718,1088032,314,10,N,N,-,-1,-1
MULIFE.txt,1087737,1088060,323,10,N,N,-,-1,-1
MULIFE.txt,1087786,1088073,287,10,N,N,-,-1,-1
MULIFE.txt,1087804,1088079,275,10,N,N,-,-1,-1
MULIFE.txt,1087814,1088083,269,10,N,N,-,-1,-1
MULIFE.txt,1087910,1088088,178,10,N,N,-,-1,-1
MULIFE.txt,1087940,1088115,175,10,N,N,-,-1,-1
MULIFE.txt,1087989,1088129,140,10,N,N,-,-1,-1
MULIFE.txt,1088000,1088133,133,10,N,N,-,-1,-1
MULIFE.txt,1088028,1088138,110,10,N,N,-,-1,-1
MULIFE.txt,1088034,1088182,148,10,N,N,-,-1,-1
MULIFE.txt,1088061,1088187,126,10,N,N,-,-1,-1
MULIFE.txt,1088074,1088197,123,10,N,N,-,-1,-1
MULIFE.txt,1088080,1088201,121,10,N,N,-,-1,-1
MULIFE.txt,1088084,1088206,122,10,N,N,-,-1,-1
MULIFE.txt,1088090,1088236,146,10,N,N,-,-1,-1
MULIFE.txt,1088116,1088243,127,10,N,N,-,-1,-1
MULIFE.txt,1088130,1088249,119,10,N,N,-,-1,-1
MULIFE.txt,1088134,1088254,120,10,N,N,-,-1,-1
MULIFE.txt,1088140,1088265,125,10,N,N,-,-1,-1
MULIFE.txt,1088183,1088326,143,10,N,N,-,-1,-1
MULIFE.txt,1088188,1088381,193,10,N,N,-,-1,-1
MULIFE.txt,1088198,1088391,193,10,N,N,-,-1,-1
MULIFE.txt,1088202,1088402,200,10,N,N,-,-1,-1
MULIFE.txt,1088208,1088446,238,10,N,N,-,-1,-1
MULIFE.txt,1088238,1088590,352,10,N,N,-,-1,-1
MULIFE.txt,1088244,1088627,383,10,N,N,-,-1,-1
MULIFE.txt,1088250,1088673,423,10,N,N,-,-1,-1
MULIFE.txt,1088257,1088722,465,10,N,N,-,-1,-1
MULIFE.txt,1088266,1088757,491,10,N,N,-,-1,-1
MULIFE.txt,1088327,1088761,434,10,N,N,-,-1,-1
MULIFE.txt,1088382,1088766,384,10,N,N,-,-1,-1
MULIFE.txt,1088394,1088772,378,10,N,N,-,-1,-1
MULIFE.txt,1088403,1088784,381,10,N,N,-,-1,-1
MULIFE.txt,1088447,1088825,378,10,N,N,-,-1,-1
MULIFE.txt,1088591,1088847,256,10,N,N,-,-1,-1
MULIFE.txt,1088628,1088870,242,10,N,N,-,-1,-1
MULIFE.txt,1088674,1088882,208,10,N,N,-,-1,-1
MULIFE.txt,1088723,1088888,165,10,N,N,-,-1,-1
MULIFE.txt,1088758,1088900,142,10,N,N,-,-1,-1
MULIFE.txt,1088762,1089083,321,10,N,N,-,-1,-1
MULIFE.txt,1088767,1089119,352,10,N,N,-,-1,-1
MULIFE.txt,1088775,1089130,355,10,N,N,-,-1,-1
MULIFE.txt,1088785,1089136,351,10,N,N,-,-1,-1
MULIFE.txt,1088826,1089145,319,10,N,N,-,-1,-1
MULIFE.txt,1088848,1089208,360,10,N,N,-,-1,-1
MULIFE.txt,1088872,1089295,423,10,N,N,-,-1,-1
MULIFE.txt,1088883,1089343,460,10,N,N,-,-1,-1
MULIFE.txt,1088891,1089355,464,10,N,N,-,-1,-1
MULIFE.txt,1088901,1089365,464,10,N,N,-,-1,-1
MULIFE.txt,1089084,1089376,292,10,N,N,-,-1,-1
MULIFE.txt,1089120,1089408,288,10,N,N,-,-1,-1
MULIFE.txt,1089131,1089436,305,10,N,N,-,-1,-1
MULIFE.txt,1089139,1089502,363,10,N,N,-,-1,-1
MULIFE.txt,1089146,1089508,362,10,N,N,-,-1,-1
MULIFE.txt,1089209,1089515,306,10,N,N,-,-1,-1
MULIFE.txt,1089296,1089520,224,10,N,N,-,-1,-1
MULIFE.txt,1089345,1089575,230,10,N,N,-,-1,-1
MULIFE.txt,1089356,1089612,256,10,N,N,-,-1,-1
MULIFE.txt,1089368,1089714,346,10,N,N,-,-1,-1
MULIFE.txt,1089377,1089725,348,10,N,N,-,-1,-1
MULIFE.txt,1089409,1089808,399,10,N,N,-,-1,-1
MULIFE.txt,1089437,1089836,399,10,N,N,-,-1,-1
MULIFE.txt,1089504,1089861,357,10,N,N,-,-1,-1
MULIFE.txt,1089509,1089865,356,10,N,N,-,-1,-1
MULIFE.txt,1089516,1089898,382,10,N,N,-,-1,-1
MULIFE.txt,1089525,1089942,417,10,N,N,-,-1,-1
MULIFE.txt,1089580,1089957,377,10,N,N,-,-1,-1
MULIFE.txt,1089615,1089958,343,10,N,N,-,-1,-1
MULIFE.txt,1089717,1089959,242,10,N,N,-,-1,-1
MULIFE.txt,1089726,1089963,237,10,N,N,-,-1,-1
MULIFE.txt,1089809,1090038,229,10,N,N,-,-1,-1
MULIFE.txt,1089837,1090057,220,10,N,N,-,-1,-1
MULIFE.txt,1089862,1090097,235,10,N,N,-,-1,-1
MULIFE.txt,1089868,1090108,240,10,N,N,-,-1,-1
MULIFE.txt,1089901,1090117,216,10,N,N,-,-1,-1
MULIFE.txt,1089943,1090157,214,10,N,N,-,-1,-1
MULIFE.txt,1089957,1090171,214,10,N,N,-,-1,-1
MULIFE.txt,1089958,1090192,234,10,N,N,-,-1,-1
MULIFE.txt,1089960,1090198,238,10,N,N,-,-1,-1
MULIFE.txt,1089965,1090221,256,10,N,N,-,-1,-1
MULIFE.txt,1090039,1090232,193,10,N,N,-,-1,-1
MULIFE.txt,1090059,1090240,181,10,N,N,-,-1,-1
MULIFE.txt,1090098,1090244,146,10,N,N,-,-1,-1
MULIFE.txt,1090109,1090263,154,10,N,N,-,-1,-1
MULIFE.txt,1090119,1090267,148,10,N,N,-,-1,-1
MULIFE.txt,1090158,1090272,114,10,N,N,-,-1,-1
MULIFE.txt,1090172,1090278,106,10,N,N,-,-1,-1
MULIFE.txt,1090193,1090282,89,10,N,N,-,-1,-1
MULIFE.txt,1090200,1090440,240,10,N,N,-,-1,-1
MULIFE.txt,1090222,1090456,234,10,N,N,-,-1,-1
MULIFE.txt,1090233,1090460,227,10,N,N,-,-1,-1
MULIFE.txt,1090241,1090472,231,10,N,N,-,-1,-1
MULIFE.txt,1090247,1090503,256,10,N,N,-,-1,-1
MULIFE.txt,1090264,1090604,340,10,N,N,-,-1,-1
MULIFE.txt,1090268,1090614,346,10,N,N,-,-1,-1
MULIFE.txt,1090273,1090615,342,10,N,N,-,-1,-1
MULIFE.txt,1090279,1090616,337,10,N,N,-,-1,-1
MULIFE.txt,1090284,1090628,344,10,N,N,-,-1,-1
MULIFE.txt,1090441,1090706,265,10,N,N,-,-1,-1
MULIFE.txt,1090457,1090777,320,10,N,N,-,-1,-1
MULIFE.txt,1090463,1090809,346,10,N,N,-,-1,-1
MULIFE.txt,1090473,1090820,347,10,N,N,-,-1,-1
MULIFE.txt,1090504,1090830,326,10,N,N,-,-1,-1
MULIFE.txt,1090605,1090901,296,10,N,N,-,-1,-1
MULIFE.txt,1090614,1090925,311,10,N,N,-,-1,-1
MULIFE.txt,1090615,1090940,325,10,N,N,-,-1,-1
MULIFE.txt,1090619,1090951,332,10,N,N,-,-1,-1
MULIFE.txt,1090629,1090955,326,10,N,N,-,-1,-1
MULIFE.txt,1090707,1090966,259,10,N,N,-,-1,-1
MULIFE.txt,1090778,1091020,242,10,N,N,-,-1,-1
MULIFE.txt,1090810,1091027,217,10,N,N,-,-1,-1
MULIFE.txt,1090823,1091037,214,10,N,N,-,-1,-1
MULIFE.txt,1090831,1091059,228,10,N,N,-,-1,-1
MULIFE.txt,1090902,1091078,176,10,N,N,-,-1,-1
MULIFE.txt,1090926,1091092,166,10,N,N,-,-1,-1
MULIFE.txt,1090941,1091113,172,10,N,N,-,-1,-1
MULIFE.txt,1090952,1091119,167,10,N,N,-,-1,-1
MULIFE.txt,1090960,1091146,186,10,N,N,-,-1,-1
MULIFE.txt,1090967,1091158,191,10,N,N,-,-1,-1
MULIFE.txt,1091022,1091167,145,10,N,N,-,-1,-1
MULIFE.txt,1091028,1091201,173,10,N,N,-,-1,-1
MULIFE.txt,1091040,1091238,198,10,N,N,-,-1,-1
MULIFE.txt,1091061,1091244,183,10,N,N,-,-1,-1
MULIFE.txt,1091079,1091251,172,10,N,N,-,-1,-1
MULIFE.txt,1091095,1091285,190,10,N,N,-,-1,-1
MULIFE.txt,1091114,1091294,180,10,N,N,-,-1,-1
MULIFE.txt,1091121,1091305,184,10,N,N,-,-1,-1
MULIFE.txt,1091147,1091312,165,10,N,N,-,-1,-1
MULIFE.txt,1091159,1091316,157,10,N,N,-,-1,-1
MULIFE.txt,1091172,1091322,150,10,N,N,-,-1,-1
MULIFE.txt,1091204,1091377,173,10,N,N,-,-1,-1
MULIFE.txt,1091240,1091388,148,10,N,N,-,-1,-1
MULIFE.txt,1091245,1091392,147,10,N,N,-,-1,-1
MULIFE.txt,1091254,1091396,142,10,N,N,-,-1,-1
MULIFE.txt,1091286,1091414,128,10,N,N,-,-1,-1
MULIFE.txt,1091295,1091457,162,10,N,N,-,-1,-1
MULIFE.txt,1091306,1091468,162,10,N,N,-,-1,-1
MULIFE.txt,1091313,1091514,201,10,N,N,-,-1,-1
MULIFE.txt,1091317,1091522,205,10,N,N,-,-1,-1
MULIFE.txt,1091325,1091527,202,10,N,N,-,-1,-1
MULIFE.txt,1091378,1091533,155,10,N,N,-,-1,-1
MULIFE.txt,1091389,1091534,145,10,N,N,-,-1,-1
MULIFE.txt,1091393,1091535,142,10,N,N,-,-1,-1
MULIFE.txt,1091398,1091618,220,10,N,N,-,-1,-1
MULIFE.txt,1091417,1091702,285,10,N,N,-,-1,-1
MULIFE.txt,1091458,1091719,261,10,N,N,-,-1,-1
MULIFE.txt,1091471,1091815,344,10,N,N,-,-1,-1
MULIFE.txt,1091515,1091819,304,10,N,N,-,-1,-1
MULIFE.txt,1091523,1091824,301,10,N,N,-,-1,-1
MULIFE.txt,1091528,1091849,321,10,N,N,-,-1,-1
MULIFE.txt,1091533,1091927,394,10,N,N,-,-1,-1
MULIFE.txt,1091534,1091931,397,10,N,N,-,-1,-1
MULIFE.txt,1091538,1091964,426,10,N,N,-,-1,-1
MULIFE.txt,1091619,1092042,423,10,N,N,-,-1,-1
MULIFE.txt,1091703,1092046,343,10,N,N,-,-1,-1
MULIFE.txt,1091722,1092075,353,10,N,N,-,-1,-1
MULIFE.txt,1091816,1092122,306,10,N,N,-,-1,-1
MULIFE.txt,1091820,1092130,310,10,N,N,-,-1,-1
MULIFE.txt,1091825,1092143,318,10,N,N,-,-1,-1
MULIFE.txt,1091850,1092150,300,10,N,N,-,-1,-1
MULIFE.txt,1091928,1092156,228,10,N,N,-,-1,-1
MULIFE.txt,1091932,1092196,264,10,N,N,-,-1,-1
MULIFE.txt,1091965,1092208,243,10,N,N,-,-1,-1
MULIFE.txt,1092043,1092212,169,10,N,N,-,-1,-1
MULIFE.txt,1092047,1092217,170,10,N,N,-,-1,-1
MULIFE.txt,1092077,1092223,146,10,N,N,-,-1,-1
MULIFE.txt,1092123,1092227,104,10,N,N,-,-1,-1
MULIFE.txt,1092131,1092242,111,10,N,N,-,-1,-1
MULIFE.txt,1092144,1092269,125,10,N,N,-,-1,-1
MULIFE.txt,1092151,1092299,148,10,N,N,-,-1,-1
MULIFE.txt,1092158,1092377,219,10,N,N,-,-1,-1
MULIFE.txt,1092197,1092381,184,10,N,N,-,-1,-1
MULIFE.txt,1092209,1092392,183,10,N,N,-,-1,-1
MULIFE.txt,1092213,1092437,224,10,N,N,-,-1,-1
MULIFE.txt,1092218,1092513,295,10,N,N,-,-1,-1
MULIFE.txt,1092224,1092517,293,10,N,N,-,-1,-1
MULIFE.txt,1092230,1092522,292,10,N,N,-,-1,-1
MULIFE.txt,1092243,1092528,285,10,N,N,-,-1,-1
MULIFE.txt,1092274,1092627,353,10,N,N,-,-1,-1
MULIFE.txt,1092300,1092632,332,10,N,N,-,-1,-1
MULIFE.txt,1092378,1092637,259,10,N,N,-,-1,-1
MULIFE.txt,1092383,1092638,255,10,N,N,-,-1,-1
MULIFE.txt,1092395,1092674,279,10,N,N,-,-1,-1
MULIFE.txt,1092438,1092682,244,10,N,N,-,-1,-1
MULIFE.txt,1092514,1092697,183,10,N,N,-,-1,-1
MULIFE.txt,1092518,1092698,180,10,N,N,-,-1,-1
MULIFE.txt,1092523,1092699,176,10,N,N,-,-1,-1
MULIFE.txt,1092531,1092707,176,10,N,N,-,-1,-1
MULIFE.txt,1092628,1092716,88,10,N,N,-,-1,-1
MULIFE.txt,1092633,1092738,105,10,N,N,-,-1,-1
MULIFE.txt,1092637,1092792,155,10,N,N,-,-1,-1
MULIFE.txt,1092641,1092796,155,10,N,N,-,-1,-1
MULIFE.txt,1092677,1092810,133,10,N,N,-,-1,-1
MULIFE.txt,1092683,1093015,332,10,N,N,-,-1,-1
MULIFE.txt,1092697,1093027,330,10,N,N,-,-1,-1
MULIFE.txt,1092698,1093036,338,10,N,N,-,-1,-1
MULIFE.txt,1092702,1093050,348,10,N,N,-,-1,-1
MULIFE.txt,1092708,1093131,423,10,N,N,-,-1,-1
MULIFE.txt,1092717,1093166,449,10,N,N,-,-1,-1
MULIFE.txt,1092740,1093293,553,10,N,N,-,-1,-1
MUSING.txt,0,2031,2031,10,N,N,-,-1,-1
MUSING.txt,202,2311,2109,10,N,N,-,-1,-1
MUSING.txt,220,2460,2240,10,N,N,-,-1,-1
MUSING.txt,319,2791,2472,10,N,N,-,-1,-1
MUSING.txt,692,3428,2736,10,N,N,-,-1,-1
MUSING.txt,1011,3605,2594,10,N,N,-,-1,-1
MUSING.txt,1054,4015,2961,10,N,N,-,-1,-1
MUSING.txt,1283,4381,3098,10,N,N,-,-1,-1
MUSING.txt,1901,4731,2830,10,N,N,-,-1,-1
MUSING.txt,1988,5177,3189,10,N,N,-,-1,-1
MUSING.txt,2032,5332,3300,10,N,N,-,-1,-1
MUSING.txt,2312,5545,3233,10,N,N,-,-1,-1
MUSING.txt,2461,5702,3241,10,N,N,-,-1,-1
MUSING.txt,2792,5977,3185,10,N,N,-,-1,-1
MUSING.txt,3433,6013,2580,10,N,N,-,-1,-1
MUSING.txt,3606,6114,2508,10,N,N,-,-1,-1
MUSING.txt,4016,6357,2341,10,N,N,-,-1,-1
MUSING.txt,4384,6537,2153,10,N,N,-,-1,-1
MUSING.txt,4734,6787,2053,10,N,N,-,-1,-1
MUSING.txt,5178,6887,1709,10,N,N,-,-1,-1
MUSING.txt,5334,6953,1619,10,N,N,-,-1,-1
MUSING.txt,5546,7036,1490,10,N,N,-,-1,-1
MUSING.txt,5703,7205,1502,10,N,N,-,-1,-1
MUSING.txt,5978,7409,1431,10,N,N,-,-1,-1
MUSING.txt,6014,7905,1891,10,N,N,-,-1,-1
MUSING.txt,6115,8219,2104,10,N,N,-,-1,-1
MUSING.txt,6358,8472,2114,10,N,N,-,-1,-1
MUSING.txt,6539,8631,2092,10,N,N,-,-1,-1
MUSING.txt,6788,8645,1857,10,N,N,-,-1,-1
MUSING.txt,6888,8844,1956,10,N,N,-,-1,-1
MUSING.txt,6955,9101,2146,10,N,N,-,-1,-1
MUSING.txt,7039,9393,2354,10,N,N,-,-1,-1
MUSING.txt,7206,9426,2220,10,N,N,-,-1,-1
MUSING.txt,7412,9610,2198,10,N,N,-,-1,-1
MUSING.txt,7906,9696,1790,10,N,N,-,-1,-1
MUSING.txt,8220,9828,1608,10,N,N,-,-1,-1
MUSING.txt,8473,9923,1450,10,N,N,-,-1,-1
MUSING.txt,8633,10089,1456,10,N,N,-,-1,-1
MUSING.txt,8646,10140,1494,10,N,N,-,-1,-1
MUSING.txt,8845,10157,1312,10,N,N,-,-1,-1
MUSING.txt,9102,10190,1088,10,N,N,-,-1,-1
MUSING.txt,9396,10238,842,10,N,N,-,-1,-1
MUSING.txt,9427,10503,1076,10,N,N,-,-1,-1
MUSING.txt,9612,10841,1229,10,N,N,-,-1,-1
MUSING.txt,9697,11769,2072,10,N,N,-,-1,-1
MUSING.txt,9829,12155,2326,10,N,Y,1437475017618,98942,100041
MUSING.txt,9924,12613,2689,10,N,Y,1437475017618,98942,100041
MUSING.txt,10090,12731,2641,10,N,Y,1437477480340,424837,425856
MUSING.txt,10141,12997,2856,10,Y,Y,1437477480340,424837,425856
MUSING.txt,10158,13342,3184,10,N,Y,1437477480340,424837,425856
MUSING.txt,10191,13362,3171,10,N,Y,1437477480340,424837,425856
MUSING.txt,10239,13794,3555,10,Y,Y,1437477480340,424837,425856
MUSING.txt,10504,14115,3611,10,Y,Y,1437477480340,424837,425856
MUSING.txt,10846,14636,3790,10,Y,Y,1437477480340,424837,425856
MUSING.txt,11772,15303,3531,10,Y,Y,1437477480340,424837,425856
MUSING.txt,12156,15556,3400,10,Y,Y,1437477480340,424837,425856
MUSING.txt,12614,15715,3101,10,Y,Y,1437477480340,424837,425856
MUSING.txt,12733,15940,3207,10,Y,Y,1437477480340,424837,425856
MUSING.txt,13000,16186,3186,10,Y,Y,1448280884746,88496,89294
MUSING.txt,13343,16337,2994,10,Y,Y,1448280884746,88496,89294
MUSING.txt,13363,16595,3232,10,Y,Y,1448280884746,88496,89294
MUSING.txt,13795,17333,3538,10,Y,Y,1448285563397,102964,108476
MUSING.txt,14118,17978,3860,10,Y,Y,1448285563397,102964,108476
MUSING.txt,14639,18271,3632,10,Y,Y,1448285913012,108803,110925
MUSING.txt,15304,18417,3113,10,Y,Y,1448285913012,108803,110925
MUSING.txt,15558,18996,3438,10,Y,Y,1448285913012,108803,110925
MUSING.txt,15716,19178,3462,10,Y,Y,1448285913012,108803,110925
MUSING.txt,15941,19292,3351,10,Y,Y,1448285913012,108803,110925
MUSING.txt,16189,19598,3409,10,Y,Y,1448277582432,52552,54595
MUSING.txt,16338,19798,3460,10,N,Y,1448277582432,52552,54595
MUSING.txt,16598,20142,3544,10,Y,Y,1448277582432,52552,54595
MUSING.txt,17334,20175,2841,10,Y,Y,1448277582432,52552,54595
MUSING.txt,17981,20501,2520,10,Y,Y,1437471855423,351318,351853
MUSING.txt,18272,20992,2720,10,Y,Y,1437471855423,351318,351853
MUSING.txt,18420,21271,2851,10,Y,Y,1437471855423,351318,351853
MUSING.txt,18997,21452,2455,10,Y,Y,1437471855423,351318,351853
MUSING.txt,19179,21668,2489,10,Y,Y,1437471855423,351318,351853
MUSING.txt,19295,21885,2590,10,Y,Y,1437471855423,351318,351853
MUSING.txt,19599,22147,2548,10,Y,Y,1437471855423,351318,351853
MUSING.txt,19801,22222,2421,10,Y,Y,1437471855423,351318,351853
MUSING.txt,20143,22263,2120,10,Y,Y,1437471855423,351318,351853
MUSING.txt,20178,22418,2240,10,Y,Y,1437471855423,351318,351853
MUSING.txt,20503,22727,2224,10,Y,Y,1436867017136,105674,106651
MUSING.txt,20993,22925,1932,10,Y,Y,1436867017136,105674,106651
MUSING.txt,21272,23164,1892,10,Y,Y,1436867017136,105674,106651
MUSING.txt,21453,23244,1791,10,Y,Y,1436867017136,105674,106651
MUSING.txt,21669,23264,1595,10,N,Y,1436867017136,105674,106651
MUSING.txt,21886,24219,2333,10,N,N,-,-1,-1
MUSING.txt,22148,24700,2552,10,N,Y,1437472380836,351899,352666
MUSING.txt,22224,24834,2610,10,N,Y,1437472380836,351899,352666
MUSING.txt,22264,25106,2842,10,N,Y,1437472380836,351899,352666
MUSING.txt,22419,25200,2781,10,N,Y,1437472380836,351899,352666
MUSING.txt,22728,26143,3415,10,N,Y,1437472380836,351899,352666
MUSING.txt,22926,26194,3268,10,N,Y,1437472380836,351899,352666
MUSING.txt,23167,26253,3086,10,N,Y,1437472380836,351899,352666
MUSING.txt,23245,26386,3141,10,N,Y,1437472380836,351899,352666
MUSING.txt,23265,26457,3192,10,N,Y,1437472380836,351899,352666
MUSING.txt,24220,26642,2422,10,N,Y,1437472380836,351899,352666
MUSING.txt,24705,26824,2119,10,N,N,-,-1,-1
MUSING.txt,24835,27345,2510,10,Y,N,-,-1,-1
MUSING.txt,25107,27628,2521,10,Y,N,-,-1,-1
MUSING.txt,25201,27731,2530,10,Y,N,-,-1,-1
MUSING.txt,26144,27977,1833,10,N,N,-,-1,-1
MUSING.txt,26196,28147,1951,10,Y,Y,1437490253936,460795,462238
MUSING.txt,26254,28644,2390,10,Y,Y,1437490253936,460795,462238
MUSING.txt,26387,28753,2366,10,Y,Y,1437490253936,460795,462238
MUSING.txt,26460,28900,2440,10,Y,Y,1437490253936,460795,462238
MUSING.txt,26643,29223,2580,10,Y,Y,1437490253936,460795,462238
MUSING.txt,26825,29616,2791,10,Y,Y,1437490253936,460795,462238
MUSING.txt,27348,29906,2558,10,Y,Y,1437490253936,460795,462238
MUSING.txt,27631,30171,2540,10,Y,Y,1437490253936,460795,462238
MUSING.txt,27732,30304,2572,10,Y,Y,1437490253936,460795,462238
MUSING.txt,27979,30602,2623,10,Y,Y,1437477878183,427206,428439
MUSING.txt,28148,30736,2588,10,Y,Y,1437477878183,427206,428439
MUSING.txt,28646,30933,2287,10,Y,Y,1437477878183,427206,428439
MUSING.txt,28754,31594,2840,10,Y,Y,1437477878183,427206,428439
MUSING.txt,28901,31669,2768,10,Y,Y,1437477878183,427206,428439
MUSING.txt,29224,31861,2637,10,Y,Y,1437477878183,427206,428439
MUSING.txt,29617,32045,2428,10,Y,Y,1437477878183,427206,428439
MUSING.txt,29907,32264,2357,10,Y,Y,1437477878183,427206,428439
MUSING.txt,30172,32621,2449,10,Y,Y,1437470299748,152207,152889
MUSING.txt,30307,32666,2359,10,Y,Y,1437470299748,152207,152889
MUSING.txt,30603,32865,2262,10,Y,Y,1437470299748,152207,152889
MUSING.txt,30739,33115,2376,10,Y,Y,1437470299748,152207,152889
MUSING.txt,30934,33684,2750,10,Y,Y,1437470299748,152207,152889
MUSING.txt,31597,33910,2313,10,Y,Y,1437470299748,152207,152889
MUSING.txt,31670,34073,2403,10,Y,Y,1437470299748,152207,152889
MUSING.txt,31862,34306,2444,10,Y,Y,1437470299748,152207,152889
MUSING.txt,32046,34554,2508,10,Y,Y,1437470299748,152207,152889
MUSING.txt,32267,34934,2667,10,Y,Y,1437470299748,152207,152889
MUSING.txt,32622,35333,2711,10,N,Y,1437470299748,152207,152889
MUSING.txt,32667,35634,2967,10,Y,Y,1437470299748,152207,152889
MUSING.txt,32866,35775,2909,10,Y,Y,1437470299748,152207,152889
MUSING.txt,33116,35861,2745,10,N,Y,1437470299748,152207,152889
MUSING.txt,33687,35863,2176,10,N,N,-,-1,-1
MUSING.txt,33911,36231,2320,10,N,N,-,-1,-1
MUSING.txt,34076,36462,2386,10,N,N,-,-1,-1
MUSING.txt,34308,36737,2429,10,N,N,-,-1,-1
MUSING.txt,34555,36815,2260,10,N,N,-,-1,-1
MUSING.txt,34937,36877,1940,10,N,N,-,-1,-1
MUSING.txt,35334,36925,1591,10,N,N,-,-1,-1
MUSING.txt,35635,37430,1795,10,N,N,-,-1,-1
MUSING.txt,35776,37504,1728,10,N,N,-,-1,-1
MUSING.txt,35862,37823,1961,10,N,N,-,-1,-1
MUSING.txt,35863,37981,2118,10,N,N,-,-1,-1
MUSING.txt,36232,38179,1947,10,N,N,-,-1,-1
MUSING.txt,36463,38480,2017,10,N,Y,1448038803075,18895,19670
MUSING.txt,36738,38883,2145,10,N,Y,1448038803075,18895,19670
MUSING.txt,36818,39380,2562,10,N,Y,1448038803075,18895,19670
MUSING.txt,36878,39624,2746,10,N,Y,1448038803075,18895,19670
MUSING.txt,36926,40078,3152,10,N,Y,1448038803075,18895,19670
MUSING.txt,37432,40428,2996,10,N,Y,1448038803075,18895,19670
MUSING.txt,37509,40573,3064,10,Y,Y,1448038803075,18895,19670
MUSING.txt,37824,41039,3215,10,Y,Y,1448038803075,18895,19670
MUSING.txt,37983,41326,3343,10,Y,Y,1448038803075,18895,19670
MUSING.txt,38180,41602,3422,10,N,Y,1448038803075,18895,19670
MUSING.txt,38481,41831,3350,10,N,Y,1448038803075,18895,19670
MUSING.txt,38886,41901,3015,10,N,Y,1448038803075,18895,19670
MUSING.txt,39381,42228,2847,10,N,Y,1448038803075,18895,19670
MUSING.txt,39627,42395,2768,10,N,Y,1448274893770,25386,26202
MUSING.txt,40079,42424,2345,10,N,Y,1448274893770,25386,26202
MUSING.txt,40431,42569,2138,10,N,N,-,-1,-1
MUSING.txt,40574,42874,2300,10,N,N,-,-1,-1
MUSING.txt,41040,42928,1888,10,N,N,-,-1,-1
MUSING.txt,41327,42975,1648,10,N,N,-,-1,-1
MUSING.txt,41605,43113,1508,10,N,N,-,-1,-1
MUSING.txt,41833,43169,1336,10,N,Y,1448037533268,13930,15031
MUSING.txt,41902,43507,1605,10,N,Y,1448037533268,13930,15031
MUSING.txt,42229,43721,1492,10,N,Y,1448037533268,13930,15031
MUSING.txt,42398,43943,1545,10,N,Y,1448037533268,13930,15031
MUSING.txt,42425,44381,1956,10,Y,Y,1448037533268,13930,15031
MUSING.txt,42574,44520,1946,10,Y,Y,1448037533268,13930,15031
MUSING.txt,42875,44895,2020,10,Y,Y,1448037533268,13930,15031
MUSING.txt,42929,45049,2120,10,Y,Y,1448037533268,13930,15031
MUSING.txt,42976,45131,2155,10,Y,Y,1448037533268,13930,15031
MUSING.txt,43116,45256,2140,10,Y,Y,1448037533268,13930,15031
MUSING.txt,43170,45444,2274,10,N,Y,1448037533268,13930,15031
MUSING.txt,43510,45573,2063,10,N,N,-,-1,-1
MUSING.txt,43722,45855,2133,10,N,N,-,-1,-1
MUSING.txt,43944,46134,2190,10,N,N,-,-1,-1
MUSING.txt,44384,46355,1971,10,N,N,-,-1,-1
MUSING.txt,44521,46471,1950,10,N,N,-,-1,-1
MUSING.txt,44896,46689,1793,10,N,N,-,-1,-1
MUSING.txt,45050,46720,1670,10,N,N,-,-1,-1
MUSING.txt,45132,46877,1745,10,N,N,-,-1,-1
MUSING.txt,45257,46914,1657,10,N,N,-,-1,-1
MUSING.txt,45447,46975,1528,10,N,N,-,-1,-1
MUSING.txt,45574,47252,1678,10,N,N,-,-1,-1
MUSING.txt,45856,47520,1664,10,N,N,-,-1,-1
MUSING.txt,46135,47547,1412,10,N,N,-,-1,-1
MUSING.txt,46357,47640,1283,10,N,N,-,-1,-1
MUSING.txt,46472,47835,1363,10,N,N,-,-1,-1
MUSING.txt,46690,48208,1518,10,N,N,-,-1,-1
MUSING.txt,46721,48222,1501,10,N,N,-,-1,-1
MUSING.txt,46878,48409,1531,10,N,N,-,-1,-1
MUSING.txt,46915,48504,1589,10,N,N,-,-1,-1
MUSING.txt,46976,48557,1581,10,N,N,-,-1,-1
MUSING.txt,47253,48669,1416,10,N,N,-,-1,-1
MUSING.txt,47521,48881,1360,10,N,N,-,-1,-1
MUSING.txt,47549,48970,1421,10,N,N,-,-1,-1
MUSING.txt,47642,49001,1359,10,N,N,-,-1,-1
MUSING.txt,47836,49265,1429,10,N,Y,1448038101349,15101,17486
MUSING.txt,48209,49555,1346,10,N,Y,1448038101349,15101,17486
MUSING.txt,48223,49709,1486,10,N,Y,1448038101349,15101,17486
MUSING.txt,48411,50094,1683,10,N,Y,1448038101349,15101,17486
MUSING.txt,48505,50303,1798,10,Y,Y,1448038101349,15101,17486
MUSING.txt,48558,50718,2160,10,Y,Y,1448038101349,15101,17486
MUSING.txt,48670,50836,2166,10,Y,Y,1448038101349,15101,17486
MUSING.txt,48882,51174,2292,10,Y,Y,1448038101349,15101,17486
MUSING.txt,48973,51395,2422,10,Y,Y,1448038101349,15101,17486
MUSING.txt,49002,51834,2832,10,Y,Y,1448038101349,15101,17486
MUSING.txt,49266,52074,2808,10,Y,Y,1448038101349,15101,17486
MUSING.txt,49558,52328,2770,10,Y,Y,1437476486340,221621,222520
MUSING.txt,49710,52389,2679,10,Y,Y,1437476486340,221621,222520
MUSING.txt,50095,52573,2478,10,Y,Y,1437476486340,221621,222520
MUSING.txt,50304,53071,2767,10,Y,Y,1437476486340,221621,222520
MUSING.txt,50720,53750,3030,10,Y,Y,1437471397525,350644,351290
MUSING.txt,50837,53781,2944,10,Y,Y,1437471397525,350644,351290
MUSING.txt,51177,53823,2646,10,Y,Y,1437471397525,350644,351290
MUSING.txt,51398,53968,2570,10,Y,Y,1437471397525,350644,351290
MUSING.txt,51835,54299,2464,10,Y,Y,1437471397525,350644,351290
MUSING.txt,52077,54514,2437,10,N,Y,1437471397525,350644,351290
MUSING.txt,52329,54898,2569,10,Y,Y,1437471397525,350644,351290
MUSING.txt,52390,54969,2579,10,Y,Y,1437471397525,350644,351290
MUSING.txt,52574,55223,2649,10,Y,Y,1437471397525,350644,351290
MUSING.txt,53074,55513,2439,10,Y,Y,1437471397525,350644,351290
MUSING.txt,53753,55850,2097,10,Y,N,-,-1,-1
MUSING.txt,53782,56087,2305,10,Y,Y,1448277167610,40886,47737
MUSING.txt,53826,56126,2300,10,Y,Y,1448277167610,40886,47737
MUSING.txt,53969,56399,2430,10,Y,Y,1448277167610,40886,47737
MUSING.txt,54300,56634,2334,10,Y,Y,1448277167610,40886,47737
MUSING.txt,54516,56766,2250,10,Y,Y,1448277167610,40886,47737
MUSING.txt,54903,56848,1945,10,Y,Y,1448277167610,40886,47737
MUSING.txt,54970,57139,2169,10,Y,Y,1448277167610,40886,47737
MUSING.txt,55226,57268,2042,10,N,Y,1448277167610,40886,47737
MUSING.txt,55514,57363,1849,10,N,Y,1448277167610,40886,47737
MUSING.txt,55853,57517,1664,10,N,Y,1448277167610,40886,47737
MUSING.txt,56088,57686,1598,10,N,Y,1448277167610,40886,47737
MUSING.txt,56129,57733,1604,10,N,Y,1448277167610,40886,47737
MUSING.txt,56400,57867,1467,10,Y,Y,1448275023016,26258,26837
MUSING.txt,56636,57931,1295,10,N,Y,1448275023016,26258,26837
MUSING.txt,56769,58054,1285,10,N,Y,1448275023016,26258,26837
MUSING.txt,56849,58272,1423,10,N,Y,1448275023016,26258,26837
MUSING.txt,57140,58288,1148,10,N,Y,1448275023016,26258,26837
MUSING.txt,57273,58731,1458,10,N,Y,1448275023016,26258,26837
MUSING.txt,57364,59012,1648,10,N,Y,1448275023016,26258,26837
MUSING.txt,57518,59138,1620,10,N,Y,1448275023016,26258,26837
MUSING.txt,57687,59254,1567,10,N,Y,1448275023016,26258,26837
MUSING.txt,57734,59467,1733,10,N,Y,1448275023016,26258,26837
MUSING.txt,57868,59564,1696,10,N,Y,1448275023016,26258,26837
MUSING.txt,57932,59990,2058,10,Y,Y,1448275023016,26258,26837
MUSING.txt,58057,60473,2416,10,Y,Y,1448275023016,26258,26837
MUSING.txt,58274,60560,2286,10,N,N,-,-1,-1
MUSING.txt,58291,61100,2809,10,N,Y,1448279813455,71525,72226
MUSING.txt,58734,61629,2895,10,Y,Y,1448279813455,71525,72226
MUSING.txt,59014,61815,2801,10,Y,Y,1448279813455,71525,72226
MUSING.txt,59139,62175,3036,10,N,Y,1448279813455,71525,72226
MUSING.txt,59257,62357,3100,10,N,Y,1448279813455,71525,72226
MUSING.txt,59468,62604,3136,10,N,Y,1448279813455,71525,72226
MUSING.txt,59565,62838,3273,10,N,Y,1448279813455,71525,72226
MUSING.txt,59993,63053,3060,10,N,Y,1448279813455,71525,72226
MUSING.txt,60474,63262,2788,10,N,Y,1448279813455,71525,72226
MUSING.txt,60563,63423,2860,10,Y,Y,1448279813455,71525,72226
MUSING.txt,61103,63617,2514,10,Y,Y,1448279813455,71525,72226
MUSING.txt,61631,63882,2251,10,Y,Y,1437472966198,394609,395892
MUSING.txt,61817,64015,2198,10,Y,Y,1437472966198,394609,395892
MUSING.txt,62176,64096,1920,10,Y,Y,1437472966198,394609,395892
MUSING.txt,62358,64192,1834,10,Y,Y,1437472966198,394609,395892
MUSING.txt,62605,64293,1688,10,Y,Y,1437472966198,394609,395892
MUSING.txt,62841,64419,1578,10,N,Y,1437472966198,394609,395892
MUSING.txt,63054,64633,1579,10,N,Y,1437472966198,394609,395892
MUSING.txt,63263,64909,1646,10,N,Y,1437472966198,394609,395892
MUSING.txt,63424,65326,1902,10,N,Y,1437472966198,394609,395892
MUSING.txt,63620,65604,1984,10,N,Y,1437472966198,394609,395892
MUSING.txt,63887,65997,2110,10,N,Y,1437472966198,394609,395892
MUSING.txt,64016,66249,2233,10,N,Y,1437472966198,394609,395892
MUSING.txt,64097,66766,2669,10,N,Y,1437472966198,394609,395892
MUSING.txt,64193,66940,2747,10,N,Y,1437472966198,394609,395892
MUSING.txt,64294,67348,3054,10,N,Y,1437472966198,394609,395892
MUSING.txt,64420,67618,3198,10,N,Y,1448275407308,26987,29181
MUSING.txt,64635,67707,3072,10,N,Y,1448275407308,26987,29181
MUSING.txt,64912,67863,2951,10,N,Y,1448275407308,26987,29181
MUSING.txt,65329,68314,2985,10,N,Y,1448275407308,26987,29181
MUSING.txt,65605,68355,2750,10,N,Y,1448275407308,26987,29181
MUSING.txt,66000,68427,2427,10,N,Y,1448275407308,26987,29181
MUSING.txt,66250,68600,2350,10,N,Y,1448275407308,26987,29181
MUSING.txt,66767,69053,2286,10,N,Y,1448275407308,26987,29181
MUSING.txt,66943,69371,2428,10,N,Y,1448275407308,26987,29181
MUSING.txt,67349,69684,2335,10,Y,Y,1448275407308,26987,29181
MUSING.txt,67619,69755,2136,10,Y,Y,1437028092146,121457,123204
MUSING.txt,67708,69846,2138,10,Y,Y,1437028092146,121457,123204
MUSING.txt,67866,70006,2140,10,Y,Y,1437028092146,121457,123204
MUSING.txt,68315,70225,1910,10,Y,Y,1437028092146,121457,123204
MUSING.txt,68358,70572,2214,10,Y,Y,1437028092146,121457,123204
MUSING.txt,68428,70801,2373,10,Y,Y,1437028092146,121457,123204
MUSING.txt,68601,71010,2409,10,Y,Y,1437028092146,121457,123204
MUSING.txt,69054,71398,2344,10,Y,Y,1437028092146,121457,123204
MUSING.txt,69374,71555,2181,10,Y,Y,1437028092146,121457,123204
MUSING.txt,69687,71639,1952,10,Y,Y,1437028092146,121457,123204
MUSING.txt,69756,71837,2081,10,Y,Y,1437028092146,121457,123204
MUSING.txt,69849,72340,2491,10,Y,Y,1448281888079,98877,102290
MUSING.txt,70007,72454,2447,10,Y,Y,1448281888079,98877,102290
MUSING.txt,70228,72638,2410,10,N,N,-,-1,-1
MUSING.txt,70573,72903,2330,10,N,N,-,-1,-1
MUSING.txt,70802,73006,2204,10,N,N,-,-1,-1
MUSING.txt,71011,73594,2583,10,N,N,-,-1,-1
MUSING.txt,71400,73820,2420,10,N,N,-,-1,-1
MUSING.txt,71556,74154,2598,10,N,N,-,-1,-1
MUSING.txt,71640,74208,2568,10,Y,Y,1448039370049,20775,21297
MUSING.txt,71838,74345,2507,10,Y,Y,1448039370049,20775,21297
MUSING.txt,72343,74686,2343,10,Y,Y,1448039370049,20775,21297
MUSING.txt,72455,74809,2354,10,Y,Y,1448039370049,20775,21297
MUSING.txt,72639,75164,2525,10,Y,Y,1448039370049,20775,21297
MUSING.txt,72906,75284,2378,10,Y,Y,1448039370049,20775,21297
MUSING.txt,73007,75598,2591,10,Y,Y,1448039370049,20775,21297
MUSING.txt,73597,75920,2323,10,Y,Y,1448039370049,20775,21297
MUSING.txt,73822,76129,2307,10,Y,Y,1448278425221,65586,65914
MUSING.txt,74157,76327,2170,10,Y,Y,1448278425221,65586,65914
MUSING.txt,74209,76487,2278,10,Y,Y,1448278425221,65586,65914
MUSING.txt,74346,76568,2222,10,Y,Y,1448278425221,65586,65914
MUSING.txt,74687,76920,2233,10,Y,Y,1448278425221,65586,65914
MUSING.txt,74812,77073,2261,10,Y,Y,1448278425221,65586,65914
MUSING.txt,75165,77555,2390,10,Y,Y,1448278425221,65586,65914
MUSING.txt,75285,77648,2363,10,Y,Y,1448278425221,65586,65914
MUSING.txt,75601,77792,2191,10,N,Y,1448278425221,65586,65914
MUSING.txt,75921,78026,2105,10,Y,Y,1448278425221,65586,65914
MUSING.txt,76130,78539,2409,10,Y,Y,1448278425221,65586,65914
MUSING.txt,76328,78856,2528,10,Y,Y,1448278425221,65586,65914
MUSING.txt,76488,78971,2483,10,N,Y,1448279941918,72406,72905
MUSING.txt,76569,79071,2502,10,N,Y,1448279941918,72406,72905
MUSING.txt,76921,79269,2348,10,Y,Y,1448279941918,72406,72905
MUSING.txt,77074,79579,2505,10,Y,Y,1448279941918,72406,72905
MUSING.txt,77556,79876,2320,10,Y,Y,1448279941918,72406,72905
MUSING.txt,77651,79919,2268,10,Y,Y,1448279941918,72406,72905
MUSING.txt,77794,80288,2494,10,Y,Y,1448279941918,72406,72905
MUSING.txt,78027,80292,2265,10,Y,Y,1448279941918,72406,72905
MUSING.txt,78544,80315,1771,10,N,Y,1448279941918,72406,72905
MUSING.txt,78859,80665,1806,10,N,N,-,-1,-1
MUSING.txt,78972,80912,1940,10,N,N,-,-1,-1
MUSING.txt,79074,81022,1948,10,N,N,-,-1,-1
MUSING.txt,79270,81323,2053,10,N,N,-,-1,-1
MUSING.txt,79580,81635,2055,10,N,N,-,-1,-1
MUSING.txt,79877,81795,1918,10,N,N,-,-1,-1
MUSING.txt,79920,82721,2801,10,N,N,-,-1,-1
MUSING.txt,80289,82948,2659,10,N,N,-,-1,-1
MUSING.txt,80293,83042,2749,10,N,N,-,-1,-1
MUSING.txt,80318,83564,3246,10,N,N,-,-1,-1
MUSING.txt,80666,83843,3177,10,N,N,-,-1,-1
MUSING.txt,80914,84043,3129,10,N,N,-,-1,-1
MUSING.txt,81023,84099,3076,10,N,N,-,-1,-1
MUSING.txt,81324,84243,2919,10,N,N,-,-1,-1
MUSING.txt,81638,84570,2932,10,N,N,-,-1,-1
MUSING.txt,81796,84778,2982,10,N,N,-,-1,-1
MUSING.txt,82722,85277,2555,10,N,N,-,-1,-1
MUSING.txt,82950,85436,2486,10,N,N,-,-1,-1
MUSING.txt,83044,85754,2710,10,N,N,-,-1,-1
MUSING.txt,83565,85801,2236,10,N,N,-,-1,-1
MUSING.txt,83844,86079,2235,10,N,N,-,-1,-1
MUSING.txt,84044,86607,2563,10,N,N,-,-1,-1
MUSING.txt,84100,86739,2639,10,N,N,-,-1,-1
MUSING.txt,84244,87168,2924,10,N,N,-,-1,-1
MUSING.txt,84571,87326,2755,10,N,N,-,-1,-1
MUSING.txt,84779,87427,2648,10,N,N,-,-1,-1
MUSING.txt,85282,87937,2655,10,N,N,-,-1,-1
MUSING.txt,85437,88263,2826,10,N,N,-,-1,-1
MUSING.txt,85755,88535,2780,10,N,N,-,-1,-1
MUSING.txt,85802,88643,2841,10,N,N,-,-1,-1
MUSING.txt,86080,88826,2746,10,N,N,-,-1,-1
MUSING.txt,86608,89105,2497,10,N,N,-,-1,-1
MUSING.txt,86741,89475,2734,10,N,N,-,-1,-1
MUSING.txt,87169,89578,2409,10,N,N,-,-1,-1
MUSING.txt,87327,89648,2321,10,N,N,-,-1,-1
MUSING.txt,87428,89892,2464,10,N,N,-,-1,-1
MUSING.txt,87938,90034,2096,10,N,N,-,-1,-1
MUSING.txt,88264,90349,2085,10,N,N,-,-1,-1
MUSING.txt,88538,90531,1993,10,N,N,-,-1,-1
MUSING.txt,88644,90591,1947,10,N,N,-,-1,-1
MUSING.txt,88827,90966,2139,10,N,N,-,-1,-1
MUSING.txt,89106,91354,2248,10,N,N,-,-1,-1
MUSING.txt,89480,91496,2016,10,N,N,-,-1,-1
MUSING.txt,89579,91641,2062,10,N,N,-,-1,-1
MUSING.txt,89648,91796,2148,10,N,N,-,-1,-1
MUSING.txt,89895,92111,2216,10,N,N,-,-1,-1
MUSING.txt,90035,92248,2213,10,N,N,-,-1,-1
MUSING.txt,90350,92488,2138,10,N,N,-,-1,-1
MUSING.txt,90532,92581,2049,10,N,N,-,-1,-1
MUSING.txt,90592,92775,2183,10,N,N,-,-1,-1
MUSING.txt,90967,92935,1968,10,N,N,-,-1,-1
MUSING.txt,91355,93135,1780,10,N,N,-,-1,-1
MUSING.txt,91497,93223,1726,10,N,N,-,-1,-1
MUSING.txt,91642,93242,1600,10,N,N,-,-1,-1
MUSING.txt,91797,93472,1675,10,N,N,-,-1,-1
MUSING.txt,92112,93753,1641,10,N,N,-,-1,-1
MUSING.txt,92249,94182,1933,10,N,N,-,-1,-1
MUSING.txt,92489,94261,1772,10,N,N,-,-1,-1
MUSING.txt,92582,94353,1771,10,N,N,-,-1,-1
MUSING.txt,92776,94609,1833,10,N,N,-,-1,-1
MUSING.txt,92936,94852,1916,10,N,N,-,-1,-1
MUSING.txt,93140,94973,1833,10,N,N,-,-1,-1
MUSING.txt,93224,95556,2332,10,N,N,-,-1,-1
MUSING.txt,93243,95661,2418,10,N,N,-,-1,-1
MUSING.txt,93474,96038,2564,10,N,N,-,-1,-1
MUSING.txt,93756,96136,2380,10,N,N,-,-1,-1
MUSING.txt,94183,96301,2118,10,N,N,-,-1,-1
MUSING.txt,94262,96480,2218,10,N,N,-,-1,-1
MUSING.txt,94356,97202,2846,10,N,N,-,-1,-1
MUSING.txt,94612,97375,2763,10,N,N,-,-1,-1
MUSING.txt,94853,97494,2641,10,N,N,-,-1,-1
MUSING.txt,94975,97708,2733,10,N,N,-,-1,-1
MUSING.txt,95559,97970,2411,10,N,N,-,-1,-1
MUSING.txt,95662,98360,2698,10,N,N,-,-1,-1
MUSING.txt,96039,98708,2669,10,N,N,-,-1,-1
MUSING.txt,96137,98873,2736,10,N,N,-,-1,-1
MUSING.txt,96302,99175,2873,10,N,N,-,-1,-1
MUSING.txt,96481,99383,2902,10,N,N,-,-1,-1
MUSING.txt,97205,99747,2542,10,Y,N,-,-1,-1
MUSING.txt,97376,99910,2534,10,N,N,-,-1,-1
MUSING.txt,97495,100131,2636,10,N,N,-,-1,-1
MUSING.txt,97710,100250,2540,10,Y,N,-,-1,-1
MUSING.txt,97971,100528,2557,10,Y,N,-,-1,-1
MUSING.txt,98361,100553,2192,10,Y,N,-,-1,-1
MUSING.txt,98711,100800,2089,10,N,N,-,-1,-1
MUSING.txt,98874,100937,2063,10,N,N,-,-1,-1
MUSING.txt,99178,101090,1912,10,N,N,-,-1,-1
MUSING.txt,99384,101186,1802,10,N,N,-,-1,-1
MUSING.txt,99750,101286,1536,10,N,N,-,-1,-1
MUSING.txt,99911,101425,1514,10,N,N,-,-1,-1
MUSING.txt,100132,101528,1396,10,N,N,-,-1,-1
MUSING.txt,100251,101593,1342,10,N,N,-,-1,-1
MUSING.txt,100529,101609,1080,10,N,N,-,-1,-1
MUSING.txt,100554,102131,1577,10,N,N,-,-1,-1
MUSING.txt,100801,102203,1402,10,N,N,-,-1,-1
MUSING.txt,100938,102366,1428,10,N,N,-,-1,-1
MUSING.txt,101092,102477,1385,10,N,N,-,-1,-1
MUSING.txt,101187,103101,1914,10,N,N,-,-1,-1
MUSING.txt,101287,103361,2074,10,N,N,-,-1,-1
MUSING.txt,101426,103673,2247,10,Y,N,-,-1,-1
MUSING.txt,101529,104031,2502,10,Y,N,-,-1,-1
MUSING.txt,101594,104235,2641,10,Y,N,-,-1,-1
MUSING.txt,101610,104618,3008,10,Y,N,-,-1,-1
MUSING.txt,102132,104761,2629,10,Y,N,-,-1,-1
MUSING.txt,102204,104861,2657,10,Y,N,-,-1,-1
MUSING.txt,102369,105091,2722,10,Y,N,-,-1,-1
MUSING.txt,102478,105312,2834,10,Y,N,-,-1,-1
MUSING.txt,103103,105805,2702,10,Y,N,-,-1,-1
MUSING.txt,103362,106130,2768,10,Y,N,-,-1,-1
MUSING.txt,103676,106311,2635,10,Y,N,-,-1,-1
MUSING.txt,104032,106668,2636,10,Y,Y,1448276340407,30017,39003
MUSING.txt,104236,106856,2620,10,Y,Y,1448276340407,30017,39003
MUSING.txt,104619,106991,2372,10,Y,Y,1448276340407,30017,39003
MUSING.txt,104763,107009,2246,10,Y,Y,1448276340407,30017,39003
MUSING.txt,104862,107204,2342,10,Y,Y,1448276340407,30017,39003
MUSING.txt,105092,107485,2393,10,Y,Y,1448276340407,30017,39003
MUSING.txt,105313,107935,2622,10,Y,Y,1448276340407,30017,39003
MUSING.txt,105808,108268,2460,10,Y,Y,1448276340407,30017,39003
MUSING.txt,106131,108459,2328,10,Y,Y,1448276340407,30017,39003
MUSING.txt,106312,108540,2228,10,Y,Y,1448276340407,30017,39003
MUSING.txt,106669,108627,1958,10,Y,Y,1448276340407,30017,39003
MUSING.txt,106857,108776,1919,10,Y,Y,1448276340407,30017,39003
MUSING.txt,106992,108979,1987,10,Y,Y,1448276340407,30017,39003
MUSING.txt,107010,109171,2161,10,Y,Y,1448278147591,54631,55869
MUSING.txt,107207,109302,2095,10,Y,Y,1448278147591,54631,55869
MUSING.txt,107487,109348,1861,10,Y,Y,1448278147591,54631,55869
MUSING.txt,107938,109509,1571,10,N,Y,1448274783410,21836,25159
MUSING.txt,108269,109632,1363,10,N,Y,1448274783410,21836,25159
MUSING.txt,108460,109976,1516,10,N,Y,1448274783410,21836,25159
MUSING.txt,108541,110193,1652,10,N,Y,1448274783410,21836,25159
MUSING.txt,108628,110410,1782,10,N,Y,1448274783410,21836,25159
MUSING.txt,108777,110564,1787,10,N,Y,1448274783410,21836,25159
MUSING.txt,108980,110651,1671,10,N,Y,1448274783410,21836,25159
MUSING.txt,109172,110711,1539,10,N,Y,1448274783410,21836,25159
MUSING.txt,109303,110753,1450,10,N,Y,1448274783410,21836,25159
MUSING.txt,109349,110959,1610,10,N,Y,1448274783410,21836,25159
MUSING.txt,109510,110997,1487,10,N,Y,1448274783410,21836,25159
MUSING.txt,109635,111168,1533,10,N,N,-,-1,-1
MUSING.txt,109977,111305,1328,10,N,N,-,-1,-1
MUSING.txt,110194,111366,1172,10,N,N,-,-1,-1
MUSING.txt,110412,111538,1126,10,N,N,-,-1,-1
MUSING.txt,110565,111684,1119,10,N,N,-,-1,-1
MUSING.txt,110654,111732,1078,10,N,N,-,-1,-1
MUSING.txt,110712,111821,1109,10,N,N,-,-1,-1
MUSING.txt,110754,111898,1144,10,N,N,-,-1,-1
MUSING.txt,110962,111939,977,10,N,N,-,-1,-1
MUSING.txt,110998,112062,1064,10,N,N,-,-1,-1
MUSING.txt,111169,112092,923,10,N,N,-,-1,-1
MUSING.txt,111306,112208,902,10,N,N,-,-1,-1
MUSING.txt,111367,112331,964,10,N,N,-,-1,-1
MUSING.txt,111540,112460,920,10,N,N,-,-1,-1
MUSING.txt,111685,112562,877,10,N,N,-,-1,-1
MUSING.txt,111733,112766,1033,10,N,N,-,-1,-1
MUSING.txt,111822,112840,1018,10,N,N,-,-1,-1
MUSING.txt,111899,113050,1151,10,N,N,-,-1,-1
MUSING.txt,111942,113282,1340,10,N,N,-,-1,-1
MUSING.txt,112063,113362,1299,10,N,N,-,-1,-1
MUSING.txt,112093,113600,1507,10,N,N,-,-1,-1
MUSING.txt,112209,113711,1502,10,N,Y,1448039123601,19678,19935
MUSING.txt,112332,113797,1465,10,N,Y,1448039123601,19678,19935
MUSING.txt,112463,114036,1573,10,Y,Y,1448039123601,19678,19935
MUSING.txt,112563,114304,1741,10,Y,Y,1448039123601,19678,19935
MUSING.txt,112767,114429,1662,10,N,Y,1448039123601,19678,19935
MUSING.txt,112845,114566,1721,10,N,Y,1448039123601,19678,19935
MUSING.txt,113051,114652,1601,10,N,Y,1448039123601,19678,19935
MUSING.txt,113283,114796,1513,10,N,Y,1448039123601,19678,19935
MUSING.txt,113363,115180,1817,10,Y,Y,1448039123601,19678,19935
MUSING.txt,113603,115535,1932,10,N,Y,1448039123601,19678,19935
MUSING.txt,113712,115555,1843,10,N,Y,1448039123601,19678,19935
MUSING.txt,113798,115712,1914,10,N,Y,1448039123601,19678,19935
MUSING.txt,114039,115881,1842,10,N,N,-,-1,-1
MUSING.txt,114305,115937,1632,10,N,N,-,-1,-1
MUSING.txt,114432,116085,1653,10,N,N,-,-1,-1
MUSING.txt,114568,116195,1627,10,N,N,-,-1,-1
MUSING.txt,114653,116375,1722,10,N,N,-,-1,-1
MUSING.txt,114799,116603,1804,10,N,N,-,-1,-1
MUSING.txt,115183,116913,1730,10,N,N,-,-1,-1
MUSING.txt,115537,117020,1483,10,N,N,-,-1,-1
MUSING.txt,115556,117245,1689,10,N,N,-,-1,-1
MUSING.txt,115713,117758,2045,10,Y,N,-,-1,-1
MUSING.txt,115882,117888,2006,10,Y,N,-,-1,-1
MUSING.txt,115938,118137,2199,10,Y,N,-,-1,-1
MUSING.txt,116088,118622,2534,10,Y,N,-,-1,-1
MUSING.txt,116196,118785,2589,10,Y,N,-,-1,-1
MUSING.txt,116376,118908,2532,10,N,N,-,-1,-1
MUSING.txt,116604,118927,2323,10,Y,N,-,-1,-1
MUSING.txt,116914,119026,2112,10,Y,N,-,-1,-1
MUSING.txt,117021,119079,2058,10,Y,N,-,-1,-1
MUSING.txt,117246,119218,1972,10,N,N,-,-1,-1
MUSING.txt,117759,119284,1525,10,N,N,-,-1,-1
MUSING.txt,117890,119387,1497,10,N,N,-,-1,-1
MUSING.txt,118138,119686,1548,10,N,N,-,-1,-1
MUSING.txt,118625,119720,1095,10,N,N,-,-1,-1
MUSING.txt,118786,119771,985,10,N,N,-,-1,-1
MUSING.txt,118909,119816,907,10,N,N,-,-1,-1
MUSING.txt,118928,120152,1224,10,N,N,-,-1,-1
MUSING.txt,119027,120242,1215,10,N,N,-,-1,-1
MUSING.txt,119080,120472,1392,10,N,N,-,-1,-1
MUSING.txt,119219,120793,1574,10,N,N,-,-1,-1
MUSING.txt,119285,120857,1572,10,N,N,-,-1,-1
MUSING.txt,119392,121058,1666,10,N,N,-,-1,-1
MUSING.txt,119687,121224,1537,10,N,N,-,-1,-1
MUSING.txt,119721,121326,1605,10,N,N,-,-1,-1
MUSING.txt,119774,121414,1640,10,N,N,-,-1,-1
MUSING.txt,119819,121722,1903,10,N,Y,1448287306770,114686,120152
MUSING.txt,120153,121723,1570,10,N,Y,1448287306770,114686,120152
MUSING.txt,120245,121986,1741,10,N,Y,1448287306770,114686,120152
MUSING.txt,120473,122393,1920,10,N,Y,1448287306770,114686,120152
MUSING.txt,120794,122778,1984,10,N,Y,1448287306770,114686,120152
MUSING.txt,120860,122781,1921,10,N,Y,1448287306770,114686,120152
MUSING.txt,121061,122935,1874,10,N,Y,1448287306770,114686,120152
MUSING.txt,121225,123155,1930,10,N,Y,1448287306770,114686,120152
MUSING.txt,121327,123275,1948,10,N,Y,1448287306770,114686,120152
MUSING.txt,121415,123455,2040,10,N,Y,1448287306770,114686,120152
MUSING.txt,121722,123791,2069,10,N,Y,1448287306770,114686,120152
MUSING.txt,121726,124092,2366,10,Y,Y,1448287306770,114686,120152
MUSING.txt,121987,124161,2174,10,N,N,-,-1,-1
MUSING.txt,122394,124188,1794,10,N,N,-,-1,-1
MUSING.txt,122780,124535,1755,10,N,N,-,-1,-1
MUSING.txt,122784,124752,1968,10,N,N,-,-1,-1
MUSING.txt,122936,124770,1834,10,N,N,-,-1,-1
MUSING.txt,123158,124835,1677,10,N,N,-,-1,-1
MUSING.txt,123280,124983,1703,10,N,N,-,-1,-1
MUSING.txt,123456,125145,1689,10,N,N,-,-1,-1
MUSING.txt,123793,125247,1454,10,N,N,-,-1,-1
MUSING.txt,124097,125339,1242,10,N,N,-,-1,-1
MUSING.txt,124164,125504,1340,10,N,N,-,-1,-1
MUSING.txt,124189,125556,1367,10,N,N,-,-1,-1
MUSING.txt,124536,125616,1080,10,N,N,-,-1,-1
MUSING.txt,124755,125705,950,10,N,N,-,-1,-1
MUSING.txt,124773,125746,973,10,N,N,-,-1,-1
MUSING.txt,124836,125862,1026,10,N,N,-,-1,-1
MUSING.txt,124984,126054,1070,10,N,N,-,-1,-1
MUSING.txt,125148,126366,1218,10,N,N,-,-1,-1
MUSING.txt,125248,126457,1209,10,N,N,-,-1,-1
MUSING.txt,125340,126574,1234,10,N,N,-,-1,-1
MUSING.txt,125507,126692,1185,10,N,N,-,-1,-1
MUSING.txt,125557,126836,1279,10,N,N,-,-1,-1
MUSING.txt,125619,126869,1250,10,N,N,-,-1,-1
MUSING.txt,125707,127273,1566,10,N,Y,1448279089520,67624,69991
MUSING.txt,125748,127287,1539,10,N,Y,1448279089520,67624,69991
MUSING.txt,125863,127389,1526,10,N,Y,1448279089520,67624,69991
MUSING.txt,126057,127630,1573,10,N,Y,1448279089520,67624,69991
MUSING.txt,126371,127838,1467,10,N,Y,1448279089520,67624,69991
MUSING.txt,126460,128042,1582,10,N,Y,1448279089520,67624,69991
MUSING.txt,126577,128182,1605,10,N,Y,1448279089520,67624,69991
MUSING.txt,126693,128436,1743,10,N,Y,1448279089520,67624,69991
MUSING.txt,126837,128715,1878,10,N,Y,1448279089520,67624,69991
MUSING.txt,126870,128743,1873,10,N,Y,1448279089520,67624,69991
MUSING.txt,127274,128897,1623,10,N,Y,1448279089520,67624,69991
MUSING.txt,127290,128937,1647,10,N,N,-,-1,-1
MUSING.txt,127390,129307,1917,10,N,N,-,-1,-1
MUSING.txt,127635,129569,1934,10,N,N,-,-1,-1
MUSING.txt,127839,129587,1748,10,N,N,-,-1,-1
MUSING.txt,128043,129647,1604,10,N,N,-,-1,-1
MUSING.txt,128183,129802,1619,10,N,N,-,-1,-1
MUSING.txt,128438,129834,1396,10,N,N,-,-1,-1
MUSING.txt,128716,130008,1292,10,N,N,-,-1,-1
MUSING.txt,128746,130174,1428,10,N,N,-,-1,-1
MUSING.txt,128900,130211,1311,10,N,N,-,-1,-1
MUSING.txt,128942,130319,1377,10,N,N,-,-1,-1
MUSING.txt,129308,130346,1038,10,N,N,-,-1,-1
MUSING.txt,129570,130507,937,10,N,N,-,-1,-1
MUSING.txt,129588,130518,930,10,N,N,-,-1,-1
MUSING.txt,129648,130586,938,10,N,N,-,-1,-1
MUSING.txt,129803,130733,930,10,N,N,-,-1,-1
MUSING.txt,129835,130908,1073,10,N,N,-,-1,-1
MUSING.txt,130009,131036,1027,10,N,N,-,-1,-1
MUSING.txt,130176,131206,1030,10,N,N,-,-1,-1
MUSING.txt,130212,131368,1156,10,N,N,-,-1,-1
MUSING.txt,130320,131716,1396,10,N,N,-,-1,-1
MUSING.txt,130347,131840,1493,10,N,N,-,-1,-1
MUSING.txt,130510,131976,1466,10,N,N,-,-1,-1
MUSING.txt,130521,132124,1603,10,N,N,-,-1,-1
MUSING.txt,130587,132196,1609,10,N,N,-,-1,-1
MUSING.txt,130734,132277,1543,10,N,N,-,-1,-1
MUSING.txt,130909,132374,1465,10,N,N,-,-1,-1
MUSING.txt,131037,132676,1639,10,N,N,-,-1,-1
MUSING.txt,131207,132719,1512,10,N,N,-,-1,-1
MUSING.txt,131373,132922,1549,10,N,N,-,-1,-1
MUSING.txt,131717,133029,1312,10,N,N,-,-1,-1
MUSING.txt,131841,133153,1312,10,N,N,-,-1,-1
MUSING.txt,131979,133301,1322,10,N,N,-,-1,-1
MUSING.txt,132125,133428,1303,10,N,N,-,-1,-1
MUSING.txt,132198,133535,1337,10,N,N,-,-1,-1
MUSING.txt,132280,133666,1386,10,N,N,-,-1,-1
MUSING.txt,132375,133757,1382,10,N,N,-,-1,-1
MUSING.txt,132681,133866,1185,10,N,N,-,-1,-1
MUSING.txt,132722,134103,1381,10,N,N,-,-1,-1
MUSING.txt,132923,134202,1279,10,N,N,-,-1,-1
MUSING.txt,133031,134211,1180,10,N,N,-,-1,-1
MUSING.txt,133154,134291,1137,10,N,N,-,-1,-1
MUSING.txt,133304,134484,1180,10,N,N,-,-1,-1
MUSING.txt,133429,134840,1411,10,N,N,-,-1,-1
MUSING.txt,133537,135009,1472,10,N,N,-,-1,-1
MUSING.txt,133667,135210,1543,10,N,N,-,-1,-1
MUSING.txt,133758,135390,1632,10,N,N,-,-1,-1
MUSING.txt,133867,135557,1690,10,N,N,-,-1,-1
MUSING.txt,134104,135588,1484,10,N,N,-,-1,-1
MUSING.txt,134203,135644,1441,10,N,N,-,-1,-1
MUSING.txt,134212,135780,1568,10,N,N,-,-1,-1
MUSING.txt,134292,135988,1696,10,N,N,-,-1,-1
MUSING.txt,134485,136100,1615,10,N,N,-,-1,-1
MUSING.txt,134841,136560,1719,10,N,N,-,-1,-1
MUSING.txt,135012,136605,1593,10,N,N,-,-1,-1
MUSING.txt,135215,136641,1426,10,N,N,-,-1,-1
MUSING.txt,135391,136744,1353,10,N,N,-,-1,-1
MUSING.txt,135558,136840,1282,10,N,N,-,-1,-1
MUSING.txt,135589,136886,1297,10,N,N,-,-1,-1
MUSING.txt,135647,136940,1293,10,N,N,-,-1,-1
MUSING.txt,135782,137048,1266,10,N,N,-,-1,-1
MUSING.txt,135989,137109,1120,10,N,N,-,-1,-1
MUSING.txt,136101,137277,1176,10,N,N,-,-1,-1
MUSING.txt,136562,137318,756,10,N,N,-,-1,-1
MUSING.txt,136607,137333,726,10,N,N,-,-1,-1
MUSING.txt,136642,137371,729,10,N,N,-,-1,-1
MUSING.txt,136747,137435,688,10,N,N,-,-1,-1
MUSING.txt,136843,137571,728,10,N,N,-,-1,-1
MUSING.txt,136888,137614,726,10,N,N,-,-1,-1
MUSING.txt,136943,137652,709,10,N,N,-,-1,-1
MUSING.txt,137051,137781,730,10,N,N,-,-1,-1
MUSING.txt,137110,137880,770,10,N,N,-,-1,-1
MUSING.txt,137279,137941,662,10,N,N,-,-1,-1
MUSING.txt,137319,138082,763,10,N,N,-,-1,-1
MUSING.txt,137334,138310,976,10,N,N,-,-1,-1
MUSING.txt,137373,138399,1026,10,N,N,-,-1,-1
MUSING.txt,137436,138513,1077,10,N,N,-,-1,-1
MUSING.txt,137576,138728,1152,10,N,N,-,-1,-1
MUSING.txt,137617,138739,1122,10,N,N,-,-1,-1
MUSING.txt,137653,138877,1224,10,N,N,-,-1,-1
MUSING.txt,137782,138958,1176,10,N,N,-,-1,-1
MUSING.txt,137881,139003,1122,10,N,N,-,-1,-1
MUSING.txt,137942,139135,1193,10,N,N,-,-1,-1
MUSING.txt,138083,139306,1223,10,N,N,-,-1,-1
MUSING.txt,138311,139445,1134,10,N,N,-,-1,-1
MUSING.txt,138400,139481,1081,10,N,N,-,-1,-1
MUSING.txt,138516,139574,1058,10,N,N,-,-1,-1
MUSING.txt,138731,139731,1000,10,N,N,-,-1,-1
MUSING.txt,138742,139825,1083,10,N,N,-,-1,-1
MUSING.txt,138882,139967,1085,10,N,N,-,-1,-1
MUSING.txt,138959,140128,1169,10,N,N,-,-1,-1
MUSING.txt,139004,140414,1410,10,N,N,-,-1,-1
MUSING.txt,139138,140597,1459,10,N,N,-,-1,-1
MUSING.txt,139307,140608,1301,10,N,N,-,-1,-1
MUSING.txt,139446,140793,1347,10,N,Y,1448315012079,181380,182053
MUSING.txt,139482,140877,1395,10,N,Y,1448315012079,181380,182053
MUSING.txt,139575,140930,1355,10,N,Y,1448315012079,181380,182053
MUSING.txt,139732,140988,1256,10,N,Y,1448315012079,181380,182053
MUSING.txt,139826,141178,1352,10,N,Y,1448315012079,181380,182053
MUSING.txt,139968,141189,1221,10,N,Y,1448315012079,181380,182053
MUSING.txt,140129,141277,1148,10,N,Y,1448315012079,181380,182053
MUSING.txt,140415,141344,929,10,N,Y,1448315012079,181380,182053
MUSING.txt,140600,141421,821,10,N,Y,1448315012079,181380,182053
MUSING.txt,140611,141518,907,10,N,Y,1448315012079,181380,182053
MUSING.txt,140794,141559,765,10,N,Y,1448315012079,181380,182053
MUSING.txt,140878,141631,753,10,N,Y,1448315012079,181380,182053
MUSING.txt,140931,141758,827,10,N,Y,1448315012079,181380,182053
MUSING.txt,140989,141798,809,10,N,Y,1448315012079,181380,182053
MUSING.txt,141181,141809,628,10,N,N,-,-1,-1
MUSING.txt,141192,141894,702,10,N,N,-,-1,-1
MUSING.txt,141279,141924,645,10,N,N,-,-1,-1
MUSING.txt,141345,142030,685,10,N,N,-,-1,-1
MUSING.txt,141422,142142,720,10,N,N,-,-1,-1
MUSING.txt,141519,142555,1036,10,N,N,-,-1,-1
MUSING.txt,141560,142763,1203,10,N,N,-,-1,-1
MUSING.txt,141632,142868,1236,10,N,N,-,-1,-1
MUSING.txt,141759,142931,1172,10,N,N,-,-1,-1
MUSING.txt,141801,143226,1425,10,N,N,-,-1,-1
MUSING.txt,141812,143420,1608,10,N,N,-,-1,-1
MUSING.txt,141895,143429,1534,10,N,N,-,-1,-1
MUSING.txt,141925,143571,1646,10,N,N,-,-1,-1
MUSING.txt,142031,143617,1586,10,N,N,-,-1,-1
MUSING.txt,142143,143676,1533,10,N,N,-,-1,-1
MUSING.txt,142556,143757,1201,10,N,N,-,-1,-1
MUSING.txt,142764,144079,1315,10,N,N,-,-1,-1
MUSING.txt,142869,144120,1251,10,N,N,-,-1,-1
MUSING.txt,142932,144323,1391,10,N,N,-,-1,-1
MUSING.txt,143231,144443,1212,10,N,N,-,-1,-1
MUSING.txt,143421,144457,1036,10,N,N,-,-1,-1
MUSING.txt,143430,144603,1173,10,N,N,-,-1,-1
MUSING.txt,143572,144839,1267,10,N,N,-,-1,-1
MUSING.txt,143619,144938,1319,10,N,N,-,-1,-1
MUSING.txt,143677,145057,1380,10,N,N,-,-1,-1
MUSING.txt,143759,145244,1485,10,N,N,-,-1,-1
MUSING.txt,144080,145277,1197,10,N,N,-,-1,-1
MUSING.txt,144121,145313,1192,10,N,N,-,-1,-1
MUSING.txt,144324,145379,1055,10,N,N,-,-1,-1
MUSING.txt,144444,145575,1131,10,N,N,-,-1,-1
MUSING.txt,144459,145856,1397,10,N,N,-,-1,-1
MUSING.txt,144608,145944,1336,10,N,N,-,-1,-1
MUSING.txt,144840,146264,1424,10,N,N,-,-1,-1
MUSING.txt,144941,146780,1839,10,N,N,-,-1,-1
MUSING.txt,145058,147063,2005,10,N,N,-,-1,-1
MUSING.txt,145245,147165,1920,10,N,N,-,-1,-1
MUSING.txt,145278,147504,2226,10,N,N,-,-1,-1
MUSING.txt,145314,147914,2600,10,N,N,-,-1,-1
MUSING.txt,145382,148585,3203,10,N,N,-,-1,-1
MUSING.txt,145578,148846,3268,10,N,N,-,-1,-1
MUSING.txt,145857,148888,3031,10,N,N,-,-1,-1
MUSING.txt,145947,148970,3023,10,N,N,-,-1,-1
MUSING.txt,146267,149019,2752,10,N,N,-,-1,-1
MUSING.txt,146783,149124,2341,10,N,N,-,-1,-1
MUSING.txt,147066,149168,2102,10,N,N,-,-1,-1
MUSING.txt,147166,149185,2019,10,N,N,-,-1,-1
MUSING.txt,147507,149295,1788,10,N,N,-,-1,-1
MUSING.txt,147917,149405,1488,10,N,N,-,-1,-1
MUSING.txt,148590,149438,848,10,N,N,-,-1,-1
MUSING.txt,148847,149467,620,10,N,N,-,-1,-1
MUSING.txt,148892,149636,744,10,N,N,-,-1,-1
MUSING.txt,148971,149958,987,10,N,N,-,-1,-1
MUSING.txt,149020,150060,1040,10,N,N,-,-1,-1
MUSING.txt,149125,150116,991,10,N,N,-,-1,-1
MUSING.txt,149170,150220,1050,10,N,N,-,-1,-1
MUSING.txt,149186,150428,1242,10,N,N,-,-1,-1
MUSING.txt,149296,150521,1225,10,N,N,-,-1,-1
MUSING.txt,149406,150854,1448,10,N,N,-,-1,-1
MUSING.txt,149439,151044,1605,10,N,N,-,-1,-1
MUSING.txt,149468,151212,1744,10,N,N,-,-1,-1
MUSING.txt,149637,151328,1691,10,N,N,-,-1,-1
MUSING.txt,149963,151407,1444,10,N,N,-,-1,-1
MUSING.txt,150061,151447,1386,10,N,N,-,-1,-1
MUSING.txt,150117,151499,1382,10,N,N,-,-1,-1
MUSING.txt,150223,151606,1383,10,N,N,-,-1,-1
MUSING.txt,150429,151732,1303,10,N,N,-,-1,-1
MUSING.txt,150522,151823,1301,10,N,N,-,-1,-1
MUSING.txt,150857,151939,1082,10,N,N,-,-1,-1
MUSING.txt,151045,152028,983,10,N,Y,1448311594480,155711,156312
MUSING.txt,151214,152191,977,10,N,Y,1448311594480,155711,156312
MUSING.txt,151329,152403,1074,10,N,Y,1448311594480,155711,156312
MUSING.txt,151408,152576,1168,10,N,Y,1448311594480,155711,156312
MUSING.txt,151450,152642,1192,10,N,Y,1448311594480,155711,156312
MUSING.txt,151500,152753,1253,10,N,Y,1448311594480,155711,156312
MUSING.txt,151609,152892,1283,10,N,Y,1448311594480,155711,156312
MUSING.txt,151733,153020,1287,10,N,Y,1448311594480,155711,156312
MUSING.txt,151824,153223,1399,10,N,Y,1448311594480,155711,156312
MUSING.txt,151942,153310,1368,10,N,Y,1448311594480,155711,156312
MUSING.txt,152030,153366,1336,10,N,Y,1448311594480,155711,156312
MUSING.txt,152192,153442,1250,10,N,Y,1448311594480,155711,156312
MUSING.txt,152404,153500,1096,10,N,Y,1448311594480,155711,156312
MUSING.txt,152577,153571,994,10,N,Y,1448311594480,155711,156312
MUSING.txt,152643,153592,949,10,N,Y,1448311594480,155711,156312
MUSING.txt,152754,153708,954,10,N,Y,1448311594480,155711,156312
MUSING.txt,152895,153868,973,10,N,N,-,-1,-1
MUSING.txt,153023,153879,856,10,N,N,-,-1,-1
MUSING.txt,153226,154018,792,10,N,N,-,-1,-1
MUSING.txt,153311,154119,808,10,N,N,-,-1,-1
MUSING.txt,153367,154309,942,10,N,N,-,-1,-1
MUSING.txt,153444,154440,996,10,N,N,-,-1,-1
MUSING.txt,153501,154589,1088,10,N,N,-,-1,-1
MUSING.txt,153572,154686,1114,10,N,N,-,-1,-1
MUSING.txt,153593,154716,1123,10,N,N,-,-1,-1
MUSING.txt,153709,154796,1087,10,N,N,-,-1,-1
MUSING.txt,153871,154991,1120,10,N,Y,1448311811907,157566,161100
MUSING.txt,153882,155091,1209,10,N,Y,1448311811907,157566,161100
MUSING.txt,154020,155209,1189,10,N,Y,1448311811907,157566,161100
MUSING.txt,154120,155311,1191,10,N,Y,1448311811907,157566,161100
MUSING.txt,154310,155422,1112,10,N,Y,1448311811907,157566,161100
MUSING.txt,154441,155457,1016,10,N,Y,1448311811907,157566,161100
MUSING.txt,154590,155507,917,10,N,Y,1448311811907,157566,161100
MUSING.txt,154687,155587,900,10,N,Y,1448311811907,157566,161100
MUSING.txt,154719,155614,895,10,N,Y,1448311811907,157566,161100
MUSING.txt,154797,155775,978,10,N,Y,1448311811907,157566,161100
MUSING.txt,154992,155822,830,10,N,Y,1448311811907,157566,161100
MUSING.txt,155092,155936,844,10,N,Y,1448311811907,157566,161100
MUSING.txt,155210,155976,766,10,N,Y,1448311811907,157566,161100
MUSING.txt,155312,156051,739,10,N,Y,1448311811907,157566,161100
MUSING.txt,155425,156078,653,10,N,N,-,-1,-1
MUSING.txt,155460,156428,968,10,N,N,-,-1,-1
MUSING.txt,155509,156638,1129,10,N,N,-,-1,-1
MUSING.txt,155588,156748,1160,10,N,N,-,-1,-1
MUSING.txt,155615,156914,1299,10,N,N,-,-1,-1
MUSING.txt,155776,156939,1163,10,N,N,-,-1,-1
MUSING.txt,155823,157034,1211,10,N,N,-,-1,-1
MUSING.txt,155937,157273,1336,10,N,N,-,-1,-1
MUSING.txt,155978,157637,1659,10,N,N,-,-1,-1
MUSING.txt,156054,157719,1665,10,N,N,-,-1,-1
MUSING.txt,156079,157985,1906,10,N,N,-,-1,-1
MUSING.txt,156433,158080,1647,10,N,N,-,-1,-1
MUSING.txt,156639,158174,1535,10,N,N,-,-1,-1
MUSING.txt,156751,158233,1482,10,N,N,-,-1,-1
MUSING.txt,156915,158537,1622,10,N,N,-,-1,-1
MUSING.txt,156940,158572,1632,10,N,N,-,-1,-1
MUSING.txt,157035,158679,1644,10,N,N,-,-1,-1
MUSING.txt,157274,158805,1531,10,N,N,-,-1,-1
MUSING.txt,157640,158994,1354,10,N,N,-,-1,-1
MUSING.txt,157720,159273,1553,10,N,N,-,-1,-1
MUSING.txt,157986,159326,1340,10,N,N,-,-1,-1
MUSING.txt,158081,159535,1454,10,N,N,-,-1,-1
MUSING.txt,158175,159880,1705,10,N,N,-,-1,-1
MUSING.txt,158234,160096,1862,10,N,N,-,-1,-1
MUSING.txt,158538,160221,1683,10,N,N,-,-1,-1
MUSING.txt,158573,160392,1819,10,N,N,-,-1,-1
MUSING.txt,158680,160558,1878,10,N,N,-,-1,-1
MUSING.txt,158810,160919,2109,10,N,N,-,-1,-1
MUSING.txt,158995,161088,2093,10,N,N,-,-1,-1
MUSING.txt,159276,161341,2065,10,N,N,-,-1,-1
MUSING.txt,159327,161609,2282,10,N,N,-,-1,-1
MUSING.txt,159536,161718,2182,10,N,N,-,-1,-1
MUSING.txt,159883,161758,1875,10,N,N,-,-1,-1
MUSING.txt,160097,161845,1748,10,N,N,-,-1,-1
MUSING.txt,160222,162463,2241,10,N,N,-,-1,-1
MUSING.txt,160393,162526,2133,10,N,N,-,-1,-1
MUSING.txt,160561,162760,2199,10,N,N,-,-1,-1
MUSING.txt,160922,163099,2177,10,N,N,-,-1,-1
MUSING.txt,161091,163228,2137,10,N,N,-,-1,-1
MUSING.txt,161346,163584,2238,10,N,N,-,-1,-1
MUSING.txt,161612,163793,2181,10,N,N,-,-1,-1
MUSING.txt,161719,163832,2113,10,N,N,-,-1,-1
MUSING.txt,161761,163857,2096,10,N,N,-,-1,-1
MUSING.txt,161846,163927,2081,10,N,N,-,-1,-1
MUSING.txt,162466,164031,1565,10,N,N,-,-1,-1
MUSING.txt,162527,164056,1529,10,N,N,-,-1,-1
MUSING.txt,162763,164144,1381,10,N,N,-,-1,-1
MUSING.txt,163100,164486,1386,10,N,N,-,-1,-1
MUSING.txt,163230,164919,1689,10,N,N,-,-1,-1
MUSING.txt,163587,165064,1477,10,N,N,-,-1,-1
MUSING.txt,163794,165152,1358,10,N,N,-,-1,-1
MUSING.txt,163833,165203,1370,10,N,N,-,-1,-1
MUSING.txt,163858,165427,1569,10,N,N,-,-1,-1
MUSING.txt,163932,165615,1683,10,N,N,-,-1,-1
MUSING.txt,164032,165859,1827,10,N,N,-,-1,-1
MUSING.txt,164057,165967,1910,10,N,N,-,-1,-1
MUSING.txt,164146,166141,1995,10,N,N,-,-1,-1
MUSING.txt,164489,166301,1812,10,N,N,-,-1,-1
MUSING.txt,164920,166375,1455,10,N,N,-,-1,-1
MUSING.txt,165065,166449,1384,10,N,N,-,-1,-1
MUSING.txt,165153,166653,1500,10,N,N,-,-1,-1
MUSING.txt,165204,166776,1572,10,N,N,-,-1,-1
MUSING.txt,165428,166831,1403,10,N,N,-,-1,-1
MUSING.txt,165618,166918,1300,10,N,N,-,-1,-1
MUSING.txt,165860,166989,1129,10,N,N,-,-1,-1
MUSING.txt,165968,167016,1048,10,N,N,-,-1,-1
MUSING.txt,166144,167281,1137,10,N,N,-,-1,-1
MUSING.txt,166302,167710,1408,10,N,N,-,-1,-1
MUSING.txt,166376,167885,1509,10,N,N,-,-1,-1
MUSING.txt,166450,168659,2209,10,N,N,-,-1,-1
MUSING.txt,166656,169017,2361,10,N,N,-,-1,-1
MUSING.txt,166777,169445,2668,10,N,N,-,-1,-1
MUSING.txt,166833,169516,2683,10,N,N,-,-1,-1
MUSING.txt,166921,170327,3406,10,N,N,-,-1,-1
MUSING.txt,166990,170698,3708,10,Y,N,-,-1,-1
MUSING.txt,167017,170795,3778,10,Y,N,-,-1,-1
MUSING.txt,167282,171185,3903,10,Y,N,-,-1,-1
MUSING.txt,167711,171419,3708,10,Y,N,-,-1,-1
MUSING.txt,167890,171597,3707,10,Y,N,-,-1,-1
MUSING.txt,168662,171727,3065,10,Y,N,-,-1,-1
MUSING.txt,169018,171800,2782,10,Y,N,-,-1,-1
MUSING.txt,169446,171829,2383,10,Y,N,-,-1,-1
MUSING.txt,169519,171997,2478,10,Y,N,-,-1,-1
MUSING.txt,170328,172095,1767,10,N,N,-,-1,-1
MUSING.txt,170700,172551,1851,10,N,N,-,-1,-1
MUSING.txt,170797,172623,1826,10,N,N,-,-1,-1
MUSING.txt,171186,172710,1524,10,N,N,-,-1,-1
MUSING.txt,171420,173067,1647,10,N,N,-,-1,-1
MUSING.txt,171602,173234,1632,10,N,N,-,-1,-1
MUSING.txt,171730,173813,2083,10,Y,N,-,-1,-1
MUSING.txt,171801,173967,2166,10,Y,N,-,-1,-1
MUSING.txt,171830,174229,2399,10,Y,N,-,-1,-1
MUSING.txt,172000,174787,2787,10,Y,N,-,-1,-1
MUSING.txt,172096,175006,2910,10,Y,N,-,-1,-1
MUSING.txt,172554,175057,2503,10,Y,N,-,-1,-1
MUSING.txt,172624,175186,2562,10,Y,N,-,-1,-1
MUSING.txt,172711,175630,2919,10,Y,N,-,-1,-1
MUSING.txt,173068,175814,2746,10,Y,N,-,-1,-1
MUSING.txt,173235,175934,2699,10,Y,N,-,-1,-1
MUSING.txt,173816,176014,2198,10,N,N,-,-1,-1
MUSING.txt,173968,176302,2334,10,Y,N,-,-1,-1
MUSING.txt,174230,176691,2461,10,Y,N,-,-1,-1
MUSING.txt,174788,176991,2203,10,Y,N,-,-1,-1
MUSING.txt,175007,177171,2164,10,Y,N,-,-1,-1
MUSING.txt,175058,177196,2138,10,Y,N,-,-1,-1
MUSING.txt,175187,177627,2440,10,Y,N,-,-1,-1
MUSING.txt,175635,177806,2171,10,Y,N,-,-1,-1
MUSING.txt,175815,177854,2039,10,Y,N,-,-1,-1
MUSING.txt,175936,178194,2258,10,Y,N,-,-1,-1
MUSING.txt,176015,178271,2256,10,Y,N,-,-1,-1
MUSING.txt,176303,178437,2134,10,N,N,-,-1,-1
MUSING.txt,176694,178584,1890,10,N,N,-,-1,-1
MUSING.txt,176992,178939,1947,10,N,N,-,-1,-1
MUSING.txt,177174,179005,1831,10,N,N,-,-1,-1
MUSING.txt,177197,179254,2057,10,N,N,-,-1,-1
MUSING.txt,177630,179339,1709,10,N,N,-,-1,-1
MUSING.txt,177808,179547,1739,10,N,N,-,-1,-1
MUSING.txt,177857,179955,2098,10,N,N,-,-1,-1
MUSING.txt,178195,180658,2463,10,N,N,-,-1,-1
MUSING.txt,178272,181065,2793,10,N,N,-,-1,-1
MUSING.txt,178442,181396,2954,10,N,N,-,-1,-1
MUSING.txt,178585,181538,2953,10,N,N,-,-1,-1
MUSING.txt,178941,182335,3394,10,N,N,-,-1,-1
MUSING.txt,179006,182627,3621,10,Y,N,-,-1,-1
MUSING.txt,179256,182930,3674,10,N,N,-,-1,-1
MUSING.txt,179340,183310,3970,10,N,N,-,-1,-1
MUSING.txt,179548,183910,4362,10,N,N,-,-1,-1
MUSING.txt,179958,184121,4163,10,N,N,-,-1,-1
MUSING.txt,180659,184240,3581,10,Y,N,-,-1,-1
MUSING.txt,181066,184359,3293,10,N,N,-,-1,-1
MUSING.txt,181397,184437,3040,10,N,N,-,-1,-1
MUSING.txt,181539,184552,3013,10,N,N,-,-1,-1
MUSING.txt,182336,185013,2677,10,N,N,-,-1,-1
MUSING.txt,182628,185083,2455,10,N,N,-,-1,-1
MUSING.txt,182931,185573,2642,10,N,N,-,-1,-1
MUSING.txt,183313,186392,3079,10,N,N,-,-1,-1
MUSING.txt,183913,186819,2906,10,N,N,-,-1,-1
MUSING.txt,184123,186990,2867,10,N,N,-,-1,-1
MUSING.txt,184243,187767,3524,10,N,N,-,-1,-1
MUSING.txt,184362,188278,3916,10,N,N,-,-1,-1
MUSING.txt,184438,188643,4205,10,Y,N,-,-1,-1
MUSING.txt,184553,189125,4572,10,Y,N,-,-1,-1
MUSING.txt,185014,189163,4149,10,Y,N,-,-1,-1
MUSING.txt,185085,189323,4238,10,Y,N,-,-1,-1
MUSING.txt,185576,189424,3848,10,Y,N,-,-1,-1
MUSING.txt,186395,189640,3245,10,Y,N,-,-1,-1
MUSING.txt,186820,189796,2976,10,N,N,-,-1,-1
MUSING.txt,186993,189894,2901,10,N,N,-,-1,-1
MUSING.txt,187770,189943,2173,10,N,N,-,-1,-1
MUSING.txt,188281,190126,1845,10,Y,N,-,-1,-1
MUSING.txt,188644,190276,1632,10,N,N,-,-1,-1
MUSING.txt,189126,190515,1389,10,N,N,-,-1,-1
MUSING.txt,189164,190657,1493,10,Y,N,-,-1,-1
MUSING.txt,189326,190659,1333,10,Y,N,-,-1,-1
MUSING.txt,189425,190685,1260,10,N,N,-,-1,-1
MUSING.txt,189642,190749,1107,10,N,N,-,-1,-1
MUSING.txt,189799,190995,1196,10,N,N,-,-1,-1
MUSING.txt,189895,191129,1234,10,N,N,-,-1,-1
MUSING.txt,189944,191249,1305,10,N,N,-,-1,-1
MUSING.txt,190127,191560,1433,10,N,N,-,-1,-1
MUSING.txt,190278,191690,1412,10,N,N,-,-1,-1
MUSING.txt,190518,191710,1192,10,N,N,-,-1,-1
MUSING.txt,190658,191789,1131,10,N,N,-,-1,-1
MUSING.txt,190659,191994,1335,10,N,N,-,-1,-1
MUSING.txt,190686,192294,1608,10,N,N,-,-1,-1
MUSING.txt,190750,192605,1855,10,N,N,-,-1,-1
MUSING.txt,190998,193010,2012,10,N,N,-,-1,-1
MUSING.txt,191130,193046,1916,10,N,N,-,-1,-1
MUSING.txt,191250,193348,2098,10,N,N,-,-1,-1
MUSING.txt,191561,193565,2004,10,N,N,-,-1,-1
MUSING.txt,191691,193822,2131,10,N,N,-,-1,-1
MUSING.txt,191711,194157,2446,10,N,N,-,-1,-1
MUSING.txt,191792,194305,2513,10,N,N,-,-1,-1
MUSING.txt,191995,194547,2552,10,Y,N,-,-1,-1
MUSING.txt,192295,194707,2412,10,Y,N,-,-1,-1
MUSING.txt,192606,194943,2337,10,Y,N,-,-1,-1
MUSING.txt,193012,195504,2492,10,Y,N,-,-1,-1
MUSING.txt,193049,195645,2596,10,Y,N,-,-1,-1
MUSING.txt,193351,196232,2881,10,N,N,-,-1,-1
MUSING.txt,193566,196591,3025,10,N,N,-,-1,-1
MUSING.txt,193823,196832,3009,10,N,N,-,-1,-1
MUSING.txt,194159,196976,2817,10,Y,N,-,-1,-1
MUSING.txt,194307,197021,2714,10,N,N,-,-1,-1
MUSING.txt,194550,197270,2720,10,N,N,-,-1,-1
MUSING.txt,194708,197874,3166,10,N,N,-,-1,-1
MUSING.txt,194946,198003,3057,10,N,N,-,-1,-1
MUSING.txt,195505,198157,2652,10,N,N,-,-1,-1
MUSING.txt,195646,198215,2569,10,N,N,-,-1,-1
MUSING.txt,196233,198394,2161,10,N,N,-,-1,-1
MUSING.txt,196593,198534,1941,10,N,N,-,-1,-1
MUSING.txt,196833,198625,1792,10,N,N,-,-1,-1
MUSING.txt,196976,198648,1672,10,N,N,-,-1,-1
MUSING.txt,197022,199183,2161,10,N,N,-,-1,-1
MUSING.txt,197271,199920,2649,10,N,N,-,-1,-1
MUSING.txt,197877,199935,2058,10,N,N,-,-1,-1
MUSING.txt,198008,200676,2668,10,N,N,-,-1,-1
MUSING.txt,198158,201070,2912,10,N,N,-,-1,-1
MUSING.txt,198216,201553,3337,10,N,N,-,-1,-1
MUSING.txt,198395,201578,3183,10,N,N,-,-1,-1
MUSING.txt,198535,201803,3268,10,N,N,-,-1,-1
MUSING.txt,198626,202032,3406,10,N,N,-,-1,-1
MUSING.txt,198649,202177,3528,10,N,N,-,-1,-1
MUSING.txt,199186,202282,3096,10,N,N,-,-1,-1
MUSING.txt,199921,202532,2611,10,N,N,-,-1,-1
MUSING.txt,199936,202667,2731,10,N,N,-,-1,-1
MUSING.txt,200681,202805,2124,10,N,N,-,-1,-1
MUSING.txt,201071,203002,1931,10,N,N,-,-1,-1
MUSING.txt,201555,203384,1829,10,N,N,-,-1,-1
MUSING.txt,201579,203663,2084,10,N,N,-,-1,-1
MUSING.txt,201806,204039,2233,10,N,N,-,-1,-1
MUSING.txt,202034,204163,2129,10,N,N,-,-1,-1
MUSING.txt,202178,204223,2045,10,N,N,-,-1,-1
MUSING.txt,202283,204903,2620,10,N,N,-,-1,-1
MUSING.txt,202533,204981,2448,10,N,N,-,-1,-1
MUSING.txt,202670,205174,2504,10,N,N,-,-1,-1
MUSING.txt,202806,205281,2475,10,N,N,-,-1,-1
MUSING.txt,203007,205601,2594,10,N,N,-,-1,-1
MUSING.txt,203385,206537,3152,10,N,N,-,-1,-1
MUSING.txt,203666,206837,3171,10,N,N,-,-1,-1
MUSING.txt,204042,206972,2930,10,N,N,-,-1,-1
MUSING.txt,204166,207187,3021,10,N,N,-,-1,-1
MUSING.txt,204224,207488,3264,10,N,N,-,-1,-1
MUSING.txt,204906,207654,2748,10,N,N,-,-1,-1
MUSING.txt,204982,207916,2934,10,N,N,-,-1,-1
MUSING.txt,205175,208138,2963,10,N,N,-,-1,-1
MUSING.txt,205282,208506,3224,10,N,N,-,-1,-1
MUSING.txt,205606,208825,3219,10,N,N,-,-1,-1
MUSING.txt,206538,208906,2368,10,N,N,-,-1,-1
MUSING.txt,206838,209023,2185,10,Y,N,-,-1,-1
MUSING.txt,206977,209306,2329,10,Y,N,-,-1,-1
MUSING.txt,207188,209459,2271,10,Y,N,-,-1,-1
MUSING.txt,207489,210115,2626,10,Y,N,-,-1,-1
MUSING.txt,207656,210542,2886,10,Y,N,-,-1,-1
MUSING.txt,207919,210586,2667,10,Y,N,-,-1,-1
MUSING.txt,208143,210781,2638,10,Y,N,-,-1,-1
MUSING.txt,208507,211090,2583,10,Y,N,-,-1,-1
MUSING.txt,208827,211215,2388,10,Y,N,-,-1,-1
MUSING.txt,208907,211402,2495,10,Y,N,-,-1,-1
MUSING.txt,209024,211682,2658,10,Y,N,-,-1,-1
MUSING.txt,209307,211772,2465,10,Y,N,-,-1,-1
MUSING.txt,209462,211894,2432,10,Y,N,-,-1,-1
MUSING.txt,210116,211896,1780,10,Y,N,-,-1,-1
MUSING.txt,210543,212086,1543,10,Y,N,-,-1,-1
MUSING.txt,210587,212414,1827,10,Y,N,-,-1,-1
MUSING.txt,210782,212664,1882,10,N,N,-,-1,-1
MUSING.txt,211091,213016,1925,10,N,N,-,-1,-1
MUSING.txt,211216,213130,1914,10,N,N,-,-1,-1
MUSING.txt,211403,213516,2113,10,N,N,-,-1,-1
MUSING.txt,211683,213702,2019,10,N,N,-,-1,-1
MUSING.txt,211773,213778,2005,10,N,N,-,-1,-1
MUSING.txt,211895,214067,2172,10,Y,N,-,-1,-1
MUSING.txt,211899,214388,2489,10,Y,N,-,-1,-1
MUSING.txt,212088,214468,2380,10,Y,N,-,-1,-1
MUSING.txt,212415,214816,2401,10,Y,N,-,-1,-1
MUSING.txt,212667,214884,2217,10,Y,N,-,-1,-1
MUSING.txt,213017,215104,2087,10,Y,N,-,-1,-1
MUSING.txt,213131,215315,2184,10,Y,N,-,-1,-1
MUSING.txt,213517,215539,2022,10,Y,N,-,-1,-1
MUSING.txt,213703,215916,2213,10,Y,N,-,-1,-1
MUSING.txt,213779,216031,2252,10,Y,N,-,-1,-1
MUSING.txt,214069,216127,2058,10,Y,N,-,-1,-1
MUSING.txt,214390,216191,1801,10,Y,N,-,-1,-1
MUSING.txt,214469,216226,1757,10,Y,N,-,-1,-1
MUSING.txt,214817,216330,1513,10,N,N,-,-1,-1
MUSING.txt,214885,216509,1624,10,N,N,-,-1,-1
MUSING.txt,215105,216686,1581,10,N,N,-,-1,-1
MUSING.txt,215316,216761,1445,10,N,N,-,-1,-1
MUSING.txt,215540,216769,1229,10,N,N,-,-1,-1
MUSING.txt,215917,216885,968,10,N,N,-,-1,-1
MUSING.txt,216032,217227,1195,10,N,N,-,-1,-1
MUSING.txt,216128,217709,1581,10,N,N,-,-1,-1
MUSING.txt,216192,218099,1907,10,N,N,-,-1,-1
MUSING.txt,216228,218282,2054,10,N,N,-,-1,-1
MUSING.txt,216331,218691,2360,10,N,N,-,-1,-1
MUSING.txt,216510,218890,2380,10,N,N,-,-1,-1
MUSING.txt,216687,219056,2369,10,N,N,-,-1,-1
MUSING.txt,216762,219313,2551,10,N,N,-,-1,-1
MUSING.txt,216770,219481,2711,10,N,N,-,-1,-1
MUSING.txt,216887,219557,2670,10,N,N,-,-1,-1
MUSING.txt,217228,219679,2451,10,N,N,-,-1,-1
MUSING.txt,217710,219794,2084,10,N,N,-,-1,-1
MUSING.txt,218100,220205,2105,10,N,N,-,-1,-1
MUSING.txt,218285,220274,1989,10,N,N,-,-1,-1
MUSING.txt,218692,220378,1686,10,N,N,-,-1,-1
MUSING.txt,218893,220585,1692,10,N,N,-,-1,-1
MUSING.txt,219058,220839,1781,10,N,N,-,-1,-1
MUSING.txt,219314,220963,1649,10,N,N,-,-1,-1
MUSING.txt,219482,221131,1649,10,N,N,-,-1,-1
MUSING.txt,219558,221220,1662,10,N,N,-,-1,-1
MUSING.txt,219680,221335,1655,10,N,N,-,-1,-1
MUSING.txt,219795,221420,1625,10,N,N,-,-1,-1
MUSING.txt,220206,221712,1506,10,N,N,-,-1,-1
MUSING.txt,220275,221889,1614,10,N,N,-,-1,-1
MUSING.txt,220381,222161,1780,10,N,N,-,-1,-1
MUSING.txt,220586,222587,2001,10,N,N,-,-1,-1
MUSING.txt,220842,222833,1991,10,N,N,-,-1,-1
MUSING.txt,220964,222896,1932,10,N,N,-,-1,-1
MUSING.txt,221132,223044,1912,10,N,N,-,-1,-1
MUSING.txt,221221,223461,2240,10,N,N,-,-1,-1
MUSING.txt,221336,223929,2593,10,N,N,-,-1,-1
MUSING.txt,221421,224197,2776,10,N,N,-,-1,-1
MUSING.txt,221713,224901,3188,10,Y,N,-,-1,-1
MUSING.txt,221890,225074,3184,10,Y,N,-,-1,-1
MUSING.txt,222162,225100,2938,10,Y,N,-,-1,-1
MUSING.txt,222588,225305,2717,10,Y,N,-,-1,-1
MUSING.txt,222836,225455,2619,10,Y,N,-,-1,-1
MUSING.txt,222897,225652,2755,10,Y,N,-,-1,-1
MUSING.txt,223046,225905,2859,10,Y,N,-,-1,-1
MUSING.txt,223464,226062,2598,10,Y,N,-,-1,-1
MUSING.txt,223930,226176,2246,10,Y,N,-,-1,-1
MUSING.txt,224199,226311,2112,10,Y,N,-,-1,-1
MUSING.txt,224902,226477,1575,10,Y,N,-,-1,-1
MUSING.txt,225075,226728,1653,10,Y,N,-,-1,-1
MUSING.txt,225101,226938,1837,10,Y,N,-,-1,-1
MUSING.txt,225306,227169,1863,10,Y,N,-,-1,-1
MUSING.txt,225456,227209,1753,10,Y,N,-,-1,-1
MUSING.txt,225657,227453,1796,10,Y,N,-,-1,-1
MUSING.txt,225906,227482,1576,10,Y,N,-,-1,-1
MUSING.txt,226064,227559,1495,10,Y,N,-,-1,-1
MUSING.txt,226177,227925,1748,10,Y,N,-,-1,-1
MUSING.txt,226312,228052,1740,10,Y,N,-,-1,-1
MUSING.txt,226478,228130,1652,10,Y,N,-,-1,-1
MUSING.txt,226731,228383,1652,10,N,N,-,-1,-1
MUSING.txt,226939,228822,1883,10,N,N,-,-1,-1
MUSING.txt,227172,228909,1737,10,N,N,-,-1,-1
MUSING.txt,227210,228983,1773,10,N,N,-,-1,-1
MUSING.txt,227454,229132,1678,10,N,N,-,-1,-1
MUSING.txt,227483,229246,1763,10,N,N,-,-1,-1
MUSING.txt,227560,229528,1968,10,N,N,-,-1,-1
MUSING.txt,227930,229740,1810,10,N,N,-,-1,-1
MUSING.txt,228055,230100,2045,10,N,N,-,-1,-1
MUSING.txt,228133,230541,2408,10,N,N,-,-1,-1
MUSING.txt,228384,230848,2464,10,N,N,-,-1,-1
MUSING.txt,228823,231040,2217,10,N,N,-,-1,-1
MUSING.txt,228910,231177,2267,10,N,N,-,-1,-1
MUSING.txt,228984,231256,2272,10,N,N,-,-1,-1
MUSING.txt,229133,231572,2439,10,Y,N,-,-1,-1
MUSING.txt,229247,231627,2380,10,Y,N,-,-1,-1
MUSING.txt,229529,231707,2178,10,N,N,-,-1,-1
MUSING.txt,229741,231869,2128,10,N,N,-,-1,-1
MUSING.txt,230101,231935,1834,10,N,N,-,-1,-1
MUSING.txt,230546,232226,1680,10,N,N,-,-1,-1
MUSING.txt,230849,232387,1538,10,N,N,-,-1,-1
MUSING.txt,231042,232671,1629,10,Y,N,-,-1,-1
MUSING.txt,231178,233027,1849,10,Y,N,-,-1,-1
MUSING.txt,231257,233046,1789,10,Y,N,-,-1,-1
MUSING.txt,231575,233378,1803,10,Y,N,-,-1,-1
MUSING.txt,231628,233646,2018,10,Y,N,-,-1,-1
MUSING.txt,231710,233759,2049,10,Y,N,-,-1,-1
MUSING.txt,231870,234145,2275,10,Y,N,-,-1,-1
MUSING.txt,231936,234442,2506,10,Y,N,-,-1,-1
MUSING.txt,232227,234679,2452,10,Y,N,-,-1,-1
MUSING.txt,232388,234932,2544,10,Y,N,-,-1,-1
MUSING.txt,232674,234956,2282,10,Y,N,-,-1,-1
MUSING.txt,233028,235100,2072,10,Y,N,-,-1,-1
MUSING.txt,233047,235404,2357,10,Y,N,-,-1,-1
MUSING.txt,233379,235467,2088,10,Y,N,-,-1,-1
MUSING.txt,233647,235828,2181,10,N,N,-,-1,-1
MUSING.txt,233760,235861,2101,10,N,N,-,-1,-1
MUSING.txt,234146,235874,1728,10,N,N,-,-1,-1
MUSING.txt,234443,235883,1440,10,N,N,-,-1,-1
MUSING.txt,234681,236015,1334,10,N,N,-,-1,-1
MUSING.txt,234933,236077,1144,10,N,N,-,-1,-1
MUSING.txt,234957,236380,1423,10,N,N,-,-1,-1
MUSING.txt,235101,236704,1603,10,N,N,-,-1,-1
MUSING.txt,235406,236750,1344,10,N,N,-,-1,-1
MUSING.txt,235468,236850,1382,10,N,N,-,-1,-1
MUSING.txt,235829,236876,1047,10,N,N,-,-1,-1
MUSING.txt,235862,236958,1096,10,N,N,-,-1,-1
MUSING.txt,235875,237019,1144,10,N,N,-,-1,-1
MUSING.txt,235884,237488,1604,10,N,N,-,-1,-1
MUSING.txt,236016,237650,1634,10,N,N,-,-1,-1
MUSING.txt,236078,238114,2036,10,N,N,-,-1,-1
MUSING.txt,236381,238471,2090,10,N,N,-,-1,-1
MUSING.txt,236706,238581,1875,10,N,N,-,-1,-1
MUSING.txt,236751,238715,1964,10,N,N,-,-1,-1
MUSING.txt,236851,239168,2317,10,N,N,-,-1,-1
MUSING.txt,236877,239539,2662,10,N,N,-,-1,-1
MUSING.txt,236959,239936,2977,10,N,N,-,-1,-1
MUSING.txt,237021,240162,3141,10,N,N,-,-1,-1
MUSING.txt,237493,240344,2851,10,N,N,-,-1,-1
MUSING.txt,237651,240360,2709,10,N,N,-,-1,-1
MUSING.txt,238116,240718,2602,10,N,N,-,-1,-1
MUSING.txt,238474,240966,2492,10,N,N,-,-1,-1
MUSING.txt,238584,241069,2485,10,N,N,-,-1,-1
MUSING.txt,238717,241168,2451,10,Y,N,-,-1,-1
MUSING.txt,239169,241522,2353,10,Y,N,-,-1,-1
MUSING.txt,239540,241555,2015,10,Y,N,-,-1,-1
MUSING.txt,239937,241898,1961,10,Y,N,-,-1,-1
MUSING.txt,240163,241927,1764,10,N,N,-,-1,-1
MUSING.txt,240346,242089,1743,10,N,N,-,-1,-1
MUSING.txt,240361,242205,1844,10,N,N,-,-1,-1
MUSING.txt,240721,242247,1526,10,N,N,-,-1,-1
MUSING.txt,240969,242429,1460,10,N,N,-,-1,-1
MUSING.txt,241071,242727,1656,10,Y,N,-,-1,-1
MUSING.txt,241171,243110,1939,10,Y,N,-,-1,-1
MUSING.txt,241523,243858,2335,10,Y,N,-,-1,-1
MUSING.txt,241558,244048,2490,10,Y,N,-,-1,-1
MUSING.txt,241899,244093,2194,10,N,N,-,-1,-1
MUSING.txt,241929,244412,2483,10,N,N,-,-1,-1
MUSING.txt,242090,244681,2591,10,Y,N,-,-1,-1
MUSING.txt,242206,244923,2717,10,Y,N,-,-1,-1
MUSING.txt,242248,245076,2828,10,Y,N,-,-1,-1
MUSING.txt,242431,245128,2697,10,N,N,-,-1,-1
MUSING.txt,242732,245229,2497,10,N,N,-,-1,-1
MUSING.txt,243113,245267,2154,10,N,N,-,-1,-1
MUSING.txt,243861,245436,1575,10,N,N,-,-1,-1
MUSING.txt,244049,245523,1474,10,N,N,-,-1,-1
MUSING.txt,244094,245654,1560,10,N,N,-,-1,-1
MUSING.txt,244413,245917,1504,10,N,N,-,-1,-1
MUSING.txt,244684,246067,1383,10,N,N,-,-1,-1
MUSING.txt,244924,246468,1544,10,N,N,-,-1,-1
MUSING.txt,245077,246587,1510,10,N,N,-,-1,-1
MUSING.txt,245129,246921,1792,10,N,N,-,-1,-1
MUSING.txt,245230,246940,1710,10,N,N,-,-1,-1
MUSING.txt,245268,247363,2095,10,N,N,-,-1,-1
MUSING.txt,245437,247523,2086,10,N,N,-,-1,-1
MUSING.txt,245525,247855,2330,10,Y,N,-,-1,-1
MUSING.txt,245655,248200,2545,10,Y,N,-,-1,-1
MUSING.txt,245920,248262,2342,10,Y,N,-,-1,-1
MUSING.txt,246070,248611,2541,10,Y,N,-,-1,-1
MUSING.txt,246469,248639,2170,10,Y,N,-,-1,-1
MUSING.txt,246588,248977,2389,10,Y,N,-,-1,-1
MUSING.txt,246924,249147,2223,10,Y,N,-,-1,-1
MUSING.txt,246941,249564,2623,10,Y,N,-,-1,-1
MUSING.txt,247365,249575,2210,10,N,N,-,-1,-1
MUSING.txt,247524,249940,2416,10,N,N,-,-1,-1
MUSING.txt,247856,250260,2404,10,N,N,-,-1,-1
MUSING.txt,248201,250656,2455,10,N,N,-,-1,-1
MUSING.txt,248265,251109,2844,10,N,N,-,-1,-1
MUSING.txt,248613,251283,2670,10,N,N,-,-1,-1
MUSING.txt,248640,251671,3031,10,N,N,-,-1,-1
MUSING.txt,248978,252286,3308,10,N,N,-,-1,-1
MUSING.txt,249150,252390,3240,10,N,N,-,-1,-1
MUSING.txt,249565,252797,3232,10,N,N,-,-1,-1
MUSING.txt,249577,252915,3338,10,N,N,-,-1,-1
MUSING.txt,249941,253080,3139,10,N,N,-,-1,-1
MUSING.txt,250262,253282,3020,10,N,N,-,-1,-1
MUSING.txt,250657,253494,2837,10,N,N,-,-1,-1
MUSING.txt,251110,253745,2635,10,N,N,-,-1,-1
MUSING.txt,251286,254078,2792,10,N,N,-,-1,-1
MUSING.txt,251672,254315,2643,10,N,N,-,-1,-1
MUSING.txt,252287,254476,2189,10,N,N,-,-1,-1
MUSING.txt,252395,254553,2158,10,N,N,-,-1,-1
MUSING.txt,252798,255368,2570,10,N,N,-,-1,-1
MUSING.txt,252916,255649,2733,10,N,N,-,-1,-1
MUSING.txt,253081,255758,2677,10,N,N,-,-1,-1
MUSING.txt,253283,256209,2926,10,N,N,-,-1,-1
MUSING.txt,253495,256251,2756,10,N,N,-,-1,-1
MUSING.txt,253750,256545,2795,10,N,N,-,-1,-1
MUSING.txt,254079,256766,2687,10,N,N,-,-1,-1
MUSING.txt,254316,256980,2664,10,N,N,-,-1,-1
MUSING.txt,254477,257434,2957,10,N,N,-,-1,-1
MUSING.txt,254554,257600,3046,10,N,N,-,-1,-1
MUSING.txt,255369,257967,2598,10,N,N,-,-1,-1
MUSING.txt,255650,258199,2549,10,N,N,-,-1,-1
MUSING.txt,255759,258833,3074,10,N,N,-,-1,-1
MUSING.txt,256210,259012,2802,10,N,N,-,-1,-1
MUSING.txt,256252,259723,3471,10,N,N,-,-1,-1
MUSING.txt,256546,259929,3383,10,N,N,-,-1,-1
MUSING.txt,256767,260161,3394,10,N,N,-,-1,-1
MUSING.txt,256981,260658,3677,10,N,N,-,-1,-1
MUSING.txt,257435,260936,3501,10,N,N,-,-1,-1
MUSING.txt,257601,261025,3424,10,N,N,-,-1,-1
MUSING.txt,257968,261435,3467,10,N,N,-,-1,-1
MUSING.txt,258200,261647,3447,10,N,N,-,-1,-1
MUSING.txt,258834,262080,3246,10,N,N,-,-1,-1
MUSING.txt,259013,262395,3382,10,N,N,-,-1,-1
MUSING.txt,259726,262997,3271,10,N,N,-,-1,-1
MUSING.txt,259932,264423,4491,10,N,N,-,-1,-1
MUSING.txt,260163,264680,4517,10,N,N,-,-1,-1
MUSING.txt,260660,264798,4138,10,N,N,-,-1,-1
MUSING.txt,260938,265273,4335,10,N,N,-,-1,-1
MUSING.txt,261026,265390,4364,10,N,N,-,-1,-1
MUSING.txt,261436,265518,4082,10,N,N,-,-1,-1
MUSING.txt,261650,265616,3966,10,N,N,-,-1,-1
MUSING.txt,262081,265923,3842,10,N,N,-,-1,-1
MUSING.txt,262396,266006,3610,10,N,N,-,-1,-1
MUSING.txt,262998,266070,3072,10,N,N,-,-1,-1
MUSING.txt,264424,266321,1897,10,N,N,-,-1,-1
MUSING.txt,264681,266433,1752,10,N,N,-,-1,-1
MUSING.txt,264801,266655,1854,10,N,N,-,-1,-1
MUSING.txt,265274,266722,1448,10,N,N,-,-1,-1
MUSING.txt,265392,266891,1499,10,N,N,-,-1,-1
MUSING.txt,265519,267109,1590,10,N,N,-,-1,-1
MUSING.txt,265617,267166,1549,10,N,N,-,-1,-1
MUSING.txt,265924,267210,1286,10,N,N,-,-1,-1
MUSING.txt,266007,267379,1372,10,N,N,-,-1,-1
MUSING.txt,266071,267403,1332,10,N,N,-,-1,-1
MUSING.txt,266322,267498,1176,10,N,N,-,-1,-1
MUSING.txt,266434,267733,1299,10,N,N,-,-1,-1
MUSING.txt,266657,267923,1266,10,N,N,-,-1,-1
MUSING.txt,266723,268347,1624,10,N,N,-,-1,-1
MUSING.txt,266892,268619,1727,10,N,N,-,-1,-1
MUSING.txt,267110,268801,1691,10,N,N,-,-1,-1
MUSING.txt,267167,268887,1720,10,N,N,-,-1,-1
MUSING.txt,267211,268899,1688,10,N,N,-,-1,-1
MUSING.txt,267380,268912,1532,10,N,N,-,-1,-1
MUSING.txt,267405,268963,1558,10,N,N,-,-1,-1
MUSING.txt,267500,269021,1521,10,N,N,-,-1,-1
MUSING.txt,267735,269144,1409,10,N,N,-,-1,-1
MUSING.txt,267926,269266,1340,10,N,N,-,-1,-1
MUSING.txt,268348,269334,986,10,N,N,-,-1,-1
MUSING.txt,268620,269465,845,10,N,N,-,-1,-1
MUSING.txt,268802,269478,676,10,N,N,-,-1,-1
MUSING.txt,268888,269499,611,10,N,N,-,-1,-1
MUSING.txt,268901,269550,649,10,N,N,-,-1,-1
MUSING.txt,268913,269674,761,10,N,N,-,-1,-1
MUSING.txt,268964,269803,839,10,N,N,-,-1,-1
MUSING.txt,269024,269815,791,10,N,N,-,-1,-1
MUSING.txt,269145,269871,726,10,N,N,-,-1,-1
MUSING.txt,269267,269986,719,10,N,N,-,-1,-1
MUSING.txt,269335,270070,735,10,N,N,-,-1,-1
MUSING.txt,269466,270126,660,10,N,N,-,-1,-1
MUSING.txt,269481,270238,757,10,N,N,-,-1,-1
MUSING.txt,269500,270333,833,10,N,N,-,-1,-1
MUSING.txt,269551,270349,798,10,N,N,-,-1,-1
MUSING.txt,269675,270404,729,10,N,N,-,-1,-1
MUSING.txt,269804,270500,696,10,N,N,-,-1,-1
MUSING.txt,269816,270531,715,10,N,N,-,-1,-1
MUSING.txt,269874,270549,675,10,N,N,-,-1,-1
MUSING.txt,269987,270754,767,10,N,N,-,-1,-1
MUSING.txt,270071,270923,852,10,N,N,-,-1,-1
MUSING.txt,270127,271008,881,10,N,N,-,-1,-1
MUSING.txt,270240,271212,972,10,N,N,-,-1,-1
MUSING.txt,270336,271449,1113,10,Y,N,-,-1,-1
MUSING.txt,270350,271530,1180,10,Y,N,-,-1,-1
MUSING.txt,270405,271743,1338,10,Y,N,-,-1,-1
MUSING.txt,270501,271998,1497,10,Y,N,-,-1,-1
MUSING.txt,270534,272064,1530,10,Y,N,-,-1,-1
MUSING.txt,270554,272333,1779,10,Y,N,-,-1,-1
MUSING.txt,270755,272626,1871,10,Y,N,-,-1,-1
MUSING.txt,270925,272792,1867,10,Y,N,-,-1,-1
MUSING.txt,271009,273123,2114,10,Y,N,-,-1,-1
MUSING.txt,271213,273199,1986,10,N,N,-,-1,-1
MUSING.txt,271452,273371,1919,10,N,N,-,-1,-1
MUSING.txt,271531,273656,2125,10,N,N,-,-1,-1
MUSING.txt,271744,274058,2314,10,N,N,-,-1,-1
MUSING.txt,271999,274077,2078,10,N,N,-,-1,-1
MUSING.txt,272065,274531,2466,10,N,N,-,-1,-1
MUSING.txt,272334,274778,2444,10,N,N,-,-1,-1
MUSING.txt,272629,274988,2359,10,N,N,-,-1,-1
MUSING.txt,272793,275274,2481,10,N,N,-,-1,-1
MUSING.txt,273124,275781,2657,10,N,N,-,-1,-1
MUSING.txt,273201,276050,2849,10,Y,N,-,-1,-1
MUSING.txt,273372,276157,2785,10,Y,N,-,-1,-1
MUSING.txt,273658,276255,2597,10,Y,N,-,-1,-1
MUSING.txt,274059,276537,2478,10,Y,N,-,-1,-1
MUSING.txt,274078,276609,2531,10,Y,N,-,-1,-1
MUSING.txt,274534,276727,2193,10,N,N,-,-1,-1
MUSING.txt,274779,276771,1992,10,N,N,-,-1,-1
MUSING.txt,274990,276887,1897,10,N,N,-,-1,-1
MUSING.txt,275275,276969,1694,10,N,N,-,-1,-1
MUSING.txt,275783,277206,1423,10,N,N,-,-1,-1
MUSING.txt,276053,277452,1399,10,N,N,-,-1,-1
MUSING.txt,276158,277564,1406,10,N,N,-,-1,-1
MUSING.txt,276258,277684,1426,10,N,N,-,-1,-1
MUSING.txt,276538,277914,1376,10,N,N,-,-1,-1
MUSING.txt,276611,278001,1390,10,N,N,-,-1,-1
MUSING.txt,276728,278276,1548,10,N,N,-,-1,-1
MUSING.txt,276772,278868,2096,10,Y,N,-,-1,-1
MUSING.txt,276888,279070,2182,10,Y,N,-,-1,-1
MUSING.txt,276971,279136,2165,10,Y,N,-,-1,-1
MUSING.txt,277208,279347,2139,10,Y,N,-,-1,-1
MUSING.txt,277453,279403,1950,10,Y,N,-,-1,-1
MUSING.txt,277567,279446,1879,10,Y,N,-,-1,-1
MUSING.txt,277687,279593,1906,10,Y,N,-,-1,-1
MUSING.txt,277915,279789,1874,10,Y,N,-,-1,-1
MUSING.txt,278002,279841,1839,10,Y,N,-,-1,-1
MUSING.txt,278277,279953,1676,10,Y,N,-,-1,-1
MUSING.txt,278871,280200,1329,10,N,N,-,-1,-1
MUSING.txt,279071,280232,1161,10,N,N,-,-1,-1
MUSING.txt,279137,280308,1171,10,N,N,-,-1,-1
MUSING.txt,279348,280420,1072,10,N,N,-,-1,-1
MUSING.txt,279406,280452,1046,10,N,N,-,-1,-1
MUSING.txt,279448,280626,1178,10,N,N,-,-1,-1
MUSING.txt,279594,280850,1256,10,N,N,-,-1,-1
MUSING.txt,279792,280978,1186,10,N,N,-,-1,-1
MUSING.txt,279842,281173,1331,10,N,N,-,-1,-1
MUSING.txt,279954,281337,1383,10,N,N,-,-1,-1
MUSING.txt,280201,281587,1386,10,N,N,-,-1,-1
MUSING.txt,280233,281753,1520,10,N,N,-,-1,-1
MUSING.txt,280309,281983,1674,10,Y,N,-,-1,-1
MUSING.txt,280422,282291,1869,10,N,N,-,-1,-1
MUSING.txt,280453,282383,1930,10,N,N,-,-1,-1
MUSING.txt,280627,282753,2126,10,Y,N,-,-1,-1
MUSING.txt,280853,283044,2191,10,Y,N,-,-1,-1
MUSING.txt,280979,283295,2316,10,Y,N,-,-1,-1
MUSING.txt,281176,283438,2262,10,Y,N,-,-1,-1
MUSING.txt,281342,283576,2234,10,N,N,-,-1,-1
MUSING.txt,281588,283993,2405,10,Y,N,-,-1,-1
MUSING.txt,281754,284152,2398,10,N,N,-,-1,-1
MUSING.txt,281984,284423,2439,10,Y,N,-,-1,-1
MUSING.txt,282294,284570,2276,10,Y,N,-,-1,-1
MUSING.txt,282384,284738,2354,10,Y,N,-,-1,-1
MUSING.txt,282754,285191,2437,10,Y,N,-,-1,-1
MUSING.txt,283047,285299,2252,10,Y,N,-,-1,-1
MUSING.txt,283298,285420,2122,10,Y,N,-,-1,-1
MUSING.txt,283439,285520,2081,10,Y,N,-,-1,-1
MUSING.txt,283577,285985,2408,10,Y,N,-,-1,-1
MUSING.txt,283996,286618,2622,10,Y,N,-,-1,-1
MUSING.txt,284153,286871,2718,10,Y,N,-,-1,-1
MUSING.txt,284426,287130,2704,10,N,N,-,-1,-1
MUSING.txt,284573,287468,2895,10,N,N,-,-1,-1
MUSING.txt,284739,287973,3234,10,N,N,-,-1,-1
MUSING.txt,285194,288107,2913,10,N,N,-,-1,-1
MUSING.txt,285300,288141,2841,10,N,N,-,-1,-1
MUSING.txt,285421,288388,2967,10,N,N,-,-1,-1
MUSING.txt,285521,288659,3138,10,N,N,-,-1,-1
MUSING.txt,285986,288902,2916,10,N,N,-,-1,-1
MUSING.txt,286621,289049,2428,10,N,N,-,-1,-1
MUSING.txt,286872,289306,2434,10,N,N,-,-1,-1
MUSING.txt,287133,289509,2376,10,Y,N,-,-1,-1
MUSING.txt,287469,289723,2254,10,N,N,-,-1,-1
MUSING.txt,287974,290131,2157,10,N,N,-,-1,-1
MUSING.txt,288110,290741,2631,10,N,N,-,-1,-1
MUSING.txt,288142,290766,2624,10,N,N,-,-1,-1
MUSING.txt,288389,290995,2606,10,N,N,-,-1,-1
MUSING.txt,288660,291168,2508,10,N,N,-,-1,-1
MUSING.txt,288903,291209,2306,10,N,N,-,-1,-1
MUSING.txt,289051,291308,2257,10,N,N,-,-1,-1
MUSING.txt,289307,291450,2143,10,N,N,-,-1,-1
MUSING.txt,289510,291625,2115,10,N,N,-,-1,-1
MUSING.txt,289724,291705,1981,10,N,N,-,-1,-1
MUSING.txt,290132,291762,1630,10,N,N,-,-1,-1
MUSING.txt,290742,291799,1057,10,N,N,-,-1,-1
MUSING.txt,290767,291831,1064,10,N,N,-,-1,-1
MUSING.txt,290998,291991,993,10,N,N,-,-1,-1
MUSING.txt,291169,292168,999,10,N,N,-,-1,-1
MUSING.txt,291211,292263,1052,10,N,N,-,-1,-1
MUSING.txt,291311,292324,1013,10,N,N,-,-1,-1
MUSING.txt,291455,292388,933,10,N,N,-,-1,-1
MUSING.txt,291628,292426,798,10,N,N,-,-1,-1
MUSING.txt,291708,292772,1064,10,N,N,-,-1,-1
MUSING.txt,291763,293076,1313,10,N,N,-,-1,-1
MUSING.txt,291801,293115,1314,10,N,N,-,-1,-1
MUSING.txt,291832,293237,1405,10,N,N,-,-1,-1
MUSING.txt,291992,293368,1376,10,N,N,-,-1,-1
MUSING.txt,292169,293435,1266,10,N,N,-,-1,-1
MUSING.txt,292264,293496,1232,10,N,N,-,-1,-1
MUSING.txt,292325,293580,1255,10,N,N,-,-1,-1
MUSING.txt,292389,294254,1865,10,N,N,-,-1,-1
MUSING.txt,292429,294317,1888,10,N,N,-,-1,-1
MUSING.txt,292777,294357,1580,10,N,N,-,-1,-1
MUSING.txt,293077,294466,1389,10,N,N,-,-1,-1
MUSING.txt,293117,294553,1436,10,N,N,-,-1,-1
MUSING.txt,293238,294585,1347,10,N,N,-,-1,-1
MUSING.txt,293369,294787,1418,10,N,N,-,-1,-1
MUSING.txt,293436,295036,1600,10,N,N,-,-1,-1
MUSING.txt,293497,295505,2008,10,N,N,-,-1,-1
MUSING.txt,293581,295691,2110,10,N,N,-,-1,-1
MUSING.txt,294255,295755,1500,10,N,N,-,-1,-1
MUSING.txt,294318,296134,1816,10,N,N,-,-1,-1
MUSING.txt,294358,296346,1988,10,N,N,-,-1,-1
MUSING.txt,294468,296480,2012,10,N,N,-,-1,-1
MUSING.txt,294555,296572,2017,10,N,N,-,-1,-1
MUSING.txt,294586,296926,2340,10,N,N,-,-1,-1
MUSING.txt,294792,297078,2286,10,N,N,-,-1,-1
MUSING.txt,295038,297400,2362,10,N,N,-,-1,-1
MUSING.txt,295506,297612,2106,10,N,N,-,-1,-1
MUSING.txt,295692,297739,2047,10,N,N,-,-1,-1
MUSING.txt,295756,298315,2559,10,N,N,-,-1,-1
MUSING.txt,296135,298618,2483,10,N,N,-,-1,-1
MUSING.txt,296347,298737,2390,10,N,N,-,-1,-1
MUSING.txt,296481,298768,2287,10,N,N,-,-1,-1
MUSING.txt,296573,298880,2307,10,N,N,-,-1,-1
MUSING.txt,296929,299090,2161,10,N,N,-,-1,-1
MUSING.txt,297081,299170,2089,10,N,N,-,-1,-1
MUSING.txt,297401,299309,1908,10,N,N,-,-1,-1
MUSING.txt,297614,299336,1722,10,N,N,-,-1,-1
MUSING.txt,297740,299630,1890,10,N,N,-,-1,-1
MUSING.txt,298316,299773,1457,10,N,N,-,-1,-1
MUSING.txt,298619,300033,1414,10,N,N,-,-1,-1
MUSING.txt,298738,300317,1579,10,N,N,-,-1,-1
MUSING.txt,298769,300634,1865,10,N,N,-,-1,-1
MUSING.txt,298881,301374,2493,10,N,N,-,-1,-1
MUSING.txt,299093,301572,2479,10,N,N,-,-1,-1
MUSING.txt,299173,301829,2656,10,N,N,-,-1,-1
MUSING.txt,299310,302106,2796,10,Y,N,-,-1,-1
MUSING.txt,299337,302735,3398,10,Y,N,-,-1,-1
MUSING.txt,299632,302869,3237,10,Y,N,-,-1,-1
MUSING.txt,299778,302980,3202,10,Y,N,-,-1,-1
MUSING.txt,300034,303441,3407,10,Y,N,-,-1,-1
MUSING.txt,300318,303669,3351,10,Y,N,-,-1,-1
MUSING.txt,300635,304049,3414,10,Y,N,-,-1,-1
MUSING.txt,301377,304242,2865,10,Y,N,-,-1,-1
MUSING.txt,301577,304793,3216,10,N,N,-,-1,-1
MUSING.txt,301832,304975,3143,10,N,N,-,-1,-1
MUSING.txt,302107,305130,3023,10,N,N,-,-1,-1
MUSING.txt,302736,305266,2530,10,N,N,-,-1,-1
MUSING.txt,302870,305663,2793,10,N,N,-,-1,-1
MUSING.txt,302981,305700,2719,10,N,N,-,-1,-1
MUSING.txt,303442,306158,2716,10,N,N,-,-1,-1
MUSING.txt,303672,306469,2797,10,N,N,-,-1,-1
MUSING.txt,304050,306537,2487,10,N,N,-,-1,-1
MUSING.txt,304245,306927,2682,10,N,N,-,-1,-1
MUSING.txt,304794,307202,2408,10,N,N,-,-1,-1
MUSING.txt,304976,307421,2445,10,N,N,-,-1,-1
MUSING.txt,305131,308015,2884,10,N,N,-,-1,-1
MUSING.txt,305267,308224,2957,10,N,N,-,-1,-1
MUSING.txt,305664,308341,2677,10,N,N,-,-1,-1
MUSING.txt,305701,308370,2669,10,N,N,-,-1,-1
MUSING.txt,306160,308427,2267,10,N,N,-,-1,-1
MUSING.txt,306471,308438,1967,10,N,N,-,-1,-1
MUSING.txt,306538,308591,2053,10,N,N,-,-1,-1
MUSING.txt,306928,308608,1680,10,N,N,-,-1,-1
MUSING.txt,307205,308788,1583,10,N,N,-,-1,-1
MUSING.txt,307422,308858,1436,10,N,N,-,-1,-1
MUSING.txt,308018,309541,1523,10,N,N,-,-1,-1
MUSING.txt,308225,309639,1414,10,N,N,-,-1,-1
MUSING.txt,308342,309669,1327,10,N,N,-,-1,-1
MUSING.txt,308371,309711,1340,10,N,N,-,-1,-1
MUSING.txt,308428,309797,1369,10,N,N,-,-1,-1
MUSING.txt,308441,309871,1430,10,N,N,-,-1,-1
MUSING.txt,308592,309949,1357,10,N,N,-,-1,-1
MUSING.txt,308611,309974,1363,10,N,N,-,-1,-1
MUSING.txt,308790,310052,1262,10,N,N,-,-1,-1
MUSING.txt,308859,310095,1236,10,N,N,-,-1,-1
MUSING.txt,309542,310112,570,10,N,N,-,-1,-1
MUSING.txt,309642,310139,497,10,N,N,-,-1,-1
MUSING.txt,309670,310239,569,10,N,N,-,-1,-1
MUSING.txt,309712,310307,595,10,N,N,-,-1,-1
MUSING.txt,309798,310650,852,10,N,N,-,-1,-1
MUSING.txt,309872,310713,841,10,N,N,-,-1,-1
MUSING.txt,309950,311425,1475,10,N,N,-,-1,-1
MUSING.txt,309975,311559,1584,10,N,N,-,-1,-1
MUSING.txt,310053,311906,1853,10,N,N,-,-1,-1
MUSING.txt,310096,312100,2004,10,N,N,-,-1,-1
MUSING.txt,310113,312509,2396,10,N,N,-,-1,-1
MUSING.txt,310142,312547,2405,10,N,N,-,-1,-1
MUSING.txt,310242,312849,2607,10,N,N,-,-1,-1
MUSING.txt,310308,313032,2724,10,N,N,-,-1,-1
MUSING.txt,310651,313159,2508,10,N,N,-,-1,-1
MUSING.txt,310714,313300,2586,10,N,N,-,-1,-1
MUSING.txt,311426,313686,2260,10,N,N,-,-1,-1
MUSING.txt,311560,313912,2352,10,N,N,-,-1,-1
MUSING.txt,311907,314217,2310,10,N,N,-,-1,-1
MUSING.txt,312101,314427,2326,10,N,N,-,-1,-1
MUSING.txt,312510,314634,2124,10,N,N,-,-1,-1
MUSING.txt,312548,314735,2187,10,N,N,-,-1,-1
MUSING.txt,312850,314865,2015,10,N,N,-,-1,-1
MUSING.txt,313033,315030,1997,10,N,N,-,-1,-1
MUSING.txt,313160,315221,2061,10,N,N,-,-1,-1
MUSING.txt,313301,315295,1994,10,N,N,-,-1,-1
MUSING.txt,313687,315331,1644,10,N,N,-,-1,-1
MUSING.txt,313913,315393,1480,10,N,N,-,-1,-1
MUSING.txt,314218,315425,1207,10,N,N,-,-1,-1
MUSING.txt,314429,315467,1038,10,N,N,-,-1,-1
MUSING.txt,314635,315514,879,10,N,N,-,-1,-1
MUSING.txt,314736,315568,832,10,N,N,-,-1,-1
MUSING.txt,314866,315666,800,10,N,N,-,-1,-1
MUSING.txt,315033,315696,663,10,N,N,-,-1,-1
MUSING.txt,315223,315907,684,10,N,N,-,-1,-1
MUSING.txt,315296,316163,867,10,N,N,-,-1,-1
MUSING.txt,315332,316452,1120,10,N,N,-,-1,-1
MUSING.txt,315395,316494,1099,10,N,N,-,-1,-1
MUSING.txt,315426,316532,1106,10,N,N,-,-1,-1
MUSING.txt,315468,316615,1147,10,N,N,-,-1,-1
MUSING.txt,315515,316671,1156,10,N,N,-,-1,-1
MUSING.txt,315569,316889,1320,10,N,N,-,-1,-1
MUSING.txt,315669,317281,1612,10,N,N,-,-1,-1
MUSING.txt,315697,317412,1715,10,N,N,-,-1,-1
MUSING.txt,315908,317542,1634,10,N,N,-,-1,-1
MUSING.txt,316166,318272,2106,10,N,N,-,-1,-1
MUSING.txt,316453,318500,2047,10,N,N,-,-1,-1
MUSING.txt,316496,318536,2040,10,N,N,-,-1,-1
MUSING.txt,316533,318609,2076,10,N,N,-,-1,-1
MUSING.txt,316616,318685,2069,10,N,N,-,-1,-1
MUSING.txt,316673,318709,2036,10,N,N,-,-1,-1
MUSING.txt,316891,319015,2124,10,N,N,-,-1,-1
MUSING.txt,317282,319152,1870,10,N,N,-,-1,-1
MUSING.txt,317415,319314,1899,10,N,N,-,-1,-1
MUSING.txt,317544,319415,1871,10,N,N,-,-1,-1
MUSING.txt,318273,319580,1307,10,N,N,-,-1,-1
MUSING.txt,318501,319672,1171,10,N,N,-,-1,-1
MUSING.txt,318537,320000,1463,10,N,N,-,-1,-1
MUSING.txt,318614,320189,1575,10,N,N,-,-1,-1
MUSING.txt,318686,320250,1564,10,N,N,-,-1,-1
MUSING.txt,318710,320387,1677,10,N,N,-,-1,-1
MUSING.txt,319016,320875,1859,10,N,N,-,-1,-1
MUSING.txt,319153,321050,1897,10,N,N,-,-1,-1
MUSING.txt,319315,321401,2086,10,N,N,-,-1,-1
MUSING.txt,319416,321806,2390,10,N,N,-,-1,-1
MUSING.txt,319581,322115,2534,10,Y,N,-,-1,-1
MUSING.txt,319673,322363,2690,10,Y,N,-,-1,-1
MUSING.txt,320002,322506,2504,10,Y,N,-,-1,-1
MUSING.txt,320192,322704,2512,10,Y,N,-,-1,-1
MUSING.txt,320255,323050,2795,10,Y,N,-,-1,-1
MUSING.txt,320388,323580,3192,10,Y,N,-,-1,-1
MUSING.txt,320880,323973,3093,10,Y,N,-,-1,-1
MUSING.txt,321051,324141,3090,10,Y,N,-,-1,-1
MUSING.txt,321402,324463,3061,10,Y,N,-,-1,-1
MUSING.txt,321808,324923,3115,10,Y,N,-,-1,-1
MUSING.txt,322116,325253,3137,10,Y,N,-,-1,-1
MUSING.txt,322364,325442,3078,10,Y,N,-,-1,-1
MUSING.txt,322507,325660,3153,10,Y,N,-,-1,-1
MUSING.txt,322706,325735,3029,10,N,N,-,-1,-1
MUSING.txt,323053,326059,3006,10,N,N,-,-1,-1
MUSING.txt,323581,326167,2586,10,N,N,-,-1,-1
MUSING.txt,323974,326353,2379,10,N,N,-,-1,-1
MUSING.txt,324143,326935,2792,10,N,N,-,-1,-1
MUSING.txt,324465,326970,2505,10,N,N,-,-1,-1
MUSING.txt,324924,327369,2445,10,N,N,-,-1,-1
MUSING.txt,325256,327734,2478,10,N,N,-,-1,-1
MUSING.txt,325445,327872,2427,10,Y,N,-,-1,-1
MUSING.txt,325661,328091,2430,10,Y,N,-,-1,-1
MUSING.txt,325736,328157,2421,10,Y,N,-,-1,-1
MUSING.txt,326061,328225,2164,10,Y,N,-,-1,-1
MUSING.txt,326168,328408,2240,10,Y,N,-,-1,-1
MUSING.txt,326354,328542,2188,10,Y,N,-,-1,-1
MUSING.txt,326936,328568,1632,10,N,N,-,-1,-1
MUSING.txt,326972,329084,2112,10,N,N,-,-1,-1
MUSING.txt,327370,329119,1749,10,N,N,-,-1,-1
MUSING.txt,327735,329530,1795,10,N,N,-,-1,-1
MUSING.txt,327873,329560,1687,10,N,N,-,-1,-1
MUSING.txt,328092,329678,1586,10,N,N,-,-1,-1
MUSING.txt,328159,329891,1732,10,N,N,-,-1,-1
MUSING.txt,328226,330248,2022,10,N,N,-,-1,-1
MUSING.txt,328409,330455,2046,10,N,N,-,-1,-1
MUSING.txt,328543,330717,2174,10,N,N,-,-1,-1
MUSING.txt,328571,330775,2204,10,N,N,-,-1,-1
MUSING.txt,329087,331011,1924,10,N,N,-,-1,-1
MUSING.txt,329120,331208,2088,10,N,N,-,-1,-1
MUSING.txt,329531,331508,1977,10,N,N,-,-1,-1
MUSING.txt,329561,331604,2043,10,N,N,-,-1,-1
MUSING.txt,329679,331774,2095,10,N,N,-,-1,-1
MUSING.txt,329894,331996,2102,10,N,N,-,-1,-1
MUSING.txt,330251,332165,1914,10,N,N,-,-1,-1
MUSING.txt,330456,332234,1778,10,N,N,-,-1,-1
MUSING.txt,330718,332369,1651,10,Y,N,-,-1,-1
MUSING.txt,330776,332655,1879,10,Y,N,-,-1,-1
MUSING.txt,331014,332703,1689,10,N,N,-,-1,-1
MUSING.txt,331209,333155,1946,10,N,N,-,-1,-1
MUSING.txt,331513,333367,1854,10,N,N,-,-1,-1
MUSING.txt,331605,333412,1807,10,N,N,-,-1,-1
MUSING.txt,331775,333613,1838,10,N,N,-,-1,-1
MUSING.txt,331997,333776,1779,10,N,N,-,-1,-1
MUSING.txt,332167,334237,2070,10,N,N,-,-1,-1
MUSING.txt,332235,334498,2263,10,N,N,-,-1,-1
MUSING.txt,332370,334869,2499,10,N,N,-,-1,-1
MUSING.txt,332656,335096,2440,10,N,N,-,-1,-1
MUSING.txt,332706,335197,2491,10,N,N,-,-1,-1
MUSING.txt,333158,335432,2274,10,N,N,-,-1,-1
MUSING.txt,333368,336154,2786,10,N,N,-,-1,-1
MUSING.txt,333413,336286,2873,10,N,N,-,-1,-1
MUSING.txt,333614,336574,2960,10,N,N,-,-1,-1
MUSING.txt,333777,336970,3193,10,N,N,-,-1,-1
MUSING.txt,334240,336994,2754,10,N,N,-,-1,-1
MUSING.txt,334499,337028,2529,10,N,N,-,-1,-1
MUSING.txt,334871,337051,2180,10,N,N,-,-1,-1
MUSING.txt,335097,337193,2096,10,N,N,-,-1,-1
MUSING.txt,335200,337275,2075,10,N,N,-,-1,-1
MUSING.txt,335433,337490,2057,10,N,N,-,-1,-1
MUSING.txt,336155,337521,1366,10,N,N,-,-1,-1
MUSING.txt,336287,337607,1320,10,N,N,-,-1,-1
MUSING.txt,336575,337728,1153,10,N,N,-,-1,-1
MUSING.txt,336971,337770,799,10,N,N,-,-1,-1
MUSING.txt,336995,337932,937,10,N,N,-,-1,-1
MUSING.txt,337029,338416,1387,10,N,N,-,-1,-1
MUSING.txt,337052,338564,1512,10,N,N,-,-1,-1
MUSING.txt,337194,339043,1849,10,N,N,-,-1,-1
MUSING.txt,337276,339071,1795,10,N,N,-,-1,-1
MUSING.txt,337491,339419,1928,10,N,N,-,-1,-1
MUSING.txt,337523,339680,2157,10,N,N,-,-1,-1
MUSING.txt,337608,340220,2612,10,N,N,-,-1,-1
MUSING.txt,337731,340277,2546,10,N,N,-,-1,-1
MUSING.txt,337771,340429,2658,10,N,N,-,-1,-1
MUSING.txt,337937,340692,2755,10,N,N,-,-1,-1
MUSING.txt,338417,340774,2357,10,N,N,-,-1,-1
MUSING.txt,338565,340803,2238,10,N,N,-,-1,-1
MUSING.txt,339046,341083,2037,10,N,N,-,-1,-1
MUSING.txt,339072,341519,2447,10,N,N,-,-1,-1
MUSING.txt,339420,341795,2375,10,N,N,-,-1,-1
MUSING.txt,339681,341981,2300,10,N,N,-,-1,-1
MUSING.txt,340220,342629,2409,10,N,N,-,-1,-1
MUSING.txt,340278,342760,2482,10,N,N,-,-1,-1
MUSING.txt,340430,343018,2588,10,N,N,-,-1,-1
MUSING.txt,340697,343136,2439,10,N,N,-,-1,-1
MUSING.txt,340779,343465,2686,10,N,N,-,-1,-1
MUSING.txt,340804,343549,2745,10,N,N,-,-1,-1
MUSING.txt,341084,344192,3108,10,Y,N,-,-1,-1
MUSING.txt,341521,344243,2722,10,N,N,-,-1,-1
MUSING.txt,341797,344512,2715,10,N,N,-,-1,-1
MUSING.txt,341986,344619,2633,10,Y,N,-,-1,-1
MUSING.txt,342630,344890,2260,10,N,N,-,-1,-1
MUSING.txt,342761,345109,2348,10,N,N,-,-1,-1
MUSING.txt,343020,345225,2205,10,Y,N,-,-1,-1
MUSING.txt,343137,345365,2228,10,Y,N,-,-1,-1
MUSING.txt,343466,345390,1924,10,Y,N,-,-1,-1
MUSING.txt,343554,345802,2248,10,Y,N,-,-1,-1
MUSING.txt,344194,346032,1838,10,Y,N,-,-1,-1
MUSING.txt,344244,346209,1965,10,Y,N,-,-1,-1
MUSING.txt,344515,346509,1994,10,N,N,-,-1,-1
MUSING.txt,344622,346572,1950,10,N,N,-,-1,-1
MUSING.txt,344891,346647,1756,10,N,N,-,-1,-1
MUSING.txt,345110,346836,1726,10,N,N,-,-1,-1
MUSING.txt,345227,346920,1693,10,N,N,-,-1,-1
MUSING.txt,345366,347041,1675,10,N,N,-,-1,-1
MUSING.txt,345391,347150,1759,10,N,N,-,-1,-1
MUSING.txt,345803,347581,1778,10,N,N,-,-1,-1
MUSING.txt,346035,347750,1715,10,N,N,-,-1,-1
MUSING.txt,346210,347920,1710,10,N,N,-,-1,-1
MUSING.txt,346510,348013,1503,10,N,N,-,-1,-1
MUSING.txt,346575,348328,1753,10,N,N,-,-1,-1
MUSING.txt,346650,348435,1785,10,N,N,-,-1,-1
MUSING.txt,346839,348559,1720,10,N,N,-,-1,-1
MUSING.txt,346923,348799,1876,10,N,N,-,-1,-1
MUSING.txt,347044,348985,1941,10,N,N,-,-1,-1
MUSING.txt,347151,349126,1975,10,N,N,-,-1,-1
MUSING.txt,347582,349248,1666,10,N,N,-,-1,-1
MUSING.txt,347751,349315,1564,10,N,N,-,-1,-1
MUSING.txt,347921,349694,1773,10,N,N,-,-1,-1
MUSING.txt,348015,349904,1889,10,N,N,-,-1,-1
MUSING.txt,348330,350211,1881,10,N,N,-,-1,-1
MUSING.txt,348436,350404,1968,10,N,N,-,-1,-1
MUSING.txt,348561,350623,2062,10,N,N,-,-1,-1
MUSING.txt,348802,350829,2027,10,N,N,-,-1,-1
MUSING.txt,348986,350907,1921,10,N,N,-,-1,-1
MUSING.txt,349127,350925,1798,10,N,N,-,-1,-1
MUSING.txt,349249,351052,1803,10,N,N,-,-1,-1
MUSING.txt,349316,351071,1755,10,N,N,-,-1,-1
MUSING.txt,349695,351344,1649,10,N,N,-,-1,-1
MUSING.txt,349905,351464,1559,10,N,N,-,-1,-1
MUSING.txt,350212,351570,1358,10,N,N,-,-1,-1
MUSING.txt,350405,351709,1304,10,N,N,-,-1,-1
MUSING.txt,350624,352172,1548,10,N,N,-,-1,-1
MUSING.txt,350830,352319,1489,10,N,N,-,-1,-1
MUSING.txt,350908,352359,1451,10,N,N,-,-1,-1
MUSING.txt,350927,352461,1534,10,N,N,-,-1,-1
MUSING.txt,351053,352555,1502,10,N,N,-,-1,-1
MUSING.txt,351072,352668,1596,10,N,N,-,-1,-1
MUSING.txt,351346,352959,1613,10,Y,N,-,-1,-1
MUSING.txt,351465,353022,1557,10,Y,N,-,-1,-1
MUSING.txt,351571,353222,1651,10,Y,N,-,-1,-1
MUSING.txt,351710,353620,1910,10,Y,N,-,-1,-1
MUSING.txt,352173,353770,1597,10,N,N,-,-1,-1
MUSING.txt,352320,353849,1529,10,N,N,-,-1,-1
MUSING.txt,352360,353963,1603,10,N,N,-,-1,-1
MUSING.txt,352463,354396,1933,10,N,N,-,-1,-1
MUSING.txt,352558,354626,2068,10,Y,N,-,-1,-1
MUSING.txt,352669,354725,2056,10,Y,N,-,-1,-1
MUSING.txt,352960,355084,2124,10,N,N,-,-1,-1
MUSING.txt,353023,355735,2712,10,N,N,-,-1,-1
MUSING.txt,353224,355884,2660,10,N,N,-,-1,-1
MUSING.txt,353622,355988,2366,10,N,N,-,-1,-1
MUSING.txt,353771,356112,2341,10,N,N,-,-1,-1
MUSING.txt,353850,356344,2494,10,N,N,-,-1,-1
MUSING.txt,353964,356409,2445,10,N,N,-,-1,-1
MUSING.txt,354397,356498,2101,10,Y,N,-,-1,-1
MUSING.txt,354629,356632,2003,10,Y,N,-,-1,-1
MUSING.txt,354727,356714,1987,10,Y,N,-,-1,-1
MUSING.txt,355087,356769,1682,10,Y,N,-,-1,-1
MUSING.txt,355738,357006,1268,10,Y,N,-,-1,-1
MUSING.txt,355885,357216,1331,10,Y,N,-,-1,-1
MUSING.txt,355989,357638,1649,10,N,N,-,-1,-1
MUSING.txt,356115,358001,1886,10,N,N,-,-1,-1
MUSING.txt,356347,358107,1760,10,N,N,-,-1,-1
MUSING.txt,356410,358775,2365,10,N,N,-,-1,-1
MUSING.txt,356499,358883,2384,10,N,N,-,-1,-1
MUSING.txt,356633,359054,2421,10,N,N,-,-1,-1
MUSING.txt,356716,359137,2421,10,N,N,-,-1,-1
MUSING.txt,356770,359160,2390,10,N,N,-,-1,-1
MUSING.txt,357007,359443,2436,10,N,N,-,-1,-1
MUSING.txt,357217,359585,2368,10,N,N,-,-1,-1
MUSING.txt,357639,359717,2078,10,N,N,-,-1,-1
MUSING.txt,358004,359797,1793,10,N,N,-,-1,-1
MUSING.txt,358108,359967,1859,10,N,N,-,-1,-1
MUSING.txt,358776,360193,1417,10,N,N,-,-1,-1
MUSING.txt,358884,360423,1539,10,N,N,-,-1,-1
MUSING.txt,359055,360577,1522,10,N,N,-,-1,-1
MUSING.txt,359140,360727,1587,10,N,N,-,-1,-1
MUSING.txt,359163,360852,1689,10,N,N,-,-1,-1
MUSING.txt,359444,360946,1502,10,N,N,-,-1,-1
MUSING.txt,359586,361093,1507,10,N,N,-,-1,-1
MUSING.txt,359719,361215,1496,10,N,N,-,-1,-1
MUSING.txt,359798,361341,1543,10,N,N,-,-1,-1
MUSING.txt,359968,361390,1422,10,N,N,-,-1,-1
MUSING.txt,360194,361530,1336,10,N,N,-,-1,-1
MUSING.txt,360424,361589,1165,10,N,N,-,-1,-1
MUSING.txt,360578,361893,1315,10,N,N,-,-1,-1
MUSING.txt,360728,361986,1258,10,N,N,-,-1,-1
MUSING.txt,360854,362100,1246,10,N,N,-,-1,-1
MUSING.txt,360949,362227,1278,10,N,N,-,-1,-1
MUSING.txt,361094,362412,1318,10,N,N,-,-1,-1
MUSING.txt,361216,362428,1212,10,N,N,-,-1,-1
MUSING.txt,361342,362617,1275,10,N,N,-,-1,-1
MUSING.txt,361391,363113,1722,10,N,N,-,-1,-1
MUSING.txt,361531,363329,1798,10,N,N,-,-1,-1
MUSING.txt,361590,363561,1971,10,Y,N,-,-1,-1
MUSING.txt,361895,363828,1933,10,Y,N,-,-1,-1
MUSING.txt,361987,364074,2087,10,Y,N,-,-1,-1
MUSING.txt,362103,364141,2038,10,Y,N,-,-1,-1
MUSING.txt,362228,364291,2063,10,Y,N,-,-1,-1
MUSING.txt,362413,364336,1923,10,Y,N,-,-1,-1
MUSING.txt,362430,364451,2021,10,Y,N,-,-1,-1
MUSING.txt,362619,364466,1847,10,Y,N,-,-1,-1
MUSING.txt,363114,364630,1516,10,Y,N,-,-1,-1
MUSING.txt,363330,364924,1594,10,Y,N,-,-1,-1
MUSING.txt,363564,365017,1453,10,N,N,-,-1,-1
MUSING.txt,363831,365106,1275,10,N,N,-,-1,-1
MUSING.txt,364075,365384,1309,10,N,N,-,-1,-1
MUSING.txt,364142,365554,1412,10,N,N,-,-1,-1
MUSING.txt,364292,365799,1507,10,N,N,-,-1,-1
MUSING.txt,364337,366013,1676,10,N,N,-,-1,-1
MUSING.txt,364454,366050,1596,10,N,N,-,-1,-1
MUSING.txt,364471,366229,1758,10,N,N,-,-1,-1
MUSING.txt,364631,366311,1680,10,N,N,-,-1,-1
MUSING.txt,364927,366458,1531,10,N,N,-,-1,-1
MUSING.txt,365020,366503,1483,10,N,N,-,-1,-1
MUSING.txt,365109,366534,1425,10,N,N,-,-1,-1
MUSING.txt,365386,366680,1294,10,N,N,-,-1,-1
MUSING.txt,365555,366887,1332,10,N,N,-,-1,-1
MUSING.txt,365800,366962,1162,10,N,N,-,-1,-1
MUSING.txt,366014,367107,1093,10,N,N,-,-1,-1
MUSING.txt,366051,367137,1086,10,N,N,-,-1,-1
MUSING.txt,366230,367547,1317,10,N,N,-,-1,-1
MUSING.txt,366312,367635,1323,10,N,N,-,-1,-1
MUSING.txt,366459,367904,1445,10,N,N,-,-1,-1
MUSING.txt,366504,368044,1540,10,N,N,-,-1,-1
MUSING.txt,366535,368193,1658,10,N,N,-,-1,-1
MUSING.txt,366685,368285,1600,10,N,N,-,-1,-1
MUSING.txt,366888,368361,1473,10,N,N,-,-1,-1
MUSING.txt,366963,368421,1458,10,N,N,-,-1,-1
MUSING.txt,367108,368547,1439,10,N,N,-,-1,-1
MUSING.txt,367138,368593,1455,10,N,N,-,-1,-1
MUSING.txt,367550,368701,1151,10,N,N,-,-1,-1
MUSING.txt,367636,368739,1103,10,N,N,-,-1,-1
MUSING.txt,367907,368834,927,10,N,N,-,-1,-1
MUSING.txt,368047,368912,865,10,N,N,-,-1,-1
MUSING.txt,368196,369073,877,10,N,N,-,-1,-1
MUSING.txt,368286,369234,948,10,N,N,-,-1,-1
MUSING.txt,368362,369396,1034,10,N,N,-,-1,-1
MUSING.txt,368422,369525,1103,10,N,N,-,-1,-1
MUSING.txt,368548,369627,1079,10,N,N,-,-1,-1
MUSING.txt,368594,369675,1081,10,N,N,-,-1,-1
MUSING.txt,368702,369711,1009,10,N,N,-,-1,-1
MUSING.txt,368740,370141,1401,10,Y,N,-,-1,-1
MUSING.txt,368835,370564,1729,10,Y,N,-,-1,-1
MUSING.txt,368913,370698,1785,10,Y,N,-,-1,-1
MUSING.txt,369076,370922,1846,10,Y,N,-,-1,-1
MUSING.txt,369237,371582,2345,10,Y,N,-,-1,-1
MUSING.txt,369399,371653,2254,10,N,N,-,-1,-1
MUSING.txt,369528,371869,2341,10,N,N,-,-1,-1
MUSING.txt,369628,371880,2252,10,N,N,-,-1,-1
MUSING.txt,369678,371941,2263,10,N,N,-,-1,-1
MUSING.txt,369712,371954,2242,10,N,N,-,-1,-1
MUSING.txt,370142,371965,1823,10,N,N,-,-1,-1
MUSING.txt,370567,372031,1464,10,N,N,-,-1,-1
MUSING.txt,370699,372077,1378,10,N,N,-,-1,-1
MUSING.txt,370923,372088,1165,10,N,N,-,-1,-1
MUSING.txt,371584,372143,559,10,N,N,-,-1,-1
MUSING.txt,371654,372156,502,10,N,N,-,-1,-1
MUSING.txt,371870,372167,297,10,N,N,-,-1,-1
MUSING.txt,371883,372237,354,10,N,N,-,-1,-1
MUSING.txt,371944,372394,450,10,N,N,-,-1,-1
MUSING.txt,371955,372484,529,10,N,N,-,-1,-1
MUSING.txt,371968,372765,797,10,N,N,-,-1,-1
MUSING.txt,372036,372947,911,10,N,N,-,-1,-1
MUSING.txt,372078,373481,1403,10,N,N,-,-1,-1
MUSING.txt,372091,373635,1544,10,N,N,-,-1,-1
MUSING.txt,372146,373713,1567,10,N,N,-,-1,-1
MUSING.txt,372157,373885,1728,10,N,N,-,-1,-1
MUSING.txt,372170,374076,1906,10,N,N,-,-1,-1
MUSING.txt,372240,374093,1853,10,N,N,-,-1,-1
MUSING.txt,372395,374312,1917,10,N,N,-,-1,-1
MUSING.txt,372487,374575,2088,10,N,N,-,-1,-1
MUSING.txt,372768,374594,1826,10,N,N,-,-1,-1
MUSING.txt,372949,374832,1883,10,N,N,-,-1,-1
MUSING.txt,373482,374989,1507,10,N,N,-,-1,-1
MUSING.txt,373637,375031,1394,10,N,N,-,-1,-1
MUSING.txt,373714,375059,1345,10,N,N,-,-1,-1
MUSING.txt,373886,375483,1597,10,N,N,-,-1,-1
MUSING.txt,374077,375727,1650,10,N,N,-,-1,-1
MUSING.txt,374095,376707,2612,10,N,N,-,-1,-1
MUSING.txt,374313,376811,2498,10,N,N,-,-1,-1
MUSING.txt,374576,376866,2290,10,N,N,-,-1,-1
MUSING.txt,374596,376951,2355,10,N,N,-,-1,-1
MUSING.txt,374833,377018,2185,10,N,N,-,-1,-1
MUSING.txt,374990,377092,2102,10,N,N,-,-1,-1
MUSING.txt,375034,377117,2083,10,N,N,-,-1,-1
MUSING.txt,375062,377217,2155,10,N,N,-,-1,-1
MUSING.txt,375484,377343,1859,10,N,N,-,-1,-1
MUSING.txt,375728,377394,1666,10,N,N,-,-1,-1
MUSING.txt,376708,377511,803,10,N,N,-,-1,-1
MUSING.txt,376812,377551,739,10,N,N,-,-1,-1
MUSING.txt,376867,377663,796,10,N,N,-,-1,-1
MUSING.txt,376953,378013,1060,10,N,N,-,-1,-1
MUSING.txt,377019,378231,1212,10,N,N,-,-1,-1
MUSING.txt,377093,378426,1333,10,N,N,-,-1,-1
MUSING.txt,377118,378701,1583,10,N,N,-,-1,-1
MUSING.txt,377218,378828,1610,10,N,N,-,-1,-1
MUSING.txt,377344,379121,1777,10,N,N,-,-1,-1
MUSING.txt,377397,379259,1862,10,N,N,-,-1,-1
MUSING.txt,377514,379398,1884,10,N,N,-,-1,-1
MUSING.txt,377556,379600,2044,10,N,N,-,-1,-1
MUSING.txt,377664,379739,2075,10,N,N,-,-1,-1
MUSING.txt,378015,379932,1917,10,N,N,-,-1,-1
MUSING.txt,378232,380408,2176,10,N,N,-,-1,-1
MUSING.txt,378427,380713,2286,10,N,N,-,-1,-1
MUSING.txt,378703,380899,2196,10,N,N,-,-1,-1
MUSING.txt,378829,381055,2226,10,Y,N,-,-1,-1
MUSING.txt,379123,381056,1933,10,Y,N,-,-1,-1
MUSING.txt,379261,381186,1925,10,Y,N,-,-1,-1
MUSING.txt,379400,381740,2340,10,Y,N,-,-1,-1
MUSING.txt,379601,382451,2850,10,Y,N,-,-1,-1
MUSING.txt,379740,382740,3000,10,Y,N,-,-1,-1
MUSING.txt,379933,383260,3327,10,Y,N,-,-1,-1
MUSING.txt,380409,383545,3136,10,N,N,-,-1,-1
MUSING.txt,380714,383573,2859,10,N,N,-,-1,-1
MUSING.txt,380900,383605,2705,10,N,N,-,-1,-1
MUSING.txt,381055,384159,3104,10,N,N,-,-1,-1
MUSING.txt,381057,384339,3282,10,N,N,-,-1,-1
MUSING.txt,381187,384546,3359,10,N,N,-,-1,-1
MUSING.txt,381743,385055,3312,10,N,N,-,-1,-1
MUSING.txt,382452,385310,2858,10,N,N,-,-1,-1
MUSING.txt,382741,385476,2735,10,N,N,-,-1,-1
MUSING.txt,383262,385618,2356,10,N,N,-,-1,-1
MUSING.txt,383546,385632,2086,10,N,N,-,-1,-1
MUSING.txt,383574,385677,2103,10,N,N,-,-1,-1
MUSING.txt,383608,385863,2255,10,N,N,-,-1,-1
MUSING.txt,384162,386055,1893,10,N,N,-,-1,-1
MUSING.txt,384340,386442,2102,10,N,N,-,-1,-1
MUSING.txt,384547,386517,1970,10,N,N,-,-1,-1
MUSING.txt,385057,386564,1507,10,N,N,-,-1,-1
MUSING.txt,385311,386873,1562,10,N,N,-,-1,-1
MUSING.txt,385478,387091,1613,10,N,N,-,-1,-1
MUSING.txt,385619,387438,1819,10,N,N,-,-1,-1
MUSING.txt,385633,387714,2081,10,N,N,-,-1,-1
MUSING.txt,385678,388662,2984,10,N,N,-,-1,-1
MUSING.txt,385864,388847,2983,10,N,N,-,-1,-1
MUSING.txt,386056,389196,3140,10,N,N,-,-1,-1
MUSING.txt,386443,389365,2922,10,N,N,-,-1,-1
MUSING.txt,386518,389543,3025,10,N,N,-,-1,-1
MUSING.txt,386567,389859,3292,10,N,N,-,-1,-1
MUSING.txt,386874,390269,3395,10,N,N,-,-1,-1
MUSING.txt,387094,390686,3592,10,N,N,-,-1,-1
MUSING.txt,387439,391028,3589,10,N,N,-,-1,-1
MUSING.txt,387715,391334,3619,10,N,N,-,-1,-1
MUSING.txt,388663,391348,2685,10,N,N,-,-1,-1
MUSING.txt,388849,391594,2745,10,N,N,-,-1,-1
MUSING.txt,389197,391848,2651,10,N,N,-,-1,-1
MUSING.txt,389366,391976,2610,10,N,N,-,-1,-1
MUSING.txt,389544,392212,2668,10,N,N,-,-1,-1
MUSING.txt,389861,392230,2369,10,N,N,-,-1,-1
MUSING.txt,390270,392515,2245,10,N,N,-,-1,-1
MUSING.txt,390687,392689,2002,10,N,N,-,-1,-1
MUSING.txt,391029,392892,1863,10,N,N,-,-1,-1
MUSING.txt,391335,392983,1648,10,N,N,-,-1,-1
MUSING.txt,391349,393158,1809,10,N,N,-,-1,-1
MUSING.txt,391595,393365,1770,10,N,N,-,-1,-1
MUSING.txt,391849,393542,1693,10,N,N,-,-1,-1
MUSING.txt,391978,393837,1859,10,N,N,-,-1,-1
MUSING.txt,392214,394076,1862,10,Y,N,-,-1,-1
MUSING.txt,392231,394280,2049,10,Y,N,-,-1,-1
MUSING.txt,392516,394563,2047,10,Y,N,-,-1,-1
MUSING.txt,392690,394688,1998,10,N,N,-,-1,-1
MUSING.txt,392893,394842,1949,10,N,N,-,-1,-1
MUSING.txt,392984,394900,1916,10,N,N,-,-1,-1
MUSING.txt,393163,395153,1990,10,Y,N,-,-1,-1
MUSING.txt,393366,395405,2039,10,Y,N,-,-1,-1
MUSING.txt,393543,396205,2662,10,Y,N,-,-1,-1
MUSING.txt,393838,396951,3113,10,Y,N,-,-1,-1
MUSING.txt,394079,397377,3298,10,Y,N,-,-1,-1
MUSING.txt,394281,397485,3204,10,Y,N,-,-1,-1
MUSING.txt,394566,397845,3279,10,Y,N,-,-1,-1
MUSING.txt,394689,398310,3621,10,Y,N,-,-1,-1
MUSING.txt,394843,398538,3695,10,Y,N,-,-1,-1
MUSING.txt,394901,398899,3998,10,Y,N,-,-1,-1
MUSING.txt,395154,399232,4078,10,Y,N,-,-1,-1
MUSING.txt,395406,399479,4073,10,Y,N,-,-1,-1
MUSING.txt,396206,399806,3600,10,N,N,-,-1,-1
MUSING.txt,396953,399892,2939,10,N,N,-,-1,-1
MUSING.txt,397378,400036,2658,10,N,N,-,-1,-1
MUSING.txt,397486,400150,2664,10,N,N,-,-1,-1
MUSING.txt,397847,400411,2564,10,Y,N,-,-1,-1
MUSING.txt,398311,400551,2240,10,N,N,-,-1,-1
MUSING.txt,398539,400588,2049,10,Y,N,-,-1,-1
MUSING.txt,398900,400665,1765,10,Y,N,-,-1,-1
MUSING.txt,399235,400771,1536,10,Y,N,-,-1,-1
MUSING.txt,399482,400957,1475,10,Y,N,-,-1,-1
MUSING.txt,399807,401026,1219,10,Y,N,-,-1,-1
MUSING.txt,399895,401094,1199,10,Y,N,-,-1,-1
MUSING.txt,400039,401116,1077,10,Y,N,-,-1,-1
MUSING.txt,400153,401273,1120,10,Y,N,-,-1,-1
MUSING.txt,400416,401473,1057,10,N,N,-,-1,-1
MUSING.txt,400554,401524,970,10,N,N,-,-1,-1
MUSING.txt,400589,401672,1083,10,N,N,-,-1,-1
MUSING.txt,400666,402003,1337,10,N,N,-,-1,-1
MUSING.txt,400772,402250,1478,10,N,N,-,-1,-1
MUSING.txt,400959,402565,1606,10,N,N,-,-1,-1
MUSING.txt,401027,402862,1835,10,N,N,-,-1,-1
MUSING.txt,401097,402896,1799,10,N,N,-,-1,-1
MUSING.txt,401117,403261,2144,10,Y,N,-,-1,-1
MUSING.txt,401276,403670,2394,10,Y,N,-,-1,-1
MUSING.txt,401474,403827,2353,10,Y,N,-,-1,-1
MUSING.txt,401527,404030,2503,10,Y,N,-,-1,-1
MUSING.txt,401673,404171,2498,10,Y,N,-,-1,-1
MUSING.txt,402008,404348,2340,10,Y,N,-,-1,-1
MUSING.txt,402253,404844,2591,10,Y,N,-,-1,-1
MUSING.txt,402567,404954,2387,10,Y,N,-,-1,-1
MUSING.txt,402863,405030,2167,10,Y,N,-,-1,-1
MUSING.txt,402897,405183,2286,10,Y,N,-,-1,-1
MUSING.txt,403262,405432,2170,10,Y,N,-,-1,-1
MUSING.txt,403673,405528,1855,10,Y,N,-,-1,-1
MUSING.txt,403828,405621,1793,10,N,N,-,-1,-1
MUSING.txt,404032,405812,1780,10,N,N,-,-1,-1
MUSING.txt,404173,405977,1804,10,N,N,-,-1,-1
MUSING.txt,404349,406295,1946,10,N,N,-,-1,-1
MUSING.txt,404845,406372,1527,10,N,N,-,-1,-1
MUSING.txt,404955,406588,1633,10,N,N,-,-1,-1
MUSING.txt,405032,406798,1766,10,N,N,-,-1,-1
MUSING.txt,405184,407103,1919,10,N,N,-,-1,-1
MUSING.txt,405433,407264,1831,10,Y,N,-,-1,-1
MUSING.txt,405529,407514,1985,10,Y,N,-,-1,-1
MUSING.txt,405622,407871,2249,10,Y,N,-,-1,-1
MUSING.txt,405815,408038,2223,10,Y,N,-,-1,-1
MUSING.txt,405982,408123,2141,10,Y,N,-,-1,-1
MUSING.txt,406296,408294,1998,10,Y,N,-,-1,-1
MUSING.txt,406373,409444,3071,10,Y,N,-,-1,-1
MUSING.txt,406589,409904,3315,10,N,N,-,-1,-1
MUSING.txt,406799,410038,3239,10,N,N,-,-1,-1
MUSING.txt,407104,410042,2938,10,N,N,-,-1,-1
MUSING.txt,407267,410104,2837,10,N,N,-,-1,-1
MUSING.txt,407515,410117,2602,10,N,N,-,-1,-1
MUSING.txt,407872,410150,2278,10,N,N,-,-1,-1
MUSING.txt,408040,410314,2274,10,N,N,-,-1,-1
MUSING.txt,408124,410328,2204,10,N,N,-,-1,-1
MUSING.txt,408295,410350,2055,10,N,N,-,-1,-1
MUSING.txt,409445,410428,983,10,N,N,-,-1,-1
MUSING.txt,409907,410479,572,10,N,N,-,-1,-1
MUSING.txt,410039,410495,456,10,N,N,-,-1,-1
MUSING.txt,410044,410520,476,10,N,N,-,-1,-1
MUSING.txt,410106,410542,436,10,N,N,-,-1,-1
MUSING.txt,410118,410566,448,10,N,N,-,-1,-1
MUSING.txt,410151,410591,440,10,N,N,-,-1,-1
MUSING.txt,410316,410612,296,10,N,N,-,-1,-1
MUSING.txt,410329,410628,299,10,N,N,-,-1,-1
MUSING.txt,410352,410654,302,10,N,N,-,-1,-1
MUSING.txt,410430,410711,281,10,N,N,-,-1,-1
MUSING.txt,410481,410732,251,10,N,N,-,-1,-1
MUSING.txt,410497,410751,254,10,N,N,-,-1,-1
MUSING.txt,410522,410777,255,10,N,N,-,-1,-1
MUSING.txt,410544,410801,257,10,N,N,-,-1,-1
MUSING.txt,410571,410853,282,10,N,N,-,-1,-1
MUSING.txt,410593,410873,280,10,N,N,-,-1,-1
MUSING.txt,410614,410891,277,10,N,N,-,-1,-1
MUSING.txt,410630,410916,286,10,N,N,-,-1,-1
MUSING.txt,410656,410939,283,10,N,N,-,-1,-1
MUSING.txt,410713,410956,243,10,N,N,-,-1,-1
MUSING.txt,410734,410981,247,10,N,N,-,-1,-1
MUSING.txt,410753,410988,235,10,N,N,-,-1,-1
MUSING.txt,410779,410999,220,10,N,N,-,-1,-1
MUSING.txt,410803,411025,222,10,N,N,-,-1,-1
MUSING.txt,410855,411048,193,10,N,N,-,-1,-1
MUSING.txt,410875,411070,195,10,N,N,-,-1,-1
MUSING.txt,410893,411113,220,10,N,N,-,-1,-1
MUSING.txt,410918,411133,215,10,N,N,-,-1,-1
MUSING.txt,410941,411152,211,10,N,N,-,-1,-1
MUSING.txt,410958,411171,213,10,N,N,-,-1,-1
MUSING.txt,410983,411177,194,10,N,N,-,-1,-1
MUSING.txt,410989,411190,201,10,N,N,-,-1,-1
MUSING.txt,411001,411209,208,10,N,N,-,-1,-1
MUSING.txt,411027,411229,202,10,N,N,-,-1,-1
MUSING.txt,411050,411246,196,10,N,N,-,-1,-1
MUSING.txt,411072,411267,195,10,N,N,-,-1,-1
MUSING.txt,411115,411288,173,10,N,N,-,-1,-1
MUSING.txt,411135,411340,205,10,N,N,-,-1,-1
MUSING.txt,411154,411359,205,10,N,N,-,-1,-1
MUSING.txt,411173,411424,251,10,N,N,-,-1,-1
MUSING.txt,411178,411450,272,10,N,N,-,-1,-1
MUSING.txt,411192,411473,281,10,N,N,-,-1,-1
MUSING.txt,411211,411495,284,10,N,N,-,-1,-1
MUSING.txt,411231,411515,284,10,N,N,-,-1,-1
MUSING.txt,411248,411534,286,10,N,N,-,-1,-1
MUSING.txt,411269,411556,287,10,N,N,-,-1,-1
MUSING.txt,411290,411579,289,10,N,N,-,-1,-1
MUSING.txt,411342,411603,261,10,N,N,-,-1,-1
MUSING.txt,411362,411620,258,10,N,N,-,-1,-1
MUSING.txt,411426,411638,212,10,N,N,-,-1,-1
MUSING.txt,411452,411661,209,10,N,N,-,-1,-1
MUSING.txt,411475,411733,258,10,N,N,-,-1,-1
MUSING.txt,411497,411754,257,10,N,N,-,-1,-1
MUSING.txt,411517,411779,262,10,N,N,-,-1,-1
MUSING.txt,411536,411800,264,10,N,N,-,-1,-1
MUSING.txt,411558,411821,263,10,N,N,-,-1,-1
MUSING.txt,411581,411847,266,10,N,N,-,-1,-1
MUSING.txt,411605,411870,265,10,N,N,-,-1,-1
MUSING.txt,411622,411900,278,10,N,N,-,-1,-1
MUSING.txt,411640,411921,281,10,N,N,-,-1,-1
MUSING.txt,411663,411927,264,10,N,N,-,-1,-1
MUSING.txt,411735,411972,237,10,N,N,-,-1,-1
MUSING.txt,411756,411991,235,10,N,N,-,-1,-1
MUSING.txt,411781,412044,263,10,N,N,-,-1,-1
MUSING.txt,411802,412065,263,10,N,N,-,-1,-1
MUSING.txt,411826,412085,259,10,N,N,-,-1,-1
MUSING.txt,411849,412111,262,10,N,N,-,-1,-1
MUSING.txt,411871,412130,259,10,N,N,-,-1,-1
MUSING.txt,411902,412137,235,10,N,N,-,-1,-1
MUSING.txt,411923,412153,230,10,N,N,-,-1,-1
MUSING.txt,411928,412176,248,10,N,N,-,-1,-1
MUSING.txt,411974,412198,224,10,N,N,-,-1,-1
MUSING.txt,411993,412216,223,10,N,N,-,-1,-1
MUSING.txt,412046,412235,189,10,N,N,-,-1,-1
MUSING.txt,412067,412254,187,10,N,N,-,-1,-1
MUSING.txt,412087,412277,190,10,N,N,-,-1,-1
MUSING.txt,412113,412533,420,10,N,N,-,-1,-1
MUSING.txt,412132,413179,1047,10,N,N,-,-1,-1
MUSING.txt,412138,413511,1373,10,N,N,-,-1,-1
MUSING.txt,412155,413524,1369,10,N,N,-,-1,-1
MUSING.txt,412178,413752,1574,10,N,N,-,-1,-1
MUSING.txt,412200,413970,1770,10,N,N,-,-1,-1
MUSING.txt,412218,414237,2019,10,N,N,-,-1,-1
MUSING.txt,412237,414358,2121,10,N,N,-,-1,-1
MUSING.txt,412259,414572,2313,10,N,N,-,-1,-1
MUSING.txt,412280,414925,2645,10,Y,N,-,-1,-1
MUSING.txt,412534,415096,2562,10,Y,N,-,-1,-1
MUSING.txt,413181,415162,1981,10,N,N,-,-1,-1
MUSING.txt,413514,415226,1712,10,N,N,-,-1,-1
MUSING.txt,413525,415302,1777,10,N,N,-,-1,-1
MUSING.txt,413753,415325,1572,10,N,N,-,-1,-1
MUSING.txt,413971,415529,1558,10,N,N,-,-1,-1
MUSING.txt,414238,415683,1445,10,N,N,-,-1,-1
MUSING.txt,414359,415697,1338,10,N,N,-,-1,-1
MUSING.txt,414573,415910,1337,10,N,N,-,-1,-1
MUSING.txt,414926,415933,1007,10,N,N,-,-1,-1
MUSING.txt,415097,416157,1060,10,N,N,-,-1,-1
MUSING.txt,415163,416316,1153,10,N,N,-,-1,-1
MUSING.txt,415227,416444,1217,10,N,N,-,-1,-1
MUSING.txt,415305,416457,1152,10,N,N,-,-1,-1
MUSING.txt,415326,416695,1369,10,N,N,-,-1,-1
MUSING.txt,415530,416716,1186,10,N,N,-,-1,-1
MUSING.txt,415686,416796,1110,10,N,N,-,-1,-1
MUSING.txt,415698,416841,1143,10,N,N,-,-1,-1
MUSING.txt,415913,416853,940,10,N,N,-,-1,-1
MUSING.txt,415934,417023,1089,10,N,N,-,-1,-1
MUSING.txt,416158,417327,1169,10,N,N,-,-1,-1
MUSING.txt,416317,417538,1221,10,N,N,-,-1,-1
MUSING.txt,416447,417564,1117,10,N,N,-,-1,-1
MUSING.txt,416458,417734,1276,10,N,N,-,-1,-1
MUSING.txt,416698,417923,1225,10,N,N,-,-1,-1
MUSING.txt,416717,418127,1410,10,N,N,-,-1,-1
MUSING.txt,416797,418313,1516,10,N,N,-,-1,-1
MUSING.txt,416844,418427,1583,10,N,N,-,-1,-1
MUSING.txt,416854,418498,1644,10,N,N,-,-1,-1
MUSING.txt,417024,418578,1554,10,N,N,-,-1,-1
MUSING.txt,417328,418620,1292,10,N,N,-,-1,-1
MUSING.txt,417541,418759,1218,10,N,N,-,-1,-1
MUSING.txt,417565,418925,1360,10,N,N,-,-1,-1
MUSING.txt,417735,419069,1334,10,N,N,-,-1,-1
MUSING.txt,417924,419105,1181,10,N,N,-,-1,-1
MUSING.txt,418128,419446,1318,10,N,N,-,-1,-1
MUSING.txt,418314,419534,1220,10,N,N,-,-1,-1
MUSING.txt,418428,419672,1244,10,N,N,-,-1,-1
MUSING.txt,418499,419783,1284,10,N,N,-,-1,-1
MUSING.txt,418579,419989,1410,10,N,N,-,-1,-1
MUSING.txt,418622,420079,1457,10,N,N,-,-1,-1
MUSING.txt,418760,420519,1759,10,N,N,-,-1,-1
MUSING.txt,418926,420558,1632,10,N,N,-,-1,-1
MUSING.txt,419071,420688,1617,10,N,N,-,-1,-1
MUSING.txt,419106,420882,1776,10,N,N,-,-1,-1
MUSING.txt,419448,421222,1774,10,N,N,-,-1,-1
MUSING.txt,419535,421446,1911,10,Y,N,-,-1,-1
MUSING.txt,419673,421670,1997,10,N,N,-,-1,-1
MUSING.txt,419784,421880,2096,10,N,N,-,-1,-1
MUSING.txt,419990,422039,2049,10,N,N,-,-1,-1
MUSING.txt,420082,422569,2487,10,N,N,-,-1,-1
MUSING.txt,420520,422741,2221,10,N,N,-,-1,-1
MUSING.txt,420559,423456,2897,10,N,N,-,-1,-1
MUSING.txt,420689,423688,2999,10,N,N,-,-1,-1
MUSING.txt,420883,423791,2908,10,N,N,-,-1,-1
MUSING.txt,421223,424009,2786,10,N,N,-,-1,-1
MUSING.txt,421447,424143,2696,10,N,N,-,-1,-1
MUSING.txt,421670,424197,2527,10,N,N,-,-1,-1
MUSING.txt,421881,424425,2544,10,Y,N,-,-1,-1
MUSING.txt,422042,424489,2447,10,N,N,-,-1,-1
MUSING.txt,422572,424562,1990,10,N,N,-,-1,-1
MUSING.txt,422742,424613,1871,10,N,N,-,-1,-1
MUSING.txt,423457,424704,1247,10,N,N,-,-1,-1
MUSING.txt,423689,425143,1454,10,N,N,-,-1,-1
MUSING.txt,423794,425379,1585,10,N,N,-,-1,-1
MUSING.txt,424010,425400,1390,10,N,N,-,-1,-1
MUSING.txt,424144,425413,1269,10,N,N,-,-1,-1
MUSING.txt,424198,425442,1244,10,N,N,-,-1,-1
MUSING.txt,424427,425460,1033,10,N,N,-,-1,-1
MUSING.txt,424490,425772,1282,10,N,N,-,-1,-1
MUSING.txt,424563,426167,1604,10,N,N,-,-1,-1
MUSING.txt,424616,426316,1700,10,N,N,-,-1,-1
MUSING.txt,424706,426540,1834,10,N,N,-,-1,-1
MUSING.txt,425144,426993,1849,10,N,N,-,-1,-1
MUSING.txt,425380,427204,1824,10,N,N,-,-1,-1
MUSING.txt,425401,427336,1935,10,N,N,-,-1,-1
MUSING.txt,425414,427542,2128,10,N,N,-,-1,-1
MUSING.txt,425442,427603,2161,10,N,N,-,-1,-1
MUSING.txt,425465,427744,2279,10,N,N,-,-1,-1
MUSING.txt,425774,427799,2025,10,N,N,-,-1,-1
MUSING.txt,426168,428091,1923,10,N,N,-,-1,-1
MUSING.txt,426317,428457,2140,10,N,N,-,-1,-1
MUSING.txt,426541,428681,2140,10,N,N,-,-1,-1
MUSING.txt,426994,429100,2106,10,N,N,-,-1,-1
MUSING.txt,427205,429362,2157,10,N,N,-,-1,-1
MUSING.txt,427337,429560,2223,10,Y,N,-,-1,-1
MUSING.txt,427543,429895,2352,10,Y,N,-,-1,-1
MUSING.txt,427604,430283,2679,10,Y,N,-,-1,-1
MUSING.txt,427745,430357,2612,10,Y,N,-,-1,-1
MUSING.txt,427800,430663,2863,10,Y,N,-,-1,-1
MUSING.txt,428093,430719,2626,10,Y,N,-,-1,-1
MUSING.txt,428460,430874,2414,10,Y,N,-,-1,-1
MUSING.txt,428683,431067,2384,10,Y,N,-,-1,-1
MUSING.txt,429103,431080,1977,10,N,N,-,-1,-1
MUSING.txt,429364,431113,1749,10,Y,N,-,-1,-1
MUSING.txt,429561,431167,1606,10,N,N,-,-1,-1
MUSING.txt,429896,431229,1333,10,N,N,-,-1,-1
MUSING.txt,430284,431348,1064,10,N,N,-,-1,-1
MUSING.txt,430358,431377,1019,10,N,N,-,-1,-1
MUSING.txt,430664,431533,869,10,N,N,-,-1,-1
MUSING.txt,430720,431618,898,10,N,N,-,-1,-1
MUSING.txt,430876,431657,781,10,N,N,-,-1,-1
MUSING.txt,431068,432005,937,10,N,N,-,-1,-1
MUSING.txt,431080,432185,1105,10,N,N,-,-1,-1
MUSING.txt,431114,432532,1418,10,N,N,-,-1,-1
MUSING.txt,431167,432658,1491,10,N,N,-,-1,-1
MUSING.txt,431231,432951,1720,10,N,N,-,-1,-1
MUSING.txt,431349,433018,1669,10,N,N,-,-1,-1
MUSING.txt,431378,433110,1732,10,N,N,-,-1,-1
MUSING.txt,431534,433221,1687,10,N,N,-,-1,-1
MUSING.txt,431621,433346,1725,10,N,N,-,-1,-1
MUSING.txt,431658,433772,2114,10,Y,N,-,-1,-1
MUSING.txt,432006,433859,1853,10,N,N,-,-1,-1
MUSING.txt,432186,434088,1902,10,N,N,-,-1,-1
MUSING.txt,432533,434115,1582,10,N,N,-,-1,-1
MUSING.txt,432659,434131,1472,10,N,N,-,-1,-1
MUSING.txt,432952,434705,1753,10,Y,N,-,-1,-1
MUSING.txt,433019,434949,1930,10,N,N,-,-1,-1
MUSING.txt,433115,435140,2025,10,N,N,-,-1,-1
MUSING.txt,433222,435230,2008,10,N,N,-,-1,-1
MUSING.txt,433347,435341,1994,10,N,N,-,-1,-1
MUSING.txt,433775,435541,1766,10,N,N,-,-1,-1
MUSING.txt,433860,435658,1798,10,N,N,-,-1,-1
MUSING.txt,434091,435822,1731,10,N,N,-,-1,-1
MUSING.txt,434118,435994,1876,10,Y,N,-,-1,-1
MUSING.txt,434134,436197,2063,10,N,N,-,-1,-1
MUSING.txt,434706,436359,1653,10,N,N,-,-1,-1
MUSING.txt,434950,436472,1522,10,N,N,-,-1,-1
MUSING.txt,435141,436512,1371,10,N,N,-,-1,-1
MUSING.txt,435231,436967,1736,10,N,N,-,-1,-1
MUSING.txt,435342,437187,1845,10,N,N,-,-1,-1
MUSING.txt,435542,437301,1759,10,Y,N,-,-1,-1
MUSING.txt,435659,437472,1813,10,Y,N,-,-1,-1
MUSING.txt,435823,437511,1688,10,Y,N,-,-1,-1
MUSING.txt,435995,437575,1580,10,Y,N,-,-1,-1
MUSING.txt,436198,437657,1459,10,Y,N,-,-1,-1
MUSING.txt,436360,437910,1550,10,Y,N,-,-1,-1
MUSING.txt,436474,438088,1614,10,Y,N,-,-1,-1
MUSING.txt,436515,438585,2070,10,Y,N,-,-1,-1
MUSING.txt,436970,438753,1783,10,Y,N,-,-1,-1
MUSING.txt,437192,438844,1652,10,Y,N,-,-1,-1
MUSING.txt,437302,438892,1590,10,Y,N,-,-1,-1
MUSING.txt,437473,439134,1661,10,N,N,-,-1,-1
MUSING.txt,437512,439282,1770,10,N,N,-,-1,-1
MUSING.txt,437576,439346,1770,10,N,N,-,-1,-1
MUSING.txt,437658,439583,1925,10,N,N,-,-1,-1
MUSING.txt,437911,439753,1842,10,N,N,-,-1,-1
MUSING.txt,438089,439986,1897,10,Y,N,-,-1,-1
MUSING.txt,438586,440181,1595,10,N,N,-,-1,-1
MUSING.txt,438755,440300,1545,10,N,N,-,-1,-1
MUSING.txt,438846,440454,1608,10,N,N,-,-1,-1
MUSING.txt,438894,440476,1582,10,N,N,-,-1,-1
MUSING.txt,439135,440722,1587,10,N,N,-,-1,-1
MUSING.txt,439282,441079,1797,10,Y,N,-,-1,-1
MUSING.txt,439347,441122,1775,10,Y,N,-,-1,-1
MUSING.txt,439586,441272,1686,10,Y,N,-,-1,-1
MUSING.txt,439755,441464,1709,10,Y,N,-,-1,-1
MUSING.txt,439987,441554,1567,10,Y,N,-,-1,-1
MUSING.txt,440182,441671,1489,10,Y,N,-,-1,-1
MUSING.txt,440301,441990,1689,10,Y,N,-,-1,-1
MUSING.txt,440455,442130,1675,10,Y,N,-,-1,-1
MUSING.txt,440477,442221,1744,10,Y,N,-,-1,-1
MUSING.txt,440725,442336,1611,10,Y,N,-,-1,-1
MUSING.txt,441081,442657,1576,10,Y,N,-,-1,-1
MUSING.txt,441124,442689,1565,10,Y,N,-,-1,-1
MUSING.txt,441273,442827,1554,10,Y,N,-,-1,-1
MUSING.txt,441465,443005,1540,10,N,N,-,-1,-1
MUSING.txt,441555,443284,1729,10,N,N,-,-1,-1
MUSING.txt,441673,443856,2183,10,N,N,-,-1,-1
MUSING.txt,441993,444000,2007,10,N,N,-,-1,-1
MUSING.txt,442131,444185,2054,10,N,N,-,-1,-1
MUSING.txt,442222,444405,2183,10,N,N,-,-1,-1
MUSING.txt,442341,444790,2449,10,N,N,-,-1,-1
MUSING.txt,442658,445053,2395,10,N,N,-,-1,-1
MUSING.txt,442690,445109,2419,10,N,N,-,-1,-1
MUSING.txt,442829,445211,2382,10,N,N,-,-1,-1
MUSING.txt,443008,445227,2219,10,N,N,-,-1,-1
MUSING.txt,443287,445486,2199,10,N,N,-,-1,-1
MUSING.txt,443857,445789,1932,10,N,N,-,-1,-1
MUSING.txt,444001,446030,2029,10,N,N,-,-1,-1
MUSING.txt,444186,446502,2316,10,N,N,-,-1,-1
MUSING.txt,444406,446727,2321,10,N,N,-,-1,-1
MUSING.txt,444792,446998,2206,10,N,N,-,-1,-1
MUSING.txt,445054,447082,2028,10,N,N,-,-1,-1
MUSING.txt,445110,447375,2265,10,N,N,-,-1,-1
MUSING.txt,445212,447624,2412,10,N,N,-,-1,-1
MUSING.txt,445228,447723,2495,10,N,N,-,-1,-1
MUSING.txt,445487,447762,2275,10,N,N,-,-1,-1
MUSING.txt,445790,447843,2053,10,N,N,-,-1,-1
MUSING.txt,446033,447988,1955,10,N,N,-,-1,-1
MUSING.txt,446503,448231,1728,10,N,N,-,-1,-1
MUSING.txt,446728,448420,1692,10,N,N,-,-1,-1
MUSING.txt,446999,448440,1441,10,N,N,-,-1,-1
MUSING.txt,447084,448483,1399,10,N,N,-,-1,-1
MUSING.txt,447376,448505,1129,10,N,N,-,-1,-1
MUSING.txt,447625,448525,900,10,N,N,-,-1,-1
MUSING.txt,447724,448539,815,10,N,N,-,-1,-1
MUSING.txt,447763,448552,789,10,N,N,-,-1,-1
MUSING.txt,447844,448598,754,10,N,N,-,-1,-1
MUSING.txt,447989,448722,733,10,N,N,-,-1,-1
MUSING.txt,448232,448995,763,10,N,N,-,-1,-1
MUSING.txt,448421,449021,600,10,N,N,-,-1,-1
MUSING.txt,448441,449538,1097,10,N,N,-,-1,-1
MUSING.txt,448484,450257,1773,10,N,N,-,-1,-1
MUSING.txt,448506,450278,1772,10,N,N,-,-1,-1
MUSING.txt,448526,450437,1911,10,N,N,-,-1,-1
MUSING.txt,448540,450638,2098,10,N,N,-,-1,-1
MUSING.txt,448553,451130,2577,10,Y,N,-,-1,-1
MUSING.txt,448599,451613,3014,10,N,N,-,-1,-1
MUSING.txt,448723,451628,2905,10,N,N,-,-1,-1
MUSING.txt,448998,451666,2668,10,N,N,-,-1,-1
MUSING.txt,449022,451968,2946,10,N,N,-,-1,-1
MUSING.txt,449543,452185,2642,10,N,N,-,-1,-1
MUSING.txt,450260,452893,2633,10,N,N,-,-1,-1
MUSING.txt,450279,452932,2653,10,N,N,-,-1,-1
MUSING.txt,450439,453067,2628,10,N,N,-,-1,-1
MUSING.txt,450639,453114,2475,10,N,N,-,-1,-1
MUSING.txt,451132,453304,2172,10,Y,N,-,-1,-1
MUSING.txt,451615,453370,1755,10,Y,N,-,-1,-1
MUSING.txt,451631,453484,1853,10,N,N,-,-1,-1
MUSING.txt,451667,453912,2245,10,N,N,-,-1,-1
MUSING.txt,451969,454510,2541,10,N,N,-,-1,-1
MUSING.txt,452187,454546,2359,10,N,N,-,-1,-1
MUSING.txt,452896,455076,2180,10,Y,N,-,-1,-1
MUSING.txt,452933,455115,2182,10,Y,N,-,-1,-1
MUSING.txt,453068,455461,2393,10,N,N,-,-1,-1
MUSING.txt,453115,455572,2457,10,N,N,-,-1,-1
MUSING.txt,453305,455801,2496,10,N,N,-,-1,-1
MUSING.txt,453371,455876,2505,10,N,N,-,-1,-1
MUSING.txt,453486,455982,2496,10,N,N,-,-1,-1
MUSING.txt,453913,456211,2298,10,N,N,-,-1,-1
MUSING.txt,454511,456382,1871,10,N,N,-,-1,-1
MUSING.txt,454547,457052,2505,10,N,N,-,-1,-1
MUSING.txt,455079,457573,2494,10,N,N,-,-1,-1
MUSING.txt,455116,457801,2685,10,N,N,-,-1,-1
MUSING.txt,455462,458134,2672,10,N,N,-,-1,-1
MUSING.txt,455573,458229,2656,10,N,N,-,-1,-1
MUSING.txt,455802,458711,2909,10,N,N,-,-1,-1
MUSING.txt,455877,459055,3178,10,N,N,-,-1,-1
MUSING.txt,455985,459478,3493,10,N,N,-,-1,-1
MUSING.txt,456212,459603,3391,10,N,N,-,-1,-1
MUSING.txt,456385,459965,3580,10,N,N,-,-1,-1
MUSING.txt,457053,460561,3508,10,N,N,-,-1,-1
MUSING.txt,457574,460820,3246,10,N,N,-,-1,-1
MUSING.txt,457804,461132,3328,10,N,N,-,-1,-1
MUSING.txt,458135,461282,3147,10,N,N,-,-1,-1
MUSING.txt,458230,461876,3646,10,N,N,-,-1,-1
MUSING.txt,458716,462067,3351,10,N,N,-,-1,-1
MUSING.txt,459058,462716,3658,10,N,N,-,-1,-1
MUSING.txt,459481,462802,3321,10,N,N,-,-1,-1
MUSING.txt,459604,462966,3362,10,N,N,-,-1,-1
MUSING.txt,459966,463178,3212,10,N,N,-,-1,-1
MUSING.txt,460564,463362,2798,10,N,N,-,-1,-1
MUSING.txt,460821,463640,2819,10,N,N,-,-1,-1
MUSING.txt,461135,463968,2833,10,N,N,-,-1,-1
MUSING.txt,461283,464273,2990,10,N,N,-,-1,-1
MUSING.txt,461881,464403,2522,10,Y,N,-,-1,-1
MUSING.txt,462068,464729,2661,10,N,N,-,-1,-1
MUSING.txt,462718,464913,2195,10,Y,N,-,-1,-1
MUSING.txt,462804,465125,2321,10,N,N,-,-1,-1
MUSING.txt,462967,465391,2424,10,Y,N,-,-1,-1
MUSING.txt,463179,465417,2238,10,N,N,-,-1,-1
MUSING.txt,463363,465458,2095,10,N,N,-,-1,-1
MUSING.txt,463643,465517,1874,10,N,N,-,-1,-1
MUSING.txt,463969,465582,1613,10,N,N,-,-1,-1
MUSING.txt,464274,465627,1353,10,N,N,-,-1,-1
MUSING.txt,464406,465662,1256,10,N,N,-,-1,-1
MUSING.txt,464730,465893,1163,10,N,N,-,-1,-1
MUSING.txt,464914,466130,1216,10,N,N,-,-1,-1
MUSING.txt,465126,466141,1015,10,N,N,-,-1,-1
MUSING.txt,465394,466389,995,10,N,N,-,-1,-1
MUSING.txt,465418,466633,1215,10,N,N,-,-1,-1
MUSING.txt,465461,467032,1571,10,N,N,-,-1,-1
MUSING.txt,465518,467360,1842,10,N,N,-,-1,-1
MUSING.txt,465585,467469,1884,10,N,N,-,-1,-1
MUSING.txt,465629,467650,2021,10,N,N,-,-1,-1
MUSING.txt,465663,467692,2029,10,N,N,-,-1,-1
MUSING.txt,465894,467981,2087,10,N,N,-,-1,-1
MUSING.txt,466133,468150,2017,10,N,N,-,-1,-1
MUSING.txt,466142,468353,2211,10,N,N,-,-1,-1
MUSING.txt,466394,468530,2136,10,Y,N,-,-1,-1
MUSING.txt,466634,468626,1992,10,Y,N,-,-1,-1
MUSING.txt,467035,468870,1835,10,Y,N,-,-1,-1
MUSING.txt,467361,469010,1649,10,Y,N,-,-1,-1
MUSING.txt,467471,469174,1703,10,Y,N,-,-1,-1
MUSING.txt,467651,469725,2074,10,Y,N,-,-1,-1
MUSING.txt,467693,469938,2245,10,Y,N,-,-1,-1
MUSING.txt,467983,470037,2054,10,Y,N,-,-1,-1
MUSING.txt,468151,470494,2343,10,N,N,-,-1,-1
MUSING.txt,468354,470693,2339,10,N,N,-,-1,-1
MUSING.txt,468531,470759,2228,10,N,N,-,-1,-1
MUSING.txt,468627,470881,2254,10,N,N,-,-1,-1
MUSING.txt,468872,471117,2245,10,N,N,-,-1,-1
MUSING.txt,469012,472046,3034,10,N,N,-,-1,-1
MUSING.txt,469177,472151,2974,10,N,N,-,-1,-1
MUSING.txt,469726,472344,2618,10,N,N,-,-1,-1
MUSING.txt,469939,472468,2529,10,N,N,-,-1,-1
MUSING.txt,470039,472485,2446,10,N,N,-,-1,-1
MUSING.txt,470495,472538,2043,10,N,N,-,-1,-1
MUSING.txt,470694,472953,2259,10,N,N,-,-1,-1
MUSING.txt,470760,473367,2607,10,N,N,-,-1,-1
MUSING.txt,470882,473767,2885,10,N,N,-,-1,-1
MUSING.txt,471118,474242,3124,10,N,N,-,-1,-1
MUSING.txt,472048,474301,2253,10,N,N,-,-1,-1
MUSING.txt,472152,474558,2406,10,N,N,-,-1,-1
MUSING.txt,472345,474807,2462,10,N,N,-,-1,-1
MUSING.txt,472470,474831,2361,10,N,N,-,-1,-1
MUSING.txt,472488,474946,2458,10,N,N,-,-1,-1
MUSING.txt,472538,475275,2737,10,N,N,-,-1,-1
MUSING.txt,472954,475456,2502,10,N,N,-,-1,-1
MUSING.txt,473368,475545,2177,10,N,N,-,-1,-1
MUSING.txt,473769,475584,1815,10,N,N,-,-1,-1
MUSING.txt,474243,475878,1635,10,N,N,-,-1,-1
MUSING.txt,474302,476247,1945,10,N,N,-,-1,-1
MUSING.txt,474559,476444,1885,10,N,N,-,-1,-1
MUSING.txt,474808,476673,1865,10,N,N,-,-1,-1
MUSING.txt,474832,476954,2122,10,N,N,-,-1,-1
MUSING.txt,474947,477132,2185,10,N,N,-,-1,-1
MUSING.txt,475277,477304,2027,10,Y,N,-,-1,-1
MUSING.txt,475457,477449,1992,10,Y,N,-,-1,-1
MUSING.txt,475547,477707,2160,10,Y,N,-,-1,-1
MUSING.txt,475585,477757,2172,10,N,N,-,-1,-1
MUSING.txt,475879,477823,1944,10,Y,N,-,-1,-1
MUSING.txt,476248,478011,1763,10,Y,N,-,-1,-1
MUSING.txt,476445,478112,1667,10,Y,N,-,-1,-1
MUSING.txt,476676,478313,1637,10,N,N,-,-1,-1
MUSING.txt,476957,478535,1578,10,Y,N,-,-1,-1
MUSING.txt,477133,478677,1544,10,N,N,-,-1,-1
MUSING.txt,477306,478905,1599,10,Y,N,-,-1,-1
MUSING.txt,477450,479247,1797,10,Y,N,-,-1,-1
MUSING.txt,477709,479456,1747,10,Y,N,-,-1,-1
MUSING.txt,477760,479473,1713,10,Y,N,-,-1,-1
MUSING.txt,477828,479605,1777,10,Y,N,-,-1,-1
MUSING.txt,478012,479693,1681,10,Y,N,-,-1,-1
MUSING.txt,478114,479844,1730,10,Y,N,-,-1,-1
MUSING.txt,478314,479906,1592,10,Y,N,-,-1,-1
MUSING.txt,478536,480023,1487,10,Y,N,-,-1,-1
MUSING.txt,478678,480070,1392,10,Y,N,-,-1,-1
MUSING.txt,478906,480092,1186,10,Y,N,-,-1,-1
MUSING.txt,479248,480250,1002,10,N,N,-,-1,-1
MUSING.txt,479457,480433,976,10,N,N,-,-1,-1
MUSING.txt,479474,480533,1059,10,N,N,-,-1,-1
MUSING.txt,479606,480678,1072,10,N,N,-,-1,-1
MUSING.txt,479694,480836,1142,10,N,N,-,-1,-1
MUSING.txt,479845,481048,1203,10,N,N,-,-1,-1
MUSING.txt,479907,481166,1259,10,N,N,-,-1,-1
MUSING.txt,480025,481572,1547,10,N,N,-,-1,-1
MUSING.txt,480072,481898,1826,10,N,N,-,-1,-1
MUSING.txt,480095,482297,2202,10,N,N,-,-1,-1
MUSING.txt,480251,482445,2194,10,N,N,-,-1,-1
MUSING.txt,480434,482485,2051,10,N,N,-,-1,-1
MUSING.txt,480534,482613,2079,10,N,N,-,-1,-1
MUSING.txt,480679,482628,1949,10,N,N,-,-1,-1
MUSING.txt,480837,482694,1857,10,N,N,-,-1,-1
MUSING.txt,481049,482828,1779,10,N,N,-,-1,-1
MUSING.txt,481167,482959,1792,10,N,N,-,-1,-1
MUSING.txt,481573,483141,1568,10,N,N,-,-1,-1
MUSING.txt,481899,483447,1548,10,N,N,-,-1,-1
MUSING.txt,482298,483818,1520,10,N,N,-,-1,-1
MUSING.txt,482446,484091,1645,10,N,N,-,-1,-1
MUSING.txt,482486,484856,2370,10,N,N,-,-1,-1
MUSING.txt,482614,484934,2320,10,N,N,-,-1,-1
MUSING.txt,482629,485223,2594,10,N,N,-,-1,-1
MUSING.txt,482695,485419,2724,10,N,N,-,-1,-1
MUSING.txt,482833,485770,2937,10,N,N,-,-1,-1
MUSING.txt,482961,485890,2929,10,N,N,-,-1,-1
MUSING.txt,483143,486142,2999,10,N,N,-,-1,-1
MUSING.txt,483448,486593,3145,10,N,N,-,-1,-1
MUSING.txt,483820,486848,3028,10,N,N,-,-1,-1
MUSING.txt,484092,487236,3144,10,N,N,-,-1,-1
MUSING.txt,484857,487435,2578,10,N,N,-,-1,-1
MUSING.txt,484935,487729,2794,10,N,N,-,-1,-1
MUSING.txt,485224,487798,2574,10,N,N,-,-1,-1
MUSING.txt,485421,488167,2746,10,N,N,-,-1,-1
MUSING.txt,485771,488398,2627,10,N,N,-,-1,-1
MUSING.txt,485895,488624,2729,10,N,N,-,-1,-1
MUSING.txt,486143,488861,2718,10,N,N,-,-1,-1
MUSING.txt,486594,489183,2589,10,N,N,-,-1,-1
MUSING.txt,486851,489440,2589,10,N,N,-,-1,-1
MUSING.txt,487237,489550,2313,10,N,N,-,-1,-1
MUSING.txt,487436,489807,2371,10,N,N,-,-1,-1
MUSING.txt,487730,490029,2299,10,N,N,-,-1,-1
MUSING.txt,487799,490303,2504,10,N,N,-,-1,-1
MUSING.txt,488168,490414,2246,10,N,N,-,-1,-1
MUSING.txt,488400,490525,2125,10,N,N,-,-1,-1
MUSING.txt,488625,490691,2066,10,N,N,-,-1,-1
MUSING.txt,488864,490722,1858,10,N,N,-,-1,-1
MUSING.txt,489186,490886,1700,10,N,N,-,-1,-1
MUSING.txt,489441,491065,1624,10,N,N,-,-1,-1
MUSING.txt,489551,491445,1894,10,N,N,-,-1,-1
MUSING.txt,489808,491463,1655,10,N,N,-,-1,-1
MUSING.txt,490030,491570,1540,10,N,N,-,-1,-1
MUSING.txt,490304,491630,1326,10,N,N,-,-1,-1
MUSING.txt,490415,491681,1266,10,N,N,-,-1,-1
MUSING.txt,490526,491795,1269,10,N,N,-,-1,-1
MUSING.txt,490692,491902,1210,10,N,N,-,-1,-1
MUSING.txt,490723,491934,1211,10,N,N,-,-1,-1
MUSING.txt,490888,492055,1167,10,N,N,-,-1,-1
MUSING.txt,491067,492296,1229,10,N,N,-,-1,-1
MUSING.txt,491446,492992,1546,10,N,N,-,-1,-1
MUSING.txt,491464,493370,1906,10,N,N,-,-1,-1
MUSING.txt,491572,493670,2098,10,N,N,-,-1,-1
MUSING.txt,491631,493944,2313,10,N,N,-,-1,-1
MUSING.txt,491682,494024,2342,10,N,N,-,-1,-1
MUSING.txt,491796,494257,2461,10,N,N,-,-1,-1
MUSING.txt,491905,494368,2463,10,N,N,-,-1,-1
MUSING.txt,491935,494678,2743,10,N,N,-,-1,-1
MUSING.txt,492056,495032,2976,10,N,N,-,-1,-1
MUSING.txt,492297,495270,2973,10,N,N,-,-1,-1
MUSING.txt,492993,495679,2686,10,N,N,-,-1,-1
MUSING.txt,493371,495727,2356,10,N,N,-,-1,-1
MUSING.txt,493671,495882,2211,10,N,N,-,-1,-1
MUSING.txt,493947,495994,2047,10,N,N,-,-1,-1
MUSING.txt,494025,496228,2203,10,N,N,-,-1,-1
MUSING.txt,494258,496548,2290,10,N,N,-,-1,-1
MUSING.txt,494370,496638,2268,10,N,N,-,-1,-1
MUSING.txt,494679,496856,2177,10,N,N,-,-1,-1
MUSING.txt,495033,496931,1898,10,N,N,-,-1,-1
MUSING.txt,495271,497071,1800,10,N,N,-,-1,-1
MUSING.txt,495682,497456,1774,10,N,N,-,-1,-1
MUSING.txt,495728,497508,1780,10,N,N,-,-1,-1
MUSING.txt,495883,497724,1841,10,N,N,-,-1,-1
MUSING.txt,495995,497827,1832,10,N,N,-,-1,-1
MUSING.txt,496229,498089,1860,10,N,N,-,-1,-1
MUSING.txt,496549,498281,1732,10,N,N,-,-1,-1
MUSING.txt,496639,498572,1933,10,N,N,-,-1,-1
MUSING.txt,496858,498961,2103,10,N,N,-,-1,-1
MUSING.txt,496934,499338,2404,10,N,N,-,-1,-1
MUSING.txt,497072,499554,2482,10,N,N,-,-1,-1
MUSING.txt,497459,499579,2120,10,N,N,-,-1,-1
MUSING.txt,497509,499783,2274,10,N,N,-,-1,-1
MUSING.txt,497725,499829,2104,10,N,N,-,-1,-1
MUSING.txt,497828,500093,2265,10,Y,N,-,-1,-1
MUSING.txt,498090,500337,2247,10,Y,N,-,-1,-1
MUSING.txt,498282,500462,2180,10,Y,N,-,-1,-1
MUSING.txt,498573,500676,2103,10,Y,N,-,-1,-1
MUSING.txt,498966,500784,1818,10,N,N,-,-1,-1
MUSING.txt,499339,500910,1571,10,N,N,-,-1,-1
MUSING.txt,499555,500957,1402,10,N,N,-,-1,-1
MUSING.txt,499581,500970,1389,10,N,N,-,-1,-1
MUSING.txt,499786,500995,1209,10,N,N,-,-1,-1
MUSING.txt,499831,501240,1409,10,N,N,-,-1,-1
MUSING.txt,500094,501482,1388,10,N,N,-,-1,-1
MUSING.txt,500338,501710,1372,10,N,N,-,-1,-1
MUSING.txt,500463,501863,1400,10,N,N,-,-1,-1
MUSING.txt,500678,502056,1378,10,N,N,-,-1,-1
MUSING.txt,500785,502395,1610,10,N,N,-,-1,-1
MUSING.txt,500911,502457,1546,10,N,N,-,-1,-1
MUSING.txt,500958,502783,1825,10,N,N,-,-1,-1
MUSING.txt,500971,503001,2030,10,N,N,-,-1,-1
MUSING.txt,500996,503201,2205,10,N,N,-,-1,-1
MUSING.txt,501241,503245,2004,10,N,N,-,-1,-1
MUSING.txt,501483,503637,2154,10,N,N,-,-1,-1
MUSING.txt,501711,503811,2100,10,N,N,-,-1,-1
MUSING.txt,501864,503995,2131,10,N,N,-,-1,-1
MUSING.txt,502059,504128,2069,10,N,N,-,-1,-1
MUSING.txt,502397,504174,1777,10,N,N,-,-1,-1
MUSING.txt,502458,504330,1872,10,N,N,-,-1,-1
MUSING.txt,502784,504544,1760,10,N,N,-,-1,-1
MUSING.txt,503006,504698,1692,10,N,N,-,-1,-1
MUSING.txt,503202,504861,1659,10,N,N,-,-1,-1
MUSING.txt,503246,504954,1708,10,N,N,-,-1,-1
MUSING.txt,503638,505180,1542,10,N,N,-,-1,-1
MUSING.txt,503812,505515,1703,10,N,N,-,-1,-1
MUSING.txt,503996,505844,1848,10,N,N,-,-1,-1
MUSING.txt,504129,506091,1962,10,N,N,-,-1,-1
MUSING.txt,504175,506216,2041,10,N,N,-,-1,-1
MUSING.txt,504332,506453,2121,10,N,N,-,-1,-1
MUSING.txt,504545,506641,2096,10,N,N,-,-1,-1
MUSING.txt,504699,506748,2049,10,N,N,-,-1,-1
MUSING.txt,504862,507025,2163,10,N,N,-,-1,-1
MUSING.txt,504955,507763,2808,10,N,N,-,-1,-1
MUSING.txt,505181,508225,3044,10,Y,N,-,-1,-1
MUSING.txt,505517,508596,3079,10,Y,N,-,-1,-1
MUSING.txt,505845,508804,2959,10,N,N,-,-1,-1
MUSING.txt,506092,508856,2764,10,N,N,-,-1,-1
MUSING.txt,506221,508941,2720,10,Y,N,-,-1,-1
MUSING.txt,506454,509084,2630,10,Y,N,-,-1,-1
MUSING.txt,506644,509239,2595,10,N,N,-,-1,-1
MUSING.txt,506749,509250,2501,10,N,N,-,-1,-1
MUSING.txt,507030,509296,2266,10,N,N,-,-1,-1
MUSING.txt,507766,509525,1759,10,N,N,-,-1,-1
MUSING.txt,508228,509902,1674,10,N,N,-,-1,-1
MUSING.txt,508597,510225,1628,10,N,N,-,-1,-1
MUSING.txt,508805,510343,1538,10,N,N,-,-1,-1
MUSING.txt,508857,510457,1600,10,N,N,-,-1,-1
MUSING.txt,508942,510528,1586,10,N,N,-,-1,-1
MUSING.txt,509085,510635,1550,10,N,N,-,-1,-1
MUSING.txt,509240,511242,2002,10,N,N,-,-1,-1
MUSING.txt,509251,515547,6296,10,N,N,-,-1,-1
MUSING.txt,509299,516097,6798,10,N,N,-,-1,-1
MUSING.txt,509526,516268,6742,10,N,N,-,-1,-1
MUSREM.txt,8,503,495,10,N,N,-,-1,-1
MUSREM.txt,27,551,524,10,N,N,-,-1,-1
MUSREM.txt,49,688,639,10,N,N,-,-1,-1
MUSREM.txt,98,700,602,10,N,N,-,-1,-1
MUSREM.txt,200,868,668,10,N,N,-,-1,-1
MUSREM.txt,321,870,549,10,N,N,-,-1,-1
MUSREM.txt,358,888,530,10,N,N,-,-1,-1
MUSREM.txt,439,900,461,10,N,N,-,-1,-1
MUSREM.txt,449,1081,632,10,N,N,-,-1,-1
MUSREM.txt,494,1095,601,10,N,N,-,-1,-1
MUSREM.txt,506,1107,601,10,N,N,-,-1,-1
MUSREM.txt,554,1481,927,10,N,N,-,-1,-1
MUSREM.txt,691,1590,899,10,N,N,-,-1,-1
MUSREM.txt,703,1602,899,10,N,N,-,-1,-1
MUSREM.txt,869,1612,743,10,N,N,-,-1,-1
MUSREM.txt,871,1648,777,10,N,N,-,-1,-1
MUSREM.txt,891,1791,900,10,N,N,-,-1,-1
MUSREM.txt,903,1803,900,10,N,N,-,-1,-1
MUSREM.txt,1084,1949,865,10,N,N,-,-1,-1
MUSREM.txt,1098,1969,871,10,N,N,-,-1,-1
MUSREM.txt,1110,2089,979,10,N,N,-,-1,-1
MUSREM.txt,1484,2101,617,10,N,N,-,-1,-1
MUSREM.txt,1593,2120,527,10,N,N,-,-1,-1
MUSREM.txt,1605,2214,609,10,N,N,-,-1,-1
MUSREM.txt,1613,2336,723,10,N,N,-,-1,-1
MUSREM.txt,1649,2361,712,10,N,N,-,-1,-1
MUSREM.txt,1794,2436,642,10,N,N,-,-1,-1
MUSREM.txt,1806,2764,958,10,N,N,-,-1,-1
MUSREM.txt,1950,3135,1185,10,N,N,-,-1,-1
MUSREM.txt,1972,3189,1217,10,N,N,-,-1,-1
MUSREM.txt,2092,3533,1441,10,N,N,-,-1,-1
MUSREM.txt,2104,3689,1585,10,N,N,-,-1,-1
MUSREM.txt,2121,3958,1837,10,N,N,-,-1,-1
MUSREM.txt,2217,4108,1891,10,N,N,-,-1,-1
MUSREM.txt,2337,4433,2096,10,Y,N,-,-1,-1
MUSREM.txt,2364,5022,2658,10,Y,N,-,-1,-1
MUSREM.txt,2441,5115,2674,10,Y,N,-,-1,-1
MUSREM.txt,2766,5137,2371,10,N,N,-,-1,-1
MUSREM.txt,3138,5508,2370,10,N,N,-,-1,-1
MUSREM.txt,3190,5707,2517,10,N,N,-,-1,-1
MUSREM.txt,3534,6163,2629,10,Y,N,-,-1,-1
MUSREM.txt,3690,6192,2502,10,Y,N,-,-1,-1
MUSREM.txt,3960,6358,2398,10,N,N,-,-1,-1
MUSREM.txt,4109,6574,2465,10,Y,N,-,-1,-1
MUSREM.txt,4434,6711,2277,10,N,N,-,-1,-1
MUSREM.txt,5023,7149,2126,10,N,N,-,-1,-1
MUSREM.txt,5120,7200,2080,10,N,N,-,-1,-1
MUSREM.txt,5140,7500,2360,10,N,N,-,-1,-1
MUSREM.txt,5509,7629,2120,10,N,N,-,-1,-1
MUSREM.txt,5708,7878,2170,10,Y,N,-,-1,-1
MUSREM.txt,6164,8068,1904,10,N,N,-,-1,-1
MUSREM.txt,6193,8086,1893,10,N,N,-,-1,-1
MUSREM.txt,6359,8516,2157,10,N,N,-,-1,-1
MUSREM.txt,6575,8821,2246,10,N,N,-,-1,-1
MUSREM.txt,6713,8940,2227,10,N,N,-,-1,-1
MUSREM.txt,7152,9028,1876,10,N,N,-,-1,-1
MUSREM.txt,7201,9091,1890,10,N,N,-,-1,-1
MUSREM.txt,7503,9549,2046,10,N,N,-,-1,-1
MUSREM.txt,7630,9577,1947,10,N,N,-,-1,-1
MUSREM.txt,7879,9602,1723,10,N,N,-,-1,-1
MUSREM.txt,8073,9736,1663,10,N,N,-,-1,-1
MUSREM.txt,8087,9898,1811,10,N,N,-,-1,-1
MUSREM.txt,8519,10197,1678,10,N,N,-,-1,-1
MUSREM.txt,8822,10267,1445,10,N,N,-,-1,-1
MUSREM.txt,8941,10281,1340,10,N,N,-,-1,-1
MUSREM.txt,9031,10488,1457,10,N,Y,1448037533268,13930,15031
MUSREM.txt,9092,10621,1529,10,N,Y,1448037533268,13930,15031
MUSREM.txt,9554,10720,1166,10,N,Y,1448037533268,13930,15031
MUSREM.txt,9580,10857,1277,10,N,Y,1448037533268,13930,15031
MUSREM.txt,9605,10953,1348,10,Y,Y,1448037533268,13930,15031
MUSREM.txt,9739,11056,1317,10,Y,Y,1448037533268,13930,15031
MUSREM.txt,9898,11171,1273,10,Y,Y,1448037533268,13930,15031
MUSREM.txt,10198,11271,1073,10,N,Y,1448037533268,13930,15031
MUSREM.txt,10273,11424,1151,10,Y,Y,1448037533268,13930,15031
MUSREM.txt,10284,11548,1264,10,Y,Y,1448037533268,13930,15031
MUSREM.txt,10489,11638,1149,10,Y,Y,1448037533268,13930,15031
MUSREM.txt,10622,11721,1099,10,Y,Y,1448037533268,13930,15031
MUSREM.txt,10721,11868,1147,10,Y,Y,1448037533268,13930,15031
MUSREM.txt,10858,12005,1147,10,Y,Y,1448037533268,13930,15031
MUSREM.txt,10954,12120,1166,10,Y,Y,1448037533268,13930,15031
MUSREM.txt,11057,12228,1171,10,Y,Y,1448274783410,21836,25159
MUSREM.txt,11174,12288,1114,10,N,Y,1448274783410,21836,25159
MUSREM.txt,11272,12463,1191,10,Y,Y,1448274783410,21836,25159
MUSREM.txt,11425,12651,1226,10,Y,Y,1448274783410,21836,25159
MUSREM.txt,11550,12880,1330,10,N,Y,1448274783410,21836,25159
MUSREM.txt,11640,13107,1467,10,N,N,-,-1,-1
MUSREM.txt,11722,13345,1623,10,N,N,-,-1,-1
MUSREM.txt,11869,13435,1566,10,N,N,-,-1,-1
MUSREM.txt,12006,13850,1844,10,Y,N,-,-1,-1
MUSREM.txt,12121,13993,1872,10,Y,N,-,-1,-1
MUSREM.txt,12231,14146,1915,10,Y,N,-,-1,-1
MUSREM.txt,12291,14399,2108,10,Y,N,-,-1,-1
MUSREM.txt,12464,14412,1948,10,Y,N,-,-1,-1
MUSREM.txt,12653,14638,1985,10,Y,N,-,-1,-1
MUSREM.txt,12882,14714,1832,10,Y,N,-,-1,-1
MUSREM.txt,13109,14801,1692,10,Y,N,-,-1,-1
MUSREM.txt,13346,14904,1558,10,N,N,-,-1,-1
MUSREM.txt,13438,15254,1816,10,Y,N,-,-1,-1
MUSREM.txt,13851,15368,1517,10,Y,N,-,-1,-1
MUSREM.txt,13994,15379,1385,10,Y,N,-,-1,-1
MUSREM.txt,14147,15790,1643,10,Y,Y,1437476486340,221621,222520
MUSREM.txt,14402,15935,1533,10,Y,Y,1437476486340,221621,222520
MUSREM.txt,14413,16021,1608,10,Y,Y,1437476486340,221621,222520
MUSREM.txt,14639,16115,1476,10,Y,Y,1437476486340,221621,222520
MUSREM.txt,14716,16225,1509,10,Y,Y,1437476486340,221621,222520
MUSREM.txt,14803,16386,1583,10,Y,Y,1437476486340,221621,222520
MUSREM.txt,14904,16465,1561,10,Y,Y,1437476486340,221621,222520
MUSREM.txt,15257,16569,1312,10,N,Y,1437476486340,221621,222520
MUSREM.txt,15373,16709,1336,10,Y,Y,1437476486340,221621,222520
MUSREM.txt,15380,16813,1433,10,Y,Y,1437476486340,221621,222520
MUSREM.txt,15793,17145,1352,10,Y,Y,1448322397200,219547,220107
MUSREM.txt,15936,17435,1499,10,Y,Y,1448322397200,219547,220107
MUSREM.txt,16022,17465,1443,10,Y,Y,1448322397200,219547,220107
MUSREM.txt,16116,17490,1374,10,Y,Y,1448322397200,219547,220107
MUSREM.txt,16226,17524,1298,10,Y,Y,1448322397200,219547,220107
MUSREM.txt,16389,17634,1245,10,Y,Y,1448322397200,219547,220107
MUSREM.txt,16466,17818,1352,10,Y,Y,1448322397200,219547,220107
MUSREM.txt,16571,18097,1526,10,Y,Y,1448315360596,182069,182233
MUSREM.txt,16711,18134,1423,10,Y,Y,1448315360596,182069,182233
MUSREM.txt,16814,18212,1398,10,Y,Y,1448315360596,182069,182233
MUSREM.txt,17146,18365,1219,10,N,Y,1448315360596,182069,182233
MUSREM.txt,17438,18439,1001,10,N,Y,1448315360596,182069,182233
MUSREM.txt,17466,18521,1055,10,N,Y,1448315360596,182069,182233
MUSREM.txt,17493,18905,1412,10,Y,Y,1448315360596,182069,182233
MUSREM.txt,17525,19082,1557,10,Y,Y,1448315360596,182069,182233
MUSREM.txt,17635,19206,1571,10,Y,Y,1448315360596,182069,182233
MUSREM.txt,17819,19367,1548,10,Y,Y,1448315360596,182069,182233
MUSREM.txt,18098,19490,1392,10,Y,Y,1448315360596,182069,182233
MUSREM.txt,18135,19629,1494,10,Y,Y,1448315360596,182069,182233
MUSREM.txt,18213,19766,1553,10,Y,Y,1448315360596,182069,182233
MUSREM.txt,18366,19915,1549,10,Y,Y,1448315360596,182069,182233
MUSREM.txt,18442,19937,1495,10,Y,Y,1448315360596,182069,182233
MUSREM.txt,18522,19951,1429,10,Y,Y,1448315360596,182069,182233
MUSREM.txt,18906,19963,1057,10,N,N,-,-1,-1
MUSREM.txt,19084,20143,1059,10,N,N,-,-1,-1
MUSREM.txt,19207,20450,1243,10,Y,N,-,-1,-1
MUSREM.txt,19368,20497,1129,10,Y,N,-,-1,-1
MUSREM.txt,19491,20741,1250,10,Y,Y,1448394436678,290724,292129
MUSREM.txt,19631,20962,1331,10,N,Y,1448394436678,290724,292129
MUSREM.txt,19769,21357,1588,10,Y,Y,1448394436678,290724,292129
MUSREM.txt,19920,21455,1535,10,Y,Y,1448394436678,290724,292129
MUSREM.txt,19940,21616,1676,10,Y,Y,1448394436678,290724,292129
MUSREM.txt,19954,21816,1862,10,Y,Y,1448394436678,290724,292129
MUSREM.txt,19966,22086,2120,10,Y,Y,1448394436678,290724,292129
MUSREM.txt,20146,22346,2200,10,Y,Y,1448394436678,290724,292129
MUSREM.txt,20452,22545,2093,10,Y,Y,1448394436678,290724,292129
MUSREM.txt,20500,22801,2301,10,Y,Y,1448394436678,290724,292129
MUSREM.txt,20742,22869,2127,10,Y,Y,1448394436678,290724,292129
MUSREM.txt,20963,22887,1924,10,Y,N,-,-1,-1
MUSREM.txt,21358,23035,1677,10,Y,Y,1437471397525,350644,351290
MUSREM.txt,21456,23214,1758,10,Y,Y,1437471397525,350644,351290
MUSREM.txt,21618,23398,1780,10,Y,Y,1437471397525,350644,351290
MUSREM.txt,21819,23519,1700,10,Y,Y,1437471397525,350644,351290
MUSREM.txt,22086,23769,1683,10,Y,Y,1437471397525,350644,351290
MUSREM.txt,22347,23954,1607,10,Y,Y,1437471397525,350644,351290
MUSREM.txt,22546,24101,1555,10,Y,Y,1437471397525,350644,351290
MUSREM.txt,22802,24203,1401,10,Y,Y,1437471397525,350644,351290
MUSREM.txt,22874,24480,1606,10,Y,Y,1437471397525,350644,351290
MUSREM.txt,22888,24733,1845,10,Y,Y,1437471397525,350644,351290
MUSREM.txt,23036,24844,1808,10,Y,Y,1437471397525,350644,351290
MUSREM.txt,23215,24958,1743,10,Y,Y,1437471397525,350644,351290
MUSREM.txt,23399,24983,1584,10,Y,Y,1448287306770,114686,120152
MUSREM.txt,23520,25211,1691,10,Y,Y,1448287306770,114686,120152
MUSREM.txt,23770,25295,1525,10,Y,Y,1448287306770,114686,120152
MUSREM.txt,23957,25516,1559,10,Y,Y,1448287306770,114686,120152
MUSREM.txt,24102,26010,1908,10,Y,Y,1448287306770,114686,120152
MUSREM.txt,24206,26018,1812,10,Y,Y,1448287306770,114686,120152
MUSREM.txt,24483,26121,1638,10,Y,Y,1448287306770,114686,120152
MUSREM.txt,24734,26238,1504,10,Y,Y,1448287306770,114686,120152
MUSREM.txt,24846,26417,1571,10,Y,Y,1448359608080,265546,265784
MUSREM.txt,24959,26583,1624,10,Y,Y,1448359608080,265546,265784
MUSREM.txt,24984,26788,1804,10,Y,Y,1448359608080,265546,265784
MUSREM.txt,25212,26829,1617,10,Y,Y,1448359608080,265546,265784
MUSREM.txt,25296,26912,1616,10,Y,Y,1448359608080,265546,265784
MUSREM.txt,25519,27023,1504,10,Y,Y,1448359608080,265546,265784
MUSREM.txt,26013,27256,1243,10,Y,Y,1448359608080,265546,265784
MUSREM.txt,26019,27324,1305,10,Y,Y,1448359608080,265546,265784
MUSREM.txt,26122,27506,1384,10,Y,Y,1448359608080,265546,265784
MUSREM.txt,26240,27580,1340,10,Y,Y,1448359608080,265546,265784
MUSREM.txt,26418,27741,1323,10,N,N,-,-1,-1
MUSREM.txt,26584,27907,1323,10,N,N,-,-1,-1
MUSREM.txt,26789,28039,1250,10,N,Y,1436867017136,105674,106651
MUSREM.txt,26832,28063,1231,10,N,Y,1436867017136,105674,106651
MUSREM.txt,26913,28417,1504,10,Y,Y,1436867017136,105674,106651
MUSREM.txt,27024,28660,1636,10,Y,Y,1436867017136,105674,106651
MUSREM.txt,27259,28823,1564,10,Y,Y,1436867017136,105674,106651
MUSREM.txt,27325,28980,1655,10,Y,Y,1436867017136,105674,106651
MUSREM.txt,27507,29076,1569,10,Y,Y,1436867017136,105674,106651
MUSREM.txt,27581,29106,1525,10,Y,Y,1436867017136,105674,106651
MUSREM.txt,27742,29423,1681,10,Y,Y,1436867017136,105674,106651
MUSREM.txt,27908,29590,1682,10,Y,Y,1436867017136,105674,106651
MUSREM.txt,28042,29647,1605,10,Y,Y,1436867017136,105674,106651
MUSREM.txt,28064,29674,1610,10,Y,Y,1436867017136,105674,106651
MUSREM.txt,28418,29867,1449,10,Y,Y,1448394918930,293978,294297
MUSREM.txt,28661,29923,1262,10,Y,Y,1448394918930,293978,294297
MUSREM.txt,28825,30062,1237,10,N,N,-,-1,-1
MUSREM.txt,28981,30145,1164,10,N,N,-,-1,-1
MUSREM.txt,29077,30166,1089,10,N,N,-,-1,-1
MUSREM.txt,29107,30232,1125,10,N,N,-,-1,-1
MUSREM.txt,29425,30542,1117,10,N,N,-,-1,-1
MUSREM.txt,29591,30673,1082,10,N,N,-,-1,-1
MUSREM.txt,29647,30828,1181,10,N,N,-,-1,-1
MUSREM.txt,29675,31037,1362,10,N,N,-,-1,-1
MUSREM.txt,29868,31185,1317,10,N,N,-,-1,-1
MUSREM.txt,29925,31249,1324,10,N,N,-,-1,-1
MUSREM.txt,30063,31484,1421,10,N,Y,1448039533036,21326,21680
MUSREM.txt,30150,31873,1723,10,N,Y,1448039533036,21326,21680
MUSREM.txt,30169,32098,1929,10,Y,Y,1448039533036,21326,21680
MUSREM.txt,30235,32206,1971,10,Y,Y,1448039533036,21326,21680
MUSREM.txt,30545,32223,1678,10,Y,Y,1448039533036,21326,21680
MUSREM.txt,30674,32267,1593,10,Y,Y,1448039533036,21326,21680
MUSREM.txt,30829,32582,1753,10,Y,Y,1448039533036,21326,21680
MUSREM.txt,31039,32857,1818,10,Y,Y,1448039533036,21326,21680
MUSREM.txt,31185,33194,2009,10,Y,Y,1448039533036,21326,21680
MUSREM.txt,31252,33240,1988,10,Y,Y,1448039533036,21326,21680
MUSREM.txt,31484,33310,1826,10,Y,Y,1448039533036,21326,21680
MUSREM.txt,31874,33546,1672,10,Y,N,-,-1,-1
MUSREM.txt,32099,33631,1532,10,Y,N,-,-1,-1
MUSREM.txt,32211,33687,1476,10,Y,N,-,-1,-1
MUSREM.txt,32226,33782,1556,10,Y,N,-,-1,-1
MUSREM.txt,32268,34012,1744,10,Y,N,-,-1,-1
MUSREM.txt,32585,34080,1495,10,Y,N,-,-1,-1
MUSREM.txt,32860,34288,1428,10,Y,N,-,-1,-1
MUSREM.txt,33195,34299,1104,10,Y,N,-,-1,-1
MUSREM.txt,33241,34434,1193,10,Y,N,-,-1,-1
MUSREM.txt,33311,34630,1319,10,N,N,-,-1,-1
MUSREM.txt,33547,34798,1251,10,N,N,-,-1,-1
MUSREM.txt,33632,34847,1215,10,N,N,-,-1,-1
MUSREM.txt,33688,35082,1394,10,N,N,-,-1,-1
MUSREM.txt,33785,35253,1468,10,Y,N,-,-1,-1
MUSREM.txt,34014,35318,1304,10,Y,Y,1448279941918,72406,72905
MUSREM.txt,34083,35567,1484,10,Y,Y,1448279941918,72406,72905
MUSREM.txt,34291,35820,1529,10,Y,Y,1448279941918,72406,72905
MUSREM.txt,34299,36037,1738,10,Y,Y,1448279941918,72406,72905
MUSREM.txt,34435,36090,1655,10,Y,Y,1448279941918,72406,72905
MUSREM.txt,34633,36248,1615,10,Y,Y,1448279941918,72406,72905
MUSREM.txt,34799,36335,1536,10,Y,Y,1448279941918,72406,72905
MUSREM.txt,34848,36401,1553,10,Y,Y,1448279941918,72406,72905
MUSREM.txt,35085,36560,1475,10,Y,Y,1448279941918,72406,72905
MUSREM.txt,35254,36578,1324,10,Y,Y,1448279941918,72406,72905
MUSREM.txt,35319,36598,1279,10,N,Y,1448279941918,72406,72905
MUSREM.txt,35568,36610,1042,10,N,N,-,-1,-1
MUSREM.txt,35821,36772,951,10,N,N,-,-1,-1
MUSREM.txt,36038,37124,1086,10,N,Y,1448369133400,279084,280004
MUSREM.txt,36093,37330,1237,10,Y,Y,1448369133400,279084,280004
MUSREM.txt,36249,37398,1149,10,N,Y,1448369133400,279084,280004
MUSREM.txt,36338,37595,1257,10,N,Y,1437471855423,351318,351853
MUSREM.txt,36404,37751,1347,10,N,Y,1437471855423,351318,351853
MUSREM.txt,36565,37900,1335,10,N,Y,1437471855423,351318,351853
MUSREM.txt,36579,38010,1431,10,N,Y,1437471855423,351318,351853
MUSREM.txt,36601,38154,1553,10,N,Y,1437471855423,351318,351853
MUSREM.txt,36613,38201,1588,10,N,Y,1437471855423,351318,351853
MUSREM.txt,36775,38342,1567,10,N,Y,1437471855423,351318,351853
MUSREM.txt,37125,38604,1479,10,N,Y,1437471855423,351318,351853
MUSREM.txt,37333,38878,1545,10,Y,Y,1437471855423,351318,351853
MUSREM.txt,37401,39060,1659,10,Y,Y,1437471855423,351318,351853
MUSREM.txt,37596,39233,1637,10,Y,Y,1448314503640,180207,180355
MUSREM.txt,37754,39388,1634,10,Y,Y,1448314503640,180207,180355
MUSREM.txt,37901,39398,1497,10,Y,Y,1448314503640,180207,180355
MUSREM.txt,38011,39468,1457,10,Y,Y,1448314503640,180207,180355
MUSREM.txt,38155,39850,1695,10,Y,Y,1448314503640,180207,180355
MUSREM.txt,38204,39946,1742,10,Y,Y,1448314503640,180207,180355
MUSREM.txt,38343,40023,1680,10,Y,Y,1448314503640,180207,180355
MUSREM.txt,38605,40395,1790,10,Y,Y,1448314503640,180207,180355
MUSREM.txt,38879,40406,1527,10,Y,Y,1448314503640,180207,180355
MUSREM.txt,39063,40604,1541,10,N,Y,1448314503640,180207,180355
MUSREM.txt,39234,40756,1522,10,Y,Y,1448314503640,180207,180355
MUSREM.txt,39389,40801,1412,10,Y,Y,1448313123004,175370,176057
MUSREM.txt,39401,41046,1645,10,Y,Y,1448286451685,111065,112127
MUSREM.txt,39471,41164,1693,10,Y,Y,1448286451685,111065,112127
MUSREM.txt,39851,41297,1446,10,Y,Y,1448286451685,111065,112127
MUSREM.txt,39947,41458,1511,10,Y,Y,1448286451685,111065,112127
MUSREM.txt,40024,41653,1629,10,Y,Y,1448286451685,111065,112127
MUSREM.txt,40400,41822,1422,10,Y,Y,1448286451685,111065,112127
MUSREM.txt,40407,42032,1625,10,Y,Y,1448286451685,111065,112127
MUSREM.txt,40605,42232,1627,10,Y,Y,1448286451685,111065,112127
MUSREM.txt,40757,42467,1710,10,Y,Y,1448286451685,111065,112127
MUSREM.txt,40804,42584,1780,10,Y,Y,1448286451685,111065,112127
MUSREM.txt,41047,42738,1691,10,Y,Y,1448286451685,111065,112127
MUSREM.txt,41165,42883,1718,10,Y,Y,1448286451685,111065,112127
MUSREM.txt,41298,43021,1723,10,Y,Y,1448286451685,111065,112127
MUSREM.txt,41461,43156,1695,10,Y,Y,1448286451685,111065,112127
MUSREM.txt,41654,43523,1869,10,Y,Y,1448359440819,262798,263079
MUSREM.txt,41823,43548,1725,10,Y,Y,1448359440819,262798,263079
MUSREM.txt,42035,43604,1569,10,Y,Y,1448359440819,262798,263079
MUSREM.txt,42235,43747,1512,10,Y,Y,1448366107348,271942,274308
MUSREM.txt,42468,43861,1393,10,N,Y,1448366107348,271942,274308
MUSREM.txt,42585,43892,1307,10,Y,Y,1448366107348,271942,274308
MUSREM.txt,42740,43988,1248,10,Y,Y,1448366107348,271942,274308
MUSREM.txt,42884,44158,1274,10,N,Y,1448366107348,271942,274308
MUSREM.txt,43022,44281,1259,10,N,Y,1448366107348,271942,274308
MUSREM.txt,43157,44418,1261,10,N,Y,1448366107348,271942,274308
MUSREM.txt,43526,44441,915,10,N,Y,1448366107348,271942,274308
MUSREM.txt,43549,44557,1008,10,N,Y,1448366107348,271942,274308
MUSREM.txt,43607,44667,1060,10,N,Y,1448366107348,271942,274308
MUSREM.txt,43748,44709,961,10,N,Y,1448366107348,271942,274308
MUSREM.txt,43862,44982,1120,10,N,Y,1448369361055,281280,281814
MUSREM.txt,43893,45135,1242,10,N,Y,1448369361055,281280,281814
MUSREM.txt,43989,45177,1188,10,N,Y,1448369361055,281280,281814
MUSREM.txt,44159,45233,1074,10,N,Y,1448369361055,281280,281814
MUSREM.txt,44282,45491,1209,10,Y,Y,1448038803075,18895,19670
MUSREM.txt,44420,45549,1129,10,N,Y,1448038803075,18895,19670
MUSREM.txt,44442,45682,1240,10,N,Y,1448038803075,18895,19670
MUSREM.txt,44558,45801,1243,10,N,Y,1448038803075,18895,19670
MUSREM.txt,44668,46031,1363,10,N,Y,1448038803075,18895,19670
MUSREM.txt,44712,46122,1410,10,N,Y,1448038803075,18895,19670
MUSREM.txt,44984,46252,1268,10,N,Y,1448038803075,18895,19670
MUSREM.txt,45136,46447,1311,10,N,Y,1448038803075,18895,19670
MUSREM.txt,45178,46590,1412,10,N,Y,1448038803075,18895,19670
MUSREM.txt,45236,46802,1566,10,Y,Y,1448038803075,18895,19670
MUSREM.txt,45494,47146,1652,10,Y,Y,1448314706721,180385,181191
MUSREM.txt,45552,47194,1642,10,Y,Y,1448314706721,180385,181191
MUSREM.txt,45685,47526,1841,10,Y,Y,1448314706721,180385,181191
MUSREM.txt,45802,47591,1789,10,Y,Y,1448314706721,180385,181191
MUSREM.txt,46032,47635,1603,10,Y,Y,1448314706721,180385,181191
MUSREM.txt,46123,47779,1656,10,Y,Y,1448314706721,180385,181191
MUSREM.txt,46253,47964,1711,10,Y,Y,1448314706721,180385,181191
MUSREM.txt,46448,48013,1565,10,Y,Y,1448314706721,180385,181191
MUSREM.txt,46591,48252,1661,10,Y,Y,1448314706721,180385,181191
MUSREM.txt,46805,48497,1692,10,Y,Y,1448279620157,70041,71486
MUSREM.txt,47147,48584,1437,10,Y,Y,1448279620157,70041,71486
MUSREM.txt,47195,48652,1457,10,Y,Y,1448279620157,70041,71486
MUSREM.txt,47527,48713,1186,10,Y,Y,1448279620157,70041,71486
MUSREM.txt,47592,48914,1322,10,Y,Y,1448279620157,70041,71486
MUSREM.txt,47638,49327,1689,10,Y,Y,1448279620157,70041,71486
MUSREM.txt,47780,49370,1590,10,Y,Y,1448279620157,70041,71486
MUSREM.txt,47965,49483,1518,10,Y,Y,1448279620157,70041,71486
MUSREM.txt,48014,49670,1656,10,Y,Y,1448279620157,70041,71486
MUSREM.txt,48255,49698,1443,10,Y,Y,1448279620157,70041,71486
MUSREM.txt,48498,49931,1433,10,Y,Y,1448279620157,70041,71486
MUSREM.txt,48585,50111,1526,10,Y,Y,1448311594480,155711,156312
MUSREM.txt,48657,50284,1627,10,Y,Y,1448311594480,155711,156312
MUSREM.txt,48716,50676,1960,10,Y,Y,1448315012079,181380,182053
MUSREM.txt,48915,50722,1807,10,Y,Y,1448315012079,181380,182053
MUSREM.txt,49328,50784,1456,10,Y,Y,1448315012079,181380,182053
MUSREM.txt,49371,50901,1530,10,Y,Y,1448315012079,181380,182053
MUSREM.txt,49484,51069,1585,10,Y,Y,1448277167610,40886,47737
MUSREM.txt,49673,51305,1632,10,Y,Y,1448277167610,40886,47737
MUSREM.txt,49699,51345,1646,10,Y,Y,1448277167610,40886,47737
MUSREM.txt,49934,51503,1569,10,Y,Y,1448277167610,40886,47737
MUSREM.txt,50114,51673,1559,10,Y,Y,1448277167610,40886,47737
MUSREM.txt,50285,51762,1477,10,Y,Y,1448277167610,40886,47737
MUSREM.txt,50677,51923,1246,10,Y,Y,1448277167610,40886,47737
MUSREM.txt,50723,52104,1381,10,N,Y,1448277167610,40886,47737
MUSREM.txt,50785,52127,1342,10,N,Y,1448277167610,40886,47737
MUSREM.txt,50904,52421,1517,10,Y,Y,1448277167610,40886,47737
MUSREM.txt,51070,52606,1536,10,Y,Y,1448277167610,40886,47737
MUSREM.txt,51307,52774,1467,10,N,N,-,-1,-1
MUSREM.txt,51348,52797,1449,10,N,N,-,-1,-1
MUSREM.txt,51504,53054,1550,10,N,N,-,-1,-1
MUSREM.txt,51674,53341,1667,10,N,N,-,-1,-1
MUSREM.txt,51765,53565,1800,10,Y,N,-,-1,-1
MUSREM.txt,51924,53837,1913,10,Y,N,-,-1,-1
MUSREM.txt,52105,53877,1772,10,Y,N,-,-1,-1
MUSREM.txt,52129,53974,1845,10,Y,N,-,-1,-1
MUSREM.txt,52421,54132,1711,10,Y,N,-,-1,-1
MUSREM.txt,52609,54323,1714,10,Y,N,-,-1,-1
MUSREM.txt,52779,54358,1579,10,Y,N,-,-1,-1
MUSREM.txt,52798,54602,1804,10,Y,N,-,-1,-1
MUSREM.txt,53055,54833,1778,10,Y,N,-,-1,-1
MUSREM.txt,53342,54948,1606,10,Y,N,-,-1,-1
MUSREM.txt,53565,55189,1624,10,Y,N,-,-1,-1
MUSREM.txt,53838,55332,1494,10,Y,N,-,-1,-1
MUSREM.txt,53882,55405,1523,10,Y,N,-,-1,-1
MUSREM.txt,53975,55608,1633,10,Y,N,-,-1,-1
MUSREM.txt,54135,55634,1499,10,Y,N,-,-1,-1
MUSREM.txt,54324,55972,1648,10,Y,N,-,-1,-1
MUSREM.txt,54361,56559,2198,10,Y,Y,1448274893770,25386,26202
MUSREM.txt,54603,56679,2076,10,Y,Y,1448274893770,25386,26202
MUSREM.txt,54836,56798,1962,10,Y,Y,1448274893770,25386,26202
MUSREM.txt,54949,56861,1912,10,Y,Y,1448274893770,25386,26202
MUSREM.txt,55190,57003,1813,10,Y,Y,1448274893770,25386,26202
MUSREM.txt,55333,57076,1743,10,Y,Y,1448274893770,25386,26202
MUSREM.txt,55406,57341,1935,10,Y,Y,1448274893770,25386,26202
MUSREM.txt,55609,57535,1926,10,Y,Y,1448274893770,25386,26202
MUSREM.txt,55636,57665,2029,10,Y,Y,1448274893770,25386,26202
MUSREM.txt,55973,57708,1735,10,Y,Y,1448274893770,25386,26202
MUSREM.txt,56560,58164,1604,10,Y,Y,1448274893770,25386,26202
MUSREM.txt,56680,58341,1661,10,Y,Y,1448274893770,25386,26202
MUSREM.txt,56799,58558,1759,10,Y,Y,1448274893770,25386,26202
MUSREM.txt,56862,58685,1823,10,Y,Y,1448274893770,25386,26202
MUSREM.txt,57005,58767,1762,10,Y,Y,1448274893770,25386,26202
MUSREM.txt,57077,58777,1700,10,Y,Y,1448274893770,25386,26202
MUSREM.txt,57342,58800,1458,10,Y,Y,1448274893770,25386,26202
MUSREM.txt,57537,58812,1275,10,Y,N,-,-1,-1
MUSREM.txt,57666,59162,1496,10,Y,N,-,-1,-1
MUSREM.txt,57709,59243,1534,10,Y,N,-,-1,-1
MUSREM.txt,58167,59564,1397,10,Y,N,-,-1,-1
MUSREM.txt,58341,59624,1283,10,N,N,-,-1,-1
MUSREM.txt,58560,59792,1232,10,Y,N,-,-1,-1
MUSREM.txt,58686,59904,1218,10,Y,N,-,-1,-1
MUSREM.txt,58772,60249,1477,10,Y,N,-,-1,-1
MUSREM.txt,58782,60370,1588,10,Y,Y,1448280297446,84055,84972
MUSREM.txt,58803,60801,1998,10,Y,Y,1448280297446,84055,84972
MUSREM.txt,58815,60875,2060,10,Y,Y,1448280297446,84055,84972
MUSREM.txt,59165,61039,1874,10,Y,Y,1448280297446,84055,84972
MUSREM.txt,59246,61198,1952,10,Y,Y,1448280297446,84055,84972
MUSREM.txt,59567,61405,1838,10,Y,Y,1448280297446,84055,84972
MUSREM.txt,59625,61524,1899,10,Y,Y,1448280297446,84055,84972
MUSREM.txt,59794,61678,1884,10,Y,Y,1448280297446,84055,84972
MUSREM.txt,59905,61696,1791,10,Y,Y,1448280297446,84055,84972
MUSREM.txt,60250,61821,1571,10,Y,Y,1448280297446,84055,84972
MUSREM.txt,60371,61941,1570,10,Y,Y,1448280297446,84055,84972
MUSREM.txt,60802,62087,1285,10,Y,Y,1448280297446,84055,84972
MUSREM.txt,60877,62282,1405,10,Y,Y,1448279089520,67624,69991
MUSREM.txt,61040,62373,1333,10,Y,Y,1448279089520,67624,69991
MUSREM.txt,61199,62478,1279,10,Y,Y,1448279089520,67624,69991
MUSREM.txt,61408,62716,1308,10,Y,Y,1448393386565,284140,284575
MUSREM.txt,61525,63088,1563,10,N,Y,1448393386565,284140,284575
MUSREM.txt,61683,63213,1530,10,Y,Y,1448357159811,231190,232925
MUSREM.txt,61699,63318,1619,10,Y,Y,1448357159811,231190,232925
MUSREM.txt,61824,63414,1590,10,Y,Y,1448357159811,231190,232925
MUSREM.txt,61942,63690,1748,10,N,Y,1448357159811,231190,232925
MUSREM.txt,62089,63751,1662,10,N,Y,1448357159811,231190,232925
MUSREM.txt,62283,63903,1620,10,N,Y,1448357159811,231190,232925
MUSREM.txt,62374,64012,1638,10,N,Y,1448357159811,231190,232925
MUSREM.txt,62481,64264,1783,10,Y,Y,1448357159811,231190,232925
MUSREM.txt,62717,64685,1968,10,Y,Y,1448357159811,231190,232925
MUSREM.txt,63089,64785,1696,10,Y,Y,1448357159811,231190,232925
MUSREM.txt,63215,64811,1596,10,Y,Y,1448357159811,231190,232925
MUSREM.txt,63319,64868,1549,10,Y,Y,1448357159811,231190,232925
MUSREM.txt,63415,65077,1662,10,Y,Y,1448358276684,234999,235995
MUSREM.txt,63693,65154,1461,10,Y,Y,1448358276684,234999,235995
MUSREM.txt,63754,65565,1811,10,Y,Y,1448358276684,234999,235995
MUSREM.txt,63904,65656,1752,10,Y,Y,1448358276684,234999,235995
MUSREM.txt,64013,65747,1734,10,Y,Y,1448358276684,234999,235995
MUSREM.txt,64265,65839,1574,10,Y,N,-,-1,-1
MUSREM.txt,64686,65860,1174,10,N,N,-,-1,-1
MUSREM.txt,64786,66063,1277,10,Y,N,-,-1,-1
MUSREM.txt,64812,66271,1459,10,Y,N,-,-1,-1
MUSREM.txt,64869,66473,1604,10,N,Y,1448395383674,294308,294925
MUSREM.txt,65078,66834,1756,10,N,Y,1448395383674,294308,294925
MUSREM.txt,65157,66897,1740,10,N,Y,1448395383674,294308,294925
MUSREM.txt,65567,66973,1406,10,N,Y,1448395383674,294308,294925
MUSREM.txt,65658,67584,1926,10,Y,Y,1448395383674,294308,294925
MUSREM.txt,65749,67756,2007,10,Y,Y,1448395383674,294308,294925
MUSREM.txt,65841,67881,2040,10,Y,Y,1448395383674,294308,294925
MUSREM.txt,65863,67952,2089,10,Y,Y,1448395383674,294308,294925
MUSREM.txt,66066,68006,1940,10,Y,Y,1448395383674,294308,294925
MUSREM.txt,66272,68311,2039,10,Y,Y,1448395383674,294308,294925
MUSREM.txt,66475,68492,2017,10,Y,Y,1448395383674,294308,294925
MUSREM.txt,66835,68676,1841,10,Y,N,-,-1,-1
MUSREM.txt,66898,68709,1811,10,Y,N,-,-1,-1
MUSREM.txt,66974,68811,1837,10,Y,N,-,-1,-1
MUSREM.txt,67585,68870,1285,10,Y,N,-,-1,-1
MUSREM.txt,67758,68992,1234,10,Y,N,-,-1,-1
MUSREM.txt,67882,69400,1518,10,N,N,-,-1,-1
MUSREM.txt,67955,69501,1546,10,Y,N,-,-1,-1
MUSREM.txt,68007,69648,1641,10,Y,Y,1448316411409,206556,208475
MUSREM.txt,68314,69785,1471,10,N,Y,1448316411409,206556,208475
MUSREM.txt,68493,70046,1553,10,N,Y,1448316411409,206556,208475
MUSREM.txt,68677,70097,1420,10,N,Y,1448316411409,206556,208475
MUSREM.txt,68711,70284,1573,10,Y,Y,1448316411409,206556,208475
MUSREM.txt,68812,70619,1807,10,Y,Y,1448316411409,206556,208475
MUSREM.txt,68870,70707,1837,10,Y,Y,1448316411409,206556,208475
MUSREM.txt,68993,70826,1833,10,Y,Y,1448316411409,206556,208475
MUSREM.txt,69402,70868,1466,10,N,Y,1448316411409,206556,208475
MUSREM.txt,69502,71079,1577,10,Y,Y,1448316411409,206556,208475
MUSREM.txt,69649,71117,1468,10,Y,Y,1448316411409,206556,208475
MUSREM.txt,69786,71193,1407,10,Y,Y,1448316411409,206556,208475
MUSREM.txt,70049,71343,1294,10,Y,Y,1448316411409,206556,208475
MUSREM.txt,70099,71690,1591,10,Y,Y,1448316411409,206556,208475
MUSREM.txt,70286,71936,1650,10,Y,Y,1448316411409,206556,208475
MUSREM.txt,70621,71988,1367,10,Y,Y,1448316411409,206556,208475
MUSREM.txt,70708,72112,1404,10,Y,Y,1448316411409,206556,208475
MUSREM.txt,70827,72182,1355,10,Y,Y,1448316411409,206556,208475
MUSREM.txt,70871,72324,1453,10,Y,Y,1448316411409,206556,208475
MUSREM.txt,71080,72581,1501,10,Y,N,-,-1,-1
MUSREM.txt,71118,72753,1635,10,N,N,-,-1,-1
MUSREM.txt,71196,72941,1745,10,N,N,-,-1,-1
MUSREM.txt,71344,73077,1733,10,N,N,-,-1,-1
MUSREM.txt,71693,73254,1561,10,N,N,-,-1,-1
MUSREM.txt,71937,73352,1415,10,N,N,-,-1,-1
MUSREM.txt,71989,73651,1662,10,N,N,-,-1,-1
MUSREM.txt,72113,73872,1759,10,N,N,-,-1,-1
MUSREM.txt,72185,74242,2057,10,N,N,-,-1,-1
MUSREM.txt,72326,74272,1946,10,N,N,-,-1,-1
MUSREM.txt,72582,74318,1736,10,N,N,-,-1,-1
MUSREM.txt,72754,74375,1621,10,N,N,-,-1,-1
MUSREM.txt,72942,74523,1581,10,N,N,-,-1,-1
MUSREM.txt,73078,74767,1689,10,N,N,-,-1,-1
MUSREM.txt,73255,74901,1646,10,N,N,-,-1,-1
MUSREM.txt,73354,75214,1860,10,N,N,-,-1,-1
MUSREM.txt,73652,75241,1589,10,N,N,-,-1,-1
MUSREM.txt,73873,75421,1548,10,N,N,-,-1,-1
MUSREM.txt,74247,75644,1397,10,N,N,-,-1,-1
MUSREM.txt,74275,75743,1468,10,N,N,-,-1,-1
MUSREM.txt,74318,76005,1687,10,Y,N,-,-1,-1
MUSREM.txt,74378,76183,1805,10,Y,N,-,-1,-1
MUSREM.txt,74524,76309,1785,10,Y,N,-,-1,-1
MUSREM.txt,74768,76396,1628,10,Y,N,-,-1,-1
MUSREM.txt,74902,76505,1603,10,Y,N,-,-1,-1
MUSREM.txt,75219,76573,1354,10,Y,N,-,-1,-1
MUSREM.txt,75242,76904,1662,10,Y,N,-,-1,-1
MUSREM.txt,75422,77001,1579,10,Y,N,-,-1,-1
MUSREM.txt,75646,77237,1591,10,Y,N,-,-1,-1
MUSREM.txt,75744,77324,1580,10,Y,N,-,-1,-1
MUSREM.txt,76006,77351,1345,10,Y,N,-,-1,-1
MUSREM.txt,76184,77791,1607,10,N,N,-,-1,-1
MUSREM.txt,76312,78022,1710,10,N,N,-,-1,-1
MUSREM.txt,76397,78200,1803,10,Y,N,-,-1,-1
MUSREM.txt,76506,78410,1904,10,Y,N,-,-1,-1
MUSREM.txt,76576,78436,1860,10,Y,N,-,-1,-1
MUSREM.txt,76905,78688,1783,10,Y,N,-,-1,-1
MUSREM.txt,77002,79019,2017,10,Y,N,-,-1,-1
MUSREM.txt,77238,79192,1954,10,Y,N,-,-1,-1
MUSREM.txt,77325,79400,2075,10,Y,N,-,-1,-1
MUSREM.txt,77352,79442,2090,10,Y,N,-,-1,-1
MUSREM.txt,77792,79462,1670,10,Y,N,-,-1,-1
MUSREM.txt,78024,79618,1594,10,Y,N,-,-1,-1
MUSREM.txt,78202,79862,1660,10,Y,N,-,-1,-1
MUSREM.txt,78415,80038,1623,10,Y,N,-,-1,-1
MUSREM.txt,78439,80172,1733,10,Y,N,-,-1,-1
MUSREM.txt,78689,80500,1811,10,Y,N,-,-1,-1
MUSREM.txt,79020,80561,1541,10,Y,N,-,-1,-1
MUSREM.txt,79193,80615,1422,10,N,N,-,-1,-1
MUSREM.txt,79403,80675,1272,10,N,N,-,-1,-1
MUSREM.txt,79447,81047,1600,10,N,N,-,-1,-1
MUSREM.txt,79463,81070,1607,10,N,N,-,-1,-1
MUSREM.txt,79619,81100,1481,10,N,N,-,-1,-1
MUSREM.txt,79863,81193,1330,10,N,N,-,-1,-1
MUSREM.txt,80039,81455,1416,10,N,N,-,-1,-1
MUSREM.txt,80175,81582,1407,10,N,N,-,-1,-1
MUSREM.txt,80501,81723,1222,10,N,N,-,-1,-1
MUSREM.txt,80564,81802,1238,10,N,Y,1448278279697,58861,59444
MUSREM.txt,80616,81822,1206,10,N,Y,1448278279697,58861,59444
MUSREM.txt,80676,81941,1265,10,N,Y,1448278279697,58861,59444
MUSREM.txt,81052,82069,1017,10,N,Y,1448278279697,58861,59444
MUSREM.txt,81071,82181,1110,10,Y,Y,1448278279697,58861,59444
MUSREM.txt,81103,82497,1394,10,Y,Y,1448278279697,58861,59444
MUSREM.txt,81196,82531,1335,10,Y,Y,1448278279697,58861,59444
MUSREM.txt,81456,82706,1250,10,Y,Y,1448278279697,58861,59444
MUSREM.txt,81583,82812,1229,10,Y,Y,1448278279697,58861,59444
MUSREM.txt,81726,82965,1239,10,Y,Y,1448278279697,58861,59444
MUSREM.txt,81803,83028,1225,10,Y,Y,1448278279697,58861,59444
MUSREM.txt,81825,83121,1296,10,Y,Y,1448278279697,58861,59444
MUSREM.txt,81942,83227,1285,10,Y,Y,1448278279697,58861,59444
MUSREM.txt,82072,83317,1245,10,Y,N,-,-1,-1
MUSREM.txt,82182,83456,1274,10,Y,N,-,-1,-1
MUSREM.txt,82500,83743,1243,10,Y,N,-,-1,-1
MUSREM.txt,82532,83825,1293,10,Y,N,-,-1,-1
MUSREM.txt,82707,83928,1221,10,N,N,-,-1,-1
MUSREM.txt,82813,83999,1186,10,Y,N,-,-1,-1
MUSREM.txt,82966,84071,1105,10,Y,N,-,-1,-1
MUSREM.txt,83031,84561,1530,10,Y,N,-,-1,-1
MUSREM.txt,83122,84858,1736,10,Y,N,-,-1,-1
MUSREM.txt,83228,84868,1640,10,Y,N,-,-1,-1
MUSREM.txt,83318,84988,1670,10,Y,N,-,-1,-1
MUSREM.txt,83457,85246,1789,10,Y,N,-,-1,-1
MUSREM.txt,83744,85381,1637,10,Y,N,-,-1,-1
MUSREM.txt,83828,85572,1744,10,Y,N,-,-1,-1
MUSREM.txt,83929,85780,1851,10,Y,N,-,-1,-1
MUSREM.txt,84000,85910,1910,10,Y,N,-,-1,-1
MUSREM.txt,84071,85918,1847,10,Y,N,-,-1,-1
MUSREM.txt,84562,85994,1432,10,N,N,-,-1,-1
MUSREM.txt,84863,86116,1253,10,N,N,-,-1,-1
MUSREM.txt,84869,86281,1412,10,N,N,-,-1,-1
MUSREM.txt,84989,86589,1600,10,N,N,-,-1,-1
MUSREM.txt,85247,86621,1374,10,N,N,-,-1,-1
MUSREM.txt,85382,86622,1240,10,N,N,-,-1,-1
MUSREM.txt,85574,86942,1368,10,N,Y,1448322514970,220165,221397
MUSREM.txt,85781,86976,1195,10,Y,Y,1448322514970,220165,221397
MUSREM.txt,85913,87209,1296,10,Y,Y,1448322514970,220165,221397
MUSREM.txt,85919,87372,1453,10,Y,Y,1448322514970,220165,221397
MUSREM.txt,85996,87658,1662,10,Y,Y,1448322514970,220165,221397
MUSREM.txt,86119,87946,1827,10,Y,Y,1448322514970,220165,221397
MUSREM.txt,86282,88007,1725,10,N,Y,1448322514970,220165,221397
MUSREM.txt,86590,88179,1589,10,Y,Y,1448322514970,220165,221397
MUSREM.txt,86621,88438,1817,10,Y,Y,1448322514970,220165,221397
MUSREM.txt,86622,88614,1992,10,Y,Y,1448322514970,220165,221397
MUSREM.txt,86943,88729,1786,10,Y,Y,1448322514970,220165,221397
MUSREM.txt,86977,88856,1879,10,Y,Y,1448322514970,220165,221397
MUSREM.txt,87210,88933,1723,10,Y,Y,1448322514970,220165,221397
MUSREM.txt,87373,89095,1722,10,Y,Y,1448322514970,220165,221397
MUSREM.txt,87659,89158,1499,10,Y,Y,1448322514970,220165,221397
MUSREM.txt,87949,89340,1391,10,Y,Y,1448322514970,220165,221397
MUSREM.txt,88010,89465,1455,10,Y,Y,1448322514970,220165,221397
MUSREM.txt,88180,89651,1471,10,Y,Y,1448322514970,220165,221397
MUSREM.txt,88439,89827,1388,10,Y,Y,1448287490368,120754,123385
MUSREM.txt,88615,89972,1357,10,Y,Y,1448360754961,270225,271673
MUSREM.txt,88730,90134,1404,10,Y,Y,1448360754961,270225,271673
MUSREM.txt,88857,90321,1464,10,Y,Y,1448360754961,270225,271673
MUSREM.txt,88934,90377,1443,10,Y,Y,1448360754961,270225,271673
MUSREM.txt,89096,90553,1457,10,Y,Y,1448360754961,270225,271673
MUSREM.txt,89161,90690,1529,10,Y,Y,1448360754961,270225,271673
MUSREM.txt,89341,90908,1567,10,Y,Y,1437477480340,424837,425856
MUSREM.txt,89468,91001,1533,10,Y,Y,1437477480340,424837,425856
MUSREM.txt,89652,91174,1522,10,Y,Y,1437477480340,424837,425856
MUSREM.txt,89828,91228,1400,10,Y,Y,1437477480340,424837,425856
MUSREM.txt,89975,91323,1348,10,Y,Y,1437477480340,424837,425856
MUSREM.txt,90135,91801,1666,10,Y,Y,1437477480340,424837,425856
MUSREM.txt,90322,92016,1694,10,Y,Y,1437477480340,424837,425856
MUSREM.txt,90378,92046,1668,10,Y,Y,1437477480340,424837,425856
MUSREM.txt,90555,92134,1579,10,Y,Y,1437477480340,424837,425856
MUSREM.txt,90692,92690,1998,10,Y,Y,1437477480340,424837,425856
MUSREM.txt,90910,92792,1882,10,Y,Y,1437477480340,424837,425856
MUSREM.txt,91002,92957,1955,10,N,Y,1437477480340,424837,425856
MUSREM.txt,91175,93058,1883,10,N,Y,1437477480340,424837,425856
MUSREM.txt,91230,93149,1919,10,Y,Y,1448314192885,179720,179950
MUSREM.txt,91326,93335,2009,10,Y,Y,1448314192885,179720,179950
MUSREM.txt,91802,93468,1666,10,Y,Y,1448314192885,179720,179950
MUSREM.txt,92019,93743,1724,10,Y,Y,1448314192885,179720,179950
MUSREM.txt,92047,93831,1784,10,Y,Y,1448314192885,179720,179950
MUSREM.txt,92135,93932,1797,10,Y,Y,1448314192885,179720,179950
MUSREM.txt,92692,94068,1376,10,Y,Y,1448314192885,179720,179950
MUSREM.txt,92793,94106,1313,10,Y,Y,1448314192885,179720,179950
MUSREM.txt,92959,94203,1244,10,Y,Y,1448314192885,179720,179950
MUSREM.txt,93059,94370,1311,10,Y,Y,1448314192885,179720,179950
MUSREM.txt,93150,94436,1286,10,Y,Y,1448314192885,179720,179950
MUSREM.txt,93336,94554,1218,10,Y,Y,1448314192885,179720,179950
MUSREM.txt,93471,94597,1126,10,Y,Y,1448316586529,210063,210674
MUSREM.txt,93746,94755,1009,10,Y,Y,1448316586529,210063,210674
MUSREM.txt,93833,94919,1086,10,Y,Y,1448316586529,210063,210674
MUSREM.txt,93933,95032,1099,10,Y,Y,1448316586529,210063,210674
MUSREM.txt,94071,95043,972,10,Y,Y,1448316586529,210063,210674
MUSREM.txt,94107,95087,980,10,Y,Y,1448316586529,210063,210674
MUSREM.txt,94203,95230,1027,10,Y,Y,1448316586529,210063,210674
MUSREM.txt,94372,95307,935,10,Y,Y,1448316586529,210063,210674
MUSREM.txt,94437,95395,958,10,Y,Y,1448316586529,210063,210674
MUSREM.txt,94555,95518,963,10,Y,Y,1437490253936,460795,462238
MUSREM.txt,94598,95713,1115,10,Y,Y,1437490253936,460795,462238
MUSREM.txt,94756,95821,1065,10,Y,Y,1437490253936,460795,462238
MUSREM.txt,94920,95969,1049,10,Y,Y,1437490253936,460795,462238
MUSREM.txt,95037,96049,1012,10,N,Y,1437490253936,460795,462238
MUSREM.txt,95044,96060,1016,10,N,Y,1437490253936,460795,462238
MUSREM.txt,95088,96297,1209,10,Y,Y,1437490253936,460795,462238
MUSREM.txt,95232,96387,1155,10,Y,Y,1437490253936,460795,462238
MUSREM.txt,95308,96403,1095,10,Y,Y,1437490253936,460795,462238
MUSREM.txt,95398,96422,1024,10,N,Y,1437490253936,460795,462238
MUSREM.txt,95521,96434,913,10,N,Y,1448275407308,26987,29181
MUSREM.txt,95714,96855,1141,10,N,Y,1448275407308,26987,29181
MUSREM.txt,95822,97005,1183,10,N,Y,1448357431466,233540,233770
MUSREM.txt,95970,97130,1160,10,N,Y,1448357431466,233540,233770
MUSREM.txt,96054,97163,1109,10,N,Y,1448357431466,233540,233770
MUSREM.txt,96065,97199,1134,10,N,Y,1437475017618,98942,100041
MUSREM.txt,96298,97414,1116,10,Y,Y,1437475017618,98942,100041
MUSREM.txt,96392,97497,1105,10,Y,Y,1437475017618,98942,100041
MUSREM.txt,96404,97636,1232,10,Y,Y,1437475017618,98942,100041
MUSREM.txt,96425,97832,1407,10,Y,Y,1437475017618,98942,100041
MUSREM.txt,96437,97955,1518,10,Y,Y,1437475017618,98942,100041
MUSREM.txt,96856,98093,1237,10,Y,Y,1437475017618,98942,100041
MUSREM.txt,97007,98197,1190,10,Y,Y,1437475017618,98942,100041
MUSREM.txt,97131,98325,1194,10,N,Y,1437475017618,98942,100041
MUSREM.txt,97166,98447,1281,10,N,Y,1437475017618,98942,100041
MUSREM.txt,97200,98880,1680,10,Y,Y,1437475017618,98942,100041
MUSREM.txt,97415,99019,1604,10,N,Y,1448315841759,183531,183799
MUSREM.txt,97498,99099,1601,10,N,Y,1448315841759,183531,183799
MUSREM.txt,97637,99167,1530,10,N,Y,1448315841759,183531,183799
MUSREM.txt,97833,99460,1627,10,N,Y,1448315841759,183531,183799
MUSREM.txt,97956,99681,1725,10,N,Y,1448315841759,183531,183799
MUSREM.txt,98096,99924,1828,10,Y,Y,1448315841759,183531,183799
MUSREM.txt,98198,100153,1955,10,Y,Y,1448315841759,183531,183799
MUSREM.txt,98326,100184,1858,10,Y,Y,1448286880729,112151,113274
MUSREM.txt,98448,100316,1868,10,Y,Y,1448286880729,112151,113274
MUSREM.txt,98883,100599,1716,10,Y,Y,1448286880729,112151,113274
MUSREM.txt,99021,100849,1828,10,Y,Y,1448286880729,112151,113274
MUSREM.txt,99100,100978,1878,10,Y,Y,1448286880729,112151,113274
MUSREM.txt,99170,101165,1995,10,Y,Y,1448286880729,112151,113274
MUSREM.txt,99461,101254,1793,10,Y,Y,1448286880729,112151,113274
MUSREM.txt,99682,101321,1639,10,Y,Y,1448286880729,112151,113274
MUSREM.txt,99925,101494,1569,10,Y,Y,1448286880729,112151,113274
MUSREM.txt,100154,101733,1579,10,Y,Y,1448286880729,112151,113274
MUSREM.txt,100185,101998,1813,10,Y,Y,1448286880729,112151,113274
MUSREM.txt,100317,102157,1840,10,Y,Y,1448286880729,112151,113274
MUSREM.txt,100600,102225,1625,10,Y,Y,1448286880729,112151,113274
MUSREM.txt,100850,102286,1436,10,N,Y,1448368573498,278931,279027
MUSREM.txt,100979,102377,1398,10,N,Y,1448368573498,278931,279027
MUSREM.txt,101166,102851,1685,10,N,Y,1448368573498,278931,279027
MUSREM.txt,101257,103064,1807,10,Y,Y,1448368573498,278931,279027
MUSREM.txt,101324,103202,1878,10,Y,Y,1448368573498,278931,279027
MUSREM.txt,101495,103287,1792,10,Y,Y,1448366492754,275659,275884
MUSREM.txt,101736,103358,1622,10,Y,Y,1448366492754,275659,275884
MUSREM.txt,101999,103744,1745,10,Y,Y,1448366492754,275659,275884
MUSREM.txt,102158,103828,1670,10,Y,Y,1448366492754,275659,275884
MUSREM.txt,102226,104005,1779,10,Y,Y,1448366492754,275659,275884
MUSREM.txt,102287,104116,1829,10,Y,Y,1448366492754,275659,275884
MUSREM.txt,102378,104230,1852,10,Y,Y,1448366492754,275659,275884
MUSREM.txt,102852,104310,1458,10,Y,Y,1448366492754,275659,275884
MUSREM.txt,103065,104324,1259,10,N,Y,1448366492754,275659,275884
MUSREM.txt,103203,104466,1263,10,N,Y,1448366492754,275659,275884
MUSREM.txt,103290,104715,1425,10,N,Y,1448366492754,275659,275884
MUSREM.txt,103358,104903,1545,10,Y,N,-,-1,-1
MUSREM.txt,103745,105044,1299,10,Y,N,-,-1,-1
MUSREM.txt,103831,105282,1451,10,N,Y,1448278147591,54631,55869
MUSREM.txt,104006,105302,1296,10,N,Y,1448278147591,54631,55869
MUSREM.txt,104117,105623,1506,10,N,Y,1448278147591,54631,55869
MUSREM.txt,104231,106248,2017,10,N,Y,1448278147591,54631,55869
MUSREM.txt,104315,106366,2051,10,Y,Y,1448278147591,54631,55869
MUSREM.txt,104325,106468,2143,10,Y,Y,1448278147591,54631,55869
MUSREM.txt,104469,106617,2148,10,Y,Y,1448278147591,54631,55869
MUSREM.txt,104715,107260,2545,10,Y,Y,1448278147591,54631,55869
MUSREM.txt,104905,107496,2591,10,Y,Y,1448278147591,54631,55869
MUSREM.txt,105046,107514,2468,10,Y,Y,1448278147591,54631,55869
MUSREM.txt,105284,107658,2374,10,Y,Y,1448278147591,54631,55869
MUSREM.txt,105305,107786,2481,10,Y,Y,1448278147591,54631,55869
MUSREM.txt,105625,107921,2296,10,Y,Y,1448278147591,54631,55869
MUSREM.txt,106249,108312,2063,10,Y,Y,1448278147591,54631,55869
MUSREM.txt,106367,108423,2056,10,Y,Y,1448278147591,54631,55869
MUSREM.txt,106469,108582,2113,10,Y,Y,1448278147591,54631,55869
MUSREM.txt,106618,108611,1993,10,Y,N,-,-1,-1
MUSREM.txt,107261,108854,1593,10,Y,N,-,-1,-1
MUSREM.txt,107501,109111,1610,10,Y,N,-,-1,-1
MUSREM.txt,107517,109207,1690,10,Y,N,-,-1,-1
MUSREM.txt,107660,109327,1667,10,Y,N,-,-1,-1
MUSREM.txt,107787,109460,1673,10,Y,N,-,-1,-1
MUSREM.txt,107922,109630,1708,10,Y,N,-,-1,-1
MUSREM.txt,108313,109644,1331,10,Y,N,-,-1,-1
MUSREM.txt,108424,109931,1507,10,Y,N,-,-1,-1
MUSREM.txt,108583,110188,1605,10,Y,N,-,-1,-1
MUSREM.txt,108612,110316,1704,10,Y,N,-,-1,-1
MUSREM.txt,108855,110440,1585,10,Y,N,-,-1,-1
MUSREM.txt,109114,110558,1444,10,Y,N,-,-1,-1
MUSREM.txt,109209,110635,1426,10,Y,N,-,-1,-1
MUSREM.txt,109328,110698,1370,10,Y,N,-,-1,-1
MUSREM.txt,109461,111127,1666,10,Y,Y,1448393552252,287738,288962
MUSREM.txt,109633,111265,1632,10,Y,Y,1448393552252,287738,288962
MUSREM.txt,109645,111337,1692,10,Y,Y,1448393552252,287738,288962
MUSREM.txt,109932,111553,1621,10,Y,Y,1448393552252,287738,288962
MUSREM.txt,110191,111650,1459,10,Y,Y,1448393552252,287738,288962
MUSREM.txt,110317,111699,1382,10,Y,Y,1448393552252,287738,288962
MUSREM.txt,110441,111881,1440,10,Y,Y,1448393552252,287738,288962
MUSREM.txt,110559,112002,1443,10,N,Y,1448393552252,287738,288962
MUSREM.txt,110636,112326,1690,10,N,Y,1448393552252,287738,288962
MUSREM.txt,110699,112591,1892,10,Y,Y,1448393552252,287738,288962
MUSREM.txt,111129,112709,1580,10,Y,Y,1448393552252,287738,288962
MUSREM.txt,111267,112784,1517,10,Y,Y,1448393552252,287738,288962
MUSREM.txt,111338,112864,1526,10,Y,Y,1448393552252,287738,288962
MUSREM.txt,111554,113107,1553,10,Y,N,-,-1,-1
MUSREM.txt,111651,113303,1652,10,Y,N,-,-1,-1
MUSREM.txt,111702,113436,1734,10,Y,N,-,-1,-1
MUSREM.txt,111884,113693,1809,10,Y,N,-,-1,-1
MUSREM.txt,112003,113754,1751,10,Y,N,-,-1,-1
MUSREM.txt,112328,113893,1565,10,Y,N,-,-1,-1
MUSREM.txt,112592,114226,1634,10,Y,N,-,-1,-1
MUSREM.txt,112710,114380,1670,10,N,N,-,-1,-1
MUSREM.txt,112787,114615,1828,10,N,N,-,-1,-1
MUSREM.txt,112864,114750,1886,10,N,N,-,-1,-1
MUSREM.txt,113108,114764,1656,10,N,N,-,-1,-1
MUSREM.txt,113304,115215,1911,10,N,N,-,-1,-1
MUSREM.txt,113437,115405,1968,10,N,N,-,-1,-1
MUSREM.txt,113694,115792,2098,10,N,N,-,-1,-1
MUSREM.txt,113759,116032,2273,10,N,N,-,-1,-1
MUSREM.txt,113894,116236,2342,10,N,N,-,-1,-1
MUSREM.txt,114227,116371,2144,10,Y,N,-,-1,-1
MUSREM.txt,114382,116549,2167,10,Y,N,-,-1,-1
MUSREM.txt,114615,116649,2034,10,Y,N,-,-1,-1
MUSREM.txt,114755,116674,1919,10,Y,N,-,-1,-1
MUSREM.txt,114765,116851,2086,10,N,N,-,-1,-1
MUSREM.txt,115218,117061,1843,10,N,N,-,-1,-1
MUSREM.txt,115406,117248,1842,10,N,N,-,-1,-1
MUSREM.txt,115797,117363,1566,10,N,N,-,-1,-1
MUSREM.txt,116033,117465,1432,10,N,N,-,-1,-1
MUSREM.txt,116237,117587,1350,10,N,N,-,-1,-1
MUSREM.txt,116372,117856,1484,10,N,Y,1448366973491,278203,278343
MUSREM.txt,116550,117877,1327,10,N,Y,1448366973491,278203,278343
MUSREM.txt,116652,118214,1562,10,N,Y,1448366973491,278203,278343
MUSREM.txt,116675,118400,1725,10,N,Y,1448366973491,278203,278343
MUSREM.txt,116852,118807,1955,10,N,Y,1448366973491,278203,278343
MUSREM.txt,117064,118869,1805,10,N,Y,1448366973491,278203,278343
MUSREM.txt,117249,119008,1759,10,N,Y,1448366973491,278203,278343
MUSREM.txt,117366,119735,2369,10,Y,Y,1448366973491,278203,278343
MUSREM.txt,117466,119890,2424,10,Y,Y,1448366973491,278203,278343
MUSREM.txt,117589,119939,2350,10,Y,Y,1448366973491,278203,278343
MUSREM.txt,117861,120001,2140,10,Y,Y,1448366973491,278203,278343
MUSREM.txt,117880,120503,2623,10,Y,Y,1448316079788,183824,184995
MUSREM.txt,118217,120697,2480,10,Y,Y,1448316079788,183824,184995
MUSREM.txt,118401,120761,2360,10,Y,Y,1448316079788,183824,184995
MUSREM.txt,118810,120961,2151,10,Y,Y,1448316079788,183824,184995
MUSREM.txt,118874,121127,2253,10,Y,Y,1448316079788,183824,184995
MUSREM.txt,119009,121350,2341,10,Y,Y,1448316079788,183824,184995
MUSREM.txt,119736,121536,1800,10,Y,Y,1448316079788,183824,184995
MUSREM.txt,119891,121595,1704,10,Y,Y,1448316079788,183824,184995
MUSREM.txt,119942,121941,1999,10,Y,Y,1448316079788,183824,184995
MUSREM.txt,120002,122015,2013,10,Y,Y,1448316079788,183824,184995
MUSREM.txt,120504,122036,1532,10,Y,Y,1448316079788,183824,184995
MUSREM.txt,120698,122049,1351,10,Y,N,-,-1,-1
MUSREM.txt,120764,122269,1505,10,Y,N,-,-1,-1
MUSREM.txt,120962,122417,1455,10,Y,N,-,-1,-1
MUSREM.txt,121127,122579,1452,10,Y,N,-,-1,-1
MUSREM.txt,121352,122754,1402,10,Y,N,-,-1,-1
MUSREM.txt,121538,122993,1455,10,Y,N,-,-1,-1
MUSREM.txt,121596,123014,1418,10,Y,N,-,-1,-1
MUSREM.txt,121942,123080,1138,10,N,N,-,-1,-1
MUSREM.txt,122020,123143,1123,10,N,N,-,-1,-1
MUSREM.txt,122039,123313,1274,10,Y,N,-,-1,-1
MUSREM.txt,122050,123523,1473,10,Y,N,-,-1,-1
MUSREM.txt,122272,123730,1458,10,N,N,-,-1,-1
MUSREM.txt,122420,123930,1510,10,Y,N,-,-1,-1
MUSREM.txt,122580,123975,1395,10,Y,Y,1437028092146,121457,123204
MUSREM.txt,122755,124202,1447,10,N,Y,1437028092146,121457,123204
MUSREM.txt,122998,124473,1475,10,N,Y,1437028092146,121457,123204
MUSREM.txt,123015,124604,1589,10,Y,Y,1437028092146,121457,123204
MUSREM.txt,123081,124832,1751,10,Y,Y,1437028092146,121457,123204
MUSREM.txt,123144,125008,1864,10,Y,Y,1437028092146,121457,123204
MUSREM.txt,123316,125308,1992,10,Y,Y,1437028092146,121457,123204
MUSREM.txt,123526,125337,1811,10,N,Y,1437028092146,121457,123204
MUSREM.txt,123733,125354,1621,10,N,Y,1437028092146,121457,123204
MUSREM.txt,123931,125366,1435,10,N,Y,1437028092146,121457,123204
MUSREM.txt,123978,125485,1507,10,N,Y,1437028092146,121457,123204
MUSREM.txt,124203,125829,1626,10,N,Y,1437028092146,121457,123204
MUSREM.txt,124476,126034,1558,10,N,N,-,-1,-1
MUSREM.txt,124605,126096,1491,10,N,N,-,-1,-1
MUSREM.txt,124833,126253,1420,10,N,N,-,-1,-1
MUSREM.txt,125009,126532,1523,10,N,N,-,-1,-1
MUSREM.txt,125319,126623,1304,10,N,N,-,-1,-1
MUSREM.txt,125342,127157,1815,10,N,N,-,-1,-1
MUSREM.txt,125357,127415,2058,10,Y,N,-,-1,-1
MUSREM.txt,125369,127550,2181,10,Y,N,-,-1,-1
MUSREM.txt,125488,127746,2258,10,Y,N,-,-1,-1
MUSREM.txt,125830,128088,2258,10,Y,N,-,-1,-1
MUSREM.txt,126037,128217,2180,10,Y,N,-,-1,-1
MUSREM.txt,126097,128435,2338,10,Y,N,-,-1,-1
MUSREM.txt,126254,128466,2212,10,N,N,-,-1,-1
MUSREM.txt,126533,128583,2050,10,Y,N,-,-1,-1
MUSREM.txt,126624,128761,2137,10,Y,N,-,-1,-1
MUSREM.txt,127160,128924,1764,10,N,N,-,-1,-1
MUSREM.txt,127415,129043,1628,10,Y,N,-,-1,-1
MUSREM.txt,127551,129129,1578,10,Y,N,-,-1,-1
MUSREM.txt,127747,129320,1573,10,Y,N,-,-1,-1
MUSREM.txt,128089,129476,1387,10,Y,N,-,-1,-1
MUSREM.txt,128218,129501,1283,10,Y,N,-,-1,-1
MUSREM.txt,128436,129528,1092,10,Y,N,-,-1,-1
MUSREM.txt,128467,129604,1137,10,Y,N,-,-1,-1
MUSREM.txt,128584,129904,1320,10,Y,N,-,-1,-1
MUSREM.txt,128764,130235,1471,10,Y,N,-,-1,-1
MUSREM.txt,128925,130383,1458,10,Y,N,-,-1,-1
MUSREM.txt,129044,130565,1521,10,Y,N,-,-1,-1
MUSREM.txt,129130,130661,1531,10,Y,N,-,-1,-1
MUSREM.txt,129323,130776,1453,10,Y,N,-,-1,-1
MUSREM.txt,129477,131183,1706,10,Y,N,-,-1,-1
MUSREM.txt,129504,131638,2134,10,Y,N,-,-1,-1
MUSREM.txt,129531,131661,2130,10,Y,N,-,-1,-1
MUSREM.txt,129605,131815,2210,10,Y,N,-,-1,-1
MUSREM.txt,129907,132227,2320,10,Y,N,-,-1,-1
MUSREM.txt,130236,132467,2231,10,Y,N,-,-1,-1
MUSREM.txt,130384,132629,2245,10,Y,N,-,-1,-1
MUSREM.txt,130566,132688,2122,10,Y,N,-,-1,-1
MUSREM.txt,130663,132707,2044,10,Y,N,-,-1,-1
MUSREM.txt,130776,132823,2047,10,Y,N,-,-1,-1
MUSREM.txt,131185,133014,1829,10,Y,N,-,-1,-1
MUSREM.txt,131643,133207,1564,10,Y,N,-,-1,-1
MUSREM.txt,131664,133480,1816,10,Y,N,-,-1,-1
MUSREM.txt,131815,133546,1731,10,Y,N,-,-1,-1
MUSREM.txt,132228,133838,1610,10,Y,N,-,-1,-1
MUSREM.txt,132468,133861,1393,10,Y,N,-,-1,-1
MUSREM.txt,132630,133952,1322,10,Y,N,-,-1,-1
MUSREM.txt,132693,134301,1608,10,Y,N,-,-1,-1
MUSREM.txt,132708,134459,1751,10,Y,N,-,-1,-1
MUSREM.txt,132823,134659,1836,10,Y,N,-,-1,-1
MUSREM.txt,133015,134679,1664,10,Y,N,-,-1,-1
MUSREM.txt,133208,134746,1538,10,Y,N,-,-1,-1
MUSREM.txt,133481,135039,1558,10,Y,N,-,-1,-1
MUSREM.txt,133547,135232,1685,10,Y,N,-,-1,-1
MUSREM.txt,133843,135245,1402,10,Y,N,-,-1,-1
MUSREM.txt,133864,135381,1517,10,Y,N,-,-1,-1
MUSREM.txt,133952,135706,1754,10,Y,N,-,-1,-1
MUSREM.txt,134302,135946,1644,10,Y,N,-,-1,-1
MUSREM.txt,134460,136059,1599,10,Y,N,-,-1,-1
MUSREM.txt,134660,136151,1491,10,N,N,-,-1,-1
MUSREM.txt,134680,136310,1630,10,N,N,-,-1,-1
MUSREM.txt,134747,136464,1717,10,N,N,-,-1,-1
MUSREM.txt,135040,136678,1638,10,N,Y,1448323072174,227638,227786
MUSREM.txt,135237,136989,1752,10,N,Y,1448323072174,227638,227786
MUSREM.txt,135246,137296,2050,10,N,Y,1448323072174,227638,227786
MUSREM.txt,135383,137310,1927,10,N,Y,1448323072174,227638,227786
MUSREM.txt,135708,137474,1766,10,N,Y,1448323072174,227638,227786
MUSREM.txt,135947,137604,1657,10,N,Y,1448323072174,227638,227786
MUSREM.txt,136060,137717,1657,10,N,Y,1448323072174,227638,227786
MUSREM.txt,136152,138169,2017,10,N,Y,1448323072174,227638,227786
MUSREM.txt,136313,138334,2021,10,N,Y,1448323072174,227638,227786
MUSREM.txt,136467,138391,1924,10,N,Y,1448323072174,227638,227786
MUSREM.txt,136679,138503,1824,10,N,Y,1448323072174,227638,227786
MUSREM.txt,136991,138580,1589,10,N,N,-,-1,-1
MUSREM.txt,137301,138719,1418,10,N,N,-,-1,-1
MUSREM.txt,137311,138832,1521,10,Y,N,-,-1,-1
MUSREM.txt,137475,139097,1622,10,N,N,-,-1,-1
MUSREM.txt,137605,139345,1740,10,N,N,-,-1,-1
MUSREM.txt,137720,139467,1747,10,Y,N,-,-1,-1
MUSREM.txt,138170,139788,1618,10,Y,N,-,-1,-1
MUSREM.txt,138335,139958,1623,10,Y,N,-,-1,-1
MUSREM.txt,138394,140011,1617,10,Y,N,-,-1,-1
MUSREM.txt,138504,140204,1700,10,Y,N,-,-1,-1
MUSREM.txt,138582,140418,1836,10,Y,N,-,-1,-1
MUSREM.txt,138720,140474,1754,10,Y,N,-,-1,-1
MUSREM.txt,138833,140648,1815,10,N,N,-,-1,-1
MUSREM.txt,139098,140868,1770,10,N,N,-,-1,-1
MUSREM.txt,139345,140943,1598,10,N,N,-,-1,-1
MUSREM.txt,139470,141070,1600,10,N,N,-,-1,-1
MUSREM.txt,139789,141316,1527,10,N,N,-,-1,-1
MUSREM.txt,139958,141430,1472,10,N,N,-,-1,-1
MUSREM.txt,140012,141604,1592,10,N,N,-,-1,-1
MUSREM.txt,140205,141657,1452,10,N,N,-,-1,-1
MUSREM.txt,140419,141710,1291,10,N,N,-,-1,-1
MUSREM.txt,140477,141722,1245,10,N,N,-,-1,-1
MUSREM.txt,140651,141903,1252,10,N,N,-,-1,-1
MUSREM.txt,140869,142048,1179,10,N,N,-,-1,-1
MUSREM.txt,140944,142189,1245,10,N,N,-,-1,-1
MUSREM.txt,141071,142790,1719,10,N,N,-,-1,-1
MUSREM.txt,141318,143086,1768,10,N,N,-,-1,-1
MUSREM.txt,141431,143260,1829,10,N,N,-,-1,-1
MUSREM.txt,141605,143434,1829,10,N,N,-,-1,-1
MUSREM.txt,141658,143505,1847,10,N,Y,1448658612805,316427,316672
MUSREM.txt,141715,143688,1973,10,N,Y,1448658612805,316427,316672
MUSREM.txt,141723,143799,2076,10,N,Y,1448658612805,316427,316672
MUSREM.txt,141904,143891,1987,10,N,Y,1448658612805,316427,316672
MUSREM.txt,142049,144045,1996,10,N,Y,1448658612805,316427,316672
MUSREM.txt,142190,144155,1965,10,Y,Y,1448658612805,316427,316672
MUSREM.txt,142793,144200,1407,10,N,Y,1448658612805,316427,316672
MUSREM.txt,143089,144253,1164,10,N,Y,1448658612805,316427,316672
MUSREM.txt,143263,144346,1083,10,N,Y,1448658612805,316427,316672
MUSREM.txt,143437,144488,1051,10,Y,Y,1448658612805,316427,316672
MUSREM.txt,143506,144572,1066,10,Y,Y,1448658612805,316427,316672
MUSREM.txt,143689,144699,1010,10,Y,Y,1448658612805,316427,316672
MUSREM.txt,143800,144783,983,10,N,Y,1448658612805,316427,316672
MUSREM.txt,143892,144808,916,10,Y,Y,1448359878707,265791,267089
MUSREM.txt,144046,144916,870,10,N,Y,1448359878707,265791,267089
MUSREM.txt,144156,145116,960,10,N,Y,1448359878707,265791,267089
MUSREM.txt,144203,145673,1470,10,Y,Y,1448359878707,265791,267089
MUSREM.txt,144254,145725,1471,10,Y,Y,1448359878707,265791,267089
MUSREM.txt,144347,145832,1485,10,Y,Y,1448359878707,265791,267089
MUSREM.txt,144491,145974,1483,10,Y,Y,1448359878707,265791,267089
MUSREM.txt,144574,146185,1611,10,Y,Y,1448359878707,265791,267089
MUSREM.txt,144700,146344,1644,10,Y,Y,1448359878707,265791,267089
MUSREM.txt,144784,146525,1741,10,Y,Y,1448359878707,265791,267089
MUSREM.txt,144811,146727,1916,10,Y,Y,1448359878707,265791,267089
MUSREM.txt,144917,146826,1909,10,Y,Y,1448321627053,211159,212725
MUSREM.txt,145117,146845,1728,10,Y,Y,1448321627053,211159,212725
MUSREM.txt,145674,146964,1290,10,Y,Y,1448321627053,211159,212725
MUSREM.txt,145726,147056,1330,10,Y,Y,1448321627053,211159,212725
MUSREM.txt,145833,147373,1540,10,Y,Y,1448321627053,211159,212725
MUSREM.txt,145976,147518,1542,10,Y,Y,1448311366799,143137,146264
MUSREM.txt,146186,147775,1589,10,Y,Y,1448311366799,143137,146264
MUSREM.txt,146345,147856,1511,10,Y,Y,1448311366799,143137,146264
MUSREM.txt,146528,147871,1343,10,Y,Y,1448311366799,143137,146264
MUSREM.txt,146730,148113,1383,10,Y,Y,1448311366799,143137,146264
MUSREM.txt,146831,148159,1328,10,Y,Y,1448311366799,143137,146264
MUSREM.txt,146848,148202,1354,10,Y,Y,1448311366799,143137,146264
MUSREM.txt,146965,148286,1321,10,Y,Y,1448311366799,143137,146264
MUSREM.txt,147057,148341,1284,10,Y,Y,1448311366799,143137,146264
MUSREM.txt,147376,148384,1008,10,Y,Y,1448311366799,143137,146264
MUSREM.txt,147519,148584,1065,10,N,Y,1448311366799,143137,146264
MUSREM.txt,147776,148730,954,10,N,Y,1448311366799,143137,146264
MUSREM.txt,147861,148886,1025,10,N,Y,1448311366799,143137,146264
MUSREM.txt,147872,149085,1213,10,N,Y,1448311366799,143137,146264
MUSREM.txt,148114,149380,1266,10,N,Y,1448311366799,143137,146264
MUSREM.txt,148160,149489,1329,10,N,N,-,-1,-1
MUSREM.txt,148203,149581,1378,10,N,N,-,-1,-1
MUSREM.txt,148288,149691,1403,10,N,N,-,-1,-1
MUSREM.txt,148344,149921,1577,10,Y,N,-,-1,-1
MUSREM.txt,148386,150107,1721,10,Y,N,-,-1,-1
MUSREM.txt,148585,150281,1696,10,Y,N,-,-1,-1
MUSREM.txt,148733,150486,1753,10,Y,N,-,-1,-1
MUSREM.txt,148889,150671,1782,10,Y,N,-,-1,-1
MUSREM.txt,149086,150811,1725,10,Y,N,-,-1,-1
MUSREM.txt,149382,150954,1572,10,Y,N,-,-1,-1
MUSREM.txt,149490,150969,1479,10,Y,N,-,-1,-1
MUSREM.txt,149582,151279,1697,10,Y,N,-,-1,-1
MUSREM.txt,149693,151422,1729,10,Y,N,-,-1,-1
MUSREM.txt,149922,151523,1601,10,Y,Y,1448285913012,108803,110925
MUSREM.txt,150109,151798,1689,10,Y,Y,1448285913012,108803,110925
MUSREM.txt,150282,152026,1744,10,Y,Y,1448285913012,108803,110925
MUSREM.txt,150487,152182,1695,10,Y,Y,1448285913012,108803,110925
MUSREM.txt,150672,152442,1770,10,Y,Y,1448285913012,108803,110925
MUSREM.txt,150812,152536,1724,10,Y,Y,1448285913012,108803,110925
MUSREM.txt,150959,152624,1665,10,Y,Y,1448285913012,108803,110925
MUSREM.txt,150972,152740,1768,10,Y,Y,1448285913012,108803,110925
MUSREM.txt,151280,152769,1489,10,Y,Y,1448285913012,108803,110925
MUSREM.txt,151423,152792,1369,10,Y,Y,1448285913012,108803,110925
MUSREM.txt,151524,152810,1286,10,Y,Y,1448285913012,108803,110925
MUSREM.txt,151799,152906,1107,10,N,Y,1448285913012,108803,110925
MUSREM.txt,152027,153148,1121,10,N,Y,1448285913012,108803,110925
MUSREM.txt,152182,153468,1286,10,N,N,-,-1,-1
MUSREM.txt,152443,153533,1090,10,N,N,-,-1,-1
MUSREM.txt,152537,153598,1061,10,N,N,-,-1,-1
MUSREM.txt,152625,153673,1048,10,N,N,-,-1,-1
MUSREM.txt,152741,153832,1091,10,N,N,-,-1,-1
MUSREM.txt,152774,154084,1310,10,N,N,-,-1,-1
MUSREM.txt,152797,154167,1370,10,N,N,-,-1,-1
MUSREM.txt,152813,154277,1464,10,Y,N,-,-1,-1
MUSREM.txt,152909,154538,1629,10,Y,Y,1448310549245,137491,141408
MUSREM.txt,153151,154756,1605,10,Y,Y,1448310549245,137491,141408
MUSREM.txt,153470,154917,1447,10,Y,Y,1448310549245,137491,141408
MUSREM.txt,153534,155137,1603,10,Y,Y,1448310549245,137491,141408
MUSREM.txt,153601,155458,1857,10,Y,Y,1448310549245,137491,141408
MUSREM.txt,153674,155552,1878,10,Y,Y,1448310549245,137491,141408
MUSREM.txt,153833,155690,1857,10,Y,Y,1448310549245,137491,141408
MUSREM.txt,154086,156125,2039,10,Y,Y,1448310549245,137491,141408
MUSREM.txt,154168,156203,2035,10,Y,Y,1448310549245,137491,141408
MUSREM.txt,154278,156439,2161,10,Y,Y,1448310549245,137491,141408
MUSREM.txt,154541,156616,2075,10,Y,Y,1448310549245,137491,141408
MUSREM.txt,154757,156629,1872,10,Y,Y,1448310549245,137491,141408
MUSREM.txt,154920,156639,1719,10,Y,Y,1448357582358,234204,234401
MUSREM.txt,155139,156981,1842,10,Y,Y,1448357582358,234204,234401
MUSREM.txt,155459,157384,1925,10,Y,Y,1448357582358,234204,234401
MUSREM.txt,155553,157481,1928,10,Y,Y,1448357582358,234204,234401
MUSREM.txt,155692,157643,1951,10,Y,Y,1448357582358,234204,234401
MUSREM.txt,156126,157659,1533,10,Y,Y,1448357582358,234204,234401
MUSREM.txt,156203,157705,1502,10,Y,Y,1448368866047,278997,279078
MUSREM.txt,156440,157885,1445,10,N,Y,1448368866047,278997,279078
MUSREM.txt,156621,158159,1538,10,N,Y,1448368866047,278997,279078
MUSREM.txt,156630,158270,1640,10,Y,Y,1448368866047,278997,279078
MUSREM.txt,156642,158475,1833,10,Y,Y,1448368866047,278997,279078
MUSREM.txt,156982,158696,1714,10,Y,Y,1437470299748,152207,152889
MUSREM.txt,157385,158716,1331,10,Y,Y,1437470299748,152207,152889
MUSREM.txt,157484,158831,1347,10,Y,Y,1437470299748,152207,152889
MUSREM.txt,157648,158964,1316,10,Y,Y,1437470299748,152207,152889
MUSREM.txt,157660,159243,1583,10,Y,Y,1437470299748,152207,152889
MUSREM.txt,157706,159403,1697,10,Y,Y,1437470299748,152207,152889
MUSREM.txt,157886,159746,1860,10,Y,Y,1437470299748,152207,152889
MUSREM.txt,158160,159765,1605,10,Y,Y,1437470299748,152207,152889
MUSREM.txt,158271,159915,1644,10,Y,Y,1437470299748,152207,152889
MUSREM.txt,158475,160049,1574,10,Y,Y,1437470299748,152207,152889
MUSREM.txt,158701,160160,1459,10,Y,Y,1437470299748,152207,152889
MUSREM.txt,158719,160451,1732,10,Y,Y,1437470299748,152207,152889
MUSREM.txt,158832,160591,1759,10,Y,Y,1437470299748,152207,152889
MUSREM.txt,158965,160641,1676,10,Y,Y,1437470299748,152207,152889
MUSREM.txt,159246,160662,1416,10,N,N,-,-1,-1
MUSREM.txt,159404,160691,1287,10,N,N,-,-1,-1
MUSREM.txt,159751,160703,952,10,N,N,-,-1,-1
MUSREM.txt,159766,160722,956,10,N,N,-,-1,-1
MUSREM.txt,159916,160788,872,10,N,N,-,-1,-1
MUSREM.txt,160050,160964,914,10,N,N,-,-1,-1
MUSREM.txt,160161,161060,899,10,N,N,-,-1,-1
MUSREM.txt,160451,161299,848,10,N,Y,1448395538701,294934,295016
MUSREM.txt,160592,161396,804,10,N,Y,1448395538701,294934,295016
MUSREM.txt,160646,161425,779,10,N,Y,1448395538701,294934,295016
MUSREM.txt,160662,161589,927,10,N,Y,1448395538701,294934,295016
MUSREM.txt,160694,161837,1143,10,N,Y,1448395538701,294934,295016
MUSREM.txt,160706,161910,1204,10,N,Y,1448395538701,294934,295016
MUSREM.txt,160723,162036,1313,10,N,Y,1448395538701,294934,295016
MUSREM.txt,160791,162272,1481,10,N,Y,1448395538701,294934,295016
MUSREM.txt,160965,162393,1428,10,N,Y,1448395538701,294934,295016
MUSREM.txt,161063,162417,1354,10,N,Y,1448395538701,294934,295016
MUSREM.txt,161300,162684,1384,10,N,Y,1448395538701,294934,295016
MUSREM.txt,161397,162883,1486,10,N,Y,1448395538701,294934,295016
MUSREM.txt,161426,162947,1521,10,N,Y,1448395538701,294934,295016
MUSREM.txt,161590,163132,1542,10,N,Y,1448395538701,294934,295016
MUSREM.txt,161838,163226,1388,10,N,Y,1448395538701,294934,295016
MUSREM.txt,161911,163446,1535,10,N,Y,1448395538701,294934,295016
MUSREM.txt,162037,163464,1427,10,N,N,-,-1,-1
MUSREM.txt,162273,163512,1239,10,N,N,-,-1,-1
MUSREM.txt,162396,163605,1209,10,N,N,-,-1,-1
MUSREM.txt,162420,163729,1309,10,N,N,-,-1,-1
MUSREM.txt,162686,163873,1187,10,N,N,-,-1,-1
MUSREM.txt,162884,164022,1138,10,N,N,-,-1,-1
MUSREM.txt,162950,164251,1301,10,N,N,-,-1,-1
MUSREM.txt,163133,164287,1154,10,N,N,-,-1,-1
MUSREM.txt,163227,164489,1262,10,N,N,-,-1,-1
MUSREM.txt,163447,164548,1101,10,N,N,-,-1,-1
MUSREM.txt,163465,164761,1296,10,N,N,-,-1,-1
MUSREM.txt,163515,164910,1395,10,N,N,-,-1,-1
MUSREM.txt,163606,165197,1591,10,N,N,-,-1,-1
MUSREM.txt,163730,165439,1709,10,N,N,-,-1,-1
MUSREM.txt,163874,165458,1584,10,N,N,-,-1,-1
MUSREM.txt,164023,165650,1627,10,N,N,-,-1,-1
MUSREM.txt,164252,165794,1542,10,N,N,-,-1,-1
MUSREM.txt,164287,165925,1638,10,N,N,-,-1,-1
MUSREM.txt,164492,166300,1808,10,N,N,-,-1,-1
MUSREM.txt,164551,166399,1848,10,N,N,-,-1,-1
MUSREM.txt,164762,166434,1672,10,N,N,-,-1,-1
MUSREM.txt,164911,166508,1597,10,N,N,-,-1,-1
MUSREM.txt,165200,166698,1498,10,N,N,-,-1,-1
MUSREM.txt,165444,166810,1366,10,N,N,-,-1,-1
MUSREM.txt,165459,166949,1490,10,N,N,-,-1,-1
MUSREM.txt,165651,167297,1646,10,Y,Y,1448396441082,299649,301294
MUSREM.txt,165795,167456,1661,10,Y,Y,1448396441082,299649,301294
MUSREM.txt,165926,167497,1571,10,Y,Y,1448396441082,299649,301294
MUSREM.txt,166301,168024,1723,10,Y,Y,1448396441082,299649,301294
MUSREM.txt,166400,168300,1900,10,Y,Y,1448396441082,299649,301294
MUSREM.txt,166437,168406,1969,10,Y,Y,1448396441082,299649,301294
MUSREM.txt,166511,168423,1912,10,Y,Y,1448396441082,299649,301294
MUSREM.txt,166699,168572,1873,10,Y,Y,1448396441082,299649,301294
MUSREM.txt,166811,168786,1975,10,Y,Y,1448396441082,299649,301294
MUSREM.txt,166950,168997,2047,10,Y,Y,1448396441082,299649,301294
MUSREM.txt,167298,169306,2008,10,Y,Y,1448396441082,299649,301294
MUSREM.txt,167457,169472,2015,10,Y,Y,1448396441082,299649,301294
MUSREM.txt,167498,169634,2136,10,Y,Y,1448396441082,299649,301294
MUSREM.txt,168025,169927,1902,10,Y,N,-,-1,-1
MUSREM.txt,168300,170328,2028,10,Y,N,-,-1,-1
MUSREM.txt,168411,170515,2104,10,Y,N,-,-1,-1
MUSREM.txt,168426,170594,2168,10,Y,Y,1448357928644,234586,234661
MUSREM.txt,168573,170788,2215,10,Y,Y,1448357928644,234586,234661
MUSREM.txt,168787,171044,2257,10,Y,Y,1448357928644,234586,234661
MUSREM.txt,168998,171193,2195,10,Y,Y,1448357928644,234586,234661
MUSREM.txt,169307,171456,2149,10,Y,Y,1448357928644,234586,234661
MUSREM.txt,169473,171536,2063,10,Y,Y,1448357928644,234586,234661
MUSREM.txt,169635,171713,2078,10,Y,Y,1448357928644,234586,234661
MUSREM.txt,169928,171933,2005,10,Y,Y,1448357928644,234586,234661
MUSREM.txt,170329,172112,1783,10,Y,Y,1448357928644,234586,234661
MUSREM.txt,170518,172245,1727,10,Y,Y,1448357928644,234586,234661
MUSREM.txt,170595,172385,1790,10,Y,Y,1448357928644,234586,234661
MUSREM.txt,170789,172421,1632,10,Y,Y,1448357928644,234586,234661
MUSREM.txt,171045,172586,1541,10,Y,Y,1448357928644,234586,234661
MUSREM.txt,171194,172618,1424,10,Y,Y,1448357928644,234586,234661
MUSREM.txt,171457,172679,1222,10,Y,Y,1448357928644,234586,234661
MUSREM.txt,171537,172716,1179,10,Y,Y,1448357928644,234586,234661
MUSREM.txt,171714,172777,1063,10,Y,Y,1448312968013,174511,175025
MUSREM.txt,171935,172934,999,10,Y,Y,1448312968013,174511,175025
MUSREM.txt,172114,173071,957,10,Y,Y,1448312968013,174511,175025
MUSREM.txt,172247,173271,1024,10,Y,Y,1448312968013,174511,175025
MUSREM.txt,172386,173397,1011,10,Y,Y,1448312968013,174511,175025
MUSREM.txt,172422,173577,1155,10,Y,Y,1448312968013,174511,175025
MUSREM.txt,172591,173646,1055,10,Y,Y,1448312968013,174511,175025
MUSREM.txt,172619,173790,1171,10,N,Y,1448312968013,174511,175025
MUSREM.txt,172682,173973,1291,10,N,Y,1448312968013,174511,175025
MUSREM.txt,172717,174093,1376,10,N,Y,1448312968013,174511,175025
MUSREM.txt,172778,174274,1496,10,N,Y,1448312968013,174511,175025
MUSREM.txt,172935,174407,1472,10,N,Y,1448312968013,174511,175025
MUSREM.txt,173072,174633,1561,10,N,Y,1448312968013,174511,175025
MUSREM.txt,173272,174660,1388,10,N,Y,1448312968013,174511,175025
MUSREM.txt,173398,174812,1414,10,Y,Y,1448312968013,174511,175025
MUSREM.txt,173578,174898,1320,10,Y,Y,1448312968013,174511,175025
MUSREM.txt,173647,175111,1464,10,Y,Y,1448312968013,174511,175025
MUSREM.txt,173791,175242,1451,10,Y,N,-,-1,-1
MUSREM.txt,173974,175549,1575,10,Y,N,-,-1,-1
MUSREM.txt,174094,175562,1468,10,Y,N,-,-1,-1
MUSREM.txt,174275,175654,1379,10,Y,N,-,-1,-1
MUSREM.txt,174408,175754,1346,10,Y,N,-,-1,-1
MUSREM.txt,174636,175946,1310,10,Y,Y,1448366833867,275966,276698
MUSREM.txt,174661,176141,1480,10,Y,Y,1448366833867,275966,276698
MUSREM.txt,174815,176327,1512,10,Y,Y,1448366833867,275966,276698
MUSREM.txt,174898,176476,1578,10,Y,Y,1448366833867,275966,276698
MUSREM.txt,175112,176604,1492,10,Y,Y,1448366833867,275966,276698
MUSREM.txt,175244,176804,1560,10,Y,Y,1448366833867,275966,276698
MUSREM.txt,175554,176907,1353,10,N,Y,1448366833867,275966,276698
MUSREM.txt,175563,176980,1417,10,Y,Y,1448366833867,275966,276698
MUSREM.txt,175655,177105,1450,10,Y,Y,1448366833867,275966,276698
MUSREM.txt,175755,177232,1477,10,Y,Y,1448366833867,275966,276698
MUSREM.txt,175947,177635,1688,10,Y,Y,1448315575026,182236,182361
MUSREM.txt,176142,177716,1574,10,Y,Y,1448315575026,182236,182361
MUSREM.txt,176328,177920,1592,10,Y,Y,1448315575026,182236,182361
MUSREM.txt,176477,178129,1652,10,Y,Y,1448315575026,182236,182361
MUSREM.txt,176607,178362,1755,10,Y,Y,1448315575026,182236,182361
MUSREM.txt,176805,178564,1759,10,Y,Y,1448315575026,182236,182361
MUSREM.txt,176908,178691,1783,10,Y,Y,1448315575026,182236,182361
MUSREM.txt,176981,178747,1766,10,Y,Y,1448315575026,182236,182361
MUSREM.txt,177106,179121,2015,10,Y,Y,1448325046337,230539,231128
MUSREM.txt,177233,179283,2050,10,Y,Y,1448325046337,230539,231128
MUSREM.txt,177636,179350,1714,10,Y,Y,1448325046337,230539,231128
MUSREM.txt,177719,179603,1884,10,Y,Y,1448325046337,230539,231128
MUSREM.txt,177921,179790,1869,10,Y,Y,1448325046337,230539,231128
MUSREM.txt,178130,179801,1671,10,Y,Y,1448325046337,230539,231128
MUSREM.txt,178363,179853,1490,10,Y,Y,1448325046337,230539,231128
MUSREM.txt,178566,180037,1471,10,Y,Y,1448325046337,230539,231128
MUSREM.txt,178692,180109,1417,10,Y,Y,1448325046337,230539,231128
MUSREM.txt,178750,180240,1490,10,Y,Y,1448325046337,230539,231128
MUSREM.txt,179122,180368,1246,10,Y,Y,1448325046337,230539,231128
MUSREM.txt,179284,180424,1140,10,Y,Y,1448325046337,230539,231128
MUSREM.txt,179351,180585,1234,10,Y,Y,1448325046337,230539,231128
MUSREM.txt,179605,180792,1187,10,Y,Y,1448325046337,230539,231128
MUSREM.txt,179795,180824,1029,10,Y,Y,1448325046337,230539,231128
MUSREM.txt,179802,180961,1159,10,Y,Y,1448325046337,230539,231128
MUSREM.txt,179854,181184,1330,10,Y,Y,1448325046337,230539,231128
MUSREM.txt,180038,181360,1322,10,Y,Y,1448325046337,230539,231128
MUSREM.txt,180110,181496,1386,10,Y,Y,1448325046337,230539,231128
MUSREM.txt,180241,181799,1558,10,Y,Y,1448325046337,230539,231128
MUSREM.txt,180369,181820,1451,10,N,Y,1448325046337,230539,231128
MUSREM.txt,180427,182006,1579,10,N,Y,1448323254416,230223,230526
MUSREM.txt,180586,182127,1541,10,N,Y,1448323254416,230223,230526
MUSREM.txt,180795,182251,1456,10,N,Y,1448323254416,230223,230526
MUSREM.txt,180824,182543,1719,10,Y,N,-,-1,-1
MUSREM.txt,180962,182681,1719,10,Y,N,-,-1,-1
MUSREM.txt,181187,182769,1582,10,Y,N,-,-1,-1
MUSREM.txt,181361,182819,1458,10,Y,N,-,-1,-1
MUSREM.txt,181499,182954,1455,10,Y,N,-,-1,-1
MUSREM.txt,181804,183110,1306,10,Y,N,-,-1,-1
MUSREM.txt,181823,183216,1393,10,Y,N,-,-1,-1
MUSREM.txt,182007,183287,1280,10,Y,N,-,-1,-1
MUSREM.txt,182129,183432,1303,10,Y,N,-,-1,-1
MUSREM.txt,182252,183482,1230,10,Y,N,-,-1,-1
MUSREM.txt,182543,183661,1118,10,Y,N,-,-1,-1
MUSREM.txt,182682,183825,1143,10,N,N,-,-1,-1
MUSREM.txt,182774,184174,1400,10,N,N,-,-1,-1
MUSREM.txt,182820,184414,1594,10,Y,N,-,-1,-1
MUSREM.txt,182955,184644,1689,10,Y,N,-,-1,-1
MUSREM.txt,183112,184836,1724,10,Y,N,-,-1,-1
MUSREM.txt,183217,184944,1727,10,Y,N,-,-1,-1
MUSREM.txt,183289,185007,1718,10,N,N,-,-1,-1
MUSREM.txt,183433,185272,1839,10,N,N,-,-1,-1
MUSREM.txt,183485,185568,2083,10,Y,N,-,-1,-1
MUSREM.txt,183662,185664,2002,10,Y,N,-,-1,-1
MUSREM.txt,183826,185905,2079,10,Y,N,-,-1,-1
MUSREM.txt,184175,186188,2013,10,Y,N,-,-1,-1
MUSREM.txt,184415,186322,1907,10,Y,N,-,-1,-1
MUSREM.txt,184644,186440,1796,10,Y,N,-,-1,-1
MUSREM.txt,184841,186538,1697,10,N,N,-,-1,-1
MUSREM.txt,184945,187268,2323,10,N,N,-,-1,-1
MUSREM.txt,185008,187413,2405,10,N,N,-,-1,-1
MUSREM.txt,185273,187635,2362,10,Y,N,-,-1,-1
MUSREM.txt,185569,188054,2485,10,N,N,-,-1,-1
MUSREM.txt,185665,188077,2412,10,N,N,-,-1,-1
MUSREM.txt,185906,188254,2348,10,N,N,-,-1,-1
MUSREM.txt,186190,188446,2256,10,N,N,-,-1,-1
MUSREM.txt,186325,188651,2326,10,N,N,-,-1,-1
MUSREM.txt,186441,188898,2457,10,N,N,-,-1,-1
MUSREM.txt,186539,188973,2434,10,N,N,-,-1,-1
MUSREM.txt,187269,189530,2261,10,N,N,-,-1,-1
MUSREM.txt,187414,189671,2257,10,N,N,-,-1,-1
MUSREM.txt,187636,189788,2152,10,N,N,-,-1,-1
MUSREM.txt,188059,189827,1768,10,N,N,-,-1,-1
MUSREM.txt,188078,190008,1930,10,N,N,-,-1,-1
MUSREM.txt,188255,190098,1843,10,N,N,-,-1,-1
MUSREM.txt,188448,190256,1808,10,N,N,-,-1,-1
MUSREM.txt,188652,190279,1627,10,N,N,-,-1,-1
MUSREM.txt,188899,190299,1400,10,N,N,-,-1,-1
MUSREM.txt,188974,190502,1528,10,N,N,-,-1,-1
MUSREM.txt,189531,190618,1087,10,N,N,-,-1,-1
MUSREM.txt,189672,190870,1198,10,N,N,-,-1,-1
MUSREM.txt,189790,191034,1244,10,N,N,-,-1,-1
MUSREM.txt,189828,191323,1495,10,N,N,-,-1,-1
MUSREM.txt,190009,191620,1611,10,N,N,-,-1,-1
MUSREM.txt,190099,191695,1596,10,N,N,-,-1,-1
MUSREM.txt,190261,191731,1470,10,N,N,-,-1,-1
MUSREM.txt,190280,191876,1596,10,N,N,-,-1,-1
MUSREM.txt,190300,192007,1707,10,N,N,-,-1,-1
MUSREM.txt,190503,192133,1630,10,N,N,-,-1,-1
MUSREM.txt,190619,192302,1683,10,N,N,-,-1,-1
MUSREM.txt,190871,192325,1454,10,N,N,-,-1,-1
MUSREM.txt,191035,192655,1620,10,N,N,-,-1,-1
MUSREM.txt,191323,192770,1447,10,N,N,-,-1,-1
MUSREM.txt,191621,193212,1591,10,N,N,-,-1,-1
MUSREM.txt,191696,193394,1698,10,N,N,-,-1,-1
MUSREM.txt,191732,193568,1836,10,N,N,-,-1,-1
MUSREM.txt,191879,193925,2046,10,N,N,-,-1,-1
MUSREM.txt,192010,194218,2208,10,N,N,-,-1,-1
MUSREM.txt,192134,194476,2342,10,N,N,-,-1,-1
MUSREM.txt,192307,194499,2192,10,N,N,-,-1,-1
MUSREM.txt,192326,194685,2359,10,N,N,-,-1,-1
MUSREM.txt,192656,195087,2431,10,N,N,-,-1,-1
MUSREM.txt,192771,195329,2558,10,N,N,-,-1,-1
MUSREM.txt,193215,195487,2272,10,N,N,-,-1,-1
MUSREM.txt,193395,195573,2178,10,N,N,-,-1,-1
MUSREM.txt,193568,196002,2434,10,N,N,-,-1,-1
MUSREM.txt,193926,196149,2223,10,N,N,-,-1,-1
MUSREM.txt,194221,196244,2023,10,N,N,-,-1,-1
MUSREM.txt,194481,196325,1844,10,N,N,-,-1,-1
MUSREM.txt,194500,196606,2106,10,N,N,-,-1,-1
MUSREM.txt,194687,196618,1931,10,N,N,-,-1,-1
MUSREM.txt,195089,197096,2007,10,Y,N,-,-1,-1
MUSREM.txt,195330,197237,1907,10,Y,N,-,-1,-1
MUSREM.txt,195489,197463,1974,10,Y,N,-,-1,-1
MUSREM.txt,195574,197657,2083,10,Y,N,-,-1,-1
MUSREM.txt,196005,197694,1689,10,Y,N,-,-1,-1
MUSREM.txt,196150,197917,1767,10,N,N,-,-1,-1
MUSREM.txt,196245,198199,1954,10,Y,Y,1448039123601,19678,19935
MUSREM.txt,196326,198376,2050,10,Y,Y,1448039123601,19678,19935
MUSREM.txt,196611,198497,1886,10,N,Y,1448039123601,19678,19935
MUSREM.txt,196619,198634,2015,10,Y,Y,1448039123601,19678,19935
MUSREM.txt,197097,198741,1644,10,N,Y,1448039123601,19678,19935
MUSREM.txt,197238,198758,1520,10,N,Y,1448039123601,19678,19935
MUSREM.txt,197464,198983,1519,10,N,Y,1448039123601,19678,19935
MUSREM.txt,197658,199098,1440,10,N,Y,1448039123601,19678,19935
MUSREM.txt,197697,199278,1581,10,N,Y,1448039123601,19678,19935
MUSREM.txt,197920,199394,1474,10,N,Y,1448039123601,19678,19935
MUSREM.txt,198200,199499,1299,10,Y,Y,1448039123601,19678,19935
MUSREM.txt,198377,199657,1280,10,Y,Y,1448039123601,19678,19935
MUSREM.txt,198498,199785,1287,10,Y,Y,1448039123601,19678,19935
MUSREM.txt,198635,199801,1166,10,N,Y,1448039123601,19678,19935
MUSREM.txt,198742,200019,1277,10,N,Y,1448039123601,19678,19935
MUSREM.txt,198759,200516,1757,10,N,Y,1448039123601,19678,19935
MUSREM.txt,198985,200574,1589,10,N,Y,1448285563397,102964,108476
MUSREM.txt,199099,200659,1560,10,N,Y,1448285563397,102964,108476
MUSREM.txt,199279,201026,1747,10,N,Y,1448285563397,102964,108476
MUSREM.txt,199396,201123,1727,10,N,Y,1448285563397,102964,108476
MUSREM.txt,199500,201358,1858,10,Y,Y,1448285563397,102964,108476
MUSREM.txt,199658,201550,1892,10,Y,Y,1448285563397,102964,108476
MUSREM.txt,199790,201644,1854,10,Y,Y,1448285563397,102964,108476
MUSREM.txt,199804,201758,1954,10,Y,Y,1448285563397,102964,108476
MUSREM.txt,200020,201906,1886,10,Y,Y,1448285563397,102964,108476
MUSREM.txt,200519,201935,1416,10,Y,Y,1448285563397,102964,108476
MUSREM.txt,200575,202011,1436,10,Y,Y,1448285563397,102964,108476
MUSREM.txt,200660,202082,1422,10,Y,Y,1448285563397,102964,108476
MUSREM.txt,201027,202219,1192,10,Y,Y,1448285563397,102964,108476
MUSREM.txt,201124,202330,1206,10,Y,Y,1448285563397,102964,108476
MUSREM.txt,201361,202487,1126,10,N,N,-,-1,-1
MUSREM.txt,201551,202600,1049,10,N,N,-,-1,-1
MUSREM.txt,201645,202787,1142,10,N,N,-,-1,-1
MUSREM.txt,201759,202964,1205,10,N,N,-,-1,-1
MUSREM.txt,201907,202983,1076,10,N,N,-,-1,-1
MUSREM.txt,201938,203079,1141,10,N,N,-,-1,-1
MUSREM.txt,202012,203104,1092,10,N,N,-,-1,-1
MUSREM.txt,202083,203184,1101,10,N,N,-,-1,-1
MUSREM.txt,202220,203264,1044,10,N,N,-,-1,-1
MUSREM.txt,202332,203501,1169,10,N,N,-,-1,-1
MUSREM.txt,202487,203680,1193,10,Y,N,-,-1,-1
MUSREM.txt,202603,203885,1282,10,Y,N,-,-1,-1
MUSREM.txt,202788,203897,1109,10,Y,N,-,-1,-1
MUSREM.txt,202966,203913,947,10,Y,N,-,-1,-1
MUSREM.txt,202988,204072,1084,10,Y,N,-,-1,-1
MUSREM.txt,203080,204186,1106,10,Y,N,-,-1,-1
MUSREM.txt,203105,204462,1357,10,Y,N,-,-1,-1
MUSREM.txt,203185,204478,1293,10,N,N,-,-1,-1
MUSREM.txt,203266,204505,1239,10,N,N,-,-1,-1
MUSREM.txt,203502,204541,1039,10,N,N,-,-1,-1
MUSREM.txt,203681,204625,944,10,N,N,-,-1,-1
MUSREM.txt,203888,205052,1164,10,N,N,-,-1,-1
MUSREM.txt,203902,205178,1276,10,N,N,-,-1,-1
MUSREM.txt,203918,205408,1490,10,N,N,-,-1,-1
MUSREM.txt,204073,205567,1494,10,N,N,-,-1,-1
MUSREM.txt,204187,205615,1428,10,N,N,-,-1,-1
MUSREM.txt,204467,205840,1373,10,N,N,-,-1,-1
MUSREM.txt,204483,206119,1636,10,N,N,-,-1,-1
MUSREM.txt,204508,206250,1742,10,N,N,-,-1,-1
MUSREM.txt,204542,206407,1865,10,N,N,-,-1,-1
MUSREM.txt,204628,206475,1847,10,N,N,-,-1,-1
MUSREM.txt,205053,206598,1545,10,Y,N,-,-1,-1
MUSREM.txt,205181,206685,1504,10,N,N,-,-1,-1
MUSREM.txt,205409,206945,1536,10,N,N,-,-1,-1
MUSREM.txt,205568,207058,1490,10,N,N,-,-1,-1
MUSREM.txt,205616,207141,1525,10,N,N,-,-1,-1
MUSREM.txt,205841,207226,1385,10,N,N,-,-1,-1
MUSREM.txt,206120,207306,1186,10,N,Y,1448314861876,180438,180657
MUSREM.txt,206251,207518,1267,10,N,Y,1448314861876,180438,180657
MUSREM.txt,206408,207573,1165,10,N,Y,1448314861876,180438,180657
MUSREM.txt,206478,207756,1278,10,N,Y,1448314861876,180438,180657
MUSREM.txt,206599,207781,1182,10,N,Y,1448314861876,180438,180657
MUSREM.txt,206686,207984,1298,10,N,Y,1448314861876,180438,180657
MUSREM.txt,206946,208014,1068,10,N,Y,1448314861876,180438,180657
MUSREM.txt,207059,208059,1000,10,N,Y,1448314861876,180438,180657
MUSREM.txt,207142,208180,1038,10,N,Y,1448314861876,180438,180657
MUSREM.txt,207227,208300,1073,10,N,Y,1448314861876,180438,180657
MUSREM.txt,207309,208357,1048,10,N,Y,1448314861876,180438,180657
MUSREM.txt,207519,208487,968,10,N,Y,1448314861876,180438,180657
MUSREM.txt,207574,208635,1061,10,N,Y,1448314861876,180438,180657
MUSREM.txt,207757,208766,1009,10,N,Y,1448314861876,180438,180657
MUSREM.txt,207782,208884,1102,10,N,Y,1448314861876,180438,180657
MUSREM.txt,207985,209009,1024,10,N,Y,1448314861876,180438,180657
MUSREM.txt,208015,209169,1154,10,N,Y,1448314861876,180438,180657
MUSREM.txt,208060,209281,1221,10,N,Y,1448314861876,180438,180657
MUSREM.txt,208181,209324,1143,10,N,Y,1448314861876,180438,180657
MUSREM.txt,208302,209394,1092,10,N,N,-,-1,-1
MUSREM.txt,208358,209553,1195,10,N,N,-,-1,-1
MUSREM.txt,208488,209735,1247,10,N,N,-,-1,-1
MUSREM.txt,208637,209873,1236,10,N,N,-,-1,-1
MUSREM.txt,208768,209964,1196,10,N,N,-,-1,-1
MUSREM.txt,208885,210181,1296,10,N,N,-,-1,-1
MUSREM.txt,209012,210243,1231,10,N,N,-,-1,-1
MUSREM.txt,209170,210323,1153,10,N,N,-,-1,-1
MUSREM.txt,209284,210398,1114,10,N,Y,1448281888079,98877,102290
MUSREM.txt,209325,210573,1248,10,N,Y,1448281888079,98877,102290
MUSREM.txt,209397,210660,1263,10,N,Y,1448281888079,98877,102290
MUSREM.txt,209556,210943,1387,10,N,Y,1448281888079,98877,102290
MUSREM.txt,209736,211122,1386,10,N,Y,1448281888079,98877,102290
MUSREM.txt,209874,211431,1557,10,Y,Y,1448281888079,98877,102290
MUSREM.txt,209965,211487,1522,10,N,Y,1448281888079,98877,102290
MUSREM.txt,210182,211657,1475,10,N,Y,1448281888079,98877,102290
MUSREM.txt,210244,211753,1509,10,Y,Y,1448281888079,98877,102290
MUSREM.txt,210324,211789,1465,10,Y,Y,1448281888079,98877,102290
MUSREM.txt,210399,212091,1692,10,Y,Y,1448281888079,98877,102290
MUSREM.txt,210574,212193,1619,10,Y,Y,1448314402792,179959,180202
MUSREM.txt,210661,212365,1704,10,Y,Y,1448314402792,179959,180202
MUSREM.txt,210944,212539,1595,10,Y,Y,1448322713112,221941,223038
MUSREM.txt,211123,212599,1476,10,Y,Y,1448322713112,221941,223038
MUSREM.txt,211432,212853,1421,10,N,Y,1448322713112,221941,223038
MUSREM.txt,211490,212925,1435,10,N,Y,1448322713112,221941,223038
MUSREM.txt,211658,213066,1408,10,N,Y,1448322713112,221941,223038
MUSREM.txt,211754,213067,1313,10,N,Y,1448322713112,221941,223038
MUSREM.txt,211792,213196,1404,10,N,Y,1448322713112,221941,223038
MUSREM.txt,212092,213406,1314,10,Y,Y,1448281491382,97818,98860
MUSREM.txt,212194,213603,1409,10,Y,Y,1448281491382,97818,98860
MUSREM.txt,212366,213659,1293,10,Y,Y,1448281491382,97818,98860
MUSREM.txt,212542,213814,1272,10,Y,Y,1448281491382,97818,98860
MUSREM.txt,212600,213909,1309,10,Y,Y,1448281491382,97818,98860
MUSREM.txt,212855,214058,1203,10,Y,Y,1448281491382,97818,98860
MUSREM.txt,212926,214198,1272,10,Y,Y,1448281491382,97818,98860
MUSREM.txt,213066,214273,1207,10,Y,Y,1448281491382,97818,98860
MUSREM.txt,213068,214418,1350,10,Y,Y,1448281491382,97818,98860
MUSREM.txt,213197,214624,1427,10,Y,Y,1448281491382,97818,98860
MUSREM.txt,213407,214856,1449,10,Y,Y,1448281491382,97818,98860
MUSREM.txt,213606,214975,1369,10,Y,Y,1448281491382,97818,98860
MUSREM.txt,213660,215058,1398,10,Y,Y,1448358806100,240524,240915
MUSREM.txt,213817,215272,1455,10,Y,Y,1448358806100,240524,240915
MUSREM.txt,213910,215388,1478,10,Y,Y,1448358806100,240524,240915
MUSREM.txt,214059,215590,1531,10,Y,Y,1437472966198,394609,395892
MUSREM.txt,214199,215619,1420,10,Y,Y,1437472966198,394609,395892
MUSREM.txt,214274,215768,1494,10,Y,Y,1437472966198,394609,395892
MUSREM.txt,214419,215808,1389,10,Y,Y,1437472966198,394609,395892
MUSREM.txt,214625,215961,1336,10,Y,Y,1437472966198,394609,395892
MUSREM.txt,214857,216140,1283,10,Y,Y,1437472966198,394609,395892
MUSREM.txt,214976,216358,1382,10,Y,Y,1437472966198,394609,395892
MUSREM.txt,215059,216430,1371,10,Y,Y,1437472966198,394609,395892
MUSREM.txt,215273,216555,1282,10,Y,Y,1437472966198,394609,395892
MUSREM.txt,215391,216651,1260,10,Y,Y,1437472966198,394609,395892
MUSREM.txt,215591,216662,1071,10,Y,Y,1437472966198,394609,395892
MUSREM.txt,215622,216803,1181,10,Y,Y,1437472966198,394609,395892
MUSREM.txt,215770,217023,1253,10,N,Y,1437472966198,394609,395892
MUSREM.txt,215809,217173,1364,10,Y,Y,1437472966198,394609,395892
MUSREM.txt,215962,217214,1252,10,Y,Y,1437472966198,394609,395892
MUSREM.txt,216142,217296,1154,10,Y,Y,1448367229258,278623,278697
MUSREM.txt,216359,217455,1096,10,Y,N,-,-1,-1
MUSREM.txt,216433,217595,1162,10,Y,N,-,-1,-1
MUSREM.txt,216556,217744,1188,10,Y,Y,1448281320115,89144,91129
MUSREM.txt,216656,217817,1161,10,Y,Y,1448281320115,89144,91129
MUSREM.txt,216663,217929,1266,10,Y,Y,1448281320115,89144,91129
MUSREM.txt,216805,218074,1269,10,Y,Y,1448281320115,89144,91129
MUSREM.txt,217024,218106,1082,10,Y,Y,1448281320115,89144,91129
MUSREM.txt,217175,218246,1071,10,N,Y,1448281320115,89144,91129
MUSREM.txt,217215,218379,1164,10,Y,Y,1448281320115,89144,91129
MUSREM.txt,217297,218571,1274,10,Y,Y,1448281320115,89144,91129
MUSREM.txt,217456,218693,1237,10,Y,Y,1448281320115,89144,91129
MUSREM.txt,217596,218761,1165,10,Y,Y,1448281320115,89144,91129
MUSREM.txt,217747,218864,1117,10,Y,Y,1448281320115,89144,91129
MUSREM.txt,217818,218902,1084,10,N,Y,1448281320115,89144,91129
MUSREM.txt,217930,219047,1117,10,N,Y,1448280884746,88496,89294
MUSREM.txt,218075,219188,1113,10,Y,Y,1448280884746,88496,89294
MUSREM.txt,218107,219385,1278,10,Y,Y,1448280884746,88496,89294
MUSREM.txt,218247,219560,1313,10,Y,Y,1448312844411,173573,174472
MUSREM.txt,218382,219607,1225,10,Y,Y,1448312844411,173573,174472
MUSREM.txt,218572,219776,1204,10,N,Y,1448312844411,173573,174472
MUSREM.txt,218695,219881,1186,10,N,Y,1448312844411,173573,174472
MUSREM.txt,218762,220119,1357,10,Y,Y,1448312844411,173573,174472
MUSREM.txt,218865,220223,1358,10,Y,Y,1448312844411,173573,174472
MUSREM.txt,218904,220292,1388,10,Y,Y,1448312844411,173573,174472
MUSREM.txt,219048,220431,1383,10,Y,Y,1448312844411,173573,174472
MUSREM.txt,219189,220592,1403,10,Y,Y,1448312844411,173573,174472
MUSREM.txt,219386,220755,1369,10,Y,Y,1448312844411,173573,174472
MUSREM.txt,219561,220792,1231,10,Y,Y,1448312844411,173573,174472
MUSREM.txt,219608,220933,1325,10,Y,Y,1448312844411,173573,174472
MUSREM.txt,219779,221079,1300,10,Y,Y,1448312844411,173573,174472
MUSREM.txt,219882,221279,1397,10,Y,Y,1448312844411,173573,174472
MUSREM.txt,220120,221435,1315,10,Y,Y,1448312844411,173573,174472
MUSREM.txt,220225,221580,1355,10,Y,Y,1448312844411,173573,174472
MUSREM.txt,220293,221611,1318,10,Y,Y,1448312844411,173573,174472
MUSREM.txt,220432,221808,1376,10,Y,Y,1448312844411,173573,174472
MUSREM.txt,220593,221849,1256,10,Y,Y,1448312844411,173573,174472
MUSREM.txt,220756,221988,1232,10,Y,Y,1448312844411,173573,174472
MUSREM.txt,220793,222180,1387,10,Y,Y,1448312844411,173573,174472
MUSREM.txt,220935,222353,1418,10,Y,N,-,-1,-1
MUSREM.txt,221080,222690,1610,10,Y,N,-,-1,-1
MUSREM.txt,221281,222815,1534,10,Y,N,-,-1,-1
MUSREM.txt,221436,222839,1403,10,Y,N,-,-1,-1
MUSREM.txt,221581,222892,1311,10,Y,N,-,-1,-1
MUSREM.txt,221614,223164,1550,10,Y,N,-,-1,-1
MUSREM.txt,221809,223344,1535,10,Y,N,-,-1,-1
MUSREM.txt,221852,223672,1820,10,Y,N,-,-1,-1
MUSREM.txt,221990,223920,1930,10,Y,N,-,-1,-1
MUSREM.txt,222183,224036,1853,10,Y,N,-,-1,-1
MUSREM.txt,222354,224162,1808,10,Y,N,-,-1,-1
MUSREM.txt,222691,224506,1815,10,Y,N,-,-1,-1
MUSREM.txt,222816,224616,1800,10,Y,N,-,-1,-1
MUSREM.txt,222840,224823,1983,10,Y,N,-,-1,-1
MUSREM.txt,222893,224888,1995,10,Y,N,-,-1,-1
MUSREM.txt,223165,224925,1760,10,N,N,-,-1,-1
MUSREM.txt,223345,225067,1722,10,N,N,-,-1,-1
MUSREM.txt,223674,225098,1424,10,N,N,-,-1,-1
MUSREM.txt,223923,225280,1357,10,N,N,-,-1,-1
MUSREM.txt,224037,225402,1365,10,N,N,-,-1,-1
MUSREM.txt,224163,225632,1469,10,Y,N,-,-1,-1
MUSREM.txt,224507,225781,1274,10,Y,N,-,-1,-1
MUSREM.txt,224617,225965,1348,10,Y,N,-,-1,-1
MUSREM.txt,224826,225981,1155,10,Y,N,-,-1,-1
MUSREM.txt,224889,226431,1542,10,Y,N,-,-1,-1
MUSREM.txt,224926,226677,1751,10,Y,N,-,-1,-1
MUSREM.txt,225068,226899,1831,10,Y,N,-,-1,-1
MUSREM.txt,225100,226975,1875,10,Y,N,-,-1,-1
MUSREM.txt,225283,226999,1716,10,Y,N,-,-1,-1
MUSREM.txt,225403,227135,1732,10,Y,N,-,-1,-1
MUSREM.txt,225635,227300,1665,10,Y,N,-,-1,-1
MUSREM.txt,225782,227444,1662,10,Y,N,-,-1,-1
MUSREM.txt,225968,227662,1694,10,Y,N,-,-1,-1
MUSREM.txt,225982,227935,1953,10,Y,N,-,-1,-1
MUSREM.txt,226432,228040,1608,10,Y,N,-,-1,-1
MUSREM.txt,226678,228079,1401,10,N,N,-,-1,-1
MUSREM.txt,226900,228280,1380,10,N,N,-,-1,-1
MUSREM.txt,226976,228395,1419,10,N,N,-,-1,-1
MUSREM.txt,227000,228631,1631,10,N,N,-,-1,-1
MUSREM.txt,227136,228789,1653,10,N,N,-,-1,-1
MUSREM.txt,227301,228943,1642,10,N,N,-,-1,-1
MUSREM.txt,227445,229081,1636,10,N,N,-,-1,-1
MUSREM.txt,227663,229361,1698,10,N,N,-,-1,-1
MUSREM.txt,227938,229444,1506,10,N,N,-,-1,-1
MUSREM.txt,228043,229775,1732,10,N,N,-,-1,-1
MUSREM.txt,228080,229870,1790,10,N,N,-,-1,-1
MUSREM.txt,228281,229992,1711,10,N,N,-,-1,-1
MUSREM.txt,228397,230019,1622,10,N,N,-,-1,-1
MUSREM.txt,228632,230211,1579,10,N,N,-,-1,-1
MUSREM.txt,228790,230246,1456,10,N,N,-,-1,-1
MUSREM.txt,228944,230254,1310,10,N,N,-,-1,-1
MUSREM.txt,229082,230305,1223,10,N,N,-,-1,-1
MUSREM.txt,229361,230566,1205,10,N,N,-,-1,-1
MUSREM.txt,229447,230781,1334,10,N,N,-,-1,-1
MUSREM.txt,229776,230994,1218,10,N,N,-,-1,-1
MUSREM.txt,229872,231020,1148,10,N,N,-,-1,-1
MUSREM.txt,229993,231172,1179,10,N,N,-,-1,-1
MUSREM.txt,230020,231253,1233,10,N,N,-,-1,-1
MUSREM.txt,230216,231363,1147,10,N,N,-,-1,-1
MUSREM.txt,230249,231568,1319,10,N,N,-,-1,-1
MUSREM.txt,230256,231719,1463,10,N,N,-,-1,-1
MUSREM.txt,230308,231925,1617,10,N,N,-,-1,-1
MUSREM.txt,230567,232071,1504,10,N,N,-,-1,-1
MUSREM.txt,230782,232252,1470,10,N,N,-,-1,-1
MUSREM.txt,230999,232412,1413,10,N,N,-,-1,-1
MUSREM.txt,231021,232558,1537,10,N,N,-,-1,-1
MUSREM.txt,231173,232827,1654,10,N,N,-,-1,-1
MUSREM.txt,231255,232956,1701,10,N,N,-,-1,-1
MUSREM.txt,231364,233065,1701,10,N,N,-,-1,-1
MUSREM.txt,231569,233116,1547,10,N,N,-,-1,-1
MUSREM.txt,231722,233319,1597,10,N,N,-,-1,-1
MUSREM.txt,231926,233512,1586,10,N,N,-,-1,-1
MUSREM.txt,232072,233809,1737,10,N,N,-,-1,-1
MUSREM.txt,232253,233888,1635,10,N,N,-,-1,-1
MUSREM.txt,232415,233939,1524,10,N,N,-,-1,-1
MUSREM.txt,232559,234068,1509,10,N,N,-,-1,-1
MUSREM.txt,232829,234572,1743,10,N,N,-,-1,-1
MUSREM.txt,232957,234791,1834,10,N,N,-,-1,-1
MUSREM.txt,233066,234966,1900,10,N,N,-,-1,-1
MUSREM.txt,233117,235124,2007,10,N,N,-,-1,-1
MUSREM.txt,233320,235245,1925,10,N,N,-,-1,-1
MUSREM.txt,233513,235298,1785,10,N,N,-,-1,-1
MUSREM.txt,233810,235626,1816,10,N,N,-,-1,-1
MUSREM.txt,233889,235862,1973,10,N,N,-,-1,-1
MUSREM.txt,233941,236099,2158,10,N,N,-,-1,-1
MUSREM.txt,234069,236236,2167,10,N,N,-,-1,-1
MUSREM.txt,234573,236368,1795,10,N,N,-,-1,-1
MUSREM.txt,234792,236481,1689,10,N,N,-,-1,-1
MUSREM.txt,234968,236593,1625,10,N,N,-,-1,-1
MUSREM.txt,235127,236794,1667,10,N,N,-,-1,-1
MUSREM.txt,235248,236914,1666,10,N,N,-,-1,-1
MUSREM.txt,235299,237056,1757,10,N,N,-,-1,-1
MUSREM.txt,235627,237105,1478,10,N,N,-,-1,-1
MUSREM.txt,235863,237224,1361,10,N,N,-,-1,-1
MUSREM.txt,236100,237468,1368,10,N,N,-,-1,-1
MUSREM.txt,236237,237480,1243,10,N,N,-,-1,-1
MUSREM.txt,236369,237657,1288,10,N,N,-,-1,-1
MUSREM.txt,236482,237898,1416,10,N,N,-,-1,-1
MUSREM.txt,236594,238036,1442,10,N,N,-,-1,-1
MUSREM.txt,236795,238230,1435,10,N,N,-,-1,-1
MUSREM.txt,236915,238329,1414,10,N,N,-,-1,-1
MUSREM.txt,237057,238562,1505,10,Y,N,-,-1,-1
MUSREM.txt,237106,238716,1610,10,Y,N,-,-1,-1
MUSREM.txt,237226,238850,1624,10,Y,N,-,-1,-1
MUSREM.txt,237469,238917,1448,10,Y,N,-,-1,-1
MUSREM.txt,237481,239079,1598,10,Y,N,-,-1,-1
MUSREM.txt,237659,239237,1578,10,Y,N,-,-1,-1
MUSREM.txt,237899,239594,1695,10,Y,Y,1448369582981,281838,282369
MUSREM.txt,238039,239679,1640,10,Y,Y,1448369582981,281838,282369
MUSREM.txt,238231,239755,1524,10,Y,Y,1448369582981,281838,282369
MUSREM.txt,238330,239898,1568,10,Y,Y,1448369582981,281838,282369
MUSREM.txt,238563,240082,1519,10,Y,Y,1448369582981,281838,282369
MUSREM.txt,238717,240125,1408,10,Y,Y,1448369582981,281838,282369
MUSREM.txt,238851,240283,1432,10,Y,Y,1448369582981,281838,282369
MUSREM.txt,238918,240292,1374,10,N,Y,1448369582981,281838,282369
MUSREM.txt,239080,240298,1218,10,N,Y,1448369582981,281838,282369
MUSREM.txt,239239,240335,1096,10,N,Y,1448369582981,281838,282369
MUSREM.txt,239595,240346,751,10,N,Y,1448369582981,281838,282369
MUSREM.txt,239680,240348,668,10,N,Y,1448369582981,281838,282369
MUSREM.txt,239756,240365,609,10,N,Y,1448369582981,281838,282369
MUSREM.txt,239899,240367,468,10,N,N,-,-1,-1
MUSREM.txt,240083,240427,344,10,N,N,-,-1,-1
MUSREM.txt,240126,240429,303,10,N,N,-,-1,-1
MUSREM.txt,240283,240484,201,10,N,N,-,-1,-1
MUSREM.txt,240293,240646,353,10,N,N,-,-1,-1
MUSREM.txt,240301,240822,521,10,N,N,-,-1,-1
MUSREM.txt,240338,240939,601,10,N,N,-,-1,-1
MUSREM.txt,240347,241044,697,10,N,N,-,-1,-1
MUSREM.txt,240349,241366,1017,10,Y,N,-,-1,-1
MUSREM.txt,240366,241562,1196,10,Y,N,-,-1,-1
MUSREM.txt,240368,241629,1261,10,Y,N,-,-1,-1
MUSREM.txt,240428,241752,1324,10,Y,N,-,-1,-1
MUSREM.txt,240430,241840,1410,10,Y,N,-,-1,-1
MUSREM.txt,240489,242193,1704,10,Y,N,-,-1,-1
MUSREM.txt,240647,242343,1696,10,Y,N,-,-1,-1
MUSREM.txt,240823,242448,1625,10,Y,N,-,-1,-1
MUSREM.txt,240940,242560,1620,10,Y,N,-,-1,-1
MUSREM.txt,241046,242793,1747,10,Y,N,-,-1,-1
MUSREM.txt,241367,243017,1650,10,Y,N,-,-1,-1
MUSREM.txt,241563,243172,1609,10,Y,N,-,-1,-1
MUSREM.txt,241630,243361,1731,10,Y,N,-,-1,-1
MUSREM.txt,241754,243462,1708,10,N,N,-,-1,-1
MUSREM.txt,241842,243629,1787,10,N,N,-,-1,-1
MUSREM.txt,242195,243701,1506,10,N,N,-,-1,-1
MUSREM.txt,242344,243896,1552,10,N,N,-,-1,-1
MUSREM.txt,242449,244236,1787,10,N,N,-,-1,-1
MUSREM.txt,242561,244363,1802,10,N,N,-,-1,-1
MUSREM.txt,242794,244475,1681,10,N,N,-,-1,-1
MUSREM.txt,243018,244952,1934,10,N,N,-,-1,-1
MUSREM.txt,243174,245114,1940,10,Y,N,-,-1,-1
MUSREM.txt,243363,245349,1986,10,Y,N,-,-1,-1
MUSREM.txt,243463,245592,2129,10,Y,N,-,-1,-1
MUSREM.txt,243630,245763,2133,10,Y,N,-,-1,-1
MUSREM.txt,243702,245871,2169,10,Y,N,-,-1,-1
MUSREM.txt,243897,246132,2235,10,Y,N,-,-1,-1
MUSREM.txt,244239,246182,1943,10,Y,N,-,-1,-1
MUSREM.txt,244365,246702,2337,10,Y,N,-,-1,-1
MUSREM.txt,244476,246867,2391,10,Y,N,-,-1,-1
MUSREM.txt,244953,246910,1957,10,Y,N,-,-1,-1
MUSREM.txt,245115,247003,1888,10,N,N,-,-1,-1
MUSREM.txt,245350,247363,2013,10,N,N,-,-1,-1
MUSREM.txt,245593,247453,1860,10,N,N,-,-1,-1
MUSREM.txt,245764,247622,1858,10,N,N,-,-1,-1
MUSREM.txt,245872,247780,1908,10,N,N,-,-1,-1
MUSREM.txt,246132,247966,1834,10,N,N,-,-1,-1
MUSREM.txt,246183,248053,1870,10,N,N,-,-1,-1
MUSREM.txt,246705,248146,1441,10,N,N,-,-1,-1
MUSREM.txt,246868,248250,1382,10,N,N,-,-1,-1
MUSREM.txt,246911,248403,1492,10,N,N,-,-1,-1
MUSREM.txt,247006,248572,1566,10,N,N,-,-1,-1
MUSREM.txt,247364,248729,1365,10,N,N,-,-1,-1
MUSREM.txt,247454,248829,1375,10,N,N,-,-1,-1
MUSREM.txt,247624,249173,1549,10,N,Y,1448658736891,316691,317030
MUSREM.txt,247781,249238,1457,10,N,Y,1448658736891,316691,317030
MUSREM.txt,247968,249506,1538,10,N,Y,1448658736891,316691,317030
MUSREM.txt,248054,249530,1476,10,N,Y,1448658736891,316691,317030
MUSREM.txt,248147,249679,1532,10,N,Y,1448658736891,316691,317030
MUSREM.txt,248251,249846,1595,10,N,Y,1448658736891,316691,317030
MUSREM.txt,248406,250390,1984,10,Y,Y,1448658736891,316691,317030
MUSREM.txt,248573,250510,1937,10,Y,Y,1448322095209,213778,214023
MUSREM.txt,248730,250704,1974,10,N,Y,1448322095209,213778,214023
MUSREM.txt,248832,250854,2022,10,Y,Y,1448322095209,213778,214023
MUSREM.txt,249174,250884,1710,10,Y,Y,1448322095209,213778,214023
MUSREM.txt,249239,251013,1774,10,Y,Y,1448322095209,213778,214023
MUSREM.txt,249507,251084,1577,10,N,Y,1448322095209,213778,214023
MUSREM.txt,249531,251247,1716,10,Y,Y,1448322095209,213778,214023
MUSREM.txt,249682,251312,1630,10,Y,Y,1448322095209,213778,214023
MUSREM.txt,249847,251396,1549,10,Y,Y,1448322095209,213778,214023
MUSREM.txt,250391,251480,1089,10,N,Y,1448322095209,213778,214023
MUSREM.txt,250511,251523,1012,10,N,Y,1448322095209,213778,214023
MUSREM.txt,250706,251768,1062,10,N,Y,1448322095209,213778,214023
MUSREM.txt,250855,251864,1009,10,N,N,-,-1,-1
MUSREM.txt,250885,251881,996,10,N,N,-,-1,-1
MUSREM.txt,251014,252004,990,10,N,N,-,-1,-1
MUSREM.txt,251085,252240,1155,10,N,N,-,-1,-1
MUSREM.txt,251248,252380,1132,10,N,N,-,-1,-1
MUSREM.txt,251313,252598,1285,10,N,N,-,-1,-1
MUSREM.txt,251397,252746,1349,10,N,N,-,-1,-1
MUSREM.txt,251481,253010,1529,10,N,N,-,-1,-1
MUSREM.txt,251524,253203,1679,10,N,N,-,-1,-1
MUSREM.txt,251769,253382,1613,10,N,N,-,-1,-1
MUSREM.txt,251865,253477,1612,10,N,N,-,-1,-1
MUSREM.txt,251882,253587,1705,10,N,N,-,-1,-1
MUSREM.txt,252006,253813,1807,10,N,N,-,-1,-1
MUSREM.txt,252241,253962,1721,10,N,N,-,-1,-1
MUSREM.txt,252383,253975,1592,10,N,N,-,-1,-1
MUSREM.txt,252599,254113,1514,10,N,N,-,-1,-1
MUSREM.txt,252747,254231,1484,10,N,N,-,-1,-1
MUSREM.txt,253011,254417,1406,10,N,N,-,-1,-1
MUSREM.txt,253205,254741,1536,10,N,N,-,-1,-1
MUSREM.txt,253384,254836,1452,10,N,N,-,-1,-1
MUSREM.txt,253479,254901,1422,10,N,N,-,-1,-1
MUSREM.txt,253588,255190,1602,10,N,N,-,-1,-1
MUSREM.txt,253814,255353,1539,10,N,N,-,-1,-1
MUSREM.txt,253963,255403,1440,10,N,N,-,-1,-1
MUSREM.txt,253976,255684,1708,10,N,N,-,-1,-1
MUSREM.txt,254114,255996,1882,10,N,N,-,-1,-1
MUSREM.txt,254232,256064,1832,10,N,N,-,-1,-1
MUSREM.txt,254420,256258,1838,10,N,Y,1448393918391,289044,290517
MUSREM.txt,254743,256372,1629,10,N,Y,1448393918391,289044,290517
MUSREM.txt,254836,256495,1659,10,N,Y,1448393918391,289044,290517
MUSREM.txt,254904,256607,1703,10,N,Y,1448393918391,289044,290517
MUSREM.txt,255191,256690,1499,10,N,Y,1448393918391,289044,290517
MUSREM.txt,255354,256862,1508,10,N,Y,1448393918391,289044,290517
MUSREM.txt,255404,256901,1497,10,N,Y,1448393918391,289044,290517
MUSREM.txt,255685,257045,1360,10,N,Y,1448393918391,289044,290517
MUSREM.txt,255999,257079,1080,10,N,Y,1448393918391,289044,290517
MUSREM.txt,256065,257174,1109,10,N,Y,1448393918391,289044,290517
MUSREM.txt,256259,257373,1114,10,Y,Y,1448393918391,289044,290517
MUSREM.txt,256373,257595,1222,10,Y,Y,1448393918391,289044,290517
MUSREM.txt,256496,257704,1208,10,Y,Y,1448393918391,289044,290517
MUSREM.txt,256608,257781,1173,10,N,Y,1448393918391,289044,290517
MUSREM.txt,256691,257977,1286,10,N,Y,1448393918391,289044,290517
MUSREM.txt,256863,258159,1296,10,N,Y,1448393918391,289044,290517
MUSREM.txt,256902,258247,1345,10,N,Y,1448393918391,289044,290517
MUSREM.txt,257046,258283,1237,10,N,Y,1448393918391,289044,290517
MUSREM.txt,257080,258603,1523,10,N,Y,1448393918391,289044,290517
MUSREM.txt,257175,258685,1510,10,N,Y,1448393918391,289044,290517
MUSREM.txt,257376,258797,1421,10,N,N,-,-1,-1
MUSREM.txt,257596,258891,1295,10,N,N,-,-1,-1
MUSREM.txt,257705,259049,1344,10,N,N,-,-1,-1
MUSREM.txt,257783,259415,1632,10,Y,N,-,-1,-1
MUSREM.txt,257979,259595,1616,10,Y,N,-,-1,-1
MUSREM.txt,258160,259738,1578,10,Y,N,-,-1,-1
MUSREM.txt,258248,259835,1587,10,Y,Y,1448039370049,20775,21297
MUSREM.txt,258284,260061,1777,10,Y,Y,1448039370049,20775,21297
MUSREM.txt,258604,260129,1525,10,Y,Y,1448039370049,20775,21297
MUSREM.txt,258686,260338,1652,10,Y,Y,1448039370049,20775,21297
MUSREM.txt,258798,260456,1658,10,Y,Y,1448039370049,20775,21297
MUSREM.txt,258894,260611,1717,10,Y,Y,1448039370049,20775,21297
MUSREM.txt,259052,260751,1699,10,Y,Y,1448039370049,20775,21297
MUSREM.txt,259416,260926,1510,10,N,Y,1448039370049,20775,21297
MUSREM.txt,259598,260992,1394,10,Y,Y,1448039370049,20775,21297
MUSREM.txt,259739,261235,1496,10,N,Y,1448039370049,20775,21297
MUSREM.txt,259836,261485,1649,10,Y,Y,1448039370049,20775,21297
MUSREM.txt,260062,261522,1460,10,N,Y,1448039370049,20775,21297
MUSREM.txt,260130,261625,1495,10,N,Y,1448039370049,20775,21297
MUSREM.txt,260339,261688,1349,10,N,Y,1448039370049,20775,21297
MUSREM.txt,260457,261832,1375,10,N,Y,1448039370049,20775,21297
MUSREM.txt,260614,261899,1285,10,N,Y,1448039370049,20775,21297
MUSREM.txt,260752,262295,1543,10,N,Y,1448039370049,20775,21297
MUSREM.txt,260928,262334,1406,10,N,Y,1448039370049,20775,21297
MUSREM.txt,260995,262423,1428,10,N,Y,1437477878183,427206,428439
MUSREM.txt,261238,262472,1234,10,N,Y,1437477878183,427206,428439
MUSREM.txt,261487,262732,1245,10,N,Y,1437477878183,427206,428439
MUSREM.txt,261523,262881,1358,10,N,Y,1437477878183,427206,428439
MUSREM.txt,261627,262989,1362,10,N,Y,1437477878183,427206,428439
MUSREM.txt,261689,263163,1474,10,N,Y,1437477878183,427206,428439
MUSREM.txt,261833,263568,1735,10,N,Y,1437477878183,427206,428439
MUSREM.txt,261900,263620,1720,10,N,Y,1437477878183,427206,428439
MUSREM.txt,262296,263754,1458,10,N,Y,1437477878183,427206,428439
MUSREM.txt,262335,263823,1488,10,N,Y,1437477878183,427206,428439
MUSREM.txt,262424,263988,1564,10,N,Y,1437477878183,427206,428439
MUSREM.txt,262473,264449,1976,10,Y,Y,1437477878183,427206,428439
MUSREM.txt,262733,264556,1823,10,Y,Y,1437477878183,427206,428439
MUSREM.txt,262883,264594,1711,10,Y,Y,1448287094676,113323,113870
MUSREM.txt,262990,264694,1704,10,Y,Y,1448287094676,113323,113870
MUSREM.txt,263164,264774,1610,10,Y,Y,1448287094676,113323,113870
MUSREM.txt,263569,264946,1377,10,Y,Y,1448287094676,113323,113870
MUSREM.txt,263621,265107,1486,10,Y,Y,1448287094676,113323,113870
MUSREM.txt,263757,265369,1612,10,Y,Y,1448038356234,18463,18881
MUSREM.txt,263824,265507,1683,10,Y,Y,1448038356234,18463,18881
MUSREM.txt,263989,266034,2045,10,Y,Y,1448038356234,18463,18881
MUSREM.txt,264450,266073,1623,10,N,Y,1448038356234,18463,18881
MUSREM.txt,264557,266180,1623,10,N,Y,1448038356234,18463,18881
MUSREM.txt,264595,266344,1749,10,N,Y,1448038356234,18463,18881
MUSREM.txt,264695,266479,1784,10,N,Y,1448038356234,18463,18881
MUSREM.txt,264775,266637,1862,10,N,Y,1448038356234,18463,18881
MUSREM.txt,264947,266660,1713,10,N,Y,1448038356234,18463,18881
MUSREM.txt,265110,266743,1633,10,N,Y,1448038356234,18463,18881
MUSREM.txt,265370,266885,1515,10,Y,Y,1448038356234,18463,18881
MUSREM.txt,265508,267026,1518,10,Y,Y,1448038356234,18463,18881
MUSREM.txt,266035,267216,1181,10,Y,Y,1448038356234,18463,18881
MUSREM.txt,266074,267312,1238,10,Y,Y,1448038356234,18463,18881
MUSREM.txt,266181,267407,1226,10,Y,Y,1448038356234,18463,18881
MUSREM.txt,266347,267468,1121,10,Y,Y,1448282044001,101941,102395
MUSREM.txt,266482,267524,1042,10,Y,Y,1448282044001,101941,102395
MUSREM.txt,266638,267581,943,10,N,Y,1448282044001,101941,102395
MUSREM.txt,266661,267724,1063,10,Y,Y,1448282044001,101941,102395
MUSREM.txt,266744,267849,1105,10,Y,Y,1448282044001,101941,102395
MUSREM.txt,266886,268077,1191,10,N,Y,1448282044001,101941,102395
MUSREM.txt,267027,268201,1174,10,Y,Y,1448282044001,101941,102395
MUSREM.txt,267217,268346,1129,10,Y,Y,1448282044001,101941,102395
MUSREM.txt,267313,268535,1222,10,Y,Y,1448282044001,101941,102395
MUSREM.txt,267408,268575,1167,10,Y,Y,1448282044001,101941,102395
MUSREM.txt,267469,268677,1208,10,N,Y,1448282044001,101941,102395
MUSREM.txt,267525,268775,1250,10,N,Y,1448282044001,101941,102395
MUSREM.txt,267582,268788,1206,10,N,Y,1448282044001,101941,102395
MUSREM.txt,267725,268903,1178,10,N,Y,1448282044001,101941,102395
MUSREM.txt,267850,269273,1423,10,N,Y,1448282044001,101941,102395
MUSREM.txt,268078,269408,1330,10,N,Y,1448282044001,101941,102395
MUSREM.txt,268204,269555,1351,10,N,Y,1448311811907,157566,161100
MUSREM.txt,268347,269607,1260,10,N,Y,1448311811907,157566,161100
MUSREM.txt,268536,269752,1216,10,N,Y,1448311811907,157566,161100
MUSREM.txt,268576,269941,1365,10,N,Y,1448311811907,157566,161100
MUSREM.txt,268678,270014,1336,10,N,Y,1448311811907,157566,161100
MUSREM.txt,268776,270117,1341,10,N,Y,1448311811907,157566,161100
MUSREM.txt,268789,270229,1440,10,N,Y,1448311811907,157566,161100
MUSREM.txt,268904,270315,1411,10,Y,Y,1448311811907,157566,161100
MUSREM.txt,269274,270492,1218,10,N,Y,1448311811907,157566,161100
MUSREM.txt,269411,270629,1218,10,N,Y,1448311811907,157566,161100
MUSREM.txt,269556,270668,1112,10,N,Y,1448311811907,157566,161100
MUSREM.txt,269608,270756,1148,10,Y,Y,1448311811907,157566,161100
MUSREM.txt,269753,270863,1110,10,Y,Y,1448311811907,157566,161100
MUSREM.txt,269942,270940,998,10,N,Y,1448311811907,157566,161100
MUSREM.txt,270015,271120,1105,10,N,Y,1448311811907,157566,161100
MUSREM.txt,270119,271306,1187,10,N,Y,1448359079273,247104,249268
MUSREM.txt,270230,271460,1230,10,Y,Y,1448359079273,247104,249268
MUSREM.txt,270316,271637,1321,10,N,Y,1448359079273,247104,249268
MUSREM.txt,270493,271756,1263,10,N,Y,1448313800274,179025,179317
MUSREM.txt,270630,272138,1508,10,Y,Y,1448313800274,179025,179317
MUSREM.txt,270669,272202,1533,10,Y,Y,1448313800274,179025,179317
MUSREM.txt,270757,272331,1574,10,Y,Y,1448313800274,179025,179317
MUSREM.txt,270866,272433,1567,10,Y,Y,1448313800274,179025,179317
MUSREM.txt,270941,272512,1571,10,Y,Y,1448313800274,179025,179317
MUSREM.txt,271121,272549,1428,10,Y,Y,1448313800274,179025,179317
MUSREM.txt,271307,272737,1430,10,Y,Y,1448313800274,179025,179317
MUSREM.txt,271461,272860,1399,10,Y,Y,1448313800274,179025,179317
MUSREM.txt,271638,272883,1245,10,Y,Y,1448313800274,179025,179317
MUSREM.txt,271757,272987,1230,10,Y,Y,1448313800274,179025,179317
MUSREM.txt,272139,273084,945,10,N,Y,1448313800274,179025,179317
MUSREM.txt,272203,273280,1077,10,N,Y,1448313800274,179025,179317
MUSREM.txt,272332,273443,1111,10,N,Y,1448313800274,179025,179317
MUSREM.txt,272434,273612,1178,10,N,Y,1448313800274,179025,179317
MUSREM.txt,272513,273865,1352,10,N,Y,1448313800274,179025,179317
MUSREM.txt,272552,273971,1419,10,N,N,-,-1,-1
MUSREM.txt,272739,274146,1407,10,N,N,-,-1,-1
MUSREM.txt,272861,274257,1396,10,N,N,-,-1,-1
MUSREM.txt,272884,274384,1500,10,N,N,-,-1,-1
MUSREM.txt,272988,274485,1497,10,N,N,-,-1,-1
MUSREM.txt,273086,274623,1537,10,Y,Y,1448038101349,15101,17486
MUSREM.txt,273283,274675,1392,10,N,Y,1448038101349,15101,17486
MUSREM.txt,273444,274885,1441,10,Y,Y,1448038101349,15101,17486
MUSREM.txt,273613,275057,1444,10,Y,Y,1448038101349,15101,17486
MUSREM.txt,273867,275124,1257,10,Y,Y,1448038101349,15101,17486
MUSREM.txt,273972,275328,1356,10,Y,Y,1448038101349,15101,17486
MUSREM.txt,274147,275413,1266,10,N,Y,1448038101349,15101,17486
MUSREM.txt,274259,275685,1426,10,N,Y,1448038101349,15101,17486
MUSREM.txt,274385,275762,1377,10,N,Y,1448038101349,15101,17486
MUSREM.txt,274486,275854,1368,10,N,Y,1448038101349,15101,17486
MUSREM.txt,274624,276041,1417,10,N,Y,1448277582432,52552,54595
MUSREM.txt,274678,276091,1413,10,N,Y,1448277582432,52552,54595
MUSREM.txt,274886,276228,1342,10,N,Y,1448277582432,52552,54595
MUSREM.txt,275060,276287,1227,10,N,Y,1448277582432,52552,54595
MUSREM.txt,275125,276404,1279,10,N,Y,1448281071558,89330,89524
MUSREM.txt,275330,276553,1223,10,N,Y,1448281071558,89330,89524
MUSREM.txt,275414,276757,1343,10,Y,Y,1448281071558,89330,89524
MUSREM.txt,275686,276862,1176,10,Y,Y,1448281071558,89330,89524
MUSREM.txt,275763,276906,1143,10,Y,Y,1448280423373,85694,86154
MUSREM.txt,275855,276968,1113,10,Y,Y,1448280423373,85694,86154
MUSREM.txt,276042,277080,1038,10,N,Y,1448280423373,85694,86154
MUSREM.txt,276094,277154,1060,10,N,Y,1448280423373,85694,86154
MUSREM.txt,276229,277232,1003,10,N,Y,1448280423373,85694,86154
MUSREM.txt,276288,277299,1011,10,N,Y,1448280423373,85694,86154
MUSREM.txt,276405,277447,1042,10,N,Y,1448280423373,85694,86154
MUSREM.txt,276555,277575,1020,10,N,Y,1448280423373,85694,86154
MUSREM.txt,276758,277641,883,10,N,Y,1448280423373,85694,86154
MUSREM.txt,276865,277719,854,10,N,Y,1448280423373,85694,86154
MUSREM.txt,276908,278109,1201,10,N,Y,1448280423373,85694,86154
MUSREM.txt,276969,278313,1344,10,N,Y,1448280423373,85694,86154
MUSREM.txt,277081,278516,1435,10,N,Y,1448280423373,85694,86154
MUSREM.txt,277155,278567,1412,10,N,Y,1448280423373,85694,86154
MUSREM.txt,277233,278749,1516,10,N,Y,1448280423373,85694,86154
MUSREM.txt,277302,278978,1676,10,N,N,-,-1,-1
MUSREM.txt,277450,279073,1623,10,N,N,-,-1,-1
MUSREM.txt,277576,279195,1619,10,N,Y,1437472380836,351899,352666
MUSREM.txt,277642,279386,1744,10,N,Y,1437472380836,351899,352666
MUSREM.txt,277720,279515,1795,10,N,Y,1437472380836,351899,352666
MUSREM.txt,278114,279936,1822,10,N,Y,1437472380836,351899,352666
MUSREM.txt,278315,280041,1726,10,N,Y,1437472380836,351899,352666
MUSREM.txt,278517,280217,1700,10,N,Y,1437472380836,351899,352666
MUSREM.txt,278568,280448,1880,10,N,Y,1437472380836,351899,352666
MUSREM.txt,278750,280537,1787,10,N,Y,1437472380836,351899,352666
MUSREM.txt,278979,280567,1588,10,N,Y,1437472380836,351899,352666
MUSREM.txt,279074,280639,1565,10,N,Y,1437472380836,351899,352666
MUSREM.txt,279196,280786,1590,10,N,Y,1437472380836,351899,352666
MUSREM.txt,279388,280983,1595,10,Y,Y,1448313994373,179347,179715
MUSREM.txt,279516,281186,1670,10,Y,Y,1448313994373,179347,179715
MUSREM.txt,279937,281246,1309,10,Y,Y,1448313994373,179347,179715
MUSREM.txt,280042,281281,1239,10,Y,Y,1448322979449,227304,227638
MUSREM.txt,280222,281408,1186,10,Y,Y,1448322979449,227304,227638
MUSREM.txt,280449,281499,1050,10,N,Y,1448322979449,227304,227638
MUSREM.txt,280538,281681,1143,10,N,Y,1448322979449,227304,227638
MUSREM.txt,280568,281723,1155,10,N,Y,1448322979449,227304,227638
MUSREM.txt,280640,281949,1309,10,N,Y,1448322979449,227304,227638
MUSREM.txt,280787,281999,1212,10,N,Y,1448322979449,227304,227638
MUSREM.txt,280985,282043,1058,10,N,N,-,-1,-1
MUSREM.txt,281187,282105,918,10,N,N,-,-1,-1
MUSREM.txt,281247,282279,1032,10,N,Y,1448313674408,176614,178600
MUSREM.txt,281282,282574,1292,10,Y,Y,1448313674408,176614,178600
MUSREM.txt,281409,282639,1230,10,Y,Y,1448313674408,176614,178600
MUSREM.txt,281500,282785,1285,10,Y,Y,1448313674408,176614,178600
MUSREM.txt,281682,283031,1349,10,Y,Y,1448313674408,176614,178600
MUSREM.txt,281724,283105,1381,10,Y,Y,1448313674408,176614,178600
MUSREM.txt,281950,283200,1250,10,Y,Y,1448313674408,176614,178600
MUSREM.txt,282000,283327,1327,10,Y,Y,1448313674408,176614,178600
MUSREM.txt,282044,283401,1357,10,Y,Y,1448313674408,176614,178600
MUSREM.txt,282106,283528,1422,10,Y,Y,1448313674408,176614,178600
MUSREM.txt,282280,283637,1357,10,Y,Y,1448313674408,176614,178600
MUSREM.txt,282575,283754,1179,10,N,Y,1448275023016,26258,26837
MUSREM.txt,282640,283873,1233,10,N,Y,1448275023016,26258,26837
MUSREM.txt,282786,284023,1237,10,N,Y,1448275023016,26258,26837
MUSREM.txt,283032,284137,1105,10,N,Y,1448275023016,26258,26837
MUSREM.txt,283106,284368,1262,10,N,Y,1448275023016,26258,26837
MUSREM.txt,283203,284544,1341,10,N,Y,1448275023016,26258,26837
MUSREM.txt,283328,284738,1410,10,N,Y,1448275023016,26258,26837
MUSREM.txt,283402,285041,1639,10,Y,Y,1448275023016,26258,26837
MUSREM.txt,283529,285251,1722,10,Y,Y,1448275023016,26258,26837
MUSREM.txt,283639,285392,1753,10,Y,Y,1448275023016,26258,26837
MUSREM.txt,283755,285492,1737,10,Y,Y,1448275023016,26258,26837
MUSREM.txt,283874,285562,1688,10,Y,Y,1448360140810,268069,269800
MUSREM.txt,284024,285897,1873,10,Y,Y,1448280673594,87462,88501
MUSREM.txt,284138,285921,1783,10,Y,Y,1448280673594,87462,88501
MUSREM.txt,284369,286196,1827,10,Y,Y,1448280673594,87462,88501
MUSREM.txt,284545,286324,1779,10,N,Y,1448280673594,87462,88501
MUSREM.txt,284739,286433,1694,10,N,Y,1448280673594,87462,88501
MUSREM.txt,285042,286515,1473,10,N,Y,1448280673594,87462,88501
MUSREM.txt,285252,286691,1439,10,N,Y,1448280673594,87462,88501
MUSREM.txt,285393,286852,1459,10,N,Y,1448280673594,87462,88501
MUSREM.txt,285494,287018,1524,10,Y,Y,1448280673594,87462,88501
MUSREM.txt,285563,287056,1493,10,Y,Y,1448280673594,87462,88501
MUSREM.txt,285898,287138,1240,10,Y,Y,1448276340407,30017,39003
MUSREM.txt,285922,287280,1358,10,Y,Y,1448276340407,30017,39003
MUSREM.txt,286197,287349,1152,10,Y,Y,1448276340407,30017,39003
MUSREM.txt,286326,287388,1062,10,Y,Y,1448276340407,30017,39003
MUSREM.txt,286434,287470,1036,10,Y,Y,1448276340407,30017,39003
MUSREM.txt,286516,287581,1065,10,Y,Y,1448276340407,30017,39003
MUSREM.txt,286692,287766,1074,10,Y,Y,1448276340407,30017,39003
MUSREM.txt,286854,287778,924,10,N,Y,1448276340407,30017,39003
MUSREM.txt,287019,287843,824,10,N,Y,1448276340407,30017,39003
MUSREM.txt,287057,287987,930,10,N,Y,1448276340407,30017,39003
MUSREM.txt,287139,288073,934,10,N,Y,1448276340407,30017,39003
MUSREM.txt,287281,288138,857,10,N,Y,1448276340407,30017,39003
MUSREM.txt,287350,288208,858,10,N,Y,1448276340407,30017,39003
MUSREM.txt,287389,288268,879,10,N,Y,1448394636895,292272,293963
MUSREM.txt,287473,288319,846,10,N,Y,1448394636895,292272,293963
MUSREM.txt,287582,288428,846,10,N,Y,1448394636895,292272,293963
MUSREM.txt,287767,288529,762,10,N,Y,1448394636895,292272,293963
MUSREM.txt,287779,288586,807,10,N,Y,1448394636895,292272,293963
MUSREM.txt,287844,288754,910,10,N,Y,1448394636895,292272,293963
MUSREM.txt,287989,289006,1017,10,Y,Y,1448312128598,172353,173027
MUSREM.txt,288075,289203,1128,10,Y,Y,1448312128598,172353,173027
MUSREM.txt,288139,289258,1119,10,Y,Y,1448312128598,172353,173027
MUSREM.txt,288209,289355,1146,10,Y,Y,1448312128598,172353,173027
MUSREM.txt,288269,289724,1455,10,Y,Y,1448279813455,71525,72226
MUSREM.txt,288320,289903,1583,10,Y,Y,1448279813455,71525,72226
MUSREM.txt,288429,289928,1499,10,N,Y,1448279813455,71525,72226
MUSREM.txt,288530,290119,1589,10,Y,Y,1448279813455,71525,72226
MUSREM.txt,288588,290239,1651,10,Y,Y,1448279813455,71525,72226
MUSREM.txt,288755,290312,1557,10,N,Y,1448279813455,71525,72226
MUSREM.txt,289007,290516,1509,10,N,Y,1448279813455,71525,72226
MUSREM.txt,289205,290855,1650,10,Y,Y,1448279813455,71525,72226
MUSREM.txt,289259,291031,1772,10,Y,Y,1448279813455,71525,72226
MUSREM.txt,289356,291207,1851,10,Y,Y,1448279813455,71525,72226
MUSREM.txt,289725,291309,1584,10,Y,Y,1448279813455,71525,72226
MUSREM.txt,289904,291458,1554,10,N,Y,1448279813455,71525,72226
MUSREM.txt,289929,291670,1741,10,N,Y,1448279813455,71525,72226
MUSREM.txt,290120,291992,1872,10,N,Y,1448322273366,219239,219544
MUSREM.txt,290240,292038,1798,10,N,Y,1448322273366,219239,219544
MUSREM.txt,290315,292451,2136,10,N,Y,1448322273366,219239,219544
MUSREM.txt,290517,292719,2202,10,Y,Y,1448322273366,219239,219544
MUSREM.txt,290856,292817,1961,10,Y,Y,1448322273366,219239,219544
MUSREM.txt,291032,293043,2011,10,Y,Y,1448322273366,219239,219544
MUSREM.txt,291208,293246,2038,10,Y,Y,1448322273366,219239,219544
MUSREM.txt,291310,293406,2096,10,Y,Y,1448322273366,219239,219544
MUSREM.txt,291459,293487,2028,10,Y,Y,1448322273366,219239,219544
MUSREM.txt,291671,293675,2004,10,Y,Y,1448322273366,219239,219544
MUSREM.txt,291995,293920,1925,10,Y,Y,1448322273366,219239,219544
MUSREM.txt,292040,294084,2044,10,Y,Y,1448322273366,219239,219544
MUSREM.txt,292452,294121,1669,10,N,Y,1448313482895,176553,176862
MUSREM.txt,292720,294312,1592,10,Y,Y,1448313482895,176553,176862
MUSREM.txt,292818,294448,1630,10,Y,Y,1448313482895,176553,176862
MUSREM.txt,293044,294702,1658,10,N,Y,1448278425221,65586,65914
MUSREM.txt,293247,294852,1605,10,N,Y,1448278425221,65586,65914
MUSREM.txt,293407,295343,1936,10,N,Y,1448278425221,65586,65914
MUSREM.txt,293488,295631,2143,10,Y,Y,1448278425221,65586,65914
MUSREM.txt,293676,295806,2130,10,N,Y,1448278425221,65586,65914
MUSREM.txt,293922,295886,1964,10,N,Y,1448278425221,65586,65914
MUSREM.txt,294085,296027,1942,10,N,Y,1448278425221,65586,65914
MUSREM.txt,294122,296205,2083,10,N,Y,1448278425221,65586,65914
MUSREM.txt,294314,296225,1911,10,N,Y,1448278425221,65586,65914
MUSREM.txt,294450,296426,1976,10,N,Y,1448278425221,65586,65914
MUSREM.txt,294705,296499,1794,10,N,Y,1448278425221,65586,65914
MUSREM.txt,294853,296701,1848,10,N,N,-,-1,-1
MUSREM.txt,295346,296835,1489,10,N,N,-,-1,-1
MUSREM.txt,295632,296957,1325,10,N,N,-,-1,-1
MUSREM.txt,295807,297292,1485,10,N,N,-,-1,-1
MUSREM.txt,295887,297557,1670,10,N,N,-,-1,-1
MUSREM.txt,296028,297736,1708,10,N,N,-,-1,-1
MUSREM.txt,296206,297937,1731,10,N,N,-,-1,-1
MUSREM.txt,296226,298008,1782,10,N,N,-,-1,-1
MUSREM.txt,296427,298061,1634,10,N,N,-,-1,-1
MUSREM.txt,296500,298283,1783,10,N,N,-,-1,-1
MUSREM.txt,296702,298318,1616,10,N,N,-,-1,-1
MUSREM.txt,296836,298408,1572,10,N,N,-,-1,-1
MUSREM.txt,296958,298614,1656,10,N,N,-,-1,-1
MUSREM.txt,297293,298732,1439,10,N,N,-,-1,-1
MUSREM.txt,297558,298765,1207,10,N,N,-,-1,-1
MUSREM.txt,297737,298835,1098,10,N,N,-,-1,-1
MUSREM.txt,297938,299045,1107,10,N,N,-,-1,-1
MUSREM.txt,298009,299140,1131,10,N,N,-,-1,-1
MUSREM.txt,298063,299353,1290,10,N,N,-,-1,-1
MUSREM.txt,298284,299763,1479,10,N,N,-,-1,-1
MUSREM.txt,298319,300008,1689,10,N,N,-,-1,-1
MUSREM.txt,298409,300189,1780,10,N,N,-,-1,-1
MUSREM.txt,298615,300338,1723,10,N,N,-,-1,-1
MUSREM.txt,298734,300462,1728,10,N,N,-,-1,-1
MUSREM.txt,298766,300554,1788,10,N,N,-,-1,-1
MUSREM.txt,298836,300643,1807,10,N,N,-,-1,-1
MUSREM.txt,299047,300664,1617,10,N,N,-,-1,-1
MUSREM.txt,299142,300785,1643,10,N,N,-,-1,-1
MUSREM.txt,299358,301003,1645,10,N,N,-,-1,-1
MUSREM.txt,299764,301346,1582,10,N,N,-,-1,-1
MUSREM.txt,300009,301515,1506,10,N,N,-,-1,-1
MUSREM.txt,300190,301839,1649,10,N,N,-,-1,-1
MUSREM.txt,300339,302137,1798,10,N,N,-,-1,-1
MUSREM.txt,300463,302378,1915,10,N,N,-,-1,-1
MUSREM.txt,300555,302425,1870,10,N,N,-,-1,-1
MUSREM.txt,300644,302591,1947,10,N,N,-,-1,-1
MUSREM.txt,300665,302835,2170,10,N,N,-,-1,-1
MUSREM.txt,300787,302908,2121,10,N,N,-,-1,-1
MUSREM.txt,301006,303035,2029,10,N,N,-,-1,-1
MUSREM.txt,301347,303160,1813,10,N,N,-,-1,-1
MUSREM.txt,301520,303359,1839,10,N,N,-,-1,-1
MUSREM.txt,301841,303706,1865,10,N,N,-,-1,-1
MUSREM.txt,302138,303742,1604,10,N,N,-,-1,-1
MUSREM.txt,302379,303841,1462,10,N,N,-,-1,-1
MUSREM.txt,302427,303922,1495,10,N,N,-,-1,-1
MUSREM.txt,302592,304231,1639,10,N,N,-,-1,-1
MUSREM.txt,302836,304331,1495,10,N,N,-,-1,-1
MUSREM.txt,302909,304436,1527,10,N,N,-,-1,-1
MUSREM.txt,303036,304594,1558,10,Y,N,-,-1,-1
MUSREM.txt,303161,304752,1591,10,Y,N,-,-1,-1
MUSREM.txt,303359,304815,1456,10,N,N,-,-1,-1
MUSREM.txt,303709,304831,1122,10,N,N,-,-1,-1
MUSREM.txt,303743,305013,1270,10,N,N,-,-1,-1
MUSREM.txt,303842,305182,1340,10,N,N,-,-1,-1
MUSREM.txt,303924,305266,1342,10,N,N,-,-1,-1
MUSREM.txt,304232,305325,1093,10,N,N,-,-1,-1
MUSREM.txt,304332,305411,1079,10,N,N,-,-1,-1
MUSREM.txt,304437,305645,1208,10,N,N,-,-1,-1
MUSREM.txt,304595,305815,1220,10,N,N,-,-1,-1
MUSREM.txt,304753,305834,1081,10,N,N,-,-1,-1
MUSREM.txt,304820,305988,1168,10,N,N,-,-1,-1
MUSREM.txt,304832,306108,1276,10,N,N,-,-1,-1
MUSREM.txt,305014,306121,1107,10,N,N,-,-1,-1
MUSREM.txt,305183,306137,954,10,N,N,-,-1,-1
MUSREM.txt,305267,306186,919,10,N,N,-,-1,-1
MUSREM.txt,305326,306216,890,10,N,N,-,-1,-1
OUSELEY.txt,0,2717,2717,10,N,N,-,-1,-1
OUSELEY.txt,264,3189,2925,10,N,N,-,-1,-1
OUSELEY.txt,356,3921,3565,10,N,N,-,-1,-1
OUSELEY.txt,761,4762,4001,10,N,N,-,-1,-1
OUSELEY.txt,881,4767,3886,10,N,N,-,-1,-1
OUSELEY.txt,910,5214,4304,10,N,N,-,-1,-1
OUSELEY.txt,960,6147,5187,10,N,N,-,-1,-1
OUSELEY.txt,1064,6304,5240,10,N,N,-,-1,-1
OUSELEY.txt,1457,7200,5743,10,N,N,-,-1,-1
OUSELEY.txt,2310,7480,5170,10,N,N,-,-1,-1
OUSELEY.txt,2718,7977,5259,10,N,N,-,-1,-1
OUSELEY.txt,3190,9005,5815,10,N,N,-,-1,-1
OUSELEY.txt,3922,10136,6214,10,N,N,-,-1,-1
OUSELEY.txt,4763,11234,6471,10,N,N,-,-1,-1
OUSELEY.txt,4768,11273,6505,10,N,N,-,-1,-1
OUSELEY.txt,5215,11297,6082,10,N,N,-,-1,-1
OUSELEY.txt,6150,11353,5203,10,N,N,-,-1,-1
OUSELEY.txt,6305,11373,5068,10,N,N,-,-1,-1
OUSELEY.txt,7205,11448,4243,10,N,N,-,-1,-1
OUSELEY.txt,7481,11496,4015,10,N,N,-,-1,-1
OUSELEY.txt,7978,11499,3521,10,N,N,-,-1,-1
OUSELEY.txt,9006,11522,2516,10,N,N,-,-1,-1
OUSELEY.txt,10137,11530,1393,10,N,N,-,-1,-1
OUSELEY.txt,11235,11531,296,10,N,N,-,-1,-1
OUSELEY.txt,11274,11536,262,10,N,N,-,-1,-1
OUSELEY.txt,11298,11538,240,10,N,N,-,-1,-1
OUSELEY.txt,11354,11539,185,10,N,N,-,-1,-1
OUSELEY.txt,11374,11574,200,10,N,N,-,-1,-1
OUSELEY.txt,11451,11586,135,10,N,N,-,-1,-1
OUSELEY.txt,11498,11864,366,10,N,N,-,-1,-1
OUSELEY.txt,11499,11884,385,10,N,N,-,-1,-1
OUSELEY.txt,11524,12226,702,10,N,N,-,-1,-1
OUSELEY.txt,11530,12227,697,10,N,N,-,-1,-1
OUSELEY.txt,11532,12399,867,10,N,N,-,-1,-1
OUSELEY.txt,11537,12400,863,10,N,N,-,-1,-1
OUSELEY.txt,11538,12747,1209,10,N,N,-,-1,-1
OUSELEY.txt,11540,12777,1237,10,N,N,-,-1,-1
OUSELEY.txt,11579,12873,1294,10,N,N,-,-1,-1
OUSELEY.txt,11591,12969,1378,10,N,N,-,-1,-1
OUSELEY.txt,11865,12970,1105,10,N,N,-,-1,-1
OUSELEY.txt,11885,13030,1145,10,N,N,-,-1,-1
OUSELEY.txt,12226,13561,1335,10,N,N,-,-1,-1
OUSELEY.txt,12230,13587,1357,10,N,N,-,-1,-1
OUSELEY.txt,12399,13730,1331,10,N,N,-,-1,-1
OUSELEY.txt,12403,13764,1361,10,N,N,-,-1,-1
OUSELEY.txt,12749,13772,1023,10,N,N,-,-1,-1
OUSELEY.txt,12778,14168,1390,10,N,N,-,-1,-1
OUSELEY.txt,12873,14570,1697,10,N,N,-,-1,-1
OUSELEY.txt,12969,14574,1605,10,N,N,-,-1,-1
OUSELEY.txt,12971,14578,1607,10,N,N,-,-1,-1
OUSELEY.txt,13031,14592,1561,10,N,N,-,-1,-1
OUSELEY.txt,13567,14613,1046,10,N,N,-,-1,-1
OUSELEY.txt,13591,14745,1154,10,N,N,-,-1,-1
OUSELEY.txt,13734,14814,1080,10,N,N,-,-1,-1
OUSELEY.txt,13765,15019,1254,10,N,N,-,-1,-1
OUSELEY.txt,13773,15052,1279,10,N,N,-,-1,-1
OUSELEY.txt,14169,15061,892,10,N,N,-,-1,-1
OUSELEY.txt,14571,15198,627,10,N,N,-,-1,-1
OUSELEY.txt,14575,15199,624,10,N,N,-,-1,-1
OUSELEY.txt,14579,15254,675,10,N,N,-,-1,-1
OUSELEY.txt,14593,15276,683,10,N,N,-,-1,-1
OUSELEY.txt,14618,15440,822,10,N,N,-,-1,-1
OUSELEY.txt,14748,15505,757,10,N,N,-,-1,-1
OUSELEY.txt,14817,15511,694,10,N,N,-,-1,-1
OUSELEY.txt,15020,15767,747,10,N,N,-,-1,-1
OUSELEY.txt,15053,15923,870,10,N,N,-,-1,-1
OUSELEY.txt,15062,16100,1038,10,N,N,-,-1,-1
OUSELEY.txt,15198,16260,1062,10,N,N,-,-1,-1
OUSELEY.txt,15204,16279,1075,10,N,N,-,-1,-1
OUSELEY.txt,15255,16334,1079,10,N,N,-,-1,-1
OUSELEY.txt,15278,16358,1080,10,N,N,-,-1,-1
OUSELEY.txt,15441,16379,938,10,N,N,-,-1,-1
OUSELEY.txt,15510,16487,977,10,N,N,-,-1,-1
OUSELEY.txt,15511,16735,1224,10,N,N,-,-1,-1
OUSELEY.txt,15770,16969,1199,10,N,N,-,-1,-1
OUSELEY.txt,15924,17115,1191,10,N,N,-,-1,-1
OUSELEY.txt,16103,17179,1076,10,N,N,-,-1,-1
OUSELEY.txt,16265,17216,951,10,N,N,-,-1,-1
OUSELEY.txt,16284,17330,1046,10,N,N,-,-1,-1
OUSELEY.txt,16337,17444,1107,10,N,N,-,-1,-1
OUSELEY.txt,16360,17625,1265,10,N,N,-,-1,-1
OUSELEY.txt,16384,17650,1266,10,N,N,-,-1,-1
OUSELEY.txt,16492,17917,1425,10,N,N,-,-1,-1
OUSELEY.txt,16736,18248,1512,10,N,N,-,-1,-1
OUSELEY.txt,16970,18849,1879,10,N,N,-,-1,-1
OUSELEY.txt,17116,19249,2133,10,N,N,-,-1,-1
OUSELEY.txt,17180,19651,2471,10,N,N,-,-1,-1
OUSELEY.txt,17217,19982,2765,10,N,N,-,-1,-1
OUSELEY.txt,17331,20163,2832,10,N,N,-,-1,-1
OUSELEY.txt,17446,20218,2772,10,N,N,-,-1,-1
OUSELEY.txt,17626,20284,2658,10,N,N,-,-1,-1
OUSELEY.txt,17652,20339,2687,10,N,N,-,-1,-1
OUSELEY.txt,17918,20372,2454,10,N,N,-,-1,-1
OUSELEY.txt,18249,20484,2235,10,N,N,-,-1,-1
OUSELEY.txt,18850,20526,1676,10,N,N,-,-1,-1
OUSELEY.txt,19250,20605,1355,10,N,N,-,-1,-1
OUSELEY.txt,19652,20748,1096,10,N,N,-,-1,-1
OUSELEY.txt,19985,20942,957,10,N,N,-,-1,-1
OUSELEY.txt,20164,21291,1127,10,N,N,-,-1,-1
OUSELEY.txt,20219,21537,1318,10,N,N,-,-1,-1
OUSELEY.txt,20289,21780,1491,10,N,N,-,-1,-1
OUSELEY.txt,20340,22064,1724,10,N,N,-,-1,-1
OUSELEY.txt,20377,22185,1808,10,N,N,-,-1,-1
OUSELEY.txt,20485,22227,1742,10,N,N,-,-1,-1
OUSELEY.txt,20527,22606,2079,10,N,N,-,-1,-1
OUSELEY.txt,20606,22903,2297,10,N,N,-,-1,-1
OUSELEY.txt,20749,23044,2295,10,Y,N,-,-1,-1
OUSELEY.txt,20945,23152,2207,10,Y,N,-,-1,-1
OUSELEY.txt,21293,23360,2067,10,Y,N,-,-1,-1
OUSELEY.txt,21538,23536,1998,10,Y,N,-,-1,-1
OUSELEY.txt,21783,23987,2204,10,Y,N,-,-1,-1
OUSELEY.txt,22067,24355,2288,10,Y,N,-,-1,-1
OUSELEY.txt,22186,24620,2434,10,Y,N,-,-1,-1
OUSELEY.txt,22232,25116,2884,10,Y,N,-,-1,-1
OUSELEY.txt,22607,25175,2568,10,Y,N,-,-1,-1
OUSELEY.txt,22906,25342,2436,10,N,N,-,-1,-1
OUSELEY.txt,23045,25475,2430,10,Y,N,-,-1,-1
OUSELEY.txt,23153,25672,2519,10,N,N,-,-1,-1
OUSELEY.txt,23361,25750,2389,10,N,N,-,-1,-1
OUSELEY.txt,23539,25949,2410,10,Y,N,-,-1,-1
OUSELEY.txt,23988,25971,1983,10,N,N,-,-1,-1
OUSELEY.txt,24356,26033,1677,10,N,N,-,-1,-1
OUSELEY.txt,24623,26096,1473,10,N,N,-,-1,-1
OUSELEY.txt,25117,26142,1025,10,N,N,-,-1,-1
OUSELEY.txt,25178,26208,1030,10,N,N,-,-1,-1
OUSELEY.txt,25343,26327,984,10,N,N,-,-1,-1
OUSELEY.txt,25478,26366,888,10,Y,N,-,-1,-1
OUSELEY.txt,25675,26392,717,10,Y,N,-,-1,-1
OUSELEY.txt,25751,26455,704,10,Y,N,-,-1,-1
OUSELEY.txt,25950,26548,598,10,N,N,-,-1,-1
OUSELEY.txt,25972,26594,622,10,N,N,-,-1,-1
OUSELEY.txt,26034,26645,611,10,N,N,-,-1,-1
OUSELEY.txt,26097,26674,577,10,N,N,-,-1,-1
OUSELEY.txt,26144,26731,587,10,N,N,-,-1,-1
OUSELEY.txt,26209,26866,657,10,N,N,-,-1,-1
OUSELEY.txt,26328,26929,601,10,N,N,-,-1,-1
OUSELEY.txt,26367,26950,583,10,N,N,-,-1,-1
OUSELEY.txt,26393,26971,578,10,N,N,-,-1,-1
OUSELEY.txt,26457,27082,625,10,N,N,-,-1,-1
OUSELEY.txt,26549,27154,605,10,N,N,-,-1,-1
OUSELEY.txt,26595,27361,766,10,N,N,-,-1,-1
OUSELEY.txt,26646,27465,819,10,N,N,-,-1,-1
OUSELEY.txt,26675,27490,815,10,N,N,-,-1,-1
OUSELEY.txt,26732,27521,789,10,N,N,-,-1,-1
OUSELEY.txt,26868,27746,878,10,N,N,-,-1,-1
OUSELEY.txt,26930,28456,1526,10,N,N,-,-1,-1
OUSELEY.txt,26951,28731,1780,10,N,N,-,-1,-1
OUSELEY.txt,26973,29234,2261,10,Y,N,-,-1,-1
OUSELEY.txt,27083,29295,2212,10,Y,N,-,-1,-1
OUSELEY.txt,27159,29304,2145,10,Y,N,-,-1,-1
OUSELEY.txt,27362,29377,2015,10,Y,N,-,-1,-1
OUSELEY.txt,27466,29386,1920,10,Y,N,-,-1,-1
OUSELEY.txt,27491,29457,1966,10,Y,N,-,-1,-1
OUSELEY.txt,27524,29485,1961,10,Y,N,-,-1,-1
OUSELEY.txt,27747,29496,1749,10,N,N,-,-1,-1
OUSELEY.txt,28457,29533,1076,10,N,N,-,-1,-1
OUSELEY.txt,28734,29541,807,10,N,N,-,-1,-1
OUSELEY.txt,29235,29554,319,10,N,N,-,-1,-1
OUSELEY.txt,29298,29563,265,10,N,N,-,-1,-1
OUSELEY.txt,29305,29638,333,10,N,N,-,-1,-1
OUSELEY.txt,29380,30036,656,10,N,N,-,-1,-1
OUSELEY.txt,29387,30439,1052,10,N,N,-,-1,-1
OUSELEY.txt,29462,30577,1115,10,N,N,-,-1,-1
OUSELEY.txt,29490,30763,1273,10,N,N,-,-1,-1
OUSELEY.txt,29497,31689,2192,10,N,N,-,-1,-1
OUSELEY.txt,29535,31699,2164,10,N,N,-,-1,-1
OUSELEY.txt,29542,31728,2186,10,N,N,-,-1,-1
OUSELEY.txt,29557,31828,2271,10,N,N,-,-1,-1
OUSELEY.txt,29564,31907,2343,10,N,N,-,-1,-1
OUSELEY.txt,29641,32031,2390,10,N,N,-,-1,-1
OUSELEY.txt,30037,32106,2069,10,N,N,-,-1,-1
OUSELEY.txt,30442,32211,1769,10,N,N,-,-1,-1
OUSELEY.txt,30579,32320,1741,10,N,N,-,-1,-1
OUSELEY.txt,30766,32436,1670,10,N,N,-,-1,-1
OUSELEY.txt,31692,32496,804,10,N,N,-,-1,-1
OUSELEY.txt,31702,32656,954,10,N,N,-,-1,-1
OUSELEY.txt,31730,33010,1280,10,N,N,-,-1,-1
OUSELEY.txt,31829,33086,1257,10,N,N,-,-1,-1
OUSELEY.txt,31908,33174,1266,10,N,N,-,-1,-1
OUSELEY.txt,32032,33349,1317,10,N,N,-,-1,-1
OUSELEY.txt,32107,33459,1352,10,N,N,-,-1,-1
OUSELEY.txt,32212,33516,1304,10,N,N,-,-1,-1
OUSELEY.txt,32321,33541,1220,10,N,N,-,-1,-1
OUSELEY.txt,32437,33759,1322,10,N,N,-,-1,-1
OUSELEY.txt,32497,34097,1600,10,N,N,-,-1,-1
OUSELEY.txt,32658,34283,1625,10,N,N,-,-1,-1
OUSELEY.txt,33015,34373,1358,10,N,N,-,-1,-1
OUSELEY.txt,33087,34621,1534,10,N,N,-,-1,-1
OUSELEY.txt,33176,34723,1547,10,N,N,-,-1,-1
OUSELEY.txt,33350,34832,1482,10,N,N,-,-1,-1
OUSELEY.txt,33462,34856,1394,10,N,N,-,-1,-1
OUSELEY.txt,33519,35275,1756,10,N,N,-,-1,-1
OUSELEY.txt,33544,35484,1940,10,N,N,-,-1,-1
OUSELEY.txt,33764,35655,1891,10,N,N,-,-1,-1
OUSELEY.txt,34098,35816,1718,10,N,N,-,-1,-1
OUSELEY.txt,34284,36135,1851,10,N,N,-,-1,-1
OUSELEY.txt,34376,36323,1947,10,N,N,-,-1,-1
OUSELEY.txt,34622,36385,1763,10,N,N,-,-1,-1
OUSELEY.txt,34725,36489,1764,10,N,N,-,-1,-1
OUSELEY.txt,34833,36788,1955,10,N,N,-,-1,-1
OUSELEY.txt,34859,36988,2129,10,N,N,-,-1,-1
OUSELEY.txt,35278,37206,1928,10,N,N,-,-1,-1
OUSELEY.txt,35485,37399,1914,10,N,N,-,-1,-1
OUSELEY.txt,35657,37785,2128,10,N,N,-,-1,-1
OUSELEY.txt,35817,37970,2153,10,N,N,-,-1,-1
OUSELEY.txt,36136,38180,2044,10,N,N,-,-1,-1
OUSELEY.txt,36324,38275,1951,10,N,N,-,-1,-1
OUSELEY.txt,36386,38654,2268,10,N,N,-,-1,-1
OUSELEY.txt,36491,38967,2476,10,Y,N,-,-1,-1
OUSELEY.txt,36789,39000,2211,10,N,N,-,-1,-1
OUSELEY.txt,36993,39113,2120,10,N,N,-,-1,-1
OUSELEY.txt,37212,39149,1937,10,N,N,-,-1,-1
OUSELEY.txt,37400,39157,1757,10,N,N,-,-1,-1
OUSELEY.txt,37786,39324,1538,10,N,N,-,-1,-1
OUSELEY.txt,37973,39475,1502,10,N,N,-,-1,-1
OUSELEY.txt,38183,39483,1300,10,N,N,-,-1,-1
OUSELEY.txt,38276,39706,1430,10,Y,N,-,-1,-1
OUSELEY.txt,38657,39714,1057,10,N,N,-,-1,-1
OUSELEY.txt,38970,39802,832,10,N,N,-,-1,-1
OUSELEY.txt,39005,39810,805,10,N,N,-,-1,-1
OUSELEY.txt,39116,39892,776,10,N,N,-,-1,-1
OUSELEY.txt,39152,39900,748,10,N,N,-,-1,-1
OUSELEY.txt,39158,39972,814,10,N,N,-,-1,-1
OUSELEY.txt,39325,39999,674,10,N,N,-,-1,-1
OUSELEY.txt,39478,40632,1154,10,Y,N,-,-1,-1
OUSELEY.txt,39484,40775,1291,10,Y,N,-,-1,-1
OUSELEY.txt,39709,40960,1251,10,Y,N,-,-1,-1
OUSELEY.txt,39715,41086,1371,10,Y,N,-,-1,-1
OUSELEY.txt,39805,41245,1440,10,Y,N,-,-1,-1
OUSELEY.txt,39811,41258,1447,10,Y,N,-,-1,-1
OUSELEY.txt,39895,41391,1496,10,Y,N,-,-1,-1
OUSELEY.txt,39901,41588,1687,10,Y,N,-,-1,-1
OUSELEY.txt,39973,41635,1662,10,Y,N,-,-1,-1
OUSELEY.txt,40000,41657,1657,10,Y,Y,1437472966198,394609,395892
OUSELEY.txt,40635,41771,1136,10,Y,Y,1437472966198,394609,395892
OUSELEY.txt,40780,41981,1201,10,Y,Y,1437472966198,394609,395892
OUSELEY.txt,40963,42137,1174,10,N,Y,1437472966198,394609,395892
OUSELEY.txt,41087,42174,1087,10,Y,Y,1437472966198,394609,395892
OUSELEY.txt,41248,42277,1029,10,Y,Y,1437472966198,394609,395892
OUSELEY.txt,41259,42502,1243,10,Y,Y,1437472966198,394609,395892
OUSELEY.txt,41392,42946,1554,10,Y,Y,1437472966198,394609,395892
OUSELEY.txt,41591,43209,1618,10,N,Y,1437472966198,394609,395892
OUSELEY.txt,41640,43436,1796,10,N,Y,1437472966198,394609,395892
OUSELEY.txt,41660,43732,2072,10,N,Y,1437472966198,394609,395892
OUSELEY.txt,41772,43794,2022,10,N,Y,1437472966198,394609,395892
OUSELEY.txt,41982,43849,1867,10,N,Y,1437472966198,394609,395892
OUSELEY.txt,42138,44058,1920,10,N,Y,1437472966198,394609,395892
OUSELEY.txt,42177,44226,2049,10,N,Y,1437472966198,394609,395892
OUSELEY.txt,42279,44276,1997,10,N,Y,1437472966198,394609,395892
OUSELEY.txt,42505,44359,1854,10,N,Y,1437472966198,394609,395892
OUSELEY.txt,42949,44464,1515,10,N,Y,1437472966198,394609,395892
OUSELEY.txt,43210,44530,1320,10,N,Y,1437472966198,394609,395892
OUSELEY.txt,43437,44602,1165,10,N,Y,1437472966198,394609,395892
OUSELEY.txt,43735,44625,890,10,N,Y,1437472966198,394609,395892
OUSELEY.txt,43795,44660,865,10,N,Y,1437472966198,394609,395892
OUSELEY.txt,43852,45035,1183,10,N,Y,1437472966198,394609,395892
OUSELEY.txt,44061,45331,1270,10,N,N,-,-1,-1
OUSELEY.txt,44231,45365,1134,10,N,N,-,-1,-1
OUSELEY.txt,44279,45391,1112,10,N,N,-,-1,-1
OUSELEY.txt,44360,45411,1051,10,N,N,-,-1,-1
OUSELEY.txt,44465,45472,1007,10,N,N,-,-1,-1
OUSELEY.txt,44531,45476,945,10,N,N,-,-1,-1
OUSELEY.txt,44603,45580,977,10,N,N,-,-1,-1
OUSELEY.txt,44627,45584,957,10,N,N,-,-1,-1
OUSELEY.txt,44663,45594,931,10,N,N,-,-1,-1
OUSELEY.txt,45036,45622,586,10,N,N,-,-1,-1
OUSELEY.txt,45334,45661,327,10,N,N,-,-1,-1
OUSELEY.txt,45366,45666,300,10,N,N,-,-1,-1
OUSELEY.txt,45392,45674,282,10,N,N,-,-1,-1
OUSELEY.txt,45412,45675,263,10,N,N,-,-1,-1
OUSELEY.txt,45473,45711,238,10,N,N,-,-1,-1
OUSELEY.txt,45477,45969,492,10,N,N,-,-1,-1
OUSELEY.txt,45581,46038,457,10,N,N,-,-1,-1
OUSELEY.txt,45585,46110,525,10,N,N,-,-1,-1
OUSELEY.txt,45599,46237,638,10,N,N,-,-1,-1
OUSELEY.txt,45627,46343,716,10,N,N,-,-1,-1
OUSELEY.txt,45663,46552,889,10,N,N,-,-1,-1
OUSELEY.txt,45667,46767,1100,10,N,N,-,-1,-1
OUSELEY.txt,45674,46850,1176,10,N,N,-,-1,-1
OUSELEY.txt,45678,46996,1318,10,N,N,-,-1,-1
OUSELEY.txt,45714,47109,1395,10,N,N,-,-1,-1
OUSELEY.txt,45970,47309,1339,10,N,N,-,-1,-1
OUSELEY.txt,46039,47339,1300,10,N,N,-,-1,-1
OUSELEY.txt,46111,47345,1234,10,N,N,-,-1,-1
OUSELEY.txt,46240,47366,1126,10,N,N,-,-1,-1
OUSELEY.txt,46344,47371,1027,10,N,N,-,-1,-1
OUSELEY.txt,46553,47620,1067,10,N,N,-,-1,-1
OUSELEY.txt,46768,47673,905,10,N,N,-,-1,-1
OUSELEY.txt,46853,47706,853,10,N,N,-,-1,-1
OUSELEY.txt,46999,47981,982,10,N,N,-,-1,-1
OUSELEY.txt,47110,48116,1006,10,N,N,-,-1,-1
OUSELEY.txt,47312,48248,936,10,N,N,-,-1,-1
OUSELEY.txt,47340,48279,939,10,N,N,-,-1,-1
OUSELEY.txt,47346,48425,1079,10,N,N,-,-1,-1
OUSELEY.txt,47367,48484,1117,10,N,N,-,-1,-1
OUSELEY.txt,47372,48787,1415,10,N,N,-,-1,-1
OUSELEY.txt,47625,48930,1305,10,N,N,-,-1,-1
OUSELEY.txt,47678,49026,1348,10,N,N,-,-1,-1
OUSELEY.txt,47709,49123,1414,10,N,N,-,-1,-1
OUSELEY.txt,47982,49200,1218,10,N,N,-,-1,-1
OUSELEY.txt,48117,49306,1189,10,N,N,-,-1,-1
OUSELEY.txt,48249,49533,1284,10,N,N,-,-1,-1
OUSELEY.txt,48280,49590,1310,10,N,N,-,-1,-1
OUSELEY.txt,48426,49830,1404,10,N,N,-,-1,-1
OUSELEY.txt,48485,49964,1479,10,N,N,-,-1,-1
OUSELEY.txt,48788,50240,1452,10,N,N,-,-1,-1
OUSELEY.txt,48931,50386,1455,10,N,N,-,-1,-1
OUSELEY.txt,49027,50521,1494,10,N,N,-,-1,-1
OUSELEY.txt,49124,50721,1597,10,N,N,-,-1,-1
OUSELEY.txt,49201,50822,1621,10,N,N,-,-1,-1
OUSELEY.txt,49307,50911,1604,10,N,N,-,-1,-1
OUSELEY.txt,49534,51061,1527,10,N,N,-,-1,-1
OUSELEY.txt,49591,51153,1562,10,N,N,-,-1,-1
OUSELEY.txt,49831,51287,1456,10,N,N,-,-1,-1
OUSELEY.txt,49965,51424,1459,10,N,N,-,-1,-1
OUSELEY.txt,50242,51556,1314,10,N,N,-,-1,-1
OUSELEY.txt,50387,51763,1376,10,N,N,-,-1,-1
OUSELEY.txt,50522,52030,1508,10,N,N,-,-1,-1
OUSELEY.txt,50723,52124,1401,10,N,N,-,-1,-1
OUSELEY.txt,50823,52228,1405,10,N,N,-,-1,-1
OUSELEY.txt,50912,52472,1560,10,N,N,-,-1,-1
OUSELEY.txt,51062,52726,1664,10,N,N,-,-1,-1
OUSELEY.txt,51154,52783,1629,10,N,N,-,-1,-1
OUSELEY.txt,51288,52903,1615,10,N,N,-,-1,-1
OUSELEY.txt,51425,52990,1565,10,N,N,-,-1,-1
OUSELEY.txt,51557,53116,1559,10,N,N,-,-1,-1
OUSELEY.txt,51764,53229,1465,10,N,N,-,-1,-1
OUSELEY.txt,52031,53627,1596,10,N,N,-,-1,-1
OUSELEY.txt,52125,53860,1735,10,N,N,-,-1,-1
OUSELEY.txt,52230,53930,1700,10,N,N,-,-1,-1
OUSELEY.txt,52473,54066,1593,10,N,N,-,-1,-1
OUSELEY.txt,52727,54318,1591,10,N,N,-,-1,-1
OUSELEY.txt,52784,54359,1575,10,N,N,-,-1,-1
OUSELEY.txt,52904,54402,1498,10,N,N,-,-1,-1
OUSELEY.txt,52991,54514,1523,10,N,N,-,-1,-1
OUSELEY.txt,53118,54599,1481,10,N,N,-,-1,-1
OUSELEY.txt,53230,54849,1619,10,N,N,-,-1,-1
OUSELEY.txt,53628,55047,1419,10,N,N,-,-1,-1
OUSELEY.txt,53861,55268,1407,10,N,N,-,-1,-1
OUSELEY.txt,53931,55373,1442,10,N,N,-,-1,-1
OUSELEY.txt,54068,55522,1454,10,N,N,-,-1,-1
OUSELEY.txt,54319,56130,1811,10,Y,N,-,-1,-1
OUSELEY.txt,54364,56419,2055,10,Y,N,-,-1,-1
OUSELEY.txt,54403,56497,2094,10,Y,N,-,-1,-1
OUSELEY.txt,54515,56588,2073,10,Y,N,-,-1,-1
OUSELEY.txt,54600,56644,2044,10,N,N,-,-1,-1
OUSELEY.txt,54850,56806,1956,10,N,N,-,-1,-1
OUSELEY.txt,55048,57027,1979,10,N,N,-,-1,-1
OUSELEY.txt,55269,57179,1910,10,N,N,-,-1,-1
OUSELEY.txt,55374,57319,1945,10,N,N,-,-1,-1
OUSELEY.txt,55523,57459,1936,10,N,N,-,-1,-1
OUSELEY.txt,56132,57582,1450,10,N,N,-,-1,-1
OUSELEY.txt,56424,57603,1179,10,N,N,-,-1,-1
OUSELEY.txt,56498,57625,1127,10,N,N,-,-1,-1
OUSELEY.txt,56589,57735,1146,10,N,N,-,-1,-1
OUSELEY.txt,56645,58223,1578,10,N,N,-,-1,-1
OUSELEY.txt,56807,58281,1474,10,N,N,-,-1,-1
OUSELEY.txt,57028,58350,1322,10,N,N,-,-1,-1
OUSELEY.txt,57180,58499,1319,10,N,N,-,-1,-1
OUSELEY.txt,57320,58599,1279,10,N,N,-,-1,-1
OUSELEY.txt,57460,58604,1144,10,N,N,-,-1,-1
OUSELEY.txt,57587,58661,1074,10,N,N,-,-1,-1
OUSELEY.txt,57605,58666,1061,10,N,N,-,-1,-1
OUSELEY.txt,57627,58675,1048,10,N,N,-,-1,-1
OUSELEY.txt,57738,58842,1104,10,N,N,-,-1,-1
OUSELEY.txt,58226,58984,758,10,N,N,-,-1,-1
OUSELEY.txt,58282,59146,864,10,N,N,-,-1,-1
OUSELEY.txt,58352,59228,876,10,N,N,-,-1,-1
OUSELEY.txt,58500,59381,881,10,N,N,-,-1,-1
OUSELEY.txt,58600,59649,1049,10,N,N,-,-1,-1
OUSELEY.txt,58605,59714,1109,10,N,N,-,-1,-1
OUSELEY.txt,58662,59932,1270,10,N,N,-,-1,-1
OUSELEY.txt,58667,60035,1368,10,N,N,-,-1,-1
OUSELEY.txt,58676,60074,1398,10,N,N,-,-1,-1
OUSELEY.txt,58843,60197,1354,10,N,N,-,-1,-1
OUSELEY.txt,58985,60383,1398,10,N,N,-,-1,-1
OUSELEY.txt,59149,60459,1310,10,N,N,-,-1,-1
OUSELEY.txt,59230,60781,1551,10,N,N,-,-1,-1
OUSELEY.txt,59382,60866,1484,10,N,N,-,-1,-1
OUSELEY.txt,59650,60972,1322,10,N,N,-,-1,-1
OUSELEY.txt,59715,61223,1508,10,Y,N,-,-1,-1
OUSELEY.txt,59934,61485,1551,10,N,N,-,-1,-1
OUSELEY.txt,60036,61579,1543,10,N,N,-,-1,-1
OUSELEY.txt,60077,61668,1591,10,Y,N,-,-1,-1
OUSELEY.txt,60199,61795,1596,10,Y,N,-,-1,-1
OUSELEY.txt,60384,61867,1483,10,Y,N,-,-1,-1
OUSELEY.txt,60460,61937,1477,10,Y,N,-,-1,-1
OUSELEY.txt,60784,62384,1600,10,N,N,-,-1,-1
OUSELEY.txt,60868,62503,1635,10,N,N,-,-1,-1
OUSELEY.txt,60973,62581,1608,10,N,N,-,-1,-1
OUSELEY.txt,61225,62613,1388,10,N,N,-,-1,-1
OUSELEY.txt,61487,62631,1144,10,N,N,-,-1,-1
OUSELEY.txt,61581,62669,1088,10,N,N,-,-1,-1
OUSELEY.txt,61670,63145,1475,10,N,N,-,-1,-1
OUSELEY.txt,61798,63192,1394,10,N,N,-,-1,-1
OUSELEY.txt,61868,63416,1548,10,N,N,-,-1,-1
OUSELEY.txt,61938,63518,1580,10,N,N,-,-1,-1
OUSELEY.txt,62385,63646,1261,10,N,N,-,-1,-1
OUSELEY.txt,62504,63843,1339,10,N,N,-,-1,-1
OUSELEY.txt,62582,63985,1403,10,N,N,-,-1,-1
OUSELEY.txt,62616,64202,1586,10,N,N,-,-1,-1
OUSELEY.txt,62636,64352,1716,10,N,N,-,-1,-1
OUSELEY.txt,62672,64380,1708,10,N,N,-,-1,-1
OUSELEY.txt,63150,64548,1398,10,N,N,-,-1,-1
OUSELEY.txt,63194,64777,1583,10,N,N,-,-1,-1
OUSELEY.txt,63418,65070,1652,10,N,N,-,-1,-1
OUSELEY.txt,63519,65164,1645,10,N,N,-,-1,-1
OUSELEY.txt,63647,65291,1644,10,N,N,-,-1,-1
OUSELEY.txt,63844,65493,1649,10,N,N,-,-1,-1
OUSELEY.txt,63986,65596,1610,10,N,N,-,-1,-1
OUSELEY.txt,64203,65739,1536,10,N,N,-,-1,-1
OUSELEY.txt,64357,65808,1451,10,N,N,-,-1,-1
OUSELEY.txt,64383,65956,1573,10,N,N,-,-1,-1
OUSELEY.txt,64549,66291,1742,10,N,N,-,-1,-1
OUSELEY.txt,64779,66540,1761,10,N,N,-,-1,-1
OUSELEY.txt,65071,66748,1677,10,N,N,-,-1,-1
OUSELEY.txt,65165,66819,1654,10,N,N,-,-1,-1
OUSELEY.txt,65292,66829,1537,10,N,N,-,-1,-1
OUSELEY.txt,65494,67403,1909,10,N,N,-,-1,-1
OUSELEY.txt,65597,67586,1989,10,N,N,-,-1,-1
OUSELEY.txt,65740,67887,2147,10,N,N,-,-1,-1
OUSELEY.txt,65809,68184,2375,10,N,N,-,-1,-1
OUSELEY.txt,65957,68345,2388,10,N,N,-,-1,-1
OUSELEY.txt,66292,68355,2063,10,N,N,-,-1,-1
OUSELEY.txt,66541,68432,1891,10,N,N,-,-1,-1
OUSELEY.txt,66749,68557,1808,10,N,N,-,-1,-1
OUSELEY.txt,66820,68724,1904,10,N,N,-,-1,-1
OUSELEY.txt,66834,69140,2306,10,N,N,-,-1,-1
OUSELEY.txt,67408,69220,1812,10,N,N,-,-1,-1
OUSELEY.txt,67587,69279,1692,10,N,N,-,-1,-1
OUSELEY.txt,67888,69565,1677,10,N,N,-,-1,-1
OUSELEY.txt,68186,69810,1624,10,N,N,-,-1,-1
OUSELEY.txt,68346,70002,1656,10,N,N,-,-1,-1
OUSELEY.txt,68356,70056,1700,10,N,N,-,-1,-1
OUSELEY.txt,68433,70297,1864,10,N,N,-,-1,-1
OUSELEY.txt,68562,70598,2036,10,N,N,-,-1,-1
OUSELEY.txt,68725,70712,1987,10,N,N,-,-1,-1
OUSELEY.txt,69141,70813,1672,10,N,N,-,-1,-1
OUSELEY.txt,69222,70958,1736,10,N,N,-,-1,-1
OUSELEY.txt,69280,71235,1955,10,N,N,-,-1,-1
OUSELEY.txt,69566,71384,1818,10,N,N,-,-1,-1
OUSELEY.txt,69811,71669,1858,10,N,N,-,-1,-1
OUSELEY.txt,70007,71696,1689,10,N,N,-,-1,-1
OUSELEY.txt,70059,71702,1643,10,N,N,-,-1,-1
OUSELEY.txt,70299,71736,1437,10,N,N,-,-1,-1
OUSELEY.txt,70600,71804,1204,10,N,N,-,-1,-1
OUSELEY.txt,70713,72070,1357,10,N,N,-,-1,-1
OUSELEY.txt,70814,72298,1484,10,N,N,-,-1,-1
OUSELEY.txt,70959,72383,1424,10,N,N,-,-1,-1
OUSELEY.txt,71237,72529,1292,10,N,N,-,-1,-1
OUSELEY.txt,71385,72595,1210,10,N,N,-,-1,-1
OUSELEY.txt,71670,72739,1069,10,N,N,-,-1,-1
OUSELEY.txt,71698,72872,1174,10,N,N,-,-1,-1
OUSELEY.txt,71703,73029,1326,10,N,N,-,-1,-1
OUSELEY.txt,71738,73259,1521,10,N,N,-,-1,-1
OUSELEY.txt,71809,73718,1909,10,N,N,-,-1,-1
OUSELEY.txt,72071,73844,1773,10,N,N,-,-1,-1
OUSELEY.txt,72299,73955,1656,10,N,N,-,-1,-1
OUSELEY.txt,72384,73970,1586,10,N,N,-,-1,-1
OUSELEY.txt,72530,73985,1455,10,N,N,-,-1,-1
OUSELEY.txt,72596,74090,1494,10,N,N,-,-1,-1
OUSELEY.txt,72740,74298,1558,10,N,N,-,-1,-1
OUSELEY.txt,72877,74448,1571,10,N,N,-,-1,-1
OUSELEY.txt,73030,74532,1502,10,N,N,-,-1,-1
OUSELEY.txt,73260,74688,1428,10,N,N,-,-1,-1
OUSELEY.txt,73719,74729,1010,10,N,N,-,-1,-1
OUSELEY.txt,73845,74949,1104,10,N,N,-,-1,-1
OUSELEY.txt,73960,75021,1061,10,N,N,-,-1,-1
OUSELEY.txt,73971,75076,1105,10,N,N,-,-1,-1
OUSELEY.txt,73988,75202,1214,10,N,N,-,-1,-1
OUSELEY.txt,74091,75370,1279,10,N,N,-,-1,-1
OUSELEY.txt,74299,75410,1111,10,N,N,-,-1,-1
OUSELEY.txt,74450,75750,1300,10,N,N,-,-1,-1
OUSELEY.txt,74533,75922,1389,10,N,N,-,-1,-1
OUSELEY.txt,74693,76068,1375,10,N,N,-,-1,-1
OUSELEY.txt,74732,76170,1438,10,N,N,-,-1,-1
OUSELEY.txt,74950,76274,1324,10,N,N,-,-1,-1
OUSELEY.txt,75022,76340,1318,10,N,N,-,-1,-1
OUSELEY.txt,75077,76443,1366,10,N,N,-,-1,-1
OUSELEY.txt,75203,76623,1420,10,N,N,-,-1,-1
OUSELEY.txt,75372,76974,1602,10,N,N,-,-1,-1
OUSELEY.txt,75412,77140,1728,10,N,N,-,-1,-1
OUSELEY.txt,75752,77309,1557,10,N,N,-,-1,-1
OUSELEY.txt,75924,77537,1613,10,N,N,-,-1,-1
OUSELEY.txt,76069,77797,1728,10,Y,N,-,-1,-1
OUSELEY.txt,76171,78037,1866,10,Y,N,-,-1,-1
OUSELEY.txt,76275,78187,1912,10,Y,N,-,-1,-1
OUSELEY.txt,76345,78364,2019,10,Y,N,-,-1,-1
OUSELEY.txt,76448,78631,2183,10,Y,N,-,-1,-1
OUSELEY.txt,76624,78817,2193,10,Y,N,-,-1,-1
OUSELEY.txt,76975,78862,1887,10,N,N,-,-1,-1
OUSELEY.txt,77141,78884,1743,10,N,N,-,-1,-1
OUSELEY.txt,77310,78920,1610,10,N,N,-,-1,-1
OUSELEY.txt,77538,79226,1688,10,N,N,-,-1,-1
OUSELEY.txt,77798,79427,1629,10,N,N,-,-1,-1
OUSELEY.txt,78038,79556,1518,10,N,N,-,-1,-1
OUSELEY.txt,78188,79561,1373,10,N,N,-,-1,-1
OUSELEY.txt,78367,79579,1212,10,N,N,-,-1,-1
OUSELEY.txt,78632,79584,952,10,N,N,-,-1,-1
OUSELEY.txt,78818,79593,775,10,N,N,-,-1,-1
OUSELEY.txt,78865,79704,839,10,N,N,-,-1,-1
OUSELEY.txt,78889,79766,877,10,N,N,-,-1,-1
OUSELEY.txt,78923,79988,1065,10,N,N,-,-1,-1
OUSELEY.txt,79227,80282,1055,10,N,N,-,-1,-1
OUSELEY.txt,79429,80422,993,10,N,N,-,-1,-1
OUSELEY.txt,79557,80849,1292,10,N,N,-,-1,-1
OUSELEY.txt,79562,80996,1434,10,N,N,-,-1,-1
OUSELEY.txt,79580,81268,1688,10,N,N,-,-1,-1
OUSELEY.txt,79585,81601,2016,10,Y,N,-,-1,-1
OUSELEY.txt,79595,81723,2128,10,Y,N,-,-1,-1
OUSELEY.txt,79705,81984,2279,10,N,N,-,-1,-1
OUSELEY.txt,79767,82014,2247,10,Y,N,-,-1,-1
OUSELEY.txt,79989,82140,2151,10,Y,N,-,-1,-1
OUSELEY.txt,80283,82184,1901,10,Y,N,-,-1,-1
OUSELEY.txt,80427,82377,1950,10,Y,N,-,-1,-1
OUSELEY.txt,80850,82475,1625,10,N,N,-,-1,-1
OUSELEY.txt,80997,82582,1585,10,N,N,-,-1,-1
OUSELEY.txt,81269,82711,1442,10,N,N,-,-1,-1
OUSELEY.txt,81602,82926,1324,10,N,N,-,-1,-1
OUSELEY.txt,81724,83096,1372,10,N,N,-,-1,-1
OUSELEY.txt,81989,83298,1309,10,N,N,-,-1,-1
OUSELEY.txt,82017,83484,1467,10,N,N,-,-1,-1
OUSELEY.txt,82141,83651,1510,10,N,N,-,-1,-1
OUSELEY.txt,82185,83852,1667,10,N,N,-,-1,-1
OUSELEY.txt,82378,83961,1583,10,N,N,-,-1,-1
OUSELEY.txt,82476,83984,1508,10,N,N,-,-1,-1
OUSELEY.txt,82583,84207,1624,10,N,N,-,-1,-1
OUSELEY.txt,82712,84384,1672,10,N,N,-,-1,-1
OUSELEY.txt,82928,84433,1505,10,N,N,-,-1,-1
OUSELEY.txt,83097,84525,1428,10,N,N,-,-1,-1
OUSELEY.txt,83299,84628,1329,10,N,N,-,-1,-1
OUSELEY.txt,83486,84820,1334,10,N,N,-,-1,-1
OUSELEY.txt,83652,84960,1308,10,N,N,-,-1,-1
OUSELEY.txt,83853,85151,1298,10,N,N,-,-1,-1
OUSELEY.txt,83966,85179,1213,10,N,N,-,-1,-1
OUSELEY.txt,83987,85184,1197,10,N,N,-,-1,-1
OUSELEY.txt,84208,85218,1010,10,N,N,-,-1,-1
OUSELEY.txt,84385,85501,1116,10,N,N,-,-1,-1
OUSELEY.txt,84434,85730,1296,10,N,N,-,-1,-1
OUSELEY.txt,84527,85815,1288,10,N,N,-,-1,-1
OUSELEY.txt,84629,85962,1333,10,N,N,-,-1,-1
OUSELEY.txt,84821,86046,1225,10,N,N,-,-1,-1
OUSELEY.txt,84961,86192,1231,10,N,N,-,-1,-1
OUSELEY.txt,85152,86552,1400,10,N,N,-,-1,-1
OUSELEY.txt,85180,86801,1621,10,N,N,-,-1,-1
OUSELEY.txt,85185,87042,1857,10,N,N,-,-1,-1
OUSELEY.txt,85219,87185,1966,10,N,N,-,-1,-1
OUSELEY.txt,85502,87336,1834,10,N,N,-,-1,-1
OUSELEY.txt,85731,87609,1878,10,Y,N,-,-1,-1
OUSELEY.txt,85816,87638,1822,10,Y,N,-,-1,-1
OUSELEY.txt,85963,87693,1730,10,Y,N,-,-1,-1
OUSELEY.txt,86047,87793,1746,10,Y,N,-,-1,-1
OUSELEY.txt,86193,87873,1680,10,Y,N,-,-1,-1
OUSELEY.txt,86553,88235,1682,10,Y,N,-,-1,-1
OUSELEY.txt,86802,88417,1615,10,N,N,-,-1,-1
OUSELEY.txt,87045,88622,1577,10,N,N,-,-1,-1
OUSELEY.txt,87186,88647,1461,10,N,N,-,-1,-1
OUSELEY.txt,87338,88788,1450,10,N,N,-,-1,-1
OUSELEY.txt,87614,88852,1238,10,N,N,-,-1,-1
OUSELEY.txt,87641,88882,1241,10,N,N,-,-1,-1
OUSELEY.txt,87694,88959,1265,10,N,N,-,-1,-1
OUSELEY.txt,87794,89257,1463,10,N,N,-,-1,-1
OUSELEY.txt,87874,89532,1658,10,N,N,-,-1,-1
OUSELEY.txt,88236,89916,1680,10,N,N,-,-1,-1
OUSELEY.txt,88418,90158,1740,10,N,N,-,-1,-1
OUSELEY.txt,88623,90232,1609,10,N,N,-,-1,-1
OUSELEY.txt,88649,90356,1707,10,N,N,-,-1,-1
OUSELEY.txt,88789,90547,1758,10,N,N,-,-1,-1
OUSELEY.txt,88853,90892,2039,10,N,N,-,-1,-1
OUSELEY.txt,88887,91029,2142,10,N,N,-,-1,-1
OUSELEY.txt,88960,91112,2152,10,N,N,-,-1,-1
OUSELEY.txt,89258,91171,1913,10,N,N,-,-1,-1
OUSELEY.txt,89533,91360,1827,10,N,N,-,-1,-1
OUSELEY.txt,89917,91479,1562,10,N,N,-,-1,-1
OUSELEY.txt,90159,92075,1916,10,N,N,-,-1,-1
OUSELEY.txt,90233,92146,1913,10,N,N,-,-1,-1
OUSELEY.txt,90358,92330,1972,10,N,N,-,-1,-1
OUSELEY.txt,90548,92480,1932,10,N,N,-,-1,-1
OUSELEY.txt,90893,92537,1644,10,N,N,-,-1,-1
OUSELEY.txt,91032,92786,1754,10,N,N,-,-1,-1
OUSELEY.txt,91117,92964,1847,10,N,N,-,-1,-1
OUSELEY.txt,91172,93295,2123,10,N,N,-,-1,-1
OUSELEY.txt,91361,93517,2156,10,N,N,-,-1,-1
OUSELEY.txt,91480,93672,2192,10,N,N,-,-1,-1
OUSELEY.txt,92076,93852,1776,10,N,N,-,-1,-1
OUSELEY.txt,92147,94186,2039,10,N,N,-,-1,-1
OUSELEY.txt,92331,94407,2076,10,N,N,-,-1,-1
OUSELEY.txt,92483,94481,1998,10,N,N,-,-1,-1
OUSELEY.txt,92538,94542,2004,10,N,N,-,-1,-1
OUSELEY.txt,92787,94674,1887,10,N,N,-,-1,-1
OUSELEY.txt,92965,94873,1908,10,N,N,-,-1,-1
OUSELEY.txt,93296,94973,1677,10,N,N,-,-1,-1
OUSELEY.txt,93518,95249,1731,10,N,N,-,-1,-1
OUSELEY.txt,93673,95359,1686,10,N,N,-,-1,-1
OUSELEY.txt,93853,95434,1581,10,N,N,-,-1,-1
OUSELEY.txt,94187,95751,1564,10,N,N,-,-1,-1
OUSELEY.txt,94408,95959,1551,10,N,N,-,-1,-1
OUSELEY.txt,94482,96023,1541,10,N,N,-,-1,-1
OUSELEY.txt,94543,96141,1598,10,N,N,-,-1,-1
OUSELEY.txt,94675,96350,1675,10,N,N,-,-1,-1
OUSELEY.txt,94874,96532,1658,10,N,N,-,-1,-1
OUSELEY.txt,94976,96696,1720,10,N,N,-,-1,-1
OUSELEY.txt,95250,96820,1570,10,N,N,-,-1,-1
OUSELEY.txt,95360,96895,1535,10,N,N,-,-1,-1
OUSELEY.txt,95435,96973,1538,10,N,N,-,-1,-1
OUSELEY.txt,95752,97409,1657,10,N,N,-,-1,-1
OUSELEY.txt,95960,97652,1692,10,N,N,-,-1,-1
OUSELEY.txt,96024,97811,1787,10,N,N,-,-1,-1
OUSELEY.txt,96142,97828,1686,10,N,N,-,-1,-1
OUSELEY.txt,96352,97930,1578,10,N,N,-,-1,-1
OUSELEY.txt,96535,98099,1564,10,N,N,-,-1,-1
OUSELEY.txt,96697,98215,1518,10,N,N,-,-1,-1
OUSELEY.txt,96821,98278,1457,10,N,N,-,-1,-1
OUSELEY.txt,96896,98456,1560,10,N,N,-,-1,-1
OUSELEY.txt,96974,98945,1971,10,N,N,-,-1,-1
OUSELEY.txt,97410,99262,1852,10,N,N,-,-1,-1
OUSELEY.txt,97654,99779,2125,10,N,N,-,-1,-1
OUSELEY.txt,97816,100012,2196,10,N,N,-,-1,-1
OUSELEY.txt,97829,100337,2508,10,N,N,-,-1,-1
OUSELEY.txt,97931,100709,2778,10,N,N,-,-1,-1
OUSELEY.txt,98100,101036,2936,10,N,N,-,-1,-1
OUSELEY.txt,98216,101174,2958,10,N,N,-,-1,-1
OUSELEY.txt,98283,101940,3657,10,N,N,-,-1,-1
OUSELEY.txt,98457,102063,3606,10,N,N,-,-1,-1
OUSELEY.txt,98946,102756,3810,10,Y,N,-,-1,-1
OUSELEY.txt,99263,103197,3934,10,Y,N,-,-1,-1
OUSELEY.txt,99780,103464,3684,10,Y,N,-,-1,-1
OUSELEY.txt,100013,103722,3709,10,Y,N,-,-1,-1
OUSELEY.txt,100338,103896,3558,10,Y,N,-,-1,-1
OUSELEY.txt,100710,104019,3309,10,N,N,-,-1,-1
OUSELEY.txt,101037,104592,3555,10,N,N,-,-1,-1
OUSELEY.txt,101174,105199,4025,10,Y,N,-,-1,-1
OUSELEY.txt,101941,105423,3482,10,Y,N,-,-1,-1
OUSELEY.txt,102064,105485,3421,10,Y,N,-,-1,-1
OUSELEY.txt,102758,105644,2886,10,N,N,-,-1,-1
OUSELEY.txt,103200,106101,2901,10,N,N,-,-1,-1
OUSELEY.txt,103465,106385,2920,10,N,N,-,-1,-1
OUSELEY.txt,103723,106436,2713,10,N,N,-,-1,-1
OUSELEY.txt,103897,106440,2543,10,N,N,-,-1,-1
OUSELEY.txt,104020,106642,2622,10,N,N,-,-1,-1
OUSELEY.txt,104593,106929,2336,10,N,N,-,-1,-1
OUSELEY.txt,105201,106984,1783,10,N,N,-,-1,-1
OUSELEY.txt,105424,107079,1655,10,N,N,-,-1,-1
OUSELEY.txt,105486,107388,1902,10,N,N,-,-1,-1
OUSELEY.txt,105645,107590,1945,10,N,N,-,-1,-1
OUSELEY.txt,106102,107778,1676,10,N,N,-,-1,-1
OUSELEY.txt,106390,107823,1433,10,N,N,-,-1,-1
OUSELEY.txt,106439,107882,1443,10,N,N,-,-1,-1
OUSELEY.txt,106440,107975,1535,10,N,N,-,-1,-1
OUSELEY.txt,106643,108030,1387,10,N,N,-,-1,-1
OUSELEY.txt,106930,108082,1152,10,N,N,-,-1,-1
OUSELEY.txt,106989,108121,1132,10,N,N,-,-1,-1
OUSELEY.txt,107080,108136,1056,10,N,N,-,-1,-1
OUSELEY.txt,107390,108163,773,10,N,N,-,-1,-1
OUSELEY.txt,107591,108234,643,10,N,N,-,-1,-1
OUSELEY.txt,107779,108314,535,10,N,N,-,-1,-1
OUSELEY.txt,107824,108348,524,10,N,N,-,-1,-1
OUSELEY.txt,107882,108388,506,10,N,N,-,-1,-1
OUSELEY.txt,107976,108490,514,10,N,N,-,-1,-1
OUSELEY.txt,108031,108622,591,10,N,N,-,-1,-1
OUSELEY.txt,108085,108710,625,10,N,N,-,-1,-1
OUSELEY.txt,108122,108897,775,10,N,N,-,-1,-1
OUSELEY.txt,108137,108951,814,10,N,N,-,-1,-1
OUSELEY.txt,108164,108989,825,10,N,N,-,-1,-1
OUSELEY.txt,108237,109102,865,10,N,N,-,-1,-1
OUSELEY.txt,108315,109233,918,10,N,N,-,-1,-1
OUSELEY.txt,108351,109450,1099,10,N,N,-,-1,-1
OUSELEY.txt,108391,109598,1207,10,N,N,-,-1,-1
OUSELEY.txt,108491,109708,1217,10,N,N,-,-1,-1
OUSELEY.txt,108623,109744,1121,10,N,N,-,-1,-1
OUSELEY.txt,108711,109749,1038,10,N,N,-,-1,-1
OUSELEY.txt,108898,109798,900,10,N,N,-,-1,-1
OUSELEY.txt,108956,109803,847,10,N,N,-,-1,-1
OUSELEY.txt,108992,109995,1003,10,N,N,-,-1,-1
OUSELEY.txt,109103,110065,962,10,N,N,-,-1,-1
OUSELEY.txt,109234,110248,1014,10,N,N,-,-1,-1
OUSELEY.txt,109451,110291,840,10,N,N,-,-1,-1
OUSELEY.txt,109599,110440,841,10,N,N,-,-1,-1
OUSELEY.txt,109710,110557,847,10,N,N,-,-1,-1
OUSELEY.txt,109745,110748,1003,10,N,N,-,-1,-1
OUSELEY.txt,109750,110800,1050,10,N,N,-,-1,-1
OUSELEY.txt,109799,110970,1171,10,N,N,-,-1,-1
OUSELEY.txt,109804,111009,1205,10,N,N,-,-1,-1
OUSELEY.txt,109996,111357,1361,10,N,N,-,-1,-1
OUSELEY.txt,110066,111527,1461,10,N,N,-,-1,-1
OUSELEY.txt,110249,111688,1439,10,N,N,-,-1,-1
OUSELEY.txt,110292,111823,1531,10,N,N,-,-1,-1
OUSELEY.txt,110443,111949,1506,10,N,N,-,-1,-1
OUSELEY.txt,110558,112057,1499,10,N,N,-,-1,-1
OUSELEY.txt,110749,112100,1351,10,N,N,-,-1,-1
OUSELEY.txt,110801,112272,1471,10,N,N,-,-1,-1
OUSELEY.txt,110975,112395,1420,10,N,N,-,-1,-1
OUSELEY.txt,111012,112472,1460,10,N,N,-,-1,-1
OUSELEY.txt,111358,112917,1559,10,N,N,-,-1,-1
OUSELEY.txt,111528,113159,1631,10,N,N,-,-1,-1
OUSELEY.txt,111689,113233,1544,10,N,N,-,-1,-1
OUSELEY.txt,111824,113507,1683,10,N,N,-,-1,-1
OUSELEY.txt,111950,113559,1609,10,N,N,-,-1,-1
OUSELEY.txt,112062,113607,1545,10,N,N,-,-1,-1
OUSELEY.txt,112103,113865,1762,10,N,N,-,-1,-1
OUSELEY.txt,112273,113993,1720,10,N,N,-,-1,-1
OUSELEY.txt,112396,114134,1738,10,N,N,-,-1,-1
OUSELEY.txt,112473,114311,1838,10,N,N,-,-1,-1
OUSELEY.txt,112918,114457,1539,10,N,N,-,-1,-1
OUSELEY.txt,113160,114492,1332,10,N,N,-,-1,-1
OUSELEY.txt,113235,114901,1666,10,N,N,-,-1,-1
OUSELEY.txt,113508,115020,1512,10,N,N,-,-1,-1
OUSELEY.txt,113560,115083,1523,10,N,N,-,-1,-1
OUSELEY.txt,113608,115556,1948,10,N,N,-,-1,-1
OUSELEY.txt,113866,115643,1777,10,N,N,-,-1,-1
OUSELEY.txt,113994,115738,1744,10,N,N,-,-1,-1
OUSELEY.txt,114135,115801,1666,10,N,N,-,-1,-1
OUSELEY.txt,114312,115915,1603,10,N,N,-,-1,-1
OUSELEY.txt,114458,115982,1524,10,N,N,-,-1,-1
OUSELEY.txt,114494,116096,1602,10,N,N,-,-1,-1
OUSELEY.txt,114902,116180,1278,10,N,N,-,-1,-1
OUSELEY.txt,115022,116404,1382,10,N,N,-,-1,-1
OUSELEY.txt,115084,116431,1347,10,N,N,-,-1,-1
OUSELEY.txt,115558,116436,878,10,N,N,-,-1,-1
OUSELEY.txt,115645,116447,802,10,N,N,-,-1,-1
OUSELEY.txt,115739,116523,784,10,N,N,-,-1,-1
OUSELEY.txt,115806,116537,731,10,N,N,-,-1,-1
OUSELEY.txt,115916,116701,785,10,N,N,-,-1,-1
OUSELEY.txt,115983,116739,756,10,N,N,-,-1,-1
OUSELEY.txt,116099,116816,717,10,N,N,-,-1,-1
OUSELEY.txt,116181,116832,651,10,N,N,-,-1,-1
OUSELEY.txt,116405,116994,589,10,N,N,-,-1,-1
OUSELEY.txt,116432,117031,599,10,N,N,-,-1,-1
OUSELEY.txt,116438,117070,632,10,N,N,-,-1,-1
OUSELEY.txt,116448,117113,665,10,N,N,-,-1,-1
OUSELEY.txt,116524,117182,658,10,N,N,-,-1,-1
OUSELEY.txt,116538,117219,681,10,N,N,-,-1,-1
OUSELEY.txt,116702,117278,576,10,N,N,-,-1,-1
OUSELEY.txt,116740,117322,582,10,N,N,-,-1,-1
OUSELEY.txt,116817,117342,525,10,N,N,-,-1,-1
OUSELEY.txt,116833,117422,589,10,N,N,-,-1,-1
OUSELEY.txt,116995,117525,530,10,N,N,-,-1,-1
OUSELEY.txt,117032,117560,528,10,N,N,-,-1,-1
OUSELEY.txt,117071,117590,519,10,N,N,-,-1,-1
OUSELEY.txt,117114,117661,547,10,N,N,-,-1,-1
OUSELEY.txt,117183,117709,526,10,N,N,-,-1,-1
OUSELEY.txt,117220,117845,625,10,N,N,-,-1,-1
OUSELEY.txt,117279,117921,642,10,N,N,-,-1,-1
OUSELEY.txt,117323,117956,633,10,N,N,-,-1,-1
OUSELEY.txt,117343,118036,693,10,N,N,-,-1,-1
OUSELEY.txt,117424,118054,630,10,N,N,-,-1,-1
OUSELEY.txt,117526,118198,672,10,N,N,-,-1,-1
OUSELEY.txt,117561,118201,640,10,N,N,-,-1,-1
OUSELEY.txt,117591,118217,626,10,N,N,-,-1,-1
OUSELEY.txt,117662,118243,581,10,N,N,-,-1,-1
OUSELEY.txt,117710,118332,622,10,N,N,-,-1,-1
OUSELEY.txt,117846,118442,596,10,N,N,-,-1,-1
OUSELEY.txt,117922,118462,540,10,N,N,-,-1,-1
OUSELEY.txt,117957,118598,641,10,N,N,-,-1,-1
OUSELEY.txt,118038,118721,683,10,N,N,-,-1,-1
OUSELEY.txt,118055,118858,803,10,N,N,-,-1,-1
OUSELEY.txt,118198,119143,945,10,N,N,-,-1,-1
OUSELEY.txt,118203,119380,1177,10,N,N,-,-1,-1
OUSELEY.txt,118218,119399,1181,10,N,N,-,-1,-1
OUSELEY.txt,118245,119445,1200,10,N,N,-,-1,-1
OUSELEY.txt,118334,119609,1275,10,N,N,-,-1,-1
OUSELEY.txt,118443,119764,1321,10,N,N,-,-1,-1
OUSELEY.txt,118464,119853,1389,10,N,N,-,-1,-1
OUSELEY.txt,118599,120057,1458,10,N,N,-,-1,-1
OUSELEY.txt,118722,120101,1379,10,N,N,-,-1,-1
OUSELEY.txt,118859,120106,1247,10,N,N,-,-1,-1
OUSELEY.txt,119144,120164,1020,10,N,N,-,-1,-1
OUSELEY.txt,119381,120421,1040,10,N,N,-,-1,-1
OUSELEY.txt,119400,120440,1040,10,N,N,-,-1,-1
OUSELEY.txt,119446,120566,1120,10,N,N,-,-1,-1
OUSELEY.txt,119610,120692,1082,10,N,N,-,-1,-1
OUSELEY.txt,119767,121026,1259,10,N,N,-,-1,-1
OUSELEY.txt,119855,121127,1272,10,N,N,-,-1,-1
OUSELEY.txt,120062,121220,1158,10,N,N,-,-1,-1
OUSELEY.txt,120102,121556,1454,10,N,N,-,-1,-1
OUSELEY.txt,120107,121633,1526,10,N,N,-,-1,-1
OUSELEY.txt,120165,121638,1473,10,N,N,-,-1,-1
OUSELEY.txt,120421,121940,1519,10,N,N,-,-1,-1
OUSELEY.txt,120443,122383,1940,10,N,N,-,-1,-1
OUSELEY.txt,120567,122770,2203,10,N,N,-,-1,-1
OUSELEY.txt,120693,122869,2176,10,N,N,-,-1,-1
OUSELEY.txt,121029,123040,2011,10,Y,N,-,-1,-1
OUSELEY.txt,121128,123140,2012,10,Y,N,-,-1,-1
OUSELEY.txt,121221,123194,1973,10,Y,N,-,-1,-1
OUSELEY.txt,121557,123658,2101,10,N,N,-,-1,-1
OUSELEY.txt,121634,123840,2206,10,N,N,-,-1,-1
OUSELEY.txt,121639,124086,2447,10,N,N,-,-1,-1
OUSELEY.txt,121941,124196,2255,10,N,N,-,-1,-1
OUSELEY.txt,122384,124368,1984,10,N,N,-,-1,-1
OUSELEY.txt,122773,124558,1785,10,N,N,-,-1,-1
OUSELEY.txt,122874,124695,1821,10,N,N,-,-1,-1
OUSELEY.txt,123041,124779,1738,10,N,N,-,-1,-1
OUSELEY.txt,123141,124947,1806,10,N,N,-,-1,-1
OUSELEY.txt,123195,125089,1894,10,N,N,-,-1,-1
OUSELEY.txt,123660,125255,1595,10,N,N,-,-1,-1
OUSELEY.txt,123842,125318,1476,10,N,N,-,-1,-1
OUSELEY.txt,124087,125415,1328,10,N,N,-,-1,-1
OUSELEY.txt,124197,125613,1416,10,N,N,-,-1,-1
OUSELEY.txt,124369,125723,1354,10,N,N,-,-1,-1
OUSELEY.txt,124559,125930,1371,10,N,N,-,-1,-1
OUSELEY.txt,124698,125949,1251,10,N,N,-,-1,-1
OUSELEY.txt,124780,125980,1200,10,N,N,-,-1,-1
OUSELEY.txt,124948,125998,1050,10,N,N,-,-1,-1
OUSELEY.txt,125091,126387,1296,10,N,N,-,-1,-1
OUSELEY.txt,125260,126434,1174,10,N,N,-,-1,-1
OUSELEY.txt,125321,126641,1320,10,N,N,-,-1,-1
OUSELEY.txt,125416,126767,1351,10,N,N,-,-1,-1
OUSELEY.txt,125616,127032,1416,10,N,N,-,-1,-1
OUSELEY.txt,125724,127262,1538,10,N,N,-,-1,-1
OUSELEY.txt,125933,127532,1599,10,N,N,-,-1,-1
OUSELEY.txt,125954,127694,1740,10,N,N,-,-1,-1
OUSELEY.txt,125982,128207,2225,10,N,N,-,-1,-1
OUSELEY.txt,126000,128551,2551,10,N,N,-,-1,-1
OUSELEY.txt,126388,129018,2630,10,N,N,-,-1,-1
OUSELEY.txt,126434,129208,2774,10,N,N,-,-1,-1
OUSELEY.txt,126642,129399,2757,10,N,N,-,-1,-1
OUSELEY.txt,126768,129596,2828,10,N,N,-,-1,-1
OUSELEY.txt,127033,130048,3015,10,N,N,-,-1,-1
OUSELEY.txt,127263,130068,2805,10,N,N,-,-1,-1
OUSELEY.txt,127534,130123,2589,10,N,N,-,-1,-1
OUSELEY.txt,127695,130424,2729,10,N,N,-,-1,-1
OUSELEY.txt,128208,130485,2277,10,N,N,-,-1,-1
OUSELEY.txt,128552,130912,2360,10,N,N,-,-1,-1
OUSELEY.txt,129019,131240,2221,10,N,N,-,-1,-1
OUSELEY.txt,129209,131793,2584,10,N,N,-,-1,-1
OUSELEY.txt,129400,132019,2619,10,N,N,-,-1,-1
OUSELEY.txt,129598,132121,2523,10,N,N,-,-1,-1
OUSELEY.txt,130050,132559,2509,10,N,N,-,-1,-1
OUSELEY.txt,130069,132746,2677,10,N,N,-,-1,-1
OUSELEY.txt,130124,132823,2699,10,N,N,-,-1,-1
OUSELEY.txt,130425,133012,2587,10,N,N,-,-1,-1
OUSELEY.txt,130486,133139,2653,10,N,N,-,-1,-1
OUSELEY.txt,130913,133259,2346,10,N,N,-,-1,-1
OUSELEY.txt,131241,133446,2205,10,N,N,-,-1,-1
OUSELEY.txt,131796,133809,2013,10,N,N,-,-1,-1
OUSELEY.txt,132020,134067,2047,10,N,N,-,-1,-1
OUSELEY.txt,132122,134319,2197,10,N,N,-,-1,-1
OUSELEY.txt,132560,134372,1812,10,N,N,-,-1,-1
OUSELEY.txt,132747,134598,1851,10,N,N,-,-1,-1
OUSELEY.txt,132824,134648,1824,10,N,N,-,-1,-1
OUSELEY.txt,133013,134821,1808,10,N,N,-,-1,-1
OUSELEY.txt,133141,135033,1892,10,N,N,-,-1,-1
OUSELEY.txt,133260,135316,2056,10,N,N,-,-1,-1
OUSELEY.txt,133447,135961,2514,10,N,N,-,-1,-1
OUSELEY.txt,133810,136372,2562,10,N,N,-,-1,-1
OUSELEY.txt,134068,136451,2383,10,N,N,-,-1,-1
OUSELEY.txt,134320,136550,2230,10,N,N,-,-1,-1
OUSELEY.txt,134373,136927,2554,10,N,N,-,-1,-1
OUSELEY.txt,134599,137041,2442,10,N,N,-,-1,-1
OUSELEY.txt,134649,137224,2575,10,N,N,-,-1,-1
OUSELEY.txt,134826,137303,2477,10,N,N,-,-1,-1
OUSELEY.txt,135034,137769,2735,10,N,N,-,-1,-1
OUSELEY.txt,135317,137788,2471,10,N,N,-,-1,-1
OUSELEY.txt,135962,137807,1845,10,N,N,-,-1,-1
OUSELEY.txt,136375,137942,1567,10,N,N,-,-1,-1
OUSELEY.txt,136454,138099,1645,10,N,N,-,-1,-1
OUSELEY.txt,136552,138309,1757,10,N,N,-,-1,-1
OUSELEY.txt,136930,138581,1651,10,N,N,-,-1,-1
OUSELEY.txt,137042,138709,1667,10,N,N,-,-1,-1
OUSELEY.txt,137225,138967,1742,10,N,N,-,-1,-1
OUSELEY.txt,137304,139093,1789,10,N,N,-,-1,-1
OUSELEY.txt,137772,139203,1431,10,N,N,-,-1,-1
OUSELEY.txt,137793,139258,1465,10,N,N,-,-1,-1
OUSELEY.txt,137810,139409,1599,10,N,N,-,-1,-1
OUSELEY.txt,137943,139582,1639,10,N,N,-,-1,-1
OUSELEY.txt,138100,139756,1656,10,N,N,-,-1,-1
OUSELEY.txt,138310,139853,1543,10,N,N,-,-1,-1
OUSELEY.txt,138582,139914,1332,10,N,N,-,-1,-1
OUSELEY.txt,138710,140104,1394,10,N,N,-,-1,-1
OUSELEY.txt,138968,140109,1141,10,N,N,-,-1,-1
OUSELEY.txt,139095,140135,1040,10,N,N,-,-1,-1
OUSELEY.txt,139204,140140,936,10,N,N,-,-1,-1
OUSELEY.txt,139259,140222,963,10,N,N,-,-1,-1
OUSELEY.txt,139410,140394,984,10,N,N,-,-1,-1
OUSELEY.txt,139583,140567,984,10,N,N,-,-1,-1
OUSELEY.txt,139757,140638,881,10,N,N,-,-1,-1
OUSELEY.txt,139854,140737,883,10,N,N,-,-1,-1
OUSELEY.txt,139916,141008,1092,10,N,N,-,-1,-1
OUSELEY.txt,140105,141212,1107,10,N,N,-,-1,-1
OUSELEY.txt,140110,141414,1304,10,N,N,-,-1,-1
OUSELEY.txt,140136,141576,1440,10,N,N,-,-1,-1
OUSELEY.txt,140142,141654,1512,10,N,N,-,-1,-1
OUSELEY.txt,140223,141961,1738,10,N,N,-,-1,-1
OUSELEY.txt,140395,142216,1821,10,N,N,-,-1,-1
OUSELEY.txt,140568,142385,1817,10,N,N,-,-1,-1
OUSELEY.txt,140639,142684,2045,10,N,N,-,-1,-1
OUSELEY.txt,140738,142843,2105,10,N,N,-,-1,-1
OUSELEY.txt,141011,143102,2091,10,N,N,-,-1,-1
OUSELEY.txt,141213,143153,1940,10,N,N,-,-1,-1
OUSELEY.txt,141415,143289,1874,10,N,N,-,-1,-1
OUSELEY.txt,141577,143442,1865,10,N,N,-,-1,-1
OUSELEY.txt,141655,143540,1885,10,N,N,-,-1,-1
OUSELEY.txt,141962,143746,1784,10,N,N,-,-1,-1
OUSELEY.txt,142218,143968,1750,10,N,N,-,-1,-1
OUSELEY.txt,142386,144120,1734,10,N,N,-,-1,-1
OUSELEY.txt,142685,144294,1609,10,N,N,-,-1,-1
OUSELEY.txt,142844,144490,1646,10,N,N,-,-1,-1
OUSELEY.txt,143105,144659,1554,10,N,N,-,-1,-1
OUSELEY.txt,143154,144811,1657,10,N,N,-,-1,-1
OUSELEY.txt,143290,144913,1623,10,N,N,-,-1,-1
OUSELEY.txt,143443,145220,1777,10,N,N,-,-1,-1
OUSELEY.txt,143541,145370,1829,10,N,N,-,-1,-1
OUSELEY.txt,143747,145505,1758,10,N,N,-,-1,-1
OUSELEY.txt,143970,145565,1595,10,N,N,-,-1,-1
OUSELEY.txt,144125,145602,1477,10,N,N,-,-1,-1
OUSELEY.txt,144295,145683,1388,10,N,N,-,-1,-1
OUSELEY.txt,144491,145786,1295,10,N,N,-,-1,-1
OUSELEY.txt,144660,145931,1271,10,N,N,-,-1,-1
OUSELEY.txt,144812,146128,1316,10,N,N,-,-1,-1
OUSELEY.txt,144914,146250,1336,10,N,N,-,-1,-1
OUSELEY.txt,145221,146392,1171,10,N,N,-,-1,-1
OUSELEY.txt,145370,146414,1044,10,N,N,-,-1,-1
OUSELEY.txt,145507,146554,1047,10,N,N,-,-1,-1
OUSELEY.txt,145566,146747,1181,10,N,N,-,-1,-1
OUSELEY.txt,145603,146779,1176,10,N,N,-,-1,-1
OUSELEY.txt,145684,146857,1173,10,N,N,-,-1,-1
OUSELEY.txt,145787,147105,1318,10,N,N,-,-1,-1
OUSELEY.txt,145932,147357,1425,10,N,N,-,-1,-1
OUSELEY.txt,146129,147599,1470,10,N,N,-,-1,-1
OUSELEY.txt,146252,147683,1431,10,N,N,-,-1,-1
OUSELEY.txt,146392,147938,1546,10,N,N,-,-1,-1
OUSELEY.txt,146415,148105,1690,10,N,N,-,-1,-1
OUSELEY.txt,146555,148404,1849,10,N,N,-,-1,-1
OUSELEY.txt,146748,148436,1688,10,N,N,-,-1,-1
OUSELEY.txt,146780,148658,1878,10,N,N,-,-1,-1
OUSELEY.txt,146858,148831,1973,10,N,N,-,-1,-1
OUSELEY.txt,147106,148970,1864,10,N,N,-,-1,-1
OUSELEY.txt,147358,149349,1991,10,N,N,-,-1,-1
OUSELEY.txt,147600,149703,2103,10,N,N,-,-1,-1
OUSELEY.txt,147684,149835,2151,10,N,N,-,-1,-1
OUSELEY.txt,147941,149910,1969,10,N,N,-,-1,-1
OUSELEY.txt,148106,150079,1973,10,N,N,-,-1,-1
OUSELEY.txt,148409,150152,1743,10,N,N,-,-1,-1
OUSELEY.txt,148439,150177,1738,10,N,N,-,-1,-1
OUSELEY.txt,148660,150430,1770,10,N,N,-,-1,-1
OUSELEY.txt,148832,150691,1859,10,Y,N,-,-1,-1
OUSELEY.txt,148971,150928,1957,10,N,N,-,-1,-1
OUSELEY.txt,149350,151203,1853,10,N,N,-,-1,-1
OUSELEY.txt,149704,151222,1518,10,N,N,-,-1,-1
OUSELEY.txt,149836,151249,1413,10,N,N,-,-1,-1
OUSELEY.txt,149911,151443,1532,10,N,N,-,-1,-1
OUSELEY.txt,150081,151631,1550,10,N,N,-,-1,-1
OUSELEY.txt,150157,151763,1606,10,N,N,-,-1,-1
OUSELEY.txt,150180,151965,1785,10,N,N,-,-1,-1
OUSELEY.txt,150431,152395,1964,10,N,N,-,-1,-1
OUSELEY.txt,150692,152623,1931,10,N,N,-,-1,-1
OUSELEY.txt,150930,152708,1778,10,N,N,-,-1,-1
OUSELEY.txt,151206,152853,1647,10,N,N,-,-1,-1
OUSELEY.txt,151225,152919,1694,10,N,N,-,-1,-1
OUSELEY.txt,151250,152956,1706,10,N,N,-,-1,-1
OUSELEY.txt,151444,153069,1625,10,N,N,-,-1,-1
OUSELEY.txt,151632,153221,1589,10,N,N,-,-1,-1
OUSELEY.txt,151764,153524,1760,10,N,N,-,-1,-1
OUSELEY.txt,151967,153639,1672,10,N,N,-,-1,-1
OUSELEY.txt,152396,153740,1344,10,N,N,-,-1,-1
OUSELEY.txt,152624,153842,1218,10,N,N,-,-1,-1
OUSELEY.txt,152709,154165,1456,10,N,N,-,-1,-1
OUSELEY.txt,152854,154315,1461,10,N,N,-,-1,-1
OUSELEY.txt,152924,154602,1678,10,N,N,-,-1,-1
OUSELEY.txt,152959,154630,1671,10,N,N,-,-1,-1
OUSELEY.txt,153074,154635,1561,10,N,N,-,-1,-1
OUSELEY.txt,153222,154670,1448,10,N,N,-,-1,-1
OUSELEY.txt,153525,154978,1453,10,N,N,-,-1,-1
OUSELEY.txt,153641,155205,1564,10,N,N,-,-1,-1
OUSELEY.txt,153741,155292,1551,10,N,N,-,-1,-1
OUSELEY.txt,153843,155438,1595,10,N,N,-,-1,-1
OUSELEY.txt,154167,155507,1340,10,N,N,-,-1,-1
OUSELEY.txt,154316,155653,1337,10,N,N,-,-1,-1
OUSELEY.txt,154603,156014,1411,10,N,N,-,-1,-1
OUSELEY.txt,154631,156264,1633,10,N,N,-,-1,-1
OUSELEY.txt,154636,156501,1865,10,N,N,-,-1,-1
OUSELEY.txt,154671,156535,1864,10,N,N,-,-1,-1
OUSELEY.txt,154979,156565,1586,10,N,N,-,-1,-1
OUSELEY.txt,155206,157176,1970,10,N,N,-,-1,-1
OUSELEY.txt,155293,157511,2218,10,N,N,-,-1,-1
OUSELEY.txt,155439,157899,2460,10,N,N,-,-1,-1
OUSELEY.txt,155508,158251,2743,10,N,N,-,-1,-1
OUSELEY.txt,155654,158923,3269,10,N,N,-,-1,-1
OUSELEY.txt,156015,158962,2947,10,N,N,-,-1,-1
OUSELEY.txt,156265,158982,2717,10,N,N,-,-1,-1
OUSELEY.txt,156504,159047,2543,10,N,N,-,-1,-1
OUSELEY.txt,156538,159312,2774,10,N,N,-,-1,-1
OUSELEY.txt,156568,159661,3093,10,N,N,-,-1,-1
OUSELEY.txt,157179,159667,2488,10,N,N,-,-1,-1
OUSELEY.txt,157512,159690,2178,10,N,N,-,-1,-1
OUSELEY.txt,157902,159723,1821,10,N,N,-,-1,-1
OUSELEY.txt,158252,159907,1655,10,N,N,-,-1,-1
OUSELEY.txt,158926,159998,1072,10,N,N,-,-1,-1
OUSELEY.txt,158964,160248,1284,10,N,N,-,-1,-1
OUSELEY.txt,158985,160427,1442,10,N,N,-,-1,-1
OUSELEY.txt,159052,160588,1536,10,N,N,-,-1,-1
OUSELEY.txt,159313,160828,1515,10,N,N,-,-1,-1
OUSELEY.txt,159662,160887,1225,10,N,N,-,-1,-1
OUSELEY.txt,159668,161256,1588,10,N,N,-,-1,-1
OUSELEY.txt,159690,161531,1841,10,N,N,-,-1,-1
OUSELEY.txt,159726,161830,2104,10,N,N,-,-1,-1
OUSELEY.txt,159908,161894,1986,10,N,N,-,-1,-1
OUSELEY.txt,159999,161964,1965,10,N,N,-,-1,-1
OUSELEY.txt,160249,162057,1808,10,N,N,-,-1,-1
OUSELEY.txt,160428,162172,1744,10,N,N,-,-1,-1
OUSELEY.txt,160589,162313,1724,10,N,N,-,-1,-1
OUSELEY.txt,160829,162523,1694,10,N,N,-,-1,-1
OUSELEY.txt,160889,162726,1837,10,N,N,-,-1,-1
OUSELEY.txt,161257,162997,1740,10,N,N,-,-1,-1
OUSELEY.txt,161532,163033,1501,10,N,N,-,-1,-1
OUSELEY.txt,161831,163071,1240,10,N,N,-,-1,-1
OUSELEY.txt,161895,163226,1331,10,N,N,-,-1,-1
OUSELEY.txt,161969,163343,1374,10,N,N,-,-1,-1
OUSELEY.txt,162058,163491,1433,10,N,N,-,-1,-1
OUSELEY.txt,162173,163497,1324,10,N,N,-,-1,-1
OUSELEY.txt,162316,163684,1368,10,N,N,-,-1,-1
OUSELEY.txt,162524,163769,1245,10,N,N,-,-1,-1
OUSELEY.txt,162729,163787,1058,10,N,N,-,-1,-1
OUSELEY.txt,163000,163796,796,10,N,N,-,-1,-1
OUSELEY.txt,163038,163823,785,10,N,N,-,-1,-1
OUSELEY.txt,163073,163849,776,10,N,N,-,-1,-1
OUSELEY.txt,163227,163932,705,10,N,N,-,-1,-1
OUSELEY.txt,163344,164095,751,10,N,N,-,-1,-1
OUSELEY.txt,163492,164465,973,10,N,N,-,-1,-1
OUSELEY.txt,163498,164840,1342,10,N,N,-,-1,-1
OUSELEY.txt,163685,164969,1284,10,N,N,-,-1,-1
OUSELEY.txt,163772,165026,1254,10,N,N,-,-1,-1
OUSELEY.txt,163790,165119,1329,10,N,N,-,-1,-1
OUSELEY.txt,163797,165528,1731,10,Y,N,-,-1,-1
OUSELEY.txt,163826,165649,1823,10,Y,N,-,-1,-1
OUSELEY.txt,163851,165784,1933,10,Y,N,-,-1,-1
OUSELEY.txt,163933,165835,1902,10,Y,N,-,-1,-1
OUSELEY.txt,164096,165922,1826,10,Y,N,-,-1,-1
OUSELEY.txt,164467,166054,1587,10,Y,N,-,-1,-1
OUSELEY.txt,164843,166227,1384,10,Y,N,-,-1,-1
OUSELEY.txt,164971,166549,1578,10,Y,N,-,-1,-1
OUSELEY.txt,165027,166618,1591,10,Y,N,-,-1,-1
OUSELEY.txt,165120,166703,1583,10,Y,N,-,-1,-1
OUSELEY.txt,165529,166808,1279,10,Y,N,-,-1,-1
OUSELEY.txt,165650,166827,1177,10,Y,N,-,-1,-1
OUSELEY.txt,165785,167057,1272,10,Y,N,-,-1,-1
OUSELEY.txt,165836,167172,1336,10,Y,N,-,-1,-1
OUSELEY.txt,165923,167400,1477,10,N,N,-,-1,-1
OUSELEY.txt,166055,167453,1398,10,N,N,-,-1,-1
OUSELEY.txt,166228,167458,1230,10,N,N,-,-1,-1
OUSELEY.txt,166554,167474,920,10,N,N,-,-1,-1
OUSELEY.txt,166619,167692,1073,10,N,N,-,-1,-1
OUSELEY.txt,166704,167853,1149,10,N,N,-,-1,-1
OUSELEY.txt,166809,168091,1282,10,N,N,-,-1,-1
OUSELEY.txt,166827,168113,1286,10,N,N,-,-1,-1
OUSELEY.txt,167058,168119,1061,10,N,N,-,-1,-1
OUSELEY.txt,167173,168270,1097,10,N,N,-,-1,-1
OUSELEY.txt,167401,168540,1139,10,N,N,-,-1,-1
OUSELEY.txt,167454,168751,1297,10,N,N,-,-1,-1
OUSELEY.txt,167459,168994,1535,10,N,N,-,-1,-1
OUSELEY.txt,167475,169098,1623,10,N,N,-,-1,-1
OUSELEY.txt,167693,169348,1655,10,N,N,-,-1,-1
OUSELEY.txt,167854,169632,1778,10,N,N,-,-1,-1
OUSELEY.txt,168092,169677,1585,10,N,N,-,-1,-1
OUSELEY.txt,168115,169823,1708,10,N,N,-,-1,-1
OUSELEY.txt,168120,169983,1863,10,N,N,-,-1,-1
OUSELEY.txt,168271,170095,1824,10,N,N,-,-1,-1
OUSELEY.txt,168541,170182,1641,10,N,N,-,-1,-1
OUSELEY.txt,168752,170298,1546,10,N,N,-,-1,-1
OUSELEY.txt,168996,170604,1608,10,N,N,-,-1,-1
OUSELEY.txt,169103,170816,1713,10,N,N,-,-1,-1
OUSELEY.txt,169349,170853,1504,10,N,N,-,-1,-1
OUSELEY.txt,169635,171110,1475,10,N,N,-,-1,-1
OUSELEY.txt,169679,171169,1490,10,N,N,-,-1,-1
OUSELEY.txt,169824,171270,1446,10,N,N,-,-1,-1
OUSELEY.txt,169984,171396,1412,10,N,N,-,-1,-1
OUSELEY.txt,170096,171463,1367,10,N,N,-,-1,-1
OUSELEY.txt,170183,171493,1310,10,N,N,-,-1,-1
OUSELEY.txt,170299,171668,1369,10,N,N,-,-1,-1
OUSELEY.txt,170605,171688,1083,10,N,N,-,-1,-1
OUSELEY.txt,170818,171843,1025,10,N,N,-,-1,-1
OUSELEY.txt,170854,172066,1212,10,N,N,-,-1,-1
OUSELEY.txt,171115,172257,1142,10,N,N,-,-1,-1
OUSELEY.txt,171171,172523,1352,10,N,N,-,-1,-1
OUSELEY.txt,171271,172743,1472,10,N,N,-,-1,-1
OUSELEY.txt,171397,172880,1483,10,N,N,-,-1,-1
OUSELEY.txt,171468,172969,1501,10,N,N,-,-1,-1
OUSELEY.txt,171496,173074,1578,10,N,N,-,-1,-1
OUSELEY.txt,171673,173149,1476,10,N,N,-,-1,-1
OUSELEY.txt,171691,173262,1571,10,N,N,-,-1,-1
OUSELEY.txt,171844,173491,1647,10,N,N,-,-1,-1
OUSELEY.txt,172067,173708,1641,10,N,N,-,-1,-1
OUSELEY.txt,172262,174010,1748,10,N,N,-,-1,-1
OUSELEY.txt,172524,174063,1539,10,N,N,-,-1,-1
OUSELEY.txt,172744,174328,1584,10,N,N,-,-1,-1
OUSELEY.txt,172881,174583,1702,10,N,N,-,-1,-1
OUSELEY.txt,172974,174817,1843,10,N,N,-,-1,-1
OUSELEY.txt,173075,175003,1928,10,N,N,-,-1,-1
OUSELEY.txt,173151,175045,1894,10,N,N,-,-1,-1
OUSELEY.txt,173265,175174,1909,10,N,N,-,-1,-1
OUSELEY.txt,173496,175237,1741,10,N,N,-,-1,-1
OUSELEY.txt,173713,175266,1553,10,N,N,-,-1,-1
OUSELEY.txt,174011,175696,1685,10,N,N,-,-1,-1
OUSELEY.txt,174064,175905,1841,10,N,N,-,-1,-1
OUSELEY.txt,174329,175919,1590,10,N,N,-,-1,-1
OUSELEY.txt,174584,176109,1525,10,N,N,-,-1,-1
OUSELEY.txt,174819,176144,1325,10,N,N,-,-1,-1
OUSELEY.txt,175008,176228,1220,10,N,N,-,-1,-1
OUSELEY.txt,175048,176273,1225,10,N,N,-,-1,-1
OUSELEY.txt,175175,176337,1162,10,N,N,-,-1,-1
OUSELEY.txt,175238,176674,1436,10,N,N,-,-1,-1
OUSELEY.txt,175267,176837,1570,10,N,N,-,-1,-1
OUSELEY.txt,175697,177020,1323,10,N,N,-,-1,-1
OUSELEY.txt,175908,177120,1212,10,N,N,-,-1,-1
OUSELEY.txt,175924,177200,1276,10,N,N,-,-1,-1
OUSELEY.txt,176110,177559,1449,10,N,N,-,-1,-1
OUSELEY.txt,176146,177664,1518,10,N,N,-,-1,-1
OUSELEY.txt,176229,177875,1646,10,N,N,-,-1,-1
OUSELEY.txt,176274,178058,1784,10,N,N,-,-1,-1
OUSELEY.txt,176338,178240,1902,10,N,N,-,-1,-1
OUSELEY.txt,176675,178383,1708,10,N,N,-,-1,-1
OUSELEY.txt,176840,178525,1685,10,N,N,-,-1,-1
OUSELEY.txt,177021,178633,1612,10,N,N,-,-1,-1
OUSELEY.txt,177123,178746,1623,10,N,N,-,-1,-1
OUSELEY.txt,177201,178786,1585,10,N,N,-,-1,-1
OUSELEY.txt,177562,178842,1280,10,N,N,-,-1,-1
OUSELEY.txt,177665,179123,1458,10,N,N,-,-1,-1
OUSELEY.txt,177876,179408,1532,10,N,N,-,-1,-1
OUSELEY.txt,178059,179650,1591,10,N,N,-,-1,-1
OUSELEY.txt,178241,179889,1648,10,N,N,-,-1,-1
OUSELEY.txt,178384,179910,1526,10,N,N,-,-1,-1
OUSELEY.txt,178526,180229,1703,10,N,N,-,-1,-1
OUSELEY.txt,178634,180258,1624,10,N,N,-,-1,-1
OUSELEY.txt,178747,180381,1634,10,N,N,-,-1,-1
OUSELEY.txt,178787,180572,1785,10,N,N,-,-1,-1
OUSELEY.txt,178844,180937,2093,10,N,N,-,-1,-1
OUSELEY.txt,179124,181089,1965,10,N,N,-,-1,-1
OUSELEY.txt,179409,181243,1834,10,N,N,-,-1,-1
OUSELEY.txt,179652,181355,1703,10,N,N,-,-1,-1
OUSELEY.txt,179894,181511,1617,10,N,N,-,-1,-1
OUSELEY.txt,179912,181871,1959,10,N,N,-,-1,-1
OUSELEY.txt,180234,182147,1913,10,N,N,-,-1,-1
OUSELEY.txt,180263,182453,2190,10,N,N,-,-1,-1
OUSELEY.txt,180382,182701,2319,10,N,N,-,-1,-1
OUSELEY.txt,180573,182802,2229,10,N,N,-,-1,-1
OUSELEY.txt,180939,182848,1909,10,N,N,-,-1,-1
OUSELEY.txt,181092,182883,1791,10,N,N,-,-1,-1
OUSELEY.txt,181244,182903,1659,10,N,N,-,-1,-1
OUSELEY.txt,181356,182928,1572,10,N,N,-,-1,-1
OUSELEY.txt,181514,183260,1746,10,N,N,-,-1,-1
OUSELEY.txt,181874,183417,1543,10,N,N,-,-1,-1
OUSELEY.txt,182150,183542,1392,10,N,N,-,-1,-1
OUSELEY.txt,182454,183704,1250,10,N,N,-,-1,-1
OUSELEY.txt,182702,183823,1121,10,N,N,-,-1,-1
OUSELEY.txt,182805,183857,1052,10,N,N,-,-1,-1
OUSELEY.txt,182850,183880,1030,10,N,N,-,-1,-1
OUSELEY.txt,182888,184126,1238,10,N,N,-,-1,-1
OUSELEY.txt,182905,184414,1509,10,N,N,-,-1,-1
OUSELEY.txt,182929,184486,1557,10,N,N,-,-1,-1
OUSELEY.txt,183261,184601,1340,10,N,N,-,-1,-1
OUSELEY.txt,183418,184728,1310,10,N,N,-,-1,-1
OUSELEY.txt,183543,184918,1375,10,N,N,-,-1,-1
OUSELEY.txt,183705,185070,1365,10,N,N,-,-1,-1
OUSELEY.txt,183828,185213,1385,10,N,N,-,-1,-1
OUSELEY.txt,183860,185256,1396,10,N,N,-,-1,-1
OUSELEY.txt,183883,185674,1791,10,N,N,-,-1,-1
OUSELEY.txt,184127,185771,1644,10,N,N,-,-1,-1
OUSELEY.txt,184416,186147,1731,10,N,N,-,-1,-1
OUSELEY.txt,184487,186544,2057,10,N,N,-,-1,-1
OUSELEY.txt,184602,186813,2211,10,N,N,-,-1,-1
OUSELEY.txt,184729,187029,2300,10,N,N,-,-1,-1
OUSELEY.txt,184919,187255,2336,10,N,N,-,-1,-1
OUSELEY.txt,185072,187288,2216,10,N,N,-,-1,-1
OUSELEY.txt,185218,187308,2090,10,N,N,-,-1,-1
OUSELEY.txt,185259,187755,2496,10,N,N,-,-1,-1
OUSELEY.txt,185675,187815,2140,10,N,N,-,-1,-1
OUSELEY.txt,185772,187921,2149,10,N,N,-,-1,-1
OUSELEY.txt,186149,188021,1872,10,N,N,-,-1,-1
OUSELEY.txt,186545,188128,1583,10,N,N,-,-1,-1
OUSELEY.txt,186818,188394,1576,10,N,N,-,-1,-1
OUSELEY.txt,187030,188607,1577,10,N,N,-,-1,-1
OUSELEY.txt,187258,188643,1385,10,N,N,-,-1,-1
OUSELEY.txt,187290,188650,1360,10,N,N,-,-1,-1
OUSELEY.txt,187313,188658,1345,10,N,N,-,-1,-1
OUSELEY.txt,187756,188663,907,10,N,N,-,-1,-1
OUSELEY.txt,187816,188698,882,10,N,N,-,-1,-1
OUSELEY.txt,187922,188706,784,10,N,N,-,-1,-1
OUSELEY.txt,188024,188711,687,10,N,N,-,-1,-1
OUSELEY.txt,188129,188715,586,10,N,N,-,-1,-1
OUSELEY.txt,188397,188749,352,10,N,N,-,-1,-1
OUSELEY.txt,188610,188776,166,10,N,N,-,-1,-1
OUSELEY.txt,188646,188892,246,10,N,N,-,-1,-1
OUSELEY.txt,188651,189000,349,10,N,N,-,-1,-1
OUSELEY.txt,188659,189201,542,10,N,N,-,-1,-1
OUSELEY.txt,188664,189376,712,10,N,N,-,-1,-1
OUSELEY.txt,188699,189542,843,10,N,N,-,-1,-1
OUSELEY.txt,188707,189651,944,10,N,N,-,-1,-1
OUSELEY.txt,188712,189700,988,10,N,N,-,-1,-1
OUSELEY.txt,188716,189737,1021,10,N,N,-,-1,-1
OUSELEY.txt,188754,189876,1122,10,N,N,-,-1,-1
OUSELEY.txt,188781,190159,1378,10,N,N,-,-1,-1
OUSELEY.txt,188893,190447,1554,10,N,N,-,-1,-1
OUSELEY.txt,189001,190619,1618,10,N,N,-,-1,-1
OUSELEY.txt,189202,190844,1642,10,N,N,-,-1,-1
OUSELEY.txt,189377,191096,1719,10,N,N,-,-1,-1
OUSELEY.txt,189543,191263,1720,10,N,N,-,-1,-1
OUSELEY.txt,189656,191766,2110,10,N,N,-,-1,-1
OUSELEY.txt,189702,192028,2326,10,N,N,-,-1,-1
OUSELEY.txt,189740,192065,2325,10,N,N,-,-1,-1
OUSELEY.txt,189879,192347,2468,10,N,N,-,-1,-1
OUSELEY.txt,190162,192742,2580,10,N,N,-,-1,-1
OUSELEY.txt,190450,192839,2389,10,N,N,-,-1,-1
OUSELEY.txt,190622,193011,2389,10,N,N,-,-1,-1
OUSELEY.txt,190846,193469,2623,10,N,N,-,-1,-1
OUSELEY.txt,191097,193706,2609,10,N,N,-,-1,-1
OUSELEY.txt,191266,193753,2487,10,N,N,-,-1,-1
OUSELEY.txt,191769,193813,2044,10,N,N,-,-1,-1
OUSELEY.txt,192031,193969,1938,10,N,N,-,-1,-1
OUSELEY.txt,192068,194005,1937,10,N,N,-,-1,-1
OUSELEY.txt,192348,194205,1857,10,N,N,-,-1,-1
OUSELEY.txt,192745,194610,1865,10,N,N,-,-1,-1
OUSELEY.txt,192840,194920,2080,10,N,N,-,-1,-1
OUSELEY.txt,193012,194976,1964,10,N,N,-,-1,-1
OUSELEY.txt,193470,195013,1543,10,N,N,-,-1,-1
OUSELEY.txt,193707,195694,1987,10,N,N,-,-1,-1
OUSELEY.txt,193753,195908,2155,10,N,N,-,-1,-1
OUSELEY.txt,193814,196318,2504,10,N,N,-,-1,-1
OUSELEY.txt,193972,196480,2508,10,N,N,-,-1,-1
OUSELEY.txt,194006,196684,2678,10,N,N,-,-1,-1
OUSELEY.txt,194208,196781,2573,10,N,N,-,-1,-1
OUSELEY.txt,194611,196878,2267,10,N,N,-,-1,-1
OUSELEY.txt,194921,196935,2014,10,N,N,-,-1,-1
OUSELEY.txt,194977,197048,2071,10,N,N,-,-1,-1
OUSELEY.txt,195014,197216,2202,10,N,N,-,-1,-1
OUSELEY.txt,195695,197256,1561,10,N,N,-,-1,-1
OUSELEY.txt,195911,197316,1405,10,N,N,-,-1,-1
OUSELEY.txt,196319,197443,1124,10,N,N,-,-1,-1
OUSELEY.txt,196482,197691,1209,10,N,N,-,-1,-1
OUSELEY.txt,196685,197878,1193,10,N,N,-,-1,-1
OUSELEY.txt,196782,197937,1155,10,N,N,-,-1,-1
OUSELEY.txt,196879,198079,1200,10,N,N,-,-1,-1
OUSELEY.txt,196938,198318,1380,10,N,N,-,-1,-1
OUSELEY.txt,197049,198389,1340,10,N,N,-,-1,-1
OUSELEY.txt,197217,198424,1207,10,N,N,-,-1,-1
OUSELEY.txt,197257,198450,1193,10,N,N,-,-1,-1
OUSELEY.txt,197319,198495,1176,10,N,N,-,-1,-1
OUSELEY.txt,197445,198686,1241,10,N,N,-,-1,-1
OUSELEY.txt,197696,198978,1282,10,N,N,-,-1,-1
OUSELEY.txt,197881,199133,1252,10,N,N,-,-1,-1
OUSELEY.txt,197940,199148,1208,10,N,N,-,-1,-1
OUSELEY.txt,198080,199165,1085,10,N,N,-,-1,-1
OUSELEY.txt,198319,199225,906,10,N,N,-,-1,-1
OUSELEY.txt,198394,199230,836,10,N,N,-,-1,-1
OUSELEY.txt,198427,199239,812,10,N,N,-,-1,-1
OUSELEY.txt,198453,199290,837,10,N,N,-,-1,-1
OUSELEY.txt,198498,199377,879,10,N,N,-,-1,-1
OUSELEY.txt,198688,199425,737,10,N,N,-,-1,-1
OUSELEY.txt,198981,199511,530,10,N,N,-,-1,-1
OUSELEY.txt,199136,199609,473,10,N,N,-,-1,-1
OUSELEY.txt,199153,199628,475,10,N,N,-,-1,-1
OUSELEY.txt,199168,199790,622,10,N,N,-,-1,-1
OUSELEY.txt,199226,199831,605,10,N,N,-,-1,-1
OUSELEY.txt,199233,199856,623,10,N,N,-,-1,-1
OUSELEY.txt,199240,200016,776,10,N,N,-,-1,-1
OUSELEY.txt,199291,200176,885,10,N,N,-,-1,-1
OUSELEY.txt,199380,200185,805,10,N,N,-,-1,-1
OUSELEY.txt,199427,200295,868,10,N,N,-,-1,-1
OUSELEY.txt,199513,200892,1379,10,N,N,-,-1,-1
OUSELEY.txt,199611,201268,1657,10,N,N,-,-1,-1
OUSELEY.txt,199629,201489,1860,10,N,N,-,-1,-1
OUSELEY.txt,199793,201607,1814,10,N,N,-,-1,-1
OUSELEY.txt,199836,201712,1876,10,N,N,-,-1,-1
OUSELEY.txt,199861,201799,1938,10,N,N,-,-1,-1
OUSELEY.txt,200017,202057,2040,10,N,N,-,-1,-1
OUSELEY.txt,200177,202406,2229,10,N,N,-,-1,-1
OUSELEY.txt,200186,202581,2395,10,N,N,-,-1,-1
OUSELEY.txt,200297,202906,2609,10,N,N,-,-1,-1
OUSELEY.txt,200893,203079,2186,10,N,N,-,-1,-1
OUSELEY.txt,201269,203333,2064,10,N,N,-,-1,-1
OUSELEY.txt,201490,203865,2375,10,N,N,-,-1,-1
OUSELEY.txt,201608,204639,3031,10,N,N,-,-1,-1
OUSELEY.txt,201713,205042,3329,10,N,N,-,-1,-1
OUSELEY.txt,201800,205153,3353,10,N,N,-,-1,-1
OUSELEY.txt,202058,205583,3525,10,N,N,-,-1,-1
OUSELEY.txt,202411,205810,3399,10,N,N,-,-1,-1
OUSELEY.txt,202582,206046,3464,10,N,N,-,-1,-1
OUSELEY.txt,202907,206361,3454,10,N,N,-,-1,-1
OUSELEY.txt,203080,206364,3284,10,N,N,-,-1,-1
OUSELEY.txt,203334,206482,3148,10,N,N,-,-1,-1
OUSELEY.txt,203866,206535,2669,10,N,N,-,-1,-1
OUSELEY.txt,204640,206723,2083,10,N,N,-,-1,-1
OUSELEY.txt,205043,206754,1711,10,N,N,-,-1,-1
OUSELEY.txt,205154,206819,1665,10,N,N,-,-1,-1
OUSELEY.txt,205584,206839,1255,10,N,N,-,-1,-1
OUSELEY.txt,205811,206922,1111,10,N,N,-,-1,-1
OUSELEY.txt,206048,206925,877,10,N,N,-,-1,-1
OUSELEY.txt,206362,207006,644,10,N,N,-,-1,-1
OUSELEY.txt,206365,207074,709,10,N,N,-,-1,-1
OUSELEY.txt,206484,207366,882,10,N,N,-,-1,-1
OUSELEY.txt,206536,207369,833,10,N,N,-,-1,-1
OUSELEY.txt,206728,207400,672,10,N,N,-,-1,-1
OUSELEY.txt,206755,207599,844,10,N,N,-,-1,-1
OUSELEY.txt,206821,207682,861,10,N,N,-,-1,-1
OUSELEY.txt,206840,207867,1027,10,N,N,-,-1,-1
OUSELEY.txt,206923,207885,962,10,N,N,-,-1,-1
OUSELEY.txt,206926,207978,1052,10,N,N,-,-1,-1
OUSELEY.txt,207007,207994,987,10,N,N,-,-1,-1
OUSELEY.txt,207075,208386,1311,10,N,N,-,-1,-1
OUSELEY.txt,207367,208464,1097,10,N,N,-,-1,-1
OUSELEY.txt,207370,208699,1329,10,N,N,-,-1,-1
OUSELEY.txt,207401,208830,1429,10,N,N,-,-1,-1
OUSELEY.txt,207600,208975,1375,10,N,N,-,-1,-1
OUSELEY.txt,207683,209116,1433,10,N,N,-,-1,-1
OUSELEY.txt,207868,209175,1307,10,N,N,-,-1,-1
OUSELEY.txt,207886,209380,1494,10,N,N,-,-1,-1
OUSELEY.txt,207979,209436,1457,10,N,N,-,-1,-1
OUSELEY.txt,207995,209574,1579,10,N,N,-,-1,-1
OUSELEY.txt,208387,209704,1317,10,N,N,-,-1,-1
OUSELEY.txt,208465,209751,1286,10,N,N,-,-1,-1
OUSELEY.txt,208700,210048,1348,10,N,N,-,-1,-1
OUSELEY.txt,208831,210227,1396,10,N,N,-,-1,-1
OUSELEY.txt,208976,210460,1484,10,N,N,-,-1,-1
OUSELEY.txt,209121,210695,1574,10,N,N,-,-1,-1
OUSELEY.txt,209176,210865,1689,10,N,N,-,-1,-1
OUSELEY.txt,209382,210923,1541,10,N,N,-,-1,-1
OUSELEY.txt,209437,211091,1654,10,N,N,-,-1,-1
OUSELEY.txt,209575,211224,1649,10,N,N,-,-1,-1
OUSELEY.txt,209705,211388,1683,10,N,N,-,-1,-1
OUSELEY.txt,209752,211447,1695,10,N,N,-,-1,-1
OUSELEY.txt,210051,211508,1457,10,N,N,-,-1,-1
OUSELEY.txt,210228,211888,1660,10,N,N,-,-1,-1
OUSELEY.txt,210461,212041,1580,10,N,N,-,-1,-1
OUSELEY.txt,210696,212091,1395,10,N,N,-,-1,-1
OUSELEY.txt,210866,212164,1298,10,N,N,-,-1,-1
OUSELEY.txt,210924,212334,1410,10,N,N,-,-1,-1
OUSELEY.txt,211092,212486,1394,10,N,N,-,-1,-1
OUSELEY.txt,211225,212527,1302,10,N,N,-,-1,-1
OUSELEY.txt,211389,212597,1208,10,N,N,-,-1,-1
OUSELEY.txt,211450,212759,1309,10,N,N,-,-1,-1
OUSELEY.txt,211511,212972,1461,10,N,N,-,-1,-1
OUSELEY.txt,211889,213120,1231,10,N,N,-,-1,-1
OUSELEY.txt,212042,213171,1129,10,N,N,-,-1,-1
OUSELEY.txt,212092,213249,1157,10,N,N,-,-1,-1
OUSELEY.txt,212166,213324,1158,10,N,N,-,-1,-1
OUSELEY.txt,212335,213497,1162,10,N,N,-,-1,-1
OUSELEY.txt,212487,213619,1132,10,N,N,-,-1,-1
OUSELEY.txt,212528,214044,1516,10,N,N,-,-1,-1
OUSELEY.txt,212598,214179,1581,10,N,N,-,-1,-1
OUSELEY.txt,212764,214457,1693,10,N,N,-,-1,-1
OUSELEY.txt,212973,214805,1832,10,N,N,-,-1,-1
OUSELEY.txt,213121,215034,1913,10,N,N,-,-1,-1
OUSELEY.txt,213172,215337,2165,10,N,N,-,-1,-1
OUSELEY.txt,213250,215493,2243,10,N,N,-,-1,-1
OUSELEY.txt,213329,215727,2398,10,N,N,-,-1,-1
OUSELEY.txt,213502,215750,2248,10,N,N,-,-1,-1
OUSELEY.txt,213622,215993,2371,10,N,N,-,-1,-1
OUSELEY.txt,214045,216130,2085,10,N,N,-,-1,-1
OUSELEY.txt,214180,216191,2011,10,N,N,-,-1,-1
OUSELEY.txt,214458,216261,1803,10,N,N,-,-1,-1
OUSELEY.txt,214806,216570,1764,10,N,N,-,-1,-1
OUSELEY.txt,215035,216688,1653,10,N,N,-,-1,-1
OUSELEY.txt,215338,216766,1428,10,N,N,-,-1,-1
OUSELEY.txt,215494,216799,1305,10,N,N,-,-1,-1
OUSELEY.txt,215732,217369,1637,10,N,N,-,-1,-1
OUSELEY.txt,215751,217831,2080,10,N,N,-,-1,-1
OUSELEY.txt,215995,217847,1852,10,N,N,-,-1,-1
OUSELEY.txt,216131,217997,1866,10,N,N,-,-1,-1
OUSELEY.txt,216192,218393,2201,10,N,N,-,-1,-1
OUSELEY.txt,216262,218525,2263,10,N,N,-,-1,-1
OUSELEY.txt,216571,218665,2094,10,N,N,-,-1,-1
OUSELEY.txt,216689,218741,2052,10,N,N,-,-1,-1
OUSELEY.txt,216767,218757,1990,10,N,N,-,-1,-1
OUSELEY.txt,216800,218761,1961,10,N,N,-,-1,-1
OUSELEY.txt,217372,219221,1849,10,N,N,-,-1,-1
OUSELEY.txt,217833,219648,1815,10,N,N,-,-1,-1
OUSELEY.txt,217848,219991,2143,10,N,N,-,-1,-1
OUSELEY.txt,218002,220099,2097,10,N,N,-,-1,-1
OUSELEY.txt,218396,220388,1992,10,N,N,-,-1,-1
OUSELEY.txt,218530,220439,1909,10,N,N,-,-1,-1
OUSELEY.txt,218666,220562,1896,10,N,N,-,-1,-1
OUSELEY.txt,218742,220669,1927,10,N,N,-,-1,-1
OUSELEY.txt,218758,221084,2326,10,N,N,-,-1,-1
OUSELEY.txt,218764,221141,2377,10,N,N,-,-1,-1
OUSELEY.txt,219222,221477,2255,10,N,N,-,-1,-1
OUSELEY.txt,219649,221520,1871,10,N,N,-,-1,-1
OUSELEY.txt,219992,221550,1558,10,N,N,-,-1,-1
OUSELEY.txt,220100,221730,1630,10,N,N,-,-1,-1
OUSELEY.txt,220389,221804,1415,10,N,N,-,-1,-1
OUSELEY.txt,220440,222022,1582,10,N,N,-,-1,-1
OUSELEY.txt,220564,222351,1787,10,N,N,-,-1,-1
OUSELEY.txt,220670,222632,1962,10,N,N,-,-1,-1
OUSELEY.txt,221085,223169,2084,10,N,N,-,-1,-1
OUSELEY.txt,221142,223298,2156,10,N,N,-,-1,-1
OUSELEY.txt,221478,223566,2088,10,N,N,-,-1,-1
OUSELEY.txt,221521,223745,2224,10,N,N,-,-1,-1
OUSELEY.txt,221551,224328,2777,10,N,N,-,-1,-1
OUSELEY.txt,221731,224776,3045,10,N,N,-,-1,-1
OUSELEY.txt,221805,224852,3047,10,N,N,-,-1,-1
OUSELEY.txt,222023,225039,3016,10,N,N,-,-1,-1
OUSELEY.txt,222352,225708,3356,10,N,N,-,-1,-1
OUSELEY.txt,222634,225768,3134,10,N,N,-,-1,-1
OUSELEY.txt,223170,226254,3084,10,N,N,-,-1,-1
OUSELEY.txt,223299,226478,3179,10,N,N,-,-1,-1
OUSELEY.txt,223567,226714,3147,10,N,N,-,-1,-1
OUSELEY.txt,223746,226954,3208,10,N,N,-,-1,-1
OUSELEY.txt,224329,227435,3106,10,N,N,-,-1,-1
OUSELEY.txt,224777,227610,2833,10,N,N,-,-1,-1
OUSELEY.txt,224857,227636,2779,10,N,N,-,-1,-1
OUSELEY.txt,225040,228110,3070,10,N,N,-,-1,-1
OUSELEY.txt,225709,228169,2460,10,N,N,-,-1,-1
OUSELEY.txt,225769,228460,2691,10,N,N,-,-1,-1
OUSELEY.txt,226255,228786,2531,10,N,N,-,-1,-1
OUSELEY.txt,226479,229073,2594,10,N,N,-,-1,-1
OUSELEY.txt,226715,229137,2422,10,N,N,-,-1,-1
OUSELEY.txt,226956,229220,2264,10,N,N,-,-1,-1
OUSELEY.txt,227436,229418,1982,10,N,N,-,-1,-1
OUSELEY.txt,227611,229650,2039,10,N,N,-,-1,-1
OUSELEY.txt,227637,229774,2137,10,N,N,-,-1,-1
OUSELEY.txt,228111,229921,1810,10,N,N,-,-1,-1
OUSELEY.txt,228170,230110,1940,10,N,N,-,-1,-1
OUSELEY.txt,228461,230308,1847,10,N,N,-,-1,-1
OUSELEY.txt,228787,230436,1649,10,N,N,-,-1,-1
OUSELEY.txt,229078,230617,1539,10,N,N,-,-1,-1
OUSELEY.txt,229142,230786,1644,10,N,N,-,-1,-1
OUSELEY.txt,229222,230897,1675,10,N,N,-,-1,-1
OUSELEY.txt,229419,231094,1675,10,N,N,-,-1,-1
OUSELEY.txt,229651,231274,1623,10,Y,N,-,-1,-1
OUSELEY.txt,229775,231448,1673,10,Y,N,-,-1,-1
OUSELEY.txt,229922,231637,1715,10,Y,N,-,-1,-1
OUSELEY.txt,230111,231831,1720,10,Y,N,-,-1,-1
OUSELEY.txt,230309,232064,1755,10,Y,N,-,-1,-1
OUSELEY.txt,230437,232209,1772,10,Y,N,-,-1,-1
OUSELEY.txt,230618,232416,1798,10,Y,N,-,-1,-1
OUSELEY.txt,230789,232738,1949,10,Y,N,-,-1,-1
OUSELEY.txt,230898,232858,1960,10,Y,N,-,-1,-1
OUSELEY.txt,231096,233064,1968,10,N,N,-,-1,-1
OUSELEY.txt,231275,233303,2028,10,N,N,-,-1,-1
OUSELEY.txt,231449,233401,1952,10,N,N,-,-1,-1
OUSELEY.txt,231642,233796,2154,10,N,N,-,-1,-1
OUSELEY.txt,231832,233892,2060,10,N,N,-,-1,-1
OUSELEY.txt,232065,233938,1873,10,N,N,-,-1,-1
OUSELEY.txt,232211,234225,2014,10,N,N,-,-1,-1
OUSELEY.txt,232417,234428,2011,10,N,N,-,-1,-1
OUSELEY.txt,232739,234561,1822,10,N,N,-,-1,-1
OUSELEY.txt,232859,234817,1958,10,N,N,-,-1,-1
OUSELEY.txt,233066,235049,1983,10,N,N,-,-1,-1
OUSELEY.txt,233304,235231,1927,10,N,N,-,-1,-1
OUSELEY.txt,233406,235537,2131,10,N,N,-,-1,-1
OUSELEY.txt,233797,235886,2089,10,N,N,-,-1,-1
OUSELEY.txt,233892,236139,2247,10,N,N,-,-1,-1
OUSELEY.txt,233940,236606,2666,10,N,N,-,-1,-1
OUSELEY.txt,234226,236687,2461,10,N,N,-,-1,-1
OUSELEY.txt,234429,236901,2472,10,N,N,-,-1,-1
OUSELEY.txt,234562,237069,2507,10,N,N,-,-1,-1
OUSELEY.txt,234818,237320,2502,10,N,N,-,-1,-1
OUSELEY.txt,235050,237747,2697,10,N,N,-,-1,-1
OUSELEY.txt,235233,238013,2780,10,N,N,-,-1,-1
OUSELEY.txt,235538,238281,2743,10,N,N,-,-1,-1
OUSELEY.txt,235887,238437,2550,10,N,N,-,-1,-1
OUSELEY.txt,236140,238608,2468,10,N,N,-,-1,-1
OUSELEY.txt,236608,239140,2532,10,N,N,-,-1,-1
OUSELEY.txt,236688,239344,2656,10,N,N,-,-1,-1
OUSELEY.txt,236902,239550,2648,10,N,N,-,-1,-1
OUSELEY.txt,237070,239675,2605,10,N,N,-,-1,-1
OUSELEY.txt,237321,239881,2560,10,N,N,-,-1,-1
OUSELEY.txt,237748,240049,2301,10,N,N,-,-1,-1
OUSELEY.txt,238014,240399,2385,10,N,N,-,-1,-1
OUSELEY.txt,238282,240588,2306,10,N,N,-,-1,-1
OUSELEY.txt,238438,241063,2625,10,N,N,-,-1,-1
OUSELEY.txt,238609,241331,2722,10,N,N,-,-1,-1
OUSELEY.txt,239141,241587,2446,10,N,N,-,-1,-1
OUSELEY.txt,239345,241816,2471,10,N,N,-,-1,-1
OUSELEY.txt,239551,241935,2384,10,N,N,-,-1,-1
OUSELEY.txt,239676,242024,2348,10,N,N,-,-1,-1
OUSELEY.txt,239882,242207,2325,10,N,N,-,-1,-1
OUSELEY.txt,240051,242437,2386,10,N,N,-,-1,-1
OUSELEY.txt,240401,242579,2178,10,N,N,-,-1,-1
OUSELEY.txt,240589,242761,2172,10,N,N,-,-1,-1
OUSELEY.txt,241064,242793,1729,10,N,N,-,-1,-1
OUSELEY.txt,241332,243072,1740,10,N,N,-,-1,-1
OUSELEY.txt,241588,243379,1791,10,N,N,-,-1,-1
OUSELEY.txt,241817,243531,1714,10,N,N,-,-1,-1
OUSELEY.txt,241936,243922,1986,10,N,N,-,-1,-1
OUSELEY.txt,242027,244037,2010,10,N,N,-,-1,-1
OUSELEY.txt,242208,244244,2036,10,N,N,-,-1,-1
OUSELEY.txt,242438,244751,2313,10,N,N,-,-1,-1
OUSELEY.txt,242580,244883,2303,10,N,N,-,-1,-1
OUSELEY.txt,242766,245153,2387,10,N,N,-,-1,-1
OUSELEY.txt,242794,245533,2739,10,N,N,-,-1,-1
OUSELEY.txt,243073,245646,2573,10,N,N,-,-1,-1
OUSELEY.txt,243380,246112,2732,10,N,N,-,-1,-1
OUSELEY.txt,243532,246255,2723,10,N,N,-,-1,-1
OUSELEY.txt,243923,246509,2586,10,N,N,-,-1,-1
OUSELEY.txt,244039,246613,2574,10,N,N,-,-1,-1
OUSELEY.txt,244245,246813,2568,10,N,N,-,-1,-1
OUSELEY.txt,244752,246991,2239,10,N,N,-,-1,-1
OUSELEY.txt,244885,247294,2409,10,N,N,-,-1,-1
OUSELEY.txt,245154,247523,2369,10,N,N,-,-1,-1
OUSELEY.txt,245534,247686,2152,10,N,N,-,-1,-1
OUSELEY.txt,245647,247914,2267,10,N,N,-,-1,-1
OUSELEY.txt,246115,248069,1954,10,N,N,-,-1,-1
OUSELEY.txt,246256,248405,2149,10,N,N,-,-1,-1
OUSELEY.txt,246510,248643,2133,10,N,N,-,-1,-1
OUSELEY.txt,246614,248762,2148,10,N,N,-,-1,-1
OUSELEY.txt,246814,248868,2054,10,N,N,-,-1,-1
OUSELEY.txt,246992,248994,2002,10,N,N,-,-1,-1
OUSELEY.txt,247295,249177,1882,10,N,N,-,-1,-1
OUSELEY.txt,247524,249503,1979,10,N,N,-,-1,-1
OUSELEY.txt,247687,249587,1900,10,N,N,-,-1,-1
OUSELEY.txt,247915,249668,1753,10,N,N,-,-1,-1
OUSELEY.txt,248070,249824,1754,10,N,N,-,-1,-1
OUSELEY.txt,248406,249926,1520,10,N,N,-,-1,-1
OUSELEY.txt,248645,250166,1521,10,N,N,-,-1,-1
OUSELEY.txt,248763,250618,1855,10,N,N,-,-1,-1
OUSELEY.txt,248870,250769,1899,10,N,N,-,-1,-1
OUSELEY.txt,248995,250965,1970,10,N,N,-,-1,-1
OUSELEY.txt,249179,251457,2278,10,N,N,-,-1,-1
OUSELEY.txt,249504,251632,2128,10,N,N,-,-1,-1
OUSELEY.txt,249588,251823,2235,10,N,N,-,-1,-1
OUSELEY.txt,249669,251900,2231,10,N,N,-,-1,-1
OUSELEY.txt,249825,252161,2336,10,N,N,-,-1,-1
OUSELEY.txt,249927,252289,2362,10,N,N,-,-1,-1
OUSELEY.txt,250167,252569,2402,10,N,N,-,-1,-1
OUSELEY.txt,250619,252702,2083,10,N,N,-,-1,-1
OUSELEY.txt,250770,252999,2229,10,N,N,-,-1,-1
OUSELEY.txt,250966,253386,2420,10,N,N,-,-1,-1
OUSELEY.txt,251458,253532,2074,10,N,N,-,-1,-1
OUSELEY.txt,251637,253569,1932,10,N,N,-,-1,-1
OUSELEY.txt,251828,253604,1776,10,N,N,-,-1,-1
OUSELEY.txt,251901,253639,1738,10,N,N,-,-1,-1
OUSELEY.txt,252162,253663,1501,10,N,N,-,-1,-1
OUSELEY.txt,252290,253705,1415,10,N,N,-,-1,-1
OUSELEY.txt,252570,253987,1417,10,N,N,-,-1,-1
OUSELEY.txt,252704,254111,1407,10,N,N,-,-1,-1
OUSELEY.txt,253000,254220,1220,10,N,N,-,-1,-1
OUSELEY.txt,253387,254286,899,10,N,N,-,-1,-1
OUSELEY.txt,253535,254470,935,10,N,N,-,-1,-1
OUSELEY.txt,253570,254581,1011,10,N,N,-,-1,-1
OUSELEY.txt,253605,254637,1032,10,N,N,-,-1,-1
OUSELEY.txt,253640,254684,1044,10,N,N,-,-1,-1
OUSELEY.txt,253666,254712,1046,10,N,N,-,-1,-1
OUSELEY.txt,253708,254743,1035,10,N,N,-,-1,-1
OUSELEY.txt,253989,254781,792,10,N,N,-,-1,-1
OUSELEY.txt,254112,254825,713,10,N,N,-,-1,-1
OUSELEY.txt,254221,254849,628,10,N,N,-,-1,-1
OUSELEY.txt,254287,255202,915,10,N,N,-,-1,-1
OUSELEY.txt,254473,255256,783,10,N,N,-,-1,-1
OUSELEY.txt,254584,255318,734,10,N,N,-,-1,-1
OUSELEY.txt,254639,255581,942,10,N,N,-,-1,-1
OUSELEY.txt,254687,255933,1246,10,N,N,-,-1,-1
OUSELEY.txt,254713,256121,1408,10,N,N,-,-1,-1
OUSELEY.txt,254744,256253,1509,10,N,N,-,-1,-1
OUSELEY.txt,254783,256424,1641,10,N,N,-,-1,-1
OUSELEY.txt,254826,256615,1789,10,N,N,-,-1,-1
OUSELEY.txt,254852,256957,2105,10,N,N,-,-1,-1
OUSELEY.txt,255203,257258,2055,10,N,N,-,-1,-1
OUSELEY.txt,255257,257413,2156,10,N,N,-,-1,-1
OUSELEY.txt,255319,257562,2243,10,N,N,-,-1,-1
OUSELEY.txt,255582,257888,2306,10,N,N,-,-1,-1
OUSELEY.txt,255936,258225,2289,10,N,N,-,-1,-1
OUSELEY.txt,256122,258429,2307,10,N,N,-,-1,-1
OUSELEY.txt,256254,258460,2206,10,N,N,-,-1,-1
OUSELEY.txt,256425,258468,2043,10,N,N,-,-1,-1
OUSELEY.txt,256616,258575,1959,10,N,N,-,-1,-1
OUSELEY.txt,256958,258872,1914,10,N,N,-,-1,-1
OUSELEY.txt,257260,258998,1738,10,N,N,-,-1,-1
OUSELEY.txt,257416,259179,1763,10,N,N,-,-1,-1
OUSELEY.txt,257563,259424,1861,10,N,N,-,-1,-1
OUSELEY.txt,257889,259496,1607,10,N,N,-,-1,-1
OUSELEY.txt,258227,259565,1338,10,N,N,-,-1,-1
OUSELEY.txt,258434,259785,1351,10,N,N,-,-1,-1
OUSELEY.txt,258460,259877,1417,10,N,N,-,-1,-1
OUSELEY.txt,258473,259949,1476,10,N,N,-,-1,-1
OUSELEY.txt,258580,259993,1413,10,N,N,-,-1,-1
OUSELEY.txt,258873,260186,1313,10,N,N,-,-1,-1
OUSELEY.txt,258999,260581,1582,10,N,N,-,-1,-1
OUSELEY.txt,259180,261214,2034,10,Y,N,-,-1,-1
OUSELEY.txt,259425,261380,1955,10,Y,N,-,-1,-1
OUSELEY.txt,259498,261731,2233,10,Y,N,-,-1,-1
OUSELEY.txt,259566,261822,2256,10,Y,N,-,-1,-1
OUSELEY.txt,259786,261936,2150,10,Y,N,-,-1,-1
OUSELEY.txt,259879,261989,2110,10,Y,N,-,-1,-1
OUSELEY.txt,259950,262086,2136,10,Y,N,-,-1,-1
OUSELEY.txt,259994,262245,2251,10,Y,N,-,-1,-1
OUSELEY.txt,260189,262524,2335,10,Y,N,-,-1,-1
OUSELEY.txt,260586,262598,2012,10,N,N,-,-1,-1
OUSELEY.txt,261217,262719,1502,10,N,N,-,-1,-1
OUSELEY.txt,261381,262761,1380,10,N,N,-,-1,-1
OUSELEY.txt,261734,262866,1132,10,N,N,-,-1,-1
OUSELEY.txt,261823,263077,1254,10,N,N,-,-1,-1
OUSELEY.txt,261941,263289,1348,10,N,N,-,-1,-1
OUSELEY.txt,261992,263550,1558,10,N,N,-,-1,-1
OUSELEY.txt,262087,263636,1549,10,N,N,-,-1,-1
OUSELEY.txt,262248,263641,1393,10,N,N,-,-1,-1
OUSELEY.txt,262525,263756,1231,10,N,N,-,-1,-1
OUSELEY.txt,262600,264096,1496,10,N,N,-,-1,-1
OUSELEY.txt,262720,264429,1709,10,N,N,-,-1,-1
OUSELEY.txt,262762,264442,1680,10,N,N,-,-1,-1
OUSELEY.txt,262869,264479,1610,10,N,N,-,-1,-1
OUSELEY.txt,263078,264506,1428,10,N,N,-,-1,-1
OUSELEY.txt,263290,264623,1333,10,N,N,-,-1,-1
OUSELEY.txt,263551,264865,1314,10,N,N,-,-1,-1
OUSELEY.txt,263637,265331,1694,10,N,N,-,-1,-1
OUSELEY.txt,263644,265555,1911,10,N,N,-,-1,-1
OUSELEY.txt,263757,265713,1956,10,Y,N,-,-1,-1
OUSELEY.txt,264097,265883,1786,10,N,N,-,-1,-1
OUSELEY.txt,264430,266020,1590,10,N,N,-,-1,-1
OUSELEY.txt,264443,266047,1604,10,N,N,-,-1,-1
OUSELEY.txt,264482,266164,1682,10,N,N,-,-1,-1
OUSELEY.txt,264507,266203,1696,10,N,N,-,-1,-1
OUSELEY.txt,264628,266240,1612,10,N,N,-,-1,-1
OUSELEY.txt,264866,266268,1402,10,N,N,-,-1,-1
OUSELEY.txt,265334,266361,1027,10,N,N,-,-1,-1
OUSELEY.txt,265556,266624,1068,10,N,N,-,-1,-1
OUSELEY.txt,265714,266829,1115,10,N,N,-,-1,-1
OUSELEY.txt,265886,267039,1153,10,N,N,-,-1,-1
OUSELEY.txt,266021,267273,1252,10,N,N,-,-1,-1
OUSELEY.txt,266048,267425,1377,10,N,N,-,-1,-1
OUSELEY.txt,266167,267513,1346,10,N,N,-,-1,-1
OUSELEY.txt,266205,267558,1353,10,N,N,-,-1,-1
OUSELEY.txt,266241,267618,1377,10,N,N,-,-1,-1
OUSELEY.txt,266269,267679,1410,10,N,N,-,-1,-1
OUSELEY.txt,266364,268042,1678,10,N,N,-,-1,-1
OUSELEY.txt,266626,268489,1863,10,N,N,-,-1,-1
OUSELEY.txt,266830,268732,1902,10,N,N,-,-1,-1
OUSELEY.txt,267040,268829,1789,10,N,N,-,-1,-1
OUSELEY.txt,267278,268985,1707,10,N,N,-,-1,-1
OUSELEY.txt,267426,269012,1586,10,N,N,-,-1,-1
OUSELEY.txt,267516,269184,1668,10,N,N,-,-1,-1
OUSELEY.txt,267560,269201,1641,10,N,N,-,-1,-1
OUSELEY.txt,267619,269357,1738,10,N,N,-,-1,-1
OUSELEY.txt,267681,269517,1836,10,N,N,-,-1,-1
OUSELEY.txt,268045,269595,1550,10,N,N,-,-1,-1
OUSELEY.txt,268490,269673,1183,10,N,N,-,-1,-1
OUSELEY.txt,268733,269769,1036,10,N,N,-,-1,-1
OUSELEY.txt,268830,269943,1113,10,N,N,-,-1,-1
OUSELEY.txt,268990,270016,1026,10,N,N,-,-1,-1
OUSELEY.txt,269013,270190,1177,10,N,N,-,-1,-1
OUSELEY.txt,269189,270296,1107,10,N,N,-,-1,-1
OUSELEY.txt,269202,270444,1242,10,N,N,-,-1,-1
OUSELEY.txt,269358,270678,1320,10,N,N,-,-1,-1
OUSELEY.txt,269518,270776,1258,10,Y,N,-,-1,-1
OUSELEY.txt,269597,271130,1533,10,Y,N,-,-1,-1
OUSELEY.txt,269674,271178,1504,10,Y,N,-,-1,-1
OUSELEY.txt,269771,271257,1486,10,Y,N,-,-1,-1
OUSELEY.txt,269944,271427,1483,10,N,N,-,-1,-1
OUSELEY.txt,270019,271559,1540,10,Y,N,-,-1,-1
OUSELEY.txt,270193,271637,1444,10,N,N,-,-1,-1
OUSELEY.txt,270297,271823,1526,10,Y,N,-,-1,-1
OUSELEY.txt,270446,272000,1554,10,N,N,-,-1,-1
OUSELEY.txt,270679,272055,1376,10,N,N,-,-1,-1
OUSELEY.txt,270781,272110,1329,10,N,N,-,-1,-1
OUSELEY.txt,271131,272225,1094,10,N,N,-,-1,-1
OUSELEY.txt,271179,272291,1112,10,N,N,-,-1,-1
OUSELEY.txt,271258,272412,1154,10,N,N,-,-1,-1
OUSELEY.txt,271428,272550,1122,10,N,N,-,-1,-1
OUSELEY.txt,271560,272696,1136,10,N,N,-,-1,-1
OUSELEY.txt,271640,272866,1226,10,N,N,-,-1,-1
OUSELEY.txt,271824,273018,1194,10,N,N,-,-1,-1
OUSELEY.txt,272003,273188,1185,10,N,N,-,-1,-1
OUSELEY.txt,272056,273300,1244,10,N,N,-,-1,-1
OUSELEY.txt,272111,273439,1328,10,N,N,-,-1,-1
OUSELEY.txt,272226,273591,1365,10,N,N,-,-1,-1
OUSELEY.txt,272294,273723,1429,10,N,N,-,-1,-1
OUSELEY.txt,272413,273887,1474,10,N,N,-,-1,-1
OUSELEY.txt,272551,274037,1486,10,N,N,-,-1,-1
OUSELEY.txt,272697,274184,1487,10,N,N,-,-1,-1
OUSELEY.txt,272869,274335,1466,10,N,N,-,-1,-1
OUSELEY.txt,273019,274593,1574,10,N,N,-,-1,-1
OUSELEY.txt,273189,274685,1496,10,N,N,-,-1,-1
OUSELEY.txt,273301,274840,1539,10,N,N,-,-1,-1
OUSELEY.txt,273444,275023,1579,10,N,N,-,-1,-1
OUSELEY.txt,273592,275078,1486,10,N,N,-,-1,-1
OUSELEY.txt,273724,275219,1495,10,N,N,-,-1,-1
OUSELEY.txt,273888,275362,1474,10,N,N,-,-1,-1
OUSELEY.txt,274038,275493,1455,10,N,N,-,-1,-1
OUSELEY.txt,274185,275587,1402,10,N,N,-,-1,-1
OUSELEY.txt,274336,275784,1448,10,N,N,-,-1,-1
OUSELEY.txt,274594,275930,1336,10,N,N,-,-1,-1
OUSELEY.txt,274686,276136,1450,10,N,N,-,-1,-1
OUSELEY.txt,274842,276194,1352,10,N,N,-,-1,-1
OUSELEY.txt,275024,276323,1299,10,N,N,-,-1,-1
OUSELEY.txt,275079,276630,1551,10,N,N,-,-1,-1
OUSELEY.txt,275224,276711,1487,10,N,N,-,-1,-1
OUSELEY.txt,275363,276798,1435,10,N,N,-,-1,-1
OUSELEY.txt,275496,276809,1313,10,N,N,-,-1,-1
OUSELEY.txt,275592,276856,1264,10,N,N,-,-1,-1
OUSELEY.txt,275785,277001,1216,10,N,N,-,-1,-1
OUSELEY.txt,275935,277211,1276,10,N,N,-,-1,-1
OUSELEY.txt,276138,277266,1128,10,N,N,-,-1,-1
OUSELEY.txt,276194,277418,1224,10,N,N,-,-1,-1
OUSELEY.txt,276324,277580,1256,10,N,N,-,-1,-1
OUSELEY.txt,276631,277607,976,10,N,N,-,-1,-1
OUSELEY.txt,276716,277834,1118,10,N,N,-,-1,-1
OUSELEY.txt,276799,277972,1173,10,N,N,-,-1,-1
OUSELEY.txt,276810,278045,1235,10,N,N,-,-1,-1
OUSELEY.txt,276857,278393,1536,10,N,N,-,-1,-1
OUSELEY.txt,277004,278431,1427,10,N,N,-,-1,-1
OUSELEY.txt,277212,278454,1242,10,N,N,-,-1,-1
OUSELEY.txt,277267,278646,1379,10,N,N,-,-1,-1
OUSELEY.txt,277419,278746,1327,10,N,N,-,-1,-1
OUSELEY.txt,277585,278900,1315,10,N,N,-,-1,-1
OUSELEY.txt,277612,279154,1542,10,N,N,-,-1,-1
OUSELEY.txt,277835,279581,1746,10,N,N,-,-1,-1
OUSELEY.txt,277973,279719,1746,10,Y,N,-,-1,-1
OUSELEY.txt,278046,279789,1743,10,Y,N,-,-1,-1
OUSELEY.txt,278396,279870,1474,10,N,N,-,-1,-1
OUSELEY.txt,278433,279996,1563,10,Y,N,-,-1,-1
OUSELEY.txt,278457,280179,1722,10,Y,N,-,-1,-1
OUSELEY.txt,278647,280313,1666,10,N,N,-,-1,-1
OUSELEY.txt,278747,280408,1661,10,Y,N,-,-1,-1
OUSELEY.txt,278901,280663,1762,10,Y,N,-,-1,-1
OUSELEY.txt,279156,280741,1585,10,N,N,-,-1,-1
OUSELEY.txt,279584,280905,1321,10,N,N,-,-1,-1
OUSELEY.txt,279720,280989,1269,10,N,N,-,-1,-1
OUSELEY.txt,279794,281122,1328,10,N,N,-,-1,-1
OUSELEY.txt,279871,281193,1322,10,N,N,-,-1,-1
OUSELEY.txt,279997,281413,1416,10,N,N,-,-1,-1
OUSELEY.txt,280180,281586,1406,10,N,N,-,-1,-1
OUSELEY.txt,280314,281702,1388,10,N,N,-,-1,-1
OUSELEY.txt,280409,281819,1410,10,N,N,-,-1,-1
OUSELEY.txt,280666,282086,1420,10,N,N,-,-1,-1
OUSELEY.txt,280742,282186,1444,10,N,N,-,-1,-1
OUSELEY.txt,280906,282307,1401,10,N,N,-,-1,-1
OUSELEY.txt,280990,282510,1520,10,N,N,-,-1,-1
OUSELEY.txt,281123,282851,1728,10,N,N,-,-1,-1
OUSELEY.txt,281194,283370,2176,10,N,N,-,-1,-1
OUSELEY.txt,281415,283424,2009,10,N,N,-,-1,-1
OUSELEY.txt,281587,283599,2012,10,N,N,-,-1,-1
OUSELEY.txt,281703,283683,1980,10,N,N,-,-1,-1
OUSELEY.txt,281820,283834,2014,10,N,N,-,-1,-1
OUSELEY.txt,282087,284018,1931,10,N,N,-,-1,-1
OUSELEY.txt,282187,284087,1900,10,N,N,-,-1,-1
OUSELEY.txt,282308,284259,1951,10,N,N,-,-1,-1
OUSELEY.txt,282511,284552,2041,10,N,N,-,-1,-1
OUSELEY.txt,282852,284563,1711,10,N,N,-,-1,-1
OUSELEY.txt,283375,284585,1210,10,N,N,-,-1,-1
OUSELEY.txt,283429,284612,1183,10,N,N,-,-1,-1
OUSELEY.txt,283601,284675,1074,10,N,N,-,-1,-1
OUSELEY.txt,283685,284726,1041,10,N,N,-,-1,-1
OUSELEY.txt,283835,284797,962,10,N,N,-,-1,-1
OUSELEY.txt,284019,284821,802,10,N,N,-,-1,-1
OUSELEY.txt,284088,284851,763,10,N,N,-,-1,-1
OUSELEY.txt,284262,284899,637,10,N,N,-,-1,-1
OUSELEY.txt,284555,284972,417,10,N,N,-,-1,-1
OUSELEY.txt,284566,284983,417,10,N,N,-,-1,-1
OUSELEY.txt,284587,284995,408,10,N,N,-,-1,-1
OUSELEY.txt,284614,285012,398,10,N,N,-,-1,-1
OUSELEY.txt,284676,285047,371,10,N,N,-,-1,-1
OUSELEY.txt,284727,285063,336,10,N,N,-,-1,-1
OUSELEY.txt,284799,285086,287,10,N,N,-,-1,-1
OUSELEY.txt,284823,285110,287,10,N,N,-,-1,-1
OUSELEY.txt,284853,285129,276,10,N,N,-,-1,-1
OUSELEY.txt,284901,285161,260,10,N,N,-,-1,-1
OUSELEY.txt,284974,285195,221,10,N,N,-,-1,-1
OUSELEY.txt,284985,285207,222,10,N,N,-,-1,-1
OUSELEY.txt,284996,285232,236,10,N,N,-,-1,-1
OUSELEY.txt,285014,285260,246,10,N,N,-,-1,-1
OUSELEY.txt,285050,285452,402,10,N,N,-,-1,-1
OUSELEY.txt,285065,285543,478,10,N,N,-,-1,-1
OUSELEY.txt,285088,285646,558,10,N,N,-,-1,-1
OUSELEY.txt,285112,285730,618,10,N,N,-,-1,-1
OUSELEY.txt,285130,285749,619,10,N,N,-,-1,-1
OUSELEY.txt,285164,285803,639,10,N,N,-,-1,-1
OUSELEY.txt,285197,286106,909,10,N,N,-,-1,-1
OUSELEY.txt,285208,286145,937,10,N,N,-,-1,-1
OUSELEY.txt,285234,286175,941,10,N,N,-,-1,-1
OUSELEY.txt,285265,286247,982,10,N,N,-,-1,-1
OUSELEY.txt,285455,286291,836,10,N,N,-,-1,-1
OUSELEY.txt,285545,286376,831,10,N,N,-,-1,-1
OUSELEY.txt,285651,286387,736,10,N,N,-,-1,-1
OUSELEY.txt,285731,286396,665,10,N,N,-,-1,-1
OUSELEY.txt,285751,286443,692,10,N,N,-,-1,-1
OUSELEY.txt,285804,286535,731,10,N,N,-,-1,-1
OUSELEY.txt,286108,286553,445,10,N,N,-,-1,-1
OUSELEY.txt,286147,286585,438,10,N,N,-,-1,-1
OUSELEY.txt,286178,286642,464,10,N,N,-,-1,-1
OUSELEY.txt,286250,286648,398,10,N,N,-,-1,-1
OUSELEY.txt,286294,286717,423,10,N,N,-,-1,-1
OUSELEY.txt,286378,286744,366,10,N,N,-,-1,-1
OUSELEY.txt,286388,286769,381,10,N,N,-,-1,-1
OUSELEY.txt,286399,286782,383,10,N,N,-,-1,-1
OUSELEY.txt,286446,286855,409,10,N,N,-,-1,-1
OUSELEY.txt,286536,286866,330,10,N,N,-,-1,-1
OUSELEY.txt,286556,286878,322,10,N,N,-,-1,-1
OUSELEY.txt,286587,286999,412,10,N,N,-,-1,-1
OUSELEY.txt,286643,287011,368,10,N,N,-,-1,-1
OUSELEY.txt,286651,287071,420,10,N,N,-,-1,-1
OUSELEY.txt,286720,287082,362,10,N,N,-,-1,-1
OUSELEY.txt,286747,287091,344,10,N,N,-,-1,-1
OUSELEY.txt,286772,287132,360,10,N,N,-,-1,-1
OUSELEY.txt,286784,287153,369,10,N,N,-,-1,-1
OUSELEY.txt,286857,287186,329,10,N,N,-,-1,-1
OUSELEY.txt,286871,287197,326,10,N,N,-,-1,-1
OUSELEY.txt,286881,287243,362,10,N,N,-,-1,-1
OUSELEY.txt,287001,287281,280,10,N,N,-,-1,-1
OUSELEY.txt,287014,287318,304,10,N,N,-,-1,-1
OUSELEY.txt,287072,287365,293,10,N,N,-,-1,-1
OUSELEY.txt,287087,287454,367,10,N,N,-,-1,-1
OUSELEY.txt,287092,287465,373,10,N,N,-,-1,-1
OUSELEY.txt,287135,287518,383,10,N,N,-,-1,-1
OUSELEY.txt,287156,287580,424,10,N,N,-,-1,-1
OUSELEY.txt,287189,287594,405,10,N,N,-,-1,-1
OUSELEY.txt,287198,287627,429,10,N,N,-,-1,-1
OUSELEY.txt,287246,287655,409,10,N,N,-,-1,-1
OUSELEY.txt,287282,287667,385,10,N,N,-,-1,-1
OUSELEY.txt,287321,287673,352,10,N,N,-,-1,-1
OUSELEY.txt,287368,287710,342,10,N,N,-,-1,-1
OUSELEY.txt,287455,287756,301,10,N,N,-,-1,-1
OUSELEY.txt,287470,287789,319,10,N,N,-,-1,-1
OUSELEY.txt,287520,287845,325,10,N,N,-,-1,-1
OUSELEY.txt,287581,287877,296,10,N,N,-,-1,-1
OUSELEY.txt,287595,287894,299,10,N,N,-,-1,-1
OUSELEY.txt,287628,287913,285,10,N,N,-,-1,-1
OUSELEY.txt,287657,287958,301,10,N,N,-,-1,-1
OUSELEY.txt,287669,288000,331,10,N,N,-,-1,-1
OUSELEY.txt,287674,288026,352,10,N,N,-,-1,-1
OUSELEY.txt,287713,288039,326,10,N,N,-,-1,-1
OUSELEY.txt,287759,288073,314,10,N,N,-,-1,-1
OUSELEY.txt,287794,288080,286,10,N,N,-,-1,-1
OUSELEY.txt,287848,288159,311,10,N,N,-,-1,-1
OUSELEY.txt,287880,288178,298,10,N,N,-,-1,-1
OUSELEY.txt,287895,288214,319,10,N,N,-,-1,-1
OUSELEY.txt,287916,288219,303,10,N,N,-,-1,-1
OUSELEY.txt,287961,288262,301,10,N,N,-,-1,-1
OUSELEY.txt,288003,288279,276,10,N,N,-,-1,-1
OUSELEY.txt,288029,288291,262,10,N,N,-,-1,-1
OUSELEY.txt,288044,288296,252,10,N,N,-,-1,-1
OUSELEY.txt,288078,288384,306,10,N,N,-,-1,-1
OUSELEY.txt,288081,288389,308,10,N,N,-,-1,-1
OUSELEY.txt,288160,288416,256,10,N,N,-,-1,-1
OUSELEY.txt,288179,288482,303,10,N,N,-,-1,-1
OUSELEY.txt,288217,288527,310,10,N,N,-,-1,-1
OUSELEY.txt,288220,288532,312,10,N,N,-,-1,-1
OUSELEY.txt,288265,288571,306,10,N,N,-,-1,-1
OUSELEY.txt,288280,288586,306,10,N,N,-,-1,-1
OUSELEY.txt,288294,288719,425,10,N,N,-,-1,-1
OUSELEY.txt,288297,288855,558,10,N,N,-,-1,-1
OUSELEY.txt,288387,288897,510,10,N,N,-,-1,-1
OUSELEY.txt,288390,289056,666,10,N,N,-,-1,-1
OUSELEY.txt,288417,289786,1369,10,N,N,-,-1,-1
OUSELEY.txt,288483,289787,1304,10,N,N,-,-1,-1
OUSELEY.txt,288530,289796,1266,10,N,N,-,-1,-1
OUSELEY.txt,288533,290506,1973,10,N,N,-,-1,-1
OUSELEY.txt,288576,290693,2117,10,N,N,-,-1,-1
OUSELEY.txt,288589,290784,2195,10,N,N,-,-1,-1
OUSELEY.txt,288721,291215,2494,10,N,N,-,-1,-1
OUSELEY.txt,288856,291223,2367,10,N,N,-,-1,-1
OUSELEY.txt,288898,291334,2436,10,N,N,-,-1,-1
OUSELEY.txt,289058,291461,2403,10,N,N,-,-1,-1
OUSELEY.txt,289786,291602,1816,10,N,N,-,-1,-1
OUSELEY.txt,289790,291727,1937,10,N,N,-,-1,-1
OUSELEY.txt,289800,291882,2082,10,N,N,-,-1,-1
OUSELEY.txt,290510,291951,1441,10,N,N,-,-1,-1
OUSELEY.txt,290697,291982,1285,10,N,N,-,-1,-1
OUSELEY.txt,290784,292024,1240,10,N,N,-,-1,-1
OUSELEY.txt,291218,292088,870,10,N,N,-,-1,-1
OUSELEY.txt,291224,292230,1006,10,N,N,-,-1,-1
OUSELEY.txt,291335,292457,1122,10,N,N,-,-1,-1
OUSELEY.txt,291462,292534,1072,10,N,N,-,-1,-1
OUSELEY.txt,291603,292582,979,10,N,N,-,-1,-1
OUSELEY.txt,291732,292629,897,10,N,N,-,-1,-1
OUSELEY.txt,291883,292735,852,10,N,N,-,-1,-1
OUSELEY.txt,291954,293137,1183,10,N,N,-,-1,-1
OUSELEY.txt,291983,293164,1181,10,N,N,-,-1,-1
OUSELEY.txt,292027,293233,1206,10,N,N,-,-1,-1
OUSELEY.txt,292091,293249,1158,10,N,N,-,-1,-1
OUSELEY.txt,292233,293257,1024,10,N,N,-,-1,-1
OUSELEY.txt,292458,293262,804,10,N,N,-,-1,-1
OUSELEY.txt,292537,293283,746,10,N,N,-,-1,-1
OUSELEY.txt,292585,293288,703,10,N,N,-,-1,-1
OUSELEY.txt,292630,293314,684,10,N,N,-,-1,-1
OUSELEY.txt,292736,293319,583,10,N,N,-,-1,-1
OUSELEY.txt,293142,293365,223,10,N,N,-,-1,-1
OUSELEY.txt,293169,293370,201,10,N,N,-,-1,-1
OUSELEY.txt,293236,293422,186,10,N,N,-,-1,-1
OUSELEY.txt,293252,293443,191,10,N,N,-,-1,-1
OUSELEY.txt,293260,293464,204,10,N,N,-,-1,-1
OUSELEY.txt,293263,293469,206,10,N,N,-,-1,-1
OUSELEY.txt,293286,293481,195,10,N,N,-,-1,-1
OUSELEY.txt,293289,293487,198,10,N,N,-,-1,-1
OUSELEY.txt,293317,293518,201,10,N,N,-,-1,-1
OUSELEY.txt,293320,293524,204,10,N,N,-,-1,-1
OUSELEY.txt,293368,293543,175,10,N,N,-,-1,-1
OUSELEY.txt,293371,293556,185,10,N,N,-,-1,-1
OUSELEY.txt,293423,293591,168,10,N,N,-,-1,-1
OUSELEY.txt,293444,293597,153,10,N,N,-,-1,-1
OUSELEY.txt,293466,293614,148,10,N,N,-,-1,-1
OUSELEY.txt,293470,293620,150,10,N,N,-,-1,-1
OUSELEY.txt,293484,293636,152,10,N,N,-,-1,-1
OUSELEY.txt,293488,293654,166,10,N,N,-,-1,-1
OUSELEY.txt,293521,293660,139,10,N,N,-,-1,-1
OUSELEY.txt,293525,293694,169,10,N,N,-,-1,-1
OUSELEY.txt,293544,293700,156,10,N,N,-,-1,-1
OUSELEY.txt,293557,293712,155,10,N,N,-,-1,-1
OUSELEY.txt,293594,293718,124,10,N,N,-,-1,-1
OUSELEY.txt,293598,293816,218,10,N,N,-,-1,-1
OUSELEY.txt,293617,293834,217,10,N,N,-,-1,-1
OUSELEY.txt,293621,294025,404,10,N,N,-,-1,-1
OUSELEY.txt,293637,294040,403,10,N,N,-,-1,-1
OUSELEY.txt,293657,294276,619,10,N,N,-,-1,-1
OUSELEY.txt,293661,294478,817,10,N,N,-,-1,-1
OUSELEY.txt,293697,294574,877,10,N,N,-,-1,-1
OUSELEY.txt,293701,294881,1180,10,N,N,-,-1,-1
OUSELEY.txt,293715,295077,1362,10,N,N,-,-1,-1
OUSELEY.txt,293719,295102,1383,10,N,N,-,-1,-1
OUSELEY.txt,293821,295107,1286,10,N,N,-,-1,-1
OUSELEY.txt,293839,295145,1306,10,N,N,-,-1,-1
OUSELEY.txt,294026,295150,1124,10,N,N,-,-1,-1
OUSELEY.txt,294045,295172,1127,10,N,N,-,-1,-1
OUSELEY.txt,294277,295186,909,10,N,N,-,-1,-1
OUSELEY.txt,294480,295191,711,10,N,N,-,-1,-1
OUSELEY.txt,294575,295206,631,10,N,N,-,-1,-1
OUSELEY.txt,294881,295220,339,10,N,N,-,-1,-1
OUSELEY.txt,295078,295225,147,10,N,N,-,-1,-1
OUSELEY.txt,295103,295256,153,10,N,N,-,-1,-1
OUSELEY.txt,295109,295270,161,10,N,N,-,-1,-1
OUSELEY.txt,295146,295275,129,10,N,N,-,-1,-1
OUSELEY.txt,295152,295350,198,10,N,N,-,-1,-1
OUSELEY.txt,295173,295364,191,10,N,N,-,-1,-1
OUSELEY.txt,295187,295369,182,10,N,N,-,-1,-1
OUSELEY.txt,295194,295396,202,10,N,N,-,-1,-1
OUSELEY.txt,295207,295410,203,10,N,N,-,-1,-1
OUSELEY.txt,295221,295438,217,10,N,N,-,-1,-1
OUSELEY.txt,295228,295452,224,10,N,N,-,-1,-1
OUSELEY.txt,295257,295457,200,10,N,N,-,-1,-1
OUSELEY.txt,295271,295495,224,10,N,N,-,-1,-1
OUSELEY.txt,295277,295539,262,10,N,N,-,-1,-1
OUSELEY.txt,295351,295553,202,10,N,N,-,-1,-1
OUSELEY.txt,295365,295558,193,10,N,N,-,-1,-1
OUSELEY.txt,295371,295622,251,10,N,N,-,-1,-1
OUSELEY.txt,295397,295637,240,10,N,N,-,-1,-1
OUSELEY.txt,295411,295645,234,10,N,N,-,-1,-1
OUSELEY.txt,295439,295651,212,10,N,N,-,-1,-1
OUSELEY.txt,295453,295656,203,10,N,N,-,-1,-1
OUSELEY.txt,295459,295722,263,10,N,N,-,-1,-1
OUSELEY.txt,295496,295736,240,10,N,N,-,-1,-1
OUSELEY.txt,295540,295794,254,10,N,N,-,-1,-1
OUSELEY.txt,295554,295808,254,10,N,N,-,-1,-1
OUSELEY.txt,295560,295813,253,10,N,N,-,-1,-1
OUSELEY.txt,295623,295904,281,10,N,N,-,-1,-1
OUSELEY.txt,295638,295912,274,10,N,N,-,-1,-1
OUSELEY.txt,295646,295920,274,10,N,N,-,-1,-1
OUSELEY.txt,295652,295925,273,10,N,N,-,-1,-1
OUSELEY.txt,295658,296036,378,10,N,N,-,-1,-1
OUSELEY.txt,295723,296050,327,10,N,N,-,-1,-1
OUSELEY.txt,295738,296055,317,10,N,N,-,-1,-1
OUSELEY.txt,295795,296072,277,10,N,N,-,-1,-1
OUSELEY.txt,295809,296079,270,10,N,N,-,-1,-1
OUSELEY.txt,295815,296093,278,10,N,N,-,-1,-1
OUSELEY.txt,295905,296098,193,10,N,N,-,-1,-1
OUSELEY.txt,295915,296136,221,10,N,N,-,-1,-1
OUSELEY.txt,295921,296150,229,10,N,N,-,-1,-1
OUSELEY.txt,295928,296157,229,10,N,N,-,-1,-1
OUSELEY.txt,296037,296216,179,10,N,N,-,-1,-1
OUSELEY.txt,296051,296230,179,10,N,N,-,-1,-1
OUSELEY.txt,296058,296235,177,10,N,N,-,-1,-1
OUSELEY.txt,296073,296265,192,10,N,N,-,-1,-1
OUSELEY.txt,296080,296279,199,10,N,N,-,-1,-1
OUSELEY.txt,296094,296284,190,10,N,N,-,-1,-1
OUSELEY.txt,296101,296329,228,10,N,N,-,-1,-1
OUSELEY.txt,296137,296344,207,10,N,N,-,-1,-1
OUSELEY.txt,296153,296349,196,10,N,N,-,-1,-1
OUSELEY.txt,296159,296403,244,10,N,N,-,-1,-1
OUSELEY.txt,296217,296415,198,10,N,N,-,-1,-1
OUSELEY.txt,296231,296429,198,10,N,N,-,-1,-1
OUSELEY.txt,296237,296434,197,10,N,N,-,-1,-1
OUSELEY.txt,296266,296473,207,10,N,N,-,-1,-1
OUSELEY.txt,296280,296481,201,10,N,N,-,-1,-1
OUSELEY.txt,296286,296496,210,10,N,N,-,-1,-1
OUSELEY.txt,296330,296501,171,10,N,N,-,-1,-1
OUSELEY.txt,296345,296627,282,10,N,N,-,-1,-1
OUSELEY.txt,296352,296633,281,10,N,N,-,-1,-1
OUSELEY.txt,296404,296684,280,10,N,N,-,-1,-1
OUSELEY.txt,296416,296692,276,10,N,N,-,-1,-1
OUSELEY.txt,296430,296719,289,10,N,N,-,-1,-1
OUSELEY.txt,296437,296725,288,10,N,N,-,-1,-1
OUSELEY.txt,296474,296745,271,10,N,N,-,-1,-1
OUSELEY.txt,296483,296751,268,10,N,N,-,-1,-1
OUSELEY.txt,296497,296786,289,10,N,N,-,-1,-1
OUSELEY.txt,296506,296792,286,10,N,N,-,-1,-1
OUSELEY.txt,296628,296932,304,10,N,N,-,-1,-1
OUSELEY.txt,296635,296938,303,10,N,N,-,-1,-1
OUSELEY.txt,296687,297123,436,10,N,N,-,-1,-1
OUSELEY.txt,296694,297222,528,10,N,N,-,-1,-1
OUSELEY.txt,296720,297365,645,10,N,N,-,-1,-1
OUSELEY.txt,296727,297634,907,10,N,N,-,-1,-1
OUSELEY.txt,296746,297736,990,10,N,N,-,-1,-1
OUSELEY.txt,296753,297850,1097,10,N,N,-,-1,-1
OUSELEY.txt,296787,297918,1131,10,N,N,-,-1,-1
OUSELEY.txt,296793,297939,1146,10,N,N,-,-1,-1
OUSELEY.txt,296934,297944,1010,10,N,N,-,-1,-1
OUSELEY.txt,296941,297953,1012,10,N,N,-,-1,-1
OUSELEY.txt,297124,297995,871,10,N,N,-,-1,-1
OUSELEY.txt,297223,298031,808,10,N,N,-,-1,-1
OUSELEY.txt,297366,298061,695,10,N,N,-,-1,-1
OUSELEY.txt,297637,298067,430,10,N,N,-,-1,-1
OUSELEY.txt,297739,298215,476,10,N,N,-,-1,-1
OUSELEY.txt,297853,298234,381,10,N,N,-,-1,-1
OUSELEY.txt,297919,298268,349,10,N,N,-,-1,-1
OUSELEY.txt,297941,298446,505,10,N,N,-,-1,-1
OUSELEY.txt,297945,298556,611,10,N,N,-,-1,-1
OUSELEY.txt,297956,298747,791,10,N,N,-,-1,-1
OUSELEY.txt,297997,299037,1040,10,N,N,-,-1,-1
OUSELEY.txt,298033,299178,1145,10,N,N,-,-1,-1
OUSELEY.txt,298062,299235,1173,10,N,N,-,-1,-1
OUSELEY.txt,298070,299472,1402,10,N,N,-,-1,-1
OUSELEY.txt,298221,299709,1488,10,Y,N,-,-1,-1
OUSELEY.txt,298235,299829,1594,10,Y,N,-,-1,-1
OUSELEY.txt,298268,299878,1610,10,Y,N,-,-1,-1
OUSELEY.txt,298449,299979,1530,10,Y,N,-,-1,-1
OUSELEY.txt,298557,299984,1427,10,Y,N,-,-1,-1
OUSELEY.txt,298750,299992,1242,10,N,N,-,-1,-1
OUSELEY.txt,299040,300030,990,10,N,N,-,-1,-1
OUSELEY.txt,299181,300062,881,10,N,N,-,-1,-1
OUSELEY.txt,299236,300118,882,10,N,N,-,-1,-1
OUSELEY.txt,299473,300274,801,10,N,N,-,-1,-1
OUSELEY.txt,299712,300308,596,10,N,N,-,-1,-1
OUSELEY.txt,299830,300520,690,10,N,N,-,-1,-1
OUSELEY.txt,299881,300549,668,10,N,N,-,-1,-1
OUSELEY.txt,299980,300593,613,10,N,N,-,-1,-1
OUSELEY.txt,299985,300627,642,10,N,N,-,-1,-1
OUSELEY.txt,299993,300920,927,10,N,N,-,-1,-1
OUSELEY.txt,300031,301215,1184,10,N,N,-,-1,-1
OUSELEY.txt,300063,301322,1259,10,N,N,-,-1,-1
OUSELEY.txt,300119,301743,1624,10,N,N,-,-1,-1
OUSELEY.txt,300277,301821,1544,10,N,N,-,-1,-1
OUSELEY.txt,300311,302027,1716,10,N,N,-,-1,-1
OUSELEY.txt,300525,302148,1623,10,N,N,-,-1,-1
OUSELEY.txt,300554,302210,1656,10,N,N,-,-1,-1
OUSELEY.txt,300594,302282,1688,10,N,N,-,-1,-1
OUSELEY.txt,300630,302504,1874,10,N,N,-,-1,-1
OUSELEY.txt,300921,302540,1619,10,N,N,-,-1,-1
OUSELEY.txt,301216,302658,1442,10,N,N,-,-1,-1
OUSELEY.txt,301323,302698,1375,10,N,N,-,-1,-1
OUSELEY.txt,301745,303035,1290,10,N,N,-,-1,-1
OUSELEY.txt,301822,303150,1328,10,N,N,-,-1,-1
OUSELEY.txt,302028,303324,1296,10,N,N,-,-1,-1
OUSELEY.txt,302149,303403,1254,10,N,N,-,-1,-1
OUSELEY.txt,302211,303515,1304,10,N,N,-,-1,-1
OUSELEY.txt,302284,303542,1258,10,N,N,-,-1,-1
OUSELEY.txt,302504,303570,1066,10,N,N,-,-1,-1
OUSELEY.txt,302541,303601,1060,10,N,N,-,-1,-1
OUSELEY.txt,302659,303724,1065,10,N,N,-,-1,-1
OUSELEY.txt,302699,303803,1104,10,N,N,-,-1,-1
OUSELEY.txt,303036,303975,939,10,N,N,-,-1,-1
OUSELEY.txt,303153,304026,873,10,N,N,-,-1,-1
OUSELEY.txt,303327,304044,717,10,N,N,-,-1,-1
OUSELEY.txt,303404,304277,873,10,N,N,-,-1,-1
OUSELEY.txt,303518,304340,822,10,N,N,-,-1,-1
OUSELEY.txt,303548,304394,846,10,N,N,-,-1,-1
OUSELEY.txt,303575,304473,898,10,N,N,-,-1,-1
OUSELEY.txt,303602,304521,919,10,N,N,-,-1,-1
OUSELEY.txt,303725,304557,832,10,N,N,-,-1,-1
OUSELEY.txt,303804,304666,862,10,N,N,-,-1,-1
OUSELEY.txt,303976,304750,774,10,N,N,-,-1,-1
OUSELEY.txt,304029,304806,777,10,N,N,-,-1,-1
OUSELEY.txt,304045,304895,850,10,N,N,-,-1,-1
OUSELEY.txt,304282,305007,725,10,N,N,-,-1,-1
OUSELEY.txt,304341,305021,680,10,N,N,-,-1,-1
OUSELEY.txt,304396,305204,808,10,N,N,-,-1,-1
OUSELEY.txt,304474,305279,805,10,N,N,-,-1,-1
OUSELEY.txt,304523,305436,913,10,N,N,-,-1,-1
OUSELEY.txt,304558,305475,917,10,N,N,-,-1,-1
OUSELEY.txt,304667,305588,921,10,N,N,-,-1,-1
OUSELEY.txt,304753,305820,1067,10,N,N,-,-1,-1
OUSELEY.txt,304807,305982,1175,10,N,N,-,-1,-1
OUSELEY.txt,304898,306154,1256,10,N,N,-,-1,-1
OUSELEY.txt,305012,306270,1258,10,N,N,-,-1,-1
OUSELEY.txt,305022,306498,1476,10,N,N,-,-1,-1
OUSELEY.txt,305205,306599,1394,10,N,N,-,-1,-1
OUSELEY.txt,305280,306956,1676,10,N,N,-,-1,-1
OUSELEY.txt,305439,307250,1811,10,N,N,-,-1,-1
OUSELEY.txt,305478,307344,1866,10,N,N,-,-1,-1
OUSELEY.txt,305589,307378,1789,10,N,N,-,-1,-1
OUSELEY.txt,305821,307416,1595,10,N,N,-,-1,-1
OUSELEY.txt,305983,307438,1455,10,N,N,-,-1,-1
OUSELEY.txt,306155,307509,1354,10,N,N,-,-1,-1
OUSELEY.txt,306271,307572,1301,10,N,N,-,-1,-1
OUSELEY.txt,306499,307611,1112,10,N,N,-,-1,-1
OUSELEY.txt,306600,307759,1159,10,N,N,-,-1,-1
OUSELEY.txt,306957,307882,925,10,N,N,-,-1,-1
OUSELEY.txt,307251,307920,669,10,N,N,-,-1,-1
OUSELEY.txt,307345,307977,632,10,N,N,-,-1,-1
OUSELEY.txt,307380,308011,631,10,N,N,-,-1,-1
OUSELEY.txt,307421,308063,642,10,N,N,-,-1,-1
OUSELEY.txt,307439,308219,780,10,N,N,-,-1,-1
OUSELEY.txt,307510,308292,782,10,N,N,-,-1,-1
OUSELEY.txt,307573,308458,885,10,N,N,-,-1,-1
OUSELEY.txt,307611,308482,871,10,N,N,-,-1,-1
OUSELEY.txt,307765,308684,919,10,N,N,-,-1,-1
OUSELEY.txt,307887,308854,967,10,N,N,-,-1,-1
OUSELEY.txt,307922,308937,1015,10,N,N,-,-1,-1
OUSELEY.txt,307979,309403,1424,10,N,N,-,-1,-1
OUSELEY.txt,308013,309550,1537,10,N,N,-,-1,-1
OUSELEY.txt,308066,309723,1657,10,N,N,-,-1,-1
OUSELEY.txt,308220,309796,1576,10,N,N,-,-1,-1
OUSELEY.txt,308295,309860,1565,10,N,N,-,-1,-1
OUSELEY.txt,308463,310027,1564,10,N,N,-,-1,-1
OUSELEY.txt,308483,310063,1580,10,N,N,-,-1,-1
OUSELEY.txt,308685,310097,1412,10,N,N,-,-1,-1
OUSELEY.txt,308856,310614,1758,10,N,N,-,-1,-1
OUSELEY.txt,308938,310823,1885,10,N,N,-,-1,-1
OUSELEY.txt,309404,310959,1555,10,N,N,-,-1,-1
OUSELEY.txt,309551,311452,1901,10,N,N,-,-1,-1
OUSELEY.txt,309724,311496,1772,10,N,N,-,-1,-1
OUSELEY.txt,309797,311562,1765,10,N,N,-,-1,-1
OUSELEY.txt,309862,311598,1736,10,N,N,-,-1,-1
OUSELEY.txt,310028,311652,1624,10,N,N,-,-1,-1
OUSELEY.txt,310068,311763,1695,10,N,N,-,-1,-1
OUSELEY.txt,310100,311789,1689,10,N,N,-,-1,-1
OUSELEY.txt,310617,311800,1183,10,N,N,-,-1,-1
OUSELEY.txt,310824,311875,1051,10,N,N,-,-1,-1
OUSELEY.txt,310962,311954,992,10,N,N,-,-1,-1
OUSELEY.txt,311454,312020,566,10,N,N,-,-1,-1
OUSELEY.txt,311502,312068,566,10,N,N,-,-1,-1
OUSELEY.txt,311567,312102,535,10,N,N,-,-1,-1
OUSELEY.txt,311601,312180,579,10,N,N,-,-1,-1
OUSELEY.txt,311655,312269,614,10,N,N,-,-1,-1
OUSELEY.txt,311766,312308,542,10,N,N,-,-1,-1
OUSELEY.txt,311790,312360,570,10,N,N,-,-1,-1
OUSELEY.txt,311803,312442,639,10,N,N,-,-1,-1
OUSELEY.txt,311878,312497,619,10,N,N,-,-1,-1
OUSELEY.txt,311957,312547,590,10,N,N,-,-1,-1
OUSELEY.txt,312023,312615,592,10,N,N,-,-1,-1
OUSELEY.txt,312071,312665,594,10,N,N,-,-1,-1
OUSELEY.txt,312105,312729,624,10,N,N,-,-1,-1
OUSELEY.txt,312183,312788,605,10,N,N,-,-1,-1
OUSELEY.txt,312272,312840,568,10,N,N,-,-1,-1
OUSELEY.txt,312311,312899,588,10,N,N,-,-1,-1
OUSELEY.txt,312363,312943,580,10,N,N,-,-1,-1
OUSELEY.txt,312445,313010,565,10,N,N,-,-1,-1
OUSELEY.txt,312500,313051,551,10,N,N,-,-1,-1
PILGRIM.txt,0,899,899,10,N,N,-,-1,-1
PILGRIM.txt,24,1049,1025,10,N,N,-,-1,-1
PILGRIM.txt,51,1117,1066,10,N,N,-,-1,-1
PILGRIM.txt,52,1230,1178,10,N,N,-,-1,-1
PILGRIM.txt,73,1356,1283,10,N,N,-,-1,-1
PILGRIM.txt,86,1366,1280,10,N,N,-,-1,-1
PILGRIM.txt,203,1438,1235,10,N,N,-,-1,-1
PILGRIM.txt,340,1493,1153,10,N,N,-,-1,-1
PILGRIM.txt,390,1640,1250,10,N,N,-,-1,-1
PILGRIM.txt,780,1700,920,10,N,N,-,-1,-1
PILGRIM.txt,901,1873,972,10,N,N,-,-1,-1
PILGRIM.txt,1052,2012,960,10,N,N,-,-1,-1
PILGRIM.txt,1118,2064,946,10,N,N,-,-1,-1
PILGRIM.txt,1231,2130,899,10,N,N,-,-1,-1
PILGRIM.txt,1357,2139,782,10,N,N,-,-1,-1
PILGRIM.txt,1369,2170,801,10,N,N,-,-1,-1
PILGRIM.txt,1439,2178,739,10,N,N,-,-1,-1
PILGRIM.txt,1494,2201,707,10,N,N,-,-1,-1
PILGRIM.txt,1643,2210,567,10,N,N,-,-1,-1
PILGRIM.txt,1701,2326,625,10,N,N,-,-1,-1
PILGRIM.txt,1874,2348,474,10,N,N,-,-1,-1
PILGRIM.txt,2013,2352,339,10,N,N,-,-1,-1
PILGRIM.txt,2065,2787,722,10,N,N,-,-1,-1
PILGRIM.txt,2133,2818,685,10,N,N,-,-1,-1
PILGRIM.txt,2140,3184,1044,10,N,N,-,-1,-1
PILGRIM.txt,2172,3316,1144,10,N,N,-,-1,-1
PILGRIM.txt,2179,3528,1349,10,N,N,-,-1,-1
PILGRIM.txt,2204,3594,1390,10,N,N,-,-1,-1
PILGRIM.txt,2211,3706,1495,10,N,N,-,-1,-1
PILGRIM.txt,2329,3869,1540,10,N,N,-,-1,-1
PILGRIM.txt,2348,3998,1650,10,N,N,-,-1,-1
PILGRIM.txt,2358,4153,1795,10,N,N,-,-1,-1
PILGRIM.txt,2790,4326,1536,10,N,N,-,-1,-1
PILGRIM.txt,2826,4463,1637,10,N,N,-,-1,-1
PILGRIM.txt,3186,4634,1448,10,N,N,-,-1,-1
PILGRIM.txt,3317,5011,1694,10,N,N,-,-1,-1
PILGRIM.txt,3529,5113,1584,10,N,N,-,-1,-1
PILGRIM.txt,3595,5332,1737,10,N,N,-,-1,-1
PILGRIM.txt,3707,5423,1716,10,N,N,-,-1,-1
PILGRIM.txt,3870,5586,1716,10,N,N,-,-1,-1
PILGRIM.txt,3999,5712,1713,10,N,N,-,-1,-1
PILGRIM.txt,4154,5781,1627,10,N,N,-,-1,-1
PILGRIM.txt,4327,5867,1540,10,N,N,-,-1,-1
PILGRIM.txt,4464,6008,1544,10,N,N,-,-1,-1
PILGRIM.txt,4635,6047,1412,10,N,N,-,-1,-1
PILGRIM.txt,5012,6350,1338,10,N,N,-,-1,-1
PILGRIM.txt,5114,6364,1250,10,N,N,-,-1,-1
PILGRIM.txt,5335,6590,1255,10,N,N,-,-1,-1
PILGRIM.txt,5424,6808,1384,10,N,N,-,-1,-1
PILGRIM.txt,5588,7165,1577,10,N,N,-,-1,-1
PILGRIM.txt,5713,7179,1466,10,N,N,-,-1,-1
PILGRIM.txt,5782,7483,1701,10,N,N,-,-1,-1
PILGRIM.txt,5868,7735,1867,10,N,N,-,-1,-1
PILGRIM.txt,6011,7740,1729,10,N,N,-,-1,-1
PILGRIM.txt,6052,7975,1923,10,N,N,-,-1,-1
PILGRIM.txt,6353,8024,1671,10,N,N,-,-1,-1
PILGRIM.txt,6365,8339,1974,10,N,N,-,-1,-1
PILGRIM.txt,6591,8568,1977,10,N,N,-,-1,-1
PILGRIM.txt,6811,8583,1772,10,N,N,-,-1,-1
PILGRIM.txt,7168,8965,1797,10,N,N,-,-1,-1
PILGRIM.txt,7180,8981,1801,10,N,N,-,-1,-1
PILGRIM.txt,7486,9188,1702,10,N,N,-,-1,-1
PILGRIM.txt,7736,9293,1557,10,N,N,-,-1,-1
PILGRIM.txt,7741,9327,1586,10,N,N,-,-1,-1
PILGRIM.txt,7980,9526,1546,10,N,N,-,-1,-1
PILGRIM.txt,8025,9807,1782,10,N,N,-,-1,-1
PILGRIM.txt,8339,9821,1482,10,N,N,-,-1,-1
PILGRIM.txt,8571,10129,1558,10,N,N,-,-1,-1
PILGRIM.txt,8584,10402,1818,10,N,N,-,-1,-1
PILGRIM.txt,8968,10441,1473,10,N,N,-,-1,-1
PILGRIM.txt,8982,10734,1752,10,N,N,-,-1,-1
PILGRIM.txt,9191,10802,1611,10,N,N,-,-1,-1
PILGRIM.txt,9294,11050,1756,10,N,N,-,-1,-1
PILGRIM.txt,9329,11426,2097,10,N,N,-,-1,-1
PILGRIM.txt,9529,11568,2039,10,N,N,-,-1,-1
PILGRIM.txt,9810,11714,1904,10,N,N,-,-1,-1
PILGRIM.txt,9822,12006,2184,10,N,N,-,-1,-1
PILGRIM.txt,10132,12062,1930,10,N,N,-,-1,-1
PILGRIM.txt,10407,12301,1894,10,N,N,-,-1,-1
PILGRIM.txt,10442,12595,2153,10,N,N,-,-1,-1
PILGRIM.txt,10737,12925,2188,10,N,N,-,-1,-1
PILGRIM.txt,10803,13222,2419,10,N,N,-,-1,-1
PILGRIM.txt,11053,13553,2500,10,N,N,-,-1,-1
PILGRIM.txt,11429,13891,2462,10,N,N,-,-1,-1
PILGRIM.txt,11570,14132,2562,10,N,N,-,-1,-1
PILGRIM.txt,11717,14295,2578,10,N,N,-,-1,-1
PILGRIM.txt,12009,14560,2551,10,N,N,-,-1,-1
PILGRIM.txt,12063,14892,2829,10,N,N,-,-1,-1
PILGRIM.txt,12304,15240,2936,10,N,N,-,-1,-1
PILGRIM.txt,12600,15256,2656,10,N,N,-,-1,-1
PILGRIM.txt,12928,15542,2614,10,N,N,-,-1,-1
PILGRIM.txt,13225,15557,2332,10,N,N,-,-1,-1
PILGRIM.txt,13556,15822,2266,10,N,N,-,-1,-1
PILGRIM.txt,13894,15981,2087,10,N,N,-,-1,-1
PILGRIM.txt,14135,16548,2413,10,N,N,-,-1,-1
PILGRIM.txt,14298,16741,2443,10,N,N,-,-1,-1
PILGRIM.txt,14563,18230,3667,10,N,N,-,-1,-1
PILGRIM.txt,14897,18276,3379,10,N,N,-,-1,-1
PILGRIM.txt,15243,18321,3078,10,N,N,-,-1,-1
PILGRIM.txt,15257,18610,3353,10,N,N,-,-1,-1
PILGRIM.txt,15545,18630,3085,10,N,N,-,-1,-1
PILGRIM.txt,15558,18725,3167,10,N,N,-,-1,-1
PILGRIM.txt,15825,18870,3045,10,N,N,-,-1,-1
PILGRIM.txt,15984,18964,2980,10,N,N,-,-1,-1
PILGRIM.txt,16553,19088,2535,10,N,N,-,-1,-1
PILGRIM.txt,16744,19274,2530,10,N,N,-,-1,-1
PILGRIM.txt,18233,19374,1141,10,N,N,-,-1,-1
PILGRIM.txt,18278,19570,1292,10,N,N,-,-1,-1
PILGRIM.txt,18326,19860,1534,10,N,N,-,-1,-1
PILGRIM.txt,18611,20075,1464,10,N,N,-,-1,-1
PILGRIM.txt,18633,20292,1659,10,N,N,-,-1,-1
PILGRIM.txt,18726,20398,1672,10,N,N,-,-1,-1
PILGRIM.txt,18871,20652,1781,10,N,N,-,-1,-1
PILGRIM.txt,18965,20847,1882,10,N,N,-,-1,-1
PILGRIM.txt,19089,21013,1924,10,N,N,-,-1,-1
PILGRIM.txt,19275,21481,2206,10,N,N,-,-1,-1
PILGRIM.txt,19375,21734,2359,10,N,N,-,-1,-1
PILGRIM.txt,19575,21781,2206,10,N,N,-,-1,-1
PILGRIM.txt,19861,21874,2013,10,N,N,-,-1,-1
PILGRIM.txt,20076,22007,1931,10,N,N,-,-1,-1
PILGRIM.txt,20295,22074,1779,10,N,N,-,-1,-1
PILGRIM.txt,20400,22327,1927,10,N,N,-,-1,-1
PILGRIM.txt,20655,22406,1751,10,N,N,-,-1,-1
PILGRIM.txt,20848,22507,1659,10,N,N,-,-1,-1
PILGRIM.txt,21013,22633,1620,10,Y,N,-,-1,-1
PILGRIM.txt,21482,22764,1282,10,Y,N,-,-1,-1
PILGRIM.txt,21739,22866,1127,10,Y,N,-,-1,-1
PILGRIM.txt,21782,22923,1141,10,Y,N,-,-1,-1
PILGRIM.txt,21875,23140,1265,10,N,N,-,-1,-1
PILGRIM.txt,22008,23205,1197,10,N,N,-,-1,-1
PILGRIM.txt,22075,23276,1201,10,N,N,-,-1,-1
PILGRIM.txt,22330,23371,1041,10,N,N,-,-1,-1
PILGRIM.txt,22407,23543,1136,10,N,N,-,-1,-1
PILGRIM.txt,22508,23615,1107,10,N,N,-,-1,-1
PILGRIM.txt,22635,23846,1211,10,N,N,-,-1,-1
PILGRIM.txt,22765,23903,1138,10,N,N,-,-1,-1
PILGRIM.txt,22867,24063,1196,10,N,N,-,-1,-1
PILGRIM.txt,22924,24317,1393,10,N,N,-,-1,-1
PILGRIM.txt,23141,24496,1355,10,N,N,-,-1,-1
PILGRIM.txt,23206,24635,1429,10,N,N,-,-1,-1
PILGRIM.txt,23279,24751,1472,10,N,N,-,-1,-1
PILGRIM.txt,23372,24937,1565,10,N,N,-,-1,-1
PILGRIM.txt,23544,25111,1567,10,N,N,-,-1,-1
PILGRIM.txt,23616,25298,1682,10,N,N,-,-1,-1
PILGRIM.txt,23847,25387,1540,10,N,N,-,-1,-1
PILGRIM.txt,23904,25471,1567,10,N,N,-,-1,-1
PILGRIM.txt,24064,25764,1700,10,N,N,-,-1,-1
PILGRIM.txt,24318,25817,1499,10,N,N,-,-1,-1
PILGRIM.txt,24499,25954,1455,10,N,N,-,-1,-1
PILGRIM.txt,24636,26122,1486,10,N,N,-,-1,-1
PILGRIM.txt,24752,26233,1481,10,N,N,-,-1,-1
PILGRIM.txt,24939,26381,1442,10,N,N,-,-1,-1
PILGRIM.txt,25112,26573,1461,10,N,N,-,-1,-1
PILGRIM.txt,25299,26678,1379,10,N,N,-,-1,-1
PILGRIM.txt,25388,26796,1408,10,N,N,-,-1,-1
PILGRIM.txt,25473,26968,1495,10,N,N,-,-1,-1
PILGRIM.txt,25767,27141,1374,10,N,N,-,-1,-1
PILGRIM.txt,25819,27622,1803,10,N,N,-,-1,-1
PILGRIM.txt,25955,27840,1885,10,N,N,-,-1,-1
PILGRIM.txt,26123,27962,1839,10,N,N,-,-1,-1
PILGRIM.txt,26234,28187,1953,10,N,N,-,-1,-1
PILGRIM.txt,26382,28379,1997,10,N,N,-,-1,-1
PILGRIM.txt,26574,28522,1948,10,N,N,-,-1,-1
PILGRIM.txt,26679,28818,2139,10,N,N,-,-1,-1
PILGRIM.txt,26797,28929,2132,10,N,N,-,-1,-1
PILGRIM.txt,26971,29116,2145,10,N,N,-,-1,-1
PILGRIM.txt,27142,29210,2068,10,N,N,-,-1,-1
PILGRIM.txt,27623,29263,1640,10,N,N,-,-1,-1
PILGRIM.txt,27841,29372,1531,10,N,N,-,-1,-1
PILGRIM.txt,27963,29722,1759,10,N,N,-,-1,-1
PILGRIM.txt,28190,29828,1638,10,N,N,-,-1,-1
PILGRIM.txt,28380,29881,1501,10,N,N,-,-1,-1
PILGRIM.txt,28525,29984,1459,10,N,N,-,-1,-1
PILGRIM.txt,28818,30100,1282,10,N,N,-,-1,-1
PILGRIM.txt,28930,30218,1288,10,N,N,-,-1,-1
PILGRIM.txt,29117,30500,1383,10,N,N,-,-1,-1
PILGRIM.txt,29211,30594,1383,10,N,N,-,-1,-1
PILGRIM.txt,29264,30688,1424,10,N,N,-,-1,-1
PILGRIM.txt,29377,30843,1466,10,N,N,-,-1,-1
PILGRIM.txt,29723,31034,1311,10,N,N,-,-1,-1
PILGRIM.txt,29829,31161,1332,10,N,N,-,-1,-1
PILGRIM.txt,29882,31248,1366,10,N,N,-,-1,-1
PILGRIM.txt,29985,31374,1389,10,N,N,-,-1,-1
PILGRIM.txt,30101,31487,1386,10,N,N,-,-1,-1
PILGRIM.txt,30219,31622,1403,10,N,N,-,-1,-1
PILGRIM.txt,30502,31684,1182,10,N,N,-,-1,-1
PILGRIM.txt,30595,31872,1277,10,N,N,-,-1,-1
PILGRIM.txt,30689,32036,1347,10,N,N,-,-1,-1
PILGRIM.txt,30844,32125,1281,10,N,N,-,-1,-1
PILGRIM.txt,31035,32224,1189,10,N,N,-,-1,-1
PILGRIM.txt,31162,32271,1109,10,N,N,-,-1,-1
PILGRIM.txt,31249,32399,1150,10,N,N,-,-1,-1
PILGRIM.txt,31379,32605,1226,10,N,N,-,-1,-1
PILGRIM.txt,31488,32696,1208,10,N,N,-,-1,-1
PILGRIM.txt,31624,32891,1267,10,N,N,-,-1,-1
PILGRIM.txt,31685,33067,1382,10,N,N,-,-1,-1
PILGRIM.txt,31873,33138,1265,10,N,N,-,-1,-1
PILGRIM.txt,32037,33266,1229,10,N,N,-,-1,-1
PILGRIM.txt,32126,33686,1560,10,N,N,-,-1,-1
PILGRIM.txt,32225,33729,1504,10,N,N,-,-1,-1
PILGRIM.txt,32272,33952,1680,10,N,N,-,-1,-1
PILGRIM.txt,32400,34140,1740,10,N,N,-,-1,-1
PILGRIM.txt,32606,34220,1614,10,N,N,-,-1,-1
PILGRIM.txt,32697,34396,1699,10,N,N,-,-1,-1
PILGRIM.txt,32894,34679,1785,10,N,N,-,-1,-1
PILGRIM.txt,33068,34737,1669,10,N,N,-,-1,-1
PILGRIM.txt,33139,34973,1834,10,N,N,-,-1,-1
PILGRIM.txt,33267,35281,2014,10,N,N,-,-1,-1
PILGRIM.txt,33689,35410,1721,10,N,N,-,-1,-1
PILGRIM.txt,33730,35575,1845,10,N,N,-,-1,-1
PILGRIM.txt,33954,35681,1727,10,N,N,-,-1,-1
PILGRIM.txt,34143,35750,1607,10,N,N,-,-1,-1
PILGRIM.txt,34221,35920,1699,10,N,N,-,-1,-1
PILGRIM.txt,34398,36013,1615,10,N,N,-,-1,-1
PILGRIM.txt,34681,36051,1370,10,N,N,-,-1,-1
PILGRIM.txt,34739,36148,1409,10,N,N,-,-1,-1
PILGRIM.txt,34974,36273,1299,10,N,N,-,-1,-1
PILGRIM.txt,35282,36413,1131,10,N,N,-,-1,-1
PILGRIM.txt,35411,36501,1090,10,N,N,-,-1,-1
PILGRIM.txt,35578,36549,971,10,N,N,-,-1,-1
PILGRIM.txt,35683,36689,1006,10,N,N,-,-1,-1
PILGRIM.txt,35751,36943,1192,10,N,N,-,-1,-1
PILGRIM.txt,35921,37097,1176,10,N,N,-,-1,-1
PILGRIM.txt,36014,37266,1252,10,N,N,-,-1,-1
PILGRIM.txt,36052,37331,1279,10,Y,N,-,-1,-1
PILGRIM.txt,36151,37462,1311,10,N,N,-,-1,-1
PILGRIM.txt,36274,37634,1360,10,N,N,-,-1,-1
PILGRIM.txt,36414,37716,1302,10,N,N,-,-1,-1
PILGRIM.txt,36502,37773,1271,10,N,N,-,-1,-1
PILGRIM.txt,36552,37886,1334,10,N,N,-,-1,-1
PILGRIM.txt,36690,37937,1247,10,Y,N,-,-1,-1
PILGRIM.txt,36944,37970,1026,10,Y,N,-,-1,-1
PILGRIM.txt,37098,38109,1011,10,Y,N,-,-1,-1
PILGRIM.txt,37267,38226,959,10,Y,N,-,-1,-1
PILGRIM.txt,37332,38268,936,10,Y,N,-,-1,-1
PILGRIM.txt,37463,38456,993,10,N,N,-,-1,-1
PILGRIM.txt,37635,38545,910,10,N,N,-,-1,-1
PILGRIM.txt,37717,38703,986,10,Y,N,-,-1,-1
PILGRIM.txt,37774,38835,1061,10,Y,N,-,-1,-1
PILGRIM.txt,37887,38899,1012,10,Y,N,-,-1,-1
PILGRIM.txt,37940,39056,1116,10,Y,N,-,-1,-1
PILGRIM.txt,37971,39186,1215,10,Y,N,-,-1,-1
PILGRIM.txt,38110,39246,1136,10,Y,N,-,-1,-1
PILGRIM.txt,38227,39411,1184,10,Y,N,-,-1,-1
PILGRIM.txt,38269,39534,1265,10,Y,N,-,-1,-1
PILGRIM.txt,38459,39837,1378,10,Y,N,-,-1,-1
PILGRIM.txt,38546,40011,1465,10,Y,N,-,-1,-1
PILGRIM.txt,38704,40086,1382,10,Y,N,-,-1,-1
PILGRIM.txt,38838,40187,1349,10,N,N,-,-1,-1
PILGRIM.txt,38900,40357,1457,10,N,N,-,-1,-1
PILGRIM.txt,39057,40501,1444,10,N,N,-,-1,-1
PILGRIM.txt,39187,40578,1391,10,N,N,-,-1,-1
PILGRIM.txt,39248,40818,1570,10,N,N,-,-1,-1
PILGRIM.txt,39413,40996,1583,10,N,N,-,-1,-1
PILGRIM.txt,39535,41148,1613,10,N,N,-,-1,-1
PILGRIM.txt,39839,41311,1472,10,N,N,-,-1,-1
PILGRIM.txt,40012,41474,1462,10,N,N,-,-1,-1
PILGRIM.txt,40087,41548,1461,10,N,N,-,-1,-1
PILGRIM.txt,40188,41655,1467,10,Y,N,-,-1,-1
PILGRIM.txt,40358,41777,1419,10,Y,N,-,-1,-1
PILGRIM.txt,40502,41956,1454,10,Y,N,-,-1,-1
PILGRIM.txt,40579,42044,1465,10,Y,N,-,-1,-1
PILGRIM.txt,40821,42136,1315,10,Y,N,-,-1,-1
PILGRIM.txt,40997,42250,1253,10,Y,N,-,-1,-1
PILGRIM.txt,41149,42405,1256,10,Y,N,-,-1,-1
PILGRIM.txt,41312,42530,1218,10,Y,N,-,-1,-1
PILGRIM.txt,41475,42611,1136,10,N,N,-,-1,-1
PILGRIM.txt,41550,42737,1187,10,N,N,-,-1,-1
PILGRIM.txt,41657,42827,1170,10,N,N,-,-1,-1
PILGRIM.txt,41778,42875,1097,10,N,N,-,-1,-1
PILGRIM.txt,41957,42966,1009,10,N,N,-,-1,-1
PILGRIM.txt,42045,43213,1168,10,N,N,-,-1,-1
PILGRIM.txt,42138,43340,1202,10,N,N,-,-1,-1
PILGRIM.txt,42252,43492,1240,10,N,N,-,-1,-1
PILGRIM.txt,42406,43595,1189,10,N,N,-,-1,-1
PILGRIM.txt,42531,43685,1154,10,N,N,-,-1,-1
PILGRIM.txt,42612,43711,1099,10,N,N,-,-1,-1
PILGRIM.txt,42740,43924,1184,10,N,N,-,-1,-1
PILGRIM.txt,42828,44074,1246,10,N,N,-,-1,-1
PILGRIM.txt,42876,44156,1280,10,N,N,-,-1,-1
PILGRIM.txt,42967,44278,1311,10,N,N,-,-1,-1
PILGRIM.txt,43214,44382,1168,10,N,N,-,-1,-1
PILGRIM.txt,43343,44407,1064,10,N,N,-,-1,-1
PILGRIM.txt,43493,44582,1089,10,N,N,-,-1,-1
PILGRIM.txt,43595,44805,1210,10,N,N,-,-1,-1
PILGRIM.txt,43686,44903,1217,10,N,N,-,-1,-1
PILGRIM.txt,43712,45067,1355,10,N,N,-,-1,-1
PILGRIM.txt,43925,45253,1328,10,N,N,-,-1,-1
PILGRIM.txt,44076,45480,1404,10,Y,N,-,-1,-1
PILGRIM.txt,44157,45701,1544,10,Y,N,-,-1,-1
PILGRIM.txt,44279,45811,1532,10,Y,N,-,-1,-1
PILGRIM.txt,44385,45891,1506,10,Y,N,-,-1,-1
PILGRIM.txt,44408,46016,1608,10,Y,N,-,-1,-1
PILGRIM.txt,44585,46102,1517,10,N,N,-,-1,-1
PILGRIM.txt,44806,46239,1433,10,N,N,-,-1,-1
PILGRIM.txt,44908,46317,1409,10,N,N,-,-1,-1
PILGRIM.txt,45068,46442,1374,10,N,N,-,-1,-1
PILGRIM.txt,45254,46556,1302,10,N,N,-,-1,-1
PILGRIM.txt,45483,46582,1099,10,N,N,-,-1,-1
PILGRIM.txt,45702,46774,1072,10,N,N,-,-1,-1
PILGRIM.txt,45812,46908,1096,10,N,N,-,-1,-1
PILGRIM.txt,45892,46946,1054,10,N,N,-,-1,-1
PILGRIM.txt,46019,47105,1086,10,N,N,-,-1,-1
PILGRIM.txt,46103,47212,1109,10,N,N,-,-1,-1
PILGRIM.txt,46240,47330,1090,10,N,N,-,-1,-1
PILGRIM.txt,46318,47588,1270,10,N,N,-,-1,-1
PILGRIM.txt,46443,47770,1327,10,N,N,-,-1,-1
PILGRIM.txt,46557,48045,1488,10,N,N,-,-1,-1
PILGRIM.txt,46585,48256,1671,10,N,N,-,-1,-1
PILGRIM.txt,46775,48401,1626,10,N,N,-,-1,-1
PILGRIM.txt,46909,48633,1724,10,N,N,-,-1,-1
PILGRIM.txt,46951,48788,1837,10,N,N,-,-1,-1
PILGRIM.txt,47106,48893,1787,10,N,N,-,-1,-1
PILGRIM.txt,47213,48920,1707,10,N,N,-,-1,-1
PILGRIM.txt,47333,48960,1627,10,N,N,-,-1,-1
PILGRIM.txt,47589,49016,1427,10,N,N,-,-1,-1
PILGRIM.txt,47771,49033,1262,10,N,N,-,-1,-1
PILGRIM.txt,48048,49070,1022,10,N,N,-,-1,-1
PILGRIM.txt,48259,49170,911,10,N,N,-,-1,-1
PILGRIM.txt,48402,49304,902,10,N,N,-,-1,-1
PILGRIM.txt,48635,49449,814,10,N,N,-,-1,-1
PILGRIM.txt,48790,49576,786,10,N,N,-,-1,-1
PILGRIM.txt,48894,49671,777,10,N,N,-,-1,-1
PILGRIM.txt,48926,49812,886,10,N,N,-,-1,-1
PILGRIM.txt,48965,49964,999,10,N,N,-,-1,-1
PILGRIM.txt,49021,49980,959,10,N,N,-,-1,-1
PILGRIM.txt,49034,50203,1169,10,N,N,-,-1,-1
PILGRIM.txt,49071,50424,1353,10,N,N,-,-1,-1
PILGRIM.txt,49171,50562,1391,10,N,Y,1437490253936,460795,462238
PILGRIM.txt,49305,50690,1385,10,N,Y,1437490253936,460795,462238
PILGRIM.txt,49450,50805,1355,10,N,Y,1437490253936,460795,462238
PILGRIM.txt,49577,50999,1422,10,N,Y,1437490253936,460795,462238
PILGRIM.txt,49672,51088,1416,10,N,Y,1437490253936,460795,462238
PILGRIM.txt,49814,51226,1412,10,N,Y,1437490253936,460795,462238
PILGRIM.txt,49969,51374,1405,10,N,Y,1437490253936,460795,462238
PILGRIM.txt,49983,51605,1622,10,N,Y,1437490253936,460795,462238
PILGRIM.txt,50204,51659,1455,10,N,Y,1437490253936,460795,462238
PILGRIM.txt,50427,51714,1287,10,N,Y,1437490253936,460795,462238
PILGRIM.txt,50563,51769,1206,10,N,Y,1437490253936,460795,462238
PILGRIM.txt,50691,51935,1244,10,Y,Y,1437490253936,460795,462238
PILGRIM.txt,50806,52022,1216,10,N,Y,1437490253936,460795,462238
PILGRIM.txt,51000,52125,1125,10,N,N,-,-1,-1
PILGRIM.txt,51089,52246,1157,10,N,N,-,-1,-1
PILGRIM.txt,51228,52416,1188,10,N,N,-,-1,-1
PILGRIM.txt,51375,52440,1065,10,N,N,-,-1,-1
PILGRIM.txt,51606,52606,1000,10,N,N,-,-1,-1
PILGRIM.txt,51660,52698,1038,10,N,N,-,-1,-1
PILGRIM.txt,51715,52828,1113,10,N,N,-,-1,-1
PILGRIM.txt,51770,52930,1160,10,N,N,-,-1,-1
PILGRIM.txt,51936,53123,1187,10,N,N,-,-1,-1
PILGRIM.txt,52025,53225,1200,10,N,N,-,-1,-1
PILGRIM.txt,52126,53351,1225,10,N,N,-,-1,-1
PILGRIM.txt,52247,53443,1196,10,N,N,-,-1,-1
PILGRIM.txt,52417,53583,1166,10,N,N,-,-1,-1
PILGRIM.txt,52442,53785,1343,10,N,N,-,-1,-1
PILGRIM.txt,52607,53858,1251,10,N,N,-,-1,-1
PILGRIM.txt,52699,53986,1287,10,N,N,-,-1,-1
PILGRIM.txt,52829,54068,1239,10,N,N,-,-1,-1
PILGRIM.txt,52931,54168,1237,10,N,N,-,-1,-1
PILGRIM.txt,53126,54355,1229,10,N,N,-,-1,-1
PILGRIM.txt,53226,54478,1252,10,N,N,-,-1,-1
PILGRIM.txt,53352,54551,1199,10,N,N,-,-1,-1
PILGRIM.txt,53444,54810,1366,10,N,N,-,-1,-1
PILGRIM.txt,53584,54906,1322,10,N,N,-,-1,-1
PILGRIM.txt,53786,54946,1160,10,N,N,-,-1,-1
PILGRIM.txt,53859,55042,1183,10,N,N,-,-1,-1
PILGRIM.txt,53987,55310,1323,10,N,N,-,-1,-1
PILGRIM.txt,54069,55481,1412,10,N,N,-,-1,-1
PILGRIM.txt,54169,55669,1500,10,N,N,-,-1,-1
PILGRIM.txt,54356,55796,1440,10,N,N,-,-1,-1
PILGRIM.txt,54479,55873,1394,10,N,N,-,-1,-1
PILGRIM.txt,54552,56122,1570,10,N,N,-,-1,-1
PILGRIM.txt,54813,56262,1449,10,N,N,-,-1,-1
PILGRIM.txt,54907,56447,1540,10,N,N,-,-1,-1
PILGRIM.txt,54947,56499,1552,10,N,N,-,-1,-1
PILGRIM.txt,55043,56749,1706,10,N,N,-,-1,-1
PILGRIM.txt,55311,56844,1533,10,N,N,-,-1,-1
PILGRIM.txt,55482,56983,1501,10,N,N,-,-1,-1
PILGRIM.txt,55670,57220,1550,10,N,N,-,-1,-1
PILGRIM.txt,55797,57319,1522,10,N,N,-,-1,-1
PILGRIM.txt,55875,57583,1708,10,N,N,-,-1,-1
PILGRIM.txt,56125,57695,1570,10,N,N,-,-1,-1
PILGRIM.txt,56263,57829,1566,10,N,N,-,-1,-1
PILGRIM.txt,56448,57897,1449,10,N,N,-,-1,-1
PILGRIM.txt,56500,57965,1465,10,N,N,-,-1,-1
PILGRIM.txt,56751,58112,1361,10,N,N,-,-1,-1
PILGRIM.txt,56845,58415,1570,10,N,N,-,-1,-1
PILGRIM.txt,56986,58560,1574,10,N,N,-,-1,-1
PILGRIM.txt,57222,58651,1429,10,N,N,-,-1,-1
PILGRIM.txt,57321,58796,1475,10,N,N,-,-1,-1
PILGRIM.txt,57584,58947,1363,10,N,N,-,-1,-1
PILGRIM.txt,57696,59056,1360,10,N,N,-,-1,-1
PILGRIM.txt,57830,59258,1428,10,N,N,-,-1,-1
PILGRIM.txt,57898,59367,1469,10,N,N,-,-1,-1
PILGRIM.txt,57967,59424,1457,10,N,N,-,-1,-1
PILGRIM.txt,58113,59507,1394,10,N,N,-,-1,-1
PILGRIM.txt,58417,59582,1165,10,N,N,-,-1,-1
PILGRIM.txt,58561,59698,1137,10,N,N,-,-1,-1
PILGRIM.txt,58652,59785,1133,10,N,N,-,-1,-1
PILGRIM.txt,58797,59896,1099,10,N,N,-,-1,-1
PILGRIM.txt,58948,60062,1114,10,N,N,-,-1,-1
PILGRIM.txt,59061,60185,1124,10,N,N,-,-1,-1
PILGRIM.txt,59259,60245,986,10,N,N,-,-1,-1
PILGRIM.txt,59368,60358,990,10,N,N,-,-1,-1
PILGRIM.txt,59425,60430,1005,10,N,N,-,-1,-1
PILGRIM.txt,59508,60579,1071,10,N,N,-,-1,-1
PILGRIM.txt,59585,60722,1137,10,N,N,-,-1,-1
PILGRIM.txt,59699,60834,1135,10,N,N,-,-1,-1
PILGRIM.txt,59786,61019,1233,10,N,N,-,-1,-1
PILGRIM.txt,59897,61232,1335,10,N,N,-,-1,-1
PILGRIM.txt,60063,61328,1265,10,N,N,-,-1,-1
PILGRIM.txt,60186,61374,1188,10,N,N,-,-1,-1
PILGRIM.txt,60246,61473,1227,10,N,N,-,-1,-1
PILGRIM.txt,60359,61527,1168,10,N,N,-,-1,-1
PILGRIM.txt,60432,61725,1293,10,N,N,-,-1,-1
PILGRIM.txt,60580,61786,1206,10,N,N,-,-1,-1
PILGRIM.txt,60723,61850,1127,10,N,N,-,-1,-1
PILGRIM.txt,60835,61875,1040,10,N,N,-,-1,-1
PILGRIM.txt,61020,61956,936,10,N,N,-,-1,-1
PILGRIM.txt,61233,62096,863,10,N,N,-,-1,-1
PILGRIM.txt,61331,62329,998,10,N,N,-,-1,-1
PILGRIM.txt,61375,62483,1108,10,N,N,-,-1,-1
PILGRIM.txt,61474,62680,1206,10,N,N,-,-1,-1
PILGRIM.txt,61528,62893,1365,10,N,N,-,-1,-1
PILGRIM.txt,61726,63064,1338,10,N,N,-,-1,-1
PILGRIM.txt,61787,63228,1441,10,N,N,-,-1,-1
PILGRIM.txt,61851,63327,1476,10,N,N,-,-1,-1
PILGRIM.txt,61878,63524,1646,10,N,N,-,-1,-1
PILGRIM.txt,61957,63907,1950,10,N,N,-,-1,-1
PILGRIM.txt,62099,64062,1963,10,Y,N,-,-1,-1
PILGRIM.txt,62332,64265,1933,10,Y,N,-,-1,-1
PILGRIM.txt,62484,64398,1914,10,Y,N,-,-1,-1
PILGRIM.txt,62681,64649,1968,10,Y,N,-,-1,-1
PILGRIM.txt,62895,64692,1797,10,Y,N,-,-1,-1
PILGRIM.txt,63066,64855,1789,10,Y,N,-,-1,-1
PILGRIM.txt,63231,64930,1699,10,Y,N,-,-1,-1
PILGRIM.txt,63328,65000,1672,10,Y,N,-,-1,-1
PILGRIM.txt,63525,65068,1543,10,Y,N,-,-1,-1
PILGRIM.txt,63908,65123,1215,10,Y,N,-,-1,-1
PILGRIM.txt,64063,65404,1341,10,Y,N,-,-1,-1
PILGRIM.txt,64268,65494,1226,10,N,N,-,-1,-1
PILGRIM.txt,64399,65575,1176,10,N,N,-,-1,-1
PILGRIM.txt,64650,65668,1018,10,N,N,-,-1,-1
PILGRIM.txt,64693,65772,1079,10,N,N,-,-1,-1
PILGRIM.txt,64856,65987,1131,10,N,N,-,-1,-1
PILGRIM.txt,64931,66105,1174,10,N,N,-,-1,-1
PILGRIM.txt,65001,66235,1234,10,N,N,-,-1,-1
PILGRIM.txt,65071,66322,1251,10,N,N,-,-1,-1
PILGRIM.txt,65125,66506,1381,10,N,N,-,-1,-1
PILGRIM.txt,65405,66511,1106,10,N,N,-,-1,-1
PILGRIM.txt,65499,66599,1100,10,N,N,-,-1,-1
PILGRIM.txt,65576,66654,1078,10,N,N,-,-1,-1
PILGRIM.txt,65669,66793,1124,10,N,N,-,-1,-1
PILGRIM.txt,65773,66824,1051,10,N,N,-,-1,-1
PILGRIM.txt,65988,67002,1014,10,N,N,-,-1,-1
PILGRIM.txt,66106,67292,1186,10,N,N,-,-1,-1
PILGRIM.txt,66236,67416,1180,10,N,N,-,-1,-1
PILGRIM.txt,66323,67519,1196,10,N,N,-,-1,-1
PILGRIM.txt,66507,67634,1127,10,N,N,-,-1,-1
PILGRIM.txt,66512,67848,1336,10,N,N,-,-1,-1
PILGRIM.txt,66600,67901,1301,10,N,N,-,-1,-1
PILGRIM.txt,66655,67984,1329,10,N,N,-,-1,-1
PILGRIM.txt,66793,68033,1240,10,N,N,-,-1,-1
PILGRIM.txt,66829,68125,1296,10,N,N,-,-1,-1
PILGRIM.txt,67005,68189,1184,10,N,N,-,-1,-1
PILGRIM.txt,67295,68288,993,10,N,N,-,-1,-1
PILGRIM.txt,67417,68360,943,10,N,N,-,-1,-1
PILGRIM.txt,67520,68414,894,10,N,N,-,-1,-1
PILGRIM.txt,67635,68524,889,10,N,N,-,-1,-1
PILGRIM.txt,67849,68634,785,10,N,N,-,-1,-1
PILGRIM.txt,67902,68936,1034,10,N,N,-,-1,-1
PILGRIM.txt,67987,69026,1039,10,N,N,-,-1,-1
PILGRIM.txt,68034,69149,1115,10,N,N,-,-1,-1
PILGRIM.txt,68126,69406,1280,10,N,N,-,-1,-1
PILGRIM.txt,68190,69483,1293,10,N,N,-,-1,-1
PILGRIM.txt,68289,69603,1314,10,N,N,-,-1,-1
PILGRIM.txt,68361,69664,1303,10,N,N,-,-1,-1
PILGRIM.txt,68415,69783,1368,10,N,N,-,-1,-1
PILGRIM.txt,68529,69970,1441,10,N,N,-,-1,-1
PILGRIM.txt,68635,70070,1435,10,N,N,-,-1,-1
PILGRIM.txt,68938,70153,1215,10,N,N,-,-1,-1
PILGRIM.txt,69029,70357,1328,10,N,N,-,-1,-1
PILGRIM.txt,69150,70535,1385,10,N,N,-,-1,-1
PILGRIM.txt,69407,70627,1220,10,N,N,-,-1,-1
PILGRIM.txt,69484,70730,1246,10,N,N,-,-1,-1
PILGRIM.txt,69604,70788,1184,10,N,N,-,-1,-1
PILGRIM.txt,69667,70822,1155,10,N,N,-,-1,-1
PILGRIM.txt,69784,70912,1128,10,N,N,-,-1,-1
PILGRIM.txt,69971,71041,1070,10,N,N,-,-1,-1
PILGRIM.txt,70071,71193,1122,10,N,N,-,-1,-1
PILGRIM.txt,70154,71294,1140,10,N,N,-,-1,-1
PILGRIM.txt,70358,71518,1160,10,N,N,-,-1,-1
PILGRIM.txt,70536,71546,1010,10,N,N,-,-1,-1
PILGRIM.txt,70628,71763,1135,10,N,N,-,-1,-1
PILGRIM.txt,70731,72017,1286,10,N,N,-,-1,-1
PILGRIM.txt,70791,72259,1468,10,N,N,-,-1,-1
PILGRIM.txt,70823,72439,1616,10,N,N,-,-1,-1
PILGRIM.txt,70913,72483,1570,10,N,N,-,-1,-1
PILGRIM.txt,71042,72594,1552,10,N,N,-,-1,-1
PILGRIM.txt,71194,72770,1576,10,N,N,-,-1,-1
PILGRIM.txt,71295,72810,1515,10,N,N,-,-1,-1
PILGRIM.txt,71519,72827,1308,10,N,N,-,-1,-1
PILGRIM.txt,71547,73016,1469,10,N,N,-,-1,-1
PILGRIM.txt,71764,73027,1263,10,N,N,-,-1,-1
PILGRIM.txt,72020,73133,1113,10,N,N,-,-1,-1
PILGRIM.txt,72260,73444,1184,10,N,N,-,-1,-1
PILGRIM.txt,72440,73587,1147,10,N,N,-,-1,-1
PILGRIM.txt,72486,73628,1142,10,N,N,-,-1,-1
PILGRIM.txt,72595,73665,1070,10,N,N,-,-1,-1
PILGRIM.txt,72771,73901,1130,10,N,N,-,-1,-1
PILGRIM.txt,72812,73965,1153,10,N,N,-,-1,-1
PILGRIM.txt,72830,74032,1202,10,N,N,-,-1,-1
PILGRIM.txt,73019,74152,1133,10,N,N,-,-1,-1
PILGRIM.txt,73030,74174,1144,10,N,N,-,-1,-1
PILGRIM.txt,73135,74191,1056,10,N,N,-,-1,-1
PILGRIM.txt,73445,74533,1088,10,N,N,-,-1,-1
PILGRIM.txt,73588,74632,1044,10,N,N,-,-1,-1
PILGRIM.txt,73629,74775,1146,10,N,N,-,-1,-1
PILGRIM.txt,73666,74864,1198,10,N,N,-,-1,-1
PILGRIM.txt,73902,74960,1058,10,N,N,-,-1,-1
PILGRIM.txt,73971,75067,1096,10,N,N,-,-1,-1
PILGRIM.txt,74037,75124,1087,10,N,N,-,-1,-1
PILGRIM.txt,74153,75235,1082,10,N,N,-,-1,-1
PILGRIM.txt,74179,75373,1194,10,N,N,-,-1,-1
PILGRIM.txt,74194,75519,1325,10,N,N,-,-1,-1
PILGRIM.txt,74536,75624,1088,10,N,N,-,-1,-1
PILGRIM.txt,74634,75781,1147,10,N,N,-,-1,-1
PILGRIM.txt,74776,75836,1060,10,N,N,-,-1,-1
PILGRIM.txt,74865,76005,1140,10,N,N,-,-1,-1
PILGRIM.txt,74961,76198,1237,10,N,N,-,-1,-1
PILGRIM.txt,75068,76317,1249,10,N,N,-,-1,-1
PILGRIM.txt,75125,76574,1449,10,N,Y,1437477878183,427206,428439
PILGRIM.txt,75236,76751,1515,10,N,Y,1437477878183,427206,428439
PILGRIM.txt,75375,76899,1524,10,N,Y,1437477878183,427206,428439
PILGRIM.txt,75520,77113,1593,10,N,Y,1437477878183,427206,428439
PILGRIM.txt,75625,77254,1629,10,N,Y,1437477878183,427206,428439
PILGRIM.txt,75782,77435,1653,10,N,Y,1437477878183,427206,428439
PILGRIM.txt,75837,77487,1650,10,N,Y,1437477878183,427206,428439
PILGRIM.txt,76006,77578,1572,10,N,Y,1437477878183,427206,428439
PILGRIM.txt,76199,77804,1605,10,N,Y,1437477878183,427206,428439
PILGRIM.txt,76320,77904,1584,10,N,Y,1437477878183,427206,428439
PILGRIM.txt,76576,77972,1396,10,N,Y,1437477878183,427206,428439
PILGRIM.txt,76752,78144,1392,10,N,Y,1437477878183,427206,428439
PILGRIM.txt,76902,78325,1423,10,N,Y,1437477878183,427206,428439
PILGRIM.txt,77115,78508,1393,10,N,Y,1437477878183,427206,428439
PILGRIM.txt,77257,78599,1342,10,N,Y,1437477878183,427206,428439
PILGRIM.txt,77436,78657,1221,10,N,Y,1437477878183,427206,428439
PILGRIM.txt,77488,78777,1289,10,N,Y,1437477878183,427206,428439
PILGRIM.txt,77579,78846,1267,10,N,Y,1437477878183,427206,428439
PILGRIM.txt,77806,79158,1352,10,N,Y,1437477878183,427206,428439
PILGRIM.txt,77905,79284,1379,10,N,N,-,-1,-1
PILGRIM.txt,77974,79372,1398,10,N,N,-,-1,-1
PILGRIM.txt,78145,79495,1350,10,N,N,-,-1,-1
PILGRIM.txt,78326,79601,1275,10,N,N,-,-1,-1
PILGRIM.txt,78510,79881,1371,10,N,N,-,-1,-1
PILGRIM.txt,78600,80069,1469,10,N,N,-,-1,-1
PILGRIM.txt,78658,80144,1486,10,N,N,-,-1,-1
PILGRIM.txt,78778,80218,1440,10,N,N,-,-1,-1
PILGRIM.txt,78847,80278,1431,10,N,N,-,-1,-1
PILGRIM.txt,79159,80373,1214,10,N,N,-,-1,-1
PILGRIM.txt,79285,80536,1251,10,N,N,-,-1,-1
PILGRIM.txt,79373,80597,1224,10,N,N,-,-1,-1
PILGRIM.txt,79496,80794,1298,10,N,N,-,-1,-1
PILGRIM.txt,79602,80938,1336,10,N,N,-,-1,-1
PILGRIM.txt,79883,81012,1129,10,N,N,-,-1,-1
PILGRIM.txt,80072,81116,1044,10,N,N,-,-1,-1
PILGRIM.txt,80145,81328,1183,10,N,N,-,-1,-1
PILGRIM.txt,80219,81527,1308,10,N,N,-,-1,-1
PILGRIM.txt,80279,81889,1610,10,N,N,-,-1,-1
PILGRIM.txt,80374,81998,1624,10,N,N,-,-1,-1
PILGRIM.txt,80539,82083,1544,10,N,N,-,-1,-1
PILGRIM.txt,80598,82161,1563,10,N,N,-,-1,-1
PILGRIM.txt,80796,82277,1481,10,N,N,-,-1,-1
PILGRIM.txt,80939,82494,1555,10,N,N,-,-1,-1
PILGRIM.txt,81014,82595,1581,10,N,N,-,-1,-1
PILGRIM.txt,81117,82730,1613,10,N,N,-,-1,-1
PILGRIM.txt,81330,82914,1584,10,N,N,-,-1,-1
PILGRIM.txt,81532,83179,1647,10,N,N,-,-1,-1
PILGRIM.txt,81890,83254,1364,10,N,N,-,-1,-1
PILGRIM.txt,81999,83367,1368,10,N,N,-,-1,-1
PILGRIM.txt,82084,83563,1479,10,N,N,-,-1,-1
PILGRIM.txt,82162,83626,1464,10,N,N,-,-1,-1
PILGRIM.txt,82278,83806,1528,10,N,N,-,-1,-1
PILGRIM.txt,82497,84107,1610,10,N,N,-,-1,-1
PILGRIM.txt,82596,84280,1684,10,N,N,-,-1,-1
PILGRIM.txt,82731,84372,1641,10,N,N,-,-1,-1
PILGRIM.txt,82917,84529,1612,10,N,N,-,-1,-1
PILGRIM.txt,83180,84692,1512,10,N,N,-,-1,-1
PILGRIM.txt,83255,84787,1532,10,N,N,-,-1,-1
PILGRIM.txt,83370,84889,1519,10,N,N,-,-1,-1
PILGRIM.txt,83568,85002,1434,10,N,N,-,-1,-1
PILGRIM.txt,83627,85086,1459,10,N,N,-,-1,-1
PILGRIM.txt,83808,85226,1418,10,N,N,-,-1,-1
PILGRIM.txt,84110,85423,1313,10,N,N,-,-1,-1
PILGRIM.txt,84281,85548,1267,10,N,N,-,-1,-1
PILGRIM.txt,84375,85683,1308,10,N,N,-,-1,-1
PILGRIM.txt,84530,86054,1524,10,N,N,-,-1,-1
PILGRIM.txt,84693,86161,1468,10,N,N,-,-1,-1
PILGRIM.txt,84789,86333,1544,10,N,N,-,-1,-1
PILGRIM.txt,84890,86435,1545,10,N,N,-,-1,-1
PILGRIM.txt,85004,86567,1563,10,N,N,-,-1,-1
PILGRIM.txt,85087,86692,1605,10,N,N,-,-1,-1
PILGRIM.txt,85229,86849,1620,10,N,N,-,-1,-1
PILGRIM.txt,85428,87011,1583,10,N,N,-,-1,-1
PILGRIM.txt,85550,87089,1539,10,N,N,-,-1,-1
PILGRIM.txt,85684,87401,1717,10,N,N,-,-1,-1
PILGRIM.txt,86055,87471,1416,10,N,N,-,-1,-1
PILGRIM.txt,86162,87691,1529,10,N,N,-,-1,-1
PILGRIM.txt,86336,87872,1536,10,N,N,-,-1,-1
PILGRIM.txt,86436,87952,1516,10,N,N,-,-1,-1
PILGRIM.txt,86568,87989,1421,10,N,N,-,-1,-1
PILGRIM.txt,86695,88117,1422,10,N,N,-,-1,-1
PILGRIM.txt,86851,88263,1412,10,N,N,-,-1,-1
PILGRIM.txt,87013,88427,1414,10,N,N,-,-1,-1
PILGRIM.txt,87090,88570,1480,10,N,N,-,-1,-1
PILGRIM.txt,87402,88712,1310,10,N,N,-,-1,-1
PILGRIM.txt,87472,88876,1404,10,N,N,-,-1,-1
PILGRIM.txt,87692,88988,1296,10,N,N,-,-1,-1
PILGRIM.txt,87873,89196,1323,10,N,N,-,-1,-1
PILGRIM.txt,87953,89313,1360,10,N,N,-,-1,-1
PILGRIM.txt,87990,89407,1417,10,N,N,-,-1,-1
PILGRIM.txt,88118,89496,1378,10,N,N,-,-1,-1
PILGRIM.txt,88266,89565,1299,10,N,N,-,-1,-1
PILGRIM.txt,88428,89603,1175,10,N,N,-,-1,-1
PILGRIM.txt,88573,89747,1174,10,N,N,-,-1,-1
PILGRIM.txt,88713,89856,1143,10,N,N,-,-1,-1
PILGRIM.txt,88877,89905,1028,10,N,N,-,-1,-1
PILGRIM.txt,88989,89971,982,10,N,N,-,-1,-1
PILGRIM.txt,89197,90056,859,10,N,N,-,-1,-1
PILGRIM.txt,89315,90215,900,10,N,N,-,-1,-1
PILGRIM.txt,89408,90254,846,10,N,N,-,-1,-1
PILGRIM.txt,89497,90335,838,10,N,N,-,-1,-1
PILGRIM.txt,89567,90503,936,10,N,N,-,-1,-1
PILGRIM.txt,89604,90837,1233,10,N,N,-,-1,-1
PILGRIM.txt,89748,90925,1177,10,N,N,-,-1,-1
PILGRIM.txt,89857,90994,1137,10,N,N,-,-1,-1
PILGRIM.txt,89906,91202,1296,10,N,N,-,-1,-1
PILGRIM.txt,89973,91307,1334,10,N,N,-,-1,-1
PILGRIM.txt,90057,91435,1378,10,N,N,-,-1,-1
PILGRIM.txt,90216,91501,1285,10,N,N,-,-1,-1
PILGRIM.txt,90255,91796,1541,10,N,N,-,-1,-1
PILGRIM.txt,90338,92111,1773,10,Y,N,-,-1,-1
PILGRIM.txt,90506,92229,1723,10,Y,N,-,-1,-1
PILGRIM.txt,90838,92382,1544,10,N,N,-,-1,-1
PILGRIM.txt,90928,92499,1571,10,N,N,-,-1,-1
PILGRIM.txt,90995,92515,1520,10,N,N,-,-1,-1
PILGRIM.txt,91203,92823,1620,10,N,N,-,-1,-1
PILGRIM.txt,91308,92980,1672,10,N,N,-,-1,-1
PILGRIM.txt,91436,93201,1765,10,N,N,-,-1,-1
PILGRIM.txt,91504,93315,1811,10,N,N,-,-1,-1
PILGRIM.txt,91797,93451,1654,10,N,N,-,-1,-1
PILGRIM.txt,92112,93643,1531,10,N,N,-,-1,-1
PILGRIM.txt,92230,93769,1539,10,N,N,-,-1,-1
PILGRIM.txt,92383,93863,1480,10,N,N,-,-1,-1
PILGRIM.txt,92504,93944,1440,10,N,N,-,-1,-1
PILGRIM.txt,92518,94131,1613,10,N,N,-,-1,-1
PILGRIM.txt,92826,94235,1409,10,N,N,-,-1,-1
PILGRIM.txt,92981,94379,1398,10,N,N,-,-1,-1
PILGRIM.txt,93202,94517,1315,10,N,N,-,-1,-1
PILGRIM.txt,93317,94641,1324,10,N,N,-,-1,-1
PILGRIM.txt,93452,94832,1380,10,N,N,-,-1,-1
PILGRIM.txt,93645,94952,1307,10,N,N,-,-1,-1
PILGRIM.txt,93770,95047,1277,10,N,N,-,-1,-1
PILGRIM.txt,93866,95229,1363,10,N,N,-,-1,-1
PILGRIM.txt,93945,95353,1408,10,N,N,-,-1,-1
PILGRIM.txt,94136,95617,1481,10,N,N,-,-1,-1
PILGRIM.txt,94236,95693,1457,10,N,N,-,-1,-1
PILGRIM.txt,94380,95887,1507,10,N,N,-,-1,-1
PILGRIM.txt,94518,96078,1560,10,N,N,-,-1,-1
PILGRIM.txt,94642,96143,1501,10,N,N,-,-1,-1
PILGRIM.txt,94833,96232,1399,10,N,N,-,-1,-1
PILGRIM.txt,94953,96336,1383,10,N,N,-,-1,-1
PILGRIM.txt,95049,96471,1422,10,N,N,-,-1,-1
PILGRIM.txt,95230,96734,1504,10,N,N,-,-1,-1
PILGRIM.txt,95355,96827,1472,10,N,N,-,-1,-1
PILGRIM.txt,95618,96957,1339,10,N,N,-,-1,-1
PILGRIM.txt,95694,97091,1397,10,Y,N,-,-1,-1
PILGRIM.txt,95888,97335,1447,10,Y,N,-,-1,-1
PILGRIM.txt,96079,97482,1403,10,Y,N,-,-1,-1
PILGRIM.txt,96144,97487,1343,10,Y,N,-,-1,-1
PILGRIM.txt,96233,97541,1308,10,Y,N,-,-1,-1
PILGRIM.txt,96337,97729,1392,10,Y,N,-,-1,-1
PILGRIM.txt,96472,97933,1461,10,Y,N,-,-1,-1
PILGRIM.txt,96735,98140,1405,10,Y,N,-,-1,-1
PILGRIM.txt,96828,98425,1597,10,Y,N,-,-1,-1
PILGRIM.txt,96958,98658,1700,10,Y,N,-,-1,-1
PILGRIM.txt,97092,98684,1592,10,Y,N,-,-1,-1
PILGRIM.txt,97336,98806,1470,10,N,N,-,-1,-1
PILGRIM.txt,97483,99003,1520,10,N,N,-,-1,-1
PILGRIM.txt,97489,99105,1616,10,N,N,-,-1,-1
PILGRIM.txt,97543,99319,1776,10,N,N,-,-1,-1
PILGRIM.txt,97730,99691,1961,10,N,N,-,-1,-1
PILGRIM.txt,97934,99777,1843,10,N,N,-,-1,-1
PILGRIM.txt,98141,99907,1766,10,N,N,-,-1,-1
PILGRIM.txt,98428,100037,1609,10,N,N,-,-1,-1
PILGRIM.txt,98659,100191,1532,10,N,N,-,-1,-1
PILGRIM.txt,98687,100314,1627,10,N,N,-,-1,-1
PILGRIM.txt,98807,100402,1595,10,N,N,-,-1,-1
PILGRIM.txt,99006,100409,1403,10,N,N,-,-1,-1
PILGRIM.txt,99106,100453,1347,10,N,N,-,-1,-1
PILGRIM.txt,99320,100625,1305,10,N,N,-,-1,-1
PILGRIM.txt,99694,100730,1036,10,N,N,-,-1,-1
PILGRIM.txt,99778,101004,1226,10,N,N,-,-1,-1
PILGRIM.txt,99908,101119,1211,10,N,N,-,-1,-1
PILGRIM.txt,100038,101217,1179,10,N,N,-,-1,-1
PILGRIM.txt,100192,101292,1100,10,N,N,-,-1,-1
PILGRIM.txt,100315,101463,1148,10,N,N,-,-1,-1
PILGRIM.txt,100403,101586,1183,10,N,N,-,-1,-1
PILGRIM.txt,100410,101643,1233,10,N,N,-,-1,-1
PILGRIM.txt,100454,101997,1543,10,N,N,-,-1,-1
PILGRIM.txt,100626,102085,1459,10,N,N,-,-1,-1
PILGRIM.txt,100733,102191,1458,10,N,N,-,-1,-1
PILGRIM.txt,101007,102303,1296,10,N,N,-,-1,-1
PILGRIM.txt,101120,102386,1266,10,N,N,-,-1,-1
PILGRIM.txt,101219,102459,1240,10,N,N,-,-1,-1
PILGRIM.txt,101293,102613,1320,10,N,N,-,-1,-1
PILGRIM.txt,101464,102719,1255,10,N,N,-,-1,-1
PILGRIM.txt,101589,102815,1226,10,N,N,-,-1,-1
PILGRIM.txt,101645,102927,1282,10,N,N,-,-1,-1
PILGRIM.txt,101999,103031,1032,10,N,N,-,-1,-1
PILGRIM.txt,102086,103100,1014,10,N,N,-,-1,-1
PILGRIM.txt,102192,103315,1123,10,N,N,-,-1,-1
PILGRIM.txt,102304,103441,1137,10,N,N,-,-1,-1
PILGRIM.txt,102387,103566,1179,10,N,N,-,-1,-1
PILGRIM.txt,102460,103702,1242,10,N,N,-,-1,-1
PILGRIM.txt,102614,103783,1169,10,N,N,-,-1,-1
PILGRIM.txt,102720,103806,1086,10,N,N,-,-1,-1
PILGRIM.txt,102818,103896,1078,10,N,N,-,-1,-1
PILGRIM.txt,102928,104024,1096,10,N,N,-,-1,-1
PILGRIM.txt,103032,104173,1141,10,N,N,-,-1,-1
PILGRIM.txt,103101,104318,1217,10,N,N,-,-1,-1
PILGRIM.txt,103316,104453,1137,10,N,N,-,-1,-1
PILGRIM.txt,103442,104576,1134,10,N,N,-,-1,-1
PILGRIM.txt,103567,104671,1104,10,N,N,-,-1,-1
PILGRIM.txt,103703,104876,1173,10,N,N,-,-1,-1
PILGRIM.txt,103784,105015,1231,10,N,N,-,-1,-1
PILGRIM.txt,103809,105178,1369,10,N,N,-,-1,-1
PILGRIM.txt,103897,105387,1490,10,N,N,-,-1,-1
PILGRIM.txt,104025,105515,1490,10,N,N,-,-1,-1
PILGRIM.txt,104176,105560,1384,10,N,N,-,-1,-1
PILGRIM.txt,104321,105626,1305,10,N,N,-,-1,-1
PILGRIM.txt,104454,105797,1343,10,N,N,-,-1,-1
PILGRIM.txt,104577,105947,1370,10,N,N,-,-1,-1
PILGRIM.txt,104672,106119,1447,10,N,N,-,-1,-1
PILGRIM.txt,104877,106220,1343,10,N,N,-,-1,-1
PILGRIM.txt,105016,106270,1254,10,N,N,-,-1,-1
PILGRIM.txt,105181,106388,1207,10,N,N,-,-1,-1
PILGRIM.txt,105388,106492,1104,10,N,N,-,-1,-1
PILGRIM.txt,105520,106554,1034,10,N,N,-,-1,-1
PILGRIM.txt,105561,106644,1083,10,N,N,-,-1,-1
PILGRIM.txt,105627,106758,1131,10,N,N,-,-1,-1
PILGRIM.txt,105798,106932,1134,10,N,N,-,-1,-1
PILGRIM.txt,105948,107083,1135,10,N,N,-,-1,-1
PILGRIM.txt,106120,107130,1010,10,N,N,-,-1,-1
PILGRIM.txt,106221,107191,970,10,N,N,-,-1,-1
PILGRIM.txt,106271,107329,1058,10,N,N,-,-1,-1
PILGRIM.txt,106389,107340,951,10,N,N,-,-1,-1
PILGRIM.txt,106493,107397,904,10,N,N,-,-1,-1
PILGRIM.txt,106555,107693,1138,10,N,N,-,-1,-1
PILGRIM.txt,106645,107776,1131,10,N,N,-,-1,-1
PILGRIM.txt,106759,107936,1177,10,N,N,-,-1,-1
PILGRIM.txt,106933,108154,1221,10,Y,N,-,-1,-1
PILGRIM.txt,107084,108238,1154,10,N,N,-,-1,-1
PILGRIM.txt,107131,108451,1320,10,N,N,-,-1,-1
PILGRIM.txt,107192,108637,1445,10,N,N,-,-1,-1
PILGRIM.txt,107330,108698,1368,10,N,N,-,-1,-1
PILGRIM.txt,107341,108844,1503,10,N,N,-,-1,-1
PILGRIM.txt,107398,108909,1511,10,N,N,-,-1,-1
PILGRIM.txt,107694,109075,1381,10,N,N,-,-1,-1
PILGRIM.txt,107777,109148,1371,10,N,N,-,-1,-1
PILGRIM.txt,107937,109274,1337,10,N,N,-,-1,-1
PILGRIM.txt,108155,109428,1273,10,N,N,-,-1,-1
PILGRIM.txt,108239,109443,1204,10,N,N,-,-1,-1
PILGRIM.txt,108452,109677,1225,10,N,N,-,-1,-1
PILGRIM.txt,108640,109682,1042,10,N,N,-,-1,-1
PILGRIM.txt,108699,109936,1237,10,N,N,-,-1,-1
PILGRIM.txt,108845,110001,1156,10,N,N,-,-1,-1
PILGRIM.txt,108910,110139,1229,10,N,N,-,-1,-1
PILGRIM.txt,109077,110292,1215,10,N,N,-,-1,-1
PILGRIM.txt,109149,110394,1245,10,N,N,-,-1,-1
PILGRIM.txt,109275,110504,1229,10,N,N,-,-1,-1
PILGRIM.txt,109433,110677,1244,10,N,N,-,-1,-1
PILGRIM.txt,109446,110889,1443,10,N,N,-,-1,-1
PILGRIM.txt,109678,111000,1322,10,N,N,-,-1,-1
PILGRIM.txt,109684,111225,1541,10,N,N,-,-1,-1
PILGRIM.txt,109939,111390,1451,10,N,N,-,-1,-1
PILGRIM.txt,110002,111612,1610,10,N,N,-,-1,-1
PILGRIM.txt,110140,111652,1512,10,N,N,-,-1,-1
PILGRIM.txt,110293,111717,1424,10,N,N,-,-1,-1
PILGRIM.txt,110395,111753,1358,10,N,N,-,-1,-1
PILGRIM.txt,110505,111824,1319,10,N,N,-,-1,-1
PILGRIM.txt,110678,111991,1313,10,N,N,-,-1,-1
PILGRIM.txt,110891,112320,1429,10,N,N,-,-1,-1
PILGRIM.txt,111002,112362,1360,10,N,N,-,-1,-1
PILGRIM.txt,111226,112643,1417,10,N,N,-,-1,-1
PILGRIM.txt,111391,112746,1355,10,N,N,-,-1,-1
PILGRIM.txt,111613,112880,1267,10,N,N,-,-1,-1
PILGRIM.txt,111653,113002,1349,10,N,N,-,-1,-1
PILGRIM.txt,111718,113068,1350,10,N,N,-,-1,-1
PILGRIM.txt,111754,113130,1376,10,N,N,-,-1,-1
PILGRIM.txt,111825,113255,1430,10,N,N,-,-1,-1
PILGRIM.txt,111992,113359,1367,10,N,N,-,-1,-1
PILGRIM.txt,112321,113700,1379,10,N,N,-,-1,-1
PILGRIM.txt,112363,113862,1499,10,N,N,-,-1,-1
PILGRIM.txt,112644,113886,1242,10,N,N,-,-1,-1
PILGRIM.txt,112749,114105,1356,10,N,N,-,-1,-1
PILGRIM.txt,112881,114348,1467,10,N,N,-,-1,-1
PILGRIM.txt,113003,114383,1380,10,N,N,-,-1,-1
PILGRIM.txt,113069,114544,1475,10,N,N,-,-1,-1
PILGRIM.txt,113131,114703,1572,10,N,N,-,-1,-1
PILGRIM.txt,113256,114898,1642,10,N,N,-,-1,-1
PILGRIM.txt,113360,114920,1560,10,N,N,-,-1,-1
PILGRIM.txt,113701,115070,1369,10,N,N,-,-1,-1
PILGRIM.txt,113863,115140,1277,10,N,N,-,-1,-1
PILGRIM.txt,113889,115264,1375,10,N,N,-,-1,-1
PILGRIM.txt,114106,115339,1233,10,N,N,-,-1,-1
PILGRIM.txt,114349,115502,1153,10,N,N,-,-1,-1
PILGRIM.txt,114386,115629,1243,10,N,N,-,-1,-1
PILGRIM.txt,114546,115753,1207,10,N,N,-,-1,-1
PILGRIM.txt,114705,115895,1190,10,N,N,-,-1,-1
PILGRIM.txt,114901,116026,1125,10,N,N,-,-1,-1
PILGRIM.txt,114921,116100,1179,10,N,N,-,-1,-1
PILGRIM.txt,115071,116280,1209,10,N,N,-,-1,-1
PILGRIM.txt,115141,116456,1315,10,N,N,-,-1,-1
PILGRIM.txt,115265,116674,1409,10,N,N,-,-1,-1
PILGRIM.txt,115340,116757,1417,10,N,N,-,-1,-1
PILGRIM.txt,115503,116840,1337,10,N,N,-,-1,-1
PILGRIM.txt,115632,116975,1343,10,N,N,-,-1,-1
PILGRIM.txt,115754,117087,1333,10,N,N,-,-1,-1
PILGRIM.txt,115897,117164,1267,10,N,N,-,-1,-1
PILGRIM.txt,116027,117230,1203,10,N,N,-,-1,-1
PILGRIM.txt,116101,117344,1243,10,N,N,-,-1,-1
PILGRIM.txt,116283,117649,1366,10,N,N,-,-1,-1
PILGRIM.txt,116457,117766,1309,10,N,N,-,-1,-1
PILGRIM.txt,116679,117945,1266,10,N,N,-,-1,-1
PILGRIM.txt,116758,118183,1425,10,N,N,-,-1,-1
PILGRIM.txt,116841,118446,1605,10,N,N,-,-1,-1
PILGRIM.txt,116978,118517,1539,10,N,N,-,-1,-1
PILGRIM.txt,117089,118733,1644,10,N,N,-,-1,-1
PILGRIM.txt,117165,118872,1707,10,N,N,-,-1,-1
PILGRIM.txt,117231,119184,1953,10,N,N,-,-1,-1
PILGRIM.txt,117345,119322,1977,10,N,N,-,-1,-1
PILGRIM.txt,117650,119404,1754,10,N,N,-,-1,-1
PILGRIM.txt,117767,119621,1854,10,N,N,-,-1,-1
PILGRIM.txt,117946,119766,1820,10,N,N,-,-1,-1
PILGRIM.txt,118184,119846,1662,10,N,N,-,-1,-1
PILGRIM.txt,118447,120014,1567,10,N,N,-,-1,-1
PILGRIM.txt,118518,120103,1585,10,N,N,-,-1,-1
PILGRIM.txt,118736,120147,1411,10,N,N,-,-1,-1
PILGRIM.txt,118873,120428,1555,10,N,N,-,-1,-1
PILGRIM.txt,119185,120452,1267,10,N,N,-,-1,-1
PILGRIM.txt,119325,120480,1155,10,N,N,-,-1,-1
PILGRIM.txt,119405,120693,1288,10,N,N,-,-1,-1
PILGRIM.txt,119622,120765,1143,10,N,N,-,-1,-1
PILGRIM.txt,119767,120888,1121,10,N,N,-,-1,-1
PILGRIM.txt,119848,121225,1377,10,N,N,-,-1,-1
PILGRIM.txt,120015,121397,1382,10,N,N,-,-1,-1
PILGRIM.txt,120105,121532,1427,10,N,N,-,-1,-1
PILGRIM.txt,120147,121611,1464,10,N,N,-,-1,-1
PILGRIM.txt,120429,121764,1335,10,N,N,-,-1,-1
PILGRIM.txt,120457,121842,1385,10,N,N,-,-1,-1
PILGRIM.txt,120481,121966,1485,10,N,N,-,-1,-1
PILGRIM.txt,120694,122033,1339,10,N,N,-,-1,-1
PILGRIM.txt,120766,122104,1338,10,N,N,-,-1,-1
PILGRIM.txt,120889,122187,1298,10,N,N,-,-1,-1
PILGRIM.txt,121227,122427,1200,10,N,N,-,-1,-1
PILGRIM.txt,121400,122525,1125,10,N,N,-,-1,-1
PILGRIM.txt,121533,122628,1095,10,N,N,-,-1,-1
PILGRIM.txt,121612,122732,1120,10,N,N,-,-1,-1
PILGRIM.txt,121766,122803,1037,10,N,N,-,-1,-1
PILGRIM.txt,121843,123048,1205,10,N,N,-,-1,-1
PILGRIM.txt,121969,123185,1216,10,N,N,-,-1,-1
PILGRIM.txt,122034,123246,1212,10,N,N,-,-1,-1
PILGRIM.txt,122105,123319,1214,10,N,N,-,-1,-1
PILGRIM.txt,122188,123367,1179,10,N,N,-,-1,-1
PILGRIM.txt,122428,123477,1049,10,N,N,-,-1,-1
PILGRIM.txt,122525,123598,1073,10,N,N,-,-1,-1
PILGRIM.txt,122630,123769,1139,10,N,N,-,-1,-1
PILGRIM.txt,122733,123908,1175,10,Y,N,-,-1,-1
PILGRIM.txt,122804,123913,1109,10,Y,N,-,-1,-1
PILGRIM.txt,123049,124007,958,10,Y,N,-,-1,-1
PILGRIM.txt,123186,124273,1087,10,Y,N,-,-1,-1
PILGRIM.txt,123247,124309,1062,10,Y,N,-,-1,-1
PILGRIM.txt,123321,124529,1208,10,Y,N,-,-1,-1
PILGRIM.txt,123368,124627,1259,10,Y,N,-,-1,-1
PILGRIM.txt,123479,124839,1360,10,Y,N,-,-1,-1
PILGRIM.txt,123599,124934,1335,10,Y,N,-,-1,-1
PILGRIM.txt,123770,124961,1191,10,Y,N,-,-1,-1
PILGRIM.txt,123909,125010,1101,10,N,N,-,-1,-1
PILGRIM.txt,123915,125111,1196,10,N,N,-,-1,-1
PILGRIM.txt,124010,125148,1138,10,N,N,-,-1,-1
PILGRIM.txt,124278,125353,1075,10,N,N,-,-1,-1
PILGRIM.txt,124310,125549,1239,10,N,N,-,-1,-1
PILGRIM.txt,124530,125617,1087,10,N,N,-,-1,-1
PILGRIM.txt,124630,125778,1148,10,N,N,-,-1,-1
PILGRIM.txt,124840,125855,1015,10,N,N,-,-1,-1
PILGRIM.txt,124935,125912,977,10,N,N,-,-1,-1
PILGRIM.txt,124962,126079,1117,10,N,N,-,-1,-1
PILGRIM.txt,125013,126153,1140,10,N,N,-,-1,-1
PILGRIM.txt,125112,126245,1133,10,N,N,-,-1,-1
PILGRIM.txt,125149,126315,1166,10,N,N,-,-1,-1
PILGRIM.txt,125354,126575,1221,10,N,N,-,-1,-1
PILGRIM.txt,125550,126679,1129,10,N,N,-,-1,-1
PILGRIM.txt,125618,126718,1100,10,N,N,-,-1,-1
PILGRIM.txt,125781,126812,1031,10,N,N,-,-1,-1
PILGRIM.txt,125856,126817,961,10,N,N,-,-1,-1
PILGRIM.txt,125913,126882,969,10,N,N,-,-1,-1
PILGRIM.txt,126080,127012,932,10,N,N,-,-1,-1
PILGRIM.txt,126154,127096,942,10,N,N,-,-1,-1
PILGRIM.txt,126246,127179,933,10,N,N,-,-1,-1
PILGRIM.txt,126316,127308,992,10,N,N,-,-1,-1
PILGRIM.txt,126578,127479,901,10,N,N,-,-1,-1
PILGRIM.txt,126680,127672,992,10,N,N,-,-1,-1
PILGRIM.txt,126719,127873,1154,10,N,N,-,-1,-1
PILGRIM.txt,126813,128220,1407,10,N,N,-,-1,-1
PILGRIM.txt,126818,128323,1505,10,N,N,-,-1,-1
PILGRIM.txt,126883,128388,1505,10,N,N,-,-1,-1
PILGRIM.txt,127013,128504,1491,10,N,N,-,-1,-1
PILGRIM.txt,127097,128655,1558,10,N,N,-,-1,-1
PILGRIM.txt,127180,128700,1520,10,N,N,-,-1,-1
PILGRIM.txt,127309,128755,1446,10,N,N,-,-1,-1
PILGRIM.txt,127481,128928,1447,10,N,N,-,-1,-1
PILGRIM.txt,127673,129127,1454,10,N,N,-,-1,-1
PILGRIM.txt,127874,129290,1416,10,N,N,-,-1,-1
PILGRIM.txt,128223,129472,1249,10,N,N,-,-1,-1
PILGRIM.txt,128324,129582,1258,10,N,N,-,-1,-1
PILGRIM.txt,128390,129835,1445,10,N,N,-,-1,-1
PILGRIM.txt,128505,129882,1377,10,N,N,-,-1,-1
PILGRIM.txt,128656,129980,1324,10,N,Y,1437475017618,98942,100041
PILGRIM.txt,128701,130148,1447,10,N,Y,1437475017618,98942,100041
PILGRIM.txt,128756,130212,1456,10,N,Y,1437475017618,98942,100041
PILGRIM.txt,128929,130326,1397,10,N,Y,1437475017618,98942,100041
PILGRIM.txt,129128,130448,1320,10,N,Y,1437475017618,98942,100041
PILGRIM.txt,129291,130541,1250,10,N,Y,1437475017618,98942,100041
PILGRIM.txt,129475,130585,1110,10,N,Y,1437475017618,98942,100041
PILGRIM.txt,129583,130726,1143,10,N,Y,1437475017618,98942,100041
PILGRIM.txt,129836,130882,1046,10,N,Y,1437475017618,98942,100041
PILGRIM.txt,129887,130909,1022,10,N,Y,1437475017618,98942,100041
PILGRIM.txt,129981,131027,1046,10,Y,Y,1437475017618,98942,100041
PILGRIM.txt,130149,131176,1027,10,Y,Y,1437475017618,98942,100041
PILGRIM.txt,130213,131368,1155,10,Y,Y,1437475017618,98942,100041
PILGRIM.txt,130328,131423,1095,10,Y,Y,1437475017618,98942,100041
PILGRIM.txt,130449,131487,1038,10,Y,Y,1437475017618,98942,100041
PILGRIM.txt,130544,131546,1002,10,Y,Y,1437475017618,98942,100041
PILGRIM.txt,130586,131669,1083,10,Y,Y,1437475017618,98942,100041
PILGRIM.txt,130727,131766,1039,10,N,Y,1437475017618,98942,100041
PILGRIM.txt,130883,131840,957,10,N,Y,1437475017618,98942,100041
PILGRIM.txt,130910,131933,1023,10,N,Y,1437475017618,98942,100041
PILGRIM.txt,131028,132004,976,10,N,Y,1437475017618,98942,100041
PILGRIM.txt,131177,132146,969,10,N,Y,1437475017618,98942,100041
PILGRIM.txt,131369,132205,836,10,N,Y,1437475017618,98942,100041
PILGRIM.txt,131426,132413,987,10,N,N,-,-1,-1
PILGRIM.txt,131488,132500,1012,10,N,N,-,-1,-1
PILGRIM.txt,131547,132507,960,10,N,N,-,-1,-1
PILGRIM.txt,131670,132541,871,10,N,N,-,-1,-1
PILGRIM.txt,131767,132621,854,10,N,N,-,-1,-1
PILGRIM.txt,131841,132697,856,10,N,N,-,-1,-1
PILGRIM.txt,131934,132791,857,10,N,N,-,-1,-1
PILGRIM.txt,132005,132883,878,10,N,N,-,-1,-1
PILGRIM.txt,132147,133023,876,10,N,N,-,-1,-1
PILGRIM.txt,132206,133083,877,10,N,N,-,-1,-1
PILGRIM.txt,132414,133226,812,10,N,N,-,-1,-1
PILGRIM.txt,132501,133286,785,10,N,N,-,-1,-1
PILGRIM.txt,132509,133413,904,10,N,N,-,-1,-1
PILGRIM.txt,132542,133651,1109,10,N,N,-,-1,-1
PILGRIM.txt,132622,133797,1175,10,N,N,-,-1,-1
PILGRIM.txt,132698,133990,1292,10,N,N,-,-1,-1
PILGRIM.txt,132794,134135,1341,10,N,N,-,-1,-1
PILGRIM.txt,132884,134219,1335,10,N,N,-,-1,-1
PILGRIM.txt,133024,134358,1334,10,N,N,-,-1,-1
PILGRIM.txt,133084,134587,1503,10,N,N,-,-1,-1
PILGRIM.txt,133227,134651,1424,10,N,N,-,-1,-1
PILGRIM.txt,133287,134734,1447,10,N,N,-,-1,-1
PILGRIM.txt,133414,134830,1416,10,N,N,-,-1,-1
PILGRIM.txt,133656,134918,1262,10,N,N,-,-1,-1
PILGRIM.txt,133800,135107,1307,10,N,Y,1436867017136,105674,106651
PILGRIM.txt,133991,135342,1351,10,N,Y,1436867017136,105674,106651
PILGRIM.txt,134136,135396,1260,10,N,Y,1436867017136,105674,106651
PILGRIM.txt,134221,135545,1324,10,N,Y,1436867017136,105674,106651
PILGRIM.txt,134359,135605,1246,10,N,Y,1436867017136,105674,106651
PILGRIM.txt,134588,135651,1063,10,N,Y,1436867017136,105674,106651
PILGRIM.txt,134652,135807,1155,10,N,Y,1436867017136,105674,106651
PILGRIM.txt,134735,135888,1153,10,N,Y,1436867017136,105674,106651
PILGRIM.txt,134832,136098,1266,10,N,Y,1436867017136,105674,106651
PILGRIM.txt,134921,136194,1273,10,N,Y,1436867017136,105674,106651
PILGRIM.txt,135108,136395,1287,10,N,Y,1436867017136,105674,106651
PILGRIM.txt,135343,136462,1119,10,N,Y,1436867017136,105674,106651
PILGRIM.txt,135397,136575,1178,10,N,Y,1436867017136,105674,106651
PILGRIM.txt,135547,136619,1072,10,N,Y,1436867017136,105674,106651
PILGRIM.txt,135610,136696,1086,10,N,Y,1436867017136,105674,106651
PILGRIM.txt,135652,136847,1195,10,N,N,-,-1,-1
PILGRIM.txt,135808,137092,1284,10,N,N,-,-1,-1
PILGRIM.txt,135889,137299,1410,10,N,N,-,-1,-1
PILGRIM.txt,136099,137403,1304,10,N,N,-,-1,-1
PILGRIM.txt,136197,137461,1264,10,N,N,-,-1,-1
PILGRIM.txt,136396,137532,1136,10,N,N,-,-1,-1
PILGRIM.txt,136463,137622,1159,10,N,N,-,-1,-1
PILGRIM.txt,136577,137627,1050,10,N,N,-,-1,-1
PILGRIM.txt,136620,137636,1016,10,N,N,-,-1,-1
PILGRIM.txt,136699,137641,942,10,N,N,-,-1,-1
PILGRIM.txt,136849,137702,853,10,N,N,-,-1,-1
PILGRIM.txt,137093,137846,753,10,N,N,-,-1,-1
PILGRIM.txt,137300,137977,677,10,N,N,-,-1,-1
PILGRIM.txt,137404,138129,725,10,N,N,-,-1,-1
PILGRIM.txt,137466,138290,824,10,N,N,-,-1,-1
PILGRIM.txt,137533,138488,955,10,N,N,-,-1,-1
PILGRIM.txt,137623,138641,1018,10,N,N,-,-1,-1
PILGRIM.txt,137628,138839,1211,10,N,N,-,-1,-1
PILGRIM.txt,137637,138958,1321,10,N,N,-,-1,-1
PILGRIM.txt,137642,139002,1360,10,N,N,-,-1,-1
PILGRIM.txt,137704,139324,1620,10,N,N,-,-1,-1
PILGRIM.txt,137849,139481,1632,10,N,N,-,-1,-1
PILGRIM.txt,137978,139652,1674,10,N,N,-,-1,-1
PILGRIM.txt,138130,139944,1814,10,N,N,-,-1,-1
PILGRIM.txt,138291,140011,1720,10,N,N,-,-1,-1
PILGRIM.txt,138491,140293,1802,10,N,N,-,-1,-1
PILGRIM.txt,138642,140461,1819,10,N,N,-,-1,-1
PILGRIM.txt,138840,140661,1821,10,N,N,-,-1,-1
PILGRIM.txt,138959,140877,1918,10,N,N,-,-1,-1
PILGRIM.txt,139004,141068,2064,10,N,N,-,-1,-1
PILGRIM.txt,139329,141239,1910,10,N,N,-,-1,-1
PILGRIM.txt,139482,141328,1846,10,N,N,-,-1,-1
PILGRIM.txt,139653,141427,1774,10,N,N,-,-1,-1
PILGRIM.txt,139945,141687,1742,10,N,N,-,-1,-1
PILGRIM.txt,140012,141803,1791,10,N,N,-,-1,-1
PILGRIM.txt,140296,141897,1601,10,N,N,-,-1,-1
PILGRIM.txt,140462,142043,1581,10,N,N,-,-1,-1
PILGRIM.txt,140663,142151,1488,10,N,N,-,-1,-1
PILGRIM.txt,140879,142157,1278,10,N,N,-,-1,-1
PILGRIM.txt,141069,142200,1131,10,N,N,-,-1,-1
PILGRIM.txt,141244,142291,1047,10,N,N,-,-1,-1
PILGRIM.txt,141329,142422,1093,10,N,N,-,-1,-1
PILGRIM.txt,141429,142659,1230,10,N,N,-,-1,-1
PILGRIM.txt,141688,142719,1031,10,N,N,-,-1,-1
PILGRIM.txt,141805,142802,997,10,N,N,-,-1,-1
PILGRIM.txt,141898,142851,953,10,N,N,-,-1,-1
PILGRIM.txt,142044,142950,906,10,N,N,-,-1,-1
PILGRIM.txt,142152,142969,817,10,N,N,-,-1,-1
PILGRIM.txt,142160,142972,812,10,N,N,-,-1,-1
PILGRIM.txt,142203,143175,972,10,N,N,-,-1,-1
PILGRIM.txt,142292,143228,936,10,N,N,-,-1,-1
PILGRIM.txt,142423,143234,811,10,N,N,-,-1,-1
PILGRIM.txt,142660,143278,618,10,N,N,-,-1,-1
PILGRIM.txt,142720,143390,670,10,N,N,-,-1,-1
PILGRIM.txt,142805,143478,673,10,N,N,-,-1,-1
PILGRIM.txt,142852,143698,846,10,N,N,-,-1,-1
PILGRIM.txt,142951,143812,861,10,N,N,-,-1,-1
PILGRIM.txt,142970,143821,851,10,N,N,-,-1,-1
PILGRIM.txt,142977,143986,1009,10,N,N,-,-1,-1
PILGRIM.txt,143176,144016,840,10,N,N,-,-1,-1
PILGRIM.txt,143229,144020,791,10,N,N,-,-1,-1
PILGRIM.txt,143235,144036,801,10,N,N,-,-1,-1
PILGRIM.txt,143279,144549,1270,10,N,N,-,-1,-1
PILGRIM.txt,143391,144790,1399,10,N,N,-,-1,-1
PILGRIM.txt,143481,145028,1547,10,N,N,-,-1,-1
PILGRIM.txt,143699,145131,1432,10,N,N,-,-1,-1
PILGRIM.txt,143815,145338,1523,10,N,N,-,-1,-1
PILGRIM.txt,143822,145432,1610,10,N,N,-,-1,-1
PILGRIM.txt,143991,145531,1540,10,N,N,-,-1,-1
PILGRIM.txt,144017,145718,1701,10,N,N,-,-1,-1
PILGRIM.txt,144025,145863,1838,10,N,N,-,-1,-1
PILGRIM.txt,144039,145999,1960,10,N,N,-,-1,-1
PILGRIM.txt,144552,146168,1616,10,N,N,-,-1,-1
PILGRIM.txt,144791,146197,1406,10,N,N,-,-1,-1
PILGRIM.txt,145029,146341,1312,10,N,Y,1437471855423,351318,351853
PILGRIM.txt,145132,146432,1300,10,N,Y,1437471855423,351318,351853
PILGRIM.txt,145341,146579,1238,10,N,Y,1437471855423,351318,351853
PILGRIM.txt,145433,146648,1215,10,N,Y,1437471855423,351318,351853
PILGRIM.txt,145532,146864,1332,10,N,Y,1437471855423,351318,351853
PILGRIM.txt,145719,147145,1426,10,N,Y,1437471855423,351318,351853
PILGRIM.txt,145866,147272,1406,10,N,Y,1437471855423,351318,351853
PILGRIM.txt,146000,147353,1353,10,N,Y,1437471855423,351318,351853
PILGRIM.txt,146169,147583,1414,10,N,Y,1437471855423,351318,351853
PILGRIM.txt,146200,147773,1573,10,N,Y,1437471855423,351318,351853
PILGRIM.txt,146342,147907,1565,10,N,Y,1437471855423,351318,351853
PILGRIM.txt,146433,148030,1597,10,N,Y,1437471855423,351318,351853
PILGRIM.txt,146580,148121,1541,10,N,Y,1437471855423,351318,351853
PILGRIM.txt,146649,148233,1584,10,N,Y,1437471855423,351318,351853
PILGRIM.txt,146865,148558,1693,10,N,Y,1437471855423,351318,351853
PILGRIM.txt,147146,148711,1565,10,N,Y,1437471855423,351318,351853
PILGRIM.txt,147273,148805,1532,10,N,Y,1437471855423,351318,351853
PILGRIM.txt,147354,148941,1587,10,N,Y,1437471855423,351318,351853
PILGRIM.txt,147584,149052,1468,10,N,Y,1437471855423,351318,351853
PILGRIM.txt,147776,149229,1453,10,N,N,-,-1,-1
PILGRIM.txt,147908,149340,1432,10,N,N,-,-1,-1
PILGRIM.txt,148031,149517,1486,10,N,N,-,-1,-1
PILGRIM.txt,148122,149702,1580,10,N,N,-,-1,-1
PILGRIM.txt,148234,149881,1647,10,N,N,-,-1,-1
PILGRIM.txt,148559,149972,1413,10,N,N,-,-1,-1
PILGRIM.txt,148712,150114,1402,10,N,N,-,-1,-1
PILGRIM.txt,148806,150282,1476,10,N,N,-,-1,-1
PILGRIM.txt,148942,150474,1532,10,N,N,-,-1,-1
PILGRIM.txt,149055,150530,1475,10,N,N,-,-1,-1
PILGRIM.txt,149230,150758,1528,10,N,N,-,-1,-1
PILGRIM.txt,149341,150847,1506,10,N,N,-,-1,-1
PILGRIM.txt,149518,150978,1460,10,N,N,-,-1,-1
PILGRIM.txt,149705,151057,1352,10,N,N,-,-1,-1
PILGRIM.txt,149881,151059,1178,10,N,N,-,-1,-1
PILGRIM.txt,149973,151242,1269,10,N,N,-,-1,-1
PILGRIM.txt,150115,151314,1199,10,N,N,-,-1,-1
PILGRIM.txt,150283,151594,1311,10,N,N,-,-1,-1
PILGRIM.txt,150475,151749,1274,10,N,N,-,-1,-1
PILGRIM.txt,150531,151807,1276,10,N,N,-,-1,-1
PILGRIM.txt,150759,151908,1149,10,N,N,-,-1,-1
PILGRIM.txt,150848,152019,1171,10,N,N,-,-1,-1
PILGRIM.txt,150979,152114,1135,10,N,N,-,-1,-1
PILGRIM.txt,151058,152203,1145,10,N,N,-,-1,-1
PILGRIM.txt,151060,152297,1237,10,N,N,-,-1,-1
PILGRIM.txt,151243,152494,1251,10,N,N,-,-1,-1
PILGRIM.txt,151316,152833,1517,10,N,N,-,-1,-1
PILGRIM.txt,151596,153067,1471,10,N,N,-,-1,-1
PILGRIM.txt,151750,153257,1507,10,N,N,-,-1,-1
PILGRIM.txt,151812,153328,1516,10,N,N,-,-1,-1
PILGRIM.txt,151909,153535,1626,10,N,N,-,-1,-1
PILGRIM.txt,152020,153796,1776,10,N,N,-,-1,-1
PILGRIM.txt,152117,153931,1814,10,N,N,-,-1,-1
PILGRIM.txt,152204,154281,2077,10,N,N,-,-1,-1
PILGRIM.txt,152298,154475,2177,10,N,N,-,-1,-1
PILGRIM.txt,152495,154576,2081,10,N,N,-,-1,-1
PILGRIM.txt,152834,154666,1832,10,N,N,-,-1,-1
PILGRIM.txt,153068,154734,1666,10,N,N,-,-1,-1
PILGRIM.txt,153260,154909,1649,10,N,N,-,-1,-1
PILGRIM.txt,153329,155025,1696,10,N,N,-,-1,-1
PILGRIM.txt,153536,155180,1644,10,N,N,-,-1,-1
PILGRIM.txt,153797,155273,1476,10,N,N,-,-1,-1
PILGRIM.txt,153932,155444,1512,10,N,N,-,-1,-1
PILGRIM.txt,154282,155648,1366,10,N,N,-,-1,-1
PILGRIM.txt,154476,155788,1312,10,N,N,-,-1,-1
PILGRIM.txt,154577,155816,1239,10,N,N,-,-1,-1
PILGRIM.txt,154669,155988,1319,10,N,N,-,-1,-1
PILGRIM.txt,154735,156143,1408,10,N,N,-,-1,-1
PILGRIM.txt,154910,156235,1325,10,N,N,-,-1,-1
PILGRIM.txt,155027,156400,1373,10,N,N,-,-1,-1
PILGRIM.txt,155181,156553,1372,10,N,N,-,-1,-1
PILGRIM.txt,155274,156788,1514,10,N,N,-,-1,-1
PILGRIM.txt,155445,156961,1516,10,N,N,-,-1,-1
PILGRIM.txt,155650,157104,1454,10,N,N,-,-1,-1
PILGRIM.txt,155789,157265,1476,10,N,N,-,-1,-1
PILGRIM.txt,155817,157484,1667,10,N,N,-,-1,-1
PILGRIM.txt,155989,157591,1602,10,N,N,-,-1,-1
PILGRIM.txt,156144,157625,1481,10,N,N,-,-1,-1
PILGRIM.txt,156236,157656,1420,10,N,N,-,-1,-1
PILGRIM.txt,156401,157796,1395,10,N,N,-,-1,-1
PILGRIM.txt,156554,157854,1300,10,N,N,-,-1,-1
PILGRIM.txt,156789,158021,1232,10,N,N,-,-1,-1
PILGRIM.txt,156963,158114,1151,10,N,N,-,-1,-1
PILGRIM.txt,157105,158180,1075,10,N,N,-,-1,-1
PILGRIM.txt,157266,158435,1169,10,N,N,-,-1,-1
PILGRIM.txt,157485,158492,1007,10,N,N,-,-1,-1
PILGRIM.txt,157592,158581,989,10,N,N,-,-1,-1
PILGRIM.txt,157626,158702,1076,10,N,N,-,-1,-1
PILGRIM.txt,157659,158760,1101,10,N,N,-,-1,-1
PILGRIM.txt,157797,158820,1023,10,N,N,-,-1,-1
PILGRIM.txt,157855,159039,1184,10,N,N,-,-1,-1
PILGRIM.txt,158022,159149,1127,10,N,N,-,-1,-1
PILGRIM.txt,158115,159273,1158,10,N,N,-,-1,-1
PILGRIM.txt,158181,159483,1302,10,N,N,-,-1,-1
PILGRIM.txt,158436,159555,1119,10,N,N,-,-1,-1
PILGRIM.txt,158493,159686,1193,10,N,N,-,-1,-1
PILGRIM.txt,158582,159812,1230,10,N,N,-,-1,-1
PILGRIM.txt,158703,159845,1142,10,N,N,-,-1,-1
PILGRIM.txt,158761,159950,1189,10,N,N,-,-1,-1
PILGRIM.txt,158821,160194,1373,10,N,N,-,-1,-1
PILGRIM.txt,159040,160272,1232,10,N,N,-,-1,-1
PILGRIM.txt,159150,160486,1336,10,N,N,-,-1,-1
PILGRIM.txt,159274,160593,1319,10,N,N,-,-1,-1
PILGRIM.txt,159484,160693,1209,10,N,N,-,-1,-1
PILGRIM.txt,159556,160882,1326,10,N,N,-,-1,-1
PILGRIM.txt,159687,161070,1383,10,N,N,-,-1,-1
PILGRIM.txt,159813,161241,1428,10,N,N,-,-1,-1
PILGRIM.txt,159846,161474,1628,10,N,N,-,-1,-1
PILGRIM.txt,159951,161535,1584,10,N,N,-,-1,-1
PILGRIM.txt,160195,161698,1503,10,N,N,-,-1,-1
PILGRIM.txt,160273,161843,1570,10,N,N,-,-1,-1
PILGRIM.txt,160487,161926,1439,10,N,N,-,-1,-1
PILGRIM.txt,160596,162036,1440,10,Y,N,-,-1,-1
PILGRIM.txt,160694,162199,1505,10,N,N,-,-1,-1
PILGRIM.txt,160883,162383,1500,10,N,N,-,-1,-1
PILGRIM.txt,161071,162512,1441,10,N,N,-,-1,-1
PILGRIM.txt,161243,162689,1446,10,Y,N,-,-1,-1
PILGRIM.txt,161475,162811,1336,10,Y,N,-,-1,-1
PILGRIM.txt,161538,162907,1369,10,Y,N,-,-1,-1
PILGRIM.txt,161699,163185,1486,10,Y,N,-,-1,-1
PILGRIM.txt,161844,163251,1407,10,N,N,-,-1,-1
PILGRIM.txt,161928,163461,1533,10,N,N,-,-1,-1
PILGRIM.txt,162038,163559,1521,10,N,N,-,-1,-1
PILGRIM.txt,162200,163780,1580,10,N,N,-,-1,-1
PILGRIM.txt,162384,163972,1588,10,N,N,-,-1,-1
PILGRIM.txt,162513,164234,1721,10,N,N,-,-1,-1
PILGRIM.txt,162690,164339,1649,10,N,N,-,-1,-1
PILGRIM.txt,162812,164490,1678,10,N,N,-,-1,-1
PILGRIM.txt,162908,164576,1668,10,N,N,-,-1,-1
PILGRIM.txt,163186,164767,1581,10,N,N,-,-1,-1
PILGRIM.txt,163253,164867,1614,10,N,N,-,-1,-1
PILGRIM.txt,163462,164895,1433,10,N,N,-,-1,-1
PILGRIM.txt,163560,165053,1493,10,Y,N,-,-1,-1
PILGRIM.txt,163781,165191,1410,10,Y,N,-,-1,-1
PILGRIM.txt,163975,165280,1305,10,N,N,-,-1,-1
PILGRIM.txt,164235,165287,1052,10,N,N,-,-1,-1
PILGRIM.txt,164341,165354,1013,10,N,N,-,-1,-1
PILGRIM.txt,164491,165645,1154,10,N,N,-,-1,-1
PILGRIM.txt,164577,165706,1129,10,N,N,-,-1,-1
PILGRIM.txt,164768,165926,1158,10,N,N,-,-1,-1
PILGRIM.txt,164869,166099,1230,10,N,N,-,-1,-1
PILGRIM.txt,164898,166172,1274,10,N,N,-,-1,-1
PILGRIM.txt,165054,166429,1375,10,N,N,-,-1,-1
PILGRIM.txt,165192,166564,1372,10,N,N,-,-1,-1
PILGRIM.txt,165283,166661,1378,10,N,N,-,-1,-1
PILGRIM.txt,165288,166801,1513,10,N,N,-,-1,-1
PILGRIM.txt,165360,166942,1582,10,N,N,-,-1,-1
PILGRIM.txt,165647,167223,1576,10,N,N,-,-1,-1
PILGRIM.txt,165707,167479,1772,10,N,N,-,-1,-1
PILGRIM.txt,165927,167516,1589,10,N,N,-,-1,-1
PILGRIM.txt,166099,167659,1560,10,N,N,-,-1,-1
PILGRIM.txt,166173,167715,1542,10,N,N,-,-1,-1
PILGRIM.txt,166430,167770,1340,10,N,N,-,-1,-1
PILGRIM.txt,166565,167872,1307,10,N,N,-,-1,-1
PILGRIM.txt,166663,167949,1286,10,N,N,-,-1,-1
PILGRIM.txt,166802,168183,1381,10,N,N,-,-1,-1
PILGRIM.txt,166943,168337,1394,10,N,N,-,-1,-1
PILGRIM.txt,167224,168466,1242,10,N,N,-,-1,-1
PILGRIM.txt,167480,168541,1061,10,N,N,-,-1,-1
PILGRIM.txt,167517,168664,1147,10,N,N,-,-1,-1
PILGRIM.txt,167660,168712,1052,10,N,N,-,-1,-1
PILGRIM.txt,167716,168800,1084,10,N,N,-,-1,-1
PILGRIM.txt,167771,168907,1136,10,N,N,-,-1,-1
PILGRIM.txt,167873,169187,1314,10,N,N,-,-1,-1
PILGRIM.txt,167951,169362,1411,10,N,N,-,-1,-1
PILGRIM.txt,168184,169546,1362,10,N,N,-,-1,-1
PILGRIM.txt,168338,169676,1338,10,N,N,-,-1,-1
PILGRIM.txt,168467,169847,1380,10,N,N,-,-1,-1
PILGRIM.txt,168543,169963,1420,10,N,N,-,-1,-1
PILGRIM.txt,168665,170054,1389,10,N,N,-,-1,-1
PILGRIM.txt,168715,170200,1485,10,N,N,-,-1,-1
PILGRIM.txt,168803,170483,1680,10,N,N,-,-1,-1
PILGRIM.txt,168909,170623,1714,10,N,N,-,-1,-1
PILGRIM.txt,169188,170837,1649,10,N,N,-,-1,-1
PILGRIM.txt,169363,170912,1549,10,N,N,-,-1,-1
PILGRIM.txt,169549,171024,1475,10,N,N,-,-1,-1
PILGRIM.txt,169679,171196,1517,10,N,N,-,-1,-1
PILGRIM.txt,169848,171416,1568,10,N,N,-,-1,-1
PILGRIM.txt,169966,171487,1521,10,N,N,-,-1,-1
PILGRIM.txt,170055,171550,1495,10,N,N,-,-1,-1
PILGRIM.txt,170201,171804,1603,10,N,N,-,-1,-1
PILGRIM.txt,170486,171945,1459,10,N,N,-,-1,-1
PILGRIM.txt,170624,172151,1527,10,N,N,-,-1,-1
PILGRIM.txt,170838,172346,1508,10,N,N,-,-1,-1
PILGRIM.txt,170913,172347,1434,10,N,N,-,-1,-1
PILGRIM.txt,171025,172519,1494,10,N,N,-,-1,-1
PILGRIM.txt,171197,172574,1377,10,N,N,-,-1,-1
PILGRIM.txt,171419,172891,1472,10,N,N,-,-1,-1
PILGRIM.txt,171488,173007,1519,10,N,N,-,-1,-1
PILGRIM.txt,171551,173351,1800,10,N,N,-,-1,-1
PILGRIM.txt,171806,173951,2145,10,N,N,-,-1,-1
PILGRIM.txt,171946,174193,2247,10,N,N,-,-1,-1
PILGRIM.txt,172152,174385,2233,10,N,N,-,-1,-1
PILGRIM.txt,172346,174449,2103,10,N,N,-,-1,-1
PILGRIM.txt,172349,174622,2273,10,N,N,-,-1,-1
PILGRIM.txt,172520,174808,2288,10,N,N,-,-1,-1
PILGRIM.txt,172575,174883,2308,10,N,N,-,-1,-1
PILGRIM.txt,172892,175065,2173,10,N,N,-,-1,-1
PILGRIM.txt,173008,175210,2202,10,N,N,-,-1,-1
PILGRIM.txt,173352,175217,1865,10,N,N,-,-1,-1
PILGRIM.txt,173954,175324,1370,10,N,N,-,-1,-1
PILGRIM.txt,174194,175508,1314,10,N,N,-,-1,-1
PILGRIM.txt,174386,175711,1325,10,N,N,-,-1,-1
PILGRIM.txt,174452,175836,1384,10,N,N,-,-1,-1
PILGRIM.txt,174623,176001,1378,10,N,N,-,-1,-1
PILGRIM.txt,174809,176080,1271,10,N,N,-,-1,-1
PILGRIM.txt,174884,176414,1530,10,N,N,-,-1,-1
PILGRIM.txt,175066,176539,1473,10,N,N,-,-1,-1
PILGRIM.txt,175212,176777,1565,10,N,N,-,-1,-1
PILGRIM.txt,175218,176834,1616,10,N,N,-,-1,-1
PILGRIM.txt,175327,176975,1648,10,N,N,-,-1,-1
PILGRIM.txt,175509,177159,1650,10,N,N,-,-1,-1
PILGRIM.txt,175714,177309,1595,10,N,N,-,-1,-1
PILGRIM.txt,175837,177590,1753,10,N,N,-,-1,-1
PILGRIM.txt,176002,177680,1678,10,N,N,-,-1,-1
PILGRIM.txt,176083,177864,1781,10,N,N,-,-1,-1
PILGRIM.txt,176415,177933,1518,10,N,N,-,-1,-1
PILGRIM.txt,176541,177989,1448,10,N,N,-,-1,-1
PILGRIM.txt,176782,178065,1283,10,N,N,-,-1,-1
PILGRIM.txt,176839,178132,1293,10,N,N,-,-1,-1
PILGRIM.txt,176976,178311,1335,10,N,N,-,-1,-1
PILGRIM.txt,177160,178442,1282,10,N,N,-,-1,-1
PILGRIM.txt,177310,178727,1417,10,N,N,-,-1,-1
PILGRIM.txt,177591,178881,1290,10,N,N,-,-1,-1
PILGRIM.txt,177683,178995,1312,10,N,N,-,-1,-1
PILGRIM.txt,177867,179226,1359,10,N,N,-,-1,-1
PILGRIM.txt,177934,179345,1411,10,N,N,-,-1,-1
PILGRIM.txt,177990,179386,1396,10,N,N,-,-1,-1
PILGRIM.txt,178066,179625,1559,10,N,N,-,-1,-1
PILGRIM.txt,178133,179788,1655,10,N,N,-,-1,-1
PILGRIM.txt,178312,179945,1633,10,N,N,-,-1,-1
PILGRIM.txt,178445,180107,1662,10,N,N,-,-1,-1
PILGRIM.txt,178732,180124,1392,10,N,N,-,-1,-1
PILGRIM.txt,178882,180207,1325,10,N,N,-,-1,-1
PILGRIM.txt,178996,180480,1484,10,N,N,-,-1,-1
PILGRIM.txt,179229,180522,1293,10,N,N,-,-1,-1
PILGRIM.txt,179346,180658,1312,10,N,N,-,-1,-1
PILGRIM.txt,179388,180864,1476,10,N,N,-,-1,-1
PILGRIM.txt,179626,181076,1450,10,N,N,-,-1,-1
PILGRIM.txt,179789,181231,1442,10,N,N,-,-1,-1
PILGRIM.txt,179948,181413,1465,10,N,N,-,-1,-1
PILGRIM.txt,180112,181524,1412,10,N,N,-,-1,-1
PILGRIM.txt,180127,181659,1532,10,N,N,-,-1,-1
PILGRIM.txt,180208,181835,1627,10,N,N,-,-1,-1
PILGRIM.txt,180483,181903,1420,10,N,N,-,-1,-1
PILGRIM.txt,180523,182071,1548,10,N,N,-,-1,-1
PILGRIM.txt,180659,182239,1580,10,N,N,-,-1,-1
PILGRIM.txt,180865,182405,1540,10,N,N,-,-1,-1
PILGRIM.txt,181077,182498,1421,10,N,N,-,-1,-1
PILGRIM.txt,181233,182626,1393,10,N,N,-,-1,-1
PILGRIM.txt,181414,182721,1307,10,N,N,-,-1,-1
PILGRIM.txt,181525,182786,1261,10,N,N,-,-1,-1
PILGRIM.txt,181660,182831,1171,10,N,N,-,-1,-1
PILGRIM.txt,181836,182910,1074,10,N,N,-,-1,-1
PILGRIM.txt,181904,183007,1103,10,N,N,-,-1,-1
PILGRIM.txt,182072,183026,954,10,N,N,-,-1,-1
PILGRIM.txt,182240,183156,916,10,N,N,-,-1,-1
PILGRIM.txt,182408,183240,832,10,N,N,-,-1,-1
PILGRIM.txt,182499,183293,794,10,N,N,-,-1,-1
PILGRIM.txt,182627,183408,781,10,N,N,-,-1,-1
PILGRIM.txt,182722,183552,830,10,N,N,-,-1,-1
PILGRIM.txt,182787,183631,844,10,N,N,-,-1,-1
PILGRIM.txt,182832,183809,977,10,N,N,-,-1,-1
PILGRIM.txt,182911,184009,1098,10,N,N,-,-1,-1
PILGRIM.txt,183008,184172,1164,10,N,N,-,-1,-1
PILGRIM.txt,183027,184295,1268,10,N,N,-,-1,-1
PILGRIM.txt,183157,184424,1267,10,N,N,-,-1,-1
PILGRIM.txt,183241,184507,1266,10,N,N,-,-1,-1
PILGRIM.txt,183294,184631,1337,10,N,N,-,-1,-1
PILGRIM.txt,183409,184728,1319,10,N,N,-,-1,-1
PILGRIM.txt,183553,185002,1449,10,N,N,-,-1,-1
PILGRIM.txt,183632,185241,1609,10,N,N,-,-1,-1
PILGRIM.txt,183812,185326,1514,10,N,N,-,-1,-1
PILGRIM.txt,184010,185388,1378,10,N,N,-,-1,-1
PILGRIM.txt,184173,185396,1223,10,N,N,-,-1,-1
PILGRIM.txt,184296,185600,1304,10,N,N,-,-1,-1
PILGRIM.txt,184425,185683,1258,10,N,N,-,-1,-1
PILGRIM.txt,184508,185775,1267,10,N,N,-,-1,-1
PILGRIM.txt,184632,185836,1204,10,N,N,-,-1,-1
PILGRIM.txt,184729,185928,1199,10,N,N,-,-1,-1
PILGRIM.txt,185005,186047,1042,10,N,N,-,-1,-1
PILGRIM.txt,185242,186092,850,10,N,N,-,-1,-1
PILGRIM.txt,185329,186306,977,10,N,N,-,-1,-1
PILGRIM.txt,185389,186416,1027,10,N,N,-,-1,-1
PILGRIM.txt,185397,186496,1099,10,N,N,-,-1,-1
PILGRIM.txt,185601,186584,983,10,N,N,-,-1,-1
PILGRIM.txt,185685,186736,1051,10,N,N,-,-1,-1
PILGRIM.txt,185776,186832,1056,10,N,N,-,-1,-1
PILGRIM.txt,185837,186947,1110,10,N,N,-,-1,-1
PILGRIM.txt,185929,186967,1038,10,N,N,-,-1,-1
PILGRIM.txt,186048,186978,930,10,N,N,-,-1,-1
PILGRIM.txt,186093,187039,946,10,N,N,-,-1,-1
PILGRIM.txt,186307,187146,839,10,N,N,-,-1,-1
PILGRIM.txt,186417,187268,851,10,N,N,-,-1,-1
PILGRIM.txt,186497,187385,888,10,N,N,-,-1,-1
PILGRIM.txt,186585,187446,861,10,N,N,-,-1,-1
PILGRIM.txt,186738,187457,719,10,N,N,-,-1,-1
PILGRIM.txt,186833,187507,674,10,N,N,-,-1,-1
PILGRIM.txt,186949,187560,611,10,N,N,-,-1,-1
PILGRIM.txt,186970,187593,623,10,N,N,-,-1,-1
PILGRIM.txt,186981,187606,625,10,N,N,-,-1,-1
PILGRIM.txt,187041,187632,591,10,N,N,-,-1,-1
PILGRIM.txt,187148,187638,490,10,N,N,-,-1,-1
PILGRIM.txt,187270,187671,401,10,N,N,-,-1,-1
PILGRIM.txt,187388,187910,522,10,N,N,-,-1,-1
PILGRIM.txt,187448,188241,793,10,N,N,-,-1,-1
PILGRIM.txt,187458,188288,830,10,N,N,-,-1,-1
PILGRIM.txt,187512,188301,789,10,N,N,-,-1,-1
PILGRIM.txt,187565,188486,921,10,N,N,-,-1,-1
PILGRIM.txt,187598,188494,896,10,N,N,-,-1,-1
PILGRIM.txt,187609,188530,921,10,N,N,-,-1,-1
PILGRIM.txt,187637,188613,976,10,N,N,-,-1,-1
PILGRIM.txt,187638,188645,1007,10,N,N,-,-1,-1
PILGRIM.txt,187671,188680,1009,10,N,N,-,-1,-1
PILGRIM.txt,187911,188698,787,10,N,N,-,-1,-1
PILGRIM.txt,188242,188742,500,10,N,N,-,-1,-1
PILGRIM.txt,188293,188895,602,10,N,N,-,-1,-1
PILGRIM.txt,188302,188967,665,10,N,N,-,-1,-1
PILGRIM.txt,188491,189055,564,10,N,N,-,-1,-1
PILGRIM.txt,188495,189152,657,10,N,N,-,-1,-1
PILGRIM.txt,188535,189217,682,10,N,N,-,-1,-1
PILGRIM.txt,188613,189281,668,10,N,N,-,-1,-1
PILGRIM.txt,188650,189413,763,10,N,N,-,-1,-1
PILGRIM.txt,188685,189504,819,10,N,N,-,-1,-1
PILGRIM.txt,188701,189604,903,10,N,N,-,-1,-1
PILGRIM.txt,188747,189652,905,10,N,N,-,-1,-1
PILGRIM.txt,188896,189724,828,10,N,N,-,-1,-1
PILGRIM.txt,188968,189867,899,10,N,N,-,-1,-1
PILGRIM.txt,189056,189938,882,10,N,N,-,-1,-1
PILGRIM.txt,189153,190003,850,10,N,N,-,-1,-1
PILGRIM.txt,189218,190066,848,10,N,N,-,-1,-1
PILGRIM.txt,189282,190108,826,10,N,N,-,-1,-1
PILGRIM.txt,189414,190203,789,10,N,N,-,-1,-1
PILGRIM.txt,189505,190262,757,10,N,N,-,-1,-1
PILGRIM.txt,189605,190395,790,10,N,N,-,-1,-1
PILGRIM.txt,189653,190595,942,10,N,N,-,-1,-1
PILGRIM.txt,189725,190623,898,10,N,N,-,-1,-1
PILGRIM.txt,189868,190883,1015,10,N,N,-,-1,-1
PILGRIM.txt,189939,191108,1169,10,N,N,-,-1,-1
PILGRIM.txt,190004,191152,1148,10,N,N,-,-1,-1
PILGRIM.txt,190068,191252,1184,10,N,N,-,-1,-1
PILGRIM.txt,190111,191327,1216,10,N,N,-,-1,-1
PILGRIM.txt,190204,191443,1239,10,N,N,-,-1,-1
PILGRIM.txt,190263,191515,1252,10,N,N,-,-1,-1
PILGRIM.txt,190396,191558,1162,10,N,N,-,-1,-1
PILGRIM.txt,190597,191632,1035,10,N,N,-,-1,-1
PILGRIM.txt,190624,191708,1084,10,N,N,-,-1,-1
PILGRIM.txt,190884,191828,944,10,N,N,-,-1,-1
PILGRIM.txt,191109,191914,805,10,N,N,-,-1,-1
PILGRIM.txt,191155,192051,896,10,N,N,-,-1,-1
PILGRIM.txt,191253,192137,884,10,N,N,-,-1,-1
PILGRIM.txt,191328,192191,863,10,N,N,-,-1,-1
PILGRIM.txt,191444,192297,853,10,N,N,-,-1,-1
PILGRIM.txt,191516,192335,819,10,N,N,-,-1,-1
PILGRIM.txt,191561,192461,900,10,N,N,-,-1,-1
PILGRIM.txt,191633,192609,976,10,N,N,-,-1,-1
PILGRIM.txt,191709,192766,1057,10,N,N,-,-1,-1
PILGRIM.txt,191829,193057,1228,10,N,N,-,-1,-1
PILGRIM.txt,191915,193245,1330,10,N,N,-,-1,-1
PILGRIM.txt,192053,193308,1255,10,N,N,-,-1,-1
PILGRIM.txt,192138,193386,1248,10,N,N,-,-1,-1
PILGRIM.txt,192192,193583,1391,10,N,N,-,-1,-1
PILGRIM.txt,192298,193666,1368,10,N,N,-,-1,-1
PILGRIM.txt,192338,193723,1385,10,N,N,-,-1,-1
PILGRIM.txt,192462,193875,1413,10,N,N,-,-1,-1
PILGRIM.txt,192614,193935,1321,10,N,N,-,-1,-1
PILGRIM.txt,192767,193945,1178,10,N,N,-,-1,-1
PILGRIM.txt,193060,193984,924,10,N,N,-,-1,-1
PILGRIM.txt,193248,194069,821,10,N,N,-,-1,-1
PILGRIM.txt,193309,194111,802,10,N,N,-,-1,-1
PILGRIM.txt,193387,194247,860,10,N,N,-,-1,-1
PILGRIM.txt,193584,194312,728,10,N,N,-,-1,-1
PILGRIM.txt,193669,194668,999,10,N,N,-,-1,-1
PILGRIM.txt,193725,194892,1167,10,N,N,-,-1,-1
PILGRIM.txt,193876,194992,1116,10,N,N,-,-1,-1
PILGRIM.txt,193936,195054,1118,10,N,N,-,-1,-1
PILGRIM.txt,193946,195216,1270,10,N,N,-,-1,-1
PILGRIM.txt,193985,195296,1311,10,N,N,-,-1,-1
PILGRIM.txt,194072,195429,1357,10,N,N,-,-1,-1
PILGRIM.txt,194112,195610,1498,10,N,N,-,-1,-1
PILGRIM.txt,194248,195700,1452,10,N,N,-,-1,-1
PILGRIM.txt,194314,195769,1455,10,N,N,-,-1,-1
PILGRIM.txt,194669,195851,1182,10,N,N,-,-1,-1
PILGRIM.txt,194893,195911,1018,10,N,N,-,-1,-1
PILGRIM.txt,194994,196052,1058,10,N,N,-,-1,-1
PILGRIM.txt,195057,196233,1176,10,N,N,-,-1,-1
PILGRIM.txt,195218,196515,1297,10,N,N,-,-1,-1
PILGRIM.txt,195297,196602,1305,10,N,N,-,-1,-1
PILGRIM.txt,195430,196699,1269,10,N,N,-,-1,-1
PILGRIM.txt,195611,196835,1224,10,N,N,-,-1,-1
PILGRIM.txt,195701,196975,1274,10,N,N,-,-1,-1
PILGRIM.txt,195770,197009,1239,10,N,N,-,-1,-1
PILGRIM.txt,195852,197138,1286,10,N,N,-,-1,-1
PILGRIM.txt,195912,197304,1392,10,N,N,-,-1,-1
PILGRIM.txt,196053,197406,1353,10,N,N,-,-1,-1
PILGRIM.txt,196235,197732,1497,10,N,N,-,-1,-1
PILGRIM.txt,196518,197796,1278,10,N,N,-,-1,-1
PILGRIM.txt,196603,197935,1332,10,N,N,-,-1,-1
PILGRIM.txt,196700,198033,1333,10,N,N,-,-1,-1
PILGRIM.txt,196836,198333,1497,10,N,N,-,-1,-1
PILGRIM.txt,196976,198397,1421,10,N,N,-,-1,-1
PILGRIM.txt,197011,198441,1430,10,N,N,-,-1,-1
PILGRIM.txt,197139,198586,1447,10,N,N,-,-1,-1
PILGRIM.txt,197305,198616,1311,10,N,N,-,-1,-1
PILGRIM.txt,197407,198825,1418,10,N,N,-,-1,-1
PILGRIM.txt,197733,198980,1247,10,N,N,-,-1,-1
PILGRIM.txt,197799,199153,1354,10,N,N,-,-1,-1
PILGRIM.txt,197938,199259,1321,10,N,N,-,-1,-1
PILGRIM.txt,198034,199411,1377,10,N,N,-,-1,-1
PILGRIM.txt,198334,199538,1204,10,N,N,-,-1,-1
PILGRIM.txt,198398,199651,1253,10,N,N,-,-1,-1
PILGRIM.txt,198444,199769,1325,10,N,N,-,-1,-1
PILGRIM.txt,198587,199801,1214,10,N,N,-,-1,-1
PILGRIM.txt,198617,199869,1252,10,N,N,-,-1,-1
PILGRIM.txt,198827,199904,1077,10,N,N,-,-1,-1
PILGRIM.txt,198981,199944,963,10,N,N,-,-1,-1
PILGRIM.txt,199154,200041,887,10,N,N,-,-1,-1
PILGRIM.txt,199260,200296,1036,10,N,N,-,-1,-1
PILGRIM.txt,199412,200534,1122,10,N,N,-,-1,-1
PILGRIM.txt,199539,200669,1130,10,N,N,-,-1,-1
PILGRIM.txt,199652,200755,1103,10,N,N,-,-1,-1
PILGRIM.txt,199770,200819,1049,10,N,N,-,-1,-1
PILGRIM.txt,199802,200903,1101,10,N,N,-,-1,-1
PILGRIM.txt,199870,200985,1115,10,N,N,-,-1,-1
PILGRIM.txt,199905,201229,1324,10,N,N,-,-1,-1
PILGRIM.txt,199947,201414,1467,10,N,N,-,-1,-1
PILGRIM.txt,200042,201579,1537,10,N,N,-,-1,-1
PILGRIM.txt,200297,201674,1377,10,N,N,-,-1,-1
PILGRIM.txt,200537,201780,1243,10,N,N,-,-1,-1
PILGRIM.txt,200672,201878,1206,10,N,N,-,-1,-1
PILGRIM.txt,200756,202068,1312,10,N,N,-,-1,-1
PILGRIM.txt,200820,202170,1350,10,N,N,-,-1,-1
PILGRIM.txt,200904,202357,1453,10,N,N,-,-1,-1
PILGRIM.txt,200987,202600,1613,10,N,N,-,-1,-1
PILGRIM.txt,201230,202772,1542,10,N,N,-,-1,-1
PILGRIM.txt,201415,202868,1453,10,N,N,-,-1,-1
PILGRIM.txt,201580,202972,1392,10,N,N,-,-1,-1
PILGRIM.txt,201675,203010,1335,10,N,N,-,-1,-1
PILGRIM.txt,201781,203039,1258,10,N,N,-,-1,-1
PILGRIM.txt,201883,203134,1251,10,N,N,-,-1,-1
PILGRIM.txt,202070,203217,1147,10,N,N,-,-1,-1
PILGRIM.txt,202171,203304,1133,10,N,N,-,-1,-1
PILGRIM.txt,202360,203456,1096,10,N,N,-,-1,-1
PILGRIM.txt,202601,203541,940,10,N,N,-,-1,-1
PILGRIM.txt,202775,203621,846,10,N,N,-,-1,-1
PILGRIM.txt,202869,203753,884,10,N,N,-,-1,-1
PILGRIM.txt,202973,203932,959,10,N,N,-,-1,-1
PILGRIM.txt,203011,203985,974,10,N,N,-,-1,-1
PILGRIM.txt,203040,204134,1094,10,N,N,-,-1,-1
PILGRIM.txt,203135,204301,1166,10,N,N,-,-1,-1
PILGRIM.txt,203219,204396,1177,10,N,N,-,-1,-1
PILGRIM.txt,203305,204494,1189,10,N,N,-,-1,-1
PILGRIM.txt,203457,204521,1064,10,N,N,-,-1,-1
PILGRIM.txt,203542,204528,986,10,N,N,-,-1,-1
PILGRIM.txt,203622,204632,1010,10,N,N,-,-1,-1
PILGRIM.txt,203754,204669,915,10,N,N,-,-1,-1
PILGRIM.txt,203933,204825,892,10,N,N,-,-1,-1
PILGRIM.txt,203986,204966,980,10,N,N,-,-1,-1
PILGRIM.txt,204135,205084,949,10,N,N,-,-1,-1
PILGRIM.txt,204302,205232,930,10,N,N,-,-1,-1
PILGRIM.txt,204397,205322,925,10,N,N,-,-1,-1
PILGRIM.txt,204495,205405,910,10,N,N,-,-1,-1
PILGRIM.txt,204522,205487,965,10,N,N,-,-1,-1
PILGRIM.txt,204529,205687,1158,10,N,N,-,-1,-1
PILGRIM.txt,204633,205853,1220,10,N,N,-,-1,-1
PILGRIM.txt,204672,205940,1268,10,N,N,-,-1,-1
PILGRIM.txt,204826,206023,1197,10,N,N,-,-1,-1
PILGRIM.txt,204967,206052,1085,10,N,N,-,-1,-1
PILGRIM.txt,205085,206073,988,10,N,N,-,-1,-1
PILGRIM.txt,205233,206124,891,10,N,N,-,-1,-1
PILGRIM.txt,205323,206136,813,10,N,N,-,-1,-1
PILGRIM.txt,205408,206188,780,10,N,N,-,-1,-1
PILGRIM.txt,205488,206298,810,10,N,N,-,-1,-1
PILGRIM.txt,205688,206444,756,10,N,N,-,-1,-1
PILGRIM.txt,205854,206688,834,10,N,N,-,-1,-1
PILGRIM.txt,205941,207054,1113,10,N,N,-,-1,-1
PILGRIM.txt,206024,207080,1056,10,N,N,-,-1,-1
PILGRIM.txt,206053,207237,1184,10,N,N,-,-1,-1
PILGRIM.txt,206074,207303,1229,10,N,N,-,-1,-1
PILGRIM.txt,206125,207608,1483,10,N,N,-,-1,-1
PILGRIM.txt,206137,207808,1671,10,N,N,-,-1,-1
PILGRIM.txt,206189,207991,1802,10,N,N,-,-1,-1
PILGRIM.txt,206301,208082,1781,10,N,N,-,-1,-1
PILGRIM.txt,206445,208218,1773,10,N,N,-,-1,-1
PILGRIM.txt,206691,208352,1661,10,N,N,-,-1,-1
PILGRIM.txt,207059,208520,1461,10,N,N,-,-1,-1
PILGRIM.txt,207085,208712,1627,10,N,N,-,-1,-1
PILGRIM.txt,207238,208853,1615,10,N,N,-,-1,-1
PILGRIM.txt,207306,208966,1660,10,N,N,-,-1,-1
PILGRIM.txt,207609,209082,1473,10,N,N,-,-1,-1
PILGRIM.txt,207811,209310,1499,10,N,N,-,-1,-1
PILGRIM.txt,207992,209392,1400,10,N,N,-,-1,-1
PILGRIM.txt,208085,209487,1402,10,N,N,-,-1,-1
PILGRIM.txt,208219,209768,1549,10,N,N,-,-1,-1
PILGRIM.txt,208353,210074,1721,10,N,N,-,-1,-1
PILGRIM.txt,208522,210092,1570,10,N,N,-,-1,-1
PILGRIM.txt,208713,210272,1559,10,N,N,-,-1,-1
PILGRIM.txt,208854,210465,1611,10,N,N,-,-1,-1
PILGRIM.txt,208967,210562,1595,10,N,N,-,-1,-1
PILGRIM.txt,209083,210670,1587,10,N,N,-,-1,-1
PILGRIM.txt,209312,210775,1463,10,N,N,-,-1,-1
PILGRIM.txt,209393,210900,1507,10,N,N,-,-1,-1
PILGRIM.txt,209488,211013,1525,10,N,N,-,-1,-1
PILGRIM.txt,209769,211209,1440,10,N,N,-,-1,-1
PILGRIM.txt,210079,211349,1270,10,N,N,-,-1,-1
PILGRIM.txt,210095,211427,1332,10,N,N,-,-1,-1
PILGRIM.txt,210275,211512,1237,10,N,N,-,-1,-1
PILGRIM.txt,210466,211569,1103,10,N,N,-,-1,-1
PILGRIM.txt,210563,211636,1073,10,N,N,-,-1,-1
PILGRIM.txt,210671,211665,994,10,N,N,-,-1,-1
PILGRIM.txt,210776,211828,1052,10,N,N,-,-1,-1
PILGRIM.txt,210901,211874,973,10,N,N,-,-1,-1
PILGRIM.txt,211014,211964,950,10,N,N,-,-1,-1
PILGRIM.txt,211210,212079,869,10,N,N,-,-1,-1
PILGRIM.txt,211350,212200,850,10,N,N,-,-1,-1
PILGRIM.txt,211428,212284,856,10,N,N,-,-1,-1
PILGRIM.txt,211513,212458,945,10,N,N,-,-1,-1
PILGRIM.txt,211570,212780,1210,10,N,N,-,-1,-1
PILGRIM.txt,211637,212874,1237,10,N,N,-,-1,-1
PILGRIM.txt,211666,212971,1305,10,N,N,-,-1,-1
PILGRIM.txt,211829,213062,1233,10,N,N,-,-1,-1
PILGRIM.txt,211875,213307,1432,10,N,N,-,-1,-1
PILGRIM.txt,211967,213326,1359,10,N,N,-,-1,-1
PILGRIM.txt,212081,213417,1336,10,N,N,-,-1,-1
PILGRIM.txt,212201,213570,1369,10,N,N,-,-1,-1
PILGRIM.txt,212286,213696,1410,10,N,N,-,-1,-1
PILGRIM.txt,212459,213732,1273,10,N,N,-,-1,-1
PILGRIM.txt,212783,213836,1053,10,N,N,-,-1,-1
PILGRIM.txt,212875,213880,1005,10,N,N,-,-1,-1
PILGRIM.txt,212972,213999,1027,10,N,N,-,-1,-1
PILGRIM.txt,213063,214078,1015,10,N,N,-,-1,-1
PILGRIM.txt,213308,214313,1005,10,N,N,-,-1,-1
PILGRIM.txt,213327,214367,1040,10,N,N,-,-1,-1
PILGRIM.txt,213418,214536,1118,10,N,N,-,-1,-1
PILGRIM.txt,213571,214644,1073,10,N,N,-,-1,-1
PILGRIM.txt,213697,214740,1043,10,N,N,-,-1,-1
PILGRIM.txt,213733,214897,1164,10,N,N,-,-1,-1
PILGRIM.txt,213837,214952,1115,10,N,N,-,-1,-1
PILGRIM.txt,213883,215102,1219,10,N,N,-,-1,-1
PILGRIM.txt,214000,215202,1202,10,N,N,-,-1,-1
PILGRIM.txt,214079,215314,1235,10,N,N,-,-1,-1
PILGRIM.txt,214314,215395,1081,10,N,N,-,-1,-1
PILGRIM.txt,214368,215451,1083,10,N,N,-,-1,-1
PILGRIM.txt,214537,215506,969,10,N,N,-,-1,-1
PILGRIM.txt,214645,215654,1009,10,N,N,-,-1,-1
PILGRIM.txt,214741,215762,1021,10,N,N,-,-1,-1
PILGRIM.txt,214898,215871,973,10,N,N,-,-1,-1
PILGRIM.txt,214953,216034,1081,10,N,N,-,-1,-1
PILGRIM.txt,215103,216096,993,10,N,N,-,-1,-1
PILGRIM.txt,215203,216174,971,10,N,N,-,-1,-1
PILGRIM.txt,215315,216288,973,10,N,N,-,-1,-1
PILGRIM.txt,215396,216446,1050,10,N,N,-,-1,-1
PILGRIM.txt,215452,216540,1088,10,N,N,-,-1,-1
PILGRIM.txt,215511,216663,1152,10,N,N,-,-1,-1
PILGRIM.txt,215655,216854,1199,10,N,N,-,-1,-1
PILGRIM.txt,215763,216961,1198,10,N,N,-,-1,-1
PILGRIM.txt,215872,217064,1192,10,N,N,-,-1,-1
PILGRIM.txt,216035,217250,1215,10,N,N,-,-1,-1
PILGRIM.txt,216097,217326,1229,10,N,N,-,-1,-1
PILGRIM.txt,216176,217481,1305,10,N,N,-,-1,-1
PILGRIM.txt,216289,217602,1313,10,N,N,-,-1,-1
PILGRIM.txt,216449,217693,1244,10,N,N,-,-1,-1
PILGRIM.txt,216541,217901,1360,10,N,N,-,-1,-1
PILGRIM.txt,216664,218034,1370,10,N,N,-,-1,-1
PILGRIM.txt,216855,218151,1296,10,N,N,-,-1,-1
PILGRIM.txt,216962,218178,1216,10,N,N,-,-1,-1
PILGRIM.txt,217065,218210,1145,10,N,N,-,-1,-1
PILGRIM.txt,217253,218217,964,10,N,N,-,-1,-1
PILGRIM.txt,217327,218252,925,10,N,N,-,-1,-1
PILGRIM.txt,217482,218275,793,10,N,N,-,-1,-1
PILGRIM.txt,217604,218353,749,10,N,N,-,-1,-1
PILGRIM.txt,217694,218370,676,10,N,N,-,-1,-1
PILGRIM.txt,217902,218394,492,10,N,N,-,-1,-1
PILGRIM.txt,218036,218412,376,10,N,N,-,-1,-1
PILGRIM.txt,218154,218488,334,10,N,N,-,-1,-1
PILGRIM.txt,218179,218519,340,10,N,N,-,-1,-1
PILGRIM.txt,218211,218554,343,10,N,N,-,-1,-1
PILGRIM.txt,218218,218667,449,10,N,N,-,-1,-1
PILGRIM.txt,218254,218716,462,10,N,N,-,-1,-1
PILGRIM.txt,218276,218872,596,10,N,N,-,-1,-1
PILGRIM.txt,218354,219141,787,10,N,N,-,-1,-1
PILGRIM.txt,218371,219226,855,10,N,N,-,-1,-1
PILGRIM.txt,218395,219418,1023,10,N,N,-,-1,-1
PILGRIM.txt,218413,219541,1128,10,N,N,-,-1,-1
PILGRIM.txt,218489,219670,1181,10,N,N,-,-1,-1
PILGRIM.txt,218520,219773,1253,10,N,N,-,-1,-1
PILGRIM.txt,218556,219805,1249,10,N,N,-,-1,-1
PILGRIM.txt,218668,219833,1165,10,N,N,-,-1,-1
PILGRIM.txt,218717,219912,1195,10,N,N,-,-1,-1
PILGRIM.txt,218875,219948,1073,10,N,N,-,-1,-1
PILGRIM.txt,219144,220052,908,10,N,N,-,-1,-1
PILGRIM.txt,219227,220159,932,10,N,N,-,-1,-1
PILGRIM.txt,219419,220202,783,10,N,N,-,-1,-1
PILGRIM.txt,219542,220247,705,10,N,N,-,-1,-1
PILGRIM.txt,219671,220309,638,10,N,N,-,-1,-1
PILGRIM.txt,219774,220480,706,10,N,N,-,-1,-1
PILGRIM.txt,219807,220533,726,10,N,N,-,-1,-1
PILGRIM.txt,219834,220631,797,10,N,N,-,-1,-1
PILGRIM.txt,219914,220714,800,10,N,N,-,-1,-1
PILGRIM.txt,219949,220912,963,10,N,N,-,-1,-1
PILGRIM.txt,220053,220948,895,10,N,N,-,-1,-1
PILGRIM.txt,220160,221114,954,10,N,N,-,-1,-1
PILGRIM.txt,220203,221243,1040,10,N,N,-,-1,-1
PILGRIM.txt,220248,221287,1039,10,N,N,-,-1,-1
PILGRIM.txt,220310,221335,1025,10,N,N,-,-1,-1
PILGRIM.txt,220481,221374,893,10,N,N,-,-1,-1
PILGRIM.txt,220536,221453,917,10,N,N,-,-1,-1
PILGRIM.txt,220632,221661,1029,10,N,N,-,-1,-1
PILGRIM.txt,220715,221749,1034,10,N,N,-,-1,-1
PILGRIM.txt,220914,221822,908,10,N,N,-,-1,-1
PILGRIM.txt,220949,221964,1015,10,N,N,-,-1,-1
PILGRIM.txt,221116,222093,977,10,N,N,-,-1,-1
PILGRIM.txt,221245,222139,894,10,N,N,-,-1,-1
PILGRIM.txt,221292,222547,1255,10,N,N,-,-1,-1
PILGRIM.txt,221341,222729,1388,10,N,N,-,-1,-1
PILGRIM.txt,221375,222809,1434,10,N,N,-,-1,-1
PILGRIM.txt,221454,222944,1490,10,N,N,-,-1,-1
PILGRIM.txt,221662,223087,1425,10,N,N,-,-1,-1
PILGRIM.txt,221750,223180,1430,10,N,N,-,-1,-1
PILGRIM.txt,221823,223277,1454,10,N,N,-,-1,-1
PILGRIM.txt,221965,223310,1345,10,N,N,-,-1,-1
PILGRIM.txt,222096,223515,1419,10,N,N,-,-1,-1
PILGRIM.txt,222140,223599,1459,10,N,N,-,-1,-1
PILGRIM.txt,222550,223751,1201,10,N,N,-,-1,-1
PILGRIM.txt,222730,224039,1309,10,N,N,-,-1,-1
PILGRIM.txt,222810,224147,1337,10,N,N,-,-1,-1
PILGRIM.txt,222946,224403,1457,10,N,N,-,-1,-1
PILGRIM.txt,223088,224468,1380,10,N,N,-,-1,-1
PILGRIM.txt,223181,224596,1415,10,N,N,-,-1,-1
PILGRIM.txt,223278,224808,1530,10,N,N,-,-1,-1
PILGRIM.txt,223311,224907,1596,10,N,N,-,-1,-1
PILGRIM.txt,223516,225027,1511,10,N,N,-,-1,-1
PILGRIM.txt,223600,225099,1499,10,N,N,-,-1,-1
PILGRIM.txt,223754,225184,1430,10,N,N,-,-1,-1
PILGRIM.txt,224040,225256,1216,10,N,N,-,-1,-1
PILGRIM.txt,224148,225409,1261,10,N,N,-,-1,-1
PILGRIM.txt,224404,225529,1125,10,N,N,-,-1,-1
PILGRIM.txt,224471,225710,1239,10,N,N,-,-1,-1
PILGRIM.txt,224597,225750,1153,10,N,N,-,-1,-1
PILGRIM.txt,224811,225879,1068,10,N,N,-,-1,-1
PILGRIM.txt,224908,226148,1240,10,N,N,-,-1,-1
PILGRIM.txt,225028,226444,1416,10,N,N,-,-1,-1
PILGRIM.txt,225100,226478,1378,10,N,N,-,-1,-1
PILGRIM.txt,225186,226544,1358,10,N,N,-,-1,-1
PILGRIM.txt,225257,226651,1394,10,N,N,-,-1,-1
PILGRIM.txt,225410,226790,1380,10,N,N,-,-1,-1
PILGRIM.txt,225530,226847,1317,10,N,N,-,-1,-1
PILGRIM.txt,225711,226915,1204,10,N,N,-,-1,-1
PILGRIM.txt,225753,227002,1249,10,N,N,-,-1,-1
PILGRIM.txt,225880,227191,1311,10,N,N,-,-1,-1
PILGRIM.txt,226150,227243,1093,10,N,N,-,-1,-1
PILGRIM.txt,226445,227315,870,10,N,N,-,-1,-1
PILGRIM.txt,226479,227429,950,10,N,N,-,-1,-1
PILGRIM.txt,226545,227464,919,10,N,N,-,-1,-1
PILGRIM.txt,226652,227540,888,10,N,N,-,-1,-1
PILGRIM.txt,226791,227545,754,10,N,N,-,-1,-1
PILGRIM.txt,226848,227636,788,10,N,N,-,-1,-1
PILGRIM.txt,226916,227830,914,10,N,N,-,-1,-1
PILGRIM.txt,227003,227921,918,10,N,N,-,-1,-1
PILGRIM.txt,227192,227937,745,10,N,N,-,-1,-1
PILGRIM.txt,227245,228027,782,10,N,N,-,-1,-1
PILGRIM.txt,227316,228062,746,10,N,N,-,-1,-1
PILGRIM.txt,227430,228260,830,10,N,N,-,-1,-1
PILGRIM.txt,227465,228388,923,10,N,Y,1437472966198,394609,395892
PILGRIM.txt,227541,228649,1108,10,N,Y,1437472966198,394609,395892
PILGRIM.txt,227546,228756,1210,10,N,Y,1437472966198,394609,395892
PILGRIM.txt,227637,228973,1336,10,N,Y,1437472966198,394609,395892
PILGRIM.txt,227831,229079,1248,10,N,Y,1437472966198,394609,395892
PILGRIM.txt,227926,229197,1271,10,Y,Y,1437472966198,394609,395892
PILGRIM.txt,227940,229261,1321,10,Y,Y,1437472966198,394609,395892
PILGRIM.txt,228028,229545,1517,10,Y,Y,1437472966198,394609,395892
PILGRIM.txt,228063,229793,1730,10,Y,Y,1437472966198,394609,395892
PILGRIM.txt,228263,229887,1624,10,Y,Y,1437472966198,394609,395892
PILGRIM.txt,228389,229983,1594,10,Y,Y,1437472966198,394609,395892
PILGRIM.txt,228650,230251,1601,10,N,Y,1437472966198,394609,395892
PILGRIM.txt,228757,230322,1565,10,N,Y,1437472966198,394609,395892
PILGRIM.txt,228974,230408,1434,10,N,Y,1437472966198,394609,395892
PILGRIM.txt,229080,230557,1477,10,N,Y,1437472966198,394609,395892
PILGRIM.txt,229199,230662,1463,10,N,Y,1437472966198,394609,395892
PILGRIM.txt,229262,230820,1558,10,N,Y,1437472966198,394609,395892
PILGRIM.txt,229550,230936,1386,10,N,Y,1437472966198,394609,395892
PILGRIM.txt,229794,230987,1193,10,N,Y,1437472966198,394609,395892
PILGRIM.txt,229888,231104,1216,10,N,Y,1437472966198,394609,395892
PILGRIM.txt,229984,231417,1433,10,N,Y,1437472966198,394609,395892
PILGRIM.txt,230252,232015,1763,10,N,N,-,-1,-1
PILGRIM.txt,230323,232287,1964,10,N,N,-,-1,-1
PILGRIM.txt,230411,232446,2035,10,N,N,-,-1,-1
PILGRIM.txt,230558,232739,2181,10,N,N,-,-1,-1
PILGRIM.txt,230663,232940,2277,10,N,N,-,-1,-1
PILGRIM.txt,230821,233161,2340,10,N,N,-,-1,-1
PILGRIM.txt,230937,233425,2488,10,N,N,-,-1,-1
PILGRIM.txt,230987,233635,2648,10,N,N,-,-1,-1
PILGRIM.txt,231107,233811,2704,10,N,N,-,-1,-1
PILGRIM.txt,231418,234121,2703,10,N,N,-,-1,-1
PILGRIM.txt,232016,234324,2308,10,N,N,-,-1,-1
PILGRIM.txt,232290,234498,2208,10,N,N,-,-1,-1
PILGRIM.txt,232447,234564,2117,10,N,N,-,-1,-1
PILGRIM.txt,232742,234712,1970,10,N,N,-,-1,-1
PILGRIM.txt,232943,234821,1878,10,N,N,-,-1,-1
PILGRIM.txt,233166,234933,1767,10,N,N,-,-1,-1
PILGRIM.txt,233426,234958,1532,10,N,N,-,-1,-1
PILGRIM.txt,233636,235012,1376,10,N,N,-,-1,-1
PILGRIM.txt,233814,235135,1321,10,N,N,-,-1,-1
PILGRIM.txt,234122,235273,1151,10,N,N,-,-1,-1
PILGRIM.txt,234325,235348,1023,10,N,N,-,-1,-1
PILGRIM.txt,234499,235459,960,10,N,N,-,-1,-1
PILGRIM.txt,234567,235504,937,10,N,N,-,-1,-1
PILGRIM.txt,234713,235742,1029,10,N,N,-,-1,-1
PILGRIM.txt,234824,235816,992,10,N,N,-,-1,-1
PILGRIM.txt,234934,236031,1097,10,N,N,-,-1,-1
PILGRIM.txt,234959,236137,1178,10,N,N,-,-1,-1
PILGRIM.txt,235017,236205,1188,10,N,N,-,-1,-1
PILGRIM.txt,235136,236337,1201,10,N,N,-,-1,-1
PILGRIM.txt,235276,236433,1157,10,N,N,-,-1,-1
PILGRIM.txt,235349,236633,1284,10,N,N,-,-1,-1
PILGRIM.txt,235460,236763,1303,10,N,N,-,-1,-1
PILGRIM.txt,235505,237045,1540,10,N,N,-,-1,-1
PILGRIM.txt,235744,237337,1593,10,N,Y,1448278425221,65586,65914
PILGRIM.txt,235817,237371,1554,10,N,Y,1448278425221,65586,65914
PILGRIM.txt,236032,237532,1500,10,N,Y,1448278425221,65586,65914
PILGRIM.txt,236138,237660,1522,10,N,Y,1448278425221,65586,65914
PILGRIM.txt,236208,237661,1453,10,N,Y,1448278425221,65586,65914
PILGRIM.txt,236340,237779,1439,10,N,Y,1448278425221,65586,65914
PILGRIM.txt,236436,237887,1451,10,N,Y,1448278425221,65586,65914
PILGRIM.txt,236635,237927,1292,10,N,Y,1448278425221,65586,65914
PILGRIM.txt,236764,238036,1272,10,N,Y,1448278425221,65586,65914
PILGRIM.txt,237048,238224,1176,10,N,Y,1448278425221,65586,65914
PILGRIM.txt,237338,238296,958,10,N,Y,1448278425221,65586,65914
PILGRIM.txt,237372,238387,1015,10,N,Y,1448278425221,65586,65914
PILGRIM.txt,237533,238482,949,10,N,Y,1448278425221,65586,65914
PILGRIM.txt,237660,238562,902,10,N,Y,1448278425221,65586,65914
PILGRIM.txt,237662,238766,1104,10,N,Y,1448278425221,65586,65914
PILGRIM.txt,237780,238882,1102,10,N,Y,1448278425221,65586,65914
PILGRIM.txt,237888,238953,1065,10,N,Y,1448278425221,65586,65914
PILGRIM.txt,237928,239023,1095,10,N,Y,1448278425221,65586,65914
PILGRIM.txt,238039,239236,1197,10,N,N,-,-1,-1
PILGRIM.txt,238225,239301,1076,10,N,N,-,-1,-1
PILGRIM.txt,238298,239379,1081,10,N,N,-,-1,-1
PILGRIM.txt,238388,239449,1061,10,N,N,-,-1,-1
PILGRIM.txt,238483,239602,1119,10,N,N,-,-1,-1
PILGRIM.txt,238563,239686,1123,10,N,N,-,-1,-1
PILGRIM.txt,238771,239885,1114,10,N,N,-,-1,-1
PILGRIM.txt,238885,240055,1170,10,Y,N,-,-1,-1
PILGRIM.txt,238954,240103,1149,10,Y,N,-,-1,-1
PILGRIM.txt,239024,240201,1177,10,N,N,-,-1,-1
PILGRIM.txt,239237,240280,1043,10,N,N,-,-1,-1
PILGRIM.txt,239304,240510,1206,10,N,N,-,-1,-1
PILGRIM.txt,239380,240624,1244,10,N,N,-,-1,-1
PILGRIM.txt,239450,240734,1284,10,N,N,-,-1,-1
PILGRIM.txt,239604,240999,1395,10,N,N,-,-1,-1
PILGRIM.txt,239687,241105,1418,10,N,N,-,-1,-1
PILGRIM.txt,239886,241183,1297,10,N,N,-,-1,-1
PILGRIM.txt,240056,241249,1193,10,N,N,-,-1,-1
PILGRIM.txt,240104,241390,1286,10,N,N,-,-1,-1
PILGRIM.txt,240202,241464,1262,10,N,N,-,-1,-1
PILGRIM.txt,240281,241687,1406,10,N,N,-,-1,-1
PILGRIM.txt,240511,241877,1366,10,N,N,-,-1,-1
PILGRIM.txt,240629,241983,1354,10,N,N,-,-1,-1
PILGRIM.txt,240735,242250,1515,10,N,N,-,-1,-1
PILGRIM.txt,241000,242389,1389,10,N,N,-,-1,-1
PILGRIM.txt,241106,242500,1394,10,N,N,-,-1,-1
PILGRIM.txt,241184,242620,1436,10,N,N,-,-1,-1
PILGRIM.txt,241250,242767,1517,10,N,N,-,-1,-1
PILGRIM.txt,241393,242928,1535,10,Y,N,-,-1,-1
PILGRIM.txt,241465,242988,1523,10,Y,N,-,-1,-1
PILGRIM.txt,241688,243067,1379,10,Y,N,-,-1,-1
PILGRIM.txt,241880,243242,1362,10,Y,N,-,-1,-1
PILGRIM.txt,241984,243400,1416,10,Y,N,-,-1,-1
PILGRIM.txt,242251,243640,1389,10,Y,N,-,-1,-1
PILGRIM.txt,242390,243806,1416,10,Y,N,-,-1,-1
PILGRIM.txt,242505,243922,1417,10,Y,N,-,-1,-1
PILGRIM.txt,242621,244137,1516,10,Y,N,-,-1,-1
PILGRIM.txt,242768,244227,1459,10,Y,N,-,-1,-1
PILGRIM.txt,242929,244377,1448,10,N,N,-,-1,-1
PILGRIM.txt,242991,244597,1606,10,N,N,-,-1,-1
PILGRIM.txt,243068,244728,1660,10,N,N,-,-1,-1
PILGRIM.txt,243243,244781,1538,10,N,N,-,-1,-1
PILGRIM.txt,243401,244827,1426,10,N,N,-,-1,-1
PILGRIM.txt,243641,244939,1298,10,N,N,-,-1,-1
PILGRIM.txt,243807,245050,1243,10,N,N,-,-1,-1
PILGRIM.txt,243925,245190,1265,10,N,N,-,-1,-1
PILGRIM.txt,244139,245282,1143,10,N,N,-,-1,-1
PILGRIM.txt,244228,245353,1125,10,N,N,-,-1,-1
PILGRIM.txt,244382,245559,1177,10,N,N,-,-1,-1
PILGRIM.txt,244598,245692,1094,10,N,N,-,-1,-1
PILGRIM.txt,244729,245790,1061,10,N,N,-,-1,-1
PILGRIM.txt,244784,245853,1069,10,N,N,-,-1,-1
PILGRIM.txt,244828,246021,1193,10,N,N,-,-1,-1
PILGRIM.txt,244941,246194,1253,10,N,N,-,-1,-1
PILGRIM.txt,245051,246312,1261,10,N,N,-,-1,-1
PILGRIM.txt,245191,246395,1204,10,N,N,-,-1,-1
PILGRIM.txt,245283,246517,1234,10,N,N,-,-1,-1
PILGRIM.txt,245354,246587,1233,10,N,N,-,-1,-1
PILGRIM.txt,245560,246697,1137,10,N,N,-,-1,-1
PILGRIM.txt,245694,246849,1155,10,N,N,-,-1,-1
PILGRIM.txt,245793,246948,1155,10,N,N,-,-1,-1
PILGRIM.txt,245854,247066,1212,10,N,N,-,-1,-1
PILGRIM.txt,246022,247198,1176,10,N,N,-,-1,-1
PILGRIM.txt,246195,247283,1088,10,N,N,-,-1,-1
PILGRIM.txt,246313,247345,1032,10,N,N,-,-1,-1
PILGRIM.txt,246398,247534,1136,10,N,N,-,-1,-1
PILGRIM.txt,246518,247655,1137,10,N,N,-,-1,-1
PILGRIM.txt,246588,247925,1337,10,N,N,-,-1,-1
PILGRIM.txt,246698,248041,1343,10,N,N,-,-1,-1
PILGRIM.txt,246850,248338,1488,10,N,N,-,-1,-1
PILGRIM.txt,246949,248439,1490,10,N,N,-,-1,-1
PILGRIM.txt,247068,248522,1454,10,N,N,-,-1,-1
PILGRIM.txt,247199,248608,1409,10,N,N,-,-1,-1
PILGRIM.txt,247285,248781,1496,10,N,N,-,-1,-1
PILGRIM.txt,247348,248909,1561,10,N,N,-,-1,-1
PILGRIM.txt,247535,248914,1379,10,N,N,-,-1,-1
PILGRIM.txt,247658,249096,1438,10,N,N,-,-1,-1
PILGRIM.txt,247927,249206,1279,10,N,N,-,-1,-1
PILGRIM.txt,248046,249273,1227,10,N,N,-,-1,-1
PILGRIM.txt,248341,249381,1040,10,N,N,-,-1,-1
PILGRIM.txt,248441,249536,1095,10,N,N,-,-1,-1
PILGRIM.txt,248523,249591,1068,10,N,N,-,-1,-1
PILGRIM.txt,248609,249666,1057,10,N,N,-,-1,-1
PILGRIM.txt,248782,249924,1142,10,N,N,-,-1,-1
PILGRIM.txt,248910,250009,1099,10,N,N,-,-1,-1
PILGRIM.txt,248915,250083,1168,10,N,N,-,-1,-1
PILGRIM.txt,249097,250135,1038,10,N,N,-,-1,-1
PILGRIM.txt,249207,250229,1022,10,N,N,-,-1,-1
PILGRIM.txt,249274,250367,1093,10,N,N,-,-1,-1
PILGRIM.txt,249382,250483,1101,10,Y,N,-,-1,-1
PILGRIM.txt,249537,250620,1083,10,N,N,-,-1,-1
PILGRIM.txt,249592,250805,1213,10,N,N,-,-1,-1
PILGRIM.txt,249671,250919,1248,10,Y,N,-,-1,-1
PILGRIM.txt,249925,251117,1192,10,N,N,-,-1,-1
PILGRIM.txt,250010,251223,1213,10,N,N,-,-1,-1
PILGRIM.txt,250084,251374,1290,10,N,N,-,-1,-1
PILGRIM.txt,250136,251566,1430,10,N,N,-,-1,-1
PILGRIM.txt,250232,251723,1491,10,N,N,-,-1,-1
PILGRIM.txt,250368,251788,1420,10,N,N,-,-1,-1
PILGRIM.txt,250484,251965,1481,10,N,N,-,-1,-1
PILGRIM.txt,250621,252161,1540,10,N,N,-,-1,-1
PILGRIM.txt,250806,252238,1432,10,N,N,-,-1,-1
PILGRIM.txt,250920,252281,1361,10,N,N,-,-1,-1
PILGRIM.txt,251118,252511,1393,10,N,N,-,-1,-1
PILGRIM.txt,251224,252608,1384,10,N,N,-,-1,-1
PILGRIM.txt,251375,252805,1430,10,N,N,-,-1,-1
PILGRIM.txt,251569,252945,1376,10,N,N,-,-1,-1
PILGRIM.txt,251726,253052,1326,10,N,N,-,-1,-1
PILGRIM.txt,251789,253307,1518,10,Y,N,-,-1,-1
PILGRIM.txt,251966,253377,1411,10,Y,N,-,-1,-1
PILGRIM.txt,252162,253637,1475,10,Y,N,-,-1,-1
PILGRIM.txt,252240,253727,1487,10,N,N,-,-1,-1
PILGRIM.txt,252282,253745,1463,10,N,N,-,-1,-1
PILGRIM.txt,252512,253807,1295,10,N,N,-,-1,-1
PILGRIM.txt,252609,253841,1232,10,N,N,-,-1,-1
PILGRIM.txt,252808,254149,1341,10,N,N,-,-1,-1
PILGRIM.txt,252945,254251,1306,10,N,N,-,-1,-1
PILGRIM.txt,253053,254420,1367,10,N,N,-,-1,-1
PILGRIM.txt,253308,254571,1263,10,N,N,-,-1,-1
PILGRIM.txt,253378,254696,1318,10,N,N,-,-1,-1
PILGRIM.txt,253637,254868,1231,10,N,N,-,-1,-1
PILGRIM.txt,253728,254948,1220,10,N,N,-,-1,-1
PILGRIM.txt,253747,255039,1292,10,N,N,-,-1,-1
PILGRIM.txt,253808,255095,1287,10,N,N,-,-1,-1
PILGRIM.txt,253842,255529,1687,10,Y,N,-,-1,-1
PILGRIM.txt,254150,255666,1516,10,N,N,-,-1,-1
PILGRIM.txt,254252,255760,1508,10,N,N,-,-1,-1
PILGRIM.txt,254421,256116,1695,10,N,N,-,-1,-1
PILGRIM.txt,254572,256269,1697,10,N,N,-,-1,-1
PILGRIM.txt,254697,256418,1721,10,N,N,-,-1,-1
PILGRIM.txt,254871,256560,1689,10,N,N,-,-1,-1
PILGRIM.txt,254949,256571,1622,10,N,N,-,-1,-1
PILGRIM.txt,255040,256579,1539,10,N,N,-,-1,-1
PILGRIM.txt,255096,256728,1632,10,N,N,-,-1,-1
PILGRIM.txt,255530,256801,1271,10,N,N,-,-1,-1
PILGRIM.txt,255669,257012,1343,10,N,N,-,-1,-1
PILGRIM.txt,255761,257131,1370,10,N,N,-,-1,-1
PILGRIM.txt,256117,257186,1069,10,N,N,-,-1,-1
PILGRIM.txt,256270,257201,931,10,N,N,-,-1,-1
PILGRIM.txt,256419,257396,977,10,N,N,-,-1,-1
PILGRIM.txt,256562,257479,917,10,N,N,-,-1,-1
PILGRIM.txt,256572,257869,1297,10,N,N,-,-1,-1
PILGRIM.txt,256580,258126,1546,10,N,N,-,-1,-1
PILGRIM.txt,256729,258320,1591,10,N,N,-,-1,-1
PILGRIM.txt,256804,258396,1592,10,N,N,-,-1,-1
PILGRIM.txt,257013,258634,1621,10,N,N,-,-1,-1
PILGRIM.txt,257132,258716,1584,10,N,N,-,-1,-1
PILGRIM.txt,257187,258807,1620,10,N,N,-,-1,-1
PILGRIM.txt,257202,258909,1707,10,N,N,-,-1,-1
PILGRIM.txt,257397,259102,1705,10,N,N,-,-1,-1
PILGRIM.txt,257480,259207,1727,10,N,N,-,-1,-1
PILGRIM.txt,257870,259421,1551,10,N,N,-,-1,-1
PILGRIM.txt,258129,259526,1397,10,N,N,-,-1,-1
PILGRIM.txt,258321,259725,1404,10,N,N,-,-1,-1
PILGRIM.txt,258397,259932,1535,10,N,N,-,-1,-1
PILGRIM.txt,258635,260140,1505,10,N,Y,1448281320115,89144,91129
PILGRIM.txt,258717,260406,1689,10,N,Y,1448281320115,89144,91129
PILGRIM.txt,258808,260737,1929,10,N,Y,1448281320115,89144,91129
PILGRIM.txt,258910,260935,2025,10,N,Y,1448281320115,89144,91129
PILGRIM.txt,259104,261140,2036,10,Y,Y,1448281320115,89144,91129
PILGRIM.txt,259212,261329,2117,10,Y,Y,1448281320115,89144,91129
PILGRIM.txt,259422,261370,1948,10,Y,Y,1448281320115,89144,91129
PILGRIM.txt,259527,261593,2066,10,Y,Y,1448281320115,89144,91129
PILGRIM.txt,259726,261818,2092,10,Y,Y,1448281320115,89144,91129
PILGRIM.txt,259935,261885,1950,10,Y,Y,1448281320115,89144,91129
PILGRIM.txt,260141,261919,1778,10,Y,Y,1448281320115,89144,91129
PILGRIM.txt,260406,261999,1593,10,N,Y,1448281320115,89144,91129
PILGRIM.txt,260738,262083,1345,10,N,Y,1448281320115,89144,91129
PILGRIM.txt,260936,262208,1272,10,N,Y,1448281320115,89144,91129
PILGRIM.txt,261145,262333,1188,10,N,Y,1448281320115,89144,91129
PILGRIM.txt,261330,262417,1087,10,N,Y,1448281320115,89144,91129
PILGRIM.txt,261373,262531,1158,10,N,Y,1448281320115,89144,91129
PILGRIM.txt,261593,262600,1007,10,N,Y,1448281320115,89144,91129
PILGRIM.txt,261819,262617,798,10,N,N,-,-1,-1
PILGRIM.txt,261886,262684,798,10,N,N,-,-1,-1
PILGRIM.txt,261922,262731,809,10,N,N,-,-1,-1
PILGRIM.txt,262000,262783,783,10,N,N,-,-1,-1
PILGRIM.txt,262084,262899,815,10,N,N,-,-1,-1
PILGRIM.txt,262209,262974,765,10,N,N,-,-1,-1
PILGRIM.txt,262334,262995,661,10,N,N,-,-1,-1
PILGRIM.txt,262418,263009,591,10,N,N,-,-1,-1
PILGRIM.txt,262532,263014,482,10,N,N,-,-1,-1
PILGRIM.txt,262601,263148,547,10,N,N,-,-1,-1
PILGRIM.txt,262620,263210,590,10,N,N,-,-1,-1
PILGRIM.txt,262686,263245,559,10,N,N,-,-1,-1
PILGRIM.txt,262732,263405,673,10,N,N,-,-1,-1
PILGRIM.txt,262784,263573,789,10,N,N,-,-1,-1
PILGRIM.txt,262904,263673,769,10,N,N,-,-1,-1
PILGRIM.txt,262975,263844,869,10,N,N,-,-1,-1
PILGRIM.txt,262996,263895,899,10,N,N,-,-1,-1
PILGRIM.txt,263010,264001,991,10,N,N,-,-1,-1
PILGRIM.txt,263015,264036,1021,10,N,N,-,-1,-1
PILGRIM.txt,263149,264137,988,10,N,N,-,-1,-1
PILGRIM.txt,263212,264181,969,10,N,N,-,-1,-1
PILGRIM.txt,263248,264306,1058,10,N,N,-,-1,-1
PILGRIM.txt,263407,264433,1026,10,N,N,-,-1,-1
PILGRIM.txt,263574,264518,944,10,N,N,-,-1,-1
PILGRIM.txt,263674,264592,918,10,N,N,-,-1,-1
PILGRIM.txt,263845,264891,1046,10,N,N,-,-1,-1
PILGRIM.txt,263896,265012,1116,10,N,N,-,-1,-1
PILGRIM.txt,264002,265080,1078,10,N,N,-,-1,-1
PILGRIM.txt,264037,265213,1176,10,N,N,-,-1,-1
PILGRIM.txt,264138,265279,1141,10,N,N,-,-1,-1
PILGRIM.txt,264182,265362,1180,10,N,N,-,-1,-1
PILGRIM.txt,264307,265471,1164,10,N,N,-,-1,-1
PILGRIM.txt,264435,265612,1177,10,N,N,-,-1,-1
PILGRIM.txt,264521,265628,1107,10,N,N,-,-1,-1
PILGRIM.txt,264593,265909,1316,10,N,N,-,-1,-1
PILGRIM.txt,264892,265933,1041,10,N,N,-,-1,-1
PILGRIM.txt,265013,266118,1105,10,N,N,-,-1,-1
PILGRIM.txt,265082,266369,1287,10,N,N,-,-1,-1
PILGRIM.txt,265214,266738,1524,10,N,N,-,-1,-1
PILGRIM.txt,265280,266977,1697,10,N,N,-,-1,-1
PILGRIM.txt,265365,267137,1772,10,N,N,-,-1,-1
PILGRIM.txt,265472,267357,1885,10,N,N,-,-1,-1
PILGRIM.txt,265617,267394,1777,10,N,N,-,-1,-1
PILGRIM.txt,265631,267542,1911,10,N,N,-,-1,-1
PILGRIM.txt,265910,267672,1762,10,N,N,-,-1,-1
PILGRIM.txt,265936,267773,1837,10,N,N,-,-1,-1
PILGRIM.txt,266119,267907,1788,10,N,N,-,-1,-1
PILGRIM.txt,266372,267992,1620,10,N,N,-,-1,-1
PILGRIM.txt,266739,268123,1384,10,N,N,-,-1,-1
PILGRIM.txt,266979,268269,1290,10,N,N,-,-1,-1
PILGRIM.txt,267138,268510,1372,10,N,N,-,-1,-1
PILGRIM.txt,267358,268601,1243,10,N,N,-,-1,-1
PILGRIM.txt,267395,268838,1443,10,N,N,-,-1,-1
PILGRIM.txt,267543,269012,1469,10,N,N,-,-1,-1
PILGRIM.txt,267673,269117,1444,10,N,N,-,-1,-1
PILGRIM.txt,267774,269258,1484,10,N,N,-,-1,-1
PILGRIM.txt,267908,269350,1442,10,N,N,-,-1,-1
PILGRIM.txt,267995,269548,1553,10,N,N,-,-1,-1
PILGRIM.txt,268124,269644,1520,10,N,N,-,-1,-1
PILGRIM.txt,268270,269951,1681,10,N,N,-,-1,-1
PILGRIM.txt,268513,270076,1563,10,N,N,-,-1,-1
PILGRIM.txt,268604,270227,1623,10,N,N,-,-1,-1
PILGRIM.txt,268839,270320,1481,10,N,N,-,-1,-1
PILGRIM.txt,269013,270439,1426,10,N,N,-,-1,-1
PILGRIM.txt,269118,270489,1371,10,N,N,-,-1,-1
PILGRIM.txt,269261,270672,1411,10,N,N,-,-1,-1
PILGRIM.txt,269351,270848,1497,10,N,N,-,-1,-1
PILGRIM.txt,269549,271006,1457,10,N,N,-,-1,-1
PILGRIM.txt,269646,271140,1494,10,N,N,-,-1,-1
PILGRIM.txt,269954,271227,1273,10,N,N,-,-1,-1
PILGRIM.txt,270077,271324,1247,10,N,N,-,-1,-1
PILGRIM.txt,270230,271376,1146,10,N,N,-,-1,-1
PILGRIM.txt,270323,271471,1148,10,N,N,-,-1,-1
PILGRIM.txt,270440,271555,1115,10,N,N,-,-1,-1
PILGRIM.txt,270490,271729,1239,10,N,N,-,-1,-1
PILGRIM.txt,270674,271976,1302,10,N,N,-,-1,-1
PILGRIM.txt,270849,272115,1266,10,N,N,-,-1,-1
PILGRIM.txt,271007,272235,1228,10,N,N,-,-1,-1
PILGRIM.txt,271141,272311,1170,10,N,N,-,-1,-1
PILGRIM.txt,271228,272455,1227,10,N,N,-,-1,-1
PILGRIM.txt,271325,272585,1260,10,N,N,-,-1,-1
PILGRIM.txt,271377,272622,1245,10,N,N,-,-1,-1
PILGRIM.txt,271472,272717,1245,10,N,N,-,-1,-1
PILGRIM.txt,271556,272904,1348,10,N,N,-,-1,-1
PILGRIM.txt,271730,272952,1222,10,N,N,-,-1,-1
PILGRIM.txt,271977,273021,1044,10,N,N,-,-1,-1
PILGRIM.txt,272116,273144,1028,10,N,N,-,-1,-1
PILGRIM.txt,272236,273255,1019,10,N,N,-,-1,-1
PILGRIM.txt,272314,273308,994,10,N,N,-,-1,-1
PILGRIM.txt,272456,273394,938,10,N,N,-,-1,-1
PILGRIM.txt,272586,273511,925,10,N,N,-,-1,-1
PILGRIM.txt,272623,273631,1008,10,N,N,-,-1,-1
PILGRIM.txt,272718,273677,959,10,N,N,-,-1,-1
PILGRIM.txt,272907,273978,1071,10,N,N,-,-1,-1
PILGRIM.txt,272954,274240,1286,10,N,N,-,-1,-1
PILGRIM.txt,273022,274323,1301,10,N,N,-,-1,-1
PILGRIM.txt,273145,274500,1355,10,N,N,-,-1,-1
PILGRIM.txt,273256,274581,1325,10,N,N,-,-1,-1
PILGRIM.txt,273309,274748,1439,10,N,N,-,-1,-1
PILGRIM.txt,273395,274894,1499,10,N,N,-,-1,-1
PILGRIM.txt,273512,274986,1474,10,N,N,-,-1,-1
PILGRIM.txt,273632,275100,1468,10,N,N,-,-1,-1
PILGRIM.txt,273678,275226,1548,10,N,N,-,-1,-1
PILGRIM.txt,273981,275387,1406,10,Y,N,-,-1,-1
PILGRIM.txt,274241,275452,1211,10,N,N,-,-1,-1
PILGRIM.txt,274328,275581,1253,10,N,N,-,-1,-1
PILGRIM.txt,274502,275806,1304,10,N,N,-,-1,-1
PILGRIM.txt,274582,275880,1298,10,N,N,-,-1,-1
PILGRIM.txt,274750,276118,1368,10,N,N,-,-1,-1
PILGRIM.txt,274895,276266,1371,10,N,N,-,-1,-1
PILGRIM.txt,274987,276416,1429,10,N,N,-,-1,-1
PILGRIM.txt,275101,276562,1461,10,N,N,-,-1,-1
PILGRIM.txt,275228,276813,1585,10,N,N,-,-1,-1
PILGRIM.txt,275388,277006,1618,10,N,N,-,-1,-1
PILGRIM.txt,275453,277210,1757,10,N,N,-,-1,-1
PILGRIM.txt,275582,277562,1980,10,N,N,-,-1,-1
PILGRIM.txt,275807,277813,2006,10,N,N,-,-1,-1
PILGRIM.txt,275881,277843,1962,10,N,N,-,-1,-1
PILGRIM.txt,276119,277939,1820,10,N,N,-,-1,-1
PILGRIM.txt,276269,278062,1793,10,N,N,-,-1,-1
PILGRIM.txt,276419,278383,1964,10,N,N,-,-1,-1
PILGRIM.txt,276563,278554,1991,10,N,N,-,-1,-1
PILGRIM.txt,276816,278876,2060,10,N,N,-,-1,-1
PILGRIM.txt,277007,279042,2035,10,N,N,-,-1,-1
PILGRIM.txt,277211,279195,1984,10,N,N,-,-1,-1
PILGRIM.txt,277564,279339,1775,10,N,N,-,-1,-1
PILGRIM.txt,277819,279468,1649,10,N,N,-,-1,-1
PILGRIM.txt,277849,279724,1875,10,N,N,-,-1,-1
PILGRIM.txt,277944,279878,1934,10,N,N,-,-1,-1
PILGRIM.txt,278063,280064,2001,10,N,N,-,-1,-1
PILGRIM.txt,278384,280225,1841,10,N,N,-,-1,-1
PILGRIM.txt,278555,280353,1798,10,N,N,-,-1,-1
PILGRIM.txt,278877,280480,1603,10,N,N,-,-1,-1
PILGRIM.txt,279045,280584,1539,10,N,N,-,-1,-1
PILGRIM.txt,279196,280678,1482,10,N,N,-,-1,-1
PILGRIM.txt,279342,280734,1392,10,N,N,-,-1,-1
PILGRIM.txt,279469,280848,1379,10,N,N,-,-1,-1
PILGRIM.txt,279725,280980,1255,10,N,N,-,-1,-1
PILGRIM.txt,279879,281141,1262,10,N,N,-,-1,-1
PILGRIM.txt,280065,281281,1216,10,N,N,-,-1,-1
PILGRIM.txt,280226,281290,1064,10,N,N,-,-1,-1
PILGRIM.txt,280354,281357,1003,10,N,N,-,-1,-1
PILGRIM.txt,280481,281521,1040,10,N,N,-,-1,-1
PILGRIM.txt,280585,281579,994,10,N,N,-,-1,-1
PILGRIM.txt,280680,281638,958,10,N,N,-,-1,-1
PILGRIM.txt,280736,281789,1053,10,N,N,-,-1,-1
PILGRIM.txt,280851,281965,1114,10,N,N,-,-1,-1
PILGRIM.txt,280981,282111,1130,10,N,N,-,-1,-1
PILGRIM.txt,281142,282280,1138,10,N,N,-,-1,-1
PILGRIM.txt,281284,282323,1039,10,N,N,-,-1,-1
PILGRIM.txt,281291,282493,1202,10,N,N,-,-1,-1
PILGRIM.txt,281358,282611,1253,10,N,N,-,-1,-1
PILGRIM.txt,281522,282662,1140,10,N,N,-,-1,-1
PILGRIM.txt,281582,282784,1202,10,N,N,-,-1,-1
PILGRIM.txt,281639,282867,1228,10,N,N,-,-1,-1
PILGRIM.txt,281790,282990,1200,10,N,N,-,-1,-1
PILGRIM.txt,281966,283122,1156,10,N,N,-,-1,-1
PILGRIM.txt,282112,283172,1060,10,N,N,-,-1,-1
PILGRIM.txt,282281,283254,973,10,N,N,-,-1,-1
PILGRIM.txt,282324,283332,1008,10,N,N,-,-1,-1
PILGRIM.txt,282494,283401,907,10,N,N,-,-1,-1
PILGRIM.txt,282612,283671,1059,10,N,N,-,-1,-1
PILGRIM.txt,282663,283725,1062,10,N,N,-,-1,-1
PILGRIM.txt,282785,283860,1075,10,N,N,-,-1,-1
PILGRIM.txt,282869,284020,1151,10,N,N,-,-1,-1
PILGRIM.txt,282991,284073,1082,10,N,N,-,-1,-1
PILGRIM.txt,283124,284152,1028,10,N,N,-,-1,-1
PILGRIM.txt,283173,284293,1120,10,N,N,-,-1,-1
PILGRIM.txt,283255,284406,1151,10,N,N,-,-1,-1
PILGRIM.txt,283333,284474,1141,10,N,N,-,-1,-1
PILGRIM.txt,283402,284603,1201,10,N,N,-,-1,-1
PILGRIM.txt,283672,284684,1012,10,N,N,-,-1,-1
PILGRIM.txt,283728,284711,983,10,N,N,-,-1,-1
PILGRIM.txt,283861,284894,1033,10,N,N,-,-1,-1
PILGRIM.txt,284021,285001,980,10,N,N,-,-1,-1
PILGRIM.txt,284074,285120,1046,10,N,N,-,-1,-1
PILGRIM.txt,284153,285154,1001,10,N,N,-,-1,-1
PILGRIM.txt,284295,285232,937,10,N,N,-,-1,-1
PILGRIM.txt,284407,285419,1012,10,N,N,-,-1,-1
PILGRIM.txt,284475,285738,1263,10,N,N,-,-1,-1
PILGRIM.txt,284604,285916,1312,10,N,N,-,-1,-1
PILGRIM.txt,284685,286060,1375,10,N,N,-,-1,-1
PILGRIM.txt,284712,286215,1503,10,N,N,-,-1,-1
PILGRIM.txt,284895,286351,1456,10,N,N,-,-1,-1
PILGRIM.txt,285002,286431,1429,10,N,N,-,-1,-1
PILGRIM.txt,285121,286495,1374,10,N,N,-,-1,-1
PILGRIM.txt,285155,286546,1391,10,N,N,-,-1,-1
PILGRIM.txt,285234,286632,1398,10,N,N,-,-1,-1
PILGRIM.txt,285424,286870,1446,10,N,N,-,-1,-1
PILGRIM.txt,285739,287023,1284,10,N,N,-,-1,-1
PILGRIM.txt,285919,287159,1240,10,N,N,-,-1,-1
PILGRIM.txt,286061,287503,1442,10,N,N,-,-1,-1
PILGRIM.txt,286216,287603,1387,10,N,N,-,-1,-1
PILGRIM.txt,286352,287663,1311,10,N,N,-,-1,-1
PILGRIM.txt,286432,287781,1349,10,N,N,-,-1,-1
PILGRIM.txt,286498,288017,1519,10,N,N,-,-1,-1
PILGRIM.txt,286548,288087,1539,10,N,N,-,-1,-1
PILGRIM.txt,286635,288205,1570,10,N,N,-,-1,-1
PILGRIM.txt,286871,288401,1530,10,N,N,-,-1,-1
PILGRIM.txt,287024,288729,1705,10,N,N,-,-1,-1
PILGRIM.txt,287160,288886,1726,10,N,N,-,-1,-1
PILGRIM.txt,287504,288987,1483,10,N,N,-,-1,-1
PILGRIM.txt,287604,289143,1539,10,N,N,-,-1,-1
PILGRIM.txt,287666,289345,1679,10,N,N,-,-1,-1
PILGRIM.txt,287782,289381,1599,10,N,N,-,-1,-1
PILGRIM.txt,288018,289499,1481,10,N,N,-,-1,-1
PILGRIM.txt,288090,289561,1471,10,N,N,-,-1,-1
PILGRIM.txt,288208,289626,1418,10,N,N,-,-1,-1
PILGRIM.txt,288402,289768,1366,10,N,N,-,-1,-1
PILGRIM.txt,288730,289959,1229,10,N,N,-,-1,-1
PILGRIM.txt,288887,290055,1168,10,N,N,-,-1,-1
PILGRIM.txt,288988,290347,1359,10,N,N,-,-1,-1
PILGRIM.txt,289144,290515,1371,10,N,N,-,-1,-1
PILGRIM.txt,289347,290594,1247,10,N,N,-,-1,-1
PILGRIM.txt,289382,290700,1318,10,N,N,-,-1,-1
PILGRIM.txt,289501,290847,1346,10,N,N,-,-1,-1
PILGRIM.txt,289562,290932,1370,10,N,N,-,-1,-1
PILGRIM.txt,289627,291029,1402,10,N,N,-,-1,-1
PILGRIM.txt,289769,291158,1389,10,N,N,-,-1,-1
PILGRIM.txt,289960,291287,1327,10,N,N,-,-1,-1
PILGRIM.txt,290056,291492,1436,10,N,N,-,-1,-1
PILGRIM.txt,290348,291649,1301,10,N,N,-,-1,-1
PILGRIM.txt,290520,291871,1351,10,N,N,-,-1,-1
PILGRIM.txt,290595,292167,1572,10,N,N,-,-1,-1
PILGRIM.txt,290701,292412,1711,10,N,N,-,-1,-1
PILGRIM.txt,290848,292429,1581,10,N,N,-,-1,-1
PILGRIM.txt,290933,292684,1751,10,N,N,-,-1,-1
PILGRIM.txt,291032,292801,1769,10,N,N,-,-1,-1
PILGRIM.txt,291159,292922,1763,10,N,N,-,-1,-1
PILGRIM.txt,291288,293116,1828,10,N,N,-,-1,-1
PILGRIM.txt,291493,293362,1869,10,N,N,-,-1,-1
PILGRIM.txt,291652,293551,1899,10,N,N,-,-1,-1
PILGRIM.txt,291871,293608,1737,10,N,N,-,-1,-1
PILGRIM.txt,292172,293675,1503,10,N,N,-,-1,-1
PILGRIM.txt,292417,293744,1327,10,N,N,-,-1,-1
PILGRIM.txt,292432,293870,1438,10,N,N,-,-1,-1
PILGRIM.txt,292687,293979,1292,10,N,N,-,-1,-1
PILGRIM.txt,292802,294057,1255,10,N,N,-,-1,-1
PILGRIM.txt,292923,294258,1335,10,N,N,-,-1,-1
PILGRIM.txt,293117,294304,1187,10,N,N,-,-1,-1
PILGRIM.txt,293363,294359,996,10,N,N,-,-1,-1
PILGRIM.txt,293552,294526,974,10,N,N,-,-1,-1
PILGRIM.txt,293609,294593,984,10,N,N,-,-1,-1
PILGRIM.txt,293676,294600,924,10,N,N,-,-1,-1
PILGRIM.txt,293746,294691,945,10,N,N,-,-1,-1
PILGRIM.txt,293871,294746,875,10,N,N,-,-1,-1
PILGRIM.txt,293980,294821,841,10,N,N,-,-1,-1
PILGRIM.txt,294058,294937,879,10,N,N,-,-1,-1
PILGRIM.txt,294260,295001,741,10,N,N,-,-1,-1
PILGRIM.txt,294305,295067,762,10,N,N,-,-1,-1
PILGRIM.txt,294361,295152,791,10,N,N,-,-1,-1
PILGRIM.txt,294527,295283,756,10,N,N,-,-1,-1
PILGRIM.txt,294594,295373,779,10,N,N,-,-1,-1
PILGRIM.txt,294601,295512,911,10,N,N,-,-1,-1
PILGRIM.txt,294692,295593,901,10,N,N,-,-1,-1
PILGRIM.txt,294747,295678,931,10,N,N,-,-1,-1
PILGRIM.txt,294822,295712,890,10,N,N,-,-1,-1
PILGRIM.txt,294938,295798,860,10,N,N,-,-1,-1
PILGRIM.txt,295002,295945,943,10,N,N,-,-1,-1
PILGRIM.txt,295068,296154,1086,10,N,N,-,-1,-1
PILGRIM.txt,295153,296286,1133,10,N,N,-,-1,-1
PILGRIM.txt,295284,296333,1049,10,N,N,-,-1,-1
PILGRIM.txt,295374,296464,1090,10,N,N,-,-1,-1
PILGRIM.txt,295513,296581,1068,10,N,N,-,-1,-1
PILGRIM.txt,295594,296690,1096,10,N,N,-,-1,-1
PILGRIM.txt,295679,296788,1109,10,N,N,-,-1,-1
PILGRIM.txt,295713,296946,1233,10,N,N,-,-1,-1
PILGRIM.txt,295799,297273,1474,10,N,N,-,-1,-1
PILGRIM.txt,295946,297512,1566,10,N,N,-,-1,-1
PILGRIM.txt,296155,297554,1399,10,N,N,-,-1,-1
PILGRIM.txt,296287,297727,1440,10,N,N,-,-1,-1
PILGRIM.txt,296334,297883,1549,10,N,N,-,-1,-1
PILGRIM.txt,296465,298154,1689,10,N,N,-,-1,-1
PILGRIM.txt,296583,298177,1594,10,N,N,-,-1,-1
PILGRIM.txt,296691,298239,1548,10,N,N,-,-1,-1
PILGRIM.txt,296790,298354,1564,10,N,N,-,-1,-1
PILGRIM.txt,296948,298478,1530,10,N,N,-,-1,-1
PILGRIM.txt,297274,298615,1341,10,N,N,-,-1,-1
PILGRIM.txt,297513,298773,1260,10,N,N,-,-1,-1
PILGRIM.txt,297556,298963,1407,10,N,N,-,-1,-1
PILGRIM.txt,297729,299160,1431,10,N,N,-,-1,-1
PILGRIM.txt,297884,299223,1339,10,N,N,-,-1,-1
PILGRIM.txt,298159,299404,1245,10,N,N,-,-1,-1
PILGRIM.txt,298178,299559,1381,10,N,N,-,-1,-1
PILGRIM.txt,298240,299765,1525,10,N,N,-,-1,-1
PILGRIM.txt,298355,299869,1514,10,N,N,-,-1,-1
PILGRIM.txt,298479,300111,1632,10,N,N,-,-1,-1
PILGRIM.txt,298616,300180,1564,10,N,N,-,-1,-1
PILGRIM.txt,298774,300274,1500,10,N,N,-,-1,-1
PILGRIM.txt,298966,300505,1539,10,N,N,-,-1,-1
PILGRIM.txt,299162,300694,1532,10,N,N,-,-1,-1
PILGRIM.txt,299226,300754,1528,10,N,N,-,-1,-1
PILGRIM.txt,299405,300931,1526,10,N,N,-,-1,-1
PILGRIM.txt,299560,300982,1422,10,N,N,-,-1,-1
PILGRIM.txt,299766,301070,1304,10,N,N,-,-1,-1
PILGRIM.txt,299870,301447,1577,10,N,N,-,-1,-1
PILGRIM.txt,300112,301460,1348,10,N,N,-,-1,-1
PILGRIM.txt,300181,301723,1542,10,N,N,-,-1,-1
PILGRIM.txt,300277,301951,1674,10,N,N,-,-1,-1
PILGRIM.txt,300506,302022,1516,10,N,N,-,-1,-1
PILGRIM.txt,300695,302187,1492,10,N,N,-,-1,-1
PILGRIM.txt,300755,302344,1589,10,N,N,-,-1,-1
PILGRIM.txt,300932,302435,1503,10,N,N,-,-1,-1
PILGRIM.txt,300983,302589,1606,10,N,N,-,-1,-1
PILGRIM.txt,301070,302812,1742,10,N,N,-,-1,-1
PILGRIM.txt,301448,303140,1692,10,N,N,-,-1,-1
PILGRIM.txt,301463,303256,1793,10,N,N,-,-1,-1
PILGRIM.txt,301728,303564,1836,10,N,N,-,-1,-1
PILGRIM.txt,301952,303783,1831,10,N,N,-,-1,-1
PILGRIM.txt,302023,303843,1820,10,N,N,-,-1,-1
PILGRIM.txt,302190,303964,1774,10,N,N,-,-1,-1
PILGRIM.txt,302345,304078,1733,10,N,N,-,-1,-1
PILGRIM.txt,302438,304176,1738,10,N,N,-,-1,-1
PILGRIM.txt,302590,304333,1743,10,N,N,-,-1,-1
PILGRIM.txt,302815,304457,1642,10,N,N,-,-1,-1
PILGRIM.txt,303143,304538,1395,10,N,N,-,-1,-1
PILGRIM.txt,303257,304598,1341,10,N,N,-,-1,-1
PILGRIM.txt,303566,304669,1103,10,N,N,-,-1,-1
PILGRIM.txt,303786,304866,1080,10,N,N,-,-1,-1
PILGRIM.txt,303844,305115,1271,10,N,N,-,-1,-1
PILGRIM.txt,303965,305215,1250,10,N,N,-,-1,-1
PILGRIM.txt,304079,305303,1224,10,N,N,-,-1,-1
PILGRIM.txt,304179,305361,1182,10,N,N,-,-1,-1
PILGRIM.txt,304335,305527,1192,10,N,N,-,-1,-1
PILGRIM.txt,304458,305624,1166,10,N,N,-,-1,-1
PILGRIM.txt,304539,305673,1134,10,N,N,-,-1,-1
PILGRIM.txt,304599,305818,1219,10,N,N,-,-1,-1
PILGRIM.txt,304670,305989,1319,10,N,N,-,-1,-1
PILGRIM.txt,304867,306128,1261,10,N,N,-,-1,-1
PILGRIM.txt,305118,306238,1120,10,N,N,-,-1,-1
PILGRIM.txt,305217,306401,1184,10,N,N,-,-1,-1
PILGRIM.txt,305311,306453,1142,10,N,N,-,-1,-1
PILGRIM.txt,305366,306545,1179,10,N,N,-,-1,-1
PILGRIM.txt,305528,306552,1024,10,N,N,-,-1,-1
PILGRIM.txt,305626,306644,1018,10,N,N,-,-1,-1
PILGRIM.txt,305676,306784,1108,10,Y,N,-,-1,-1
PILGRIM.txt,305819,306885,1066,10,Y,N,-,-1,-1
PILGRIM.txt,305990,307024,1034,10,Y,N,-,-1,-1
PILGRIM.txt,306129,307099,970,10,Y,N,-,-1,-1
PILGRIM.txt,306239,307154,915,10,Y,N,-,-1,-1
PILGRIM.txt,306402,307260,858,10,Y,N,-,-1,-1
PILGRIM.txt,306454,307323,869,10,N,N,-,-1,-1
PILGRIM.txt,306546,307407,861,10,N,N,-,-1,-1
PILGRIM.txt,306553,307473,920,10,N,N,-,-1,-1
PILGRIM.txt,306645,307596,951,10,Y,N,-,-1,-1
PILGRIM.txt,306786,307761,975,10,Y,N,-,-1,-1
PILGRIM.txt,306888,307859,971,10,N,N,-,-1,-1
PILGRIM.txt,307025,308009,984,10,Y,N,-,-1,-1
PILGRIM.txt,307101,308098,997,10,Y,N,-,-1,-1
PILGRIM.txt,307155,308148,993,10,Y,N,-,-1,-1
PILGRIM.txt,307261,308226,965,10,Y,Y,1437472380836,351899,352666
PILGRIM.txt,307324,308309,985,10,Y,Y,1437472380836,351899,352666
PILGRIM.txt,307410,308328,918,10,Y,Y,1437472380836,351899,352666
PILGRIM.txt,307474,308488,1014,10,Y,Y,1437472380836,351899,352666
PILGRIM.txt,307597,308585,988,10,N,Y,1437472380836,351899,352666
PILGRIM.txt,307762,308659,897,10,N,Y,1437472380836,351899,352666
PILGRIM.txt,307860,308884,1024,10,N,Y,1437472380836,351899,352666
PILGRIM.txt,308010,308970,960,10,N,Y,1437472380836,351899,352666
PILGRIM.txt,308100,309155,1055,10,N,Y,1437472380836,351899,352666
PILGRIM.txt,308151,309255,1104,10,N,Y,1437472380836,351899,352666
PILGRIM.txt,308227,309358,1131,10,N,Y,1437472380836,351899,352666
PILGRIM.txt,308311,309404,1093,10,N,Y,1437472380836,351899,352666
PILGRIM.txt,308329,309472,1143,10,N,Y,1437472380836,351899,352666
PILGRIM.txt,308489,309506,1017,10,N,Y,1437472380836,351899,352666
PILGRIM.txt,308586,309651,1065,10,N,Y,1437472380836,351899,352666
PILGRIM.txt,308660,309817,1157,10,N,Y,1437472380836,351899,352666
PILGRIM.txt,308885,309859,974,10,N,Y,1437472380836,351899,352666
PILGRIM.txt,308971,310007,1036,10,N,Y,1437472380836,351899,352666
PILGRIM.txt,309156,310022,866,10,N,Y,1437472380836,351899,352666
PILGRIM.txt,309256,310195,939,10,N,Y,1437472380836,351899,352666
PILGRIM.txt,309359,310303,944,10,N,Y,1437472380836,351899,352666
PILGRIM.txt,309405,310454,1049,10,N,Y,1437472380836,351899,352666
PILGRIM.txt,309473,310485,1012,10,N,Y,1437472380836,351899,352666
PILGRIM.txt,309507,310629,1122,10,N,Y,1437472380836,351899,352666
PILGRIM.txt,309652,310731,1079,10,N,Y,1437472380836,351899,352666
PILGRIM.txt,309819,310867,1048,10,N,Y,1437472380836,351899,352666
PILGRIM.txt,309860,311016,1156,10,N,Y,1437472380836,351899,352666
PILGRIM.txt,310008,311135,1127,10,N,N,-,-1,-1
PILGRIM.txt,310025,311319,1294,10,N,N,-,-1,-1
PILGRIM.txt,310196,311528,1332,10,N,N,-,-1,-1
PILGRIM.txt,310304,311754,1450,10,N,N,-,-1,-1
PILGRIM.txt,310455,311909,1454,10,N,N,-,-1,-1
PILGRIM.txt,310486,312151,1665,10,N,N,-,-1,-1
PILGRIM.txt,310631,312248,1617,10,N,N,-,-1,-1
PILGRIM.txt,310732,312367,1635,10,N,N,-,-1,-1
PILGRIM.txt,310868,312478,1610,10,N,N,-,-1,-1
PILGRIM.txt,311017,312570,1553,10,N,N,-,-1,-1
PILGRIM.txt,311136,312573,1437,10,N,N,-,-1,-1
PILGRIM.txt,311320,312800,1480,10,N,N,-,-1,-1
PILGRIM.txt,311529,313010,1481,10,N,N,-,-1,-1
PILGRIM.txt,311755,313178,1423,10,N,N,-,-1,-1
PILGRIM.txt,311912,313267,1355,10,N,N,-,-1,-1
PILGRIM.txt,312152,313358,1206,10,N,N,-,-1,-1
PILGRIM.txt,312249,313492,1243,10,N,N,-,-1,-1
PILGRIM.txt,312368,313556,1188,10,N,N,-,-1,-1
PILGRIM.txt,312479,313705,1226,10,N,N,-,-1,-1
PILGRIM.txt,312572,313915,1343,10,N,N,-,-1,-1
PILGRIM.txt,312574,314006,1432,10,N,N,-,-1,-1
PILGRIM.txt,312801,314135,1334,10,N,N,-,-1,-1
PILGRIM.txt,313012,314326,1314,10,N,N,-,-1,-1
PILGRIM.txt,313180,314422,1242,10,N,N,-,-1,-1
PILGRIM.txt,313268,314492,1224,10,N,N,-,-1,-1
PILGRIM.txt,313359,314763,1404,10,N,N,-,-1,-1
PILGRIM.txt,313493,314817,1324,10,N,N,-,-1,-1
PILGRIM.txt,313557,315024,1467,10,N,N,-,-1,-1
PILGRIM.txt,313707,315098,1391,10,N,N,-,-1,-1
PILGRIM.txt,313916,315151,1235,10,N,N,-,-1,-1
PILGRIM.txt,314007,315334,1327,10,N,N,-,-1,-1
PILGRIM.txt,314137,315388,1251,10,N,N,-,-1,-1
PILGRIM.txt,314327,315539,1212,10,N,N,-,-1,-1
PILGRIM.txt,314423,315711,1288,10,N,N,-,-1,-1
PILGRIM.txt,314495,315768,1273,10,N,N,-,-1,-1
PILGRIM.txt,314764,315915,1151,10,N,N,-,-1,-1
PILGRIM.txt,314818,315959,1141,10,N,N,-,-1,-1
PILGRIM.txt,315025,316224,1199,10,N,N,-,-1,-1
PILGRIM.txt,315099,316273,1174,10,N,N,-,-1,-1
PILGRIM.txt,315152,316444,1292,10,N,N,-,-1,-1
PILGRIM.txt,315335,316604,1269,10,N,N,-,-1,-1
PILGRIM.txt,315389,316735,1346,10,N,N,-,-1,-1
PILGRIM.txt,315540,316786,1246,10,N,N,-,-1,-1
PILGRIM.txt,315712,316908,1196,10,N,N,-,-1,-1
PILGRIM.txt,315769,317066,1297,10,N,N,-,-1,-1
PILGRIM.txt,315918,317188,1270,10,N,N,-,-1,-1
PILGRIM.txt,315960,317321,1361,10,N,N,-,-1,-1
PILGRIM.txt,316225,317447,1222,10,N,N,-,-1,-1
PILGRIM.txt,316274,317577,1303,10,N,N,-,-1,-1
PILGRIM.txt,316445,317652,1207,10,N,N,-,-1,-1
PILGRIM.txt,316605,317709,1104,10,N,N,-,-1,-1
PILGRIM.txt,316736,317711,975,10,N,N,-,-1,-1
PILGRIM.txt,316787,317729,942,10,N,N,-,-1,-1
PILGRIM.txt,316909,318014,1105,10,N,N,-,-1,-1
PILGRIM.txt,317068,318168,1100,10,N,N,-,-1,-1
PILGRIM.txt,317191,318233,1042,10,N,N,-,-1,-1
PILGRIM.txt,317323,318397,1074,10,N,N,-,-1,-1
PILGRIM.txt,317450,318581,1131,10,N,N,-,-1,-1
PILGRIM.txt,317579,319023,1444,10,N,N,-,-1,-1
PILGRIM.txt,317653,319097,1444,10,N,N,-,-1,-1
PILGRIM.txt,317710,319217,1507,10,N,N,-,-1,-1
PILGRIM.txt,317716,319405,1689,10,N,N,-,-1,-1
PILGRIM.txt,317732,319558,1826,10,N,N,-,-1,-1
PILGRIM.txt,318017,319589,1572,10,N,N,-,-1,-1
PILGRIM.txt,318170,319687,1517,10,N,N,-,-1,-1
PILGRIM.txt,318234,319775,1541,10,N,N,-,-1,-1
PILGRIM.txt,318398,319920,1522,10,N,N,-,-1,-1
PILGRIM.txt,318583,320009,1426,10,N,N,-,-1,-1
PILGRIM.txt,319026,320168,1142,10,N,N,-,-1,-1
PILGRIM.txt,319098,320255,1157,10,N,N,-,-1,-1
PILGRIM.txt,319218,320374,1156,10,N,N,-,-1,-1
PILGRIM.txt,319408,320423,1015,10,N,N,-,-1,-1
PILGRIM.txt,319559,320606,1047,10,N,N,-,-1,-1
PILGRIM.txt,319590,320684,1094,10,N,N,-,-1,-1
PILGRIM.txt,319688,320822,1134,10,N,N,-,-1,-1
PILGRIM.txt,319777,320927,1150,10,N,N,-,-1,-1
PILGRIM.txt,319921,321089,1168,10,N,N,-,-1,-1
PILGRIM.txt,320012,321169,1157,10,N,N,-,-1,-1
PILGRIM.txt,320170,321195,1025,10,N,N,-,-1,-1
PILGRIM.txt,320256,321320,1064,10,N,N,-,-1,-1
PILGRIM.txt,320375,321363,988,10,N,N,-,-1,-1
PILGRIM.txt,320424,321401,977,10,N,N,-,-1,-1
PILGRIM.txt,320607,321507,900,10,N,N,-,-1,-1
PILGRIM.txt,320685,321518,833,10,N,N,-,-1,-1
PILGRIM.txt,320823,321669,846,10,N,N,-,-1,-1
PILGRIM.txt,320928,321676,748,10,N,N,-,-1,-1
PILGRIM.txt,321090,321887,797,10,N,N,-,-1,-1
PILGRIM.txt,321170,321989,819,10,N,N,-,-1,-1
PILGRIM.txt,321196,322103,907,10,N,N,-,-1,-1
PILGRIM.txt,321321,322372,1051,10,N,N,-,-1,-1
PILGRIM.txt,321366,322549,1183,10,N,N,-,-1,-1
PILGRIM.txt,321402,322651,1249,10,N,N,-,-1,-1
PILGRIM.txt,321508,322842,1334,10,N,N,-,-1,-1
PILGRIM.txt,321521,322877,1356,10,N,N,-,-1,-1
PILGRIM.txt,321670,323019,1349,10,N,N,-,-1,-1
PILGRIM.txt,321678,323290,1612,10,N,N,-,-1,-1
PILGRIM.txt,321888,323366,1478,10,N,N,-,-1,-1
PILGRIM.txt,321992,323485,1493,10,N,N,-,-1,-1
PILGRIM.txt,322104,323541,1437,10,N,N,-,-1,-1
PILGRIM.txt,322375,323666,1291,10,N,N,-,-1,-1
PILGRIM.txt,322550,324015,1465,10,N,N,-,-1,-1
PILGRIM.txt,322652,324212,1560,10,N,N,-,-1,-1
PILGRIM.txt,322845,324446,1601,10,N,N,-,-1,-1
PILGRIM.txt,322882,324685,1803,10,N,N,-,-1,-1
PILGRIM.txt,323020,324949,1929,10,N,N,-,-1,-1
PILGRIM.txt,323291,324997,1706,10,N,N,-,-1,-1
PILGRIM.txt,323369,325086,1717,10,N,N,-,-1,-1
PILGRIM.txt,323486,325295,1809,10,N,N,-,-1,-1
PILGRIM.txt,323542,325409,1867,10,N,N,-,-1,-1
PILGRIM.txt,323669,325644,1975,10,N,N,-,-1,-1
PILGRIM.txt,324016,325685,1669,10,N,N,-,-1,-1
PILGRIM.txt,324217,325780,1563,10,N,N,-,-1,-1
PILGRIM.txt,324447,325862,1415,10,N,N,-,-1,-1
PILGRIM.txt,324686,325965,1279,10,N,N,-,-1,-1
PILGRIM.txt,324950,326105,1155,10,N,N,-,-1,-1
PILGRIM.txt,325000,326390,1390,10,N,N,-,-1,-1
PILGRIM.txt,325087,326554,1467,10,N,N,-,-1,-1
PILGRIM.txt,325296,326667,1371,10,N,N,-,-1,-1
PILGRIM.txt,325412,326724,1312,10,N,N,-,-1,-1
PILGRIM.txt,325645,326985,1340,10,N,N,-,-1,-1
PILGRIM.txt,325686,327234,1548,10,N,N,-,-1,-1
PILGRIM.txt,325781,327281,1500,10,N,N,-,-1,-1
PILGRIM.txt,325863,327412,1549,10,N,N,-,-1,-1
PILGRIM.txt,325970,327564,1594,10,N,N,-,-1,-1
PILGRIM.txt,326106,327635,1529,10,N,N,-,-1,-1
PILGRIM.txt,326391,327701,1310,10,N,N,-,-1,-1
PILGRIM.txt,326555,327778,1223,10,N,N,-,-1,-1
PILGRIM.txt,326668,327937,1269,10,N,Y,1448279813455,71525,72226
PILGRIM.txt,326727,328219,1492,10,N,Y,1448279813455,71525,72226
PILGRIM.txt,326986,328405,1419,10,N,Y,1448279813455,71525,72226
PILGRIM.txt,327235,328544,1309,10,N,Y,1448279813455,71525,72226
PILGRIM.txt,327282,328623,1341,10,N,Y,1448279813455,71525,72226
PILGRIM.txt,327413,328774,1361,10,N,Y,1448279813455,71525,72226
PILGRIM.txt,327565,328827,1262,10,N,Y,1448279813455,71525,72226
PILGRIM.txt,327636,328995,1359,10,N,Y,1448279813455,71525,72226
PILGRIM.txt,327704,329259,1555,10,N,Y,1448279813455,71525,72226
PILGRIM.txt,327779,329459,1680,10,N,Y,1448279813455,71525,72226
PILGRIM.txt,327938,329580,1642,10,Y,Y,1448279813455,71525,72226
PILGRIM.txt,328220,329725,1505,10,N,Y,1448279813455,71525,72226
PILGRIM.txt,328406,329906,1500,10,N,Y,1448279813455,71525,72226
PILGRIM.txt,328545,329955,1410,10,N,Y,1448279813455,71525,72226
PILGRIM.txt,328624,330066,1442,10,N,Y,1448279813455,71525,72226
PILGRIM.txt,328775,330145,1370,10,N,Y,1448279813455,71525,72226
PILGRIM.txt,328828,330206,1378,10,N,Y,1448279813455,71525,72226
PILGRIM.txt,328996,330470,1474,10,N,Y,1448279813455,71525,72226
PILGRIM.txt,329262,330580,1318,10,N,Y,1448279813455,71525,72226
PILGRIM.txt,329460,330819,1359,10,N,Y,1448279813455,71525,72226
PILGRIM.txt,329581,330948,1367,10,N,Y,1448279813455,71525,72226
PILGRIM.txt,329726,331488,1762,10,N,Y,1448279813455,71525,72226
PILGRIM.txt,329907,331635,1728,10,N,N,-,-1,-1
PILGRIM.txt,329958,331778,1820,10,N,N,-,-1,-1
PILGRIM.txt,330068,331927,1859,10,N,N,-,-1,-1
PILGRIM.txt,330146,332111,1965,10,N,N,-,-1,-1
PILGRIM.txt,330207,332355,2148,10,N,N,-,-1,-1
PILGRIM.txt,330473,332431,1958,10,N,N,-,-1,-1
PILGRIM.txt,330581,332690,2109,10,N,N,-,-1,-1
PILGRIM.txt,330822,332718,1896,10,N,N,-,-1,-1
PILGRIM.txt,330951,332943,1992,10,N,N,-,-1,-1
PILGRIM.txt,331489,333022,1533,10,N,N,-,-1,-1
PILGRIM.txt,331636,333053,1417,10,N,N,-,-1,-1
PILGRIM.txt,331781,333070,1289,10,N,N,-,-1,-1
PILGRIM.txt,331930,333119,1189,10,N,N,-,-1,-1
PILGRIM.txt,332112,333368,1256,10,N,N,-,-1,-1
PILGRIM.txt,332358,333413,1055,10,N,N,-,-1,-1
PILGRIM.txt,332432,333662,1230,10,N,N,-,-1,-1
PILGRIM.txt,332693,333757,1064,10,N,N,-,-1,-1
PILGRIM.txt,332719,333778,1059,10,N,N,-,-1,-1
PILGRIM.txt,332946,333827,881,10,N,N,-,-1,-1
PILGRIM.txt,333028,334108,1080,10,N,N,-,-1,-1
PILGRIM.txt,333058,334197,1139,10,N,N,-,-1,-1
PILGRIM.txt,333073,334440,1367,10,N,N,-,-1,-1
PILGRIM.txt,333120,334585,1465,10,N,N,-,-1,-1
PILGRIM.txt,333371,334621,1250,10,N,N,-,-1,-1
PILGRIM.txt,333414,334767,1353,10,N,N,-,-1,-1
PILGRIM.txt,333663,334992,1329,10,N,N,-,-1,-1
PILGRIM.txt,333758,335581,1823,10,N,N,-,-1,-1
PILGRIM.txt,333781,335664,1883,10,N,N,-,-1,-1
PILGRIM.txt,333828,335853,2025,10,N,N,-,-1,-1
PILGRIM.txt,334109,336008,1899,10,N,N,-,-1,-1
PILGRIM.txt,334199,336276,2077,10,N,N,-,-1,-1
PILGRIM.txt,334441,336621,2180,10,N,N,-,-1,-1
PILGRIM.txt,334586,336709,2123,10,N,N,-,-1,-1
PILGRIM.txt,334623,336841,2218,10,N,N,-,-1,-1
PILGRIM.txt,334768,336858,2090,10,N,N,-,-1,-1
PILGRIM.txt,334995,336973,1978,10,N,N,-,-1,-1
PILGRIM.txt,335582,337044,1462,10,N,N,-,-1,-1
PILGRIM.txt,335665,337155,1490,10,N,N,-,-1,-1
PILGRIM.txt,335856,337401,1545,10,N,N,-,-1,-1
PILGRIM.txt,336011,337452,1441,10,N,N,-,-1,-1
PILGRIM.txt,336277,337647,1370,10,N,N,-,-1,-1
PILGRIM.txt,336622,337895,1273,10,N,N,-,-1,-1
PILGRIM.txt,336712,338133,1421,10,N,N,-,-1,-1
PILGRIM.txt,336842,338248,1406,10,N,N,-,-1,-1
PILGRIM.txt,336860,338527,1667,10,N,N,-,-1,-1
PILGRIM.txt,336974,338793,1819,10,N,N,-,-1,-1
PILGRIM.txt,337047,338987,1940,10,N,N,-,-1,-1
PILGRIM.txt,337156,339239,2083,10,N,N,-,-1,-1
PILGRIM.txt,337402,339403,2001,10,N,N,-,-1,-1
PILGRIM.txt,337455,339603,2148,10,N,N,-,-1,-1
PILGRIM.txt,337650,339621,1971,10,N,N,-,-1,-1
PILGRIM.txt,337896,339728,1832,10,N,N,-,-1,-1
PILGRIM.txt,338134,339913,1779,10,N,N,-,-1,-1
PILGRIM.txt,338251,340075,1824,10,N,N,-,-1,-1
PILGRIM.txt,338528,340327,1799,10,N,N,-,-1,-1
PILGRIM.txt,338796,340397,1601,10,N,N,-,-1,-1
PILGRIM.txt,338988,340621,1633,10,N,N,-,-1,-1
PILGRIM.txt,339240,340776,1536,10,N,N,-,-1,-1
PILGRIM.txt,339404,340972,1568,10,N,N,-,-1,-1
PILGRIM.txt,339604,341098,1494,10,N,N,-,-1,-1
PILGRIM.txt,339622,341303,1681,10,N,N,-,-1,-1
PILGRIM.txt,339729,341395,1666,10,N,N,-,-1,-1
PILGRIM.txt,339914,341518,1604,10,N,N,-,-1,-1
PILGRIM.txt,340076,341673,1597,10,N,N,-,-1,-1
PILGRIM.txt,340328,341845,1517,10,N,N,-,-1,-1
PILGRIM.txt,340400,342007,1607,10,N,N,-,-1,-1
PILGRIM.txt,340622,342171,1549,10,N,N,-,-1,-1
PILGRIM.txt,340778,342440,1662,10,N,N,-,-1,-1
PILGRIM.txt,340973,342471,1498,10,N,N,-,-1,-1
PILGRIM.txt,341100,342984,1884,10,N,N,-,-1,-1
PILGRIM.txt,341304,343099,1795,10,N,N,-,-1,-1
PILGRIM.txt,341396,343279,1883,10,N,N,-,-1,-1
PILGRIM.txt,341520,343612,2092,10,N,N,-,-1,-1
PILGRIM.txt,341674,343642,1968,10,N,N,-,-1,-1
PILGRIM.txt,341850,343824,1974,10,N,N,-,-1,-1
PILGRIM.txt,342008,344050,2042,10,N,N,-,-1,-1
PILGRIM.txt,342174,344166,1992,10,N,N,-,-1,-1
PILGRIM.txt,342443,344256,1813,10,N,N,-,-1,-1
PILGRIM.txt,342472,344524,2052,10,N,N,-,-1,-1
PILGRIM.txt,342985,344550,1565,10,N,N,-,-1,-1
PILGRIM.txt,343102,344705,1603,10,N,N,-,-1,-1
PILGRIM.txt,343280,345082,1802,10,N,N,-,-1,-1
PILGRIM.txt,343613,345317,1704,10,N,N,-,-1,-1
PILGRIM.txt,343647,345460,1813,10,N,N,-,-1,-1
PILGRIM.txt,343825,345613,1788,10,N,N,-,-1,-1
PILGRIM.txt,344051,345748,1697,10,N,N,-,-1,-1
PILGRIM.txt,344167,345894,1727,10,N,N,-,-1,-1
PILGRIM.txt,344257,346083,1826,10,N,N,-,-1,-1
PILGRIM.txt,344525,346231,1706,10,N,N,-,-1,-1
PILGRIM.txt,344551,346275,1724,10,N,N,-,-1,-1
PILGRIM.txt,344708,346451,1743,10,N,N,-,-1,-1
PILGRIM.txt,345083,346730,1647,10,N,N,-,-1,-1
PILGRIM.txt,345318,346886,1568,10,N,N,-,-1,-1
PILGRIM.txt,345462,347041,1579,10,N,N,-,-1,-1
PILGRIM.txt,345614,347157,1543,10,N,N,-,-1,-1
PILGRIM.txt,345749,347210,1461,10,N,N,-,-1,-1
PILGRIM.txt,345897,347479,1582,10,N,N,-,-1,-1
PILGRIM.txt,346084,347556,1472,10,N,N,-,-1,-1
PILGRIM.txt,346232,347675,1443,10,N,N,-,-1,-1
PILGRIM.txt,346278,347820,1542,10,N,N,-,-1,-1
PILGRIM.txt,346454,347921,1467,10,N,N,-,-1,-1
PILGRIM.txt,346731,348045,1314,10,N,N,-,-1,-1
PILGRIM.txt,346887,348207,1320,10,N,N,-,-1,-1
PILGRIM.txt,347042,348234,1192,10,N,N,-,-1,-1
PILGRIM.txt,347158,348380,1222,10,N,N,-,-1,-1
PILGRIM.txt,347215,348517,1302,10,N,N,-,-1,-1
PILGRIM.txt,347480,348719,1239,10,N,N,-,-1,-1
PILGRIM.txt,347559,348830,1271,10,N,N,-,-1,-1
PILGRIM.txt,347676,349033,1357,10,N,N,-,-1,-1
PILGRIM.txt,347822,349274,1452,10,N,N,-,-1,-1
PILGRIM.txt,347922,349378,1456,10,N,N,-,-1,-1
PILGRIM.txt,348046,349505,1459,10,N,N,-,-1,-1
PILGRIM.txt,348208,349667,1459,10,Y,N,-,-1,-1
PILGRIM.txt,348236,349852,1616,10,Y,N,-,-1,-1
PILGRIM.txt,348383,350097,1714,10,Y,N,-,-1,-1
PILGRIM.txt,348518,350189,1671,10,Y,N,-,-1,-1
PILGRIM.txt,348720,350452,1732,10,Y,N,-,-1,-1
PILGRIM.txt,348831,350612,1781,10,Y,N,-,-1,-1
PILGRIM.txt,349034,350745,1711,10,N,N,-,-1,-1
PILGRIM.txt,349277,350854,1577,10,Y,N,-,-1,-1
PILGRIM.txt,349380,350870,1490,10,N,N,-,-1,-1
PILGRIM.txt,349506,350892,1386,10,N,N,-,-1,-1
PILGRIM.txt,349668,351223,1555,10,N,N,-,-1,-1
PILGRIM.txt,349853,351370,1517,10,N,N,-,-1,-1
PILGRIM.txt,350098,351632,1534,10,N,N,-,-1,-1
PILGRIM.txt,350192,351790,1598,10,N,N,-,-1,-1
PILGRIM.txt,350453,351856,1403,10,N,N,-,-1,-1
PILGRIM.txt,350613,351952,1339,10,N,N,-,-1,-1
PILGRIM.txt,350746,352176,1430,10,N,N,-,-1,-1
PILGRIM.txt,350859,352275,1416,10,N,N,-,-1,-1
PILGRIM.txt,350873,352450,1577,10,N,N,-,-1,-1
PILGRIM.txt,350893,352663,1770,10,N,N,-,-1,-1
PILGRIM.txt,351226,352722,1496,10,N,N,-,-1,-1
PILGRIM.txt,351371,352875,1504,10,N,N,-,-1,-1
PILGRIM.txt,351634,353077,1443,10,N,N,-,-1,-1
PILGRIM.txt,351792,353178,1386,10,N,N,-,-1,-1
PILGRIM.txt,351859,353578,1719,10,N,N,-,-1,-1
PILGRIM.txt,351953,353797,1844,10,N,N,-,-1,-1
PILGRIM.txt,352177,354054,1877,10,N,N,-,-1,-1
PILGRIM.txt,352276,354224,1948,10,N,N,-,-1,-1
PILGRIM.txt,352451,354258,1807,10,N,N,-,-1,-1
PILGRIM.txt,352664,354450,1786,10,N,N,-,-1,-1
PILGRIM.txt,352725,354620,1895,10,N,N,-,-1,-1
PILGRIM.txt,352876,354931,2055,10,N,N,-,-1,-1
PILGRIM.txt,353078,355142,2064,10,N,N,-,-1,-1
PILGRIM.txt,353179,355234,2055,10,N,N,-,-1,-1
PILGRIM.txt,353579,355293,1714,10,N,N,-,-1,-1
PILGRIM.txt,353798,355374,1576,10,N,N,-,-1,-1
PILGRIM.txt,354055,355520,1465,10,N,N,-,-1,-1
PILGRIM.txt,354225,355647,1422,10,N,N,-,-1,-1
PILGRIM.txt,354263,355793,1530,10,N,N,-,-1,-1
PILGRIM.txt,354451,355899,1448,10,N,N,-,-1,-1
PILGRIM.txt,354622,356131,1509,10,N,N,-,-1,-1
PILGRIM.txt,354934,356348,1414,10,N,N,-,-1,-1
PILGRIM.txt,355143,356588,1445,10,N,N,-,-1,-1
PILGRIM.txt,355235,356666,1431,10,N,N,-,-1,-1
PILGRIM.txt,355296,356717,1421,10,N,N,-,-1,-1
PILGRIM.txt,355375,356916,1541,10,N,N,-,-1,-1
PILGRIM.txt,355523,357119,1596,10,N,N,-,-1,-1
PILGRIM.txt,355648,357370,1722,10,N,N,-,-1,-1
PILGRIM.txt,355796,357411,1615,10,N,N,-,-1,-1
PILGRIM.txt,355901,357611,1710,10,N,N,-,-1,-1
PILGRIM.txt,356132,357795,1663,10,N,N,-,-1,-1
PILGRIM.txt,356349,357835,1486,10,N,N,-,-1,-1
PILGRIM.txt,356589,357994,1405,10,N,N,-,-1,-1
PILGRIM.txt,356669,358150,1481,10,N,N,-,-1,-1
PILGRIM.txt,356719,358215,1496,10,N,N,-,-1,-1
PILGRIM.txt,356919,358311,1392,10,N,N,-,-1,-1
PILGRIM.txt,357120,358418,1298,10,N,N,-,-1,-1
PILGRIM.txt,357371,358482,1111,10,N,N,-,-1,-1
PILGRIM.txt,357412,358559,1147,10,N,N,-,-1,-1
PILGRIM.txt,357612,358588,976,10,N,N,-,-1,-1
PILGRIM.txt,357796,358679,883,10,N,N,-,-1,-1
PILGRIM.txt,357836,358813,977,10,N,N,-,-1,-1
PILGRIM.txt,357995,358920,925,10,N,N,-,-1,-1
PILGRIM.txt,358151,359009,858,10,N,N,-,-1,-1
PILGRIM.txt,358218,359138,920,10,N,N,-,-1,-1
PILGRIM.txt,358312,359291,979,10,N,N,-,-1,-1
PILGRIM.txt,358420,359423,1003,10,N,N,-,-1,-1
PILGRIM.txt,358483,359457,974,10,N,N,-,-1,-1
PILGRIM.txt,358560,359586,1026,10,N,N,-,-1,-1
PILGRIM.txt,358589,359794,1205,10,N,N,-,-1,-1
PILGRIM.txt,358682,359876,1194,10,N,N,-,-1,-1
PILGRIM.txt,358814,360236,1422,10,N,N,-,-1,-1
PILGRIM.txt,358921,360452,1531,10,N,N,-,-1,-1
PILGRIM.txt,359010,360668,1658,10,N,N,-,-1,-1
PILGRIM.txt,359140,360791,1651,10,N,N,-,-1,-1
PILGRIM.txt,359292,360939,1647,10,N,N,-,-1,-1
PILGRIM.txt,359424,361034,1610,10,N,N,-,-1,-1
PILGRIM.txt,359458,361153,1695,10,N,N,-,-1,-1
PILGRIM.txt,359588,361302,1714,10,N,N,-,-1,-1
PILGRIM.txt,359795,361358,1563,10,N,N,-,-1,-1
PILGRIM.txt,359877,361387,1510,10,N,N,-,-1,-1
PILGRIM.txt,360237,361543,1306,10,N,N,-,-1,-1
PILGRIM.txt,360455,361588,1133,10,N,N,-,-1,-1
PILGRIM.txt,360670,361795,1125,10,N,N,-,-1,-1
PILGRIM.txt,360792,361915,1123,10,N,N,-,-1,-1
PILGRIM.txt,360941,362036,1095,10,N,Y,1448279941918,72406,72905
PILGRIM.txt,361035,362105,1070,10,N,Y,1448279941918,72406,72905
PILGRIM.txt,361154,362278,1124,10,N,Y,1448279941918,72406,72905
PILGRIM.txt,361304,362406,1102,10,N,Y,1448279941918,72406,72905
PILGRIM.txt,361359,362590,1231,10,N,Y,1448279941918,72406,72905
PILGRIM.txt,361390,362750,1360,10,N,Y,1448279941918,72406,72905
PILGRIM.txt,361545,363072,1527,10,N,Y,1448279941918,72406,72905
PILGRIM.txt,361593,363236,1643,10,Y,Y,1448279941918,72406,72905
PILGRIM.txt,361796,363289,1493,10,Y,Y,1448279941918,72406,72905
PILGRIM.txt,361918,363467,1549,10,Y,Y,1448279941918,72406,72905
PILGRIM.txt,362037,363640,1603,10,N,Y,1448279941918,72406,72905
PILGRIM.txt,362106,363784,1678,10,N,Y,1448279941918,72406,72905
PILGRIM.txt,362281,364216,1935,10,N,Y,1448279941918,72406,72905
PILGRIM.txt,362407,364514,2107,10,Y,Y,1448279941918,72406,72905
PILGRIM.txt,362592,364753,2161,10,Y,Y,1448279941918,72406,72905
PILGRIM.txt,362751,364972,2221,10,Y,Y,1448279941918,72406,72905
PILGRIM.txt,363074,365105,2031,10,N,Y,1448279941918,72406,72905
PILGRIM.txt,363239,365230,1991,10,N,Y,1448279941918,72406,72905
PILGRIM.txt,363290,365298,2008,10,N,Y,1448279941918,72406,72905
PILGRIM.txt,363472,365539,2067,10,N,Y,1448279941918,72406,72905
PILGRIM.txt,363641,365654,2013,10,N,Y,1448279941918,72406,72905
PILGRIM.txt,363785,365682,1897,10,N,Y,1448279941918,72406,72905
PILGRIM.txt,364217,365888,1671,10,N,Y,1448279941918,72406,72905
PILGRIM.txt,364517,366046,1529,10,N,N,-,-1,-1
PILGRIM.txt,364756,366223,1467,10,N,N,-,-1,-1
PILGRIM.txt,364974,366361,1387,10,N,N,-,-1,-1
PILGRIM.txt,365106,366519,1413,10,N,N,-,-1,-1
PILGRIM.txt,365233,366629,1396,10,N,N,-,-1,-1
PILGRIM.txt,365299,366734,1435,10,N,N,-,-1,-1
PILGRIM.txt,365540,366751,1211,10,N,N,-,-1,-1
PILGRIM.txt,365655,366875,1220,10,N,N,-,-1,-1
PILGRIM.txt,365683,367025,1342,10,N,N,-,-1,-1
PILGRIM.txt,365891,367159,1268,10,N,N,-,-1,-1
PILGRIM.txt,366048,367356,1308,10,N,N,-,-1,-1
PILGRIM.txt,366226,367408,1182,10,N,N,-,-1,-1
PILGRIM.txt,366362,367566,1204,10,N,N,-,-1,-1
PILGRIM.txt,366520,367699,1179,10,N,N,-,-1,-1
PILGRIM.txt,366630,367843,1213,10,N,N,-,-1,-1
PILGRIM.txt,366739,368095,1356,10,N,N,-,-1,-1
PILGRIM.txt,366754,368284,1530,10,N,N,-,-1,-1
PILGRIM.txt,366878,368359,1481,10,N,N,-,-1,-1
PILGRIM.txt,367028,368464,1436,10,N,N,-,-1,-1
PILGRIM.txt,367160,368622,1462,10,N,N,-,-1,-1
PILGRIM.txt,367359,368739,1380,10,N,N,-,-1,-1
PILGRIM.txt,367410,368744,1334,10,N,N,-,-1,-1
PILGRIM.txt,367567,368812,1245,10,N,N,-,-1,-1
PILGRIM.txt,367700,369093,1393,10,N,N,-,-1,-1
PILGRIM.txt,367844,369310,1466,10,N,N,-,-1,-1
PILGRIM.txt,368097,369551,1454,10,N,N,-,-1,-1
PILGRIM.txt,368289,369654,1365,10,N,N,-,-1,-1
PILGRIM.txt,368360,369779,1419,10,N,N,-,-1,-1
PILGRIM.txt,368465,369863,1398,10,N,N,-,-1,-1
PILGRIM.txt,368624,369918,1294,10,N,N,-,-1,-1
PILGRIM.txt,368740,370088,1348,10,N,N,-,-1,-1
PILGRIM.txt,368745,370546,1801,10,N,N,-,-1,-1
PILGRIM.txt,368815,370662,1847,10,N,N,-,-1,-1
PILGRIM.txt,369094,370847,1753,10,N,N,-,-1,-1
PILGRIM.txt,369311,371001,1690,10,Y,N,-,-1,-1
PILGRIM.txt,369553,371158,1605,10,N,N,-,-1,-1
PILGRIM.txt,369655,371372,1717,10,N,N,-,-1,-1
PILGRIM.txt,369780,371446,1666,10,N,N,-,-1,-1
PILGRIM.txt,369863,371594,1731,10,N,N,-,-1,-1
PILGRIM.txt,369919,371698,1779,10,N,N,-,-1,-1
PILGRIM.txt,370093,371827,1734,10,N,N,-,-1,-1
PILGRIM.txt,370547,372040,1493,10,N,N,-,-1,-1
PILGRIM.txt,370663,372307,1644,10,N,N,-,-1,-1
PILGRIM.txt,370850,372456,1606,10,N,N,-,-1,-1
PILGRIM.txt,371003,372671,1668,10,N,N,-,-1,-1
PILGRIM.txt,371159,372939,1780,10,N,N,-,-1,-1
PILGRIM.txt,371373,372958,1585,10,N,N,-,-1,-1
PILGRIM.txt,371447,373139,1692,10,N,N,-,-1,-1
PILGRIM.txt,371595,373295,1700,10,N,N,-,-1,-1
PILGRIM.txt,371699,373434,1735,10,N,N,-,-1,-1
PILGRIM.txt,371828,373580,1752,10,N,N,-,-1,-1
PILGRIM.txt,372045,373687,1642,10,N,N,-,-1,-1
PILGRIM.txt,372308,373790,1482,10,N,N,-,-1,-1
PILGRIM.txt,372457,373880,1423,10,N,N,-,-1,-1
PILGRIM.txt,372672,374006,1334,10,N,N,-,-1,-1
PILGRIM.txt,372940,374173,1233,10,N,N,-,-1,-1
PILGRIM.txt,372960,374323,1363,10,N,N,-,-1,-1
PILGRIM.txt,373140,374436,1296,10,N,N,-,-1,-1
PILGRIM.txt,373296,374526,1230,10,N,N,-,-1,-1
PILGRIM.txt,373437,374685,1248,10,N,N,-,-1,-1
PILGRIM.txt,373581,374811,1230,10,N,N,-,-1,-1
PILGRIM.txt,373688,374976,1288,10,N,N,-,-1,-1
PILGRIM.txt,373791,375039,1248,10,N,N,-,-1,-1
PILGRIM.txt,373881,375150,1269,10,N,N,-,-1,-1
PILGRIM.txt,374007,375376,1369,10,N,N,-,-1,-1
PILGRIM.txt,374176,375486,1310,10,N,N,-,-1,-1
PILGRIM.txt,374324,375675,1351,10,N,N,-,-1,-1
PILGRIM.txt,374441,375815,1374,10,N,N,-,-1,-1
PILGRIM.txt,374526,376081,1555,10,N,N,-,-1,-1
PILGRIM.txt,374686,376130,1444,10,N,N,-,-1,-1
PILGRIM.txt,374812,376253,1441,10,N,N,-,-1,-1
PILGRIM.txt,374979,376428,1449,10,N,N,-,-1,-1
PILGRIM.txt,375040,376524,1484,10,N,N,-,-1,-1
PILGRIM.txt,375151,376603,1452,10,N,N,-,-1,-1
PILGRIM.txt,375377,376729,1352,10,N,N,-,-1,-1
PILGRIM.txt,375489,376750,1261,10,N,N,-,-1,-1
PILGRIM.txt,375676,376859,1183,10,N,N,-,-1,-1
PILGRIM.txt,375818,376947,1129,10,N,N,-,-1,-1
PILGRIM.txt,376083,376999,916,10,N,N,-,-1,-1
PILGRIM.txt,376133,377017,884,10,N,N,-,-1,-1
PILGRIM.txt,376254,377298,1044,10,N,N,-,-1,-1
PILGRIM.txt,376429,377589,1160,10,N,N,-,-1,-1
PILGRIM.txt,376525,377756,1231,10,N,N,-,-1,-1
PILGRIM.txt,376604,377834,1230,10,N,N,-,-1,-1
PILGRIM.txt,376730,377977,1247,10,N,N,-,-1,-1
PILGRIM.txt,376751,378176,1425,10,N,N,-,-1,-1
PILGRIM.txt,376860,378355,1495,10,N,N,-,-1,-1
PILGRIM.txt,376948,378400,1452,10,N,N,-,-1,-1
PILGRIM.txt,377004,378568,1564,10,N,N,-,-1,-1
PILGRIM.txt,377020,378706,1686,10,N,N,-,-1,-1
PILGRIM.txt,377301,378815,1514,10,N,N,-,-1,-1
PILGRIM.txt,377590,378897,1307,10,N,N,-,-1,-1
PILGRIM.txt,377759,379045,1286,10,N,N,-,-1,-1
PILGRIM.txt,377835,379185,1350,10,N,N,-,-1,-1
PILGRIM.txt,377978,379320,1342,10,N,N,-,-1,-1
PILGRIM.txt,378178,379428,1250,10,N,N,-,-1,-1
PILGRIM.txt,378356,379488,1132,10,N,N,-,-1,-1
PILGRIM.txt,378401,379650,1249,10,N,N,-,-1,-1
PILGRIM.txt,378573,379780,1207,10,N,N,-,-1,-1
PILGRIM.txt,378707,379968,1261,10,N,N,-,-1,-1
PILGRIM.txt,378815,380006,1191,10,N,N,-,-1,-1
PILGRIM.txt,378898,380215,1317,10,N,N,-,-1,-1
PILGRIM.txt,379048,380332,1284,10,N,N,-,-1,-1
PILGRIM.txt,379186,380485,1299,10,N,N,-,-1,-1
PILGRIM.txt,379323,380596,1273,10,N,N,-,-1,-1
PILGRIM.txt,379430,380673,1243,10,N,N,-,-1,-1
PILGRIM.txt,379489,380727,1238,10,N,N,-,-1,-1
PILGRIM.txt,379651,380903,1252,10,N,N,-,-1,-1
PILGRIM.txt,379781,381136,1355,10,N,N,-,-1,-1
PILGRIM.txt,379969,381223,1254,10,N,N,-,-1,-1
PILGRIM.txt,380007,381632,1625,10,N,N,-,-1,-1
PILGRIM.txt,380216,381909,1693,10,N,N,-,-1,-1
PILGRIM.txt,380333,381989,1656,10,N,N,-,-1,-1
PILGRIM.txt,380490,382129,1639,10,N,N,-,-1,-1
PILGRIM.txt,380597,382291,1694,10,N,N,-,-1,-1
PILGRIM.txt,380675,382361,1686,10,N,N,-,-1,-1
PILGRIM.txt,380728,382591,1863,10,N,N,-,-1,-1
PILGRIM.txt,380904,382720,1816,10,N,N,-,-1,-1
PILGRIM.txt,381139,382899,1760,10,N,N,-,-1,-1
PILGRIM.txt,381224,383027,1803,10,N,N,-,-1,-1
PILGRIM.txt,381633,383167,1534,10,N,N,-,-1,-1
PILGRIM.txt,381910,383344,1434,10,N,N,-,-1,-1
PILGRIM.txt,381992,383468,1476,10,N,N,-,-1,-1
PILGRIM.txt,382132,383563,1431,10,N,N,-,-1,-1
PILGRIM.txt,382292,383670,1378,10,N,N,-,-1,-1
PILGRIM.txt,382362,383915,1553,10,N,N,-,-1,-1
PILGRIM.txt,382592,383982,1390,10,N,N,-,-1,-1
PILGRIM.txt,382721,384014,1293,10,N,N,-,-1,-1
PILGRIM.txt,382902,384054,1152,10,N,N,-,-1,-1
PILGRIM.txt,383028,384304,1276,10,N,N,-,-1,-1
PILGRIM.txt,383168,384501,1333,10,N,N,-,-1,-1
PILGRIM.txt,383347,384621,1274,10,N,Y,1448281888079,98877,102290
PILGRIM.txt,383469,384846,1377,10,N,Y,1448281888079,98877,102290
PILGRIM.txt,383566,385308,1742,10,N,Y,1448281888079,98877,102290
PILGRIM.txt,383671,385467,1796,10,N,Y,1448281888079,98877,102290
PILGRIM.txt,383920,385922,2002,10,N,Y,1448281888079,98877,102290
PILGRIM.txt,383982,385974,1992,10,N,Y,1448281888079,98877,102290
PILGRIM.txt,384017,386082,2065,10,N,Y,1448281888079,98877,102290
PILGRIM.txt,384055,386224,2169,10,N,Y,1448281888079,98877,102290
PILGRIM.txt,384305,386323,2018,10,N,Y,1448281888079,98877,102290
PILGRIM.txt,384504,386569,2065,10,N,Y,1448281888079,98877,102290
PILGRIM.txt,384622,386858,2236,10,N,Y,1448281888079,98877,102290
PILGRIM.txt,384847,387061,2214,10,N,Y,1448281888079,98877,102290
PILGRIM.txt,385309,387389,2080,10,N,Y,1448281888079,98877,102290
PILGRIM.txt,385470,387578,2108,10,N,N,-,-1,-1
PILGRIM.txt,385927,387721,1794,10,N,N,-,-1,-1
PILGRIM.txt,385975,387793,1818,10,N,N,-,-1,-1
PILGRIM.txt,386083,387886,1803,10,N,N,-,-1,-1
PILGRIM.txt,386225,388019,1794,10,N,N,-,-1,-1
PILGRIM.txt,386326,388180,1854,10,N,N,-,-1,-1
PILGRIM.txt,386570,388229,1659,10,N,N,-,-1,-1
PILGRIM.txt,386860,388278,1418,10,N,N,-,-1,-1
PILGRIM.txt,387062,388348,1286,10,N,N,-,-1,-1
PILGRIM.txt,387391,388391,1000,10,N,N,-,-1,-1
PILGRIM.txt,387579,388519,940,10,N,N,-,-1,-1
PILGRIM.txt,387723,388691,968,10,N,N,-,-1,-1
PILGRIM.txt,387794,388803,1009,10,N,N,-,-1,-1
PILGRIM.txt,387887,388974,1087,10,N,N,-,-1,-1
PILGRIM.txt,388020,389091,1071,10,N,N,-,-1,-1
PILGRIM.txt,388181,389233,1052,10,N,N,-,-1,-1
PILGRIM.txt,388230,389302,1072,10,N,N,-,-1,-1
PILGRIM.txt,388279,389413,1134,10,N,N,-,-1,-1
PILGRIM.txt,388349,389571,1222,10,N,N,-,-1,-1
PILGRIM.txt,388392,389629,1237,10,N,N,-,-1,-1
PILGRIM.txt,388520,389798,1278,10,N,N,-,-1,-1
PILGRIM.txt,388692,389920,1228,10,N,N,-,-1,-1
PILGRIM.txt,388804,390152,1348,10,N,N,-,-1,-1
PILGRIM.txt,388975,390228,1253,10,N,N,-,-1,-1
PILGRIM.txt,389092,390449,1357,10,N,N,-,-1,-1
PILGRIM.txt,389235,390620,1385,10,N,N,-,-1,-1
PILGRIM.txt,389303,390715,1412,10,N,N,-,-1,-1
PILGRIM.txt,389414,390868,1454,10,N,N,-,-1,-1
PILGRIM.txt,389574,390973,1399,10,N,N,-,-1,-1
PILGRIM.txt,389630,391255,1625,10,N,N,-,-1,-1
PILGRIM.txt,389799,391566,1767,10,N,N,-,-1,-1
PILGRIM.txt,389921,391785,1864,10,N,N,-,-1,-1
PILGRIM.txt,390154,392017,1863,10,N,N,-,-1,-1
PILGRIM.txt,390229,392175,1946,10,N,N,-,-1,-1
PILGRIM.txt,390450,392484,2034,10,N,N,-,-1,-1
PILGRIM.txt,390620,392725,2105,10,N,N,-,-1,-1
PILGRIM.txt,390716,392899,2183,10,N,N,-,-1,-1
PILGRIM.txt,390870,392963,2093,10,N,N,-,-1,-1
PILGRIM.txt,390974,393061,2087,10,N,N,-,-1,-1
PILGRIM.txt,391256,393230,1974,10,N,N,-,-1,-1
PILGRIM.txt,391567,393277,1710,10,N,N,-,-1,-1
PILGRIM.txt,391786,393369,1583,10,N,N,-,-1,-1
PILGRIM.txt,392018,393444,1426,10,N,N,-,-1,-1
PILGRIM.txt,392178,393500,1322,10,N,N,-,-1,-1
PILGRIM.txt,392485,393573,1088,10,N,N,-,-1,-1
PILGRIM.txt,392726,393575,849,10,N,N,-,-1,-1
PILGRIM.txt,392900,393667,767,10,N,N,-,-1,-1
PILGRIM.txt,392964,393832,868,10,N,N,-,-1,-1
PILGRIM.txt,393062,393918,856,10,N,N,-,-1,-1
PILGRIM.txt,393231,394032,801,10,N,N,-,-1,-1
PILGRIM.txt,393278,394051,773,10,N,N,-,-1,-1
PILGRIM.txt,393370,394087,717,10,N,N,-,-1,-1
PILGRIM.txt,393445,394326,881,10,N,N,-,-1,-1
PILGRIM.txt,393501,394415,914,10,N,N,-,-1,-1
PILGRIM.txt,393574,394708,1134,10,N,N,-,-1,-1
PILGRIM.txt,393580,394868,1288,10,N,N,-,-1,-1
PILGRIM.txt,393668,394930,1262,10,N,N,-,-1,-1
PILGRIM.txt,393833,394942,1109,10,N,N,-,-1,-1
PILGRIM.txt,393919,395095,1176,10,N,N,-,-1,-1
PILGRIM.txt,394037,395161,1124,10,N,N,-,-1,-1
PILGRIM.txt,394054,395289,1235,10,N,N,-,-1,-1
PILGRIM.txt,394088,395456,1368,10,N,N,-,-1,-1
PILGRIM.txt,394329,395606,1277,10,N,N,-,-1,-1
PILGRIM.txt,394416,395694,1278,10,N,N,-,-1,-1
PILGRIM.txt,394709,395837,1128,10,N,N,-,-1,-1
PILGRIM.txt,394869,395883,1014,10,N,N,-,-1,-1
PILGRIM.txt,394931,396180,1249,10,N,N,-,-1,-1
PILGRIM.txt,394945,396364,1419,10,N,N,-,-1,-1
PILGRIM.txt,395096,396476,1380,10,N,N,-,-1,-1
PILGRIM.txt,395164,396600,1436,10,N,N,-,-1,-1
PILGRIM.txt,395290,396757,1467,10,N,N,-,-1,-1
PILGRIM.txt,395457,396844,1387,10,N,N,-,-1,-1
PILGRIM.txt,395607,397003,1396,10,Y,N,-,-1,-1
PILGRIM.txt,395695,397112,1417,10,Y,N,-,-1,-1
PILGRIM.txt,395838,397313,1475,10,N,N,-,-1,-1
PILGRIM.txt,395884,397391,1507,10,N,N,-,-1,-1
PILGRIM.txt,396183,397993,1810,10,N,N,-,-1,-1
PILGRIM.txt,396367,398183,1816,10,N,N,-,-1,-1
PILGRIM.txt,396477,398353,1876,10,N,N,-,-1,-1
PILGRIM.txt,396601,398592,1991,10,N,N,-,-1,-1
PILGRIM.txt,396758,398759,2001,10,N,N,-,-1,-1
PILGRIM.txt,396847,399020,2173,10,N,N,-,-1,-1
PILGRIM.txt,397004,399360,2356,10,N,Y,1448279620157,70041,71486
PILGRIM.txt,397115,399699,2584,10,N,Y,1448279620157,70041,71486
PILGRIM.txt,397314,400219,2905,10,N,Y,1448279620157,70041,71486
PILGRIM.txt,397394,400471,3077,10,N,Y,1448279620157,70041,71486
PILGRIM.txt,397996,400589,2593,10,N,Y,1448279620157,70041,71486
PILGRIM.txt,398186,400721,2535,10,N,Y,1448279620157,70041,71486
PILGRIM.txt,398354,400928,2574,10,N,Y,1448279620157,70041,71486
PILGRIM.txt,398595,401092,2497,10,N,Y,1448279620157,70041,71486
PILGRIM.txt,398764,401165,2401,10,N,Y,1448279620157,70041,71486
PILGRIM.txt,399021,401322,2301,10,N,Y,1448279620157,70041,71486
PILGRIM.txt,399361,401559,2198,10,N,Y,1448279620157,70041,71486
PILGRIM.txt,399700,401674,1974,10,N,Y,1448279620157,70041,71486
PILGRIM.txt,400220,401912,1692,10,N,Y,1448279620157,70041,71486
PILGRIM.txt,400476,402009,1533,10,N,N,-,-1,-1
PILGRIM.txt,400590,402131,1541,10,N,N,-,-1,-1
PILGRIM.txt,400724,402286,1562,10,N,N,-,-1,-1
PILGRIM.txt,400929,402456,1527,10,N,N,-,-1,-1
PILGRIM.txt,401094,402572,1478,10,N,N,-,-1,-1
PILGRIM.txt,401168,402618,1450,10,N,N,-,-1,-1
PILGRIM.txt,401324,402677,1353,10,N,N,-,-1,-1
PILGRIM.txt,401560,402817,1257,10,N,N,-,-1,-1
PILGRIM.txt,401675,402970,1295,10,N,N,-,-1,-1
PILGRIM.txt,401913,403087,1174,10,N,N,-,-1,-1
PILGRIM.txt,402010,403197,1187,10,N,N,-,-1,-1
PILGRIM.txt,402133,403293,1160,10,N,N,-,-1,-1
PILGRIM.txt,402287,403364,1077,10,N,N,-,-1,-1
PILGRIM.txt,402457,403431,974,10,N,N,-,-1,-1
PILGRIM.txt,402573,403482,909,10,N,N,-,-1,-1
PILGRIM.txt,402619,403617,998,10,N,N,-,-1,-1
PILGRIM.txt,402678,403692,1014,10,N,N,-,-1,-1
PILGRIM.txt,402818,403914,1096,10,N,N,-,-1,-1
PILGRIM.txt,402972,404013,1041,10,N,N,-,-1,-1
PILGRIM.txt,403090,404190,1100,10,N,N,-,-1,-1
PILGRIM.txt,403198,404374,1176,10,N,N,-,-1,-1
PILGRIM.txt,403294,404443,1149,10,N,N,-,-1,-1
PILGRIM.txt,403365,404748,1383,10,N,N,-,-1,-1
PILGRIM.txt,403434,405031,1597,10,N,N,-,-1,-1
PILGRIM.txt,403484,405146,1662,10,N,N,-,-1,-1
PILGRIM.txt,403620,405330,1710,10,N,N,-,-1,-1
PILGRIM.txt,403693,405473,1780,10,N,N,-,-1,-1
PILGRIM.txt,403915,405736,1821,10,N,N,-,-1,-1
PILGRIM.txt,404014,405885,1871,10,N,N,-,-1,-1
PILGRIM.txt,404191,405929,1738,10,N,N,-,-1,-1
PILGRIM.txt,404375,406119,1744,10,N,N,-,-1,-1
PILGRIM.txt,404444,406238,1794,10,N,N,-,-1,-1
PILGRIM.txt,404749,406606,1857,10,N,N,-,-1,-1
PILGRIM.txt,405032,406625,1593,10,N,N,-,-1,-1
PILGRIM.txt,405147,406630,1483,10,N,N,-,-1,-1
PILGRIM.txt,405333,406745,1412,10,N,N,-,-1,-1
PILGRIM.txt,405475,406894,1419,10,N,N,-,-1,-1
PILGRIM.txt,405738,407028,1290,10,N,N,-,-1,-1
PILGRIM.txt,405886,407318,1432,10,N,N,-,-1,-1
PILGRIM.txt,405930,407455,1525,10,N,N,-,-1,-1
PILGRIM.txt,406124,407538,1414,10,N,N,-,-1,-1
PILGRIM.txt,406239,407543,1304,10,N,N,-,-1,-1
PILGRIM.txt,406607,407600,993,10,N,N,-,-1,-1
PILGRIM.txt,406626,407712,1086,10,N,N,-,-1,-1
PILGRIM.txt,406632,407884,1252,10,N,N,-,-1,-1
PILGRIM.txt,406748,408240,1492,10,N,N,-,-1,-1
PILGRIM.txt,406896,408473,1577,10,N,N,-,-1,-1
PILGRIM.txt,407029,408616,1587,10,N,N,-,-1,-1
PILGRIM.txt,407320,408793,1473,10,N,N,-,-1,-1
PILGRIM.txt,407458,408928,1470,10,N,N,-,-1,-1
PILGRIM.txt,407539,409087,1548,10,N,N,-,-1,-1
PILGRIM.txt,407544,409267,1723,10,N,N,-,-1,-1
PILGRIM.txt,407603,409351,1748,10,N,N,-,-1,-1
PILGRIM.txt,407713,409361,1648,10,N,N,-,-1,-1
PILGRIM.txt,407885,409373,1488,10,N,N,-,-1,-1
PILGRIM.txt,408241,409500,1259,10,N,N,-,-1,-1
PILGRIM.txt,408476,409644,1168,10,N,N,-,-1,-1
PILGRIM.txt,408617,409835,1218,10,N,N,-,-1,-1
PILGRIM.txt,408794,409852,1058,10,N,N,-,-1,-1
PILGRIM.txt,408929,410127,1198,10,N,N,-,-1,-1
PILGRIM.txt,409088,410232,1144,10,N,N,-,-1,-1
PILGRIM.txt,409269,410410,1141,10,N,N,-,-1,-1
PILGRIM.txt,409352,410595,1243,10,N,N,-,-1,-1
PILGRIM.txt,409362,410663,1301,10,N,N,-,-1,-1
PILGRIM.txt,409376,410737,1361,10,N,N,-,-1,-1
PILGRIM.txt,409501,410936,1435,10,N,N,-,-1,-1
PILGRIM.txt,409645,411012,1367,10,N,N,-,-1,-1
PILGRIM.txt,409840,411156,1316,10,N,N,-,-1,-1
PILGRIM.txt,409855,411216,1361,10,N,N,-,-1,-1
PILGRIM.txt,410132,411303,1171,10,N,N,-,-1,-1
PILGRIM.txt,410234,411517,1283,10,N,N,-,-1,-1
PILGRIM.txt,410411,411739,1328,10,N,N,-,-1,-1
PILGRIM.txt,410596,411953,1357,10,N,N,-,-1,-1
PILGRIM.txt,410664,412086,1422,10,N,Y,1437470299748,152207,152889
PILGRIM.txt,410740,412187,1447,10,N,Y,1437470299748,152207,152889
PILGRIM.txt,410937,412309,1372,10,N,Y,1437470299748,152207,152889
PILGRIM.txt,411013,412563,1550,10,N,Y,1437470299748,152207,152889
PILGRIM.txt,411157,412703,1546,10,N,Y,1437470299748,152207,152889
PILGRIM.txt,411217,412796,1579,10,N,Y,1437470299748,152207,152889
PILGRIM.txt,411304,412861,1557,10,N,Y,1437470299748,152207,152889
PILGRIM.txt,411518,413013,1495,10,N,Y,1437470299748,152207,152889
PILGRIM.txt,411742,413168,1426,10,N,Y,1437470299748,152207,152889
PILGRIM.txt,411956,413392,1436,10,N,Y,1437470299748,152207,152889
PILGRIM.txt,412087,413564,1477,10,N,Y,1437470299748,152207,152889
PILGRIM.txt,412188,413679,1491,10,N,Y,1437470299748,152207,152889
PILGRIM.txt,412310,413862,1552,10,N,Y,1437470299748,152207,152889
PILGRIM.txt,412564,414145,1581,10,N,Y,1437470299748,152207,152889
PILGRIM.txt,412704,414358,1654,10,N,Y,1437470299748,152207,152889
PILGRIM.txt,412797,414550,1753,10,N,Y,1437470299748,152207,152889
PILGRIM.txt,412862,414700,1838,10,N,Y,1437470299748,152207,152889
PILGRIM.txt,413015,414843,1828,10,N,Y,1437470299748,152207,152889
PILGRIM.txt,413169,414880,1711,10,N,Y,1437470299748,152207,152889
PILGRIM.txt,413393,415119,1726,10,N,Y,1437470299748,152207,152889
PILGRIM.txt,413565,415362,1797,10,N,Y,1437470299748,152207,152889
PILGRIM.txt,413682,415529,1847,10,N,N,-,-1,-1
PILGRIM.txt,413863,415775,1912,10,N,N,-,-1,-1
PILGRIM.txt,414146,415916,1770,10,N,N,-,-1,-1
PILGRIM.txt,414359,416090,1731,10,N,N,-,-1,-1
PILGRIM.txt,414551,416289,1738,10,N,N,-,-1,-1
PILGRIM.txt,414701,416403,1702,10,N,N,-,-1,-1
PILGRIM.txt,414844,416470,1626,10,N,N,-,-1,-1
PILGRIM.txt,414885,416677,1792,10,N,N,-,-1,-1
PILGRIM.txt,415121,416789,1668,10,N,N,-,-1,-1
PILGRIM.txt,415363,416974,1611,10,N,N,-,-1,-1
PILGRIM.txt,415530,417060,1530,10,N,N,-,-1,-1
PILGRIM.txt,415776,417238,1462,10,N,N,-,-1,-1
PILGRIM.txt,415917,417512,1595,10,N,N,-,-1,-1
PILGRIM.txt,416092,417774,1682,10,N,N,-,-1,-1
PILGRIM.txt,416292,417891,1599,10,N,N,-,-1,-1
PILGRIM.txt,416404,417977,1573,10,N,N,-,-1,-1
PILGRIM.txt,416471,418191,1720,10,N,N,-,-1,-1
PILGRIM.txt,416678,418283,1605,10,N,N,-,-1,-1
PILGRIM.txt,416790,418498,1708,10,N,N,-,-1,-1
PILGRIM.txt,416976,418588,1612,10,N,N,-,-1,-1
PILGRIM.txt,417063,418935,1872,10,N,N,-,-1,-1
PILGRIM.txt,417239,419016,1777,10,N,N,-,-1,-1
PILGRIM.txt,417513,419080,1567,10,N,N,-,-1,-1
PILGRIM.txt,417775,419161,1386,10,N,N,-,-1,-1
PILGRIM.txt,417892,419431,1539,10,N,N,-,-1,-1
PILGRIM.txt,417979,419613,1634,10,N,N,-,-1,-1
PILGRIM.txt,418192,419646,1454,10,N,N,-,-1,-1
PILGRIM.txt,418286,419878,1592,10,N,N,-,-1,-1
PILGRIM.txt,418499,420015,1516,10,N,N,-,-1,-1
PILGRIM.txt,418591,420135,1544,10,N,N,-,-1,-1
PILGRIM.txt,418938,420309,1371,10,N,N,-,-1,-1
PILGRIM.txt,419017,420419,1402,10,N,N,-,-1,-1
PILGRIM.txt,419081,420721,1640,10,N,N,-,-1,-1
PILGRIM.txt,419162,420806,1644,10,N,Y,1437477480340,424837,425856
PILGRIM.txt,419433,421029,1596,10,N,Y,1437477480340,424837,425856
PILGRIM.txt,419614,421108,1494,10,N,Y,1437477480340,424837,425856
PILGRIM.txt,419649,421363,1714,10,N,Y,1437477480340,424837,425856
PILGRIM.txt,419879,421683,1804,10,N,Y,1437477480340,424837,425856
PILGRIM.txt,420016,421716,1700,10,N,Y,1437477480340,424837,425856
PILGRIM.txt,420137,421824,1687,10,N,Y,1437477480340,424837,425856
PILGRIM.txt,420311,421993,1682,10,N,Y,1437477480340,424837,425856
PILGRIM.txt,420422,422172,1750,10,N,Y,1437477480340,424837,425856
PILGRIM.txt,420724,422221,1497,10,N,Y,1437477480340,424837,425856
PILGRIM.txt,420807,422264,1457,10,N,Y,1437477480340,424837,425856
PILGRIM.txt,421031,422396,1365,10,N,Y,1437477480340,424837,425856
PILGRIM.txt,421109,422583,1474,10,N,Y,1437477480340,424837,425856
PILGRIM.txt,421366,422852,1486,10,Y,Y,1437477480340,424837,425856
PILGRIM.txt,421684,422962,1278,10,N,N,-,-1,-1
PILGRIM.txt,421717,423154,1437,10,Y,N,-,-1,-1
PILGRIM.txt,421825,423424,1599,10,Y,N,-,-1,-1
PILGRIM.txt,421994,423543,1549,10,Y,N,-,-1,-1
PILGRIM.txt,422173,423678,1505,10,Y,N,-,-1,-1
PILGRIM.txt,422222,423843,1621,10,Y,N,-,-1,-1
PILGRIM.txt,422265,423951,1686,10,Y,N,-,-1,-1
PILGRIM.txt,422397,424068,1671,10,Y,N,-,-1,-1
PILGRIM.txt,422584,424142,1558,10,N,N,-,-1,-1
PILGRIM.txt,422853,424319,1466,10,N,N,-,-1,-1
PILGRIM.txt,422965,424450,1485,10,N,N,-,-1,-1
PILGRIM.txt,423155,424550,1395,10,N,N,-,-1,-1
PILGRIM.txt,423425,424659,1234,10,N,N,-,-1,-1
PILGRIM.txt,423544,424876,1332,10,N,N,-,-1,-1
PILGRIM.txt,423679,425100,1421,10,N,N,-,-1,-1
PILGRIM.txt,423844,425186,1342,10,N,N,-,-1,-1
PILGRIM.txt,423954,425204,1250,10,N,N,-,-1,-1
PILGRIM.txt,424069,425345,1276,10,N,N,-,-1,-1
PILGRIM.txt,424143,425518,1375,10,N,N,-,-1,-1
PILGRIM.txt,424320,425664,1344,10,N,N,-,-1,-1
PILGRIM.txt,424452,425788,1336,10,N,N,-,-1,-1
PILGRIM.txt,424551,425987,1436,10,N,N,-,-1,-1
PILGRIM.txt,424661,426072,1411,10,N,N,-,-1,-1
PILGRIM.txt,424878,426088,1210,10,N,N,-,-1,-1
PILGRIM.txt,425101,426364,1263,10,N,N,-,-1,-1
PILGRIM.txt,425187,426450,1263,10,N,N,-,-1,-1
PILGRIM.txt,425207,426590,1383,10,N,N,-,-1,-1
PILGRIM.txt,425348,426837,1489,10,N,N,-,-1,-1
PILGRIM.txt,425519,427153,1634,10,N,N,-,-1,-1
PILGRIM.txt,425665,427236,1571,10,N,N,-,-1,-1
PILGRIM.txt,425791,427322,1531,10,N,N,-,-1,-1
PILGRIM.txt,425988,427387,1399,10,N,N,-,-1,-1
PILGRIM.txt,426077,427556,1479,10,N,N,-,-1,-1
PILGRIM.txt,426091,427689,1598,10,N,N,-,-1,-1
PILGRIM.txt,426367,427888,1521,10,N,N,-,-1,-1
PILGRIM.txt,426451,428011,1560,10,N,N,-,-1,-1
PILGRIM.txt,426591,428188,1597,10,N,N,-,-1,-1
PILGRIM.txt,426838,428409,1571,10,N,N,-,-1,-1
PILGRIM.txt,427155,428548,1393,10,N,N,-,-1,-1
PILGRIM.txt,427237,428670,1433,10,N,N,-,-1,-1
PILGRIM.txt,427325,428720,1395,10,N,N,-,-1,-1
PILGRIM.txt,427388,428929,1541,10,N,N,-,-1,-1
PILGRIM.txt,427557,429145,1588,10,N,N,-,-1,-1
PILGRIM.txt,427690,429326,1636,10,N,N,-,-1,-1
PILGRIM.txt,427889,429433,1544,10,N,N,-,-1,-1
PILGRIM.txt,428012,429686,1674,10,N,N,-,-1,-1
PILGRIM.txt,428190,429717,1527,10,N,N,-,-1,-1
PILGRIM.txt,428412,429935,1523,10,N,N,-,-1,-1
PILGRIM.txt,428549,430127,1578,10,N,N,-,-1,-1
PILGRIM.txt,428672,430248,1576,10,N,N,-,-1,-1
PILGRIM.txt,428722,430318,1596,10,N,N,-,-1,-1
PILGRIM.txt,428931,430701,1770,10,N,N,-,-1,-1
PILGRIM.txt,429146,430803,1657,10,N,N,-,-1,-1
PILGRIM.txt,429327,430971,1644,10,N,N,-,-1,-1
PILGRIM.txt,429438,431035,1597,10,N,N,-,-1,-1
PILGRIM.txt,429688,431191,1503,10,N,N,-,-1,-1
PILGRIM.txt,429720,431401,1681,10,N,N,-,-1,-1
PILGRIM.txt,429936,431633,1697,10,Y,N,-,-1,-1
PILGRIM.txt,430130,431825,1695,10,Y,N,-,-1,-1
PILGRIM.txt,430249,431990,1741,10,Y,N,-,-1,-1
PILGRIM.txt,430319,432279,1960,10,Y,N,-,-1,-1
PILGRIM.txt,430702,432324,1622,10,Y,N,-,-1,-1
PILGRIM.txt,430804,432500,1696,10,Y,N,-,-1,-1
PILGRIM.txt,430974,432544,1570,10,Y,N,-,-1,-1
PILGRIM.txt,431036,432566,1530,10,Y,N,-,-1,-1
PILGRIM.txt,431192,432656,1464,10,N,N,-,-1,-1
PILGRIM.txt,431402,432704,1302,10,N,N,-,-1,-1
PILGRIM.txt,431636,432868,1232,10,N,N,-,-1,-1
PILGRIM.txt,431828,433060,1232,10,N,N,-,-1,-1
PILGRIM.txt,431991,433109,1118,10,N,N,-,-1,-1
PILGRIM.txt,432280,433300,1020,10,N,N,-,-1,-1
PILGRIM.txt,432326,433565,1239,10,N,N,-,-1,-1
PILGRIM.txt,432501,433700,1199,10,N,N,-,-1,-1
PILGRIM.txt,432545,433782,1237,10,N,N,-,-1,-1
PILGRIM.txt,432567,434042,1475,10,N,N,-,-1,-1
PILGRIM.txt,432657,434079,1422,10,N,N,-,-1,-1
PILGRIM.txt,432705,434285,1580,10,N,N,-,-1,-1
PILGRIM.txt,432873,434536,1663,10,N,N,-,-1,-1
PILGRIM.txt,433061,434749,1688,10,N,N,-,-1,-1
PILGRIM.txt,433110,435126,2016,10,N,N,-,-1,-1
PILGRIM.txt,433301,435322,2021,10,N,N,-,-1,-1
PILGRIM.txt,433566,435465,1899,10,N,N,-,-1,-1
PILGRIM.txt,433701,435551,1850,10,N,N,-,-1,-1
PILGRIM.txt,433784,435655,1871,10,N,N,-,-1,-1
PILGRIM.txt,434043,435726,1683,10,N,N,-,-1,-1
PILGRIM.txt,434082,435904,1822,10,N,N,-,-1,-1
PILGRIM.txt,434287,435956,1669,10,N,N,-,-1,-1
PILGRIM.txt,434541,436077,1536,10,N,N,-,-1,-1
PILGRIM.txt,434750,436244,1494,10,N,N,-,-1,-1
PILGRIM.txt,435129,436325,1196,10,N,N,-,-1,-1
PILGRIM.txt,435325,436381,1056,10,N,N,-,-1,-1
PILGRIM.txt,435466,436416,950,10,N,N,-,-1,-1
PILGRIM.txt,435552,436448,896,10,N,N,-,-1,-1
PILGRIM.txt,435656,436507,851,10,N,N,-,-1,-1
PILGRIM.txt,435727,436537,810,10,N,N,-,-1,-1
PILGRIM.txt,435905,436610,705,10,N,N,-,-1,-1
PILGRIM.txt,435961,436630,669,10,N,N,-,-1,-1
PILGRIM.txt,436078,436664,586,10,N,N,-,-1,-1
PILGRIM.txt,436246,436977,731,10,N,N,-,-1,-1
PILGRIM.txt,436326,437067,741,10,N,N,-,-1,-1
PILGRIM.txt,436382,437317,935,10,N,N,-,-1,-1
PILGRIM.txt,436417,437445,1028,10,N,N,-,-1,-1
PILGRIM.txt,436449,437543,1094,10,N,N,-,-1,-1
PILGRIM.txt,436508,437599,1091,10,N,N,-,-1,-1
PILGRIM.txt,436538,437616,1078,10,N,N,-,-1,-1
PILGRIM.txt,436612,437896,1284,10,N,N,-,-1,-1
PILGRIM.txt,436631,438038,1407,10,N,N,-,-1,-1
PILGRIM.txt,436667,438094,1427,10,N,N,-,-1,-1
PILGRIM.txt,436978,438312,1334,10,N,N,-,-1,-1
PILGRIM.txt,437068,438527,1459,10,N,N,-,-1,-1
PILGRIM.txt,437319,438617,1298,10,N,N,-,-1,-1
PILGRIM.txt,437446,438669,1223,10,N,N,-,-1,-1
PILGRIM.txt,437546,438776,1230,10,N,N,-,-1,-1
PILGRIM.txt,437604,439011,1407,10,N,N,-,-1,-1
PILGRIM.txt,437619,439274,1655,10,N,N,-,-1,-1
PILGRIM.txt,437899,439355,1456,10,N,N,-,-1,-1
PILGRIM.txt,438039,439504,1465,10,N,N,-,-1,-1
PILGRIM.txt,438095,439649,1554,10,N,N,-,-1,-1
PILGRIM.txt,438314,439761,1447,10,N,N,-,-1,-1
PILGRIM.txt,438530,439926,1396,10,N,N,-,-1,-1
PILGRIM.txt,438618,440053,1435,10,N,N,-,-1,-1
PILGRIM.txt,438670,440206,1536,10,N,N,-,-1,-1
PILGRIM.txt,438777,440381,1604,10,N,N,-,-1,-1
PILGRIM.txt,439012,440428,1416,10,N,N,-,-1,-1
PILGRIM.txt,439275,440509,1234,10,N,N,-,-1,-1
PILGRIM.txt,439356,440619,1263,10,N,N,-,-1,-1
PILGRIM.txt,439506,440696,1190,10,N,N,-,-1,-1
PILGRIM.txt,439650,440861,1211,10,N,N,-,-1,-1
PILGRIM.txt,439763,440927,1164,10,N,N,-,-1,-1
PILGRIM.txt,439927,441067,1140,10,N,N,-,-1,-1
PILGRIM.txt,440054,441106,1052,10,N,N,-,-1,-1
PILGRIM.txt,440207,441150,943,10,N,N,-,-1,-1
PILGRIM.txt,440384,441361,977,10,N,N,-,-1,-1
PILGRIM.txt,440430,441567,1137,10,N,N,-,-1,-1
PILGRIM.txt,440510,441843,1333,10,N,N,-,-1,-1
PILGRIM.txt,440620,441949,1329,10,N,N,-,-1,-1
PILGRIM.txt,440698,442054,1356,10,N,N,-,-1,-1
PILGRIM.txt,440866,442079,1213,10,N,N,-,-1,-1
PILGRIM.txt,440928,442172,1244,10,N,N,-,-1,-1
PILGRIM.txt,441068,442253,1185,10,N,N,-,-1,-1
PILGRIM.txt,441107,442311,1204,10,N,N,-,-1,-1
PILGRIM.txt,441153,442447,1294,10,N,N,-,-1,-1
PILGRIM.txt,441363,442635,1272,10,N,N,-,-1,-1
PILGRIM.txt,441568,442685,1117,10,N,N,-,-1,-1
PILGRIM.txt,441845,442738,893,10,N,N,-,-1,-1
PILGRIM.txt,441951,442797,846,10,N,N,-,-1,-1
PILGRIM.txt,442054,442971,917,10,N,N,-,-1,-1
PILGRIM.txt,442080,443045,965,10,N,N,-,-1,-1
PILGRIM.txt,442173,443073,900,10,N,N,-,-1,-1
PILGRIM.txt,442254,443108,854,10,N,N,-,-1,-1
PILGRIM.txt,442314,443149,835,10,N,N,-,-1,-1
PILGRIM.txt,442448,443167,719,10,N,N,-,-1,-1
PILGRIM.txt,442643,443209,566,10,N,N,-,-1,-1
PILGRIM.txt,442690,443344,654,10,N,N,-,-1,-1
PILGRIM.txt,442743,443510,767,10,N,N,-,-1,-1
PILGRIM.txt,442798,443555,757,10,N,N,-,-1,-1
PILGRIM.txt,442972,443732,760,10,N,N,-,-1,-1
PILGRIM.txt,443046,443934,888,10,N,N,-,-1,-1
PILGRIM.txt,443075,444104,1029,10,N,N,-,-1,-1
PILGRIM.txt,443109,444194,1085,10,N,N,-,-1,-1
PILGRIM.txt,443151,444326,1175,10,N,N,-,-1,-1
PILGRIM.txt,443168,444361,1193,10,N,N,-,-1,-1
PILGRIM.txt,443210,444605,1395,10,N,N,-,-1,-1
PILGRIM.txt,443345,444751,1406,10,N,N,-,-1,-1
PILGRIM.txt,443510,444875,1365,10,N,N,-,-1,-1
PILGRIM.txt,443558,444987,1429,10,N,N,-,-1,-1
PILGRIM.txt,443735,445132,1397,10,N,N,-,-1,-1
PILGRIM.txt,443935,445263,1328,10,N,N,-,-1,-1
PILGRIM.txt,444105,445424,1319,10,N,N,-,-1,-1
PILGRIM.txt,444197,445517,1320,10,N,N,-,-1,-1
PILGRIM.txt,444327,445643,1316,10,N,N,-,-1,-1
PILGRIM.txt,444362,445722,1360,10,N,N,-,-1,-1
PILGRIM.txt,444606,445871,1265,10,N,N,-,-1,-1
PILGRIM.txt,444753,446120,1367,10,N,N,-,-1,-1
PILGRIM.txt,444876,446330,1454,10,N,N,-,-1,-1
PILGRIM.txt,444988,446378,1390,10,N,N,-,-1,-1
PILGRIM.txt,445133,446485,1352,10,N,N,-,-1,-1
PILGRIM.txt,445266,446847,1581,10,N,N,-,-1,-1
PILGRIM.txt,445425,446979,1554,10,N,N,-,-1,-1
PILGRIM.txt,445518,447158,1640,10,N,N,-,-1,-1
PILGRIM.txt,445646,447297,1651,10,N,N,-,-1,-1
PILGRIM.txt,445723,447392,1669,10,N,N,-,-1,-1
PILGRIM.txt,445873,447440,1567,10,N,N,-,-1,-1
PILGRIM.txt,446121,447538,1417,10,N,N,-,-1,-1
PILGRIM.txt,446335,447639,1304,10,N,N,-,-1,-1
PILGRIM.txt,446379,447805,1426,10,N,N,-,-1,-1
PILGRIM.txt,446486,448039,1553,10,N,N,-,-1,-1
PILGRIM.txt,446849,448188,1339,10,N,N,-,-1,-1
PILGRIM.txt,446982,448414,1432,10,N,N,-,-1,-1
PILGRIM.txt,447161,448624,1463,10,N,N,-,-1,-1
PILGRIM.txt,447298,448789,1491,10,N,N,-,-1,-1
PILGRIM.txt,447393,448854,1461,10,N,N,-,-1,-1
PILGRIM.txt,447441,448947,1506,10,N,N,-,-1,-1
PILGRIM.txt,447539,449026,1487,10,N,N,-,-1,-1
PILGRIM.txt,447640,449291,1651,10,N,N,-,-1,-1
PILGRIM.txt,447806,449410,1604,10,N,N,-,-1,-1
PILGRIM.txt,448041,449585,1544,10,N,N,-,-1,-1
PILGRIM.txt,448193,449670,1477,10,N,N,-,-1,-1
PILGRIM.txt,448415,449819,1404,10,N,N,-,-1,-1
PILGRIM.txt,448626,449883,1257,10,N,N,-,-1,-1
PILGRIM.txt,448792,449987,1195,10,N,N,-,-1,-1
PILGRIM.txt,448855,450061,1206,10,N,N,-,-1,-1
PILGRIM.txt,448949,450085,1136,10,N,N,-,-1,-1
PILGRIM.txt,449027,450246,1219,10,N,N,-,-1,-1
PILGRIM.txt,449292,450540,1248,10,Y,N,-,-1,-1
PILGRIM.txt,449411,450626,1215,10,N,N,-,-1,-1
PILGRIM.txt,449586,450931,1345,10,Y,N,-,-1,-1
PILGRIM.txt,449671,451014,1343,10,Y,N,-,-1,-1
PILGRIM.txt,449820,451182,1362,10,N,N,-,-1,-1
PILGRIM.txt,449884,451216,1332,10,N,N,-,-1,-1
PILGRIM.txt,449988,451360,1372,10,N,N,-,-1,-1
PILGRIM.txt,450062,451450,1388,10,N,N,-,-1,-1
PILGRIM.txt,450090,451547,1457,10,N,N,-,-1,-1
PILGRIM.txt,450247,451735,1488,10,Y,N,-,-1,-1
PILGRIM.txt,450541,451906,1365,10,N,N,-,-1,-1
PILGRIM.txt,450627,452025,1398,10,N,N,-,-1,-1
PILGRIM.txt,450932,452056,1124,10,N,N,-,-1,-1
PILGRIM.txt,451015,452231,1216,10,N,N,-,-1,-1
PILGRIM.txt,451183,452404,1221,10,N,N,-,-1,-1
PILGRIM.txt,451217,452540,1323,10,N,N,-,-1,-1
PILGRIM.txt,451362,452812,1450,10,N,N,-,-1,-1
PILGRIM.txt,451453,453025,1572,10,N,N,-,-1,-1
PILGRIM.txt,451549,453086,1537,10,N,N,-,-1,-1
PILGRIM.txt,451736,453139,1403,10,N,N,-,-1,-1
PILGRIM.txt,451911,453247,1336,10,N,N,-,-1,-1
PILGRIM.txt,452026,453292,1266,10,N,N,-,-1,-1
PILGRIM.txt,452059,453449,1390,10,N,N,-,-1,-1
PILGRIM.txt,452234,453540,1306,10,N,N,-,-1,-1
PILGRIM.txt,452407,453850,1443,10,N,N,-,-1,-1
PILGRIM.txt,452543,454038,1495,10,N,N,-,-1,-1
PILGRIM.txt,452813,454305,1492,10,N,N,-,-1,-1
PILGRIM.txt,453026,454408,1382,10,N,N,-,-1,-1
PILGRIM.txt,453087,454555,1468,10,N,N,-,-1,-1
PILGRIM.txt,453140,454701,1561,10,N,N,-,-1,-1
PILGRIM.txt,453248,454844,1596,10,N,N,-,-1,-1
PILGRIM.txt,453295,454995,1700,10,N,N,-,-1,-1
PILGRIM.txt,453450,455168,1718,10,N,N,-,-1,-1
PILGRIM.txt,453543,455326,1783,10,N,N,-,-1,-1
PILGRIM.txt,453853,455450,1597,10,N,N,-,-1,-1
PILGRIM.txt,454039,455600,1561,10,N,Y,1437471397525,350644,351290
PILGRIM.txt,454306,455719,1413,10,N,Y,1437471397525,350644,351290
PILGRIM.txt,454409,455868,1459,10,N,Y,1437471397525,350644,351290
PILGRIM.txt,454557,456017,1460,10,N,Y,1437471397525,350644,351290
PILGRIM.txt,454702,456165,1463,10,N,Y,1437471397525,350644,351290
PILGRIM.txt,454845,456284,1439,10,N,Y,1437471397525,350644,351290
PILGRIM.txt,454996,456439,1443,10,N,Y,1437471397525,350644,351290
PILGRIM.txt,455169,456637,1468,10,N,Y,1437471397525,350644,351290
PILGRIM.txt,455327,456718,1391,10,N,Y,1437471397525,350644,351290
PILGRIM.txt,455453,456873,1420,10,N,Y,1437471397525,350644,351290
PILGRIM.txt,455601,456994,1393,10,N,Y,1437471397525,350644,351290
PILGRIM.txt,455720,457151,1431,10,N,Y,1437471397525,350644,351290
PILGRIM.txt,455871,457301,1430,10,N,N,-,-1,-1
PILGRIM.txt,456018,457337,1319,10,N,N,-,-1,-1
PILGRIM.txt,456166,457463,1297,10,N,N,-,-1,-1
PILGRIM.txt,456287,457490,1203,10,N,N,-,-1,-1
PILGRIM.txt,456442,457545,1103,10,N,N,-,-1,-1
PILGRIM.txt,456638,457649,1011,10,N,N,-,-1,-1
PILGRIM.txt,456719,457752,1033,10,N,N,-,-1,-1
PILGRIM.txt,456874,457883,1009,10,N,N,-,-1,-1
PILGRIM.txt,456996,457932,936,10,N,N,-,-1,-1
PILGRIM.txt,457152,458081,929,10,N,N,-,-1,-1
PILGRIM.txt,457302,458184,882,10,N,N,-,-1,-1
PILGRIM.txt,457338,458357,1019,10,N,N,-,-1,-1
PILGRIM.txt,457464,458491,1027,10,N,N,-,-1,-1
PILGRIM.txt,457491,458722,1231,10,N,N,-,-1,-1
PILGRIM.txt,457546,458797,1251,10,N,N,-,-1,-1
PILGRIM.txt,457650,458930,1280,10,N,N,-,-1,-1
PILGRIM.txt,457755,458951,1196,10,N,N,-,-1,-1
PILGRIM.txt,457884,459357,1473,10,N,N,-,-1,-1
PILGRIM.txt,457933,459548,1615,10,N,N,-,-1,-1
PILGRIM.txt,458082,459552,1470,10,N,N,-,-1,-1
PILGRIM.txt,458185,459618,1433,10,N,N,-,-1,-1
PILGRIM.txt,458358,459701,1343,10,N,N,-,-1,-1
PILGRIM.txt,458493,459901,1408,10,N,N,-,-1,-1
PILGRIM.txt,458723,460014,1291,10,N,N,-,-1,-1
PILGRIM.txt,458798,460080,1282,10,N,N,-,-1,-1
PILGRIM.txt,458931,460283,1352,10,N,N,-,-1,-1
PILGRIM.txt,458956,460439,1483,10,N,N,-,-1,-1
PILGRIM.txt,459358,460564,1206,10,N,N,-,-1,-1
PILGRIM.txt,459549,460612,1063,10,N,N,-,-1,-1
PILGRIM.txt,459553,460741,1188,10,N,N,-,-1,-1
PILGRIM.txt,459619,460807,1188,10,N,N,-,-1,-1
PILGRIM.txt,459702,460825,1123,10,N,N,-,-1,-1
PILGRIM.txt,459902,461138,1236,10,N,N,-,-1,-1
PILGRIM.txt,460015,461300,1285,10,N,N,-,-1,-1
PILGRIM.txt,460081,461444,1363,10,N,N,-,-1,-1
PILGRIM.txt,460284,461506,1222,10,N,N,-,-1,-1
PILGRIM.txt,460440,461677,1237,10,N,N,-,-1,-1
PILGRIM.txt,460565,461822,1257,10,N,N,-,-1,-1
PILGRIM.txt,460613,461966,1353,10,N,N,-,-1,-1
PILGRIM.txt,460742,462147,1405,10,N,N,-,-1,-1
PILGRIM.txt,460812,462387,1575,10,N,N,-,-1,-1
PILGRIM.txt,460828,462590,1762,10,N,N,-,-1,-1
PILGRIM.txt,461141,462786,1645,10,N,N,-,-1,-1
PILGRIM.txt,461302,462905,1603,10,N,N,-,-1,-1
PILGRIM.txt,461445,463065,1620,10,N,N,-,-1,-1
PILGRIM.txt,461507,463164,1657,10,N,N,-,-1,-1
PILGRIM.txt,461680,463364,1684,10,N,N,-,-1,-1
PILGRIM.txt,461824,463626,1802,10,N,N,-,-1,-1
PILGRIM.txt,461967,463687,1720,10,N,N,-,-1,-1
PILGRIM.txt,462148,463875,1727,10,N,N,-,-1,-1
PILGRIM.txt,462388,463915,1527,10,N,N,-,-1,-1
PILGRIM.txt,462593,463992,1399,10,N,N,-,-1,-1
PILGRIM.txt,462789,464145,1356,10,N,N,-,-1,-1
PILGRIM.txt,462906,464313,1407,10,N,N,-,-1,-1
PILGRIM.txt,463066,464429,1363,10,N,N,-,-1,-1
PILGRIM.txt,463165,464701,1536,10,N,N,-,-1,-1
PILGRIM.txt,463365,464782,1417,10,N,N,-,-1,-1
PILGRIM.txt,463627,464871,1244,10,N,N,-,-1,-1
PILGRIM.txt,463690,465079,1389,10,N,N,-,-1,-1
PILGRIM.txt,463876,465213,1337,10,N,N,-,-1,-1
PILGRIM.txt,463918,465220,1302,10,N,N,-,-1,-1
PILGRIM.txt,463993,465258,1265,10,N,N,-,-1,-1
PILGRIM.txt,464146,465298,1152,10,N,N,-,-1,-1
PILGRIM.txt,464315,465399,1084,10,N,N,-,-1,-1
PILGRIM.txt,464430,465623,1193,10,N,N,-,-1,-1
PILGRIM.txt,464704,465669,965,10,N,N,-,-1,-1
PILGRIM.txt,464783,465978,1195,10,N,N,-,-1,-1
PILGRIM.txt,464874,466114,1240,10,N,N,-,-1,-1
PILGRIM.txt,465080,466301,1221,10,N,N,-,-1,-1
PILGRIM.txt,465214,466538,1324,10,N,N,-,-1,-1
PILGRIM.txt,465221,466659,1438,10,N,N,-,-1,-1
PILGRIM.txt,465260,466800,1540,10,N,N,-,-1,-1
PILGRIM.txt,465301,466890,1589,10,N,N,-,-1,-1
PILGRIM.txt,465401,467000,1599,10,N,N,-,-1,-1
PILGRIM.txt,465626,467081,1455,10,N,N,-,-1,-1
PILGRIM.txt,465671,467263,1592,10,N,N,-,-1,-1
PILGRIM.txt,465980,467360,1380,10,N,N,-,-1,-1
PILGRIM.txt,466116,467562,1446,10,N,N,-,-1,-1
PILGRIM.txt,466302,467617,1315,10,N,N,-,-1,-1
PILGRIM.txt,466541,467783,1242,10,N,N,-,-1,-1
PILGRIM.txt,466660,467855,1195,10,N,N,-,-1,-1
PILGRIM.txt,466802,467980,1178,10,N,N,-,-1,-1
PILGRIM.txt,466891,468070,1179,10,N,N,-,-1,-1
PILGRIM.txt,467001,468110,1109,10,N,N,-,-1,-1
PILGRIM.txt,467082,468136,1054,10,N,N,-,-1,-1
PILGRIM.txt,467265,468141,876,10,N,N,-,-1,-1
PILGRIM.txt,467361,468330,969,10,N,N,-,-1,-1
PILGRIM.txt,467565,468430,865,10,N,N,-,-1,-1
PILGRIM.txt,467619,468559,940,10,N,N,-,-1,-1
PILGRIM.txt,467786,468714,928,10,N,N,-,-1,-1
PILGRIM.txt,467856,468801,945,10,N,N,-,-1,-1
PILGRIM.txt,467981,469017,1036,10,N,N,-,-1,-1
PILGRIM.txt,468071,469154,1083,10,N,N,-,-1,-1
PILGRIM.txt,468112,469251,1139,10,N,N,-,-1,-1
PILGRIM.txt,468137,469313,1176,10,N,N,-,-1,-1
PILGRIM.txt,468142,469495,1353,10,N,N,-,-1,-1
PILGRIM.txt,468331,469581,1250,10,N,N,-,-1,-1
PILGRIM.txt,468433,469661,1228,10,N,N,-,-1,-1
PILGRIM.txt,468560,470010,1450,10,N,N,-,-1,-1
PILGRIM.txt,468715,470131,1416,10,Y,N,-,-1,-1
PILGRIM.txt,468803,470253,1450,10,Y,N,-,-1,-1
PILGRIM.txt,469018,470406,1388,10,Y,N,-,-1,-1
PILGRIM.txt,469155,470570,1415,10,N,N,-,-1,-1
PILGRIM.txt,469252,470949,1697,10,N,N,-,-1,-1
PILGRIM.txt,469314,471066,1752,10,N,N,-,-1,-1
PILGRIM.txt,469496,471308,1812,10,N,N,-,-1,-1
PILGRIM.txt,469583,471635,2052,10,N,N,-,-1,-1
PILGRIM.txt,469662,471753,2091,10,N,Y,1437476486340,221621,222520
PILGRIM.txt,470013,471890,1877,10,N,Y,1437476486340,221621,222520
PILGRIM.txt,470132,472146,2014,10,N,Y,1437476486340,221621,222520
PILGRIM.txt,470254,472312,2058,10,N,Y,1437476486340,221621,222520
PILGRIM.txt,470407,472425,2018,10,N,Y,1437476486340,221621,222520
PILGRIM.txt,470573,472647,2074,10,N,Y,1437476486340,221621,222520
PILGRIM.txt,470950,472884,1934,10,N,Y,1437476486340,221621,222520
PILGRIM.txt,471067,472936,1869,10,N,Y,1437476486340,221621,222520
PILGRIM.txt,471311,473081,1770,10,N,Y,1437476486340,221621,222520
PILGRIM.txt,471638,473137,1499,10,N,Y,1437476486340,221621,222520
PILGRIM.txt,471754,473280,1526,10,N,Y,1437476486340,221621,222520
PILGRIM.txt,471891,473437,1546,10,N,Y,1437476486340,221621,222520
PILGRIM.txt,472147,473509,1362,10,N,Y,1437476486340,221621,222520
PILGRIM.txt,472315,473613,1298,10,N,N,-,-1,-1
PILGRIM.txt,472426,473794,1368,10,N,N,-,-1,-1
PILGRIM.txt,472648,473918,1270,10,N,N,-,-1,-1
PILGRIM.txt,472886,474027,1141,10,N,N,-,-1,-1
PILGRIM.txt,472938,474034,1096,10,N,N,-,-1,-1
PILGRIM.txt,473084,474121,1037,10,N,N,-,-1,-1
PILGRIM.txt,473139,474234,1095,10,N,N,-,-1,-1
PILGRIM.txt,473281,474386,1105,10,N,N,-,-1,-1
PILGRIM.txt,473439,474498,1059,10,N,N,-,-1,-1
PILGRIM.txt,473512,474656,1144,10,N,N,-,-1,-1
PILGRIM.txt,473615,474747,1132,10,N,N,-,-1,-1
PILGRIM.txt,473795,474822,1027,10,N,N,-,-1,-1
PILGRIM.txt,473919,474929,1010,10,N,N,-,-1,-1
PILGRIM.txt,474028,475080,1052,10,N,N,-,-1,-1
PILGRIM.txt,474035,475236,1201,10,N,N,-,-1,-1
PILGRIM.txt,474122,475376,1254,10,N,N,-,-1,-1
PILGRIM.txt,474237,475729,1492,10,N,N,-,-1,-1
PILGRIM.txt,474388,475806,1418,10,N,N,-,-1,-1
PILGRIM.txt,474499,475958,1459,10,N,N,-,-1,-1
PILGRIM.txt,474657,475977,1320,10,N,N,-,-1,-1
PILGRIM.txt,474748,476104,1356,10,N,N,-,-1,-1
PILGRIM.txt,474825,476717,1892,10,N,N,-,-1,-1
PILGRIM.txt,474930,476941,2011,10,N,N,-,-1,-1
PILGRIM.txt,475081,477174,2093,10,N,N,-,-1,-1
PILGRIM.txt,475237,477296,2059,10,N,N,-,-1,-1
PILGRIM.txt,475377,477399,2022,10,N,N,-,-1,-1
PILGRIM.txt,475730,477595,1865,10,N,N,-,-1,-1
PILGRIM.txt,475809,477794,1985,10,N,N,-,-1,-1
PILGRIM.txt,475959,478216,2257,10,N,N,-,-1,-1
PILGRIM.txt,475978,478369,2391,10,N,N,-,-1,-1
PILGRIM.txt,476105,478564,2459,10,N,N,-,-1,-1
PILGRIM.txt,476718,478672,1954,10,N,N,-,-1,-1
PILGRIM.txt,476944,478834,1890,10,N,N,-,-1,-1
PILGRIM.txt,477175,478979,1804,10,N,N,-,-1,-1
PILGRIM.txt,477299,479202,1903,10,N,N,-,-1,-1
PILGRIM.txt,477400,479385,1985,10,N,N,-,-1,-1
PILGRIM.txt,477596,479585,1989,10,N,N,-,-1,-1
PILGRIM.txt,477795,479796,2001,10,N,N,-,-1,-1
PILGRIM.txt,478217,480030,1813,10,N,N,-,-1,-1
PILGRIM.txt,478372,480237,1865,10,N,N,-,-1,-1
PILGRIM.txt,478565,480418,1853,10,N,N,-,-1,-1
PILGRIM.txt,478673,480726,2053,10,N,N,-,-1,-1
PILGRIM.txt,478837,481015,2178,10,N,N,-,-1,-1
PILGRIM.txt,478980,481100,2120,10,N,N,-,-1,-1
PILGRIM.txt,479203,481352,2149,10,N,N,-,-1,-1
PILGRIM.txt,479386,481464,2078,10,N,N,-,-1,-1
PILGRIM.txt,479586,481663,2077,10,N,N,-,-1,-1
PILGRIM.txt,479797,481721,1924,10,N,N,-,-1,-1
PILGRIM.txt,480031,481935,1904,10,N,N,-,-1,-1
PILGRIM.txt,480240,482014,1774,10,N,N,-,-1,-1
PILGRIM.txt,480419,482299,1880,10,N,N,-,-1,-1
PILGRIM.txt,480727,482581,1854,10,N,N,-,-1,-1
PILGRIM.txt,481018,482815,1797,10,N,N,-,-1,-1
PILGRIM.txt,481101,483086,1985,10,N,N,-,-1,-1
PILGRIM.txt,481353,483338,1985,10,N,N,-,-1,-1
PILGRIM.txt,481466,483539,2073,10,N,N,-,-1,-1
PILGRIM.txt,481665,483558,1893,10,N,N,-,-1,-1
PILGRIM.txt,481722,483706,1984,10,N,N,-,-1,-1
PILGRIM.txt,481938,483872,1934,10,N,N,-,-1,-1
PILGRIM.txt,482015,484009,1994,10,N,N,-,-1,-1
PILGRIM.txt,482300,484063,1763,10,N,N,-,-1,-1
PILGRIM.txt,482586,484187,1601,10,N,N,-,-1,-1
PILGRIM.txt,482818,484389,1571,10,N,N,-,-1,-1
PILGRIM.txt,483087,484525,1438,10,N,N,-,-1,-1
PILGRIM.txt,483339,484831,1492,10,N,N,-,-1,-1
PILGRIM.txt,483544,484921,1377,10,N,N,-,-1,-1
PILGRIM.txt,483561,484980,1419,10,N,N,-,-1,-1
PILGRIM.txt,483707,485120,1413,10,N,N,-,-1,-1
PILGRIM.txt,483875,485500,1625,10,N,N,-,-1,-1
PILGRIM.txt,484010,485636,1626,10,N,N,-,-1,-1
PILGRIM.txt,484064,485749,1685,10,N,N,-,-1,-1
PILGRIM.txt,484190,485864,1674,10,N,N,-,-1,-1
PILGRIM.txt,484390,486163,1773,10,N,N,-,-1,-1
PILGRIM.txt,484526,486279,1753,10,N,N,-,-1,-1
PILGRIM.txt,484834,486369,1535,10,N,N,-,-1,-1
PILGRIM.txt,484922,486707,1785,10,N,N,-,-1,-1
PILGRIM.txt,484980,486737,1757,10,N,N,-,-1,-1
PILGRIM.txt,485125,486966,1841,10,N,N,-,-1,-1
PILGRIM.txt,485501,487156,1655,10,N,N,-,-1,-1
PILGRIM.txt,485639,487441,1802,10,N,N,-,-1,-1
PILGRIM.txt,485750,487691,1941,10,N,N,-,-1,-1
PILGRIM.txt,485865,487823,1958,10,N,N,-,-1,-1
PILGRIM.txt,486166,487923,1757,10,N,N,-,-1,-1
PILGRIM.txt,486281,488053,1772,10,N,N,-,-1,-1
PILGRIM.txt,486370,488160,1790,10,N,N,-,-1,-1
PILGRIM.txt,486710,488365,1655,10,N,N,-,-1,-1
PILGRIM.txt,486738,488604,1866,10,N,N,-,-1,-1
PILGRIM.txt,486967,488879,1912,10,N,N,-,-1,-1
PILGRIM.txt,487157,489078,1921,10,N,N,-,-1,-1
PILGRIM.txt,487442,489168,1726,10,N,N,-,-1,-1
PILGRIM.txt,487692,489396,1704,10,N,N,-,-1,-1
PILGRIM.txt,487824,489483,1659,10,N,N,-,-1,-1
PILGRIM.txt,487924,489538,1614,10,N,N,-,-1,-1
PILGRIM.txt,488055,489657,1602,10,N,N,-,-1,-1
PILGRIM.txt,488162,489843,1681,10,N,N,-,-1,-1
PILGRIM.txt,488366,490001,1635,10,N,N,-,-1,-1
PILGRIM.txt,488607,490045,1438,10,N,N,-,-1,-1
PILGRIM.txt,488880,490148,1268,10,N,N,-,-1,-1
PILGRIM.txt,489079,490201,1122,10,N,N,-,-1,-1
PILGRIM.txt,489169,490365,1196,10,N,N,-,-1,-1
PILGRIM.txt,489397,490438,1041,10,N,N,-,-1,-1
PILGRIM.txt,489484,490669,1185,10,N,N,-,-1,-1
PILGRIM.txt,489539,490903,1364,10,N,N,-,-1,-1
PILGRIM.txt,489658,491114,1456,10,N,N,-,-1,-1
PILGRIM.txt,489846,491294,1448,10,N,N,-,-1,-1
PILGRIM.txt,490003,491379,1376,10,N,N,-,-1,-1
PILGRIM.txt,490046,491481,1435,10,N,N,-,-1,-1
PILGRIM.txt,490149,491545,1396,10,N,N,-,-1,-1
PILGRIM.txt,490202,491796,1594,10,N,N,-,-1,-1
PILGRIM.txt,490366,491842,1476,10,N,N,-,-1,-1
PILGRIM.txt,490439,491935,1496,10,N,N,-,-1,-1
PILGRIM.txt,490674,492198,1524,10,N,N,-,-1,-1
PILGRIM.txt,490905,492307,1402,10,N,N,-,-1,-1
PILGRIM.txt,491116,492383,1267,10,N,N,-,-1,-1
PILGRIM.txt,491295,492539,1244,10,N,N,-,-1,-1
PILGRIM.txt,491380,492830,1450,10,N,N,-,-1,-1
PILGRIM.txt,491484,492948,1464,10,N,N,-,-1,-1
PILGRIM.txt,491546,493125,1579,10,N,N,-,-1,-1
PILGRIM.txt,491799,493284,1485,10,N,N,-,-1,-1
PILGRIM.txt,491843,493331,1488,10,N,N,-,-1,-1
PILGRIM.txt,491936,493471,1535,10,N,N,-,-1,-1
PILGRIM.txt,492199,493600,1401,10,N,N,-,-1,-1
PILGRIM.txt,492308,493831,1523,10,N,N,-,-1,-1
PILGRIM.txt,492386,493951,1565,10,N,N,-,-1,-1
PILGRIM.txt,492544,494088,1544,10,N,N,-,-1,-1
PILGRIM.txt,492833,494274,1441,10,N,N,-,-1,-1
PILGRIM.txt,492949,494369,1420,10,N,N,-,-1,-1
PILGRIM.txt,493126,494561,1435,10,N,N,-,-1,-1
PILGRIM.txt,493285,494729,1444,10,N,N,-,-1,-1
PILGRIM.txt,493332,494951,1619,10,N,N,-,-1,-1
PILGRIM.txt,493473,495163,1690,10,N,N,-,-1,-1
PILGRIM.txt,493601,495468,1867,10,N,N,-,-1,-1
PILGRIM.txt,493832,495624,1792,10,N,N,-,-1,-1
PILGRIM.txt,493953,495989,2036,10,N,N,-,-1,-1
PILGRIM.txt,494089,496128,2039,10,N,Y,1448038803075,18895,19670
PILGRIM.txt,494276,496293,2017,10,N,Y,1448038803075,18895,19670
PILGRIM.txt,494370,496335,1965,10,N,Y,1448038803075,18895,19670
PILGRIM.txt,494562,496613,2051,10,N,Y,1448038803075,18895,19670
PILGRIM.txt,494730,496830,2100,10,N,Y,1448038803075,18895,19670
PILGRIM.txt,494953,497063,2110,10,N,Y,1448038803075,18895,19670
PILGRIM.txt,495165,497182,2017,10,Y,Y,1448038803075,18895,19670
PILGRIM.txt,495469,497293,1824,10,Y,Y,1448038803075,18895,19670
PILGRIM.txt,495625,497600,1975,10,Y,Y,1448038803075,18895,19670
PILGRIM.txt,495990,497794,1804,10,Y,Y,1448038803075,18895,19670
PILGRIM.txt,496129,497877,1748,10,Y,Y,1448038803075,18895,19670
PILGRIM.txt,496294,498112,1818,10,Y,Y,1448038803075,18895,19670
PILGRIM.txt,496336,498163,1827,10,Y,Y,1448038803075,18895,19670
PILGRIM.txt,496614,498471,1857,10,N,Y,1448038803075,18895,19670
PILGRIM.txt,496831,498616,1785,10,N,Y,1448038803075,18895,19670
PILGRIM.txt,497064,498821,1757,10,N,Y,1448038803075,18895,19670
PILGRIM.txt,497185,498899,1714,10,N,Y,1448038101349,15101,17486
PILGRIM.txt,497295,499026,1731,10,N,Y,1448038101349,15101,17486
PILGRIM.txt,497601,499296,1695,10,N,Y,1448038101349,15101,17486
PILGRIM.txt,497795,499578,1783,10,N,Y,1448038101349,15101,17486
PILGRIM.txt,497880,499684,1804,10,N,Y,1448038101349,15101,17486
PILGRIM.txt,498113,499981,1868,10,N,Y,1448038101349,15101,17486
PILGRIM.txt,498164,500097,1933,10,N,Y,1448038101349,15101,17486
PILGRIM.txt,498473,500250,1777,10,N,Y,1448038101349,15101,17486
PILGRIM.txt,498617,500553,1936,10,N,Y,1448038101349,15101,17486
PILGRIM.txt,498824,500684,1860,10,N,Y,1448038101349,15101,17486
PILGRIM.txt,498900,500728,1828,10,N,Y,1448038101349,15101,17486
PILGRIM.txt,499027,500875,1848,10,N,Y,1448038101349,15101,17486
PILGRIM.txt,499299,500991,1692,10,N,N,-,-1,-1
PILGRIM.txt,499581,501155,1574,10,N,N,-,-1,-1
PILGRIM.txt,499686,501248,1562,10,N,N,-,-1,-1
PILGRIM.txt,499983,501550,1567,10,N,N,-,-1,-1
PILGRIM.txt,500098,501624,1526,10,N,N,-,-1,-1
PILGRIM.txt,500251,501855,1604,10,N,N,-,-1,-1
PILGRIM.txt,500554,502047,1493,10,N,N,-,-1,-1
PILGRIM.txt,500686,502372,1686,10,N,N,-,-1,-1
PILGRIM.txt,500731,502535,1804,10,N,N,-,-1,-1
PILGRIM.txt,500877,502748,1871,10,N,N,-,-1,-1
PILGRIM.txt,500994,502931,1937,10,N,N,-,-1,-1
PILGRIM.txt,501156,503042,1886,10,N,N,-,-1,-1
PILGRIM.txt,501250,503226,1976,10,N,N,-,-1,-1
PILGRIM.txt,501551,503364,1813,10,N,N,-,-1,-1
PILGRIM.txt,501626,503387,1761,10,N,N,-,-1,-1
PILGRIM.txt,501856,503477,1621,10,N,N,-,-1,-1
PILGRIM.txt,502048,503506,1458,10,N,N,-,-1,-1
PILGRIM.txt,502375,503616,1241,10,N,N,-,-1,-1
PILGRIM.txt,502536,504063,1527,10,N,N,-,-1,-1
PILGRIM.txt,502749,504268,1519,10,N,N,-,-1,-1
PILGRIM.txt,502932,504351,1419,10,N,N,-,-1,-1
PILGRIM.txt,503043,504434,1391,10,N,N,-,-1,-1
PILGRIM.txt,503227,504746,1519,10,N,N,-,-1,-1
PILGRIM.txt,503365,505000,1635,10,N,N,-,-1,-1
PILGRIM.txt,503388,505134,1746,10,N,N,-,-1,-1
PILGRIM.txt,503478,505338,1860,10,N,N,-,-1,-1
PILGRIM.txt,503511,505651,2140,10,N,N,-,-1,-1
PILGRIM.txt,503617,505706,2089,10,N,N,-,-1,-1
PILGRIM.txt,504066,505719,1653,10,N,N,-,-1,-1
PILGRIM.txt,504269,505742,1473,10,N,N,-,-1,-1
PILGRIM.txt,504352,505781,1429,10,N,N,-,-1,-1
PILGRIM.txt,504437,505834,1397,10,N,N,-,-1,-1
PILGRIM.txt,504749,505844,1095,10,N,N,-,-1,-1
PILGRIM.txt,505001,505998,997,10,N,N,-,-1,-1
PILGRIM.txt,505137,506051,914,10,N,N,-,-1,-1
PILGRIM.txt,505343,506347,1004,10,N,N,-,-1,-1
PILGRIM.txt,505652,506813,1161,10,N,N,-,-1,-1
PILGRIM.txt,505707,507047,1340,10,N,N,-,-1,-1
PILGRIM.txt,505720,507191,1471,10,N,N,-,-1,-1
PILGRIM.txt,505745,507346,1601,10,N,N,-,-1,-1
PILGRIM.txt,505784,507428,1644,10,N,N,-,-1,-1
PILGRIM.txt,505835,507490,1655,10,N,N,-,-1,-1
PILGRIM.txt,505847,507619,1772,10,N,N,-,-1,-1
PILGRIM.txt,506001,507733,1732,10,N,N,-,-1,-1
PILGRIM.txt,506051,507874,1823,10,N,N,-,-1,-1
PILGRIM.txt,506348,507942,1594,10,N,N,-,-1,-1
PILGRIM.txt,506816,508155,1339,10,N,N,-,-1,-1
PILGRIM.txt,507048,508270,1222,10,N,N,-,-1,-1
PILGRIM.txt,507192,508350,1158,10,N,N,-,-1,-1
PILGRIM.txt,507348,508485,1137,10,N,N,-,-1,-1
PILGRIM.txt,507429,508578,1149,10,N,N,-,-1,-1
PILGRIM.txt,507491,508677,1186,10,N,N,-,-1,-1
PILGRIM.txt,507620,508760,1140,10,N,N,-,-1,-1
PILGRIM.txt,507736,508885,1149,10,N,N,-,-1,-1
PILGRIM.txt,507875,509030,1155,10,N,N,-,-1,-1
PILGRIM.txt,507947,509108,1161,10,N,N,-,-1,-1
PILGRIM.txt,508158,509181,1023,10,N,N,-,-1,-1
PILGRIM.txt,508271,509388,1117,10,N,N,-,-1,-1
PILGRIM.txt,508352,509511,1159,10,N,N,-,-1,-1
PILGRIM.txt,508486,509718,1232,10,N,N,-,-1,-1
PILGRIM.txt,508579,509877,1298,10,N,N,-,-1,-1
PILGRIM.txt,508678,509940,1262,10,N,N,-,-1,-1
PILGRIM.txt,508762,510040,1278,10,N,N,-,-1,-1
PILGRIM.txt,508886,510071,1185,10,N,N,-,-1,-1
PILGRIM.txt,509031,510089,1058,10,N,N,-,-1,-1
PILGRIM.txt,509111,510143,1032,10,N,N,-,-1,-1
PILGRIM.txt,509182,510253,1071,10,N,N,-,-1,-1
PILGRIM.txt,509389,510557,1168,10,N,N,-,-1,-1
PILGRIM.txt,509512,510768,1256,10,N,N,-,-1,-1
PILGRIM.txt,509719,510947,1228,10,N,N,-,-1,-1
PILGRIM.txt,509878,511111,1233,10,N,N,-,-1,-1
PILGRIM.txt,509941,511188,1247,10,N,N,-,-1,-1
PILGRIM.txt,510046,511241,1195,10,N,N,-,-1,-1
PILGRIM.txt,510072,511514,1442,10,N,N,-,-1,-1
PILGRIM.txt,510092,511637,1545,10,N,N,-,-1,-1
PILGRIM.txt,510145,511655,1510,10,N,N,-,-1,-1
PILGRIM.txt,510254,511878,1624,10,N,N,-,-1,-1
PILGRIM.txt,510558,512011,1453,10,N,N,-,-1,-1
PILGRIM.txt,510769,512181,1412,10,N,N,-,-1,-1
PILGRIM.txt,510948,512391,1443,10,N,N,-,-1,-1
PILGRIM.txt,511112,512456,1344,10,N,N,-,-1,-1
PILGRIM.txt,511189,512642,1453,10,N,N,-,-1,-1
PILGRIM.txt,511242,512803,1561,10,N,N,-,-1,-1
PILGRIM.txt,511515,512899,1384,10,N,N,-,-1,-1
PILGRIM.txt,511642,512937,1295,10,N,N,-,-1,-1
PILGRIM.txt,511658,513219,1561,10,N,N,-,-1,-1
PILGRIM.txt,511881,513289,1408,10,N,N,-,-1,-1
PILGRIM.txt,512012,513381,1369,10,N,N,-,-1,-1
PILGRIM.txt,512182,513585,1403,10,Y,N,-,-1,-1
PILGRIM.txt,512392,513697,1305,10,N,N,-,-1,-1
PILGRIM.txt,512459,513839,1380,10,N,N,-,-1,-1
PILGRIM.txt,512643,514047,1404,10,N,N,-,-1,-1
PILGRIM.txt,512804,514143,1339,10,N,N,-,-1,-1
PILGRIM.txt,512902,514335,1433,10,N,N,-,-1,-1
PILGRIM.txt,512938,514476,1538,10,N,N,-,-1,-1
PILGRIM.txt,513224,514667,1443,10,N,N,-,-1,-1
PILGRIM.txt,513290,514737,1447,10,N,N,-,-1,-1
PILGRIM.txt,513382,514984,1602,10,N,N,-,-1,-1
PILGRIM.txt,513588,515157,1569,10,Y,N,-,-1,-1
PILGRIM.txt,513698,515238,1540,10,Y,N,-,-1,-1
PILGRIM.txt,513841,515335,1494,10,N,N,-,-1,-1
PILGRIM.txt,514050,515477,1427,10,N,N,-,-1,-1
PILGRIM.txt,514144,515643,1499,10,N,N,-,-1,-1
PILGRIM.txt,514338,515734,1396,10,N,N,-,-1,-1
PILGRIM.txt,514477,515764,1287,10,N,N,-,-1,-1
PILGRIM.txt,514668,516008,1340,10,N,N,-,-1,-1
PILGRIM.txt,514740,516112,1372,10,N,N,-,-1,-1
PILGRIM.txt,514985,516189,1204,10,N,N,-,-1,-1
PILGRIM.txt,515158,516308,1150,10,N,N,-,-1,-1
PILGRIM.txt,515239,516362,1123,10,N,N,-,-1,-1
PILGRIM.txt,515337,516472,1135,10,N,N,-,-1,-1
PILGRIM.txt,515478,516675,1197,10,N,N,-,-1,-1
PILGRIM.txt,515644,516924,1280,10,N,N,-,-1,-1
PILGRIM.txt,515737,517023,1286,10,N,N,-,-1,-1
PILGRIM.txt,515765,517119,1354,10,N,N,-,-1,-1
PILGRIM.txt,516009,517131,1122,10,N,N,-,-1,-1
PILGRIM.txt,516115,517217,1102,10,N,N,-,-1,-1
PILGRIM.txt,516190,517341,1151,10,N,N,-,-1,-1
PILGRIM.txt,516309,517429,1120,10,N,N,-,-1,-1
PILGRIM.txt,516363,517539,1176,10,N,N,-,-1,-1
PILGRIM.txt,516473,517664,1191,10,N,N,-,-1,-1
PILGRIM.txt,516676,517755,1079,10,N,N,-,-1,-1
PILGRIM.txt,516925,517806,881,10,N,N,-,-1,-1
PILGRIM.txt,517026,517974,948,10,N,N,-,-1,-1
PILGRIM.txt,517120,518180,1060,10,N,N,-,-1,-1
PILGRIM.txt,517133,518421,1288,10,N,N,-,-1,-1
PILGRIM.txt,517218,518631,1413,10,N,N,-,-1,-1
PILGRIM.txt,517343,518741,1398,10,N,N,-,-1,-1
PILGRIM.txt,517430,518849,1419,10,N,N,-,-1,-1
PILGRIM.txt,517540,518901,1361,10,N,N,-,-1,-1
PILGRIM.txt,517666,518984,1318,10,N,N,-,-1,-1
PILGRIM.txt,517756,519128,1372,10,N,N,-,-1,-1
PILGRIM.txt,517809,519547,1738,10,N,N,-,-1,-1
PILGRIM.txt,517975,519639,1664,10,N,N,-,-1,-1
PILGRIM.txt,518182,519776,1594,10,N,N,-,-1,-1
PILGRIM.txt,518422,519986,1564,10,N,N,-,-1,-1
PILGRIM.txt,518632,520078,1446,10,N,N,-,-1,-1
PILGRIM.txt,518742,520379,1637,10,N,N,-,-1,-1
PILGRIM.txt,518850,520461,1611,10,Y,N,-,-1,-1
PILGRIM.txt,518902,520633,1731,10,Y,N,-,-1,-1
PILGRIM.txt,518986,520675,1689,10,N,N,-,-1,-1
PILGRIM.txt,519129,520726,1597,10,N,N,-,-1,-1
PILGRIM.txt,519548,520820,1272,10,N,N,-,-1,-1
PILGRIM.txt,519640,520965,1325,10,N,N,-,-1,-1
PILGRIM.txt,519777,521025,1248,10,N,N,-,-1,-1
PILGRIM.txt,519988,521077,1089,10,N,N,-,-1,-1
PILGRIM.txt,520079,521346,1267,10,N,N,-,-1,-1
PILGRIM.txt,520380,521516,1136,10,N,N,-,-1,-1
PILGRIM.txt,520462,521525,1063,10,N,N,-,-1,-1
PILGRIM.txt,520635,521595,960,10,N,N,-,-1,-1
PILGRIM.txt,520680,521665,985,10,N,N,-,-1,-1
PILGRIM.txt,520727,521769,1042,10,N,N,-,-1,-1
PILGRIM.txt,520821,521882,1061,10,N,N,-,-1,-1
PILGRIM.txt,520966,522078,1112,10,N,N,-,-1,-1
PILGRIM.txt,521028,522136,1108,10,N,N,-,-1,-1
PILGRIM.txt,521080,522278,1198,10,N,N,-,-1,-1
PILGRIM.txt,521348,522341,993,10,N,N,-,-1,-1
PILGRIM.txt,521517,522494,977,10,N,N,-,-1,-1
PILGRIM.txt,521526,522714,1188,10,N,N,-,-1,-1
PILGRIM.txt,521596,522764,1168,10,N,N,-,-1,-1
PILGRIM.txt,521667,522785,1118,10,N,N,-,-1,-1
PILGRIM.txt,521772,522876,1104,10,N,N,-,-1,-1
PILGRIM.txt,521883,522966,1083,10,N,N,-,-1,-1
PILGRIM.txt,522079,522977,898,10,N,N,-,-1,-1
PILGRIM.txt,522137,522994,857,10,N,N,-,-1,-1
PILGRIM.txt,522279,523139,860,10,N,N,-,-1,-1
PILGRIM.txt,522342,523330,988,10,N,N,-,-1,-1
PILGRIM.txt,522495,523434,939,10,N,N,-,-1,-1
PILGRIM.txt,522717,523700,983,10,N,N,-,-1,-1
PILGRIM.txt,522767,523815,1048,10,N,N,-,-1,-1
PILGRIM.txt,522786,523923,1137,10,N,N,-,-1,-1
PILGRIM.txt,522877,524008,1131,10,N,N,-,-1,-1
PILGRIM.txt,522969,524168,1199,10,N,N,-,-1,-1
PILGRIM.txt,522982,524360,1378,10,N,N,-,-1,-1
PILGRIM.txt,522997,524520,1523,10,N,N,-,-1,-1
PILGRIM.txt,523142,524592,1450,10,N,N,-,-1,-1
PILGRIM.txt,523331,524709,1378,10,N,N,-,-1,-1
PILGRIM.txt,523437,525067,1630,10,N,N,-,-1,-1
PILGRIM.txt,523701,525198,1497,10,N,N,-,-1,-1
PILGRIM.txt,523818,525290,1472,10,N,N,-,-1,-1
PILGRIM.txt,523925,525364,1439,10,N,N,-,-1,-1
PILGRIM.txt,524009,525473,1464,10,N,N,-,-1,-1
PILGRIM.txt,524169,525621,1452,10,N,N,-,-1,-1
PILGRIM.txt,524361,525845,1484,10,N,N,-,-1,-1
PILGRIM.txt,524525,525889,1364,10,N,N,-,-1,-1
PILGRIM.txt,524593,526000,1407,10,N,N,-,-1,-1
PILGRIM.txt,524711,526219,1508,10,N,Y,1437028092146,121457,123204
PILGRIM.txt,525070,526557,1487,10,N,Y,1437028092146,121457,123204
PILGRIM.txt,525199,526623,1424,10,N,Y,1437028092146,121457,123204
PILGRIM.txt,525291,526825,1534,10,N,Y,1437028092146,121457,123204
PILGRIM.txt,525365,526876,1511,10,N,Y,1437028092146,121457,123204
PILGRIM.txt,525474,527086,1612,10,N,Y,1437028092146,121457,123204
PILGRIM.txt,525622,527839,2217,10,N,Y,1437028092146,121457,123204
PILGRIM.txt,525846,527974,2128,10,N,Y,1437028092146,121457,123204
PILGRIM.txt,525892,528181,2289,10,N,Y,1437028092146,121457,123204
PILGRIM.txt,526001,528553,2552,10,N,Y,1437028092146,121457,123204
PILGRIM.txt,526220,528742,2522,10,N,Y,1437028092146,121457,123204
PILGRIM.txt,526558,528813,2255,10,N,Y,1437028092146,121457,123204
PILGRIM.txt,526625,529008,2383,10,N,Y,1437028092146,121457,123204
PILGRIM.txt,526827,529100,2273,10,N,Y,1437028092146,121457,123204
PILGRIM.txt,526879,529256,2377,10,N,Y,1437028092146,121457,123204
PILGRIM.txt,527088,529495,2407,10,N,Y,1437028092146,121457,123204
PILGRIM.txt,527840,529559,1719,10,N,Y,1437028092146,121457,123204
PILGRIM.txt,527975,529670,1695,10,N,Y,1437028092146,121457,123204
PILGRIM.txt,528182,529903,1721,10,N,Y,1437028092146,121457,123204
PILGRIM.txt,528558,530154,1596,10,N,N,-,-1,-1
PILGRIM.txt,528745,530291,1546,10,N,N,-,-1,-1
PILGRIM.txt,528814,530397,1583,10,N,N,-,-1,-1
PILGRIM.txt,529011,530532,1521,10,N,N,-,-1,-1
PILGRIM.txt,529101,530822,1721,10,N,N,-,-1,-1
PILGRIM.txt,529257,530938,1681,10,N,N,-,-1,-1
PILGRIM.txt,529496,531114,1618,10,N,N,-,-1,-1
PILGRIM.txt,529560,531294,1734,10,Y,N,-,-1,-1
PILGRIM.txt,529673,531425,1752,10,Y,N,-,-1,-1
PILGRIM.txt,529904,531629,1725,10,Y,N,-,-1,-1
PILGRIM.txt,530155,531660,1505,10,Y,N,-,-1,-1
PILGRIM.txt,530292,531762,1470,10,Y,N,-,-1,-1
PILGRIM.txt,530398,531893,1495,10,N,N,-,-1,-1
PILGRIM.txt,530533,531941,1408,10,N,N,-,-1,-1
PILGRIM.txt,530825,531946,1121,10,N,N,-,-1,-1
PILGRIM.txt,530941,531976,1035,10,N,N,-,-1,-1
PILGRIM.txt,531115,532200,1085,10,N,N,-,-1,-1
PILGRIM.txt,531296,532325,1029,10,N,Y,1448274893770,25386,26202
PILGRIM.txt,531426,532515,1089,10,N,Y,1448274893770,25386,26202
PILGRIM.txt,531630,532590,960,10,N,Y,1448274893770,25386,26202
PILGRIM.txt,531661,532622,961,10,N,Y,1448274893770,25386,26202
PILGRIM.txt,531763,532711,948,10,N,Y,1448274893770,25386,26202
PILGRIM.txt,531894,532849,955,10,N,Y,1448274893770,25386,26202
PILGRIM.txt,531942,532931,989,10,N,Y,1448274893770,25386,26202
PILGRIM.txt,531947,533021,1074,10,N,Y,1448274893770,25386,26202
PILGRIM.txt,531977,533113,1136,10,N,Y,1448274893770,25386,26202
PILGRIM.txt,532205,533577,1372,10,N,Y,1448274893770,25386,26202
PILGRIM.txt,532326,533862,1536,10,N,Y,1448274893770,25386,26202
PILGRIM.txt,532516,533950,1434,10,N,Y,1448274893770,25386,26202
PILGRIM.txt,532591,534151,1560,10,N,Y,1448274893770,25386,26202
PILGRIM.txt,532623,534188,1565,10,N,Y,1448274893770,25386,26202
PILGRIM.txt,532712,534233,1521,10,N,Y,1448274893770,25386,26202
PILGRIM.txt,532852,534682,1830,10,N,Y,1448274893770,25386,26202
PILGRIM.txt,532932,534861,1929,10,N,Y,1448274893770,25386,26202
PILGRIM.txt,533024,535061,2037,10,N,Y,1448274893770,25386,26202
PILGRIM.txt,533116,535158,2042,10,N,N,-,-1,-1
PILGRIM.txt,533578,535249,1671,10,N,N,-,-1,-1
PILGRIM.txt,533863,535250,1387,10,N,N,-,-1,-1
PILGRIM.txt,533951,535343,1392,10,N,N,-,-1,-1
PILGRIM.txt,534154,535687,1533,10,N,N,-,-1,-1
PILGRIM.txt,534189,535736,1547,10,N,N,-,-1,-1
PILGRIM.txt,534236,535795,1559,10,N,N,-,-1,-1
PILGRIM.txt,534682,536031,1349,10,N,N,-,-1,-1
PILGRIM.txt,534862,536049,1187,10,N,N,-,-1,-1
PILGRIM.txt,535064,536300,1236,10,N,N,-,-1,-1
PILGRIM.txt,535159,536559,1400,10,N,N,-,-1,-1
PILGRIM.txt,535249,536653,1404,10,N,N,-,-1,-1
PILGRIM.txt,535253,536767,1514,10,N,N,-,-1,-1
PILGRIM.txt,535344,536897,1553,10,N,N,-,-1,-1
PILGRIM.txt,535692,537087,1395,10,N,N,-,-1,-1
PILGRIM.txt,535737,537194,1457,10,N,N,-,-1,-1
PILGRIM.txt,535796,537418,1622,10,N,N,-,-1,-1
PILGRIM.txt,536036,537518,1482,10,N,N,-,-1,-1
PILGRIM.txt,536054,537783,1729,10,N,N,-,-1,-1
PILGRIM.txt,536305,537911,1606,10,N,N,-,-1,-1
PILGRIM.txt,536560,538137,1577,10,N,N,-,-1,-1
PILGRIM.txt,536654,538168,1514,10,N,N,-,-1,-1
PILGRIM.txt,536768,538261,1493,10,N,N,-,-1,-1
PILGRIM.txt,536898,538322,1424,10,N,N,-,-1,-1
PILGRIM.txt,537088,538379,1291,10,N,N,-,-1,-1
PILGRIM.txt,537195,538502,1307,10,N,N,-,-1,-1
PILGRIM.txt,537419,538550,1131,10,N,N,-,-1,-1
PILGRIM.txt,537523,538583,1060,10,N,N,-,-1,-1
PILGRIM.txt,537784,538657,873,10,N,N,-,-1,-1
PILGRIM.txt,537912,538712,800,10,N,N,-,-1,-1
PILGRIM.txt,538138,538792,654,10,N,N,-,-1,-1
PILGRIM.txt,538169,538865,696,10,N,N,-,-1,-1
PILGRIM.txt,538262,538895,633,10,N,N,-,-1,-1
PILGRIM.txt,538323,539007,684,10,N,N,-,-1,-1
PILGRIM.txt,538380,539057,677,10,N,N,-,-1,-1
PILGRIM.txt,538503,539126,623,10,N,N,-,-1,-1
PILGRIM.txt,538551,539235,684,10,N,N,-,-1,-1
PILGRIM.txt,538584,539311,727,10,N,N,-,-1,-1
PILGRIM.txt,538658,539349,691,10,N,N,-,-1,-1
PILGRIM.txt,538713,539413,700,10,N,N,-,-1,-1
PILGRIM.txt,538795,539561,766,10,N,N,-,-1,-1
PILGRIM.txt,538866,539631,765,10,N,N,-,-1,-1
PILGRIM.txt,538897,539710,813,10,N,N,-,-1,-1
PILGRIM.txt,539009,539817,808,10,N,N,-,-1,-1
PILGRIM.txt,539059,539946,887,10,N,N,-,-1,-1
PILGRIM.txt,539127,540153,1026,10,N,N,-,-1,-1
PILGRIM.txt,539236,540282,1046,10,N,N,-,-1,-1
PILGRIM.txt,539312,540471,1159,10,N,N,-,-1,-1
PILGRIM.txt,539350,540538,1188,10,N,N,-,-1,-1
PILGRIM.txt,539414,540779,1365,10,N,N,-,-1,-1
PILGRIM.txt,539562,540896,1334,10,N,N,-,-1,-1
PILGRIM.txt,539632,540987,1355,10,N,N,-,-1,-1
PILGRIM.txt,539711,541172,1461,10,N,N,-,-1,-1
PILGRIM.txt,539818,541293,1475,10,N,N,-,-1,-1
PILGRIM.txt,539947,541381,1434,10,N,N,-,-1,-1
PILGRIM.txt,540156,541551,1395,10,N,N,-,-1,-1
PILGRIM.txt,540283,541690,1407,10,N,N,-,-1,-1
PILGRIM.txt,540472,541768,1296,10,N,N,-,-1,-1
PILGRIM.txt,540539,541996,1457,10,N,N,-,-1,-1
PILGRIM.txt,540780,542110,1330,10,N,N,-,-1,-1
PILGRIM.txt,540899,542276,1377,10,N,N,-,-1,-1
PILGRIM.txt,540988,542319,1331,10,N,N,-,-1,-1
PILGRIM.txt,541173,542462,1289,10,N,N,-,-1,-1
PILGRIM.txt,541294,542590,1296,10,N,N,-,-1,-1
PILGRIM.txt,541382,542802,1420,10,N,N,-,-1,-1
PILGRIM.txt,541552,543002,1450,10,N,N,-,-1,-1
PILGRIM.txt,541691,543233,1542,10,N,N,-,-1,-1
PILGRIM.txt,541769,543340,1571,10,N,N,-,-1,-1
PILGRIM.txt,541997,543451,1454,10,N,N,-,-1,-1
PILGRIM.txt,542113,543593,1480,10,N,N,-,-1,-1
PILGRIM.txt,542278,543746,1468,10,N,N,-,-1,-1
PILGRIM.txt,542322,543973,1651,10,N,N,-,-1,-1
PILGRIM.txt,542463,544242,1779,10,N,N,-,-1,-1
PILGRIM.txt,542592,544322,1730,10,N,N,-,-1,-1
PILGRIM.txt,542804,544329,1525,10,N,N,-,-1,-1
PILGRIM.txt,543003,544410,1407,10,N,N,-,-1,-1
PILGRIM.txt,543234,544512,1278,10,N,N,-,-1,-1
PILGRIM.txt,543341,544624,1283,10,N,Y,1448039370049,20775,21297
PILGRIM.txt,543454,544862,1408,10,N,Y,1448039370049,20775,21297
PILGRIM.txt,543594,545233,1639,10,N,Y,1448039370049,20775,21297
PILGRIM.txt,543749,545315,1566,10,N,Y,1448039370049,20775,21297
PILGRIM.txt,543974,545464,1490,10,N,Y,1448039370049,20775,21297
PILGRIM.txt,544243,545624,1381,10,N,Y,1448039370049,20775,21297
PILGRIM.txt,544323,545785,1462,10,N,Y,1448039370049,20775,21297
PILGRIM.txt,544330,545910,1580,10,N,Y,1448039370049,20775,21297
PILGRIM.txt,544412,545981,1569,10,N,Y,1448039370049,20775,21297
PILGRIM.txt,544515,546146,1631,10,N,Y,1448039370049,20775,21297
PILGRIM.txt,544625,546332,1707,10,N,Y,1448039370049,20775,21297
PILGRIM.txt,544863,546411,1548,10,N,Y,1448039370049,20775,21297
PILGRIM.txt,545236,546501,1265,10,N,Y,1448039370049,20775,21297
PILGRIM.txt,545316,546618,1302,10,N,Y,1448039370049,20775,21297
PILGRIM.txt,545465,546774,1309,10,N,Y,1448039370049,20775,21297
PILGRIM.txt,545625,546793,1168,10,N,Y,1448039370049,20775,21297
PILGRIM.txt,545786,547125,1339,10,N,Y,1448039370049,20775,21297
PILGRIM.txt,545913,547294,1381,10,N,Y,1448039370049,20775,21297
PILGRIM.txt,545982,547496,1514,10,N,Y,1448039370049,20775,21297
PILGRIM.txt,546147,547751,1604,10,N,N,-,-1,-1
PILGRIM.txt,546334,547911,1577,10,N,Y,1448275407308,26987,29181
PILGRIM.txt,546414,548077,1663,10,Y,Y,1448275407308,26987,29181
PILGRIM.txt,546502,548439,1937,10,N,Y,1448275407308,26987,29181
PILGRIM.txt,546620,548618,1998,10,Y,Y,1448275407308,26987,29181
PILGRIM.txt,546779,548801,2022,10,Y,Y,1448275407308,26987,29181
PILGRIM.txt,546796,548922,2126,10,Y,Y,1448275407308,26987,29181
PILGRIM.txt,547128,549096,1968,10,Y,Y,1448275407308,26987,29181
PILGRIM.txt,547295,549205,1910,10,Y,Y,1448275407308,26987,29181
PILGRIM.txt,547497,549306,1809,10,Y,Y,1448275407308,26987,29181
PILGRIM.txt,547754,549396,1642,10,Y,Y,1448275407308,26987,29181
PILGRIM.txt,547913,549609,1696,10,N,Y,1448275407308,26987,29181
PILGRIM.txt,548078,549825,1747,10,N,Y,1448275407308,26987,29181
PILGRIM.txt,548440,549962,1522,10,N,N,-,-1,-1
PILGRIM.txt,548619,550044,1425,10,N,N,-,-1,-1
PILGRIM.txt,548802,550142,1340,10,N,N,-,-1,-1
PILGRIM.txt,548923,550223,1300,10,N,N,-,-1,-1
PILGRIM.txt,549097,550463,1366,10,N,N,-,-1,-1
PILGRIM.txt,549206,550537,1331,10,N,N,-,-1,-1
PILGRIM.txt,549309,550763,1454,10,N,N,-,-1,-1
PILGRIM.txt,549399,550821,1422,10,N,N,-,-1,-1
PILGRIM.txt,549610,550994,1384,10,N,N,-,-1,-1
PILGRIM.txt,549826,551154,1328,10,N,N,-,-1,-1
PILGRIM.txt,549963,551217,1254,10,N,N,-,-1,-1
PILGRIM.txt,550045,551302,1257,10,N,N,-,-1,-1
PILGRIM.txt,550143,551468,1325,10,N,N,-,-1,-1
PILGRIM.txt,550228,551533,1305,10,N,N,-,-1,-1
PILGRIM.txt,550465,551797,1332,10,N,N,-,-1,-1
PILGRIM.txt,550538,552022,1484,10,N,N,-,-1,-1
PILGRIM.txt,550764,552287,1523,10,N,N,-,-1,-1
PILGRIM.txt,550822,552466,1644,10,N,N,-,-1,-1
PILGRIM.txt,550995,552676,1681,10,N,N,-,-1,-1
PILGRIM.txt,551155,552762,1607,10,N,N,-,-1,-1
PILGRIM.txt,551218,552874,1656,10,Y,N,-,-1,-1
PILGRIM.txt,551305,552962,1657,10,Y,N,-,-1,-1
PILGRIM.txt,551469,553067,1598,10,Y,N,-,-1,-1
PILGRIM.txt,551536,553366,1830,10,Y,N,-,-1,-1
PILGRIM.txt,551798,553667,1869,10,Y,N,-,-1,-1
PILGRIM.txt,552023,553738,1715,10,Y,N,-,-1,-1
PILGRIM.txt,552290,553963,1673,10,Y,N,-,-1,-1
PILGRIM.txt,552467,554063,1596,10,Y,N,-,-1,-1
PILGRIM.txt,552677,554306,1629,10,Y,N,-,-1,-1
PILGRIM.txt,552762,554556,1794,10,Y,N,-,-1,-1
PILGRIM.txt,552875,554803,1928,10,N,N,-,-1,-1
PILGRIM.txt,552965,554945,1980,10,N,N,-,-1,-1
PILGRIM.txt,553069,555095,2026,10,N,N,-,-1,-1
PILGRIM.txt,553367,555159,1792,10,N,N,-,-1,-1
PILGRIM.txt,553670,555383,1713,10,N,N,-,-1,-1
PILGRIM.txt,553739,555782,2043,10,N,N,-,-1,-1
PILGRIM.txt,553966,555847,1881,10,N,N,-,-1,-1
PILGRIM.txt,554064,555954,1890,10,N,N,-,-1,-1
PILGRIM.txt,554308,555985,1677,10,N,N,-,-1,-1
PILGRIM.txt,554557,556187,1630,10,N,N,-,-1,-1
PILGRIM.txt,554804,556369,1565,10,N,N,-,-1,-1
PILGRIM.txt,554948,556579,1631,10,N,N,-,-1,-1
PILGRIM.txt,555097,556603,1506,10,N,Y,1448277582432,52552,54595
PILGRIM.txt,555160,556608,1448,10,N,Y,1448277582432,52552,54595
PILGRIM.txt,555384,556652,1268,10,N,Y,1448277582432,52552,54595
PILGRIM.txt,555783,556725,942,10,N,Y,1448277582432,52552,54595
PILGRIM.txt,555852,556988,1136,10,N,Y,1448277582432,52552,54595
PILGRIM.txt,555955,557364,1409,10,N,Y,1448277582432,52552,54595
PILGRIM.txt,555987,557384,1397,10,N,Y,1448277582432,52552,54595
PILGRIM.txt,556189,557689,1500,10,N,Y,1448277582432,52552,54595
PILGRIM.txt,556370,557903,1533,10,N,Y,1448277582432,52552,54595
PILGRIM.txt,556582,557996,1414,10,N,Y,1448277582432,52552,54595
PILGRIM.txt,556604,558042,1438,10,N,Y,1448277582432,52552,54595
PILGRIM.txt,556609,558061,1452,10,N,Y,1448277582432,52552,54595
PILGRIM.txt,556653,558257,1604,10,N,Y,1448277582432,52552,54595
PILGRIM.txt,556726,558312,1586,10,N,Y,1448277582432,52552,54595
PILGRIM.txt,556990,558597,1607,10,N,Y,1448277582432,52552,54595
PILGRIM.txt,557369,558615,1246,10,N,N,-,-1,-1
PILGRIM.txt,557389,558817,1428,10,N,N,-,-1,-1
PILGRIM.txt,557694,558848,1154,10,N,N,-,-1,-1
PILGRIM.txt,557906,559029,1123,10,N,N,-,-1,-1
PILGRIM.txt,557997,559062,1065,10,N,N,-,-1,-1
PILGRIM.txt,558043,559192,1149,10,N,N,-,-1,-1
PILGRIM.txt,558062,559282,1220,10,N,N,-,-1,-1
PILGRIM.txt,558258,559358,1100,10,N,N,-,-1,-1
PILGRIM.txt,558313,559446,1133,10,N,N,-,-1,-1
PILGRIM.txt,558597,559631,1034,10,N,N,-,-1,-1
PILGRIM.txt,558616,559964,1348,10,N,N,-,-1,-1
PILGRIM.txt,558818,560008,1190,10,N,N,-,-1,-1
PILGRIM.txt,558848,560126,1278,10,N,N,-,-1,-1
PILGRIM.txt,559031,560213,1182,10,N,N,-,-1,-1
PILGRIM.txt,559063,560330,1267,10,N,N,-,-1,-1
PILGRIM.txt,559194,560461,1267,10,N,N,-,-1,-1
PILGRIM.txt,559283,560581,1298,10,N,N,-,-1,-1
PILGRIM.txt,559360,560662,1302,10,N,N,-,-1,-1
PILGRIM.txt,559449,560848,1399,10,N,N,-,-1,-1
PILGRIM.txt,559632,560992,1360,10,N,N,-,-1,-1
PILGRIM.txt,559967,561147,1180,10,N,N,-,-1,-1
PILGRIM.txt,560009,561194,1185,10,N,N,-,-1,-1
PILGRIM.txt,560127,561341,1214,10,N,N,-,-1,-1
PILGRIM.txt,560214,561793,1579,10,N,N,-,-1,-1
PILGRIM.txt,560331,562000,1669,10,N,N,-,-1,-1
PILGRIM.txt,560462,562090,1628,10,N,N,-,-1,-1
PILGRIM.txt,560582,562135,1553,10,N,N,-,-1,-1
PILGRIM.txt,560663,562358,1695,10,N,N,-,-1,-1
PILGRIM.txt,560849,562538,1689,10,N,N,-,-1,-1
PILGRIM.txt,560993,562751,1758,10,N,N,-,-1,-1
PILGRIM.txt,561148,562917,1769,10,N,N,-,-1,-1
PILGRIM.txt,561195,563143,1948,10,N,N,-,-1,-1
PILGRIM.txt,561342,563251,1909,10,N,N,-,-1,-1
PILGRIM.txt,561794,563347,1553,10,N,N,-,-1,-1
PILGRIM.txt,562001,563447,1446,10,N,N,-,-1,-1
PILGRIM.txt,562093,563547,1454,10,N,N,-,-1,-1
PILGRIM.txt,562136,563633,1497,10,N,N,-,-1,-1
PILGRIM.txt,562361,563717,1356,10,N,N,-,-1,-1
PILGRIM.txt,562539,563806,1267,10,N,N,-,-1,-1
PILGRIM.txt,562754,563911,1157,10,N,N,-,-1,-1
PILGRIM.txt,562919,563991,1072,10,N,N,-,-1,-1
PILGRIM.txt,563146,564071,925,10,N,N,-,-1,-1
PILGRIM.txt,563254,564094,840,10,N,N,-,-1,-1
PILGRIM.txt,563349,564162,813,10,N,N,-,-1,-1
PILGRIM.txt,563449,564346,897,10,N,N,-,-1,-1
PILGRIM.txt,563549,564459,910,10,N,N,-,-1,-1
PILGRIM.txt,563635,564466,831,10,N,N,-,-1,-1
PILGRIM.txt,563719,564551,832,10,N,N,-,-1,-1
PILGRIM.txt,563808,564559,751,10,N,N,-,-1,-1
PILGRIM.txt,563913,564611,698,10,N,N,-,-1,-1
PILGRIM.txt,563993,564618,625,10,N,N,-,-1,-1
PILGRIM.txt,564073,564702,629,10,N,N,-,-1,-1
PILGRIM.txt,564095,564709,614,10,N,N,-,-1,-1
PILGRIM.txt,564167,564843,676,10,N,N,-,-1,-1
PILGRIM.txt,564347,564933,586,10,N,N,-,-1,-1
PILGRIM.txt,564461,564973,512,10,N,N,-,-1,-1
PILGRIM.txt,564467,565073,606,10,N,N,-,-1,-1
PILGRIM.txt,564554,565220,666,10,N,N,-,-1,-1
PILGRIM.txt,564560,565393,833,10,N,N,-,-1,-1
PILGRIM.txt,564613,565632,1019,10,N,N,-,-1,-1
PILGRIM.txt,564619,565795,1176,10,N,N,-,-1,-1
PILGRIM.txt,564704,565848,1144,10,N,N,-,-1,-1
PILGRIM.txt,564710,565954,1244,10,N,N,-,-1,-1
PILGRIM.txt,564846,566035,1189,10,N,N,-,-1,-1
PILGRIM.txt,564934,566124,1190,10,N,N,-,-1,-1
PILGRIM.txt,564974,566190,1216,10,N,N,-,-1,-1
PILGRIM.txt,565074,566227,1153,10,N,N,-,-1,-1
PILGRIM.txt,565221,566235,1014,10,N,N,-,-1,-1
PILGRIM.txt,565396,566338,942,10,N,N,-,-1,-1
PILGRIM.txt,565633,566431,798,10,N,N,-,-1,-1
PILGRIM.txt,565798,566442,644,10,N,N,-,-1,-1
PILGRIM.txt,565853,566534,681,10,N,N,-,-1,-1
PILGRIM.txt,565955,566659,704,10,N,N,-,-1,-1
PILGRIM.txt,566037,566809,772,10,N,N,-,-1,-1
PILGRIM.txt,566127,566903,776,10,N,N,-,-1,-1
PILGRIM.txt,566191,566973,782,10,N,N,-,-1,-1
PILGRIM.txt,566230,567047,817,10,N,N,-,-1,-1
PILGRIM.txt,566236,567091,855,10,N,N,-,-1,-1
PILGRIM.txt,566341,567178,837,10,N,N,-,-1,-1
PILGRIM.txt,566432,567222,790,10,N,N,-,-1,-1
PILGRIM.txt,566444,567333,889,10,N,N,-,-1,-1
PILGRIM.txt,566535,567471,936,10,N,N,-,-1,-1
PILGRIM.txt,566662,567608,946,10,N,N,-,-1,-1
PILGRIM.txt,566812,567780,968,10,N,N,-,-1,-1
PILGRIM.txt,566904,567940,1036,10,N,N,-,-1,-1
PILGRIM.txt,566974,567988,1014,10,N,N,-,-1,-1
PILGRIM.txt,567048,568076,1028,10,N,N,-,-1,-1
PILGRIM.txt,567092,568193,1101,10,N,N,-,-1,-1
PILGRIM.txt,567180,568443,1263,10,N,N,-,-1,-1
PILGRIM.txt,567223,568490,1267,10,N,N,-,-1,-1
PILGRIM.txt,567334,568511,1177,10,N,N,-,-1,-1
PILGRIM.txt,567472,568570,1098,10,N,N,-,-1,-1
PILGRIM.txt,567613,568658,1045,10,N,N,-,-1,-1
PILGRIM.txt,567781,568753,972,10,N,N,-,-1,-1
PILGRIM.txt,567941,568862,921,10,N,N,-,-1,-1
PILGRIM.txt,567989,568961,972,10,N,N,-,-1,-1
PILGRIM.txt,568077,569344,1267,10,N,N,-,-1,-1
PILGRIM.txt,568196,569547,1351,10,N,N,-,-1,-1
PILGRIM.txt,568444,569634,1190,10,N,N,-,-1,-1
PILGRIM.txt,568491,569678,1187,10,N,N,-,-1,-1
PILGRIM.txt,568512,569713,1201,10,N,N,-,-1,-1
PILGRIM.txt,568573,569886,1313,10,N,N,-,-1,-1
PILGRIM.txt,568659,570032,1373,10,N,N,-,-1,-1
PILGRIM.txt,568756,570036,1280,10,N,N,-,-1,-1
PILGRIM.txt,568864,570218,1354,10,N,N,-,-1,-1
PILGRIM.txt,568964,570245,1281,10,N,N,-,-1,-1
PILGRIM.txt,569345,570406,1061,10,N,N,-,-1,-1
PILGRIM.txt,569550,570999,1449,10,N,N,-,-1,-1
PILGRIM.txt,569635,571091,1456,10,N,N,-,-1,-1
PILGRIM.txt,569679,571214,1535,10,N,N,-,-1,-1
PILGRIM.txt,569716,571320,1604,10,N,N,-,-1,-1
PILGRIM.txt,569888,571347,1459,10,N,N,-,-1,-1
PILGRIM.txt,570033,571499,1466,10,N,N,-,-1,-1
PILGRIM.txt,570037,571561,1524,10,N,N,-,-1,-1
PILGRIM.txt,570219,571605,1386,10,N,N,-,-1,-1
PILGRIM.txt,570248,571694,1446,10,N,N,-,-1,-1
PILGRIM.txt,570408,571812,1404,10,N,N,-,-1,-1
PILGRIM.txt,571002,571997,995,10,N,N,-,-1,-1
PILGRIM.txt,571096,572103,1007,10,N,N,-,-1,-1
PILGRIM.txt,571217,572180,963,10,N,N,-,-1,-1
PILGRIM.txt,571321,572206,885,10,N,N,-,-1,-1
PILGRIM.txt,571348,572267,919,10,N,N,-,-1,-1
PILGRIM.txt,571500,572568,1068,10,N,N,-,-1,-1
PILGRIM.txt,571564,572586,1022,10,N,N,-,-1,-1
PILGRIM.txt,571606,572663,1057,10,N,N,-,-1,-1
PILGRIM.txt,571697,572803,1106,10,N,N,-,-1,-1
PILGRIM.txt,571813,572998,1185,10,N,N,-,-1,-1
PILGRIM.txt,572000,573143,1143,10,N,N,-,-1,-1
PILGRIM.txt,572106,573203,1097,10,N,N,-,-1,-1
PILGRIM.txt,572181,573315,1134,10,N,N,-,-1,-1
PILGRIM.txt,572209,573435,1226,10,N,N,-,-1,-1
PILGRIM.txt,572268,573563,1295,10,N,N,-,-1,-1
PILGRIM.txt,572569,573654,1085,10,N,N,-,-1,-1
PILGRIM.txt,572588,573988,1400,10,N,N,-,-1,-1
PILGRIM.txt,572665,574063,1398,10,N,N,-,-1,-1
PILGRIM.txt,572808,574247,1439,10,N,N,-,-1,-1
PILGRIM.txt,572999,574541,1542,10,N,N,-,-1,-1
PILGRIM.txt,573144,574611,1467,10,N,N,-,-1,-1
PILGRIM.txt,573205,574752,1547,10,N,N,-,-1,-1
PILGRIM.txt,573316,574949,1633,10,N,N,-,-1,-1
PILGRIM.txt,573438,575123,1685,10,N,N,-,-1,-1
PILGRIM.txt,573563,575308,1745,10,N,N,-,-1,-1
PILGRIM.txt,573655,575427,1772,10,N,N,-,-1,-1
PILGRIM.txt,573991,575796,1805,10,N,N,-,-1,-1
PILGRIM.txt,574066,576078,2012,10,N,N,-,-1,-1
PILGRIM.txt,574248,576115,1867,10,N,N,-,-1,-1
PILGRIM.txt,574546,576296,1750,10,N,N,-,-1,-1
PILGRIM.txt,574612,576388,1776,10,N,N,-,-1,-1
PILGRIM.txt,574753,576574,1821,10,N,N,-,-1,-1
PILGRIM.txt,574952,576703,1751,10,N,N,-,-1,-1
PILGRIM.txt,575124,576781,1657,10,N,N,-,-1,-1
PILGRIM.txt,575311,576940,1629,10,N,N,-,-1,-1
PILGRIM.txt,575428,576997,1569,10,N,N,-,-1,-1
PILGRIM.txt,575797,577142,1345,10,N,N,-,-1,-1
PILGRIM.txt,576081,577179,1098,10,N,N,-,-1,-1
PILGRIM.txt,576116,577444,1328,10,N,N,-,-1,-1
PILGRIM.txt,576299,577653,1354,10,N,N,-,-1,-1
PILGRIM.txt,576389,577944,1555,10,N,N,-,-1,-1
PILGRIM.txt,576575,578139,1564,10,N,N,-,-1,-1
PILGRIM.txt,576704,578282,1578,10,N,N,-,-1,-1
PILGRIM.txt,576782,578431,1649,10,N,N,-,-1,-1
PILGRIM.txt,576943,578615,1672,10,N,N,-,-1,-1
PILGRIM.txt,576998,578806,1808,10,N,N,-,-1,-1
PILGRIM.txt,577145,578880,1735,10,N,N,-,-1,-1
PILGRIM.txt,577180,579017,1837,10,N,N,-,-1,-1
PILGRIM.txt,577447,579095,1648,10,N,N,-,-1,-1
PILGRIM.txt,577656,579376,1720,10,N,N,-,-1,-1
PILGRIM.txt,577945,579634,1689,10,N,N,-,-1,-1
PILGRIM.txt,578141,579701,1560,10,N,N,-,-1,-1
PILGRIM.txt,578287,579821,1534,10,N,N,-,-1,-1
PILGRIM.txt,578432,579999,1567,10,N,N,-,-1,-1
PILGRIM.txt,578616,580105,1489,10,N,N,-,-1,-1
PILGRIM.txt,578807,580324,1517,10,N,N,-,-1,-1
PILGRIM.txt,578881,580503,1622,10,N,N,-,-1,-1
PILGRIM.txt,579018,580549,1531,10,N,N,-,-1,-1
PILGRIM.txt,579098,580550,1452,10,N,N,-,-1,-1
PILGRIM.txt,579377,580800,1423,10,N,N,-,-1,-1
PILGRIM.txt,579637,580982,1345,10,N,N,-,-1,-1
PILGRIM.txt,579702,581691,1989,10,N,N,-,-1,-1
PILGRIM.txt,579822,581975,2153,10,N,N,-,-1,-1
PILGRIM.txt,580002,582081,2079,10,N,N,-,-1,-1
PILGRIM.txt,580106,582211,2105,10,N,N,-,-1,-1
PILGRIM.txt,580329,582236,1907,10,N,N,-,-1,-1
PILGRIM.txt,580504,582311,1807,10,N,N,-,-1,-1
PILGRIM.txt,580549,582402,1853,10,N,N,-,-1,-1
PILGRIM.txt,580551,582671,2120,10,N,N,-,-1,-1
PILGRIM.txt,580803,582836,2033,10,N,N,-,-1,-1
PILGRIM.txt,580989,583077,2088,10,N,N,-,-1,-1
PILGRIM.txt,581692,583311,1619,10,N,N,-,-1,-1
PILGRIM.txt,581976,583466,1490,10,N,N,-,-1,-1
PILGRIM.txt,582082,583663,1581,10,N,N,-,-1,-1
PILGRIM.txt,582213,583994,1781,10,N,N,-,-1,-1
PILGRIM.txt,582239,584138,1899,10,N,N,-,-1,-1
PILGRIM.txt,582312,584394,2082,10,N,N,-,-1,-1
PILGRIM.txt,582403,584459,2056,10,N,N,-,-1,-1
PILGRIM.txt,582672,584561,1889,10,N,N,-,-1,-1
PILGRIM.txt,582839,584674,1835,10,N,N,-,-1,-1
PILGRIM.txt,583080,584908,1828,10,N,N,-,-1,-1
PILGRIM.txt,583312,584971,1659,10,N,N,-,-1,-1
PILGRIM.txt,583467,585070,1603,10,N,N,-,-1,-1
PILGRIM.txt,583665,585215,1550,10,N,N,-,-1,-1
PILGRIM.txt,583995,585269,1274,10,N,N,-,-1,-1
PILGRIM.txt,584139,585421,1282,10,N,N,-,-1,-1
PILGRIM.txt,584395,585472,1077,10,N,N,-,-1,-1
PILGRIM.txt,584462,585538,1076,10,N,N,-,-1,-1
PILGRIM.txt,584562,585631,1069,10,N,N,-,-1,-1
PILGRIM.txt,584675,585801,1126,10,N,N,-,-1,-1
PILGRIM.txt,584909,585899,990,10,N,N,-,-1,-1
PILGRIM.txt,584974,585912,938,10,N,N,-,-1,-1
PILGRIM.txt,585071,585917,846,10,N,N,-,-1,-1
PILGRIM.txt,585216,585923,707,10,N,N,-,-1,-1
PILGRIM.txt,585274,586009,735,10,N,N,-,-1,-1
PILGRIM.txt,585422,586148,726,10,N,N,-,-1,-1
PILGRIM.txt,585473,586199,726,10,N,N,-,-1,-1
PILGRIM.txt,585541,586255,714,10,N,N,-,-1,-1
PILGRIM.txt,585633,586416,783,10,N,N,-,-1,-1
PILGRIM.txt,585802,586505,703,10,N,N,-,-1,-1
PILGRIM.txt,585900,586542,642,10,N,N,-,-1,-1
PILGRIM.txt,585913,586625,712,10,N,N,-,-1,-1
PILGRIM.txt,585918,586772,854,10,N,N,-,-1,-1
PILGRIM.txt,585924,586907,983,10,N,N,-,-1,-1
PILGRIM.txt,586010,586973,963,10,N,N,-,-1,-1
PILGRIM.txt,586149,587060,911,10,N,N,-,-1,-1
PILGRIM.txt,586202,587275,1073,10,N,N,-,-1,-1
PILGRIM.txt,586256,587451,1195,10,N,N,-,-1,-1
PILGRIM.txt,586418,587543,1125,10,N,N,-,-1,-1
PILGRIM.txt,586506,587761,1255,10,N,N,-,-1,-1
PILGRIM.txt,586545,587873,1328,10,N,N,-,-1,-1
PILGRIM.txt,586626,588007,1381,10,N,N,-,-1,-1
PILGRIM.txt,586773,588181,1408,10,N,N,-,-1,-1
PILGRIM.txt,586908,588341,1433,10,N,N,-,-1,-1
PILGRIM.txt,586975,588387,1412,10,N,N,-,-1,-1
PILGRIM.txt,587065,588391,1326,10,N,N,-,-1,-1
PILGRIM.txt,587276,588401,1125,10,N,N,-,-1,-1
PILGRIM.txt,587452,588421,969,10,N,N,-,-1,-1
PILGRIM.txt,587544,588531,987,10,N,N,-,-1,-1
PILGRIM.txt,587762,588651,889,10,N,N,-,-1,-1
PILGRIM.txt,587876,588968,1092,10,N,N,-,-1,-1
PILGRIM.txt,588008,589046,1038,10,N,N,-,-1,-1
PILGRIM.txt,588182,589190,1008,10,N,N,-,-1,-1
PILGRIM.txt,588344,589363,1019,10,N,N,-,-1,-1
PILGRIM.txt,588388,589370,982,10,N,N,-,-1,-1
PILGRIM.txt,588393,589390,997,10,N,N,-,-1,-1
PILGRIM.txt,588402,589416,1014,10,N,N,-,-1,-1
PILGRIM.txt,588422,589418,996,10,N,N,-,-1,-1
PILGRIM.txt,588531,589424,893,10,N,N,-,-1,-1
PILGRIM.txt,588652,589426,774,10,N,N,-,-1,-1
PILGRIM.txt,588970,589710,740,10,N,N,-,-1,-1
PILGRIM.txt,589051,589766,715,10,N,N,-,-1,-1
PILGRIM.txt,589192,589885,693,10,N,N,-,-1,-1
PILGRIM.txt,589366,590073,707,10,N,N,-,-1,-1
PILGRIM.txt,589371,590147,776,10,N,N,-,-1,-1
PILGRIM.txt,589390,590286,896,10,N,N,-,-1,-1
PILGRIM.txt,589417,590375,958,10,N,N,-,-1,-1
PILGRIM.txt,589419,590430,1011,10,N,N,-,-1,-1
PILGRIM.txt,589425,590485,1060,10,N,N,-,-1,-1
PILGRIM.txt,589427,590715,1288,10,N,N,-,-1,-1
PILGRIM.txt,589712,590826,1114,10,N,N,-,-1,-1
PILGRIM.txt,589768,590909,1141,10,N,N,-,-1,-1
PILGRIM.txt,589886,590997,1111,10,N,N,-,-1,-1
PILGRIM.txt,590078,591085,1007,10,N,N,-,-1,-1
PILGRIM.txt,590148,591151,1003,10,N,N,-,-1,-1
PILGRIM.txt,590287,591302,1015,10,N,N,-,-1,-1
PILGRIM.txt,590376,591364,988,10,N,N,-,-1,-1
PILGRIM.txt,590433,591462,1029,10,N,N,-,-1,-1
PILGRIM.txt,590486,591526,1040,10,N,N,-,-1,-1
PILGRIM.txt,590716,591582,866,10,N,N,-,-1,-1
PILGRIM.txt,590827,591684,857,10,N,N,-,-1,-1
PILGRIM.txt,590910,592060,1150,10,N,N,-,-1,-1
PILGRIM.txt,591000,592173,1173,10,N,N,-,-1,-1
PILGRIM.txt,591086,592228,1142,10,N,N,-,-1,-1
PILGRIM.txt,591153,592383,1230,10,N,N,-,-1,-1
PILGRIM.txt,591303,592522,1219,10,N,N,-,-1,-1
PILGRIM.txt,591367,592679,1312,10,N,N,-,-1,-1
PILGRIM.txt,591463,592796,1333,10,N,N,-,-1,-1
PILGRIM.txt,591528,593007,1479,10,N,N,-,-1,-1
PILGRIM.txt,591585,593113,1528,10,N,N,-,-1,-1
PILGRIM.txt,591686,593261,1575,10,N,N,-,-1,-1
PILGRIM.txt,592061,593529,1468,10,N,N,-,-1,-1
PILGRIM.txt,592174,593581,1407,10,N,N,-,-1,-1
PILGRIM.txt,592231,593690,1459,10,N,N,-,-1,-1
PILGRIM.txt,592384,593771,1387,10,N,N,-,-1,-1
PILGRIM.txt,592523,594076,1553,10,N,N,-,-1,-1
PILGRIM.txt,592680,594132,1452,10,N,N,-,-1,-1
PILGRIM.txt,592797,594416,1619,10,N,N,-,-1,-1
PILGRIM.txt,593010,594564,1554,10,N,N,-,-1,-1
PILGRIM.txt,593115,594814,1699,10,N,N,-,-1,-1
PILGRIM.txt,593262,594896,1634,10,N,N,-,-1,-1
PILGRIM.txt,593530,595242,1712,10,N,N,-,-1,-1
PILGRIM.txt,593582,595643,2061,10,N,N,-,-1,-1
PILGRIM.txt,593693,595717,2024,10,N,N,-,-1,-1
PILGRIM.txt,593776,595796,2020,10,N,N,-,-1,-1
PILGRIM.txt,594077,595873,1796,10,N,N,-,-1,-1
PILGRIM.txt,594134,595994,1860,10,N,N,-,-1,-1
PILGRIM.txt,594416,596125,1709,10,N,N,-,-1,-1
PILGRIM.txt,594565,596184,1619,10,N,N,-,-1,-1
PILGRIM.txt,594817,596245,1428,10,N,N,-,-1,-1
PILGRIM.txt,594897,596403,1506,10,N,N,-,-1,-1
PILGRIM.txt,595243,596564,1321,10,N,N,-,-1,-1
PILGRIM.txt,595644,596686,1042,10,N,N,-,-1,-1
PILGRIM.txt,595720,596845,1125,10,N,N,-,-1,-1
PILGRIM.txt,595801,596979,1178,10,N,N,-,-1,-1
PILGRIM.txt,595874,597056,1182,10,N,N,-,-1,-1
PILGRIM.txt,595995,597153,1158,10,N,N,-,-1,-1
PILGRIM.txt,596126,597303,1177,10,N,N,-,-1,-1
PILGRIM.txt,596185,597380,1195,10,N,N,-,-1,-1
PILGRIM.txt,596247,597518,1271,10,N,N,-,-1,-1
PILGRIM.txt,596406,597622,1216,10,N,N,-,-1,-1
PILGRIM.txt,596566,597726,1160,10,N,N,-,-1,-1
PILGRIM.txt,596689,597845,1156,10,N,N,-,-1,-1
PILGRIM.txt,596846,597920,1074,10,N,N,-,-1,-1
PILGRIM.txt,596979,598766,1787,10,N,N,-,-1,-1
PILGRIM.txt,597057,599690,2633,10,N,N,-,-1,-1
PILGRIM.txt,597154,599800,2646,10,N,N,-,-1,-1
PILGRIM.txt,597304,600018,2714,10,N,N,-,-1,-1
PILGRIM.txt,597381,600091,2710,10,N,N,-,-1,-1
PILGRIM.txt,597519,600197,2678,10,N,N,-,-1,-1
PILGRIM.txt,597623,600224,2601,10,N,N,-,-1,-1
PILGRIM.txt,597731,600242,2511,10,N,N,-,-1,-1
PILGRIM.txt,597846,600499,2653,10,N,N,-,-1,-1
PILGRIM.txt,597923,600767,2844,10,N,N,-,-1,-1
PILGRIM.txt,598766,600848,2082,10,N,N,-,-1,-1
PILGRIM.txt,599693,601115,1422,10,N,N,-,-1,-1
PILGRIM.txt,599805,601292,1487,10,N,N,-,-1,-1
PILGRIM.txt,600021,601782,1761,10,N,N,-,-1,-1
PILGRIM.txt,600092,601994,1902,10,N,N,-,-1,-1
PILGRIM.txt,600202,602183,1981,10,N,N,-,-1,-1
PILGRIM.txt,600229,602278,2049,10,N,N,-,-1,-1
PILGRIM.txt,600245,602416,2171,10,N,N,-,-1,-1
PILGRIM.txt,600502,602527,2025,10,N,N,-,-1,-1
PILGRIM.txt,600770,602624,1854,10,N,N,-,-1,-1
PILGRIM.txt,600849,602702,1853,10,N,N,-,-1,-1
PILGRIM.txt,601116,602930,1814,10,N,N,-,-1,-1
PILGRIM.txt,601293,603163,1870,10,N,N,-,-1,-1
PILGRIM.txt,601787,603308,1521,10,N,N,-,-1,-1
PILGRIM.txt,601995,603428,1433,10,N,N,-,-1,-1
PILGRIM.txt,602184,603536,1352,10,N,N,-,-1,-1
PILGRIM.txt,602279,603750,1471,10,N,N,-,-1,-1
PILGRIM.txt,602417,603891,1474,10,N,N,-,-1,-1
PILGRIM.txt,602528,603988,1460,10,N,N,-,-1,-1
PILGRIM.txt,602627,604248,1621,10,N,N,-,-1,-1
PILGRIM.txt,602703,604523,1820,10,N,N,-,-1,-1
PILGRIM.txt,602932,604747,1815,10,N,N,-,-1,-1
PILGRIM.txt,603166,604869,1703,10,N,N,-,-1,-1
PILGRIM.txt,603311,604959,1648,10,N,N,-,-1,-1
PILGRIM.txt,603429,605234,1805,10,N,N,-,-1,-1
PILGRIM.txt,603537,605356,1819,10,N,N,-,-1,-1
PILGRIM.txt,603751,605487,1736,10,N,N,-,-1,-1
PILGRIM.txt,603892,605711,1819,10,N,N,-,-1,-1
PILGRIM.txt,603989,605856,1867,10,N,N,-,-1,-1
PILGRIM.txt,604249,605942,1693,10,N,N,-,-1,-1
PILGRIM.txt,604524,606016,1492,10,N,N,-,-1,-1
PILGRIM.txt,604750,606174,1424,10,N,N,-,-1,-1
PILGRIM.txt,604870,606386,1516,10,N,N,-,-1,-1
PILGRIM.txt,604960,606643,1683,10,N,N,-,-1,-1
PILGRIM.txt,605235,606765,1530,10,N,N,-,-1,-1
PILGRIM.txt,605359,606867,1508,10,N,N,-,-1,-1
PILGRIM.txt,605488,607158,1670,10,N,N,-,-1,-1
PILGRIM.txt,605712,607335,1623,10,N,N,-,-1,-1
PILGRIM.txt,605858,607628,1770,10,N,N,-,-1,-1
PILGRIM.txt,605943,607820,1877,10,N,N,-,-1,-1
PILGRIM.txt,606019,608330,2311,10,N,N,-,-1,-1
PILGRIM.txt,606176,608568,2392,10,N,N,-,-1,-1
PILGRIM.txt,606387,608605,2218,10,N,N,-,-1,-1
PILGRIM.txt,606644,609018,2374,10,N,N,-,-1,-1
PILGRIM.txt,606766,609197,2431,10,N,N,-,-1,-1
PILGRIM.txt,606868,609250,2382,10,N,N,-,-1,-1
PILGRIM.txt,607161,609269,2108,10,N,N,-,-1,-1
PILGRIM.txt,607340,609311,1971,10,N,N,-,-1,-1
PILGRIM.txt,607630,609312,1682,10,N,N,-,-1,-1
PILGRIM.txt,607823,609313,1490,10,N,N,-,-1,-1
PILGRIM.txt,608331,609318,987,10,N,N,-,-1,-1
PILGRIM.txt,608569,609359,790,10,N,N,-,-1,-1
PILGRIM.txt,608606,609416,810,10,N,N,-,-1,-1
PILGRIM.txt,609021,609417,396,10,N,N,-,-1,-1
PILGRIM.txt,609198,609421,223,10,N,N,-,-1,-1
PILGRIM.txt,609250,609437,187,10,N,N,-,-1,-1
PILGRIM.txt,609269,609438,169,10,N,N,-,-1,-1
PILGRIM.txt,609311,609440,129,10,N,N,-,-1,-1
PILGRIM.txt,609312,609445,133,10,N,N,-,-1,-1
PILGRIM.txt,609313,609474,161,10,N,N,-,-1,-1
PILGRIM.txt,609318,609475,157,10,N,N,-,-1,-1
PILGRIM.txt,609360,609480,120,10,N,N,-,-1,-1
PILGRIM.txt,609416,609485,69,10,N,N,-,-1,-1
PILGRIM.txt,609417,609489,72,10,N,N,-,-1,-1
PILGRIM.txt,609422,609550,128,10,N,N,-,-1,-1
PILGRIM.txt,609437,609601,164,10,N,N,-,-1,-1
PILGRIM.txt,609438,609602,164,10,N,N,-,-1,-1
PILGRIM.txt,609440,609603,163,10,N,N,-,-1,-1
PILGRIM.txt,609446,609623,177,10,N,N,-,-1,-1
PILGRIM.txt,609474,609671,197,10,N,N,-,-1,-1
PILGRIM.txt,609475,609748,273,10,N,N,-,-1,-1
PILGRIM.txt,609480,609775,295,10,N,N,-,-1,-1
PILGRIM.txt,609485,609793,308,10,N,N,-,-1,-1
PILGRIM.txt,609489,609794,305,10,N,N,-,-1,-1
PILGRIM.txt,609551,609798,247,10,N,N,-,-1,-1
PILGRIM.txt,609601,609869,268,10,N,N,-,-1,-1
PILGRIM.txt,609602,609876,274,10,N,N,-,-1,-1
PILGRIM.txt,609603,609878,275,10,N,N,-,-1,-1
PILGRIM.txt,609626,609989,363,10,N,N,-,-1,-1
PILGRIM.txt,609672,610000,328,10,N,N,-,-1,-1
PILGRIM.txt,609749,610003,254,10,N,N,-,-1,-1
PILGRIM.txt,609775,610089,314,10,N,N,-,-1,-1
PILGRIM.txt,609793,610126,333,10,N,N,-,-1,-1
PILGRIM.txt,609795,610127,332,10,N,N,-,-1,-1
PILGRIM.txt,609799,610131,332,10,N,N,-,-1,-1
PILGRIM.txt,609872,610132,260,10,N,N,-,-1,-1
PILGRIM.txt,609877,610144,267,10,N,N,-,-1,-1
PILGRIM.txt,609878,610146,268,10,N,N,-,-1,-1
PILGRIM.txt,609990,610148,158,10,N,N,-,-1,-1
PILGRIM.txt,610000,610187,187,10,N,N,-,-1,-1
PILGRIM.txt,610004,610211,207,10,N,N,-,-1,-1
PILGRIM.txt,610090,610222,132,10,N,N,-,-1,-1
PILGRIM.txt,610126,610250,124,10,N,N,-,-1,-1
PILGRIM.txt,610127,610254,127,10,N,N,-,-1,-1
PILGRIM.txt,610131,610268,137,10,N,N,-,-1,-1
PILGRIM.txt,610132,610283,151,10,N,N,-,-1,-1
PILGRIM.txt,610144,610295,151,10,N,N,-,-1,-1
PILGRIM.txt,610147,610297,150,10,N,N,-,-1,-1
PILGRIM.txt,610149,610306,157,10,N,N,-,-1,-1
PILGRIM.txt,610188,610344,156,10,N,N,-,-1,-1
PILGRIM.txt,610212,610346,134,10,N,N,-,-1,-1
PILGRIM.txt,610223,610405,182,10,N,N,-,-1,-1
PILGRIM.txt,610251,610519,268,10,N,N,-,-1,-1
PILGRIM.txt,610257,610578,321,10,N,N,-,-1,-1
PILGRIM.txt,610268,610595,327,10,N,N,-,-1,-1
PILGRIM.txt,610283,610613,330,10,N,N,-,-1,-1
PILGRIM.txt,610295,610641,346,10,N,N,-,-1,-1
PILGRIM.txt,610298,610645,347,10,N,N,-,-1,-1
PILGRIM.txt,610306,610705,399,10,N,N,-,-1,-1
PILGRIM.txt,610345,610711,366,10,N,N,-,-1,-1
PILGRIM.txt,610347,610808,461,10,N,N,-,-1,-1
PILGRIM.txt,610406,610844,438,10,N,N,-,-1,-1
PILGRIM.txt,610520,610845,325,10,N,N,-,-1,-1
PILGRIM.txt,610578,610858,280,10,N,N,-,-1,-1
PILGRIM.txt,610596,610942,346,10,N,N,-,-1,-1
PILGRIM.txt,610614,611000,386,10,N,N,-,-1,-1
PILGRIM.txt,610641,611099,458,10,N,N,-,-1,-1
PILGRIM.txt,610646,611107,461,10,N,N,-,-1,-1
PILGRIM.txt,610706,611462,756,10,N,N,-,-1,-1
PILGRIM.txt,610712,611652,940,10,N,N,-,-1,-1
PILGRIM.txt,610811,612070,1259,10,N,N,-,-1,-1
PILGRIM.txt,610844,612295,1451,10,N,N,-,-1,-1
PILGRIM.txt,610845,612510,1665,10,N,N,-,-1,-1
PILGRIM.txt,610859,612703,1844,10,N,N,-,-1,-1
PILGRIM.txt,610942,613022,2080,10,N,N,-,-1,-1
PILGRIM.txt,611001,613479,2478,10,N,N,-,-1,-1
PILGRIM.txt,611100,613570,2470,10,N,N,-,-1,-1
PILGRIM.txt,611108,613865,2757,10,N,N,-,-1,-1
PILGRIM.txt,611463,614038,2575,10,N,N,-,-1,-1
PILGRIM.txt,611653,614194,2541,10,N,N,-,-1,-1
PILGRIM.txt,612073,614427,2354,10,N,N,-,-1,-1
PILGRIM.txt,612296,614730,2434,10,N,N,-,-1,-1
PILGRIM.txt,612513,615022,2509,10,N,N,-,-1,-1
PILGRIM.txt,612704,615188,2484,10,N,N,-,-1,-1
PILGRIM.txt,613023,615339,2316,10,N,N,-,-1,-1
PILGRIM.txt,613481,615525,2044,10,N,N,-,-1,-1
PILGRIM.txt,613573,615719,2146,10,N,N,-,-1,-1
PILGRIM.txt,613866,616114,2248,10,N,N,-,-1,-1
PILGRIM.txt,614039,616322,2283,10,N,N,-,-1,-1
PILGRIM.txt,614195,616529,2334,10,N,N,-,-1,-1
PILGRIM.txt,614428,616607,2179,10,N,N,-,-1,-1
PILGRIM.txt,614731,616690,1959,10,N,N,-,-1,-1
PILGRIM.txt,615025,616753,1728,10,N,N,-,-1,-1
PILGRIM.txt,615190,616946,1756,10,N,N,-,-1,-1
PILGRIM.txt,615340,617187,1847,10,N,N,-,-1,-1
PILGRIM.txt,615526,617447,1921,10,N,N,-,-1,-1
PILGRIM.txt,615722,617547,1825,10,N,N,-,-1,-1
PILGRIM.txt,616115,617642,1527,10,N,N,-,-1,-1
PILGRIM.txt,616323,617713,1390,10,N,N,-,-1,-1
PILGRIM.txt,616530,617919,1389,10,N,N,-,-1,-1
PILGRIM.txt,616610,617977,1367,10,N,N,-,-1,-1
PILGRIM.txt,616691,618146,1455,10,N,N,-,-1,-1
PILGRIM.txt,616754,618284,1530,10,N,N,-,-1,-1
PILGRIM.txt,616947,618379,1432,10,N,N,-,-1,-1
PILGRIM.txt,617188,618497,1309,10,N,N,-,-1,-1
PILGRIM.txt,617448,618592,1144,10,N,N,-,-1,-1
PILGRIM.txt,617548,618756,1208,10,N,N,-,-1,-1
PILGRIM.txt,617644,618846,1202,10,N,N,-,-1,-1
PILGRIM.txt,617714,619046,1332,10,N,N,-,-1,-1
PILGRIM.txt,617920,619177,1257,10,N,N,-,-1,-1
PILGRIM.txt,617980,619343,1363,10,N,N,-,-1,-1
PILGRIM.txt,618149,619456,1307,10,N,N,-,-1,-1
PILGRIM.txt,618285,619500,1215,10,N,N,-,-1,-1
PILGRIM.txt,618380,619619,1239,10,N,N,-,-1,-1
PILGRIM.txt,618498,620021,1523,10,N,N,-,-1,-1
PILGRIM.txt,618597,620205,1608,10,N,N,-,-1,-1
PILGRIM.txt,618757,620376,1619,10,N,N,-,-1,-1
PILGRIM.txt,618847,620613,1766,10,N,N,-,-1,-1
PILGRIM.txt,619047,620899,1852,10,N,N,-,-1,-1
PILGRIM.txt,619179,620916,1737,10,N,N,-,-1,-1
PILGRIM.txt,619346,621153,1807,10,N,N,-,-1,-1
PILGRIM.txt,619457,621284,1827,10,N,N,-,-1,-1
PILGRIM.txt,619502,621448,1946,10,N,N,-,-1,-1
PILGRIM.txt,619620,621592,1972,10,N,N,-,-1,-1
PILGRIM.txt,620022,621822,1800,10,N,N,-,-1,-1
PILGRIM.txt,620208,622109,1901,10,N,N,-,-1,-1
PILGRIM.txt,620381,622200,1819,10,N,N,-,-1,-1
PILGRIM.txt,620615,622271,1656,10,N,N,-,-1,-1
PILGRIM.txt,620904,622321,1417,10,N,N,-,-1,-1
PILGRIM.txt,620919,622466,1547,10,N,N,-,-1,-1
PILGRIM.txt,621156,622626,1470,10,N,N,-,-1,-1
PILGRIM.txt,621285,622737,1452,10,N,N,-,-1,-1
PILGRIM.txt,621449,622914,1465,10,N,N,-,-1,-1
PILGRIM.txt,621595,623000,1405,10,N,N,-,-1,-1
PILGRIM.txt,621823,623131,1308,10,N,N,-,-1,-1
PILGRIM.txt,622112,623299,1187,10,N,N,-,-1,-1
PILGRIM.txt,622201,623342,1141,10,N,N,-,-1,-1
PILGRIM.txt,622273,623504,1231,10,N,N,-,-1,-1
PILGRIM.txt,622323,623584,1261,10,N,N,-,-1,-1
PILGRIM.txt,622471,623870,1399,10,N,N,-,-1,-1
PILGRIM.txt,622627,624029,1402,10,N,N,-,-1,-1
PILGRIM.txt,622738,624213,1475,10,N,N,-,-1,-1
PILGRIM.txt,622915,624262,1347,10,N,N,-,-1,-1
PILGRIM.txt,623003,624427,1424,10,N,N,-,-1,-1
PILGRIM.txt,623132,624499,1367,10,N,N,-,-1,-1
PILGRIM.txt,623300,624616,1316,10,N,N,-,-1,-1
PILGRIM.txt,623345,624846,1501,10,N,N,-,-1,-1
PILGRIM.txt,623505,624956,1451,10,N,N,-,-1,-1
PILGRIM.txt,623585,625050,1465,10,N,N,-,-1,-1
PILGRIM.txt,623871,625089,1218,10,N,N,-,-1,-1
PILGRIM.txt,624030,625214,1184,10,N,N,-,-1,-1
PILGRIM.txt,624214,625356,1142,10,N,N,-,-1,-1
PILGRIM.txt,624263,625636,1373,10,N,N,-,-1,-1
PILGRIM.txt,624429,625761,1332,10,N,N,-,-1,-1
PILGRIM.txt,624500,625921,1421,10,N,N,-,-1,-1
PILGRIM.txt,624619,626541,1922,10,N,N,-,-1,-1
PILGRIM.txt,624847,626619,1772,10,N,N,-,-1,-1
PILGRIM.txt,624957,626756,1799,10,N,N,-,-1,-1
PILGRIM.txt,625051,626873,1822,10,N,N,-,-1,-1
PILGRIM.txt,625090,627111,2021,10,N,N,-,-1,-1
PILGRIM.txt,625217,627177,1960,10,N,N,-,-1,-1
PILGRIM.txt,625357,627383,2026,10,N,N,-,-1,-1
PILGRIM.txt,625637,627702,2065,10,N,N,-,-1,-1
PILGRIM.txt,625762,627837,2075,10,N,N,-,-1,-1
PILGRIM.txt,625922,628019,2097,10,N,N,-,-1,-1
PILGRIM.txt,626544,628201,1657,10,N,N,-,-1,-1
PILGRIM.txt,626620,628335,1715,10,N,N,-,-1,-1
PILGRIM.txt,626757,628494,1737,10,N,N,-,-1,-1
PILGRIM.txt,626874,628616,1742,10,N,N,-,-1,-1
PILGRIM.txt,627113,628671,1558,10,N,N,-,-1,-1
PILGRIM.txt,627178,628706,1528,10,N,N,-,-1,-1
PILGRIM.txt,627384,628788,1404,10,N,N,-,-1,-1
PILGRIM.txt,627705,628906,1201,10,N,N,-,-1,-1
PILGRIM.txt,627838,629068,1230,10,N,N,-,-1,-1
PILGRIM.txt,628024,629242,1218,10,N,N,-,-1,-1
PILGRIM.txt,628202,629511,1309,10,N,N,-,-1,-1
PILGRIM.txt,628336,629691,1355,10,N,N,-,-1,-1
PILGRIM.txt,628495,629905,1410,10,N,N,-,-1,-1
PILGRIM.txt,628617,630137,1520,10,N,N,-,-1,-1
PILGRIM.txt,628672,630284,1612,10,N,N,-,-1,-1
PILGRIM.txt,628709,630393,1684,10,N,N,-,-1,-1
PILGRIM.txt,628789,630489,1700,10,N,N,-,-1,-1
PILGRIM.txt,628907,630585,1678,10,N,N,-,-1,-1
PILGRIM.txt,629071,630760,1689,10,N,N,-,-1,-1
PILGRIM.txt,629243,630971,1728,10,N,N,-,-1,-1
PILGRIM.txt,629516,631021,1505,10,N,N,-,-1,-1
PILGRIM.txt,629694,631048,1354,10,N,N,-,-1,-1
PILGRIM.txt,629906,631138,1232,10,N,N,-,-1,-1
PILGRIM.txt,630138,631184,1046,10,N,N,-,-1,-1
PILGRIM.txt,630285,631314,1029,10,N,N,-,-1,-1
PILGRIM.txt,630394,631409,1015,10,N,N,-,-1,-1
PILGRIM.txt,630491,631670,1179,10,N,N,-,-1,-1
PILGRIM.txt,630586,632157,1571,10,N,N,-,-1,-1
PILGRIM.txt,630761,632359,1598,10,N,N,-,-1,-1
PILGRIM.txt,630972,633576,2604,10,N,N,-,-1,-1
PILGRIM.txt,631022,633577,2555,10,N,N,-,-1,-1
PILGRIM.txt,631049,633981,2932,10,N,N,-,-1,-1
PILGRIM.txt,631141,634250,3109,10,N,N,-,-1,-1
PILGRIM.txt,631189,634372,3183,10,N,N,-,-1,-1
PILGRIM.txt,631316,634603,3287,10,N,N,-,-1,-1
PILGRIM.txt,631410,638248,6838,10,N,N,-,-1,-1
PILGRIM.txt,631671,640065,8394,10,N,N,-,-1,-1
PILGRIM.txt,632162,640099,7937,10,N,N,-,-1,-1
PILGRIM.txt,632360,640579,8219,10,Y,N,-,-1,-1
PILGRIM.txt,633576,640670,7094,10,Y,N,-,-1,-1
PILGRIM.txt,633582,640781,7199,10,Y,N,-,-1,-1
PILGRIM.txt,633982,641598,7616,10,Y,N,-,-1,-1
PILGRIM.txt,634251,641843,7592,10,Y,N,-,-1,-1
PILGRIM.txt,634377,642095,7718,10,Y,N,-,-1,-1
PILGRIM.txt,634608,642100,7492,10,Y,N,-,-1,-1
PILGRIM.txt,638249,642886,4637,10,N,N,-,-1,-1
PILGRIM.txt,640067,644849,4782,10,N,N,-,-1,-1
PILGRIM.txt,640102,644935,4833,10,N,N,-,-1,-1
PILGRIM.txt,640581,645148,4567,10,N,N,-,-1,-1
PILGRIM.txt,640673,646071,5398,10,N,N,-,-1,-1
PILGRIM.txt,640782,646487,5705,10,N,N,-,-1,-1
PILGRIM.txt,641599,646488,4889,10,N,N,-,-1,-1
PILGRIM.txt,641845,647481,5636,10,N,N,-,-1,-1
PILGRIM.txt,642096,647485,5389,10,N,N,-,-1,-1
PILGRIM.txt,642101,648531,6430,10,N,N,-,-1,-1
PILGRIM.txt,642887,650111,7224,10,N,N,-,-1,-1
PILGRIM.txt,644852,650743,5891,10,N,N,-,-1,-1
PILGRIM.txt,644936,651090,6154,10,N,N,-,-1,-1
PILGRIM.txt,645151,653558,8407,10,N,N,-,-1,-1
PILGRIM.txt,646072,655186,9114,10,N,N,-,-1,-1
PILGRIM.txt,646487,655619,9132,10,N,N,-,-1,-1
PILGRIM.txt,646489,658672,12183,10,N,N,-,-1,-1
PILGRIM.txt,647482,658673,11191,10,N,N,-,-1,-1
PILGRIM.txt,647486,659307,11821,10,N,N,-,-1,-1
PILGRIM.txt,648533,659310,10777,10,N,N,-,-1,-1
PILGRIM.txt,650112,659320,9208,10,N,N,-,-1,-1
PILGRIM.txt,650744,659326,8582,10,N,N,-,-1,-1
PILGRIM.txt,651091,662300,11209,10,N,N,-,-1,-1
PILGRIM.txt,653560,662919,9359,10,N,N,-,-1,-1
PILGRIM.txt,655188,663176,7988,10,N,N,-,-1,-1
RECMUS.txt,0,464,464,10,N,N,-,-1,-1
RECMUS.txt,183,539,356,10,N,N,-,-1,-1
RECMUS.txt,187,561,374,10,N,N,-,-1,-1
RECMUS.txt,189,568,379,10,N,N,-,-1,-1
RECMUS.txt,209,681,472,10,N,N,-,-1,-1
RECMUS.txt,263,782,519,10,N,N,-,-1,-1
RECMUS.txt,270,789,519,10,N,N,-,-1,-1
RECMUS.txt,286,890,604,10,N,N,-,-1,-1
RECMUS.txt,321,970,649,10,N,N,-,-1,-1
RECMUS.txt,346,977,631,10,N,N,-,-1,-1
RECMUS.txt,465,1082,617,10,N,N,-,-1,-1
RECMUS.txt,540,1146,606,10,N,N,-,-1,-1
RECMUS.txt,562,1153,591,10,N,N,-,-1,-1
RECMUS.txt,571,1193,622,10,N,N,-,-1,-1
RECMUS.txt,682,1214,532,10,N,N,-,-1,-1
RECMUS.txt,783,1243,460,10,N,N,-,-1,-1
RECMUS.txt,792,1250,458,10,N,N,-,-1,-1
RECMUS.txt,891,1284,393,10,N,N,-,-1,-1
RECMUS.txt,971,1307,336,10,N,N,-,-1,-1
RECMUS.txt,980,1773,793,10,N,N,-,-1,-1
RECMUS.txt,1083,2109,1026,10,N,N,-,-1,-1
RECMUS.txt,1147,2244,1097,10,N,N,-,-1,-1
RECMUS.txt,1156,2454,1298,10,N,N,-,-1,-1
RECMUS.txt,1196,2581,1385,10,N,N,-,-1,-1
RECMUS.txt,1215,2767,1552,10,N,N,-,-1,-1
RECMUS.txt,1244,2889,1645,10,N,N,-,-1,-1
RECMUS.txt,1253,3133,1880,10,N,N,-,-1,-1
RECMUS.txt,1289,3215,1926,10,N,N,-,-1,-1
RECMUS.txt,1312,3369,2057,10,N,N,-,-1,-1
RECMUS.txt,1778,3394,1616,10,N,N,-,-1,-1
RECMUS.txt,2110,3406,1296,10,N,N,-,-1,-1
RECMUS.txt,2245,3706,1461,10,N,N,-,-1,-1
RECMUS.txt,2455,3859,1404,10,N,N,-,-1,-1
RECMUS.txt,2584,3934,1350,10,N,N,-,-1,-1
RECMUS.txt,2768,4099,1331,10,N,N,-,-1,-1
RECMUS.txt,2890,4118,1228,10,N,N,-,-1,-1
RECMUS.txt,3134,4132,998,10,N,N,-,-1,-1
RECMUS.txt,3218,4159,941,10,N,N,-,-1,-1
RECMUS.txt,3372,4532,1160,10,N,N,-,-1,-1
RECMUS.txt,3399,4548,1149,10,N,N,-,-1,-1
RECMUS.txt,3411,4561,1150,10,N,N,-,-1,-1
RECMUS.txt,3707,4986,1279,10,N,N,-,-1,-1
RECMUS.txt,3860,5003,1143,10,N,N,-,-1,-1
RECMUS.txt,3937,5017,1080,10,N,N,-,-1,-1
RECMUS.txt,4102,5484,1382,10,N,N,-,-1,-1
RECMUS.txt,4123,5492,1369,10,N,N,-,-1,-1
RECMUS.txt,4137,5964,1827,10,N,N,-,-1,-1
RECMUS.txt,4162,6017,1855,10,N,N,-,-1,-1
RECMUS.txt,4533,6335,1802,10,N,N,-,-1,-1
RECMUS.txt,4550,6815,2265,10,N,N,-,-1,-1
RECMUS.txt,4564,7245,2681,10,N,N,-,-1,-1
RECMUS.txt,4987,7253,2266,10,N,N,-,-1,-1
RECMUS.txt,5006,7672,2666,10,N,N,-,-1,-1
RECMUS.txt,5020,7689,2669,10,N,N,-,-1,-1
RECMUS.txt,5487,7697,2210,10,N,N,-,-1,-1
RECMUS.txt,5495,8111,2616,10,N,N,-,-1,-1
RECMUS.txt,5967,8529,2562,10,N,N,-,-1,-1
RECMUS.txt,6018,8537,2519,10,N,N,-,-1,-1
RECMUS.txt,6338,8995,2657,10,N,N,-,-1,-1
RECMUS.txt,6818,9430,2612,10,N,N,-,-1,-1
RECMUS.txt,7248,9445,2197,10,N,N,-,-1,-1
RECMUS.txt,7256,9855,2599,10,N,N,-,-1,-1
RECMUS.txt,7673,9863,2190,10,N,N,-,-1,-1
RECMUS.txt,7692,10389,2697,10,N,N,-,-1,-1
RECMUS.txt,7700,10397,2697,10,N,N,-,-1,-1
RECMUS.txt,8114,10749,2635,10,N,N,-,-1,-1
RECMUS.txt,8532,10769,2237,10,N,N,-,-1,-1
RECMUS.txt,8540,10777,2237,10,N,N,-,-1,-1
RECMUS.txt,8998,11218,2220,10,N,N,-,-1,-1
RECMUS.txt,9433,11230,1797,10,N,N,-,-1,-1
RECMUS.txt,9448,11702,2254,10,N,N,-,-1,-1
RECMUS.txt,9858,11710,1852,10,N,N,-,-1,-1
RECMUS.txt,9866,12128,2262,10,Y,N,-,-1,-1
RECMUS.txt,10392,12136,1744,10,Y,N,-,-1,-1
RECMUS.txt,10400,12600,2200,10,Y,N,-,-1,-1
RECMUS.txt,10750,12614,1864,10,Y,N,-,-1,-1
RECMUS.txt,10772,12622,1850,10,Y,N,-,-1,-1
RECMUS.txt,10780,12954,2174,10,Y,N,-,-1,-1
RECMUS.txt,11221,12962,1741,10,N,N,-,-1,-1
RECMUS.txt,11231,13382,2151,10,N,N,-,-1,-1
RECMUS.txt,11705,13409,1704,10,N,N,-,-1,-1
RECMUS.txt,11713,13849,2136,10,N,N,-,-1,-1
RECMUS.txt,12131,13857,1726,10,N,N,-,-1,-1
RECMUS.txt,12139,14186,2047,10,N,N,-,-1,-1
RECMUS.txt,12603,14194,1591,10,N,N,-,-1,-1
RECMUS.txt,12617,14274,1657,10,N,N,-,-1,-1
RECMUS.txt,12625,14630,2005,10,N,N,-,-1,-1
RECMUS.txt,12957,14638,1681,10,Y,N,-,-1,-1
RECMUS.txt,12965,15030,2065,10,N,N,-,-1,-1
RECMUS.txt,13383,15441,2058,10,N,N,-,-1,-1
RECMUS.txt,13412,15449,2037,10,N,N,-,-1,-1
RECMUS.txt,13852,15876,2024,10,N,N,-,-1,-1
RECMUS.txt,13860,15884,2024,10,N,N,-,-1,-1
RECMUS.txt,14189,16028,1839,10,N,N,-,-1,-1
RECMUS.txt,14197,16360,2163,10,N,N,-,-1,-1
RECMUS.txt,14275,16368,2093,10,N,N,-,-1,-1
RECMUS.txt,14633,16780,2147,10,N,N,-,-1,-1
RECMUS.txt,14641,16794,2153,10,N,N,-,-1,-1
RECMUS.txt,15033,17246,2213,10,N,N,-,-1,-1
RECMUS.txt,15444,17261,1817,10,N,N,-,-1,-1
RECMUS.txt,15452,17687,2235,10,N,N,-,-1,-1
RECMUS.txt,15879,17695,1816,10,N,N,-,-1,-1
RECMUS.txt,15887,17770,1883,10,N,N,-,-1,-1
RECMUS.txt,16031,18067,2036,10,N,N,-,-1,-1
RECMUS.txt,16363,18075,1712,10,N,N,-,-1,-1
RECMUS.txt,16371,18498,2127,10,N,N,-,-1,-1
RECMUS.txt,16783,18500,1717,10,N,N,-,-1,-1
RECMUS.txt,16797,18521,1724,10,N,N,-,-1,-1
RECMUS.txt,17249,18535,1286,10,N,N,-,-1,-1
RECMUS.txt,17264,18949,1685,10,N,N,-,-1,-1
RECMUS.txt,17690,18963,1273,10,N,N,-,-1,-1
RECMUS.txt,17698,19363,1665,10,N,N,-,-1,-1
RECMUS.txt,17771,19831,2060,10,N,N,-,-1,-1
RECMUS.txt,18070,19884,1814,10,N,N,-,-1,-1
RECMUS.txt,18078,19890,1812,10,N,N,-,-1,-1
RECMUS.txt,18499,19928,1429,10,N,N,-,-1,-1
RECMUS.txt,18501,19958,1457,10,N,N,-,-1,-1
RECMUS.txt,18524,20310,1786,10,N,N,-,-1,-1
RECMUS.txt,18538,20610,2072,10,N,N,-,-1,-1
RECMUS.txt,18952,20705,1753,10,N,N,-,-1,-1
RECMUS.txt,18966,20818,1852,10,N,N,-,-1,-1
RECMUS.txt,19366,21025,1659,10,N,N,-,-1,-1
RECMUS.txt,19832,21141,1309,10,N,N,-,-1,-1
RECMUS.txt,19885,21276,1391,10,N,N,-,-1,-1
RECMUS.txt,19891,21307,1416,10,N,N,-,-1,-1
RECMUS.txt,19933,21385,1452,10,N,N,-,-1,-1
RECMUS.txt,19963,21468,1505,10,N,N,-,-1,-1
RECMUS.txt,20313,21509,1196,10,N,N,-,-1,-1
RECMUS.txt,20611,21720,1109,10,N,N,-,-1,-1
RECMUS.txt,20706,21770,1064,10,N,N,-,-1,-1
RECMUS.txt,20819,22013,1194,10,N,N,-,-1,-1
RECMUS.txt,21026,22123,1097,10,N,N,-,-1,-1
RECMUS.txt,21142,22260,1118,10,N,N,-,-1,-1
RECMUS.txt,21277,22291,1014,10,N,N,-,-1,-1
RECMUS.txt,21308,22432,1124,10,N,N,-,-1,-1
RECMUS.txt,21388,22600,1212,10,N,N,-,-1,-1
RECMUS.txt,21469,22645,1176,10,N,N,-,-1,-1
RECMUS.txt,21510,22834,1324,10,N,N,-,-1,-1
RECMUS.txt,21721,23040,1319,10,N,N,-,-1,-1
RECMUS.txt,21771,23173,1402,10,N,N,-,-1,-1
RECMUS.txt,22014,23441,1427,10,N,N,-,-1,-1
RECMUS.txt,22124,23552,1428,10,N,N,-,-1,-1
RECMUS.txt,22262,23647,1385,10,N,N,-,-1,-1
RECMUS.txt,22292,23723,1431,10,N,N,-,-1,-1
RECMUS.txt,22434,23758,1324,10,N,N,-,-1,-1
RECMUS.txt,22603,24052,1449,10,N,N,-,-1,-1
RECMUS.txt,22646,24156,1510,10,N,N,-,-1,-1
RECMUS.txt,22835,24328,1493,10,N,N,-,-1,-1
RECMUS.txt,23041,24415,1374,10,N,N,-,-1,-1
RECMUS.txt,23174,24618,1444,10,N,N,-,-1,-1
RECMUS.txt,23442,24696,1254,10,N,N,-,-1,-1
RECMUS.txt,23553,24795,1242,10,N,N,-,-1,-1
RECMUS.txt,23648,24900,1252,10,N,N,-,-1,-1
RECMUS.txt,23724,24991,1267,10,N,N,-,-1,-1
RECMUS.txt,23759,25098,1339,10,N,N,-,-1,-1
RECMUS.txt,24054,25446,1392,10,N,N,-,-1,-1
RECMUS.txt,24159,25589,1430,10,N,N,-,-1,-1
RECMUS.txt,24329,25822,1493,10,N,N,-,-1,-1
RECMUS.txt,24416,25988,1572,10,N,N,-,-1,-1
RECMUS.txt,24619,26083,1464,10,N,N,-,-1,-1
RECMUS.txt,24697,26096,1399,10,N,N,-,-1,-1
RECMUS.txt,24797,26163,1366,10,N,N,-,-1,-1
RECMUS.txt,24901,26303,1402,10,N,N,-,-1,-1
RECMUS.txt,24992,26403,1411,10,N,N,-,-1,-1
RECMUS.txt,25099,26647,1548,10,N,N,-,-1,-1
RECMUS.txt,25447,26796,1349,10,N,N,-,-1,-1
RECMUS.txt,25591,26860,1269,10,N,N,-,-1,-1
RECMUS.txt,25823,26872,1049,10,N,N,-,-1,-1
RECMUS.txt,25990,26953,963,10,N,N,-,-1,-1
RECMUS.txt,26086,27044,958,10,N,N,-,-1,-1
RECMUS.txt,26096,27238,1142,10,N,N,-,-1,-1
RECMUS.txt,26164,27280,1116,10,N,N,-,-1,-1
RECMUS.txt,26304,27400,1096,10,N,N,-,-1,-1
RECMUS.txt,26404,27565,1161,10,N,N,-,-1,-1
RECMUS.txt,26650,27647,997,10,N,N,-,-1,-1
RECMUS.txt,26797,27690,893,10,N,N,-,-1,-1
RECMUS.txt,26861,27754,893,10,N,N,-,-1,-1
RECMUS.txt,26874,27921,1047,10,N,N,-,-1,-1
RECMUS.txt,26954,28045,1091,10,Y,N,-,-1,-1
RECMUS.txt,27045,28153,1108,10,N,N,-,-1,-1
RECMUS.txt,27239,28260,1021,10,N,N,-,-1,-1
RECMUS.txt,27282,28338,1056,10,N,N,-,-1,-1
RECMUS.txt,27402,28476,1074,10,N,N,-,-1,-1
RECMUS.txt,27566,28513,947,10,N,N,-,-1,-1
RECMUS.txt,27648,28583,935,10,N,N,-,-1,-1
RECMUS.txt,27692,29127,1435,10,Y,N,-,-1,-1
RECMUS.txt,27755,29473,1718,10,N,N,-,-1,-1
RECMUS.txt,27923,29602,1679,10,N,N,-,-1,-1
RECMUS.txt,28046,29724,1678,10,N,N,-,-1,-1
RECMUS.txt,28154,29813,1659,10,N,N,-,-1,-1
RECMUS.txt,28262,29884,1622,10,N,N,-,-1,-1
RECMUS.txt,28339,29966,1627,10,N,N,-,-1,-1
RECMUS.txt,28481,30185,1704,10,N,N,-,-1,-1
RECMUS.txt,28514,30289,1775,10,N,N,-,-1,-1
RECMUS.txt,28584,30379,1795,10,N,N,-,-1,-1
RECMUS.txt,29128,30466,1338,10,Y,N,-,-1,-1
RECMUS.txt,29474,30587,1113,10,Y,N,-,-1,-1
RECMUS.txt,29604,30707,1103,10,Y,N,-,-1,-1
RECMUS.txt,29725,30754,1029,10,Y,N,-,-1,-1
RECMUS.txt,29814,30811,997,10,N,N,-,-1,-1
RECMUS.txt,29885,30922,1037,10,N,N,-,-1,-1
RECMUS.txt,29967,30959,992,10,N,N,-,-1,-1
RECMUS.txt,30186,31117,931,10,N,N,-,-1,-1
RECMUS.txt,30290,31321,1031,10,N,N,-,-1,-1
RECMUS.txt,30380,31463,1083,10,N,N,-,-1,-1
RECMUS.txt,30467,31673,1206,10,N,N,-,-1,-1
RECMUS.txt,30588,31879,1291,10,N,N,-,-1,-1
RECMUS.txt,30708,32168,1460,10,N,N,-,-1,-1
RECMUS.txt,30755,32302,1547,10,N,N,-,-1,-1
RECMUS.txt,30812,32338,1526,10,N,N,-,-1,-1
RECMUS.txt,30925,32364,1439,10,N,N,-,-1,-1
RECMUS.txt,30960,32431,1471,10,N,N,-,-1,-1
RECMUS.txt,31120,32541,1421,10,N,N,-,-1,-1
RECMUS.txt,31322,32762,1440,10,N,N,-,-1,-1
RECMUS.txt,31465,32883,1418,10,N,N,-,-1,-1
RECMUS.txt,31674,33065,1391,10,N,N,-,-1,-1
RECMUS.txt,31881,33292,1411,10,N,N,-,-1,-1
RECMUS.txt,32170,33314,1144,10,N,N,-,-1,-1
RECMUS.txt,32305,33322,1017,10,N,N,-,-1,-1
RECMUS.txt,32339,33383,1044,10,N,N,-,-1,-1
RECMUS.txt,32366,33440,1074,10,N,N,-,-1,-1
RECMUS.txt,32432,33576,1144,10,N,N,-,-1,-1
RECMUS.txt,32543,33747,1204,10,Y,N,-,-1,-1
RECMUS.txt,32763,33818,1055,10,N,N,-,-1,-1
RECMUS.txt,32885,33831,946,10,N,N,-,-1,-1
RECMUS.txt,33066,34255,1189,10,N,N,-,-1,-1
RECMUS.txt,33293,34356,1063,10,N,N,-,-1,-1
RECMUS.txt,33316,34548,1232,10,Y,N,-,-1,-1
RECMUS.txt,33323,34652,1329,10,Y,N,-,-1,-1
RECMUS.txt,33384,34988,1604,10,Y,N,-,-1,-1
RECMUS.txt,33441,35223,1782,10,Y,N,-,-1,-1
RECMUS.txt,33577,35236,1659,10,Y,N,-,-1,-1
RECMUS.txt,33748,35313,1565,10,Y,N,-,-1,-1
RECMUS.txt,33820,35405,1585,10,Y,N,-,-1,-1
RECMUS.txt,33834,35481,1647,10,Y,N,-,-1,-1
RECMUS.txt,34258,35581,1323,10,Y,N,-,-1,-1
RECMUS.txt,34357,35730,1373,10,Y,N,-,-1,-1
RECMUS.txt,34551,35836,1285,10,N,N,-,-1,-1
RECMUS.txt,34653,36049,1396,10,N,N,-,-1,-1
RECMUS.txt,34991,36244,1253,10,N,N,-,-1,-1
RECMUS.txt,35226,36526,1300,10,N,N,-,-1,-1
RECMUS.txt,35237,36934,1697,10,Y,N,-,-1,-1
RECMUS.txt,35314,37058,1744,10,N,N,-,-1,-1
RECMUS.txt,35406,37182,1776,10,N,N,-,-1,-1
RECMUS.txt,35482,37343,1861,10,Y,N,-,-1,-1
RECMUS.txt,35583,37467,1884,10,Y,N,-,-1,-1
RECMUS.txt,35731,37661,1930,10,Y,N,-,-1,-1
RECMUS.txt,35839,37718,1879,10,Y,N,-,-1,-1
RECMUS.txt,36050,37752,1702,10,Y,N,-,-1,-1
RECMUS.txt,36245,37971,1726,10,Y,N,-,-1,-1
RECMUS.txt,36527,38121,1594,10,N,N,-,-1,-1
RECMUS.txt,36935,38232,1297,10,N,N,-,-1,-1
RECMUS.txt,37059,38370,1311,10,N,N,-,-1,-1
RECMUS.txt,37183,38437,1254,10,N,N,-,-1,-1
RECMUS.txt,37344,38542,1198,10,N,N,-,-1,-1
RECMUS.txt,37468,38573,1105,10,N,N,-,-1,-1
RECMUS.txt,37662,38895,1233,10,N,N,-,-1,-1
RECMUS.txt,37719,39214,1495,10,N,N,-,-1,-1
RECMUS.txt,37753,39339,1586,10,N,N,-,-1,-1
RECMUS.txt,37974,39385,1411,10,N,N,-,-1,-1
RECMUS.txt,38124,39465,1341,10,N,N,-,-1,-1
RECMUS.txt,38233,39798,1565,10,N,N,-,-1,-1
RECMUS.txt,38373,39954,1581,10,N,N,-,-1,-1
RECMUS.txt,38438,40049,1611,10,N,N,-,-1,-1
RECMUS.txt,38544,40165,1621,10,N,N,-,-1,-1
RECMUS.txt,38576,40197,1621,10,N,N,-,-1,-1
RECMUS.txt,38898,40331,1433,10,N,N,-,-1,-1
RECMUS.txt,39215,40352,1137,10,N,N,-,-1,-1
RECMUS.txt,39339,40485,1146,10,N,N,-,-1,-1
RECMUS.txt,39386,40585,1199,10,N,N,-,-1,-1
RECMUS.txt,39468,40619,1151,10,N,N,-,-1,-1
RECMUS.txt,39799,40879,1080,10,N,N,-,-1,-1
RECMUS.txt,39957,41077,1120,10,N,N,-,-1,-1
RECMUS.txt,40050,41140,1090,10,N,N,-,-1,-1
RECMUS.txt,40166,41198,1032,10,N,N,-,-1,-1
RECMUS.txt,40200,41393,1193,10,N,N,-,-1,-1
RECMUS.txt,40332,41538,1206,10,N,N,-,-1,-1
RECMUS.txt,40353,41647,1294,10,N,N,-,-1,-1
RECMUS.txt,40486,41736,1250,10,N,N,-,-1,-1
RECMUS.txt,40586,41994,1408,10,N,N,-,-1,-1
RECMUS.txt,40621,41995,1374,10,N,N,-,-1,-1
RECMUS.txt,40879,42146,1267,10,N,N,-,-1,-1
RECMUS.txt,41077,42170,1093,10,N,N,-,-1,-1
RECMUS.txt,41141,42267,1126,10,N,N,-,-1,-1
RECMUS.txt,41199,42449,1250,10,N,N,-,-1,-1
RECMUS.txt,41396,42653,1257,10,N,N,-,-1,-1
RECMUS.txt,41539,42664,1125,10,N,N,-,-1,-1
RECMUS.txt,41648,42830,1182,10,Y,N,-,-1,-1
RECMUS.txt,41739,42916,1177,10,N,N,-,-1,-1
RECMUS.txt,41994,42979,985,10,N,N,-,-1,-1
RECMUS.txt,41996,43126,1130,10,Y,N,-,-1,-1
RECMUS.txt,42148,43232,1084,10,N,N,-,-1,-1
RECMUS.txt,42171,43286,1115,10,N,N,-,-1,-1
RECMUS.txt,42268,43466,1198,10,N,N,-,-1,-1
RECMUS.txt,42452,43529,1077,10,N,N,-,-1,-1
RECMUS.txt,42656,43668,1012,10,N,N,-,-1,-1
RECMUS.txt,42665,43807,1142,10,N,N,-,-1,-1
RECMUS.txt,42832,43912,1080,10,N,N,-,-1,-1
RECMUS.txt,42917,44000,1083,10,N,N,-,-1,-1
RECMUS.txt,42982,44017,1035,10,N,N,-,-1,-1
RECMUS.txt,43127,44028,901,10,N,N,-,-1,-1
RECMUS.txt,43233,44192,959,10,N,N,-,-1,-1
RECMUS.txt,43287,44194,907,10,N,N,-,-1,-1
RECMUS.txt,43469,44300,831,10,N,N,-,-1,-1
RECMUS.txt,43530,44537,1007,10,N,N,-,-1,-1
RECMUS.txt,43669,44965,1296,10,Y,N,-,-1,-1
RECMUS.txt,43808,44991,1183,10,Y,N,-,-1,-1
RECMUS.txt,43913,45223,1310,10,Y,N,-,-1,-1
RECMUS.txt,44001,45391,1390,10,Y,N,-,-1,-1
RECMUS.txt,44018,45510,1492,10,Y,N,-,-1,-1
RECMUS.txt,44029,45661,1632,10,Y,N,-,-1,-1
RECMUS.txt,44193,45773,1580,10,Y,N,-,-1,-1
RECMUS.txt,44197,45837,1640,10,Y,N,-,-1,-1
RECMUS.txt,44301,45937,1636,10,Y,N,-,-1,-1
RECMUS.txt,44538,45994,1456,10,Y,N,-,-1,-1
RECMUS.txt,44970,46132,1162,10,N,N,-,-1,-1
RECMUS.txt,44996,46180,1184,10,N,N,-,-1,-1
RECMUS.txt,45224,46506,1282,10,N,N,-,-1,-1
RECMUS.txt,45392,46536,1144,10,N,N,-,-1,-1
RECMUS.txt,45513,46585,1072,10,N,N,-,-1,-1
RECMUS.txt,45662,46689,1027,10,N,N,-,-1,-1
RECMUS.txt,45774,46938,1164,10,N,N,-,-1,-1
RECMUS.txt,45838,47402,1564,10,N,N,-,-1,-1
RECMUS.txt,45938,47464,1526,10,N,N,-,-1,-1
RECMUS.txt,45995,47486,1491,10,N,N,-,-1,-1
RECMUS.txt,46135,47506,1371,10,N,N,-,-1,-1
RECMUS.txt,46181,47570,1389,10,N,N,-,-1,-1
RECMUS.txt,46507,47689,1182,10,N,N,-,-1,-1
RECMUS.txt,46539,47826,1287,10,N,N,-,-1,-1
RECMUS.txt,46586,48034,1448,10,N,N,-,-1,-1
RECMUS.txt,46690,48232,1542,10,N,N,-,-1,-1
RECMUS.txt,46941,48431,1490,10,N,N,-,-1,-1
RECMUS.txt,47407,48480,1073,10,N,N,-,-1,-1
RECMUS.txt,47466,48708,1242,10,N,N,-,-1,-1
RECMUS.txt,47487,48858,1371,10,N,N,-,-1,-1
RECMUS.txt,47507,48927,1420,10,N,N,-,-1,-1
RECMUS.txt,47571,49007,1436,10,N,N,-,-1,-1
RECMUS.txt,47690,49396,1706,10,N,N,-,-1,-1
RECMUS.txt,47829,49513,1684,10,N,N,-,-1,-1
RECMUS.txt,48035,49667,1632,10,N,N,-,-1,-1
RECMUS.txt,48233,49811,1578,10,N,N,-,-1,-1
RECMUS.txt,48432,49900,1468,10,N,N,-,-1,-1
RECMUS.txt,48482,49940,1458,10,N,N,-,-1,-1
RECMUS.txt,48709,50146,1437,10,N,N,-,-1,-1
RECMUS.txt,48859,50222,1363,10,N,N,-,-1,-1
RECMUS.txt,48928,50458,1530,10,N,N,-,-1,-1
RECMUS.txt,49008,50576,1568,10,N,N,-,-1,-1
RECMUS.txt,49397,50659,1262,10,N,N,-,-1,-1
RECMUS.txt,49514,50879,1365,10,N,N,-,-1,-1
RECMUS.txt,49670,51230,1560,10,N,N,-,-1,-1
RECMUS.txt,49816,51305,1489,10,N,N,-,-1,-1
RECMUS.txt,49901,51401,1500,10,N,N,-,-1,-1
RECMUS.txt,49942,51571,1629,10,N,N,-,-1,-1
RECMUS.txt,50147,51841,1694,10,N,N,-,-1,-1
RECMUS.txt,50223,52016,1793,10,N,N,-,-1,-1
RECMUS.txt,50459,52171,1712,10,N,N,-,-1,-1
RECMUS.txt,50577,52248,1671,10,N,N,-,-1,-1
RECMUS.txt,50662,52277,1615,10,N,N,-,-1,-1
RECMUS.txt,50880,52431,1551,10,N,N,-,-1,-1
RECMUS.txt,51231,52525,1294,10,N,N,-,-1,-1
RECMUS.txt,51306,52537,1231,10,N,N,-,-1,-1
RECMUS.txt,51402,52664,1262,10,N,N,-,-1,-1
RECMUS.txt,51572,52819,1247,10,N,N,-,-1,-1
RECMUS.txt,51842,52923,1081,10,N,N,-,-1,-1
RECMUS.txt,52019,53000,981,10,N,N,-,-1,-1
RECMUS.txt,52174,53127,953,10,N,N,-,-1,-1
RECMUS.txt,52249,53283,1034,10,N,N,-,-1,-1
RECMUS.txt,52278,53394,1116,10,N,N,-,-1,-1
RECMUS.txt,52432,53587,1155,10,N,N,-,-1,-1
RECMUS.txt,52526,53700,1174,10,N,N,-,-1,-1
RECMUS.txt,52539,53726,1187,10,N,N,-,-1,-1
RECMUS.txt,52666,53817,1151,10,N,N,-,-1,-1
RECMUS.txt,52820,54067,1247,10,N,N,-,-1,-1
RECMUS.txt,52924,54247,1323,10,Y,N,-,-1,-1
RECMUS.txt,53001,54528,1527,10,N,N,-,-1,-1
RECMUS.txt,53128,54594,1466,10,N,N,-,-1,-1
RECMUS.txt,53284,54687,1403,10,N,N,-,-1,-1
RECMUS.txt,53395,55028,1633,10,N,N,-,-1,-1
RECMUS.txt,53588,55243,1655,10,N,N,-,-1,-1
RECMUS.txt,53701,55293,1592,10,N,N,-,-1,-1
RECMUS.txt,53727,55340,1613,10,N,N,-,-1,-1
RECMUS.txt,53818,55655,1837,10,N,N,-,-1,-1
RECMUS.txt,54069,55767,1698,10,N,N,-,-1,-1
RECMUS.txt,54248,56058,1810,10,N,N,-,-1,-1
RECMUS.txt,54531,56297,1766,10,N,N,-,-1,-1
RECMUS.txt,54595,56469,1874,10,N,N,-,-1,-1
RECMUS.txt,54688,56607,1919,10,N,N,-,-1,-1
RECMUS.txt,55029,56782,1753,10,N,N,-,-1,-1
RECMUS.txt,55244,56927,1683,10,N,N,-,-1,-1
RECMUS.txt,55296,56944,1648,10,N,N,-,-1,-1
RECMUS.txt,55341,56957,1616,10,N,N,-,-1,-1
RECMUS.txt,55656,57394,1738,10,N,N,-,-1,-1
RECMUS.txt,55770,57523,1753,10,N,N,-,-1,-1
RECMUS.txt,56059,57818,1759,10,N,N,-,-1,-1
RECMUS.txt,56299,57846,1547,10,N,N,-,-1,-1
RECMUS.txt,56470,57979,1509,10,N,N,-,-1,-1
RECMUS.txt,56608,58160,1552,10,N,N,-,-1,-1
RECMUS.txt,56783,58198,1415,10,N,N,-,-1,-1
RECMUS.txt,56932,58284,1352,10,N,N,-,-1,-1
RECMUS.txt,56946,58409,1463,10,N,N,-,-1,-1
RECMUS.txt,56960,58431,1471,10,N,N,-,-1,-1
RECMUS.txt,57397,58696,1299,10,N,N,-,-1,-1
RECMUS.txt,57524,58778,1254,10,N,N,-,-1,-1
RECMUS.txt,57819,58826,1007,10,N,N,-,-1,-1
RECMUS.txt,57847,58884,1037,10,N,N,-,-1,-1
RECMUS.txt,57980,58925,945,10,N,N,-,-1,-1
RECMUS.txt,58161,59004,843,10,N,N,-,-1,-1
RECMUS.txt,58199,59485,1286,10,Y,N,-,-1,-1
RECMUS.txt,58285,59517,1232,10,Y,N,-,-1,-1
RECMUS.txt,58410,59636,1226,10,N,N,-,-1,-1
RECMUS.txt,58432,59741,1309,10,N,N,-,-1,-1
RECMUS.txt,58697,60004,1307,10,Y,N,-,-1,-1
RECMUS.txt,58779,60168,1389,10,Y,N,-,-1,-1
RECMUS.txt,58827,60223,1396,10,Y,N,-,-1,-1
RECMUS.txt,58885,60254,1369,10,Y,N,-,-1,-1
RECMUS.txt,58930,60387,1457,10,Y,N,-,-1,-1
RECMUS.txt,59005,60399,1394,10,N,N,-,-1,-1
RECMUS.txt,59486,60413,927,10,N,N,-,-1,-1
RECMUS.txt,59519,60486,967,10,N,N,-,-1,-1
RECMUS.txt,59638,60495,857,10,N,N,-,-1,-1
RECMUS.txt,59742,60497,755,10,N,N,-,-1,-1
RECMUS.txt,60005,60529,524,10,N,N,-,-1,-1
RECMUS.txt,60171,60540,369,10,N,N,-,-1,-1
RECMUS.txt,60225,60553,328,10,N,N,-,-1,-1
RECMUS.txt,60255,60555,300,10,N,N,-,-1,-1
RECMUS.txt,60390,60571,181,10,N,N,-,-1,-1
RECMUS.txt,60400,60590,190,10,N,N,-,-1,-1
RECMUS.txt,60416,60615,199,10,N,N,-,-1,-1
RECMUS.txt,60489,60644,155,10,N,N,-,-1,-1
RECMUS.txt,60496,60673,177,10,N,N,-,-1,-1
RECMUS.txt,60498,60683,185,10,N,N,-,-1,-1
RECMUS.txt,60532,60725,193,10,N,N,-,-1,-1
RECMUS.txt,60543,60760,217,10,N,N,-,-1,-1
RECMUS.txt,60554,60814,260,10,N,N,-,-1,-1
RECMUS.txt,60556,61027,471,10,N,N,-,-1,-1
RECMUS.txt,60574,61294,720,10,N,N,-,-1,-1
RECMUS.txt,60593,61351,758,10,Y,N,-,-1,-1
RECMUS.txt,60618,61392,774,10,Y,N,-,-1,-1
RECMUS.txt,60647,61464,817,10,Y,N,-,-1,-1
RECMUS.txt,60676,61644,968,10,Y,N,-,-1,-1
RECMUS.txt,60684,61860,1176,10,Y,N,-,-1,-1
RECMUS.txt,60730,61977,1247,10,Y,N,-,-1,-1
RECMUS.txt,60763,62229,1466,10,Y,N,-,-1,-1
RECMUS.txt,60816,62361,1545,10,Y,N,-,-1,-1
RECMUS.txt,61028,62511,1483,10,Y,N,-,-1,-1
RECMUS.txt,61297,62561,1264,10,Y,N,-,-1,-1
RECMUS.txt,61353,62701,1348,10,Y,N,-,-1,-1
RECMUS.txt,61393,62785,1392,10,Y,N,-,-1,-1
RECMUS.txt,61465,62881,1416,10,Y,N,-,-1,-1
RECMUS.txt,61645,63110,1465,10,Y,N,-,-1,-1
RECMUS.txt,61861,63159,1298,10,N,N,-,-1,-1
RECMUS.txt,61978,63235,1257,10,N,N,-,-1,-1
RECMUS.txt,62230,63381,1151,10,N,N,-,-1,-1
RECMUS.txt,62363,63412,1049,10,N,N,-,-1,-1
RECMUS.txt,62512,63637,1125,10,N,N,-,-1,-1
RECMUS.txt,62562,63697,1135,10,N,N,-,-1,-1
RECMUS.txt,62702,63944,1242,10,N,N,-,-1,-1
RECMUS.txt,62786,64113,1327,10,N,N,-,-1,-1
RECMUS.txt,62882,64212,1330,10,N,N,-,-1,-1
RECMUS.txt,63111,64329,1218,10,N,N,-,-1,-1
RECMUS.txt,63160,64547,1387,10,N,N,-,-1,-1
RECMUS.txt,63236,64611,1375,10,N,N,-,-1,-1
RECMUS.txt,63382,64769,1387,10,N,N,-,-1,-1
RECMUS.txt,63413,65015,1602,10,N,N,-,-1,-1
RECMUS.txt,63638,65234,1596,10,N,N,-,-1,-1
RECMUS.txt,63700,65354,1654,10,N,N,-,-1,-1
RECMUS.txt,63945,65451,1506,10,N,N,-,-1,-1
RECMUS.txt,64116,65648,1532,10,N,N,-,-1,-1
RECMUS.txt,64215,65731,1516,10,N,N,-,-1,-1
RECMUS.txt,64331,66081,1750,10,N,N,-,-1,-1
RECMUS.txt,64548,66204,1656,10,Y,N,-,-1,-1
RECMUS.txt,64614,66324,1710,10,Y,N,-,-1,-1
RECMUS.txt,64770,66394,1624,10,Y,N,-,-1,-1
RECMUS.txt,65016,66783,1767,10,Y,N,-,-1,-1
RECMUS.txt,65237,66936,1699,10,Y,N,-,-1,-1
RECMUS.txt,65356,67100,1744,10,Y,N,-,-1,-1
RECMUS.txt,65454,67364,1910,10,Y,Y,1448325046337,230539,231128
RECMUS.txt,65649,67443,1794,10,Y,Y,1448325046337,230539,231128
RECMUS.txt,65732,67558,1826,10,Y,Y,1448325046337,230539,231128
RECMUS.txt,66082,67633,1551,10,Y,Y,1448325046337,230539,231128
RECMUS.txt,66205,67807,1602,10,Y,Y,1448325046337,230539,231128
RECMUS.txt,66325,67889,1564,10,N,Y,1448325046337,230539,231128
RECMUS.txt,66395,67921,1526,10,N,Y,1448325046337,230539,231128
RECMUS.txt,66786,67950,1164,10,N,Y,1448325046337,230539,231128
RECMUS.txt,66937,68140,1203,10,N,Y,1448325046337,230539,231128
RECMUS.txt,67101,68204,1103,10,N,Y,1448325046337,230539,231128
RECMUS.txt,67365,68302,937,10,N,Y,1448322979449,227304,227638
RECMUS.txt,67444,68431,987,10,N,Y,1448322979449,227304,227638
RECMUS.txt,67559,68580,1021,10,N,Y,1448322979449,227304,227638
RECMUS.txt,67636,68803,1167,10,N,Y,1448322979449,227304,227638
RECMUS.txt,67810,69532,1722,10,N,N,-,-1,-1
RECMUS.txt,67894,69806,1912,10,N,N,-,-1,-1
RECMUS.txt,67922,70151,2229,10,Y,N,-,-1,-1
RECMUS.txt,67951,70255,2304,10,Y,N,-,-1,-1
RECMUS.txt,68141,70402,2261,10,Y,N,-,-1,-1
RECMUS.txt,68205,70420,2215,10,Y,N,-,-1,-1
RECMUS.txt,68303,70548,2245,10,Y,N,-,-1,-1
RECMUS.txt,68432,70690,2258,10,N,N,-,-1,-1
RECMUS.txt,68581,70928,2347,10,Y,N,-,-1,-1
RECMUS.txt,68804,71077,2273,10,Y,N,-,-1,-1
RECMUS.txt,69533,71236,1703,10,Y,N,-,-1,-1
RECMUS.txt,69807,71344,1537,10,Y,N,-,-1,-1
RECMUS.txt,70152,71451,1299,10,N,N,-,-1,-1
RECMUS.txt,70256,71623,1367,10,N,N,-,-1,-1
RECMUS.txt,70407,71851,1444,10,N,N,-,-1,-1
RECMUS.txt,70421,71988,1567,10,N,N,-,-1,-1
RECMUS.txt,70551,72098,1547,10,N,N,-,-1,-1
RECMUS.txt,70691,72180,1489,10,N,N,-,-1,-1
RECMUS.txt,70929,72353,1424,10,N,N,-,-1,-1
RECMUS.txt,71080,72452,1372,10,N,Y,1448278147591,54631,55869
RECMUS.txt,71237,72559,1322,10,N,Y,1448278147591,54631,55869
RECMUS.txt,71345,72685,1340,10,N,Y,1448278147591,54631,55869
RECMUS.txt,71452,72793,1341,10,N,Y,1448278147591,54631,55869
RECMUS.txt,71624,72856,1232,10,N,Y,1448278147591,54631,55869
RECMUS.txt,71854,72944,1090,10,N,Y,1448278147591,54631,55869
RECMUS.txt,71989,72960,971,10,N,Y,1448278147591,54631,55869
RECMUS.txt,72101,72968,867,10,N,Y,1448278147591,54631,55869
RECMUS.txt,72181,73413,1232,10,N,Y,1448278147591,54631,55869
RECMUS.txt,72354,73593,1239,10,N,Y,1448278147591,54631,55869
RECMUS.txt,72453,73711,1258,10,N,Y,1448278147591,54631,55869
RECMUS.txt,72561,73858,1297,10,N,Y,1448278147591,54631,55869
RECMUS.txt,72686,73911,1225,10,N,Y,1448278147591,54631,55869
RECMUS.txt,72794,74036,1242,10,N,N,-,-1,-1
RECMUS.txt,72857,74193,1336,10,N,N,-,-1,-1
RECMUS.txt,72949,74429,1480,10,N,N,-,-1,-1
RECMUS.txt,72962,74640,1678,10,N,N,-,-1,-1
RECMUS.txt,72971,74697,1726,10,N,N,-,-1,-1
RECMUS.txt,73416,74796,1380,10,N,N,-,-1,-1
RECMUS.txt,73594,74882,1288,10,N,N,-,-1,-1
RECMUS.txt,73712,74906,1194,10,N,N,-,-1,-1
RECMUS.txt,73861,75040,1179,10,N,N,-,-1,-1
RECMUS.txt,73911,75191,1280,10,N,Y,1437028092146,121457,123204
RECMUS.txt,74038,75328,1290,10,N,Y,1437028092146,121457,123204
RECMUS.txt,74194,75358,1164,10,N,Y,1437028092146,121457,123204
RECMUS.txt,74430,75418,988,10,N,Y,1437028092146,121457,123204
RECMUS.txt,74641,75461,820,10,N,Y,1437028092146,121457,123204
RECMUS.txt,74698,75806,1108,10,N,Y,1437028092146,121457,123204
RECMUS.txt,74797,75907,1110,10,N,Y,1437028092146,121457,123204
RECMUS.txt,74887,76119,1232,10,N,Y,1437028092146,121457,123204
RECMUS.txt,74907,76303,1396,10,N,Y,1437028092146,121457,123204
RECMUS.txt,75041,76596,1555,10,N,Y,1437028092146,121457,123204
RECMUS.txt,75193,76696,1503,10,N,N,-,-1,-1
RECMUS.txt,75329,76771,1442,10,N,N,-,-1,-1
RECMUS.txt,75359,77141,1782,10,N,N,-,-1,-1
RECMUS.txt,75418,77259,1841,10,N,N,-,-1,-1
RECMUS.txt,75464,77415,1951,10,N,N,-,-1,-1
RECMUS.txt,75807,77506,1699,10,N,N,-,-1,-1
RECMUS.txt,75908,77628,1720,10,N,N,-,-1,-1
RECMUS.txt,76120,77683,1563,10,N,N,-,-1,-1
RECMUS.txt,76306,77769,1463,10,N,N,-,-1,-1
RECMUS.txt,76597,77882,1285,10,N,N,-,-1,-1
RECMUS.txt,76697,77964,1267,10,N,N,-,-1,-1
RECMUS.txt,76774,78395,1621,10,N,N,-,-1,-1
RECMUS.txt,77142,78490,1348,10,N,N,-,-1,-1
RECMUS.txt,77262,78808,1546,10,N,Y,1448279620157,70041,71486
RECMUS.txt,77416,78885,1469,10,N,Y,1448279620157,70041,71486
RECMUS.txt,77506,79057,1551,10,Y,Y,1448279620157,70041,71486
RECMUS.txt,77629,79176,1547,10,Y,Y,1448279620157,70041,71486
RECMUS.txt,77684,79302,1618,10,Y,Y,1448279620157,70041,71486
RECMUS.txt,77770,79345,1575,10,Y,Y,1448279620157,70041,71486
RECMUS.txt,77885,79445,1560,10,Y,Y,1448279620157,70041,71486
RECMUS.txt,77965,79487,1522,10,Y,Y,1448279620157,70041,71486
RECMUS.txt,78396,79579,1183,10,Y,Y,1448279620157,70041,71486
RECMUS.txt,78491,79794,1303,10,N,Y,1448279620157,70041,71486
RECMUS.txt,78809,80067,1258,10,N,Y,1448279620157,70041,71486
RECMUS.txt,78886,80178,1292,10,N,N,-,-1,-1
RECMUS.txt,79058,80215,1157,10,N,N,-,-1,-1
RECMUS.txt,79177,80578,1401,10,N,N,-,-1,-1
RECMUS.txt,79304,80765,1461,10,N,N,-,-1,-1
RECMUS.txt,79346,80879,1533,10,N,N,-,-1,-1
RECMUS.txt,79446,81018,1572,10,N,N,-,-1,-1
RECMUS.txt,79490,81164,1674,10,N,N,-,-1,-1
RECMUS.txt,79580,81333,1753,10,N,N,-,-1,-1
RECMUS.txt,79795,81553,1758,10,Y,N,-,-1,-1
RECMUS.txt,80068,81582,1514,10,N,N,-,-1,-1
RECMUS.txt,80179,81743,1564,10,Y,N,-,-1,-1
RECMUS.txt,80216,81883,1667,10,Y,N,-,-1,-1
RECMUS.txt,80581,82012,1431,10,N,N,-,-1,-1
RECMUS.txt,80766,82057,1291,10,N,N,-,-1,-1
RECMUS.txt,80881,82110,1229,10,N,N,-,-1,-1
RECMUS.txt,81019,82284,1265,10,N,N,-,-1,-1
RECMUS.txt,81165,82403,1238,10,N,N,-,-1,-1
RECMUS.txt,81334,82497,1163,10,N,N,-,-1,-1
RECMUS.txt,81554,82535,981,10,N,N,-,-1,-1
RECMUS.txt,81583,82629,1046,10,N,N,-,-1,-1
RECMUS.txt,81744,82672,928,10,N,N,-,-1,-1
RECMUS.txt,81884,82725,841,10,N,N,-,-1,-1
RECMUS.txt,82017,82780,763,10,N,N,-,-1,-1
RECMUS.txt,82058,82830,772,10,N,N,-,-1,-1
RECMUS.txt,82111,82961,850,10,N,N,-,-1,-1
RECMUS.txt,82285,83185,900,10,N,N,-,-1,-1
RECMUS.txt,82404,83355,951,10,N,N,-,-1,-1
RECMUS.txt,82498,83566,1068,10,N,N,-,-1,-1
RECMUS.txt,82537,83686,1149,10,N,N,-,-1,-1
RECMUS.txt,82630,83738,1108,10,N,N,-,-1,-1
RECMUS.txt,82673,83833,1160,10,N,N,-,-1,-1
RECMUS.txt,82726,83880,1154,10,N,N,-,-1,-1
RECMUS.txt,82781,84006,1225,10,N,N,-,-1,-1
RECMUS.txt,82832,84040,1208,10,N,N,-,-1,-1
RECMUS.txt,82961,84192,1231,10,N,N,-,-1,-1
RECMUS.txt,83186,84511,1325,10,N,N,-,-1,-1
RECMUS.txt,83356,84514,1158,10,N,N,-,-1,-1
RECMUS.txt,83567,84524,957,10,N,N,-,-1,-1
RECMUS.txt,83687,84649,962,10,N,N,-,-1,-1
RECMUS.txt,83739,84835,1096,10,N,N,-,-1,-1
RECMUS.txt,83834,84916,1082,10,N,N,-,-1,-1
RECMUS.txt,83881,85024,1143,10,N,N,-,-1,-1
RECMUS.txt,84007,85195,1188,10,N,N,-,-1,-1
RECMUS.txt,84041,85318,1277,10,N,N,-,-1,-1
RECMUS.txt,84194,85495,1301,10,N,N,-,-1,-1
RECMUS.txt,84512,85593,1081,10,N,N,-,-1,-1
RECMUS.txt,84517,85718,1201,10,N,N,-,-1,-1
RECMUS.txt,84525,85913,1388,10,N,N,-,-1,-1
RECMUS.txt,84650,86131,1481,10,N,N,-,-1,-1
RECMUS.txt,84836,86198,1362,10,N,N,-,-1,-1
RECMUS.txt,84919,86280,1361,10,N,N,-,-1,-1
RECMUS.txt,85025,86500,1475,10,N,N,-,-1,-1
RECMUS.txt,85196,86579,1383,10,N,N,-,-1,-1
RECMUS.txt,85319,86743,1424,10,N,N,-,-1,-1
RECMUS.txt,85496,86818,1322,10,Y,N,-,-1,-1
RECMUS.txt,85594,86948,1354,10,Y,N,-,-1,-1
RECMUS.txt,85719,87055,1336,10,Y,N,-,-1,-1
RECMUS.txt,85914,87229,1315,10,Y,N,-,-1,-1
RECMUS.txt,86132,87301,1169,10,Y,N,-,-1,-1
RECMUS.txt,86200,87376,1176,10,Y,N,-,-1,-1
RECMUS.txt,86281,87544,1263,10,Y,N,-,-1,-1
RECMUS.txt,86501,87606,1105,10,Y,N,-,-1,-1
RECMUS.txt,86580,87675,1095,10,Y,N,-,-1,-1
RECMUS.txt,86744,87741,997,10,N,N,-,-1,-1
RECMUS.txt,86819,87795,976,10,N,N,-,-1,-1
RECMUS.txt,86953,87854,901,10,N,N,-,-1,-1
RECMUS.txt,87056,87891,835,10,N,N,-,-1,-1
RECMUS.txt,87230,88072,842,10,N,N,-,-1,-1
RECMUS.txt,87302,88144,842,10,N,N,-,-1,-1
RECMUS.txt,87379,88212,833,10,N,N,-,-1,-1
RECMUS.txt,87545,88222,677,10,N,N,-,-1,-1
RECMUS.txt,87608,88321,713,10,N,N,-,-1,-1
RECMUS.txt,87676,88328,652,10,N,N,-,-1,-1
RECMUS.txt,87742,88499,757,10,N,N,-,-1,-1
RECMUS.txt,87797,88528,731,10,N,N,-,-1,-1
RECMUS.txt,87856,88552,696,10,N,N,-,-1,-1
RECMUS.txt,87892,88560,668,10,N,N,-,-1,-1
RECMUS.txt,88073,88652,579,10,N,N,-,-1,-1
RECMUS.txt,88146,88753,607,10,N,N,-,-1,-1
RECMUS.txt,88215,88893,678,10,N,N,-,-1,-1
RECMUS.txt,88223,89035,812,10,N,N,-,-1,-1
RECMUS.txt,88322,89078,756,10,N,N,-,-1,-1
RECMUS.txt,88329,89152,823,10,N,N,-,-1,-1
RECMUS.txt,88500,89166,666,10,N,N,-,-1,-1
RECMUS.txt,88529,89439,910,10,N,N,-,-1,-1
RECMUS.txt,88553,89726,1173,10,N,N,-,-1,-1
RECMUS.txt,88561,89947,1386,10,N,N,-,-1,-1
RECMUS.txt,88653,90042,1389,10,N,N,-,-1,-1
RECMUS.txt,88756,90125,1369,10,N,N,-,-1,-1
RECMUS.txt,88894,90164,1270,10,N,N,-,-1,-1
RECMUS.txt,89036,90175,1139,10,N,N,-,-1,-1
RECMUS.txt,89081,90225,1144,10,N,N,-,-1,-1
RECMUS.txt,89152,90283,1131,10,N,N,-,-1,-1
RECMUS.txt,89171,90444,1273,10,N,N,-,-1,-1
RECMUS.txt,89440,90458,1018,10,N,N,-,-1,-1
RECMUS.txt,89729,90512,783,10,N,N,-,-1,-1
RECMUS.txt,89948,90559,611,10,N,N,-,-1,-1
RECMUS.txt,90043,90855,812,10,N,N,-,-1,-1
RECMUS.txt,90126,90994,868,10,N,N,-,-1,-1
RECMUS.txt,90165,91056,891,10,N,N,-,-1,-1
RECMUS.txt,90176,91184,1008,10,N,N,-,-1,-1
RECMUS.txt,90226,91497,1271,10,N,N,-,-1,-1
RECMUS.txt,90284,91758,1474,10,N,N,-,-1,-1
RECMUS.txt,90445,91844,1399,10,N,N,-,-1,-1
RECMUS.txt,90459,91920,1461,10,N,N,-,-1,-1
RECMUS.txt,90513,92102,1589,10,N,N,-,-1,-1
RECMUS.txt,90560,92240,1680,10,N,N,-,-1,-1
RECMUS.txt,90856,92385,1529,10,N,N,-,-1,-1
RECMUS.txt,90995,92454,1459,10,N,N,-,-1,-1
RECMUS.txt,91059,92804,1745,10,N,N,-,-1,-1
RECMUS.txt,91185,92949,1764,10,N,N,-,-1,-1
RECMUS.txt,91500,93066,1566,10,N,N,-,-1,-1
RECMUS.txt,91759,93113,1354,10,N,N,-,-1,-1
RECMUS.txt,91845,93452,1607,10,N,N,-,-1,-1
RECMUS.txt,91923,93650,1727,10,Y,N,-,-1,-1
RECMUS.txt,92103,93906,1803,10,Y,N,-,-1,-1
RECMUS.txt,92241,94097,1856,10,N,N,-,-1,-1
RECMUS.txt,92386,94312,1926,10,N,N,-,-1,-1
RECMUS.txt,92457,94466,2009,10,N,N,-,-1,-1
RECMUS.txt,92805,94602,1797,10,N,N,-,-1,-1
RECMUS.txt,92950,94979,2029,10,N,N,-,-1,-1
RECMUS.txt,93067,95157,2090,10,Y,N,-,-1,-1
RECMUS.txt,93114,95243,2129,10,Y,N,-,-1,-1
RECMUS.txt,93453,95420,1967,10,Y,N,-,-1,-1
RECMUS.txt,93651,95532,1881,10,Y,N,-,-1,-1
RECMUS.txt,93907,95894,1987,10,Y,N,-,-1,-1
RECMUS.txt,94097,96007,1910,10,Y,N,-,-1,-1
RECMUS.txt,94313,96089,1776,10,Y,N,-,-1,-1
RECMUS.txt,94467,96237,1770,10,Y,N,-,-1,-1
RECMUS.txt,94603,96313,1710,10,Y,N,-,-1,-1
RECMUS.txt,94980,96382,1402,10,N,N,-,-1,-1
RECMUS.txt,95158,96579,1421,10,N,N,-,-1,-1
RECMUS.txt,95244,96622,1378,10,N,N,-,-1,-1
RECMUS.txt,95421,96641,1220,10,N,N,-,-1,-1
RECMUS.txt,95533,96796,1263,10,N,N,-,-1,-1
RECMUS.txt,95897,97060,1163,10,N,N,-,-1,-1
RECMUS.txt,96008,97171,1163,10,N,N,-,-1,-1
RECMUS.txt,96090,97282,1192,10,N,N,-,-1,-1
RECMUS.txt,96240,97330,1090,10,N,N,-,-1,-1
RECMUS.txt,96314,97479,1165,10,N,N,-,-1,-1
RECMUS.txt,96383,97742,1359,10,N,N,-,-1,-1
RECMUS.txt,96580,97875,1295,10,N,N,-,-1,-1
RECMUS.txt,96623,98034,1411,10,N,N,-,-1,-1
RECMUS.txt,96642,98258,1616,10,N,N,-,-1,-1
RECMUS.txt,96799,98565,1766,10,N,N,-,-1,-1
RECMUS.txt,97061,98656,1595,10,N,N,-,-1,-1
RECMUS.txt,97172,98755,1583,10,N,N,-,-1,-1
RECMUS.txt,97283,98957,1674,10,Y,N,-,-1,-1
RECMUS.txt,97332,99174,1842,10,Y,N,-,-1,-1
RECMUS.txt,97480,99319,1839,10,Y,N,-,-1,-1
RECMUS.txt,97743,99422,1679,10,Y,N,-,-1,-1
RECMUS.txt,97876,99516,1640,10,Y,N,-,-1,-1
RECMUS.txt,98037,99605,1568,10,Y,N,-,-1,-1
RECMUS.txt,98259,99797,1538,10,Y,N,-,-1,-1
RECMUS.txt,98566,99852,1286,10,Y,N,-,-1,-1
RECMUS.txt,98661,100063,1402,10,Y,N,-,-1,-1
RECMUS.txt,98756,100179,1423,10,Y,N,-,-1,-1
RECMUS.txt,98959,100279,1320,10,N,N,-,-1,-1
RECMUS.txt,99177,100289,1112,10,N,N,-,-1,-1
RECMUS.txt,99320,100440,1120,10,N,N,-,-1,-1
RECMUS.txt,99423,100559,1136,10,N,N,-,-1,-1
RECMUS.txt,99517,100574,1057,10,N,N,-,-1,-1
RECMUS.txt,99606,100653,1047,10,N,N,-,-1,-1
RECMUS.txt,99798,100756,958,10,N,N,-,-1,-1
RECMUS.txt,99853,100839,986,10,Y,N,-,-1,-1
RECMUS.txt,100066,100852,786,10,N,N,-,-1,-1
RECMUS.txt,100180,100930,750,10,Y,N,-,-1,-1
RECMUS.txt,100280,101031,751,10,Y,N,-,-1,-1
RECMUS.txt,100290,101119,829,10,Y,N,-,-1,-1
RECMUS.txt,100441,101250,809,10,Y,N,-,-1,-1
RECMUS.txt,100562,101420,858,10,Y,N,-,-1,-1
RECMUS.txt,100575,101430,855,10,Y,N,-,-1,-1
RECMUS.txt,100654,101557,903,10,N,N,-,-1,-1
RECMUS.txt,100757,101643,886,10,N,N,-,-1,-1
RECMUS.txt,100842,101714,872,10,N,N,-,-1,-1
RECMUS.txt,100853,101820,967,10,N,N,-,-1,-1
RECMUS.txt,100933,101931,998,10,Y,N,-,-1,-1
RECMUS.txt,101032,101944,912,10,Y,N,-,-1,-1
RECMUS.txt,101120,102029,909,10,Y,N,-,-1,-1
RECMUS.txt,101251,102042,791,10,N,N,-,-1,-1
RECMUS.txt,101421,102059,638,10,N,N,-,-1,-1
RECMUS.txt,101431,102114,683,10,N,N,-,-1,-1
RECMUS.txt,101558,102188,630,10,N,N,-,-1,-1
RECMUS.txt,101645,102354,709,10,N,N,-,-1,-1
RECMUS.txt,101715,102364,649,10,N,N,-,-1,-1
RECMUS.txt,101821,102463,642,10,N,N,-,-1,-1
RECMUS.txt,101934,102658,724,10,N,N,-,-1,-1
RECMUS.txt,101945,102709,764,10,N,Y,1448274783410,21836,25159
RECMUS.txt,102032,102789,757,10,N,Y,1448274783410,21836,25159
RECMUS.txt,102043,102848,805,10,N,Y,1448274783410,21836,25159
RECMUS.txt,102060,103050,990,10,N,Y,1448274783410,21836,25159
RECMUS.txt,102115,103199,1084,10,N,Y,1448274783410,21836,25159
RECMUS.txt,102189,103216,1027,10,N,Y,1448274783410,21836,25159
RECMUS.txt,102355,103290,935,10,N,Y,1448274783410,21836,25159
RECMUS.txt,102365,103338,973,10,N,Y,1448274783410,21836,25159
RECMUS.txt,102465,103352,887,10,N,Y,1448274783410,21836,25159
RECMUS.txt,102659,103432,773,10,N,Y,1448274783410,21836,25159
RECMUS.txt,102710,103503,793,10,N,Y,1448274783410,21836,25159
RECMUS.txt,102790,103773,983,10,N,N,-,-1,-1
RECMUS.txt,102849,103942,1093,10,N,N,-,-1,-1
RECMUS.txt,103051,104168,1117,10,N,N,-,-1,-1
RECMUS.txt,103200,104285,1085,10,N,N,-,-1,-1
RECMUS.txt,103217,104391,1174,10,N,N,-,-1,-1
RECMUS.txt,103291,104570,1279,10,N,N,-,-1,-1
RECMUS.txt,103341,104701,1360,10,N,N,-,-1,-1
RECMUS.txt,103353,104811,1458,10,N,N,-,-1,-1
RECMUS.txt,103433,104942,1509,10,N,N,-,-1,-1
RECMUS.txt,103506,104977,1471,10,N,N,-,-1,-1
RECMUS.txt,103774,105027,1253,10,N,N,-,-1,-1
RECMUS.txt,103943,105214,1271,10,N,N,-,-1,-1
RECMUS.txt,104169,105342,1173,10,N,N,-,-1,-1
RECMUS.txt,104286,105464,1178,10,N,N,-,-1,-1
RECMUS.txt,104392,105717,1325,10,N,N,-,-1,-1
RECMUS.txt,104571,105825,1254,10,N,N,-,-1,-1
RECMUS.txt,104702,105908,1206,10,N,N,-,-1,-1
RECMUS.txt,104814,105930,1116,10,N,N,-,-1,-1
RECMUS.txt,104943,105984,1041,10,N,N,-,-1,-1
RECMUS.txt,104979,106418,1439,10,N,N,-,-1,-1
RECMUS.txt,105028,106650,1622,10,N,N,-,-1,-1
RECMUS.txt,105215,106842,1627,10,N,N,-,-1,-1
RECMUS.txt,105343,107110,1767,10,N,N,-,-1,-1
RECMUS.txt,105465,107258,1793,10,N,N,-,-1,-1
RECMUS.txt,105718,107325,1607,10,N,N,-,-1,-1
RECMUS.txt,105825,107553,1728,10,N,N,-,-1,-1
RECMUS.txt,105913,107726,1813,10,N,N,-,-1,-1
RECMUS.txt,105933,107761,1828,10,N,N,-,-1,-1
RECMUS.txt,105985,107882,1897,10,N,N,-,-1,-1
RECMUS.txt,106419,108049,1630,10,N,N,-,-1,-1
RECMUS.txt,106651,108174,1523,10,N,N,-,-1,-1
RECMUS.txt,106843,108325,1482,10,N,N,-,-1,-1
RECMUS.txt,107111,108535,1424,10,N,N,-,-1,-1
RECMUS.txt,107261,108706,1445,10,N,N,-,-1,-1
RECMUS.txt,107326,108730,1404,10,N,N,-,-1,-1
RECMUS.txt,107556,108766,1210,10,N,N,-,-1,-1
RECMUS.txt,107731,108962,1231,10,N,N,-,-1,-1
RECMUS.txt,107764,109039,1275,10,N,N,-,-1,-1
RECMUS.txt,107883,109142,1259,10,N,N,-,-1,-1
RECMUS.txt,108050,109334,1284,10,N,N,-,-1,-1
RECMUS.txt,108175,109465,1290,10,N,N,-,-1,-1
RECMUS.txt,108326,109634,1308,10,N,N,-,-1,-1
RECMUS.txt,108536,109806,1270,10,N,N,-,-1,-1
RECMUS.txt,108707,109905,1198,10,N,N,-,-1,-1
RECMUS.txt,108733,110061,1328,10,N,N,-,-1,-1
RECMUS.txt,108767,110101,1334,10,N,N,-,-1,-1
RECMUS.txt,108964,110230,1266,10,N,N,-,-1,-1
RECMUS.txt,109042,110362,1320,10,N,N,-,-1,-1
RECMUS.txt,109143,110431,1288,10,N,N,-,-1,-1
RECMUS.txt,109335,110558,1223,10,N,N,-,-1,-1
RECMUS.txt,109468,110635,1167,10,N,N,-,-1,-1
RECMUS.txt,109636,110799,1163,10,N,N,-,-1,-1
RECMUS.txt,109809,111006,1197,10,N,N,-,-1,-1
RECMUS.txt,109906,111127,1221,10,N,N,-,-1,-1
RECMUS.txt,110066,111246,1180,10,N,N,-,-1,-1
RECMUS.txt,110102,111354,1252,10,N,N,-,-1,-1
RECMUS.txt,110231,111438,1207,10,N,N,-,-1,-1
RECMUS.txt,110363,111693,1330,10,N,N,-,-1,-1
RECMUS.txt,110432,111745,1313,10,N,N,-,-1,-1
RECMUS.txt,110559,111762,1203,10,N,N,-,-1,-1
RECMUS.txt,110638,111877,1239,10,N,N,-,-1,-1
RECMUS.txt,110802,111980,1178,10,N,N,-,-1,-1
RECMUS.txt,111012,112107,1095,10,N,N,-,-1,-1
RECMUS.txt,111132,112438,1306,10,N,N,-,-1,-1
RECMUS.txt,111249,112552,1303,10,N,N,-,-1,-1
RECMUS.txt,111355,112883,1528,10,N,N,-,-1,-1
RECMUS.txt,111439,112987,1548,10,N,N,-,-1,-1
RECMUS.txt,111694,113359,1665,10,N,N,-,-1,-1
RECMUS.txt,111750,113554,1804,10,Y,N,-,-1,-1
RECMUS.txt,111763,113702,1939,10,Y,N,-,-1,-1
RECMUS.txt,111878,113836,1958,10,Y,N,-,-1,-1
RECMUS.txt,111982,113995,2013,10,Y,N,-,-1,-1
RECMUS.txt,112109,114110,2001,10,Y,N,-,-1,-1
RECMUS.txt,112439,114178,1739,10,Y,N,-,-1,-1
RECMUS.txt,112553,114207,1654,10,Y,N,-,-1,-1
RECMUS.txt,112884,114426,1542,10,Y,N,-,-1,-1
RECMUS.txt,112988,114456,1468,10,Y,N,-,-1,-1
RECMUS.txt,113360,114570,1210,10,Y,N,-,-1,-1
RECMUS.txt,113555,114693,1138,10,Y,N,-,-1,-1
RECMUS.txt,113703,114694,991,10,Y,N,-,-1,-1
RECMUS.txt,113837,114822,985,10,Y,N,-,-1,-1
RECMUS.txt,113996,114827,831,10,Y,N,-,-1,-1
RECMUS.txt,114111,114927,816,10,Y,N,-,-1,-1
RECMUS.txt,114183,114942,759,10,Y,N,-,-1,-1
RECMUS.txt,114208,114999,791,10,Y,N,-,-1,-1
RECMUS.txt,114428,115004,576,10,N,N,-,-1,-1
RECMUS.txt,114457,115026,569,10,N,N,-,-1,-1
RECMUS.txt,114573,115031,458,10,N,N,-,-1,-1
RECMUS.txt,114693,115051,358,10,N,N,-,-1,-1
RECMUS.txt,114695,115065,370,10,N,N,-,-1,-1
RECMUS.txt,114822,115070,248,10,N,N,-,-1,-1
RECMUS.txt,114828,115078,250,10,N,N,-,-1,-1
RECMUS.txt,114930,115096,166,10,N,N,-,-1,-1
RECMUS.txt,114943,115101,158,10,N,N,-,-1,-1
RECMUS.txt,115002,115109,107,10,N,N,-,-1,-1
RECMUS.txt,115005,115114,109,10,N,N,-,-1,-1
RECMUS.txt,115029,115144,115,10,N,N,-,-1,-1
RECMUS.txt,115032,115149,117,10,N,N,-,-1,-1
RECMUS.txt,115052,115169,117,10,N,N,-,-1,-1
RECMUS.txt,115068,115174,106,10,N,N,-,-1,-1
RECMUS.txt,115071,115196,125,10,N,N,-,-1,-1
RECMUS.txt,115079,115201,122,10,N,N,-,-1,-1
RECMUS.txt,115099,115222,123,10,N,N,-,-1,-1
RECMUS.txt,115102,115228,126,10,N,N,-,-1,-1
RECMUS.txt,115112,115260,148,10,N,N,-,-1,-1
RECMUS.txt,115115,115292,177,10,N,N,-,-1,-1
RECMUS.txt,115147,115298,151,10,N,N,-,-1,-1
RECMUS.txt,115150,115329,179,10,N,N,-,-1,-1
RECMUS.txt,115172,115335,163,10,N,N,-,-1,-1
RECMUS.txt,115175,115356,181,10,N,N,-,-1,-1
RECMUS.txt,115199,115362,163,10,N,N,-,-1,-1
RECMUS.txt,115202,115403,201,10,N,N,-,-1,-1
RECMUS.txt,115225,115416,191,10,N,N,-,-1,-1
RECMUS.txt,115229,115429,200,10,N,N,-,-1,-1
RECMUS.txt,115262,115443,181,10,N,N,-,-1,-1
RECMUS.txt,115295,115511,216,10,N,N,-,-1,-1
RECMUS.txt,115299,115516,217,10,N,N,-,-1,-1
RECMUS.txt,115332,115522,190,10,N,N,-,-1,-1
RECMUS.txt,115336,115530,194,10,N,N,-,-1,-1
RECMUS.txt,115359,115578,219,10,N,N,-,-1,-1
RECMUS.txt,115363,115618,255,10,N,N,-,-1,-1
RECMUS.txt,115408,115627,219,10,N,N,-,-1,-1
RECMUS.txt,115421,115678,257,10,N,N,-,-1,-1
RECMUS.txt,115434,115687,253,10,N,N,-,-1,-1
RECMUS.txt,115448,115693,245,10,N,N,-,-1,-1
RECMUS.txt,115513,115748,235,10,N,N,-,-1,-1
RECMUS.txt,115519,115754,235,10,N,N,-,-1,-1
RECMUS.txt,115523,115776,253,10,N,N,-,-1,-1
RECMUS.txt,115531,115782,251,10,N,N,-,-1,-1
RECMUS.txt,115579,115856,277,10,N,N,-,-1,-1
RECMUS.txt,115619,115862,243,10,N,N,-,-1,-1
RECMUS.txt,115632,115923,291,10,N,N,-,-1,-1
RECMUS.txt,115679,115929,250,10,N,N,-,-1,-1
RECMUS.txt,115690,116001,311,10,N,N,-,-1,-1
RECMUS.txt,115694,116007,313,10,N,N,-,-1,-1
RECMUS.txt,115751,116058,307,10,N,N,-,-1,-1
RECMUS.txt,115755,116282,527,10,N,N,-,-1,-1
RECMUS.txt,115779,116411,632,10,N,N,-,-1,-1
RECMUS.txt,115783,116545,762,10,N,N,-,-1,-1
RECMUS.txt,115859,116714,855,10,N,N,-,-1,-1
RECMUS.txt,115863,116757,894,10,N,N,-,-1,-1
RECMUS.txt,115926,116866,940,10,N,N,-,-1,-1
RECMUS.txt,115930,117019,1089,10,N,N,-,-1,-1
RECMUS.txt,116004,117194,1190,10,N,N,-,-1,-1
RECMUS.txt,116008,117267,1259,10,N,N,-,-1,-1
RECMUS.txt,116061,117368,1307,10,N,N,-,-1,-1
RECMUS.txt,116285,117523,1238,10,N,N,-,-1,-1
RECMUS.txt,116412,117669,1257,10,N,N,-,-1,-1
RECMUS.txt,116546,117719,1173,10,N,N,-,-1,-1
RECMUS.txt,116715,117794,1079,10,N,N,-,-1,-1
RECMUS.txt,116760,117845,1085,10,N,N,-,-1,-1
RECMUS.txt,116867,118186,1319,10,N,N,-,-1,-1
RECMUS.txt,117020,118313,1293,10,N,N,-,-1,-1
RECMUS.txt,117195,118453,1258,10,N,N,-,-1,-1
RECMUS.txt,117268,118622,1354,10,N,N,-,-1,-1
RECMUS.txt,117369,118731,1362,10,N,N,-,-1,-1
RECMUS.txt,117524,118843,1319,10,N,N,-,-1,-1
RECMUS.txt,117670,118968,1298,10,N,N,-,-1,-1
RECMUS.txt,117724,119249,1525,10,N,N,-,-1,-1
RECMUS.txt,117795,119314,1519,10,N,N,-,-1,-1
RECMUS.txt,117847,119632,1785,10,N,N,-,-1,-1
RECMUS.txt,118189,119648,1459,10,N,N,-,-1,-1
RECMUS.txt,118314,119655,1341,10,N,N,-,-1,-1
RECMUS.txt,118454,119726,1272,10,N,N,-,-1,-1
RECMUS.txt,118623,120108,1485,10,N,N,-,-1,-1
RECMUS.txt,118732,120407,1675,10,N,N,-,-1,-1
RECMUS.txt,118844,120728,1884,10,N,N,-,-1,-1
RECMUS.txt,118969,120848,1879,10,N,N,-,-1,-1
RECMUS.txt,119250,121044,1794,10,N,N,-,-1,-1
RECMUS.txt,119317,121117,1800,10,N,N,-,-1,-1
RECMUS.txt,119637,121268,1631,10,N,N,-,-1,-1
RECMUS.txt,119650,121397,1747,10,N,N,-,-1,-1
RECMUS.txt,119658,121593,1935,10,N,N,-,-1,-1
RECMUS.txt,119728,121619,1891,10,N,N,-,-1,-1
RECMUS.txt,120111,121700,1589,10,N,N,-,-1,-1
RECMUS.txt,120408,121742,1334,10,N,N,-,-1,-1
RECMUS.txt,120730,121889,1159,10,N,N,-,-1,-1
RECMUS.txt,120851,122140,1289,10,N,N,-,-1,-1
RECMUS.txt,121045,122287,1242,10,N,N,-,-1,-1
RECMUS.txt,121118,122311,1193,10,N,N,-,-1,-1
RECMUS.txt,121269,122433,1164,10,N,N,-,-1,-1
RECMUS.txt,121400,122757,1357,10,N,N,-,-1,-1
RECMUS.txt,121598,122877,1279,10,N,N,-,-1,-1
RECMUS.txt,121620,122929,1309,10,N,N,-,-1,-1
RECMUS.txt,121701,123041,1340,10,N,N,-,-1,-1
RECMUS.txt,121743,123145,1402,10,N,N,-,-1,-1
RECMUS.txt,121890,123262,1372,10,N,N,-,-1,-1
RECMUS.txt,122143,123345,1202,10,N,N,-,-1,-1
RECMUS.txt,122288,123542,1254,10,N,N,-,-1,-1
RECMUS.txt,122313,123719,1406,10,N,Y,1448281491382,97818,98860
RECMUS.txt,122434,123806,1372,10,N,Y,1448281491382,97818,98860
RECMUS.txt,122758,123984,1226,10,N,Y,1448281491382,97818,98860
RECMUS.txt,122878,124090,1212,10,N,Y,1448281491382,97818,98860
RECMUS.txt,122930,124220,1290,10,N,Y,1448281491382,97818,98860
RECMUS.txt,123042,124493,1451,10,N,Y,1448281491382,97818,98860
RECMUS.txt,123145,124719,1574,10,N,Y,1448281491382,97818,98860
RECMUS.txt,123263,124867,1604,10,N,Y,1448281491382,97818,98860
RECMUS.txt,123346,125188,1842,10,N,Y,1448281491382,97818,98860
RECMUS.txt,123543,125316,1773,10,N,Y,1448281491382,97818,98860
RECMUS.txt,123720,125451,1731,10,N,Y,1448281491382,97818,98860
RECMUS.txt,123807,125580,1773,10,N,N,-,-1,-1
RECMUS.txt,123989,125815,1826,10,N,N,-,-1,-1
RECMUS.txt,124093,126230,2137,10,N,N,-,-1,-1
RECMUS.txt,124221,126327,2106,10,N,N,-,-1,-1
RECMUS.txt,124496,126355,1859,10,N,N,-,-1,-1
RECMUS.txt,124720,126538,1818,10,N,N,-,-1,-1
RECMUS.txt,124868,126677,1809,10,N,N,-,-1,-1
RECMUS.txt,125189,126821,1632,10,N,N,-,-1,-1
RECMUS.txt,125319,126943,1624,10,N,N,-,-1,-1
RECMUS.txt,125454,127143,1689,10,N,N,-,-1,-1
RECMUS.txt,125581,127368,1787,10,N,N,-,-1,-1
RECMUS.txt,125816,127538,1722,10,N,N,-,-1,-1
RECMUS.txt,126231,127830,1599,10,N,N,-,-1,-1
RECMUS.txt,126332,127977,1645,10,N,N,-,-1,-1
RECMUS.txt,126360,128037,1677,10,N,N,-,-1,-1
RECMUS.txt,126540,128067,1527,10,N,N,-,-1,-1
RECMUS.txt,126678,128260,1582,10,Y,N,-,-1,-1
RECMUS.txt,126822,128412,1590,10,Y,N,-,-1,-1
RECMUS.txt,126944,128481,1537,10,Y,N,-,-1,-1
RECMUS.txt,127144,128556,1412,10,Y,N,-,-1,-1
RECMUS.txt,127370,128587,1217,10,Y,N,-,-1,-1
RECMUS.txt,127541,128647,1106,10,Y,N,-,-1,-1
RECMUS.txt,127831,128690,859,10,N,N,-,-1,-1
RECMUS.txt,127978,128936,958,10,N,N,-,-1,-1
RECMUS.txt,128038,129077,1039,10,N,N,-,-1,-1
RECMUS.txt,128068,129371,1303,10,N,N,-,-1,-1
RECMUS.txt,128261,129499,1238,10,N,N,-,-1,-1
RECMUS.txt,128413,129641,1228,10,N,N,-,-1,-1
RECMUS.txt,128482,129732,1250,10,N,N,-,-1,-1
RECMUS.txt,128557,129954,1397,10,N,N,-,-1,-1
RECMUS.txt,128588,130115,1527,10,N,N,-,-1,-1
RECMUS.txt,128648,130197,1549,10,N,N,-,-1,-1
RECMUS.txt,128692,130314,1622,10,N,N,-,-1,-1
RECMUS.txt,128936,130404,1468,10,N,N,-,-1,-1
RECMUS.txt,129078,130559,1481,10,N,N,-,-1,-1
RECMUS.txt,129374,130639,1265,10,Y,N,-,-1,-1
RECMUS.txt,129500,130830,1330,10,N,N,-,-1,-1
RECMUS.txt,129642,131038,1396,10,N,N,-,-1,-1
RECMUS.txt,129733,131087,1354,10,N,N,-,-1,-1
RECMUS.txt,129955,131333,1378,10,N,N,-,-1,-1
RECMUS.txt,130116,131473,1357,10,N,N,-,-1,-1
RECMUS.txt,130198,131701,1503,10,N,N,-,-1,-1
RECMUS.txt,130315,131848,1533,10,N,N,-,-1,-1
RECMUS.txt,130407,131972,1565,10,N,N,-,-1,-1
RECMUS.txt,130560,132130,1570,10,N,N,-,-1,-1
RECMUS.txt,130641,132393,1752,10,N,N,-,-1,-1
RECMUS.txt,130833,132461,1628,10,Y,N,-,-1,-1
RECMUS.txt,131039,132555,1516,10,N,N,-,-1,-1
RECMUS.txt,131092,132697,1605,10,N,N,-,-1,-1
RECMUS.txt,131334,132881,1547,10,N,N,-,-1,-1
RECMUS.txt,131474,132977,1503,10,N,N,-,-1,-1
RECMUS.txt,131702,132993,1291,10,N,N,-,-1,-1
RECMUS.txt,131849,133198,1349,10,N,N,-,-1,-1
RECMUS.txt,131975,133346,1371,10,N,N,-,-1,-1
RECMUS.txt,132131,133483,1352,10,N,N,-,-1,-1
RECMUS.txt,132394,133528,1134,10,N,N,-,-1,-1
RECMUS.txt,132462,133778,1316,10,N,N,-,-1,-1
RECMUS.txt,132558,133882,1324,10,N,N,-,-1,-1
RECMUS.txt,132698,133969,1271,10,N,N,-,-1,-1
RECMUS.txt,132882,134029,1147,10,N,N,-,-1,-1
RECMUS.txt,132978,134317,1339,10,N,N,-,-1,-1
RECMUS.txt,132994,134449,1455,10,N,N,-,-1,-1
RECMUS.txt,133200,134510,1310,10,N,N,-,-1,-1
RECMUS.txt,133347,134689,1342,10,N,N,-,-1,-1
RECMUS.txt,133484,134769,1285,10,N,N,-,-1,-1
RECMUS.txt,133533,134892,1359,10,N,N,-,-1,-1
RECMUS.txt,133781,134951,1170,10,N,N,-,-1,-1
RECMUS.txt,133883,135089,1206,10,N,N,-,-1,-1
RECMUS.txt,133970,135184,1214,10,N,N,-,-1,-1
RECMUS.txt,134030,135221,1191,10,N,N,-,-1,-1
RECMUS.txt,134318,135309,991,10,N,N,-,-1,-1
RECMUS.txt,134450,135634,1184,10,N,N,-,-1,-1
RECMUS.txt,134511,135779,1268,10,N,N,-,-1,-1
RECMUS.txt,134690,135788,1098,10,N,N,-,-1,-1
RECMUS.txt,134772,135810,1038,10,N,N,-,-1,-1
RECMUS.txt,134893,135858,965,10,N,N,-,-1,-1
RECMUS.txt,134952,135955,1003,10,N,N,-,-1,-1
RECMUS.txt,135090,136151,1061,10,N,N,-,-1,-1
RECMUS.txt,135185,136313,1128,10,N,N,-,-1,-1
RECMUS.txt,135222,136541,1319,10,N,N,-,-1,-1
RECMUS.txt,135312,136586,1274,10,N,N,-,-1,-1
RECMUS.txt,135635,136616,981,10,N,N,-,-1,-1
RECMUS.txt,135779,136670,891,10,N,N,-,-1,-1
RECMUS.txt,135793,136734,941,10,N,N,-,-1,-1
RECMUS.txt,135815,136871,1056,10,N,N,-,-1,-1
RECMUS.txt,135859,137018,1159,10,N,N,-,-1,-1
RECMUS.txt,135956,137422,1466,10,N,N,-,-1,-1
RECMUS.txt,136154,137504,1350,10,N,N,-,-1,-1
RECMUS.txt,136314,137517,1203,10,N,N,-,-1,-1
RECMUS.txt,136542,137536,994,10,N,N,-,-1,-1
RECMUS.txt,136587,137637,1050,10,N,N,-,-1,-1
RECMUS.txt,136618,137733,1115,10,N,N,-,-1,-1
RECMUS.txt,136673,137780,1107,10,N,N,-,-1,-1
RECMUS.txt,136735,138043,1308,10,N,N,-,-1,-1
RECMUS.txt,136872,138230,1358,10,N,N,-,-1,-1
RECMUS.txt,137023,138256,1233,10,N,N,-,-1,-1
RECMUS.txt,137423,138367,944,10,N,N,-,-1,-1
RECMUS.txt,137509,138439,930,10,N,N,-,-1,-1
RECMUS.txt,137518,138632,1114,10,N,N,-,-1,-1
RECMUS.txt,137537,138699,1162,10,N,Y,1448280884746,88496,89294
RECMUS.txt,137638,138827,1189,10,N,Y,1448280884746,88496,89294
RECMUS.txt,137735,138901,1166,10,N,Y,1448280884746,88496,89294
RECMUS.txt,137781,138982,1201,10,N,Y,1448280884746,88496,89294
RECMUS.txt,138046,139033,987,10,N,Y,1448280884746,88496,89294
RECMUS.txt,138231,139229,998,10,N,Y,1448280884746,88496,89294
RECMUS.txt,138257,139572,1315,10,N,Y,1448280884746,88496,89294
RECMUS.txt,138368,139727,1359,10,N,Y,1448280884746,88496,89294
RECMUS.txt,138440,139816,1376,10,N,Y,1448280884746,88496,89294
RECMUS.txt,138633,139967,1334,10,N,Y,1448280884746,88496,89294
RECMUS.txt,138702,140138,1436,10,N,N,-,-1,-1
RECMUS.txt,138828,140259,1431,10,N,N,-,-1,-1
RECMUS.txt,138902,140520,1618,10,N,N,-,-1,-1
RECMUS.txt,138983,140553,1570,10,N,N,-,-1,-1
RECMUS.txt,139036,140577,1541,10,N,N,-,-1,-1
RECMUS.txt,139229,140673,1444,10,N,N,-,-1,-1
RECMUS.txt,139573,140850,1277,10,N,N,-,-1,-1
RECMUS.txt,139728,140964,1236,10,N,N,-,-1,-1
RECMUS.txt,139821,140982,1161,10,N,N,-,-1,-1
RECMUS.txt,139970,141082,1112,10,N,N,-,-1,-1
RECMUS.txt,140139,141312,1173,10,N,N,-,-1,-1
RECMUS.txt,140262,141557,1295,10,N,N,-,-1,-1
RECMUS.txt,140521,141648,1127,10,N,N,-,-1,-1
RECMUS.txt,140554,141785,1231,10,N,N,-,-1,-1
RECMUS.txt,140578,141906,1328,10,N,N,-,-1,-1
RECMUS.txt,140674,142106,1432,10,N,N,-,-1,-1
RECMUS.txt,140851,142182,1331,10,N,N,-,-1,-1
RECMUS.txt,140967,142303,1336,10,N,N,-,-1,-1
RECMUS.txt,140982,142688,1706,10,Y,N,-,-1,-1
RECMUS.txt,141084,142865,1781,10,Y,N,-,-1,-1
RECMUS.txt,141313,142902,1589,10,Y,N,-,-1,-1
RECMUS.txt,141559,143348,1789,10,Y,N,-,-1,-1
RECMUS.txt,141649,143372,1723,10,Y,N,-,-1,-1
RECMUS.txt,141786,143540,1754,10,Y,N,-,-1,-1
RECMUS.txt,141907,143652,1745,10,Y,N,-,-1,-1
RECMUS.txt,142107,143820,1713,10,Y,N,-,-1,-1
RECMUS.txt,142185,143958,1773,10,Y,N,-,-1,-1
RECMUS.txt,142305,144066,1761,10,Y,N,-,-1,-1
RECMUS.txt,142689,144181,1492,10,Y,N,-,-1,-1
RECMUS.txt,142866,144364,1498,10,N,N,-,-1,-1
RECMUS.txt,142903,144504,1601,10,N,N,-,-1,-1
RECMUS.txt,143349,144611,1262,10,N,N,-,-1,-1
RECMUS.txt,143374,144714,1340,10,N,N,-,-1,-1
RECMUS.txt,143542,144812,1270,10,N,N,-,-1,-1
RECMUS.txt,143653,144888,1235,10,N,N,-,-1,-1
RECMUS.txt,143821,144895,1074,10,N,N,-,-1,-1
RECMUS.txt,143959,144905,946,10,N,N,-,-1,-1
RECMUS.txt,144068,145116,1048,10,N,N,-,-1,-1
RECMUS.txt,144184,145166,982,10,N,N,-,-1,-1
RECMUS.txt,144365,145246,881,10,N,N,-,-1,-1
RECMUS.txt,144505,145363,858,10,N,N,-,-1,-1
RECMUS.txt,144616,145595,979,10,N,N,-,-1,-1
RECMUS.txt,144715,145764,1049,10,N,N,-,-1,-1
RECMUS.txt,144813,146059,1246,10,N,N,-,-1,-1
RECMUS.txt,144889,146298,1409,10,N,N,-,-1,-1
RECMUS.txt,144896,146536,1640,10,N,N,-,-1,-1
RECMUS.txt,144906,146777,1871,10,N,N,-,-1,-1
RECMUS.txt,145117,146988,1871,10,N,N,-,-1,-1
RECMUS.txt,145167,147011,1844,10,N,N,-,-1,-1
RECMUS.txt,145249,147152,1903,10,N,N,-,-1,-1
RECMUS.txt,145365,147482,2117,10,N,N,-,-1,-1
RECMUS.txt,145596,147634,2038,10,N,N,-,-1,-1
RECMUS.txt,145765,147763,1998,10,N,N,-,-1,-1
RECMUS.txt,146060,147928,1868,10,N,N,-,-1,-1
RECMUS.txt,146300,147957,1657,10,N,N,-,-1,-1
RECMUS.txt,146539,148136,1597,10,N,N,-,-1,-1
RECMUS.txt,146780,148305,1525,10,N,N,-,-1,-1
RECMUS.txt,146991,148559,1568,10,N,N,-,-1,-1
RECMUS.txt,147012,148686,1674,10,N,N,-,-1,-1
RECMUS.txt,147153,148827,1674,10,N,N,-,-1,-1
RECMUS.txt,147483,148884,1401,10,N,N,-,-1,-1
RECMUS.txt,147635,148901,1266,10,N,N,-,-1,-1
RECMUS.txt,147764,148909,1145,10,N,N,-,-1,-1
RECMUS.txt,147929,149300,1371,10,N,N,-,-1,-1
RECMUS.txt,147960,149550,1590,10,N,N,-,-1,-1
RECMUS.txt,148138,149713,1575,10,N,N,-,-1,-1
RECMUS.txt,148308,149840,1532,10,N,N,-,-1,-1
RECMUS.txt,148560,149931,1371,10,N,N,-,-1,-1
RECMUS.txt,148687,150085,1398,10,N,N,-,-1,-1
RECMUS.txt,148828,150147,1319,10,N,N,-,-1,-1
RECMUS.txt,148889,150281,1392,10,N,N,-,-1,-1
RECMUS.txt,148904,150450,1546,10,N,N,-,-1,-1
RECMUS.txt,148912,150598,1686,10,N,N,-,-1,-1
RECMUS.txt,149303,150807,1504,10,N,N,-,-1,-1
RECMUS.txt,149551,150899,1348,10,N,N,-,-1,-1
RECMUS.txt,149714,150987,1273,10,N,N,-,-1,-1
RECMUS.txt,149841,151199,1358,10,N,N,-,-1,-1
RECMUS.txt,149932,151569,1637,10,N,N,-,-1,-1
RECMUS.txt,150086,151831,1745,10,N,N,-,-1,-1
RECMUS.txt,150148,152025,1877,10,N,N,-,-1,-1
RECMUS.txt,150282,152184,1902,10,N,N,-,-1,-1
RECMUS.txt,150451,152392,1941,10,Y,N,-,-1,-1
RECMUS.txt,150599,152513,1914,10,Y,N,-,-1,-1
RECMUS.txt,150810,152879,2069,10,Y,N,-,-1,-1
RECMUS.txt,150902,152951,2049,10,Y,N,-,-1,-1
RECMUS.txt,150988,153176,2188,10,Y,N,-,-1,-1
RECMUS.txt,151201,153253,2052,10,Y,N,-,-1,-1
RECMUS.txt,151572,153324,1752,10,Y,N,-,-1,-1
RECMUS.txt,151832,153521,1689,10,Y,N,-,-1,-1
RECMUS.txt,152026,153607,1581,10,Y,N,-,-1,-1
RECMUS.txt,152185,153765,1580,10,Y,N,-,-1,-1
RECMUS.txt,152393,153883,1490,10,Y,N,-,-1,-1
RECMUS.txt,152515,154002,1487,10,N,N,-,-1,-1
RECMUS.txt,152880,154108,1228,10,N,N,-,-1,-1
RECMUS.txt,152954,154238,1284,10,Y,N,-,-1,-1
RECMUS.txt,153177,154516,1339,10,N,N,-,-1,-1
RECMUS.txt,153258,154617,1359,10,N,N,-,-1,-1
RECMUS.txt,153326,154687,1361,10,N,N,-,-1,-1
RECMUS.txt,153522,154790,1268,10,N,N,-,-1,-1
RECMUS.txt,153609,155007,1398,10,N,N,-,-1,-1
RECMUS.txt,153766,155178,1412,10,N,N,-,-1,-1
RECMUS.txt,153884,155185,1301,10,N,N,-,-1,-1
RECMUS.txt,154003,155240,1237,10,N,N,-,-1,-1
RECMUS.txt,154111,155412,1301,10,N,N,-,-1,-1
RECMUS.txt,154239,155527,1288,10,N,N,-,-1,-1
RECMUS.txt,154518,155631,1113,10,N,N,-,-1,-1
RECMUS.txt,154620,155882,1262,10,N,N,-,-1,-1
RECMUS.txt,154688,156039,1351,10,N,N,-,-1,-1
RECMUS.txt,154792,156248,1456,10,N,N,-,-1,-1
RECMUS.txt,155008,156584,1576,10,N,N,-,-1,-1
RECMUS.txt,155179,156701,1522,10,N,N,-,-1,-1
RECMUS.txt,155186,156850,1664,10,N,N,-,-1,-1
RECMUS.txt,155241,156952,1711,10,N,N,-,-1,-1
RECMUS.txt,155415,157045,1630,10,N,N,-,-1,-1
RECMUS.txt,155528,157124,1596,10,Y,N,-,-1,-1
RECMUS.txt,155634,157212,1578,10,Y,N,-,-1,-1
RECMUS.txt,155885,157338,1453,10,N,N,-,-1,-1
RECMUS.txt,156040,157494,1454,10,N,N,-,-1,-1
RECMUS.txt,156249,157598,1349,10,N,N,-,-1,-1
RECMUS.txt,156585,157719,1134,10,N,N,-,-1,-1
RECMUS.txt,156702,157766,1064,10,N,N,-,-1,-1
RECMUS.txt,156851,157859,1008,10,N,N,-,-1,-1
RECMUS.txt,156953,157952,999,10,N,N,-,-1,-1
RECMUS.txt,157046,158146,1100,10,N,N,-,-1,-1
RECMUS.txt,157125,158218,1093,10,N,N,-,-1,-1
RECMUS.txt,157213,158275,1062,10,N,N,-,-1,-1
RECMUS.txt,157339,158382,1043,10,N,N,-,-1,-1
RECMUS.txt,157495,158588,1093,10,N,N,-,-1,-1
RECMUS.txt,157599,158680,1081,10,N,N,-,-1,-1
RECMUS.txt,157720,159021,1301,10,N,N,-,-1,-1
RECMUS.txt,157767,159102,1335,10,N,N,-,-1,-1
RECMUS.txt,157860,159208,1348,10,N,N,-,-1,-1
RECMUS.txt,157953,159250,1297,10,N,N,-,-1,-1
RECMUS.txt,158149,159297,1148,10,N,N,-,-1,-1
RECMUS.txt,158219,159298,1079,10,N,N,-,-1,-1
RECMUS.txt,158276,159334,1058,10,N,N,-,-1,-1
RECMUS.txt,158383,159418,1035,10,N,N,-,-1,-1
RECMUS.txt,158589,159739,1150,10,N,Y,1448038356234,18463,18881
RECMUS.txt,158681,159840,1159,10,N,Y,1448038356234,18463,18881
RECMUS.txt,159023,159874,851,10,N,Y,1448038356234,18463,18881
RECMUS.txt,159103,159922,819,10,N,Y,1448038356234,18463,18881
RECMUS.txt,159209,159944,735,10,N,Y,1448038356234,18463,18881
RECMUS.txt,159251,160026,775,10,N,Y,1448038356234,18463,18881
RECMUS.txt,159297,160227,930,10,N,Y,1448038356234,18463,18881
RECMUS.txt,159299,160300,1001,10,N,Y,1448038356234,18463,18881
RECMUS.txt,159335,160470,1135,10,N,Y,1448038356234,18463,18881
RECMUS.txt,159419,160558,1139,10,N,Y,1448038356234,18463,18881
RECMUS.txt,159740,160675,935,10,N,Y,1448038356234,18463,18881
RECMUS.txt,159841,160835,994,10,N,Y,1448038356234,18463,18881
RECMUS.txt,159875,160990,1115,10,N,Y,1448038356234,18463,18881
RECMUS.txt,159923,161158,1235,10,N,Y,1448038356234,18463,18881
RECMUS.txt,159945,161287,1342,10,N,N,-,-1,-1
RECMUS.txt,160027,161425,1398,10,N,N,-,-1,-1
RECMUS.txt,160228,161612,1384,10,N,N,-,-1,-1
RECMUS.txt,160301,161629,1328,10,N,N,-,-1,-1
RECMUS.txt,160473,161969,1496,10,N,N,-,-1,-1
RECMUS.txt,160559,162085,1526,10,N,N,-,-1,-1
RECMUS.txt,160678,162393,1715,10,N,N,-,-1,-1
RECMUS.txt,160836,162648,1812,10,N,N,-,-1,-1
RECMUS.txt,160991,162860,1869,10,N,Y,1448276340407,30017,39003
RECMUS.txt,161159,162924,1765,10,N,Y,1448276340407,30017,39003
RECMUS.txt,161288,162989,1701,10,N,Y,1448276340407,30017,39003
RECMUS.txt,161426,163056,1630,10,N,Y,1448276340407,30017,39003
RECMUS.txt,161613,163348,1735,10,N,Y,1448276340407,30017,39003
RECMUS.txt,161630,163472,1842,10,Y,Y,1448276340407,30017,39003
RECMUS.txt,161970,163513,1543,10,N,Y,1448276340407,30017,39003
RECMUS.txt,162086,163525,1439,10,N,Y,1448276340407,30017,39003
RECMUS.txt,162394,163618,1224,10,N,Y,1448276340407,30017,39003
RECMUS.txt,162649,163664,1015,10,N,Y,1448276340407,30017,39003
RECMUS.txt,162861,163690,829,10,N,Y,1448276340407,30017,39003
RECMUS.txt,162926,163774,848,10,N,Y,1448276340407,30017,39003
RECMUS.txt,162992,163785,793,10,N,N,-,-1,-1
RECMUS.txt,163057,163819,762,10,N,N,-,-1,-1
RECMUS.txt,163349,163848,499,10,N,N,-,-1,-1
RECMUS.txt,163473,163974,501,10,N,N,-,-1,-1
RECMUS.txt,163513,164261,748,10,N,N,-,-1,-1
RECMUS.txt,163526,164420,894,10,N,N,-,-1,-1
RECMUS.txt,163619,164441,822,10,N,N,-,-1,-1
RECMUS.txt,163665,164462,797,10,N,N,-,-1,-1
RECMUS.txt,163691,164564,873,10,N,N,-,-1,-1
RECMUS.txt,163775,164616,841,10,N,N,-,-1,-1
RECMUS.txt,163786,164626,840,10,N,N,-,-1,-1
RECMUS.txt,163820,164764,944,10,N,N,-,-1,-1
RECMUS.txt,163851,164777,926,10,N,N,-,-1,-1
RECMUS.txt,163975,164880,905,10,N,N,-,-1,-1
RECMUS.txt,164262,164956,694,10,N,N,-,-1,-1
RECMUS.txt,164421,164995,574,10,N,N,-,-1,-1
RECMUS.txt,164442,165015,573,10,N,N,-,-1,-1
RECMUS.txt,164463,165041,578,10,N,N,-,-1,-1
RECMUS.txt,164565,165065,500,10,N,N,-,-1,-1
RECMUS.txt,164617,165118,501,10,N,N,-,-1,-1
RECMUS.txt,164627,165273,646,10,N,N,-,-1,-1
RECMUS.txt,164767,165378,611,10,N,N,-,-1,-1
RECMUS.txt,164778,165534,756,10,N,N,-,-1,-1
RECMUS.txt,164882,165634,752,10,N,N,-,-1,-1
RECMUS.txt,164961,165652,691,10,N,N,-,-1,-1
RECMUS.txt,164996,165733,737,10,N,N,-,-1,-1
RECMUS.txt,165016,165768,752,10,N,N,-,-1,-1
RECMUS.txt,165042,165785,743,10,N,N,-,-1,-1
RECMUS.txt,165066,165803,737,10,N,N,-,-1,-1
RECMUS.txt,165119,165955,836,10,N,N,-,-1,-1
RECMUS.txt,165274,166125,851,10,N,N,-,-1,-1
RECMUS.txt,165379,166166,787,10,N,N,-,-1,-1
RECMUS.txt,165535,166210,675,10,N,N,-,-1,-1
RECMUS.txt,165637,166285,648,10,N,N,-,-1,-1
RECMUS.txt,165653,166366,713,10,N,N,-,-1,-1
RECMUS.txt,165734,166513,779,10,N,N,-,-1,-1
RECMUS.txt,165771,166633,862,10,N,N,-,-1,-1
RECMUS.txt,165785,166651,866,10,N,N,-,-1,-1
RECMUS.txt,165803,166659,856,10,N,N,-,-1,-1
RECMUS.txt,165956,167070,1114,10,N,N,-,-1,-1
RECMUS.txt,166128,167298,1170,10,N,N,-,-1,-1
RECMUS.txt,166167,167379,1212,10,N,N,-,-1,-1
RECMUS.txt,166211,167600,1389,10,N,N,-,-1,-1
RECMUS.txt,166286,167713,1427,10,N,N,-,-1,-1
RECMUS.txt,166369,167884,1515,10,N,N,-,-1,-1
RECMUS.txt,166514,167969,1455,10,N,N,-,-1,-1
RECMUS.txt,166638,168138,1500,10,N,N,-,-1,-1
RECMUS.txt,166654,168240,1586,10,N,N,-,-1,-1
RECMUS.txt,166662,168368,1706,10,N,N,-,-1,-1
RECMUS.txt,167073,168524,1451,10,N,N,-,-1,-1
RECMUS.txt,167301,168556,1255,10,N,N,-,-1,-1
RECMUS.txt,167380,168846,1466,10,N,N,-,-1,-1
RECMUS.txt,167603,169003,1400,10,N,N,-,-1,-1
RECMUS.txt,167715,169266,1551,10,N,N,-,-1,-1
RECMUS.txt,167885,169415,1530,10,N,N,-,-1,-1
RECMUS.txt,167970,169578,1608,10,N,N,-,-1,-1
RECMUS.txt,168139,169615,1476,10,N,N,-,-1,-1
RECMUS.txt,168242,169732,1490,10,N,N,-,-1,-1
RECMUS.txt,168371,169829,1458,10,N,N,-,-1,-1
RECMUS.txt,168529,170031,1502,10,N,N,-,-1,-1
RECMUS.txt,168557,170208,1651,10,N,N,-,-1,-1
RECMUS.txt,168849,170244,1395,10,N,N,-,-1,-1
RECMUS.txt,169003,170389,1386,10,N,N,-,-1,-1
RECMUS.txt,169267,170781,1514,10,N,N,-,-1,-1
RECMUS.txt,169418,170827,1409,10,N,N,-,-1,-1
RECMUS.txt,169579,170858,1279,10,N,N,-,-1,-1
RECMUS.txt,169616,170907,1291,10,N,N,-,-1,-1
RECMUS.txt,169733,170966,1233,10,N,N,-,-1,-1
RECMUS.txt,169832,171053,1221,10,N,N,-,-1,-1
RECMUS.txt,170032,171185,1153,10,N,N,-,-1,-1
RECMUS.txt,170209,171333,1124,10,N,N,-,-1,-1
RECMUS.txt,170246,171475,1229,10,N,N,-,-1,-1
RECMUS.txt,170392,171578,1186,10,N,N,-,-1,-1
RECMUS.txt,170782,171638,856,10,N,N,-,-1,-1
RECMUS.txt,170832,171734,902,10,N,N,-,-1,-1
RECMUS.txt,170863,171846,983,10,N,N,-,-1,-1
RECMUS.txt,170908,172044,1136,10,N,N,-,-1,-1
RECMUS.txt,170967,172115,1148,10,N,N,-,-1,-1
RECMUS.txt,171054,172242,1188,10,N,N,-,-1,-1
RECMUS.txt,171186,172278,1092,10,N,N,-,-1,-1
RECMUS.txt,171336,172305,969,10,N,N,-,-1,-1
RECMUS.txt,171476,172471,995,10,N,N,-,-1,-1
RECMUS.txt,171579,172498,919,10,N,N,-,-1,-1
RECMUS.txt,171639,172519,880,10,N,N,-,-1,-1
RECMUS.txt,171735,172620,885,10,N,N,-,-1,-1
RECMUS.txt,171847,172712,865,10,N,N,-,-1,-1
RECMUS.txt,172045,172792,747,10,N,N,-,-1,-1
RECMUS.txt,172116,172867,751,10,N,N,-,-1,-1
RECMUS.txt,172243,172938,695,10,N,N,-,-1,-1
RECMUS.txt,172279,173007,728,10,N,N,-,-1,-1
RECMUS.txt,172306,173217,911,10,N,N,-,-1,-1
RECMUS.txt,172472,173305,833,10,N,N,-,-1,-1
RECMUS.txt,172499,173466,967,10,N,N,-,-1,-1
RECMUS.txt,172520,173560,1040,10,N,N,-,-1,-1
RECMUS.txt,172621,173668,1047,10,N,N,-,-1,-1
RECMUS.txt,172714,173828,1114,10,N,N,-,-1,-1
RECMUS.txt,172793,174015,1222,10,N,N,-,-1,-1
RECMUS.txt,172868,174102,1234,10,N,N,-,-1,-1
RECMUS.txt,172939,174203,1264,10,N,N,-,-1,-1
RECMUS.txt,173010,174321,1311,10,N,N,-,-1,-1
RECMUS.txt,173222,174362,1140,10,N,N,-,-1,-1
RECMUS.txt,173306,174404,1098,10,N,N,-,-1,-1
RECMUS.txt,173467,174492,1025,10,N,N,-,-1,-1
RECMUS.txt,173561,174785,1224,10,N,N,-,-1,-1
RECMUS.txt,173669,174850,1181,10,N,N,-,-1,-1
RECMUS.txt,173829,174949,1120,10,N,N,-,-1,-1
RECMUS.txt,174018,175129,1111,10,N,N,-,-1,-1
RECMUS.txt,174103,175260,1157,10,N,N,-,-1,-1
RECMUS.txt,174204,175453,1249,10,N,N,-,-1,-1
RECMUS.txt,174322,175578,1256,10,N,N,-,-1,-1
RECMUS.txt,174363,175618,1255,10,N,N,-,-1,-1
RECMUS.txt,174405,175853,1448,10,N,N,-,-1,-1
RECMUS.txt,174493,175993,1500,10,N,N,-,-1,-1
RECMUS.txt,174786,176192,1406,10,N,N,-,-1,-1
RECMUS.txt,174851,176332,1481,10,N,N,-,-1,-1
RECMUS.txt,174951,176419,1468,10,N,N,-,-1,-1
RECMUS.txt,175130,176528,1398,10,N,N,-,-1,-1
RECMUS.txt,175261,176587,1326,10,N,N,-,-1,-1
RECMUS.txt,175454,176657,1203,10,N,N,-,-1,-1
RECMUS.txt,175583,176787,1204,10,N,N,-,-1,-1
RECMUS.txt,175623,176849,1226,10,N,N,-,-1,-1
RECMUS.txt,175854,176921,1067,10,N,N,-,-1,-1
RECMUS.txt,175996,177098,1102,10,N,N,-,-1,-1
RECMUS.txt,176193,177317,1124,10,N,N,-,-1,-1
RECMUS.txt,176332,177467,1135,10,N,N,-,-1,-1
RECMUS.txt,176420,177597,1177,10,N,N,-,-1,-1
RECMUS.txt,176529,177658,1129,10,N,N,-,-1,-1
RECMUS.txt,176588,177789,1201,10,N,N,-,-1,-1
RECMUS.txt,176658,177898,1240,10,N,N,-,-1,-1
RECMUS.txt,176788,178034,1246,10,N,N,-,-1,-1
RECMUS.txt,176852,178347,1495,10,N,N,-,-1,-1
RECMUS.txt,176922,178426,1504,10,N,N,-,-1,-1
RECMUS.txt,177099,178493,1394,10,N,N,-,-1,-1
RECMUS.txt,177318,178716,1398,10,N,N,-,-1,-1
RECMUS.txt,177468,179019,1551,10,N,N,-,-1,-1
RECMUS.txt,177598,179087,1489,10,N,N,-,-1,-1
RECMUS.txt,177659,179219,1560,10,N,N,-,-1,-1
RECMUS.txt,177794,179321,1527,10,N,N,-,-1,-1
RECMUS.txt,177901,179365,1464,10,N,N,-,-1,-1
RECMUS.txt,178035,179535,1500,10,N,N,-,-1,-1
RECMUS.txt,178350,179812,1462,10,N,N,-,-1,-1
RECMUS.txt,178427,179969,1542,10,N,N,-,-1,-1
RECMUS.txt,178494,180084,1590,10,N,N,-,-1,-1
RECMUS.txt,178717,180200,1483,10,N,N,-,-1,-1
RECMUS.txt,179020,180207,1187,10,N,N,-,-1,-1
RECMUS.txt,179088,180309,1221,10,N,N,-,-1,-1
RECMUS.txt,179221,180577,1356,10,N,N,-,-1,-1
RECMUS.txt,179322,180649,1327,10,N,N,-,-1,-1
RECMUS.txt,179366,180816,1450,10,N,N,-,-1,-1
RECMUS.txt,179536,180881,1345,10,N,N,-,-1,-1
RECMUS.txt,179813,180913,1100,10,N,N,-,-1,-1
RECMUS.txt,179970,181148,1178,10,N,N,-,-1,-1
RECMUS.txt,180085,181233,1148,10,N,N,-,-1,-1
RECMUS.txt,180201,181297,1096,10,N,N,-,-1,-1
RECMUS.txt,180207,181469,1262,10,N,N,-,-1,-1
RECMUS.txt,180310,181693,1383,10,N,N,-,-1,-1
RECMUS.txt,180578,181813,1235,10,N,N,-,-1,-1
RECMUS.txt,180650,182099,1449,10,N,N,-,-1,-1
RECMUS.txt,180817,182251,1434,10,N,N,-,-1,-1
RECMUS.txt,180882,182267,1385,10,N,N,-,-1,-1
RECMUS.txt,180914,182274,1360,10,N,N,-,-1,-1
RECMUS.txt,181149,182656,1507,10,N,N,-,-1,-1
RECMUS.txt,181234,182796,1562,10,N,N,-,-1,-1
RECMUS.txt,181298,182801,1503,10,N,N,-,-1,-1
RECMUS.txt,181470,182811,1341,10,N,N,-,-1,-1
RECMUS.txt,181695,182828,1133,10,N,N,-,-1,-1
RECMUS.txt,181816,182875,1059,10,N,N,-,-1,-1
RECMUS.txt,182102,183116,1014,10,N,N,-,-1,-1
RECMUS.txt,182256,183238,982,10,N,N,-,-1,-1
RECMUS.txt,182269,183292,1023,10,N,N,-,-1,-1
RECMUS.txt,182277,183337,1060,10,N,N,-,-1,-1
RECMUS.txt,182659,183505,846,10,N,N,-,-1,-1
RECMUS.txt,182797,183605,808,10,N,N,-,-1,-1
RECMUS.txt,182802,183722,920,10,N,N,-,-1,-1
RECMUS.txt,182812,183859,1047,10,N,N,-,-1,-1
RECMUS.txt,182829,183871,1042,10,N,N,-,-1,-1
RECMUS.txt,182876,183887,1011,10,N,N,-,-1,-1
RECMUS.txt,183118,183901,783,10,N,N,-,-1,-1
RECMUS.txt,183239,183922,683,10,N,N,-,-1,-1
RECMUS.txt,183294,184055,761,10,N,N,-,-1,-1
RECMUS.txt,183338,184134,796,10,N,N,-,-1,-1
RECMUS.txt,183506,184174,668,10,N,N,-,-1,-1
RECMUS.txt,183606,184448,842,10,N,N,-,-1,-1
RECMUS.txt,183723,184492,769,10,N,N,-,-1,-1
RECMUS.txt,183859,184546,687,10,N,N,-,-1,-1
RECMUS.txt,183872,184639,767,10,N,N,-,-1,-1
RECMUS.txt,183888,184745,857,10,N,N,-,-1,-1
RECMUS.txt,183902,184775,873,10,N,N,-,-1,-1
RECMUS.txt,183923,184810,887,10,N,N,-,-1,-1
RECMUS.txt,184056,184894,838,10,N,N,-,-1,-1
RECMUS.txt,184135,184918,783,10,N,N,-,-1,-1
RECMUS.txt,184179,184977,798,10,N,N,-,-1,-1
RECMUS.txt,184449,185063,614,10,N,N,-,-1,-1
RECMUS.txt,184493,185223,730,10,N,N,-,-1,-1
RECMUS.txt,184547,185312,765,10,N,N,-,-1,-1
RECMUS.txt,184640,185356,716,10,N,N,-,-1,-1
RECMUS.txt,184746,185360,614,10,N,N,-,-1,-1
RECMUS.txt,184776,185454,678,10,N,N,-,-1,-1
RECMUS.txt,184811,185491,680,10,N,N,-,-1,-1
RECMUS.txt,184894,185616,722,10,N,N,-,-1,-1
RECMUS.txt,184919,185822,903,10,N,N,-,-1,-1
RECMUS.txt,184978,185921,943,10,N,N,-,-1,-1
RECMUS.txt,185064,185972,908,10,N,N,-,-1,-1
RECMUS.txt,185225,186037,812,10,N,N,-,-1,-1
RECMUS.txt,185313,186121,808,10,N,N,-,-1,-1
RECMUS.txt,185356,186191,835,10,N,N,-,-1,-1
RECMUS.txt,185361,186249,888,10,N,N,-,-1,-1
RECMUS.txt,185455,186379,924,10,N,N,-,-1,-1
RECMUS.txt,185492,186574,1082,10,N,N,-,-1,-1
RECMUS.txt,185617,186613,996,10,N,N,-,-1,-1
RECMUS.txt,185823,186699,876,10,N,N,-,-1,-1
RECMUS.txt,185922,186853,931,10,N,N,-,-1,-1
RECMUS.txt,185973,187065,1092,10,N,N,-,-1,-1
RECMUS.txt,186039,187184,1145,10,N,N,-,-1,-1
RECMUS.txt,186122,187287,1165,10,N,N,-,-1,-1
RECMUS.txt,186192,187403,1211,10,N,N,-,-1,-1
RECMUS.txt,186250,187419,1169,10,N,N,-,-1,-1
RECMUS.txt,186380,187638,1258,10,N,N,-,-1,-1
RECMUS.txt,186579,187685,1106,10,N,N,-,-1,-1
RECMUS.txt,186618,187894,1276,10,N,N,-,-1,-1
RECMUS.txt,186700,188072,1372,10,N,N,-,-1,-1
RECMUS.txt,186855,188342,1487,10,N,N,-,-1,-1
RECMUS.txt,187068,188358,1290,10,N,N,-,-1,-1
RECMUS.txt,187185,188476,1291,10,N,Y,1448311366799,143137,146264
RECMUS.txt,187287,188503,1216,10,N,Y,1448311366799,143137,146264
RECMUS.txt,187406,188684,1278,10,N,Y,1448311366799,143137,146264
RECMUS.txt,187420,188751,1331,10,N,Y,1448311366799,143137,146264
RECMUS.txt,187639,188765,1126,10,N,Y,1448311366799,143137,146264
RECMUS.txt,187686,188808,1122,10,N,Y,1448311366799,143137,146264
RECMUS.txt,187895,188884,989,10,N,Y,1448311366799,143137,146264
RECMUS.txt,188073,189053,980,10,N,Y,1448311366799,143137,146264
RECMUS.txt,188345,189156,811,10,N,Y,1448311366799,143137,146264
RECMUS.txt,188359,189181,822,10,N,Y,1448311366799,143137,146264
RECMUS.txt,188477,189328,851,10,N,Y,1448311366799,143137,146264
RECMUS.txt,188504,189525,1021,10,N,Y,1448311366799,143137,146264
RECMUS.txt,188685,189636,951,10,N,N,-,-1,-1
RECMUS.txt,188752,189676,924,10,N,N,-,-1,-1
RECMUS.txt,188766,189703,937,10,N,N,-,-1,-1
RECMUS.txt,188810,189853,1043,10,Y,N,-,-1,-1
RECMUS.txt,188885,189955,1070,10,Y,N,-,-1,-1
RECMUS.txt,189054,190040,986,10,Y,N,-,-1,-1
RECMUS.txt,189157,190171,1014,10,N,N,-,-1,-1
RECMUS.txt,189182,190255,1073,10,N,N,-,-1,-1
RECMUS.txt,189331,190454,1123,10,N,N,-,-1,-1
RECMUS.txt,189528,190505,977,10,N,N,-,-1,-1
RECMUS.txt,189637,190761,1124,10,N,N,-,-1,-1
RECMUS.txt,189677,190823,1146,10,N,N,-,-1,-1
RECMUS.txt,189705,191203,1498,10,N,N,-,-1,-1
RECMUS.txt,189854,191594,1740,10,N,N,-,-1,-1
RECMUS.txt,189956,191704,1748,10,N,N,-,-1,-1
RECMUS.txt,190041,191954,1913,10,N,N,-,-1,-1
RECMUS.txt,190174,192118,1944,10,N,N,-,-1,-1
RECMUS.txt,190256,192217,1961,10,N,N,-,-1,-1
RECMUS.txt,190455,192414,1959,10,Y,N,-,-1,-1
RECMUS.txt,190508,192634,2126,10,Y,N,-,-1,-1
RECMUS.txt,190762,192716,1954,10,N,N,-,-1,-1
RECMUS.txt,190824,192856,2032,10,Y,N,-,-1,-1
RECMUS.txt,191204,192997,1793,10,Y,N,-,-1,-1
RECMUS.txt,191595,193129,1534,10,Y,N,-,-1,-1
RECMUS.txt,191705,193244,1539,10,Y,N,-,-1,-1
RECMUS.txt,191955,193488,1533,10,Y,N,-,-1,-1
RECMUS.txt,192119,193774,1655,10,Y,N,-,-1,-1
RECMUS.txt,192220,193886,1666,10,Y,N,-,-1,-1
RECMUS.txt,192415,194135,1720,10,Y,N,-,-1,-1
RECMUS.txt,192635,194340,1705,10,Y,N,-,-1,-1
RECMUS.txt,192717,194393,1676,10,Y,N,-,-1,-1
RECMUS.txt,192857,194464,1607,10,Y,N,-,-1,-1
RECMUS.txt,192998,194479,1481,10,Y,N,-,-1,-1
RECMUS.txt,193130,194542,1412,10,Y,N,-,-1,-1
RECMUS.txt,193245,194814,1569,10,N,N,-,-1,-1
RECMUS.txt,193489,194920,1431,10,N,N,-,-1,-1
RECMUS.txt,193775,195005,1230,10,N,N,-,-1,-1
RECMUS.txt,193889,195075,1186,10,N,N,-,-1,-1
RECMUS.txt,194136,195122,986,10,N,N,-,-1,-1
RECMUS.txt,194341,195262,921,10,N,N,-,-1,-1
RECMUS.txt,194396,195268,872,10,N,N,-,-1,-1
RECMUS.txt,194465,195321,856,10,N,N,-,-1,-1
RECMUS.txt,194480,195353,873,10,N,N,-,-1,-1
RECMUS.txt,194543,195615,1072,10,N,N,-,-1,-1
RECMUS.txt,194815,195797,982,10,N,N,-,-1,-1
RECMUS.txt,194921,195807,886,10,N,N,-,-1,-1
RECMUS.txt,195008,195964,956,10,N,N,-,-1,-1
RECMUS.txt,195077,196136,1059,10,Y,N,-,-1,-1
RECMUS.txt,195125,196708,1583,10,Y,Y,1436867017136,105674,106651
RECMUS.txt,195263,196957,1694,10,Y,Y,1436867017136,105674,106651
RECMUS.txt,195270,197270,2000,10,Y,Y,1436867017136,105674,106651
RECMUS.txt,195323,197323,2000,10,Y,Y,1436867017136,105674,106651
RECMUS.txt,195356,197645,2289,10,Y,Y,1436867017136,105674,106651
RECMUS.txt,195616,197810,2194,10,Y,Y,1436867017136,105674,106651
RECMUS.txt,195800,197819,2019,10,Y,Y,1436867017136,105674,106651
RECMUS.txt,195808,197875,2067,10,Y,Y,1436867017136,105674,106651
RECMUS.txt,195965,198214,2249,10,Y,Y,1436867017136,105674,106651
RECMUS.txt,196139,198393,2254,10,Y,Y,1436867017136,105674,106651
RECMUS.txt,196709,198517,1808,10,Y,Y,1436867017136,105674,106651
RECMUS.txt,196958,198544,1586,10,Y,Y,1436867017136,105674,106651
RECMUS.txt,197271,198626,1355,10,Y,Y,1436867017136,105674,106651
RECMUS.txt,197324,198678,1354,10,N,Y,1436867017136,105674,106651
RECMUS.txt,197646,198736,1090,10,N,Y,1436867017136,105674,106651
RECMUS.txt,197811,198766,955,10,N,Y,1436867017136,105674,106651
RECMUS.txt,197820,198918,1098,10,N,Y,1436867017136,105674,106651
RECMUS.txt,197876,198987,1111,10,N,Y,1436867017136,105674,106651
RECMUS.txt,198215,199135,920,10,N,Y,1436867017136,105674,106651
RECMUS.txt,198395,199182,787,10,N,Y,1436867017136,105674,106651
RECMUS.txt,198519,199330,811,10,N,Y,1436867017136,105674,106651
RECMUS.txt,198545,199623,1078,10,N,Y,1436867017136,105674,106651
RECMUS.txt,198627,199845,1218,10,N,Y,1436867017136,105674,106651
RECMUS.txt,198679,199968,1289,10,N,Y,1436867017136,105674,106651
RECMUS.txt,198737,200097,1360,10,N,Y,1436867017136,105674,106651
RECMUS.txt,198767,200547,1780,10,Y,Y,1436867017136,105674,106651
RECMUS.txt,198919,200609,1690,10,Y,Y,1436867017136,105674,106651
RECMUS.txt,198988,200645,1657,10,Y,Y,1436867017136,105674,106651
RECMUS.txt,199136,200688,1552,10,N,N,-,-1,-1
RECMUS.txt,199183,200977,1794,10,N,N,-,-1,-1
RECMUS.txt,199331,201098,1767,10,N,N,-,-1,-1
RECMUS.txt,199625,201197,1572,10,N,N,-,-1,-1
RECMUS.txt,199846,201247,1401,10,N,N,-,-1,-1
RECMUS.txt,199969,201544,1575,10,N,N,-,-1,-1
RECMUS.txt,200098,201821,1723,10,N,N,-,-1,-1
RECMUS.txt,200548,201850,1302,10,N,N,-,-1,-1
RECMUS.txt,200612,202298,1686,10,N,N,-,-1,-1
RECMUS.txt,200646,202311,1665,10,N,N,-,-1,-1
RECMUS.txt,200689,202380,1691,10,N,N,-,-1,-1
RECMUS.txt,200980,202565,1585,10,N,N,-,-1,-1
RECMUS.txt,201099,202615,1516,10,N,N,-,-1,-1
RECMUS.txt,201198,202680,1482,10,N,N,-,-1,-1
RECMUS.txt,201248,202772,1524,10,N,N,-,-1,-1
RECMUS.txt,201545,202840,1295,10,N,N,-,-1,-1
RECMUS.txt,201822,202952,1130,10,N,N,-,-1,-1
RECMUS.txt,201851,203002,1151,10,N,N,-,-1,-1
RECMUS.txt,202301,203188,887,10,N,N,-,-1,-1
RECMUS.txt,202312,203253,941,10,N,N,-,-1,-1
RECMUS.txt,202381,203315,934,10,N,N,-,-1,-1
RECMUS.txt,202566,203463,897,10,N,N,-,-1,-1
RECMUS.txt,202616,203476,860,10,N,N,-,-1,-1
RECMUS.txt,202681,203653,972,10,N,N,-,-1,-1
RECMUS.txt,202773,203869,1096,10,N,N,-,-1,-1
RECMUS.txt,202841,203992,1151,10,N,N,-,-1,-1
RECMUS.txt,202953,204000,1047,10,N,N,-,-1,-1
RECMUS.txt,203003,204046,1043,10,N,N,-,-1,-1
RECMUS.txt,203190,204092,902,10,N,N,-,-1,-1
RECMUS.txt,203254,204125,871,10,N,N,-,-1,-1
RECMUS.txt,203316,204202,886,10,N,N,-,-1,-1
RECMUS.txt,203466,204287,821,10,N,N,-,-1,-1
RECMUS.txt,203477,204574,1097,10,N,N,-,-1,-1
RECMUS.txt,203654,204717,1063,10,N,N,-,-1,-1
RECMUS.txt,203871,204978,1107,10,N,N,-,-1,-1
RECMUS.txt,203993,205218,1225,10,N,N,-,-1,-1
RECMUS.txt,204001,205308,1307,10,N,N,-,-1,-1
RECMUS.txt,204047,205343,1296,10,N,N,-,-1,-1
RECMUS.txt,204094,205523,1429,10,N,N,-,-1,-1
RECMUS.txt,204126,205576,1450,10,N,N,-,-1,-1
RECMUS.txt,204205,205719,1514,10,N,N,-,-1,-1
RECMUS.txt,204288,205773,1485,10,N,N,-,-1,-1
RECMUS.txt,204575,205938,1363,10,N,N,-,-1,-1
RECMUS.txt,204718,206100,1382,10,N,N,-,-1,-1
RECMUS.txt,204979,206137,1158,10,N,N,-,-1,-1
RECMUS.txt,205219,206318,1099,10,N,N,-,-1,-1
RECMUS.txt,205313,206358,1045,10,N,N,-,-1,-1
RECMUS.txt,205346,206437,1091,10,N,N,-,-1,-1
RECMUS.txt,205525,206657,1132,10,N,N,-,-1,-1
RECMUS.txt,205577,206756,1179,10,N,N,-,-1,-1
RECMUS.txt,205720,206870,1150,10,N,N,-,-1,-1
RECMUS.txt,205776,207012,1236,10,N,N,-,-1,-1
RECMUS.txt,205939,207206,1267,10,N,N,-,-1,-1
RECMUS.txt,206101,207330,1229,10,N,N,-,-1,-1
RECMUS.txt,206140,207477,1337,10,N,N,-,-1,-1
RECMUS.txt,206319,207669,1350,10,N,N,-,-1,-1
RECMUS.txt,206359,207691,1332,10,N,N,-,-1,-1
RECMUS.txt,206438,208145,1707,10,N,N,-,-1,-1
RECMUS.txt,206658,208239,1581,10,N,N,-,-1,-1
RECMUS.txt,206757,208333,1576,10,N,N,-,-1,-1
RECMUS.txt,206873,208381,1508,10,N,N,-,-1,-1
RECMUS.txt,207013,208510,1497,10,N,N,-,-1,-1
RECMUS.txt,207207,208702,1495,10,N,N,-,-1,-1
RECMUS.txt,207331,208927,1596,10,N,N,-,-1,-1
RECMUS.txt,207478,209083,1605,10,N,N,-,-1,-1
RECMUS.txt,207674,209136,1462,10,N,N,-,-1,-1
RECMUS.txt,207696,209417,1721,10,N,N,-,-1,-1
RECMUS.txt,208146,209648,1502,10,N,N,-,-1,-1
RECMUS.txt,208240,209752,1512,10,N,N,-,-1,-1
RECMUS.txt,208335,209848,1513,10,N,N,-,-1,-1
RECMUS.txt,208382,210014,1632,10,N,N,-,-1,-1
RECMUS.txt,208512,210075,1563,10,N,N,-,-1,-1
RECMUS.txt,208705,210143,1438,10,N,N,-,-1,-1
RECMUS.txt,208928,210367,1439,10,N,N,-,-1,-1
RECMUS.txt,209084,210402,1318,10,N,N,-,-1,-1
RECMUS.txt,209137,210532,1395,10,N,N,-,-1,-1
RECMUS.txt,209418,210669,1251,10,N,N,-,-1,-1
RECMUS.txt,209649,210866,1217,10,N,N,-,-1,-1
RECMUS.txt,209753,211011,1258,10,N,N,-,-1,-1
RECMUS.txt,209849,211098,1249,10,N,N,-,-1,-1
RECMUS.txt,210015,211140,1125,10,N,N,-,-1,-1
RECMUS.txt,210080,211226,1146,10,N,N,-,-1,-1
RECMUS.txt,210144,211260,1116,10,N,N,-,-1,-1
RECMUS.txt,210369,211455,1086,10,N,N,-,-1,-1
RECMUS.txt,210403,211473,1070,10,N,N,-,-1,-1
RECMUS.txt,210533,211574,1041,10,N,N,-,-1,-1
RECMUS.txt,210670,211622,952,10,N,N,-,-1,-1
RECMUS.txt,210867,211717,850,10,N,N,-,-1,-1
RECMUS.txt,211016,211834,818,10,N,N,-,-1,-1
RECMUS.txt,211103,211849,746,10,N,N,-,-1,-1
RECMUS.txt,211141,211917,776,10,N,N,-,-1,-1
RECMUS.txt,211227,212067,840,10,N,N,-,-1,-1
RECMUS.txt,211261,212255,994,10,N,N,-,-1,-1
RECMUS.txt,211458,212381,923,10,N,N,-,-1,-1
RECMUS.txt,211474,212399,925,10,N,N,-,-1,-1
RECMUS.txt,211575,212421,846,10,N,N,-,-1,-1
RECMUS.txt,211623,212575,952,10,N,N,-,-1,-1
RECMUS.txt,211720,212692,972,10,N,N,-,-1,-1
RECMUS.txt,211835,212827,992,10,N,N,-,-1,-1
RECMUS.txt,211850,213023,1173,10,N,N,-,-1,-1
RECMUS.txt,211918,213055,1137,10,N,N,-,-1,-1
RECMUS.txt,212070,213253,1183,10,N,N,-,-1,-1
RECMUS.txt,212256,213360,1104,10,N,N,-,-1,-1
RECMUS.txt,212384,213541,1157,10,N,N,-,-1,-1
RECMUS.txt,212400,213724,1324,10,N,N,-,-1,-1
RECMUS.txt,212422,213769,1347,10,N,N,-,-1,-1
RECMUS.txt,212576,213781,1205,10,N,N,-,-1,-1
RECMUS.txt,212693,213975,1282,10,N,N,-,-1,-1
RECMUS.txt,212828,214053,1225,10,N,N,-,-1,-1
RECMUS.txt,213024,214187,1163,10,N,N,-,-1,-1
RECMUS.txt,213055,214335,1280,10,N,N,-,-1,-1
RECMUS.txt,213256,214381,1125,10,N,N,-,-1,-1
RECMUS.txt,213361,214620,1259,10,N,N,-,-1,-1
RECMUS.txt,213543,214792,1249,10,N,N,-,-1,-1
RECMUS.txt,213729,215129,1400,10,N,N,-,-1,-1
RECMUS.txt,213770,215271,1501,10,N,N,-,-1,-1
RECMUS.txt,213782,215341,1559,10,N,N,-,-1,-1
RECMUS.txt,213976,215547,1571,10,N,N,-,-1,-1
RECMUS.txt,214054,215661,1607,10,Y,N,-,-1,-1
RECMUS.txt,214189,215688,1499,10,N,N,-,-1,-1
RECMUS.txt,214336,215778,1442,10,Y,N,-,-1,-1
RECMUS.txt,214382,215932,1550,10,Y,N,-,-1,-1
RECMUS.txt,214621,215954,1333,10,Y,N,-,-1,-1
RECMUS.txt,214795,216175,1380,10,N,N,-,-1,-1
RECMUS.txt,215132,216355,1223,10,N,N,-,-1,-1
RECMUS.txt,215272,216655,1383,10,N,N,-,-1,-1
RECMUS.txt,215342,216862,1520,10,N,N,-,-1,-1
RECMUS.txt,215550,216903,1353,10,N,N,-,-1,-1
RECMUS.txt,215663,216981,1318,10,N,N,-,-1,-1
RECMUS.txt,215689,217056,1367,10,N,N,-,-1,-1
RECMUS.txt,215781,217175,1394,10,N,N,-,-1,-1
RECMUS.txt,215937,217252,1315,10,N,N,-,-1,-1
RECMUS.txt,215957,217507,1550,10,N,N,-,-1,-1
RECMUS.txt,216175,217564,1389,10,N,N,-,-1,-1
RECMUS.txt,216358,217792,1434,10,N,N,-,-1,-1
RECMUS.txt,216658,217909,1251,10,N,N,-,-1,-1
RECMUS.txt,216863,218073,1210,10,N,N,-,-1,-1
RECMUS.txt,216904,218184,1280,10,N,N,-,-1,-1
RECMUS.txt,216982,218374,1392,10,N,N,-,-1,-1
RECMUS.txt,217057,218519,1462,10,N,N,-,-1,-1
RECMUS.txt,217177,218615,1438,10,N,N,-,-1,-1
RECMUS.txt,217253,218860,1607,10,N,N,-,-1,-1
RECMUS.txt,217508,218935,1427,10,N,N,-,-1,-1
RECMUS.txt,217565,218970,1405,10,N,N,-,-1,-1
RECMUS.txt,217795,219474,1679,10,Y,N,-,-1,-1
RECMUS.txt,217911,219587,1676,10,Y,N,-,-1,-1
RECMUS.txt,218074,219614,1540,10,Y,N,-,-1,-1
RECMUS.txt,218185,219895,1710,10,Y,N,-,-1,-1
RECMUS.txt,218376,219961,1585,10,Y,N,-,-1,-1
RECMUS.txt,218520,219984,1464,10,Y,N,-,-1,-1
RECMUS.txt,218618,220106,1488,10,Y,N,-,-1,-1
RECMUS.txt,218861,220152,1291,10,Y,N,-,-1,-1
RECMUS.txt,218936,220339,1403,10,Y,N,-,-1,-1
RECMUS.txt,218972,220924,1952,10,Y,N,-,-1,-1
RECMUS.txt,219475,221046,1571,10,N,N,-,-1,-1
RECMUS.txt,219588,221277,1689,10,N,N,-,-1,-1
RECMUS.txt,219615,221327,1712,10,N,N,-,-1,-1
RECMUS.txt,219896,221449,1553,10,N,N,-,-1,-1
RECMUS.txt,219963,221628,1665,10,N,N,-,-1,-1
RECMUS.txt,219985,221903,1918,10,N,N,-,-1,-1
RECMUS.txt,220107,222006,1899,10,N,N,-,-1,-1
RECMUS.txt,220157,222178,2021,10,Y,N,-,-1,-1
RECMUS.txt,220341,222414,2073,10,N,N,-,-1,-1
RECMUS.txt,220925,222482,1557,10,N,N,-,-1,-1
RECMUS.txt,221047,222539,1492,10,N,N,-,-1,-1
RECMUS.txt,221278,222616,1338,10,N,N,-,-1,-1
RECMUS.txt,221328,222718,1390,10,N,N,-,-1,-1
RECMUS.txt,221450,222734,1284,10,N,N,-,-1,-1
RECMUS.txt,221631,222881,1250,10,N,N,-,-1,-1
RECMUS.txt,221904,223066,1162,10,N,N,-,-1,-1
RECMUS.txt,222007,223146,1139,10,N,N,-,-1,-1
RECMUS.txt,222179,223238,1059,10,N,N,-,-1,-1
RECMUS.txt,222415,223629,1214,10,N,N,-,-1,-1
RECMUS.txt,222483,223654,1171,10,N,N,-,-1,-1
RECMUS.txt,222540,223745,1205,10,N,N,-,-1,-1
RECMUS.txt,222621,223774,1153,10,N,N,-,-1,-1
RECMUS.txt,222719,223800,1081,10,N,N,-,-1,-1
RECMUS.txt,222735,223857,1122,10,N,N,-,-1,-1
RECMUS.txt,222882,223935,1053,10,N,N,-,-1,-1
RECMUS.txt,223067,224182,1115,10,N,N,-,-1,-1
RECMUS.txt,223147,224243,1096,10,N,N,-,-1,-1
RECMUS.txt,223239,224431,1192,10,N,N,-,-1,-1
RECMUS.txt,223630,224476,846,10,N,N,-,-1,-1
RECMUS.txt,223655,224633,978,10,N,N,-,-1,-1
RECMUS.txt,223746,224731,985,10,N,N,-,-1,-1
RECMUS.txt,223775,224865,1090,10,N,N,-,-1,-1
RECMUS.txt,223801,224959,1158,10,N,N,-,-1,-1
RECMUS.txt,223858,224978,1120,10,N,N,-,-1,-1
RECMUS.txt,223938,225007,1069,10,N,N,-,-1,-1
RECMUS.txt,224183,225093,910,10,N,N,-,-1,-1
RECMUS.txt,224246,225254,1008,10,N,N,-,-1,-1
RECMUS.txt,224432,225303,871,10,N,N,-,-1,-1
RECMUS.txt,224477,225334,857,10,N,N,-,-1,-1
RECMUS.txt,224636,225805,1169,10,N,N,-,-1,-1
RECMUS.txt,224732,225833,1101,10,N,N,-,-1,-1
RECMUS.txt,224866,225984,1118,10,N,N,-,-1,-1
RECMUS.txt,224964,226143,1179,10,N,N,-,-1,-1
RECMUS.txt,224979,226252,1273,10,N,N,-,-1,-1
RECMUS.txt,225008,226385,1377,10,N,N,-,-1,-1
RECMUS.txt,225094,226413,1319,10,N,N,-,-1,-1
RECMUS.txt,225255,226482,1227,10,N,N,-,-1,-1
RECMUS.txt,225304,226517,1213,10,N,N,-,-1,-1
RECMUS.txt,225337,226554,1217,10,N,N,-,-1,-1
RECMUS.txt,225805,226615,810,10,N,N,-,-1,-1
RECMUS.txt,225834,226690,856,10,N,N,-,-1,-1
RECMUS.txt,225985,226812,827,10,N,N,-,-1,-1
RECMUS.txt,226144,226984,840,10,N,N,-,-1,-1
RECMUS.txt,226254,227084,830,10,N,N,-,-1,-1
RECMUS.txt,226386,227205,819,10,N,N,-,-1,-1
RECMUS.txt,226414,227249,835,10,N,N,-,-1,-1
RECMUS.txt,226483,227325,842,10,N,N,-,-1,-1
RECMUS.txt,226518,227430,912,10,N,N,-,-1,-1
RECMUS.txt,226555,227497,942,10,N,N,-,-1,-1
RECMUS.txt,226616,227633,1017,10,N,N,-,-1,-1
RECMUS.txt,226691,227663,972,10,N,N,-,-1,-1
RECMUS.txt,226813,227814,1001,10,N,N,-,-1,-1
RECMUS.txt,226985,227992,1007,10,N,N,-,-1,-1
RECMUS.txt,227085,228075,990,10,N,N,-,-1,-1
RECMUS.txt,227206,228209,1003,10,N,N,-,-1,-1
RECMUS.txt,227254,228470,1216,10,N,N,-,-1,-1
RECMUS.txt,227326,228568,1242,10,N,N,-,-1,-1
RECMUS.txt,227431,228648,1217,10,N,N,-,-1,-1
RECMUS.txt,227500,228754,1254,10,N,N,-,-1,-1
RECMUS.txt,227636,229026,1390,10,N,N,-,-1,-1
RECMUS.txt,227664,229219,1555,10,N,N,-,-1,-1
RECMUS.txt,227815,229234,1419,10,N,N,-,-1,-1
RECMUS.txt,227993,229287,1294,10,N,N,-,-1,-1
RECMUS.txt,228076,229394,1318,10,N,N,-,-1,-1
RECMUS.txt,228212,229573,1361,10,N,N,-,-1,-1
RECMUS.txt,228471,229758,1287,10,N,N,-,-1,-1
RECMUS.txt,228569,229903,1334,10,N,N,-,-1,-1
RECMUS.txt,228649,230337,1688,10,N,N,-,-1,-1
RECMUS.txt,228755,230504,1749,10,N,N,-,-1,-1
RECMUS.txt,229027,230643,1616,10,N,N,-,-1,-1
RECMUS.txt,229220,230828,1608,10,N,N,-,-1,-1
RECMUS.txt,229235,231027,1792,10,N,N,-,-1,-1
RECMUS.txt,229288,231279,1991,10,N,N,-,-1,-1
RECMUS.txt,229396,231487,2091,10,N,N,-,-1,-1
RECMUS.txt,229575,231660,2085,10,N,N,-,-1,-1
RECMUS.txt,229759,231770,2011,10,N,N,-,-1,-1
RECMUS.txt,229904,231843,1939,10,N,N,-,-1,-1
RECMUS.txt,230338,232153,1815,10,N,N,-,-1,-1
RECMUS.txt,230506,232314,1808,10,N,N,-,-1,-1
RECMUS.txt,230644,232335,1691,10,N,N,-,-1,-1
RECMUS.txt,230829,232394,1565,10,N,N,-,-1,-1
RECMUS.txt,231028,232532,1504,10,N,N,-,-1,-1
RECMUS.txt,231282,232737,1455,10,N,N,-,-1,-1
RECMUS.txt,231488,232855,1367,10,N,N,-,-1,-1
RECMUS.txt,231661,232877,1216,10,N,N,-,-1,-1
RECMUS.txt,231771,232954,1183,10,N,N,-,-1,-1
RECMUS.txt,231844,232988,1144,10,N,N,-,-1,-1
RECMUS.txt,232154,233003,849,10,N,N,-,-1,-1
RECMUS.txt,232315,233313,998,10,N,N,-,-1,-1
RECMUS.txt,232336,233489,1153,10,N,N,-,-1,-1
RECMUS.txt,232395,233540,1145,10,N,N,-,-1,-1
RECMUS.txt,232533,233563,1030,10,N,N,-,-1,-1
RECMUS.txt,232738,233604,866,10,N,N,-,-1,-1
RECMUS.txt,232856,233859,1003,10,N,N,-,-1,-1
RECMUS.txt,232878,233917,1039,10,N,N,-,-1,-1
RECMUS.txt,232955,234165,1210,10,N,N,-,-1,-1
RECMUS.txt,232989,234405,1416,10,N,N,-,-1,-1
RECMUS.txt,233004,234490,1486,10,N,N,-,-1,-1
RECMUS.txt,233314,234538,1224,10,N,N,-,-1,-1
RECMUS.txt,233492,234761,1269,10,N,N,-,-1,-1
RECMUS.txt,233541,235087,1546,10,N,N,-,-1,-1
RECMUS.txt,233564,235321,1757,10,N,N,-,-1,-1
RECMUS.txt,233606,235449,1843,10,N,N,-,-1,-1
RECMUS.txt,233860,235614,1754,10,N,N,-,-1,-1
RECMUS.txt,233918,235637,1719,10,N,N,-,-1,-1
RECMUS.txt,234166,235698,1532,10,N,N,-,-1,-1
RECMUS.txt,234406,235824,1418,10,N,N,-,-1,-1
RECMUS.txt,234491,235933,1442,10,N,N,-,-1,-1
RECMUS.txt,234541,236005,1464,10,N,N,-,-1,-1
RECMUS.txt,234762,236107,1345,10,N,N,-,-1,-1
RECMUS.txt,235088,236254,1166,10,N,N,-,-1,-1
RECMUS.txt,235322,236317,995,10,N,N,-,-1,-1
RECMUS.txt,235452,236482,1030,10,N,N,-,-1,-1
RECMUS.txt,235615,236580,965,10,N,N,-,-1,-1
RECMUS.txt,235638,236671,1033,10,N,N,-,-1,-1
RECMUS.txt,235699,236877,1178,10,N,N,-,-1,-1
RECMUS.txt,235825,237095,1270,10,N,N,-,-1,-1
RECMUS.txt,235934,237305,1371,10,N,N,-,-1,-1
RECMUS.txt,236008,237469,1461,10,N,N,-,-1,-1
RECMUS.txt,236108,237502,1394,10,N,N,-,-1,-1
RECMUS.txt,236257,237655,1398,10,N,N,-,-1,-1
RECMUS.txt,236320,237728,1408,10,N,N,-,-1,-1
RECMUS.txt,236483,237931,1448,10,N,N,-,-1,-1
RECMUS.txt,236581,237966,1385,10,N,N,-,-1,-1
RECMUS.txt,236674,238019,1345,10,N,N,-,-1,-1
RECMUS.txt,236878,238171,1293,10,N,N,-,-1,-1
RECMUS.txt,237096,238280,1184,10,N,N,-,-1,-1
RECMUS.txt,237306,238372,1066,10,N,N,-,-1,-1
RECMUS.txt,237472,238465,993,10,N,N,-,-1,-1
RECMUS.txt,237503,238524,1021,10,N,N,-,-1,-1
RECMUS.txt,237656,238531,875,10,N,N,-,-1,-1
RECMUS.txt,237729,238538,809,10,N,N,-,-1,-1
RECMUS.txt,237932,238607,675,10,N,N,-,-1,-1
RECMUS.txt,237967,238650,683,10,N,N,-,-1,-1
RECMUS.txt,238020,238662,642,10,N,N,-,-1,-1
RECMUS.txt,238172,238803,631,10,N,N,-,-1,-1
RECMUS.txt,238280,238963,683,10,N,N,-,-1,-1
RECMUS.txt,238373,239107,734,10,N,N,-,-1,-1
RECMUS.txt,238466,239186,720,10,N,N,-,-1,-1
RECMUS.txt,238525,239344,819,10,N,N,-,-1,-1
RECMUS.txt,238532,239519,987,10,N,N,-,-1,-1
RECMUS.txt,238539,239756,1217,10,N,N,-,-1,-1
RECMUS.txt,238608,239852,1244,10,N,N,-,-1,-1
RECMUS.txt,238651,239883,1232,10,N,N,-,-1,-1
RECMUS.txt,238665,239926,1261,10,N,N,-,-1,-1
RECMUS.txt,238804,239968,1164,10,N,N,-,-1,-1
RECMUS.txt,238964,240103,1139,10,N,N,-,-1,-1
RECMUS.txt,239108,240189,1081,10,N,N,-,-1,-1
RECMUS.txt,239187,240384,1197,10,N,N,-,-1,-1
RECMUS.txt,239345,240511,1166,10,N,N,-,-1,-1
RECMUS.txt,239520,240598,1078,10,N,N,-,-1,-1
RECMUS.txt,239758,240719,961,10,N,N,-,-1,-1
RECMUS.txt,239855,240819,964,10,N,N,-,-1,-1
RECMUS.txt,239884,240914,1030,10,N,N,-,-1,-1
RECMUS.txt,239927,241023,1096,10,N,N,-,-1,-1
RECMUS.txt,239970,241204,1234,10,N,N,-,-1,-1
RECMUS.txt,240104,241222,1118,10,N,N,-,-1,-1
RECMUS.txt,240192,241434,1242,10,N,N,-,-1,-1
RECMUS.txt,240384,241632,1248,10,N,N,-,-1,-1
RECMUS.txt,240512,241754,1242,10,N,N,-,-1,-1
RECMUS.txt,240599,241792,1193,10,N,N,-,-1,-1
RECMUS.txt,240720,241876,1156,10,N,N,-,-1,-1
RECMUS.txt,240820,242010,1190,10,N,N,-,-1,-1
RECMUS.txt,240915,242316,1401,10,N,N,-,-1,-1
RECMUS.txt,241024,242439,1415,10,N,N,-,-1,-1
RECMUS.txt,241204,242513,1309,10,N,N,-,-1,-1
RECMUS.txt,241223,242558,1335,10,N,N,-,-1,-1
RECMUS.txt,241435,242588,1153,10,N,N,-,-1,-1
RECMUS.txt,241633,242646,1013,10,N,N,-,-1,-1
RECMUS.txt,241755,242744,989,10,N,N,-,-1,-1
RECMUS.txt,241793,243065,1272,10,N,N,-,-1,-1
RECMUS.txt,241877,243160,1283,10,N,N,-,-1,-1
RECMUS.txt,242011,243182,1171,10,N,N,-,-1,-1
RECMUS.txt,242317,243291,974,10,N,N,-,-1,-1
RECMUS.txt,242441,243442,1001,10,N,N,-,-1,-1
RECMUS.txt,242513,243564,1051,10,N,N,-,-1,-1
RECMUS.txt,242563,243600,1037,10,N,N,-,-1,-1
RECMUS.txt,242593,244051,1458,10,N,N,-,-1,-1
RECMUS.txt,242647,244142,1495,10,N,N,-,-1,-1
RECMUS.txt,242745,244268,1523,10,N,N,-,-1,-1
RECMUS.txt,243066,244305,1239,10,N,N,-,-1,-1
RECMUS.txt,243160,244378,1218,10,N,N,-,-1,-1
RECMUS.txt,243183,244409,1226,10,N,N,-,-1,-1
RECMUS.txt,243293,244534,1241,10,N,N,-,-1,-1
RECMUS.txt,243443,244661,1218,10,N,N,-,-1,-1
RECMUS.txt,243567,244737,1170,10,N,N,-,-1,-1
RECMUS.txt,243603,244901,1298,10,N,N,-,-1,-1
RECMUS.txt,244052,245088,1036,10,N,N,-,-1,-1
RECMUS.txt,244145,245354,1209,10,N,N,-,-1,-1
RECMUS.txt,244269,245597,1328,10,N,N,-,-1,-1
RECMUS.txt,244306,245746,1440,10,N,N,-,-1,-1
RECMUS.txt,244381,245872,1491,10,N,N,-,-1,-1
RECMUS.txt,244412,246004,1592,10,N,N,-,-1,-1
RECMUS.txt,244535,246045,1510,10,N,N,-,-1,-1
RECMUS.txt,244662,246126,1464,10,N,N,-,-1,-1
RECMUS.txt,244742,246237,1495,10,N,N,-,-1,-1
RECMUS.txt,244902,246484,1582,10,N,N,-,-1,-1
RECMUS.txt,245089,246565,1476,10,N,N,-,-1,-1
RECMUS.txt,245355,246655,1300,10,N,N,-,-1,-1
RECMUS.txt,245599,246934,1335,10,N,N,-,-1,-1
RECMUS.txt,245747,247033,1286,10,N,N,-,-1,-1
RECMUS.txt,245873,247195,1322,10,N,N,-,-1,-1
RECMUS.txt,246005,247362,1357,10,N,N,-,-1,-1
RECMUS.txt,246046,247540,1494,10,N,N,-,-1,-1
RECMUS.txt,246127,247701,1574,10,N,N,-,-1,-1
RECMUS.txt,246240,247832,1592,10,N,N,-,-1,-1
RECMUS.txt,246485,248007,1522,10,N,N,-,-1,-1
RECMUS.txt,246570,248113,1543,10,N,N,-,-1,-1
RECMUS.txt,246657,248152,1495,10,N,N,-,-1,-1
RECMUS.txt,246935,248276,1341,10,N,N,-,-1,-1
RECMUS.txt,247034,248344,1310,10,N,N,-,-1,-1
RECMUS.txt,247196,248380,1184,10,N,N,-,-1,-1
RECMUS.txt,247363,248546,1183,10,N,N,-,-1,-1
RECMUS.txt,247541,248659,1118,10,N,N,-,-1,-1
RECMUS.txt,247702,248875,1173,10,N,N,-,-1,-1
RECMUS.txt,247833,249002,1169,10,N,N,-,-1,-1
RECMUS.txt,248008,249167,1159,10,N,N,-,-1,-1
RECMUS.txt,248114,249294,1180,10,N,N,-,-1,-1
RECMUS.txt,248153,249384,1231,10,N,N,-,-1,-1
RECMUS.txt,248277,249613,1336,10,N,N,-,-1,-1
RECMUS.txt,248349,249846,1497,10,N,N,-,-1,-1
RECMUS.txt,248383,250220,1837,10,N,N,-,-1,-1
RECMUS.txt,248547,250332,1785,10,N,N,-,-1,-1
RECMUS.txt,248660,250430,1770,10,N,N,-,-1,-1
RECMUS.txt,248876,250586,1710,10,N,N,-,-1,-1
RECMUS.txt,249003,250729,1726,10,N,N,-,-1,-1
RECMUS.txt,249168,250823,1655,10,N,N,-,-1,-1
RECMUS.txt,249295,250879,1584,10,N,N,-,-1,-1
RECMUS.txt,249385,250985,1600,10,N,N,-,-1,-1
RECMUS.txt,249614,251063,1449,10,N,N,-,-1,-1
RECMUS.txt,249847,251160,1313,10,N,N,-,-1,-1
RECMUS.txt,250221,251379,1158,10,N,N,-,-1,-1
RECMUS.txt,250333,251465,1132,10,N,N,-,-1,-1
RECMUS.txt,250431,251629,1198,10,N,N,-,-1,-1
RECMUS.txt,250587,251756,1169,10,N,N,-,-1,-1
RECMUS.txt,250730,251865,1135,10,N,N,-,-1,-1
RECMUS.txt,250828,251949,1121,10,N,N,-,-1,-1
RECMUS.txt,250880,252067,1187,10,N,N,-,-1,-1
RECMUS.txt,250986,252157,1171,10,N,N,-,-1,-1
RECMUS.txt,251064,252235,1171,10,N,N,-,-1,-1
RECMUS.txt,251161,252252,1091,10,N,N,-,-1,-1
RECMUS.txt,251380,252279,899,10,N,N,-,-1,-1
RECMUS.txt,251466,252443,977,10,N,N,-,-1,-1
RECMUS.txt,251632,252500,868,10,N,N,-,-1,-1
RECMUS.txt,251757,252565,808,10,N,N,-,-1,-1
RECMUS.txt,251866,252640,774,10,N,N,-,-1,-1
RECMUS.txt,251952,252661,709,10,N,N,-,-1,-1
RECMUS.txt,252068,252695,627,10,N,N,-,-1,-1
RECMUS.txt,252158,252707,549,10,N,N,-,-1,-1
RECMUS.txt,252236,252797,561,10,N,N,-,-1,-1
RECMUS.txt,252253,252827,574,10,N,N,-,-1,-1
RECMUS.txt,252280,252927,647,10,N,N,-,-1,-1
RECMUS.txt,252444,253043,599,10,N,N,-,-1,-1
RECMUS.txt,252501,253115,614,10,N,N,-,-1,-1
RECMUS.txt,252566,253179,613,10,N,N,-,-1,-1
RECMUS.txt,252641,253467,826,10,N,N,-,-1,-1
RECMUS.txt,252662,253686,1024,10,N,N,-,-1,-1
RECMUS.txt,252696,253948,1252,10,N,N,-,-1,-1
RECMUS.txt,252710,254074,1364,10,N,N,-,-1,-1
RECMUS.txt,252798,254261,1463,10,N,N,-,-1,-1
RECMUS.txt,252828,254310,1482,10,N,N,-,-1,-1
RECMUS.txt,252930,254365,1435,10,N,N,-,-1,-1
RECMUS.txt,253044,254503,1459,10,N,N,-,-1,-1
RECMUS.txt,253116,254630,1514,10,N,N,-,-1,-1
RECMUS.txt,253180,254685,1505,10,N,N,-,-1,-1
RECMUS.txt,253468,254784,1316,10,N,N,-,-1,-1
RECMUS.txt,253687,254858,1171,10,N,N,-,-1,-1
RECMUS.txt,253949,254949,1000,10,N,N,-,-1,-1
RECMUS.txt,254075,255068,993,10,N,N,-,-1,-1
RECMUS.txt,254262,255148,886,10,N,N,-,-1,-1
RECMUS.txt,254311,255171,860,10,N,N,-,-1,-1
RECMUS.txt,254366,255210,844,10,N,N,-,-1,-1
RECMUS.txt,254504,255425,921,10,N,N,-,-1,-1
RECMUS.txt,254631,255568,937,10,N,N,-,-1,-1
RECMUS.txt,254686,255679,993,10,N,N,-,-1,-1
RECMUS.txt,254785,255815,1030,10,N,N,-,-1,-1
RECMUS.txt,254859,255912,1053,10,N,N,-,-1,-1
RECMUS.txt,254950,256030,1080,10,N,N,-,-1,-1
RECMUS.txt,255069,256104,1035,10,N,N,-,-1,-1
RECMUS.txt,255149,256116,967,10,N,N,-,-1,-1
RECMUS.txt,255176,256166,990,10,N,N,-,-1,-1
RECMUS.txt,255215,256187,972,10,N,N,-,-1,-1
RECMUS.txt,255430,256207,777,10,N,N,-,-1,-1
RECMUS.txt,255571,256366,795,10,N,N,-,-1,-1
RECMUS.txt,255684,256443,759,10,N,N,-,-1,-1
RECMUS.txt,255818,256569,751,10,N,N,-,-1,-1
RECMUS.txt,255915,256746,831,10,N,N,-,-1,-1
RECMUS.txt,256033,256886,853,10,N,N,-,-1,-1
RECMUS.txt,256105,257039,934,10,N,N,-,-1,-1
RECMUS.txt,256121,257067,946,10,N,N,-,-1,-1
RECMUS.txt,256168,257170,1002,10,N,N,-,-1,-1
RECMUS.txt,256189,257341,1152,10,N,N,-,-1,-1
RECMUS.txt,256210,257442,1232,10,N,N,-,-1,-1
RECMUS.txt,256371,257490,1119,10,N,N,-,-1,-1
RECMUS.txt,256443,257697,1254,10,N,N,-,-1,-1
RECMUS.txt,256572,257852,1280,10,N,N,-,-1,-1
RECMUS.txt,256749,257900,1151,10,N,N,-,-1,-1
RECMUS.txt,256889,258139,1250,10,N,N,-,-1,-1
RECMUS.txt,257044,258169,1125,10,N,N,-,-1,-1
RECMUS.txt,257070,258192,1122,10,N,N,-,-1,-1
RECMUS.txt,257172,258282,1110,10,N,N,-,-1,-1
RECMUS.txt,257344,258365,1021,10,N,N,-,-1,-1
RECMUS.txt,257445,258454,1009,10,N,N,-,-1,-1
RECMUS.txt,257493,258611,1118,10,N,N,-,-1,-1
RECMUS.txt,257700,258722,1022,10,N,N,-,-1,-1
RECMUS.txt,257854,258793,939,10,N,N,-,-1,-1
RECMUS.txt,257903,259079,1176,10,N,N,-,-1,-1
RECMUS.txt,258140,259167,1027,10,N,N,-,-1,-1
RECMUS.txt,258172,259255,1083,10,N,N,-,-1,-1
RECMUS.txt,258195,259268,1073,10,N,N,-,-1,-1
RECMUS.txt,258284,259294,1010,10,N,N,-,-1,-1
RECMUS.txt,258367,259446,1079,10,N,N,-,-1,-1
RECMUS.txt,258457,259598,1141,10,N,N,-,-1,-1
RECMUS.txt,258613,259736,1123,10,N,N,-,-1,-1
RECMUS.txt,258723,259879,1156,10,N,N,-,-1,-1
RECMUS.txt,258795,259911,1116,10,N,N,-,-1,-1
RECMUS.txt,259082,260064,982,10,N,N,-,-1,-1
RECMUS.txt,259170,260078,908,10,N,N,-,-1,-1
RECMUS.txt,259258,260079,821,10,N,N,-,-1,-1
RECMUS.txt,259273,260201,928,10,N,N,-,-1,-1
RECMUS.txt,259297,260259,962,10,N,N,-,-1,-1
RECMUS.txt,259449,260266,817,10,N,N,-,-1,-1
RECMUS.txt,259601,260309,708,10,N,N,-,-1,-1
RECMUS.txt,259738,260394,656,10,N,N,-,-1,-1
RECMUS.txt,259884,260659,775,10,N,N,-,-1,-1
RECMUS.txt,259914,260808,894,10,N,N,-,-1,-1
RECMUS.txt,260067,260862,795,10,N,N,-,-1,-1
RECMUS.txt,260078,261000,922,10,N,N,-,-1,-1
RECMUS.txt,260079,261132,1053,10,N,N,-,-1,-1
RECMUS.txt,260206,261248,1042,10,N,N,-,-1,-1
RECMUS.txt,260262,261427,1165,10,N,N,-,-1,-1
RECMUS.txt,260267,261563,1296,10,N,N,-,-1,-1
RECMUS.txt,260311,261830,1519,10,N,N,-,-1,-1
RECMUS.txt,260396,261913,1517,10,N,N,-,-1,-1
RECMUS.txt,260660,262006,1346,10,N,N,-,-1,-1
RECMUS.txt,260809,262117,1308,10,N,N,-,-1,-1
RECMUS.txt,260863,262215,1352,10,N,N,-,-1,-1
RECMUS.txt,261001,262293,1292,10,N,N,-,-1,-1
RECMUS.txt,261133,262403,1270,10,N,N,-,-1,-1
RECMUS.txt,261249,262432,1183,10,N,N,-,-1,-1
RECMUS.txt,261428,262557,1129,10,N,N,-,-1,-1
RECMUS.txt,261564,262658,1094,10,N,N,-,-1,-1
RECMUS.txt,261831,262774,943,10,N,N,-,-1,-1
RECMUS.txt,261918,262875,957,10,N,Y,1448275023016,26258,26837
RECMUS.txt,262007,262960,953,10,N,Y,1448275023016,26258,26837
RECMUS.txt,262118,262989,871,10,N,Y,1448275023016,26258,26837
RECMUS.txt,262218,263047,829,10,N,Y,1448275023016,26258,26837
RECMUS.txt,262294,263160,866,10,N,Y,1448275023016,26258,26837
RECMUS.txt,262404,263497,1093,10,N,Y,1448275023016,26258,26837
RECMUS.txt,262433,263774,1341,10,N,Y,1448275023016,26258,26837
RECMUS.txt,262558,264228,1670,10,N,Y,1448275023016,26258,26837
RECMUS.txt,262659,264268,1609,10,N,Y,1448275023016,26258,26837
RECMUS.txt,262777,264462,1685,10,N,Y,1448275023016,26258,26837
RECMUS.txt,262876,264514,1638,10,N,Y,1448275023016,26258,26837
RECMUS.txt,262961,264585,1624,10,N,Y,1448275023016,26258,26837
RECMUS.txt,262990,264624,1634,10,N,Y,1448275023016,26258,26837
RECMUS.txt,263050,264754,1704,10,N,N,-,-1,-1
RECMUS.txt,263161,264879,1718,10,N,N,-,-1,-1
RECMUS.txt,263498,265109,1611,10,N,N,-,-1,-1
RECMUS.txt,263775,265155,1380,10,N,N,-,-1,-1
RECMUS.txt,264233,265252,1019,10,N,N,-,-1,-1
RECMUS.txt,264273,265455,1182,10,N,N,-,-1,-1
RECMUS.txt,264463,265631,1168,10,N,N,-,-1,-1
RECMUS.txt,264516,265806,1290,10,N,N,-,-1,-1
RECMUS.txt,264586,266047,1461,10,N,N,-,-1,-1
RECMUS.txt,264625,266116,1491,10,N,N,-,-1,-1
RECMUS.txt,264756,266274,1518,10,N,N,-,-1,-1
RECMUS.txt,264880,266288,1408,10,N,N,-,-1,-1
RECMUS.txt,265111,266306,1195,10,N,N,-,-1,-1
RECMUS.txt,265156,266358,1202,10,N,N,-,-1,-1
RECMUS.txt,265253,266408,1155,10,N,N,-,-1,-1
RECMUS.txt,265456,266438,982,10,N,N,-,-1,-1
RECMUS.txt,265632,266543,911,10,N,N,-,-1,-1
RECMUS.txt,265808,266661,853,10,N,N,-,-1,-1
RECMUS.txt,266048,266822,774,10,N,N,-,-1,-1
RECMUS.txt,266117,266955,838,10,N,N,-,-1,-1
RECMUS.txt,266275,267270,995,10,N,N,-,-1,-1
RECMUS.txt,266289,267593,1304,10,N,N,-,-1,-1
RECMUS.txt,266307,267783,1476,10,N,N,-,-1,-1
RECMUS.txt,266360,268118,1758,10,N,N,-,-1,-1
RECMUS.txt,266413,268292,1879,10,N,N,-,-1,-1
RECMUS.txt,266439,268869,2430,10,N,N,-,-1,-1
RECMUS.txt,266544,269120,2576,10,N,N,-,-1,-1
RECMUS.txt,266662,269480,2818,10,N,N,-,-1,-1
RECMUS.txt,266823,269565,2742,10,N,N,-,-1,-1
RECMUS.txt,266957,269794,2837,10,N,N,-,-1,-1
RECMUS.txt,267271,269858,2587,10,N,N,-,-1,-1
RECMUS.txt,267594,270031,2437,10,N,N,-,-1,-1
RECMUS.txt,267784,270113,2329,10,N,N,-,-1,-1
RECMUS.txt,268121,270114,1993,10,N,N,-,-1,-1
RECMUS.txt,268294,270346,2052,10,N,N,-,-1,-1
RECMUS.txt,268871,270597,1726,10,N,N,-,-1,-1
RECMUS.txt,269121,270700,1579,10,N,N,-,-1,-1
RECMUS.txt,269481,270839,1358,10,N,N,-,-1,-1
RECMUS.txt,269568,270904,1336,10,N,N,-,-1,-1
RECMUS.txt,269796,270942,1146,10,N,N,-,-1,-1
RECMUS.txt,269859,270986,1127,10,N,N,-,-1,-1
RECMUS.txt,270032,271060,1028,10,N,N,-,-1,-1
RECMUS.txt,270113,271141,1028,10,N,N,-,-1,-1
RECMUS.txt,270115,271248,1133,10,N,N,-,-1,-1
RECMUS.txt,270347,271418,1071,10,N,N,-,-1,-1
RECMUS.txt,270598,271575,977,10,N,N,-,-1,-1
RECMUS.txt,270701,271746,1045,10,N,N,-,-1,-1
RECMUS.txt,270840,271943,1103,10,N,N,-,-1,-1
RECMUS.txt,270905,272272,1367,10,N,N,-,-1,-1
RECMUS.txt,270943,272407,1464,10,N,N,-,-1,-1
RECMUS.txt,270987,272694,1707,10,N,N,-,-1,-1
RECMUS.txt,271061,272741,1680,10,N,N,-,-1,-1
RECMUS.txt,271142,272917,1775,10,N,N,-,-1,-1
RECMUS.txt,271249,272988,1739,10,N,N,-,-1,-1
RECMUS.txt,271419,273033,1614,10,N,N,-,-1,-1
RECMUS.txt,271576,273109,1533,10,N,N,-,-1,-1
RECMUS.txt,271747,273174,1427,10,N,N,-,-1,-1
RECMUS.txt,271944,273258,1314,10,N,N,-,-1,-1
RECMUS.txt,272273,273318,1045,10,N,N,-,-1,-1
RECMUS.txt,272409,273415,1006,10,N,N,-,-1,-1
RECMUS.txt,272695,273431,736,10,N,N,-,-1,-1
RECMUS.txt,272742,273484,742,10,N,N,-,-1,-1
RECMUS.txt,272918,273519,601,10,N,N,-,-1,-1
RECMUS.txt,272989,273538,549,10,N,N,-,-1,-1
RECMUS.txt,273034,273683,649,10,N,N,-,-1,-1
RECMUS.txt,273110,273758,648,10,N,N,-,-1,-1
RECMUS.txt,273175,273817,642,10,N,N,-,-1,-1
RECMUS.txt,273259,274055,796,10,N,N,-,-1,-1
RECMUS.txt,273319,274167,848,10,N,N,-,-1,-1
RECMUS.txt,273418,274346,928,10,N,N,-,-1,-1
RECMUS.txt,273432,274375,943,10,N,N,-,-1,-1
RECMUS.txt,273485,274553,1068,10,N,N,-,-1,-1
RECMUS.txt,273520,274868,1348,10,N,N,-,-1,-1
RECMUS.txt,273539,274912,1373,10,N,N,-,-1,-1
RECMUS.txt,273684,275098,1414,10,N,N,-,-1,-1
RECMUS.txt,273760,275284,1524,10,N,N,-,-1,-1
RECMUS.txt,273820,275480,1660,10,N,N,-,-1,-1
RECMUS.txt,274056,275648,1592,10,N,N,-,-1,-1
RECMUS.txt,274168,275733,1565,10,N,N,-,-1,-1
RECMUS.txt,274347,275934,1587,10,N,N,-,-1,-1
RECMUS.txt,274377,276057,1680,10,N,N,-,-1,-1
RECMUS.txt,274554,276171,1617,10,N,N,-,-1,-1
RECMUS.txt,274869,276252,1383,10,N,N,-,-1,-1
RECMUS.txt,274913,276351,1438,10,N,N,-,-1,-1
RECMUS.txt,275099,276374,1275,10,N,N,-,-1,-1
RECMUS.txt,275285,276406,1121,10,N,N,-,-1,-1
RECMUS.txt,275481,276613,1132,10,N,N,-,-1,-1
RECMUS.txt,275649,276717,1068,10,N,N,-,-1,-1
RECMUS.txt,275734,276996,1262,10,N,N,-,-1,-1
RECMUS.txt,275935,277199,1264,10,N,N,-,-1,-1
RECMUS.txt,276058,277400,1342,10,N,N,-,-1,-1
RECMUS.txt,276172,277576,1404,10,N,N,-,-1,-1
RECMUS.txt,276255,277643,1388,10,N,N,-,-1,-1
RECMUS.txt,276352,277679,1327,10,N,N,-,-1,-1
RECMUS.txt,276377,277789,1412,10,N,N,-,-1,-1
RECMUS.txt,276407,277856,1449,10,N,N,-,-1,-1
RECMUS.txt,276614,278030,1416,10,N,N,-,-1,-1
RECMUS.txt,276718,278131,1413,10,N,N,-,-1,-1
RECMUS.txt,276997,278160,1163,10,N,N,-,-1,-1
RECMUS.txt,277200,278222,1022,10,N,N,-,-1,-1
RECMUS.txt,277402,278333,931,10,N,N,-,-1,-1
RECMUS.txt,277577,278410,833,10,N,N,-,-1,-1
RECMUS.txt,277648,278462,814,10,N,N,-,-1,-1
RECMUS.txt,277682,278536,854,10,N,N,-,-1,-1
RECMUS.txt,277790,278596,806,10,N,N,-,-1,-1
RECMUS.txt,277857,278720,863,10,N,N,-,-1,-1
RECMUS.txt,278031,278839,808,10,N,N,-,-1,-1
RECMUS.txt,278132,278934,802,10,N,N,-,-1,-1
RECMUS.txt,278161,278985,824,10,N,N,-,-1,-1
RECMUS.txt,278223,279065,842,10,N,N,-,-1,-1
RECMUS.txt,278334,279192,858,10,N,N,-,-1,-1
RECMUS.txt,278411,279272,861,10,N,N,-,-1,-1
RECMUS.txt,278463,279317,854,10,N,N,-,-1,-1
RECMUS.txt,278537,279355,818,10,N,N,-,-1,-1
RECMUS.txt,278597,279477,880,10,N,N,-,-1,-1
RECMUS.txt,278721,279560,839,10,N,N,-,-1,-1
RECMUS.txt,278840,279851,1011,10,N,N,-,-1,-1
RECMUS.txt,278935,279958,1023,10,N,N,-,-1,-1
RECMUS.txt,278986,280078,1092,10,N,N,-,-1,-1
RECMUS.txt,279066,280168,1102,10,N,N,-,-1,-1
RECMUS.txt,279193,280188,995,10,N,N,-,-1,-1
RECMUS.txt,279274,280234,960,10,N,N,-,-1,-1
RECMUS.txt,279318,280246,928,10,N,N,-,-1,-1
RECMUS.txt,279356,280507,1151,10,N,N,-,-1,-1
RECMUS.txt,279478,280606,1128,10,N,N,-,-1,-1
RECMUS.txt,279561,280971,1410,10,N,N,-,-1,-1
RECMUS.txt,279852,281175,1323,10,N,N,-,-1,-1
RECMUS.txt,279959,281357,1398,10,N,N,-,-1,-1
RECMUS.txt,280079,281385,1306,10,N,N,-,-1,-1
RECMUS.txt,280169,281580,1411,10,N,N,-,-1,-1
RECMUS.txt,280189,281814,1625,10,N,N,-,-1,-1
RECMUS.txt,280235,282112,1877,10,N,N,-,-1,-1
RECMUS.txt,280249,282159,1910,10,N,N,-,-1,-1
RECMUS.txt,280508,282543,2035,10,N,N,-,-1,-1
RECMUS.txt,280607,282734,2127,10,N,N,-,-1,-1
RECMUS.txt,280972,283368,2396,10,N,N,-,-1,-1
RECMUS.txt,281176,283677,2501,10,N,N,-,-1,-1
RECMUS.txt,281358,283859,2501,10,N,N,-,-1,-1
RECMUS.txt,281386,284110,2724,10,N,N,-,-1,-1
RECMUS.txt,281583,284306,2723,10,N,N,-,-1,-1
RECMUS.txt,281815,284590,2775,10,N,N,-,-1,-1
RECMUS.txt,282114,284801,2687,10,N,N,-,-1,-1
RECMUS.txt,282162,285034,2872,10,N,N,-,-1,-1
RECMUS.txt,282544,285134,2590,10,N,N,-,-1,-1
RECMUS.txt,282735,285281,2546,10,N,N,-,-1,-1
RECMUS.txt,283369,285435,2066,10,N,N,-,-1,-1
RECMUS.txt,283678,285522,1844,10,N,N,-,-1,-1
RECMUS.txt,283860,285676,1816,10,N,N,-,-1,-1
RECMUS.txt,284111,285778,1667,10,N,N,-,-1,-1
RECMUS.txt,284307,286016,1709,10,N,N,-,-1,-1
RECMUS.txt,284595,286221,1626,10,N,N,-,-1,-1
RECMUS.txt,284802,286437,1635,10,N,N,-,-1,-1
RECMUS.txt,285036,286557,1521,10,N,N,-,-1,-1
RECMUS.txt,285135,286827,1692,10,N,N,-,-1,-1
RECMUS.txt,285282,286886,1604,10,N,N,-,-1,-1
RECMUS.txt,285436,286985,1549,10,N,N,-,-1,-1
RECMUS.txt,285523,287258,1735,10,N,N,-,-1,-1
RECMUS.txt,285677,287282,1605,10,N,N,-,-1,-1
RECMUS.txt,285779,287347,1568,10,N,N,-,-1,-1
RECMUS.txt,286017,287513,1496,10,N,N,-,-1,-1
RECMUS.txt,286224,287813,1589,10,N,N,-,-1,-1
RECMUS.txt,286438,287883,1445,10,N,N,-,-1,-1
RECMUS.txt,286558,288035,1477,10,N,N,-,-1,-1
RECMUS.txt,286828,288231,1403,10,N,N,-,-1,-1
RECMUS.txt,286889,288438,1549,10,N,N,-,-1,-1
RECMUS.txt,286986,288499,1513,10,N,N,-,-1,-1
RECMUS.txt,287259,288543,1284,10,N,N,-,-1,-1
RECMUS.txt,287284,288649,1365,10,N,N,-,-1,-1
RECMUS.txt,287348,288675,1327,10,N,N,-,-1,-1
RECMUS.txt,287514,288787,1273,10,N,N,-,-1,-1
RECMUS.txt,287814,288998,1184,10,N,N,-,-1,-1
RECMUS.txt,287884,289231,1347,10,N,N,-,-1,-1
RECMUS.txt,288036,289469,1433,10,N,N,-,-1,-1
RECMUS.txt,288233,289704,1471,10,N,N,-,-1,-1
RECMUS.txt,288439,289883,1444,10,N,N,-,-1,-1
RECMUS.txt,288500,289962,1462,10,N,N,-,-1,-1
RECMUS.txt,288544,290221,1677,10,N,N,-,-1,-1
RECMUS.txt,288650,290484,1834,10,N,N,-,-1,-1
RECMUS.txt,288678,290521,1843,10,N,N,-,-1,-1
RECMUS.txt,288788,290603,1815,10,N,N,-,-1,-1
RECMUS.txt,288999,290969,1970,10,N,N,-,-1,-1
RECMUS.txt,289231,291336,2105,10,N,N,-,-1,-1
RECMUS.txt,289470,291439,1969,10,N,N,-,-1,-1
RECMUS.txt,289705,291577,1872,10,N,N,-,-1,-1
RECMUS.txt,289884,291698,1814,10,N,N,-,-1,-1
RECMUS.txt,289963,291751,1788,10,N,N,-,-1,-1
RECMUS.txt,290224,291938,1714,10,N,N,-,-1,-1
RECMUS.txt,290485,291980,1495,10,N,N,-,-1,-1
RECMUS.txt,290524,292078,1554,10,N,N,-,-1,-1
RECMUS.txt,290604,292672,2068,10,N,N,-,-1,-1
RECMUS.txt,290974,293040,2066,10,N,N,-,-1,-1
RECMUS.txt,291339,293141,1802,10,N,N,-,-1,-1
RECMUS.txt,291440,293238,1798,10,N,N,-,-1,-1
RECMUS.txt,291578,293270,1692,10,N,N,-,-1,-1
RECMUS.txt,291699,293498,1799,10,N,N,-,-1,-1
RECMUS.txt,291752,293595,1843,10,Y,N,-,-1,-1
RECMUS.txt,291939,293681,1742,10,N,N,-,-1,-1
RECMUS.txt,291981,293888,1907,10,N,N,-,-1,-1
RECMUS.txt,292079,293948,1869,10,Y,N,-,-1,-1
RECMUS.txt,292673,294078,1405,10,N,N,-,-1,-1
RECMUS.txt,293041,294319,1278,10,Y,N,-,-1,-1
RECMUS.txt,293142,294514,1372,10,Y,N,-,-1,-1
RECMUS.txt,293243,294696,1453,10,Y,N,-,-1,-1
RECMUS.txt,293271,294902,1631,10,Y,N,-,-1,-1
RECMUS.txt,293499,294997,1498,10,Y,N,-,-1,-1
RECMUS.txt,293596,295113,1517,10,N,N,-,-1,-1
RECMUS.txt,293683,295229,1546,10,N,N,-,-1,-1
RECMUS.txt,293889,295414,1525,10,N,N,-,-1,-1
RECMUS.txt,293949,295497,1548,10,N,N,-,-1,-1
RECMUS.txt,294079,295559,1480,10,N,N,-,-1,-1
RECMUS.txt,294320,295599,1279,10,N,N,-,-1,-1
RECMUS.txt,294515,295679,1164,10,N,N,-,-1,-1
RECMUS.txt,294697,295730,1033,10,N,N,-,-1,-1
RECMUS.txt,294905,295834,929,10,N,N,-,-1,-1
RECMUS.txt,294998,295921,923,10,N,N,-,-1,-1
RECMUS.txt,295114,296084,970,10,N,N,-,-1,-1
RECMUS.txt,295230,296188,958,10,N,N,-,-1,-1
RECMUS.txt,295415,296265,850,10,N,N,-,-1,-1
RECMUS.txt,295498,296592,1094,10,N,N,-,-1,-1
RECMUS.txt,295560,296812,1252,10,N,N,-,-1,-1
RECMUS.txt,295600,297073,1473,10,N,N,-,-1,-1
RECMUS.txt,295682,297097,1415,10,N,N,-,-1,-1
RECMUS.txt,295731,297205,1474,10,N,N,-,-1,-1
RECMUS.txt,295835,297420,1585,10,N,N,-,-1,-1
RECMUS.txt,295922,297582,1660,10,N,N,-,-1,-1
RECMUS.txt,296085,297624,1539,10,N,N,-,-1,-1
RECMUS.txt,296188,297810,1622,10,N,N,-,-1,-1
RECMUS.txt,296268,297971,1703,10,Y,N,-,-1,-1
RECMUS.txt,296593,298089,1496,10,N,N,-,-1,-1
RECMUS.txt,296812,298325,1513,10,N,N,-,-1,-1
RECMUS.txt,297074,298595,1521,10,N,N,-,-1,-1
RECMUS.txt,297098,298735,1637,10,N,N,-,-1,-1
RECMUS.txt,297206,299111,1905,10,N,N,-,-1,-1
RECMUS.txt,297420,299155,1735,10,N,N,-,-1,-1
RECMUS.txt,297583,299278,1695,10,N,N,-,-1,-1
RECMUS.txt,297625,299598,1973,10,N,N,-,-1,-1
RECMUS.txt,297811,299634,1823,10,N,N,-,-1,-1
RECMUS.txt,297972,299664,1692,10,N,N,-,-1,-1
RECMUS.txt,298092,299808,1716,10,N,N,-,-1,-1
RECMUS.txt,298327,299946,1619,10,N,N,-,-1,-1
RECMUS.txt,298596,299991,1395,10,N,N,-,-1,-1
RECMUS.txt,298736,300115,1379,10,N,N,-,-1,-1
RECMUS.txt,299112,300257,1145,10,N,N,-,-1,-1
RECMUS.txt,299156,300278,1122,10,N,N,-,-1,-1
RECMUS.txt,299281,300332,1051,10,N,N,-,-1,-1
RECMUS.txt,299600,300403,803,10,N,N,-,-1,-1
RECMUS.txt,299636,300415,779,10,N,N,-,-1,-1
RECMUS.txt,299667,300432,765,10,N,N,-,-1,-1
RECMUS.txt,299811,300579,768,10,N,N,-,-1,-1
RECMUS.txt,299949,300745,796,10,N,N,-,-1,-1
RECMUS.txt,299994,300889,895,10,N,N,-,-1,-1
RECMUS.txt,300118,300932,814,10,N,N,-,-1,-1
RECMUS.txt,300260,300971,711,10,N,N,-,-1,-1
RECMUS.txt,300279,301054,775,10,N,N,-,-1,-1
RECMUS.txt,300334,301094,760,10,N,N,-,-1,-1
RECMUS.txt,300406,301171,765,10,N,N,-,-1,-1
RECMUS.txt,300420,301212,792,10,N,N,-,-1,-1
RECMUS.txt,300435,301234,799,10,N,N,-,-1,-1
RECMUS.txt,300582,301291,709,10,N,N,-,-1,-1
RECMUS.txt,300748,301327,579,10,N,N,-,-1,-1
RECMUS.txt,300892,301370,478,10,N,N,-,-1,-1
RECMUS.txt,300934,301391,457,10,N,N,-,-1,-1
RECMUS.txt,300974,301737,763,10,N,N,-,-1,-1
RECMUS.txt,301057,301793,736,10,N,N,-,-1,-1
RECMUS.txt,301096,301955,859,10,N,N,-,-1,-1
RECMUS.txt,301173,302080,907,10,N,N,-,-1,-1
RECMUS.txt,301215,302176,961,10,N,N,-,-1,-1
RECMUS.txt,301235,302203,968,10,N,N,-,-1,-1
RECMUS.txt,301293,302298,1005,10,N,N,-,-1,-1
RECMUS.txt,301330,302457,1127,10,N,N,-,-1,-1
RECMUS.txt,301375,302518,1143,10,N,N,-,-1,-1
RECMUS.txt,301392,302805,1413,10,N,N,-,-1,-1
RECMUS.txt,301738,302920,1182,10,N,N,-,-1,-1
RECMUS.txt,301794,302989,1195,10,N,N,-,-1,-1
RECMUS.txt,301956,303151,1195,10,N,N,-,-1,-1
RECMUS.txt,302083,303298,1215,10,N,N,-,-1,-1
RECMUS.txt,302177,303396,1219,10,N,N,-,-1,-1
RECMUS.txt,302204,303626,1422,10,N,N,-,-1,-1
RECMUS.txt,302299,303693,1394,10,N,N,-,-1,-1
RECMUS.txt,302458,303781,1323,10,N,N,-,-1,-1
RECMUS.txt,302519,304069,1550,10,N,N,-,-1,-1
RECMUS.txt,302806,304128,1322,10,N,N,-,-1,-1
RECMUS.txt,302921,304213,1292,10,N,N,-,-1,-1
RECMUS.txt,302990,304418,1428,10,N,N,-,-1,-1
RECMUS.txt,303152,304564,1412,10,N,N,-,-1,-1
RECMUS.txt,303299,304595,1296,10,N,N,-,-1,-1
RECMUS.txt,303399,304636,1237,10,N,N,-,-1,-1
RECMUS.txt,303628,304877,1249,10,N,N,-,-1,-1
RECMUS.txt,303694,304949,1255,10,N,N,-,-1,-1
RECMUS.txt,303784,305118,1334,10,N,N,-,-1,-1
RECMUS.txt,304070,305236,1166,10,N,N,-,-1,-1
RECMUS.txt,304129,305262,1133,10,N,N,-,-1,-1
RECMUS.txt,304214,305457,1243,10,N,N,-,-1,-1
RECMUS.txt,304419,305517,1098,10,N,N,-,-1,-1
RECMUS.txt,304565,305718,1153,10,N,N,-,-1,-1
RECMUS.txt,304596,305833,1237,10,N,N,-,-1,-1
RECMUS.txt,304639,305870,1231,10,N,N,-,-1,-1
RECMUS.txt,304878,306156,1278,10,N,N,-,-1,-1
RECMUS.txt,304950,306172,1222,10,N,N,-,-1,-1
RECMUS.txt,305119,306179,1060,10,N,N,-,-1,-1
RECMUS.txt,305237,306597,1360,10,N,N,-,-1,-1
RECMUS.txt,305263,306622,1359,10,N,N,-,-1,-1
RECMUS.txt,305458,306688,1230,10,N,N,-,-1,-1
RECMUS.txt,305518,306919,1401,10,N,N,-,-1,-1
RECMUS.txt,305719,307252,1533,10,N,N,-,-1,-1
RECMUS.txt,305838,307590,1752,10,N,N,-,-1,-1
RECMUS.txt,305871,307689,1818,10,N,N,-,-1,-1
RECMUS.txt,306161,307812,1651,10,N,N,-,-1,-1
RECMUS.txt,306174,307926,1752,10,N,N,-,-1,-1
RECMUS.txt,306182,308085,1903,10,N,N,-,-1,-1
RECMUS.txt,306600,308127,1527,10,N,N,-,-1,-1
RECMUS.txt,306622,308299,1677,10,N,N,-,-1,-1
RECMUS.txt,306689,308405,1716,10,N,N,-,-1,-1
RECMUS.txt,306920,308798,1878,10,N,N,-,-1,-1
RECMUS.txt,307253,309042,1789,10,N,N,-,-1,-1
RECMUS.txt,307591,309168,1577,10,N,N,-,-1,-1
RECMUS.txt,307690,309466,1776,10,N,N,-,-1,-1
RECMUS.txt,307815,309835,2020,10,N,N,-,-1,-1
RECMUS.txt,307928,310086,2158,10,N,N,-,-1,-1
RECMUS.txt,308086,310356,2270,10,N,N,-,-1,-1
RECMUS.txt,308128,310396,2268,10,N,N,-,-1,-1
RECMUS.txt,308300,310568,2268,10,N,N,-,-1,-1
RECMUS.txt,308408,310699,2291,10,N,N,-,-1,-1
RECMUS.txt,308801,310836,2035,10,N,N,-,-1,-1
RECMUS.txt,309043,310990,1947,10,N,N,-,-1,-1
RECMUS.txt,309171,311163,1992,10,N,N,-,-1,-1
RECMUS.txt,309467,311252,1785,10,N,N,-,-1,-1
RECMUS.txt,309838,311400,1562,10,N,N,-,-1,-1
RECMUS.txt,310089,311473,1384,10,N,N,-,-1,-1
RECMUS.txt,310361,311785,1424,10,N,N,-,-1,-1
RECMUS.txt,310401,312025,1624,10,N,N,-,-1,-1
RECMUS.txt,310568,312286,1718,10,N,N,-,-1,-1
RECMUS.txt,310700,312454,1754,10,N,N,-,-1,-1
RECMUS.txt,310837,312570,1733,10,N,N,-,-1,-1
RECMUS.txt,310991,312714,1723,10,N,N,-,-1,-1
RECMUS.txt,311164,312821,1657,10,N,N,-,-1,-1
RECMUS.txt,311253,312848,1595,10,N,N,-,-1,-1
RECMUS.txt,311401,313008,1607,10,Y,N,-,-1,-1
RECMUS.txt,311474,313070,1596,10,Y,N,-,-1,-1
RECMUS.txt,311786,313169,1383,10,N,N,-,-1,-1
RECMUS.txt,312026,313470,1444,10,N,N,-,-1,-1
RECMUS.txt,312287,313673,1386,10,N,N,-,-1,-1
RECMUS.txt,312455,313831,1376,10,N,N,-,-1,-1
RECMUS.txt,312571,314096,1525,10,N,N,-,-1,-1
RECMUS.txt,312715,314119,1404,10,N,N,-,-1,-1
RECMUS.txt,312822,314268,1446,10,N,N,-,-1,-1
RECMUS.txt,312849,314592,1743,10,N,N,-,-1,-1
RECMUS.txt,313009,314734,1725,10,N,N,-,-1,-1
RECMUS.txt,313071,314890,1819,10,N,N,-,-1,-1
RECMUS.txt,313170,314991,1821,10,N,N,-,-1,-1
RECMUS.txt,313471,315032,1561,10,N,N,-,-1,-1
RECMUS.txt,313674,315231,1557,10,N,N,-,-1,-1
RECMUS.txt,313832,315366,1534,10,N,N,-,-1,-1
RECMUS.txt,314097,315497,1400,10,N,N,-,-1,-1
RECMUS.txt,314120,315630,1510,10,N,N,-,-1,-1
RECMUS.txt,314269,315818,1549,10,N,N,-,-1,-1
RECMUS.txt,314593,316159,1566,10,N,N,-,-1,-1
RECMUS.txt,314735,316221,1486,10,N,N,-,-1,-1
RECMUS.txt,314893,316256,1363,10,N,N,-,-1,-1
RECMUS.txt,314994,316293,1299,10,N,N,-,-1,-1
RECMUS.txt,315033,316366,1333,10,N,N,-,-1,-1
RECMUS.txt,315234,316401,1167,10,N,N,-,-1,-1
RECMUS.txt,315369,316468,1099,10,N,N,-,-1,-1
RECMUS.txt,315500,316506,1006,10,N,N,-,-1,-1
RECMUS.txt,315633,316545,912,10,N,N,-,-1,-1
RECMUS.txt,315819,316615,796,10,N,N,-,-1,-1
RECMUS.txt,316161,316654,493,10,N,N,-,-1,-1
RECMUS.txt,316224,316681,457,10,N,N,-,-1,-1
RECMUS.txt,316258,316825,567,10,N,N,-,-1,-1
RECMUS.txt,316295,317006,711,10,N,N,-,-1,-1
RECMUS.txt,316369,317075,706,10,N,N,-,-1,-1
RECMUS.txt,316403,317120,717,10,N,N,-,-1,-1
RECMUS.txt,316470,317243,773,10,N,Y,1437477878183,427206,428439
RECMUS.txt,316509,317322,813,10,N,Y,1437477878183,427206,428439
RECMUS.txt,316547,317432,885,10,N,Y,1437477878183,427206,428439
RECMUS.txt,316617,317614,997,10,N,Y,1437477878183,427206,428439
RECMUS.txt,316659,317672,1013,10,N,Y,1437477878183,427206,428439
RECMUS.txt,316686,317813,1127,10,N,Y,1437477878183,427206,428439
RECMUS.txt,316828,317845,1017,10,N,Y,1437477878183,427206,428439
RECMUS.txt,317007,317979,972,10,N,Y,1437477878183,427206,428439
RECMUS.txt,317076,318022,946,10,N,Y,1437477878183,427206,428439
RECMUS.txt,317123,318147,1024,10,N,Y,1437477878183,427206,428439
RECMUS.txt,317244,318203,959,10,N,Y,1437477878183,427206,428439
RECMUS.txt,317323,318341,1018,10,N,Y,1437477878183,427206,428439
RECMUS.txt,317433,318400,967,10,N,N,-,-1,-1
RECMUS.txt,317615,318470,855,10,N,N,-,-1,-1
RECMUS.txt,317673,318578,905,10,N,N,-,-1,-1
RECMUS.txt,317814,318825,1011,10,N,N,-,-1,-1
RECMUS.txt,317846,318865,1019,10,N,N,-,-1,-1
RECMUS.txt,317980,318991,1011,10,N,N,-,-1,-1
RECMUS.txt,318023,319062,1039,10,N,N,-,-1,-1
RECMUS.txt,318148,319359,1211,10,N,N,-,-1,-1
RECMUS.txt,318205,319619,1414,10,N,N,-,-1,-1
RECMUS.txt,318342,319919,1577,10,N,N,-,-1,-1
RECMUS.txt,318401,319982,1581,10,N,N,-,-1,-1
RECMUS.txt,318471,320051,1580,10,N,N,-,-1,-1
RECMUS.txt,318579,320159,1580,10,N,N,-,-1,-1
RECMUS.txt,318826,320348,1522,10,N,N,-,-1,-1
RECMUS.txt,318866,320422,1556,10,N,N,-,-1,-1
RECMUS.txt,318992,320511,1519,10,N,N,-,-1,-1
RECMUS.txt,319067,320580,1513,10,N,N,-,-1,-1
RECMUS.txt,319361,320757,1396,10,N,N,-,-1,-1
RECMUS.txt,319620,320784,1164,10,N,N,-,-1,-1
RECMUS.txt,319920,320879,959,10,N,N,-,-1,-1
RECMUS.txt,319983,321068,1085,10,N,N,-,-1,-1
RECMUS.txt,320052,321176,1124,10,N,N,-,-1,-1
RECMUS.txt,320161,321318,1157,10,N,N,-,-1,-1
RECMUS.txt,320349,321507,1158,10,N,N,-,-1,-1
RECMUS.txt,320423,321718,1295,10,N,N,-,-1,-1
RECMUS.txt,320512,321726,1214,10,N,N,-,-1,-1
RECMUS.txt,320581,321877,1296,10,N,N,-,-1,-1
RECMUS.txt,320757,322036,1279,10,N,N,-,-1,-1
RECMUS.txt,320784,322071,1287,10,N,N,-,-1,-1
RECMUS.txt,320880,322220,1340,10,N,N,-,-1,-1
RECMUS.txt,321071,322275,1204,10,N,N,-,-1,-1
RECMUS.txt,321178,322430,1252,10,N,N,-,-1,-1
RECMUS.txt,321319,322478,1159,10,N,N,-,-1,-1
RECMUS.txt,321512,322832,1320,10,N,N,-,-1,-1
RECMUS.txt,321721,323157,1436,10,N,N,-,-1,-1
RECMUS.txt,321726,323314,1588,10,N,N,-,-1,-1
RECMUS.txt,321878,323415,1537,10,N,N,-,-1,-1
RECMUS.txt,322037,323554,1517,10,N,N,-,-1,-1
RECMUS.txt,322072,323727,1655,10,N,N,-,-1,-1
RECMUS.txt,322221,323809,1588,10,N,N,-,-1,-1
RECMUS.txt,322278,323933,1655,10,N,N,-,-1,-1
RECMUS.txt,322431,324003,1572,10,N,N,-,-1,-1
RECMUS.txt,322479,324153,1674,10,N,N,-,-1,-1
RECMUS.txt,322833,324409,1576,10,N,N,-,-1,-1
RECMUS.txt,323158,324607,1449,10,N,N,-,-1,-1
RECMUS.txt,323315,324781,1466,10,N,N,-,-1,-1
RECMUS.txt,323416,324891,1475,10,N,N,-,-1,-1
RECMUS.txt,323555,325061,1506,10,N,N,-,-1,-1
RECMUS.txt,323728,325100,1372,10,N,N,-,-1,-1
RECMUS.txt,323810,325272,1462,10,N,N,-,-1,-1
RECMUS.txt,323936,325457,1521,10,Y,N,-,-1,-1
RECMUS.txt,324004,325466,1462,10,N,N,-,-1,-1
RECMUS.txt,324154,325586,1432,10,Y,N,-,-1,-1
RECMUS.txt,324410,325756,1346,10,Y,N,-,-1,-1
RECMUS.txt,324610,325826,1216,10,Y,N,-,-1,-1
RECMUS.txt,324783,326000,1217,10,Y,Y,1437472966198,394609,395892
RECMUS.txt,324892,326107,1215,10,Y,Y,1437472966198,394609,395892
RECMUS.txt,325062,326324,1262,10,Y,Y,1437472966198,394609,395892
RECMUS.txt,325101,326451,1350,10,Y,Y,1437472966198,394609,395892
RECMUS.txt,325273,326606,1333,10,Y,Y,1437472966198,394609,395892
RECMUS.txt,325458,326643,1185,10,Y,Y,1437472966198,394609,395892
RECMUS.txt,325467,326657,1190,10,Y,Y,1437472966198,394609,395892
RECMUS.txt,325587,326719,1132,10,Y,Y,1437472966198,394609,395892
RECMUS.txt,325757,326775,1018,10,Y,Y,1437472966198,394609,395892
RECMUS.txt,325827,326867,1040,10,Y,Y,1437472966198,394609,395892
RECMUS.txt,326001,326883,882,10,Y,Y,1437472966198,394609,395892
RECMUS.txt,326107,327132,1025,10,Y,Y,1437472966198,394609,395892
RECMUS.txt,326329,327173,844,10,N,Y,1437472966198,394609,395892
RECMUS.txt,326453,327210,757,10,N,Y,1437472966198,394609,395892
RECMUS.txt,326607,327431,824,10,N,Y,1437472966198,394609,395892
RECMUS.txt,326646,327551,905,10,N,Y,1448285913012,108803,110925
RECMUS.txt,326658,327733,1075,10,N,Y,1448285913012,108803,110925
RECMUS.txt,326720,327827,1107,10,N,Y,1448285913012,108803,110925
RECMUS.txt,326776,327945,1169,10,N,Y,1448285913012,108803,110925
RECMUS.txt,326870,328123,1253,10,N,Y,1448285913012,108803,110925
RECMUS.txt,326884,328171,1287,10,N,Y,1448285913012,108803,110925
RECMUS.txt,327133,328280,1147,10,N,Y,1448285913012,108803,110925
RECMUS.txt,327174,328562,1388,10,Y,Y,1448285913012,108803,110925
RECMUS.txt,327213,328598,1385,10,N,N,-,-1,-1
RECMUS.txt,327434,328608,1174,10,N,N,-,-1,-1
RECMUS.txt,327552,328711,1159,10,Y,N,-,-1,-1
RECMUS.txt,327734,328720,986,10,N,N,-,-1,-1
RECMUS.txt,327828,328833,1005,10,N,N,-,-1,-1
RECMUS.txt,327948,328924,976,10,N,N,-,-1,-1
RECMUS.txt,328125,329006,881,10,N,N,-,-1,-1
RECMUS.txt,328172,329017,845,10,N,N,-,-1,-1
RECMUS.txt,328283,329119,836,10,N,N,-,-1,-1
RECMUS.txt,328567,329239,672,10,N,N,-,-1,-1
RECMUS.txt,328601,329411,810,10,N,N,-,-1,-1
RECMUS.txt,328609,329476,867,10,N,N,-,-1,-1
RECMUS.txt,328711,329631,920,10,N,N,-,-1,-1
RECMUS.txt,328721,330053,1332,10,Y,N,-,-1,-1
RECMUS.txt,328834,330372,1538,10,N,N,-,-1,-1
RECMUS.txt,328925,330490,1565,10,N,N,-,-1,-1
RECMUS.txt,329007,330604,1597,10,N,N,-,-1,-1
RECMUS.txt,329018,330680,1662,10,Y,N,-,-1,-1
RECMUS.txt,329120,330733,1613,10,Y,N,-,-1,-1
RECMUS.txt,329240,330892,1652,10,N,N,-,-1,-1
RECMUS.txt,329413,330949,1536,10,N,N,-,-1,-1
RECMUS.txt,329477,330956,1479,10,N,N,-,-1,-1
RECMUS.txt,329632,331237,1605,10,N,N,-,-1,-1
RECMUS.txt,330054,331323,1269,10,N,N,-,-1,-1
RECMUS.txt,330373,331501,1128,10,N,N,-,-1,-1
RECMUS.txt,330491,331563,1072,10,N,N,-,-1,-1
RECMUS.txt,330605,331830,1225,10,N,N,-,-1,-1
RECMUS.txt,330681,331972,1291,10,N,N,-,-1,-1
RECMUS.txt,330734,332080,1346,10,Y,N,-,-1,-1
RECMUS.txt,330893,332195,1302,10,N,N,-,-1,-1
RECMUS.txt,330949,332301,1352,10,Y,N,-,-1,-1
RECMUS.txt,330957,332492,1535,10,Y,N,-,-1,-1
RECMUS.txt,331240,332604,1364,10,N,N,-,-1,-1
RECMUS.txt,331326,332720,1394,10,N,N,-,-1,-1
RECMUS.txt,331502,332910,1408,10,N,N,-,-1,-1
RECMUS.txt,331564,333265,1701,10,N,N,-,-1,-1
RECMUS.txt,331833,333465,1632,10,N,N,-,-1,-1
RECMUS.txt,331973,333550,1577,10,N,N,-,-1,-1
RECMUS.txt,332081,333857,1776,10,N,N,-,-1,-1
RECMUS.txt,332196,333891,1695,10,N,N,-,-1,-1
RECMUS.txt,332302,334024,1722,10,N,N,-,-1,-1
RECMUS.txt,332493,334087,1594,10,N,N,-,-1,-1
RECMUS.txt,332605,334217,1612,10,N,N,-,-1,-1
RECMUS.txt,332721,334366,1645,10,N,N,-,-1,-1
RECMUS.txt,332913,334458,1545,10,N,N,-,-1,-1
RECMUS.txt,333268,334645,1377,10,N,N,-,-1,-1
RECMUS.txt,333466,334749,1283,10,N,N,-,-1,-1
RECMUS.txt,333551,334807,1256,10,N,N,-,-1,-1
RECMUS.txt,333858,334958,1100,10,N,N,-,-1,-1
RECMUS.txt,333894,335079,1185,10,N,N,-,-1,-1
RECMUS.txt,334025,335160,1135,10,N,N,-,-1,-1
RECMUS.txt,334088,335327,1239,10,N,N,-,-1,-1
RECMUS.txt,334218,335344,1126,10,N,N,-,-1,-1
RECMUS.txt,334369,335351,982,10,N,N,-,-1,-1
RECMUS.txt,334461,335760,1299,10,N,N,-,-1,-1
RECMUS.txt,334648,335923,1275,10,N,N,-,-1,-1
RECMUS.txt,334750,336114,1364,10,N,N,-,-1,-1
RECMUS.txt,334808,336165,1357,10,N,N,-,-1,-1
RECMUS.txt,334959,336331,1372,10,N,N,-,-1,-1
RECMUS.txt,335080,336669,1589,10,N,N,-,-1,-1
RECMUS.txt,335163,336892,1729,10,N,N,-,-1,-1
RECMUS.txt,335332,337012,1680,10,N,N,-,-1,-1
RECMUS.txt,335346,337273,1927,10,N,N,-,-1,-1
RECMUS.txt,335354,337321,1967,10,N,N,-,-1,-1
RECMUS.txt,335763,337639,1876,10,N,N,-,-1,-1
RECMUS.txt,335924,337734,1810,10,N,N,-,-1,-1
RECMUS.txt,336115,337938,1823,10,N,N,-,-1,-1
RECMUS.txt,336167,338074,1907,10,N,N,-,-1,-1
RECMUS.txt,336332,338314,1982,10,N,N,-,-1,-1
RECMUS.txt,336670,338438,1768,10,N,N,-,-1,-1
RECMUS.txt,336893,338656,1763,10,N,N,-,-1,-1
RECMUS.txt,337013,338772,1759,10,N,N,-,-1,-1
RECMUS.txt,337274,338907,1633,10,N,N,-,-1,-1
RECMUS.txt,337324,339059,1735,10,N,N,-,-1,-1
RECMUS.txt,337642,339097,1455,10,N,N,-,-1,-1
RECMUS.txt,337735,339137,1402,10,N,N,-,-1,-1
RECMUS.txt,337939,339153,1214,10,N,N,-,-1,-1
RECMUS.txt,338075,339168,1093,10,N,N,-,-1,-1
RECMUS.txt,338315,339202,887,10,N,N,-,-1,-1
RECMUS.txt,338441,339227,786,10,N,N,-,-1,-1
RECMUS.txt,338657,339249,592,10,N,N,-,-1,-1
RECMUS.txt,338775,339279,504,10,N,N,-,-1,-1
RECMUS.txt,338908,339337,429,10,N,N,-,-1,-1
RECMUS.txt,339061,339528,467,10,N,N,-,-1,-1
RECMUS.txt,339098,339620,522,10,N,N,-,-1,-1
RECMUS.txt,339138,339670,532,10,N,N,-,-1,-1
RECMUS.txt,339154,339779,625,10,N,N,-,-1,-1
RECMUS.txt,339169,339883,714,10,N,N,-,-1,-1
RECMUS.txt,339203,339985,782,10,N,N,-,-1,-1
RECMUS.txt,339228,340067,839,10,N,N,-,-1,-1
RECMUS.txt,339250,340143,893,10,N,N,-,-1,-1
RECMUS.txt,339279,340445,1166,10,N,N,-,-1,-1
RECMUS.txt,339340,340767,1427,10,N,N,-,-1,-1
RECMUS.txt,339531,341003,1472,10,N,N,-,-1,-1
RECMUS.txt,339625,341199,1574,10,N,N,-,-1,-1
RECMUS.txt,339671,341356,1685,10,N,N,-,-1,-1
RECMUS.txt,339780,341661,1881,10,N,N,-,-1,-1
RECMUS.txt,339884,341739,1855,10,N,N,-,-1,-1
RECMUS.txt,339987,341899,1912,10,N,Y,1448357582358,234204,234401
RECMUS.txt,340068,342115,2047,10,N,Y,1448357582358,234204,234401
RECMUS.txt,340144,342271,2127,10,N,Y,1448357582358,234204,234401
RECMUS.txt,340446,342391,1945,10,N,Y,1448357582358,234204,234401
RECMUS.txt,340768,342499,1731,10,N,Y,1448357582358,234204,234401
RECMUS.txt,341004,342525,1521,10,N,Y,1448357582358,234204,234401
RECMUS.txt,341202,342692,1490,10,N,Y,1448357582358,234204,234401
RECMUS.txt,341357,342829,1472,10,N,Y,1448357582358,234204,234401
RECMUS.txt,341662,343042,1380,10,N,Y,1448357582358,234204,234401
RECMUS.txt,341741,343385,1644,10,N,Y,1448357582358,234204,234401
RECMUS.txt,341900,343580,1680,10,N,N,-,-1,-1
RECMUS.txt,342116,343814,1698,10,Y,N,-,-1,-1
RECMUS.txt,342272,344400,2128,10,Y,N,-,-1,-1
RECMUS.txt,342392,344437,2045,10,Y,N,-,-1,-1
RECMUS.txt,342500,344515,2015,10,Y,N,-,-1,-1
RECMUS.txt,342526,344599,2073,10,N,N,-,-1,-1
RECMUS.txt,342693,344649,1956,10,N,N,-,-1,-1
RECMUS.txt,342830,344717,1887,10,N,N,-,-1,-1
RECMUS.txt,343045,345008,1963,10,N,N,-,-1,-1
RECMUS.txt,343386,345336,1950,10,N,N,-,-1,-1
RECMUS.txt,343581,345563,1982,10,N,N,-,-1,-1
RECMUS.txt,343817,345667,1850,10,N,N,-,-1,-1
RECMUS.txt,344400,345855,1455,10,N,N,-,-1,-1
RECMUS.txt,344438,345990,1552,10,N,N,-,-1,-1
RECMUS.txt,344518,346099,1581,10,N,N,-,-1,-1
RECMUS.txt,344600,346130,1530,10,N,N,-,-1,-1
RECMUS.txt,344650,346247,1597,10,N,N,-,-1,-1
RECMUS.txt,344718,346350,1632,10,Y,N,-,-1,-1
RECMUS.txt,345009,346431,1422,10,Y,N,-,-1,-1
RECMUS.txt,345339,346605,1266,10,Y,N,-,-1,-1
RECMUS.txt,345564,346703,1139,10,Y,N,-,-1,-1
RECMUS.txt,345668,346795,1127,10,N,N,-,-1,-1
RECMUS.txt,345856,346916,1060,10,N,N,-,-1,-1
RECMUS.txt,345991,347042,1051,10,Y,N,-,-1,-1
RECMUS.txt,346100,347361,1261,10,Y,N,-,-1,-1
RECMUS.txt,346133,347455,1322,10,Y,N,-,-1,-1
RECMUS.txt,346248,347487,1239,10,Y,N,-,-1,-1
RECMUS.txt,346351,347693,1342,10,Y,N,-,-1,-1
RECMUS.txt,346433,348004,1571,10,Y,N,-,-1,-1
RECMUS.txt,346607,348345,1738,10,N,N,-,-1,-1
RECMUS.txt,346706,348871,2165,10,N,N,-,-1,-1
RECMUS.txt,346798,349073,2275,10,N,N,-,-1,-1
RECMUS.txt,346918,349083,2165,10,N,N,-,-1,-1
RECMUS.txt,347043,349106,2063,10,N,N,-,-1,-1
RECMUS.txt,347362,349267,1905,10,N,N,-,-1,-1
RECMUS.txt,347458,349375,1917,10,N,N,-,-1,-1
RECMUS.txt,347488,349748,2260,10,N,N,-,-1,-1
RECMUS.txt,347696,349939,2243,10,N,N,-,-1,-1
RECMUS.txt,348005,349957,1952,10,N,N,-,-1,-1
RECMUS.txt,348346,350236,1890,10,N,N,-,-1,-1
RECMUS.txt,348872,350362,1490,10,N,N,-,-1,-1
RECMUS.txt,349073,350573,1500,10,N,N,-,-1,-1
RECMUS.txt,349084,350658,1574,10,N,N,-,-1,-1
RECMUS.txt,349107,350796,1689,10,N,N,-,-1,-1
RECMUS.txt,349269,351073,1804,10,N,N,-,-1,-1
RECMUS.txt,349378,351218,1840,10,N,N,-,-1,-1
RECMUS.txt,349749,351245,1496,10,N,N,-,-1,-1
RECMUS.txt,349940,351309,1369,10,N,N,-,-1,-1
RECMUS.txt,349958,351367,1409,10,N,N,-,-1,-1
RECMUS.txt,350239,351432,1193,10,N,N,-,-1,-1
RECMUS.txt,350363,351552,1189,10,N,N,-,-1,-1
RECMUS.txt,350574,351707,1133,10,N,N,-,-1,-1
RECMUS.txt,350661,351770,1109,10,N,N,-,-1,-1
RECMUS.txt,350797,351908,1111,10,N,N,-,-1,-1
RECMUS.txt,351076,352252,1176,10,N,N,-,-1,-1
RECMUS.txt,351219,352336,1117,10,N,N,-,-1,-1
RECMUS.txt,351246,352400,1154,10,N,N,-,-1,-1
RECMUS.txt,351310,352527,1217,10,N,N,-,-1,-1
RECMUS.txt,351370,352678,1308,10,N,N,-,-1,-1
RECMUS.txt,351433,352728,1295,10,N,N,-,-1,-1
RECMUS.txt,351553,353124,1571,10,N,N,-,-1,-1
RECMUS.txt,351708,353283,1575,10,N,N,-,-1,-1
RECMUS.txt,351773,353376,1603,10,N,N,-,-1,-1
RECMUS.txt,351909,353432,1523,10,N,N,-,-1,-1
RECMUS.txt,352253,353444,1191,10,N,N,-,-1,-1
RECMUS.txt,352337,353534,1197,10,N,N,-,-1,-1
RECMUS.txt,352401,353684,1283,10,N,N,-,-1,-1
RECMUS.txt,352528,353717,1189,10,N,N,-,-1,-1
RECMUS.txt,352679,353736,1057,10,N,N,-,-1,-1
RECMUS.txt,352729,353764,1035,10,N,N,-,-1,-1
RECMUS.txt,353126,354119,993,10,N,N,-,-1,-1
RECMUS.txt,353284,354241,957,10,N,N,-,-1,-1
RECMUS.txt,353377,354339,962,10,N,N,-,-1,-1
RECMUS.txt,353433,354398,965,10,N,N,-,-1,-1
RECMUS.txt,353445,354529,1084,10,N,N,-,-1,-1
RECMUS.txt,353535,354739,1204,10,N,N,-,-1,-1
RECMUS.txt,353685,354890,1205,10,N,N,-,-1,-1
RECMUS.txt,353718,355029,1311,10,N,N,-,-1,-1
RECMUS.txt,353741,355163,1422,10,N,N,-,-1,-1
RECMUS.txt,353769,355250,1481,10,N,N,-,-1,-1
RECMUS.txt,354120,355414,1294,10,N,N,-,-1,-1
RECMUS.txt,354242,355522,1280,10,N,N,-,-1,-1
RECMUS.txt,354340,355569,1229,10,N,N,-,-1,-1
RECMUS.txt,354399,355621,1222,10,N,N,-,-1,-1
RECMUS.txt,354530,355920,1390,10,N,N,-,-1,-1
RECMUS.txt,354742,356048,1306,10,N,N,-,-1,-1
RECMUS.txt,354891,356186,1295,10,N,N,-,-1,-1
RECMUS.txt,355031,356203,1172,10,N,N,-,-1,-1
RECMUS.txt,355164,356383,1219,10,N,N,-,-1,-1
RECMUS.txt,355253,356509,1256,10,N,N,-,-1,-1
RECMUS.txt,355415,356686,1271,10,N,N,-,-1,-1
RECMUS.txt,355523,356917,1394,10,N,N,-,-1,-1
RECMUS.txt,355570,357071,1501,10,N,N,-,-1,-1
RECMUS.txt,355622,357187,1565,10,N,N,-,-1,-1
RECMUS.txt,355921,357234,1313,10,N,N,-,-1,-1
RECMUS.txt,356049,357238,1189,10,N,N,-,-1,-1
RECMUS.txt,356189,357367,1178,10,N,N,-,-1,-1
RECMUS.txt,356204,357458,1254,10,N,N,-,-1,-1
RECMUS.txt,356384,357586,1202,10,N,N,-,-1,-1
RECMUS.txt,356510,357737,1227,10,N,N,-,-1,-1
RECMUS.txt,356687,357953,1266,10,N,N,-,-1,-1
RECMUS.txt,356918,358045,1127,10,N,N,-,-1,-1
RECMUS.txt,357072,358137,1065,10,N,N,-,-1,-1
RECMUS.txt,357188,358175,987,10,N,N,-,-1,-1
RECMUS.txt,357235,358304,1069,10,N,N,-,-1,-1
RECMUS.txt,357239,358352,1113,10,N,N,-,-1,-1
RECMUS.txt,357368,358391,1023,10,N,N,-,-1,-1
RECMUS.txt,357460,358463,1003,10,N,N,-,-1,-1
RECMUS.txt,357587,358517,930,10,N,N,-,-1,-1
RECMUS.txt,357738,358554,816,10,N,N,-,-1,-1
RECMUS.txt,357954,358699,745,10,N,N,-,-1,-1
RECMUS.txt,358047,358891,844,10,N,N,-,-1,-1
RECMUS.txt,358138,359001,863,10,N,N,-,-1,-1
RECMUS.txt,358178,359247,1069,10,N,N,-,-1,-1
RECMUS.txt,358305,359416,1111,10,N,N,-,-1,-1
RECMUS.txt,358354,359620,1266,10,N,N,-,-1,-1
RECMUS.txt,358392,359841,1449,10,N,N,-,-1,-1
RECMUS.txt,358464,360054,1590,10,N,N,-,-1,-1
RECMUS.txt,358518,360206,1688,10,N,N,-,-1,-1
RECMUS.txt,358559,360472,1913,10,N,N,-,-1,-1
RECMUS.txt,358700,360545,1845,10,N,N,-,-1,-1
RECMUS.txt,358892,360678,1786,10,N,N,-,-1,-1
RECMUS.txt,359002,360807,1805,10,N,N,-,-1,-1
RECMUS.txt,359248,360979,1731,10,N,N,-,-1,-1
RECMUS.txt,359417,361061,1644,10,N,N,-,-1,-1
RECMUS.txt,359621,361535,1914,10,N,N,-,-1,-1
RECMUS.txt,359843,361557,1714,10,N,N,-,-1,-1
RECMUS.txt,360055,361656,1601,10,N,N,-,-1,-1
RECMUS.txt,360207,361704,1497,10,N,N,-,-1,-1
RECMUS.txt,360473,361804,1331,10,N,N,-,-1,-1
RECMUS.txt,360546,361965,1419,10,N,N,-,-1,-1
RECMUS.txt,360679,362066,1387,10,N,N,-,-1,-1
RECMUS.txt,360808,362185,1377,10,N,N,-,-1,-1
RECMUS.txt,360980,362260,1280,10,N,N,-,-1,-1
RECMUS.txt,361066,362345,1279,10,N,N,-,-1,-1
RECMUS.txt,361536,362481,945,10,N,N,-,-1,-1
RECMUS.txt,361558,362527,969,10,N,N,-,-1,-1
RECMUS.txt,361658,362640,982,10,N,N,-,-1,-1
RECMUS.txt,361705,362749,1044,10,N,N,-,-1,-1
RECMUS.txt,361805,362850,1045,10,N,N,-,-1,-1
RECMUS.txt,361966,362945,979,10,N,N,-,-1,-1
RECMUS.txt,362068,363081,1013,10,N,N,-,-1,-1
RECMUS.txt,362187,363214,1027,10,N,N,-,-1,-1
RECMUS.txt,362261,363427,1166,10,N,N,-,-1,-1
RECMUS.txt,362346,363440,1094,10,N,N,-,-1,-1
RECMUS.txt,362482,363629,1147,10,N,N,-,-1,-1
RECMUS.txt,362528,363722,1194,10,N,N,-,-1,-1
RECMUS.txt,362641,363917,1276,10,N,N,-,-1,-1
RECMUS.txt,362751,363974,1223,10,N,N,-,-1,-1
RECMUS.txt,362851,364043,1192,10,N,N,-,-1,-1
RECMUS.txt,362946,364146,1200,10,N,N,-,-1,-1
RECMUS.txt,363084,364233,1149,10,N,N,-,-1,-1
RECMUS.txt,363215,364482,1267,10,N,N,-,-1,-1
RECMUS.txt,363432,364571,1139,10,N,N,-,-1,-1
RECMUS.txt,363440,364715,1275,10,N,N,-,-1,-1
RECMUS.txt,363630,364799,1169,10,N,N,-,-1,-1
RECMUS.txt,363723,364835,1112,10,N,N,-,-1,-1
RECMUS.txt,363918,364836,918,10,N,N,-,-1,-1
RECMUS.txt,363975,364878,903,10,N,N,-,-1,-1
RECMUS.txt,364046,364922,876,10,N,N,-,-1,-1
RECMUS.txt,364147,365132,985,10,N,N,-,-1,-1
RECMUS.txt,364234,365262,1028,10,N,N,-,-1,-1
RECMUS.txt,364483,365330,847,10,N,N,-,-1,-1
RECMUS.txt,364572,365458,886,10,N,N,-,-1,-1
RECMUS.txt,364716,365608,892,10,N,N,-,-1,-1
RECMUS.txt,364801,365683,882,10,N,N,-,-1,-1
RECMUS.txt,364835,365796,961,10,N,N,-,-1,-1
RECMUS.txt,364837,365839,1002,10,N,N,-,-1,-1
RECMUS.txt,364879,365971,1092,10,N,N,-,-1,-1
RECMUS.txt,364923,366075,1152,10,N,N,-,-1,-1
RECMUS.txt,365133,366093,960,10,N,N,-,-1,-1
RECMUS.txt,365263,366107,844,10,N,N,-,-1,-1
RECMUS.txt,365332,366500,1168,10,N,N,-,-1,-1
RECMUS.txt,365461,366585,1124,10,N,N,-,-1,-1
RECMUS.txt,365609,366624,1015,10,N,N,-,-1,-1
RECMUS.txt,365684,366769,1085,10,N,N,-,-1,-1
RECMUS.txt,365797,366949,1152,10,N,N,-,-1,-1
RECMUS.txt,365842,367092,1250,10,N,N,-,-1,-1
RECMUS.txt,365974,367205,1231,10,N,N,-,-1,-1
RECMUS.txt,366080,367529,1449,10,N,N,-,-1,-1
RECMUS.txt,366095,367686,1591,10,N,N,-,-1,-1
RECMUS.txt,366110,367809,1699,10,N,N,-,-1,-1
RECMUS.txt,366503,367882,1379,10,N,N,-,-1,-1
RECMUS.txt,366586,367928,1342,10,N,N,-,-1,-1
RECMUS.txt,366625,368082,1457,10,N,N,-,-1,-1
RECMUS.txt,366770,368401,1631,10,N,N,-,-1,-1
RECMUS.txt,366950,368614,1664,10,N,N,-,-1,-1
RECMUS.txt,367093,368693,1600,10,N,N,-,-1,-1
RECMUS.txt,367206,369298,2092,10,Y,N,-,-1,-1
RECMUS.txt,367530,369462,1932,10,Y,N,-,-1,-1
RECMUS.txt,367687,369611,1924,10,Y,N,-,-1,-1
RECMUS.txt,367810,369716,1906,10,Y,N,-,-1,-1
RECMUS.txt,367883,369902,2019,10,Y,N,-,-1,-1
RECMUS.txt,367931,370304,2373,10,Y,N,-,-1,-1
RECMUS.txt,368083,370658,2575,10,Y,N,-,-1,-1
RECMUS.txt,368403,370733,2330,10,Y,N,-,-1,-1
RECMUS.txt,368615,370879,2264,10,Y,N,-,-1,-1
RECMUS.txt,368694,370976,2282,10,Y,N,-,-1,-1
RECMUS.txt,369299,371005,1706,10,Y,N,-,-1,-1
RECMUS.txt,369463,371053,1590,10,N,N,-,-1,-1
RECMUS.txt,369612,371104,1492,10,N,N,-,-1,-1
RECMUS.txt,369718,371153,1435,10,N,N,-,-1,-1
RECMUS.txt,369905,371650,1745,10,Y,N,-,-1,-1
RECMUS.txt,370305,371937,1632,10,N,N,-,-1,-1
RECMUS.txt,370661,372022,1361,10,N,N,-,-1,-1
RECMUS.txt,370734,372187,1453,10,N,N,-,-1,-1
RECMUS.txt,370880,372466,1586,10,N,N,-,-1,-1
RECMUS.txt,370977,372690,1713,10,N,N,-,-1,-1
RECMUS.txt,371006,372726,1720,10,N,N,-,-1,-1
RECMUS.txt,371054,372839,1785,10,Y,N,-,-1,-1
RECMUS.txt,371106,372879,1773,10,N,N,-,-1,-1
RECMUS.txt,371154,372970,1816,10,N,N,-,-1,-1
RECMUS.txt,371651,373124,1473,10,N,N,-,-1,-1
RECMUS.txt,371938,373220,1282,10,N,N,-,-1,-1
RECMUS.txt,372025,373238,1213,10,N,N,-,-1,-1
RECMUS.txt,372188,373424,1236,10,N,N,-,-1,-1
RECMUS.txt,372467,373614,1147,10,N,N,-,-1,-1
RECMUS.txt,372695,373835,1140,10,N,N,-,-1,-1
RECMUS.txt,372729,373955,1226,10,N,N,-,-1,-1
RECMUS.txt,372839,374138,1299,10,N,N,-,-1,-1
RECMUS.txt,372879,374271,1392,10,N,N,-,-1,-1
RECMUS.txt,372973,374623,1650,10,N,N,-,-1,-1
RECMUS.txt,373125,374997,1872,10,N,N,-,-1,-1
RECMUS.txt,373221,375023,1802,10,N,N,-,-1,-1
RECMUS.txt,373239,375032,1793,10,N,N,-,-1,-1
RECMUS.txt,373425,375197,1772,10,N,N,-,-1,-1
RECMUS.txt,373616,375313,1697,10,N,N,-,-1,-1
RECMUS.txt,373836,375416,1580,10,N,N,-,-1,-1
RECMUS.txt,373956,375478,1522,10,N,N,-,-1,-1
RECMUS.txt,374141,375579,1438,10,N,N,-,-1,-1
RECMUS.txt,374272,375640,1368,10,N,N,-,-1,-1
RECMUS.txt,374624,375823,1199,10,N,N,-,-1,-1
RECMUS.txt,374998,375868,870,10,N,N,-,-1,-1
RECMUS.txt,375023,376193,1170,10,N,N,-,-1,-1
RECMUS.txt,375033,376290,1257,10,N,N,-,-1,-1
RECMUS.txt,375198,376598,1400,10,N,N,-,-1,-1
RECMUS.txt,375314,377066,1752,10,N,N,-,-1,-1
RECMUS.txt,375417,377332,1915,10,N,N,-,-1,-1
RECMUS.txt,375479,377383,1904,10,N,N,-,-1,-1
RECMUS.txt,375580,377514,1934,10,N,N,-,-1,-1
RECMUS.txt,375643,377767,2124,10,N,N,-,-1,-1
RECMUS.txt,375824,377845,2021,10,N,N,-,-1,-1
RECMUS.txt,375869,378036,2167,10,N,N,-,-1,-1
RECMUS.txt,376196,378417,2221,10,Y,N,-,-1,-1
RECMUS.txt,376291,378662,2371,10,Y,N,-,-1,-1
RECMUS.txt,376599,378728,2129,10,Y,N,-,-1,-1
RECMUS.txt,377068,378842,1774,10,Y,N,-,-1,-1
RECMUS.txt,377333,378931,1598,10,N,N,-,-1,-1
RECMUS.txt,377386,379056,1670,10,N,N,-,-1,-1
RECMUS.txt,377515,379376,1861,10,N,N,-,-1,-1
RECMUS.txt,377768,379686,1918,10,Y,N,-,-1,-1
RECMUS.txt,377846,379760,1914,10,Y,N,-,-1,-1
RECMUS.txt,378039,379918,1879,10,Y,N,-,-1,-1
RECMUS.txt,378418,380030,1612,10,N,N,-,-1,-1
RECMUS.txt,378663,380098,1435,10,N,N,-,-1,-1
RECMUS.txt,378731,380284,1553,10,N,N,-,-1,-1
RECMUS.txt,378843,380466,1623,10,N,N,-,-1,-1
RECMUS.txt,378932,380544,1612,10,N,N,-,-1,-1
RECMUS.txt,379057,380659,1602,10,Y,N,-,-1,-1
RECMUS.txt,379377,380848,1471,10,Y,N,-,-1,-1
RECMUS.txt,379687,380989,1302,10,Y,N,-,-1,-1
RECMUS.txt,379765,381126,1361,10,N,N,-,-1,-1
RECMUS.txt,379919,381446,1527,10,Y,N,-,-1,-1
RECMUS.txt,380033,381746,1713,10,Y,N,-,-1,-1
RECMUS.txt,380099,382229,2130,10,Y,N,-,-1,-1
RECMUS.txt,380287,382396,2109,10,Y,N,-,-1,-1
RECMUS.txt,380469,382475,2006,10,Y,N,-,-1,-1
RECMUS.txt,380545,382712,2167,10,Y,N,-,-1,-1
RECMUS.txt,380660,382801,2141,10,Y,N,-,-1,-1
RECMUS.txt,380849,382911,2062,10,Y,N,-,-1,-1
RECMUS.txt,380990,383180,2190,10,Y,N,-,-1,-1
RECMUS.txt,381129,383315,2186,10,Y,N,-,-1,-1
RECMUS.txt,381447,383594,2147,10,Y,N,-,-1,-1
RECMUS.txt,381747,383936,2189,10,Y,N,-,-1,-1
RECMUS.txt,382232,384192,1960,10,Y,N,-,-1,-1
RECMUS.txt,382398,384430,2032,10,Y,N,-,-1,-1
RECMUS.txt,382476,384503,2027,10,Y,N,-,-1,-1
RECMUS.txt,382715,384589,1874,10,Y,N,-,-1,-1
RECMUS.txt,382802,384656,1854,10,N,N,-,-1,-1
RECMUS.txt,382912,384797,1885,10,N,N,-,-1,-1
RECMUS.txt,383182,384870,1688,10,N,N,-,-1,-1
RECMUS.txt,383318,384898,1580,10,N,N,-,-1,-1
RECMUS.txt,383595,384979,1384,10,N,N,-,-1,-1
RECMUS.txt,383937,385053,1116,10,N,N,-,-1,-1
RECMUS.txt,384193,385110,917,10,N,N,-,-1,-1
RECMUS.txt,384431,385361,930,10,N,N,-,-1,-1
RECMUS.txt,384504,385371,867,10,N,N,-,-1,-1
RECMUS.txt,384590,385457,867,10,N,N,-,-1,-1
RECMUS.txt,384657,385608,951,10,N,N,-,-1,-1
RECMUS.txt,384798,385827,1029,10,N,Y,1448280423373,85694,86154
RECMUS.txt,384871,386335,1464,10,Y,Y,1448280423373,85694,86154
RECMUS.txt,384899,386607,1708,10,Y,Y,1448280423373,85694,86154
RECMUS.txt,384982,386724,1742,10,Y,Y,1448280423373,85694,86154
RECMUS.txt,385054,386794,1740,10,Y,Y,1448280423373,85694,86154
RECMUS.txt,385111,386910,1799,10,Y,Y,1448280423373,85694,86154
RECMUS.txt,385362,387028,1666,10,Y,Y,1448280423373,85694,86154
RECMUS.txt,385372,387152,1780,10,Y,Y,1448280423373,85694,86154
RECMUS.txt,385460,387218,1758,10,Y,Y,1448280423373,85694,86154
RECMUS.txt,385609,387328,1719,10,Y,Y,1448280423373,85694,86154
RECMUS.txt,385828,387383,1555,10,N,Y,1448280423373,85694,86154
RECMUS.txt,386338,387416,1078,10,N,N,-,-1,-1
RECMUS.txt,386608,387543,935,10,N,N,-,-1,-1
RECMUS.txt,386725,387613,888,10,N,N,-,-1,-1
RECMUS.txt,386799,387619,820,10,N,N,-,-1,-1
RECMUS.txt,386911,387727,816,10,N,N,-,-1,-1
RECMUS.txt,387029,387828,799,10,N,N,-,-1,-1
RECMUS.txt,387154,387945,791,10,N,Y,1448313994373,179347,179715
RECMUS.txt,387219,388334,1115,10,N,Y,1448313994373,179347,179715
RECMUS.txt,387330,388721,1391,10,N,Y,1448313994373,179347,179715
RECMUS.txt,387385,388826,1441,10,N,Y,1448313994373,179347,179715
RECMUS.txt,387417,389060,1643,10,N,Y,1448313994373,179347,179715
RECMUS.txt,387544,389262,1718,10,N,Y,1448313994373,179347,179715
RECMUS.txt,387615,389314,1699,10,N,Y,1448313994373,179347,179715
RECMUS.txt,387620,389619,1999,10,N,Y,1448313994373,179347,179715
RECMUS.txt,387730,389747,2017,10,N,Y,1448313994373,179347,179715
RECMUS.txt,387829,389776,1947,10,N,Y,1448313994373,179347,179715
RECMUS.txt,387946,389993,2047,10,N,Y,1448313994373,179347,179715
RECMUS.txt,388335,390121,1786,10,N,Y,1448313994373,179347,179715
RECMUS.txt,388722,390257,1535,10,N,Y,1448313994373,179347,179715
RECMUS.txt,388827,390361,1534,10,N,Y,1448313994373,179347,179715
RECMUS.txt,389061,390426,1365,10,N,Y,1448313994373,179347,179715
RECMUS.txt,389263,390598,1335,10,N,Y,1448313994373,179347,179715
RECMUS.txt,389315,390655,1340,10,N,Y,1448313994373,179347,179715
RECMUS.txt,389620,390751,1131,10,N,N,-,-1,-1
RECMUS.txt,389748,390753,1005,10,N,N,-,-1,-1
RECMUS.txt,389777,390832,1055,10,N,N,-,-1,-1
RECMUS.txt,389994,390920,926,10,N,N,-,-1,-1
RECMUS.txt,390122,391168,1046,10,N,N,-,-1,-1
RECMUS.txt,390258,391308,1050,10,N,N,-,-1,-1
RECMUS.txt,390364,391388,1024,10,N,N,-,-1,-1
RECMUS.txt,390427,391498,1071,10,N,N,-,-1,-1
RECMUS.txt,390600,391827,1227,10,N,N,-,-1,-1
RECMUS.txt,390657,391991,1334,10,N,N,-,-1,-1
RECMUS.txt,390751,392155,1404,10,N,N,-,-1,-1
RECMUS.txt,390754,392344,1590,10,N,N,-,-1,-1
RECMUS.txt,390833,392647,1814,10,N,N,-,-1,-1
RECMUS.txt,390921,392716,1795,10,N,N,-,-1,-1
RECMUS.txt,391169,392828,1659,10,N,N,-,-1,-1
RECMUS.txt,391309,392958,1649,10,N,N,-,-1,-1
RECMUS.txt,391389,393025,1636,10,N,N,-,-1,-1
RECMUS.txt,391499,393115,1616,10,N,N,-,-1,-1
RECMUS.txt,391828,393202,1374,10,N,N,-,-1,-1
RECMUS.txt,391994,393364,1370,10,N,N,-,-1,-1
RECMUS.txt,392156,393376,1220,10,N,N,-,-1,-1
RECMUS.txt,392347,393392,1045,10,N,N,-,-1,-1
RECMUS.txt,392648,393419,771,10,N,N,-,-1,-1
RECMUS.txt,392719,393572,853,10,N,N,-,-1,-1
RECMUS.txt,392829,393608,779,10,N,N,-,-1,-1
RECMUS.txt,392960,393714,754,10,N,N,-,-1,-1
RECMUS.txt,393026,393822,796,10,N,N,-,-1,-1
RECMUS.txt,393116,393879,763,10,N,N,-,-1,-1
RECMUS.txt,393203,394023,820,10,N,N,-,-1,-1
RECMUS.txt,393366,394207,841,10,N,N,-,-1,-1
RECMUS.txt,393377,394406,1029,10,N,N,-,-1,-1
RECMUS.txt,393393,394534,1141,10,N,N,-,-1,-1
RECMUS.txt,393420,394632,1212,10,N,N,-,-1,-1
RECMUS.txt,393573,394639,1066,10,N,N,-,-1,-1
RECMUS.txt,393609,394858,1249,10,N,N,-,-1,-1
RECMUS.txt,393715,395141,1426,10,N,N,-,-1,-1
RECMUS.txt,393823,395294,1471,10,N,N,-,-1,-1
RECMUS.txt,393880,395311,1431,10,N,N,-,-1,-1
RECMUS.txt,394024,395319,1295,10,N,N,-,-1,-1
RECMUS.txt,394210,395827,1617,10,N,N,-,-1,-1
RECMUS.txt,394407,396130,1723,10,N,N,-,-1,-1
RECMUS.txt,394535,396193,1658,10,N,N,-,-1,-1
RECMUS.txt,394633,396499,1866,10,N,N,-,-1,-1
RECMUS.txt,394640,396650,2010,10,N,N,-,-1,-1
RECMUS.txt,394861,396724,1863,10,N,N,-,-1,-1
RECMUS.txt,395143,396789,1646,10,N,N,-,-1,-1
RECMUS.txt,395299,396849,1550,10,N,N,-,-1,-1
RECMUS.txt,395314,396924,1610,10,N,N,-,-1,-1
RECMUS.txt,395322,397058,1736,10,N,N,-,-1,-1
RECMUS.txt,395830,397220,1390,10,Y,N,-,-1,-1
RECMUS.txt,396131,397399,1268,10,N,N,-,-1,-1
RECMUS.txt,396194,397999,1805,10,Y,N,-,-1,-1
RECMUS.txt,396500,398136,1636,10,N,N,-,-1,-1
RECMUS.txt,396651,398301,1650,10,N,N,-,-1,-1
RECMUS.txt,396725,398493,1768,10,N,N,-,-1,-1
RECMUS.txt,396790,398681,1891,10,N,N,-,-1,-1
RECMUS.txt,396852,398782,1930,10,N,N,-,-1,-1
RECMUS.txt,396925,398901,1976,10,N,N,-,-1,-1
RECMUS.txt,397059,398940,1881,10,N,N,-,-1,-1
RECMUS.txt,397225,399089,1864,10,N,N,-,-1,-1
RECMUS.txt,397401,399092,1691,10,N,N,-,-1,-1
RECMUS.txt,398000,399198,1198,10,N,N,-,-1,-1
RECMUS.txt,398137,399314,1177,10,N,N,-,-1,-1
RECMUS.txt,398302,399535,1233,10,N,N,-,-1,-1
RECMUS.txt,398494,399602,1108,10,N,N,-,-1,-1
RECMUS.txt,398683,399731,1048,10,N,N,-,-1,-1
RECMUS.txt,398785,399986,1201,10,N,N,-,-1,-1
RECMUS.txt,398902,400247,1345,10,N,N,-,-1,-1
RECMUS.txt,398941,400416,1475,10,N,N,-,-1,-1
RECMUS.txt,399091,400536,1445,10,N,N,-,-1,-1
RECMUS.txt,399093,400624,1531,10,N,N,-,-1,-1
RECMUS.txt,399199,400788,1589,10,N,N,-,-1,-1
RECMUS.txt,399315,400945,1630,10,Y,N,-,-1,-1
RECMUS.txt,399536,401214,1678,10,Y,N,-,-1,-1
RECMUS.txt,399607,401532,1925,10,Y,N,-,-1,-1
RECMUS.txt,399733,401613,1880,10,Y,N,-,-1,-1
RECMUS.txt,399987,401784,1797,10,Y,N,-,-1,-1
RECMUS.txt,400248,401886,1638,10,Y,N,-,-1,-1
RECMUS.txt,400419,401934,1515,10,Y,N,-,-1,-1
RECMUS.txt,400537,402263,1726,10,Y,N,-,-1,-1
RECMUS.txt,400625,402331,1706,10,Y,N,-,-1,-1
RECMUS.txt,400789,402400,1611,10,Y,N,-,-1,-1
RECMUS.txt,400946,402555,1609,10,N,N,-,-1,-1
RECMUS.txt,401215,402953,1738,10,N,N,-,-1,-1
RECMUS.txt,401533,403166,1633,10,N,N,-,-1,-1
RECMUS.txt,401616,403417,1801,10,N,N,-,-1,-1
RECMUS.txt,401785,403746,1961,10,N,N,-,-1,-1
RECMUS.txt,401891,403835,1944,10,N,N,-,-1,-1
RECMUS.txt,401935,403959,2024,10,N,N,-,-1,-1
RECMUS.txt,402264,404205,1941,10,N,N,-,-1,-1
RECMUS.txt,402331,404600,2269,10,N,N,-,-1,-1
RECMUS.txt,402403,404681,2278,10,N,N,-,-1,-1
RECMUS.txt,402556,404696,2140,10,N,N,-,-1,-1
RECMUS.txt,402956,404779,1823,10,N,N,-,-1,-1
RECMUS.txt,403167,404857,1690,10,N,N,-,-1,-1
RECMUS.txt,403419,404858,1439,10,N,N,-,-1,-1
RECMUS.txt,403747,404897,1150,10,N,N,-,-1,-1
RECMUS.txt,403836,404909,1073,10,N,N,-,-1,-1
RECMUS.txt,403962,405199,1237,10,N,N,-,-1,-1
RECMUS.txt,404208,405217,1009,10,N,N,-,-1,-1
RECMUS.txt,404601,405348,747,10,N,Y,1448280673594,87462,88501
RECMUS.txt,404684,405415,731,10,N,Y,1448280673594,87462,88501
RECMUS.txt,404697,405579,882,10,N,Y,1448280673594,87462,88501
RECMUS.txt,404780,405912,1132,10,N,Y,1448280673594,87462,88501
RECMUS.txt,404857,405930,1073,10,N,Y,1448280673594,87462,88501
RECMUS.txt,404858,406003,1145,10,N,Y,1448280673594,87462,88501
RECMUS.txt,404898,406336,1438,10,N,Y,1448280673594,87462,88501
RECMUS.txt,404910,406411,1501,10,N,Y,1448280673594,87462,88501
RECMUS.txt,405202,406433,1231,10,N,Y,1448280673594,87462,88501
RECMUS.txt,405218,406464,1246,10,N,Y,1448280673594,87462,88501
RECMUS.txt,405349,406480,1131,10,N,Y,1448280673594,87462,88501
RECMUS.txt,405416,406618,1202,10,N,Y,1448280673594,87462,88501
RECMUS.txt,405580,406830,1250,10,N,N,-,-1,-1
RECMUS.txt,405913,406899,986,10,N,N,-,-1,-1
RECMUS.txt,405931,407176,1245,10,Y,N,-,-1,-1
RECMUS.txt,406004,407566,1562,10,Y,N,-,-1,-1
RECMUS.txt,406337,407640,1303,10,Y,N,-,-1,-1
RECMUS.txt,406412,407655,1243,10,Y,N,-,-1,-1
RECMUS.txt,406434,407746,1312,10,Y,N,-,-1,-1
RECMUS.txt,406465,407755,1290,10,Y,N,-,-1,-1
RECMUS.txt,406485,407867,1382,10,Y,N,-,-1,-1
RECMUS.txt,406619,407876,1257,10,Y,N,-,-1,-1
RECMUS.txt,406831,408045,1214,10,Y,N,-,-1,-1
RECMUS.txt,406902,408054,1152,10,Y,N,-,-1,-1
RECMUS.txt,407177,408145,968,10,N,N,-,-1,-1
RECMUS.txt,407567,408277,710,10,N,N,-,-1,-1
RECMUS.txt,407641,408390,749,10,N,N,-,-1,-1
RECMUS.txt,407658,408400,742,10,N,N,-,-1,-1
RECMUS.txt,407747,408474,727,10,N,N,-,-1,-1
RECMUS.txt,407756,408546,790,10,N,N,-,-1,-1
RECMUS.txt,407868,408556,688,10,N,N,-,-1,-1
RECMUS.txt,407877,408708,831,10,N,N,-,-1,-1
RECMUS.txt,408046,408867,821,10,N,N,-,-1,-1
RECMUS.txt,408055,409273,1218,10,N,N,-,-1,-1
RECMUS.txt,408146,409302,1156,10,N,N,-,-1,-1
RECMUS.txt,408279,409409,1130,10,N,N,-,-1,-1
RECMUS.txt,408391,409419,1028,10,N,N,-,-1,-1
RECMUS.txt,408401,409528,1127,10,N,N,-,-1,-1
RECMUS.txt,408477,409675,1198,10,N,N,-,-1,-1
RECMUS.txt,408547,409686,1139,10,N,N,-,-1,-1
RECMUS.txt,408557,409740,1183,10,N,N,-,-1,-1
RECMUS.txt,408711,409825,1114,10,N,Y,1448323072174,227638,227786
RECMUS.txt,408870,410018,1148,10,N,Y,1448323072174,227638,227786
RECMUS.txt,409274,410075,801,10,N,Y,1448323072174,227638,227786
RECMUS.txt,409303,410085,782,10,N,Y,1448323072174,227638,227786
RECMUS.txt,409410,410186,776,10,N,Y,1448323072174,227638,227786
RECMUS.txt,409420,410271,851,10,N,Y,1448323072174,227638,227786
RECMUS.txt,409529,410284,755,10,N,Y,1448323072174,227638,227786
RECMUS.txt,409675,410379,704,10,N,Y,1448323072174,227638,227786
RECMUS.txt,409687,410545,858,10,N,Y,1448323072174,227638,227786
RECMUS.txt,409741,410636,895,10,N,Y,1448323072174,227638,227786
RECMUS.txt,409826,410673,847,10,N,Y,1448323072174,227638,227786
RECMUS.txt,410019,410683,664,10,N,Y,1448323072174,227638,227786
RECMUS.txt,410076,410735,659,10,N,Y,1448315575026,182236,182361
RECMUS.txt,410086,410818,732,10,N,Y,1448315575026,182236,182361
RECMUS.txt,410188,410955,767,10,N,Y,1448315575026,182236,182361
RECMUS.txt,410274,410993,719,10,N,Y,1448315575026,182236,182361
RECMUS.txt,410285,411200,915,10,N,Y,1448315575026,182236,182361
RECMUS.txt,410380,411511,1131,10,N,Y,1448315575026,182236,182361
RECMUS.txt,410546,411572,1026,10,N,Y,1448315575026,182236,182361
RECMUS.txt,410637,411582,945,10,N,Y,1448315575026,182236,182361
RECMUS.txt,410674,411633,959,10,N,N,-,-1,-1
RECMUS.txt,410684,411716,1032,10,N,N,-,-1,-1
RECMUS.txt,410736,412019,1283,10,N,N,-,-1,-1
RECMUS.txt,410819,412133,1314,10,N,N,-,-1,-1
RECMUS.txt,410956,412275,1319,10,N,N,-,-1,-1
RECMUS.txt,410994,412445,1451,10,N,N,-,-1,-1
RECMUS.txt,411201,412552,1351,10,N,N,-,-1,-1
RECMUS.txt,411512,412786,1274,10,N,N,-,-1,-1
RECMUS.txt,411573,412856,1283,10,N,N,-,-1,-1
RECMUS.txt,411583,412914,1331,10,N,N,-,-1,-1
RECMUS.txt,411634,413025,1391,10,N,N,-,-1,-1
RECMUS.txt,411719,413088,1369,10,N,N,-,-1,-1
RECMUS.txt,412020,413126,1106,10,N,N,-,-1,-1
RECMUS.txt,412134,413229,1095,10,N,N,-,-1,-1
RECMUS.txt,412276,413301,1025,10,N,N,-,-1,-1
RECMUS.txt,412448,413461,1013,10,N,N,-,-1,-1
RECMUS.txt,412553,413581,1028,10,N,N,-,-1,-1
RECMUS.txt,412788,413670,882,10,N,N,-,-1,-1
RECMUS.txt,412859,413850,991,10,N,N,-,-1,-1
RECMUS.txt,412915,414112,1197,10,N,N,-,-1,-1
RECMUS.txt,413028,414285,1257,10,N,N,-,-1,-1
RECMUS.txt,413089,414438,1349,10,N,N,-,-1,-1
RECMUS.txt,413127,414537,1410,10,N,N,-,-1,-1
RECMUS.txt,413230,414913,1683,10,N,N,-,-1,-1
RECMUS.txt,413304,415117,1813,10,N,N,-,-1,-1
RECMUS.txt,413462,415227,1765,10,N,N,-,-1,-1
RECMUS.txt,413582,415447,1865,10,N,N,-,-1,-1
RECMUS.txt,413671,415609,1938,10,N,N,-,-1,-1
RECMUS.txt,413853,415662,1809,10,N,N,-,-1,-1
RECMUS.txt,414113,415692,1579,10,N,N,-,-1,-1
RECMUS.txt,414288,415747,1459,10,N,N,-,-1,-1
RECMUS.txt,414441,415801,1360,10,N,N,-,-1,-1
RECMUS.txt,414538,415967,1429,10,N,N,-,-1,-1
RECMUS.txt,414914,416138,1224,10,N,N,-,-1,-1
RECMUS.txt,415118,416355,1237,10,N,N,-,-1,-1
RECMUS.txt,415230,416492,1262,10,N,N,-,-1,-1
RECMUS.txt,415448,416578,1130,10,N,N,-,-1,-1
RECMUS.txt,415614,416644,1030,10,N,N,-,-1,-1
RECMUS.txt,415663,416994,1331,10,N,N,-,-1,-1
RECMUS.txt,415693,417031,1338,10,N,N,-,-1,-1
RECMUS.txt,415750,417056,1306,10,N,N,-,-1,-1
RECMUS.txt,415803,417161,1358,10,N,N,-,-1,-1
RECMUS.txt,415968,417304,1336,10,N,N,-,-1,-1
RECMUS.txt,416139,417472,1333,10,N,N,-,-1,-1
RECMUS.txt,416358,417794,1436,10,N,N,-,-1,-1
RECMUS.txt,416495,417889,1394,10,N,N,-,-1,-1
RECMUS.txt,416579,418033,1454,10,N,N,-,-1,-1
RECMUS.txt,416645,418365,1720,10,N,N,-,-1,-1
RECMUS.txt,416995,418482,1487,10,Y,N,-,-1,-1
RECMUS.txt,417032,418637,1605,10,Y,N,-,-1,-1
RECMUS.txt,417059,418801,1742,10,Y,N,-,-1,-1
RECMUS.txt,417162,419011,1849,10,Y,N,-,-1,-1
RECMUS.txt,417305,419028,1723,10,N,N,-,-1,-1
RECMUS.txt,417473,419048,1575,10,N,N,-,-1,-1
RECMUS.txt,417797,419113,1316,10,N,N,-,-1,-1
RECMUS.txt,417894,419155,1261,10,N,N,-,-1,-1
RECMUS.txt,418036,419219,1183,10,N,N,-,-1,-1
RECMUS.txt,418366,419356,990,10,N,N,-,-1,-1
RECMUS.txt,418483,419443,960,10,N,N,-,-1,-1
RECMUS.txt,418638,419531,893,10,N,N,-,-1,-1
RECMUS.txt,418802,419570,768,10,N,N,-,-1,-1
RECMUS.txt,419014,419719,705,10,N,N,-,-1,-1
RECMUS.txt,419029,419968,939,10,N,N,-,-1,-1
RECMUS.txt,419049,420188,1139,10,N,N,-,-1,-1
RECMUS.txt,419114,420226,1112,10,N,N,-,-1,-1
RECMUS.txt,419156,420310,1154,10,N,N,-,-1,-1
RECMUS.txt,419222,420581,1359,10,N,N,-,-1,-1
RECMUS.txt,419357,420656,1299,10,N,N,-,-1,-1
RECMUS.txt,419444,420721,1277,10,N,N,-,-1,-1
RECMUS.txt,419532,420788,1256,10,N,N,-,-1,-1
RECMUS.txt,419573,420884,1311,10,N,N,-,-1,-1
RECMUS.txt,419720,421032,1312,10,N,N,-,-1,-1
RECMUS.txt,419969,421448,1479,10,N,N,-,-1,-1
RECMUS.txt,420189,421637,1448,10,N,N,-,-1,-1
RECMUS.txt,420227,421848,1621,10,N,N,-,-1,-1
RECMUS.txt,420313,421964,1651,10,N,N,-,-1,-1
RECMUS.txt,420584,421996,1412,10,N,N,-,-1,-1
RECMUS.txt,420657,422089,1432,10,N,N,-,-1,-1
RECMUS.txt,420722,422158,1436,10,N,N,-,-1,-1
RECMUS.txt,420789,422251,1462,10,N,N,-,-1,-1
RECMUS.txt,420885,422428,1543,10,N,N,-,-1,-1
RECMUS.txt,421033,422593,1560,10,N,N,-,-1,-1
RECMUS.txt,421449,422648,1199,10,N,N,-,-1,-1
RECMUS.txt,421638,422841,1203,10,N,N,-,-1,-1
RECMUS.txt,421850,422958,1108,10,N,Y,1437490253936,460795,462238
RECMUS.txt,421966,423105,1139,10,N,Y,1437490253936,460795,462238
RECMUS.txt,421997,423275,1278,10,N,Y,1437490253936,460795,462238
RECMUS.txt,422090,423473,1383,10,N,Y,1437490253936,460795,462238
RECMUS.txt,422159,423765,1606,10,N,Y,1437490253936,460795,462238
RECMUS.txt,422253,423857,1604,10,N,Y,1437490253936,460795,462238
RECMUS.txt,422430,424067,1637,10,N,Y,1437490253936,460795,462238
RECMUS.txt,422596,424191,1595,10,N,Y,1437490253936,460795,462238
RECMUS.txt,422649,424376,1727,10,N,Y,1437490253936,460795,462238
RECMUS.txt,422842,424485,1643,10,N,Y,1437490253936,460795,462238
RECMUS.txt,422959,424533,1574,10,N,N,-,-1,-1
RECMUS.txt,423106,424613,1507,10,N,N,-,-1,-1
RECMUS.txt,423276,424898,1622,10,Y,N,-,-1,-1
RECMUS.txt,423474,424914,1440,10,N,N,-,-1,-1
RECMUS.txt,423767,424921,1154,10,N,N,-,-1,-1
RECMUS.txt,423858,425256,1398,10,N,N,-,-1,-1
RECMUS.txt,424068,425491,1423,10,N,N,-,-1,-1
RECMUS.txt,424192,425551,1359,10,N,N,-,-1,-1
RECMUS.txt,424377,425608,1231,10,N,N,-,-1,-1
RECMUS.txt,424487,425857,1370,10,N,N,-,-1,-1
RECMUS.txt,424534,426011,1477,10,N,N,-,-1,-1
RECMUS.txt,424616,426231,1615,10,N,N,-,-1,-1
RECMUS.txt,424903,426243,1340,10,N,N,-,-1,-1
RECMUS.txt,424916,426368,1452,10,N,N,-,-1,-1
RECMUS.txt,424924,426471,1547,10,N,N,-,-1,-1
RECMUS.txt,425259,426545,1286,10,N,N,-,-1,-1
RECMUS.txt,425492,426851,1359,10,N,N,-,-1,-1
RECMUS.txt,425552,426971,1419,10,N,N,-,-1,-1
RECMUS.txt,425609,427079,1470,10,N,N,-,-1,-1
RECMUS.txt,425860,427119,1259,10,N,N,-,-1,-1
RECMUS.txt,426013,427143,1130,10,N,N,-,-1,-1
RECMUS.txt,426232,427276,1044,10,N,N,-,-1,-1
RECMUS.txt,426244,427319,1075,10,N,N,-,-1,-1
RECMUS.txt,426369,427384,1015,10,N,N,-,-1,-1
RECMUS.txt,426472,427555,1083,10,N,N,-,-1,-1
RECMUS.txt,426547,427617,1070,10,N,N,-,-1,-1
RECMUS.txt,426852,427890,1038,10,N,N,-,-1,-1
RECMUS.txt,426972,428269,1297,10,N,N,-,-1,-1
RECMUS.txt,427082,428447,1365,10,N,N,-,-1,-1
RECMUS.txt,427120,428484,1364,10,N,N,-,-1,-1
RECMUS.txt,427144,428878,1734,10,Y,N,-,-1,-1
RECMUS.txt,427277,428910,1633,10,Y,N,-,-1,-1
RECMUS.txt,427321,428973,1652,10,Y,N,-,-1,-1
RECMUS.txt,427385,429145,1760,10,N,N,-,-1,-1
RECMUS.txt,427558,429155,1597,10,N,N,-,-1,-1
RECMUS.txt,427618,429290,1672,10,N,N,-,-1,-1
RECMUS.txt,427893,429432,1539,10,N,N,-,-1,-1
RECMUS.txt,428270,429454,1184,10,N,N,-,-1,-1
RECMUS.txt,428448,429508,1060,10,N,N,-,-1,-1
RECMUS.txt,428485,429678,1193,10,N,N,-,-1,-1
RECMUS.txt,428883,429797,914,10,N,N,-,-1,-1
RECMUS.txt,428915,429865,950,10,N,N,-,-1,-1
RECMUS.txt,428976,429979,1003,10,N,N,-,-1,-1
RECMUS.txt,429146,430085,939,10,N,N,-,-1,-1
RECMUS.txt,429157,430162,1005,10,N,N,-,-1,-1
RECMUS.txt,429291,430433,1142,10,N,N,-,-1,-1
RECMUS.txt,429433,430492,1059,10,N,N,-,-1,-1
RECMUS.txt,429455,430524,1069,10,N,N,-,-1,-1
RECMUS.txt,429510,430740,1230,10,N,N,-,-1,-1
RECMUS.txt,429679,430926,1247,10,N,N,-,-1,-1
RECMUS.txt,429798,431010,1212,10,N,N,-,-1,-1
RECMUS.txt,429866,431298,1432,10,N,N,-,-1,-1
RECMUS.txt,429980,431341,1361,10,N,N,-,-1,-1
RECMUS.txt,430086,431387,1301,10,N,N,-,-1,-1
RECMUS.txt,430165,431411,1246,10,N,N,-,-1,-1
RECMUS.txt,430434,431463,1029,10,N,N,-,-1,-1
RECMUS.txt,430493,431598,1105,10,N,N,-,-1,-1
RECMUS.txt,430525,431939,1414,10,N,N,-,-1,-1
RECMUS.txt,430741,432157,1416,10,N,N,-,-1,-1
RECMUS.txt,430928,432603,1675,10,N,N,-,-1,-1
RECMUS.txt,431011,432892,1881,10,N,N,-,-1,-1
RECMUS.txt,431299,432959,1660,10,N,N,-,-1,-1
RECMUS.txt,431342,433040,1698,10,N,N,-,-1,-1
RECMUS.txt,431388,433156,1768,10,N,N,-,-1,-1
RECMUS.txt,431414,433223,1809,10,N,N,-,-1,-1
RECMUS.txt,431465,433286,1821,10,N,N,-,-1,-1
RECMUS.txt,431599,433324,1725,10,N,N,-,-1,-1
RECMUS.txt,431941,433473,1532,10,N,N,-,-1,-1
RECMUS.txt,432158,433754,1596,10,N,N,-,-1,-1
RECMUS.txt,432604,433980,1376,10,N,N,-,-1,-1
RECMUS.txt,432893,434221,1328,10,N,N,-,-1,-1
RECMUS.txt,432959,434389,1430,10,N,N,-,-1,-1
RECMUS.txt,433041,434617,1576,10,N,N,-,-1,-1
RECMUS.txt,433159,435060,1901,10,Y,N,-,-1,-1
RECMUS.txt,433224,435278,2054,10,Y,N,-,-1,-1
RECMUS.txt,433287,435309,2022,10,Y,N,-,-1,-1
RECMUS.txt,433327,435537,2210,10,Y,N,-,-1,-1
RECMUS.txt,433474,435710,2236,10,Y,N,-,-1,-1
RECMUS.txt,433755,435931,2176,10,Y,N,-,-1,-1
RECMUS.txt,433981,436060,2079,10,N,N,-,-1,-1
RECMUS.txt,434222,436383,2161,10,N,N,-,-1,-1
RECMUS.txt,434392,436508,2116,10,N,N,-,-1,-1
RECMUS.txt,434620,436600,1980,10,N,N,-,-1,-1
RECMUS.txt,435063,436751,1688,10,N,N,-,-1,-1
RECMUS.txt,435283,436953,1670,10,N,N,-,-1,-1
RECMUS.txt,435310,437080,1770,10,N,N,-,-1,-1
RECMUS.txt,435538,437215,1677,10,N,N,-,-1,-1
RECMUS.txt,435711,437309,1598,10,N,N,-,-1,-1
RECMUS.txt,435933,437534,1601,10,N,N,-,-1,-1
RECMUS.txt,436063,437654,1591,10,Y,N,-,-1,-1
RECMUS.txt,436384,437738,1354,10,N,N,-,-1,-1
RECMUS.txt,436509,437928,1419,10,N,N,-,-1,-1
RECMUS.txt,436601,438025,1424,10,Y,N,-,-1,-1
RECMUS.txt,436752,438247,1495,10,Y,N,-,-1,-1
RECMUS.txt,436955,438510,1555,10,Y,N,-,-1,-1
RECMUS.txt,437083,438613,1530,10,Y,N,-,-1,-1
RECMUS.txt,437216,438722,1506,10,Y,N,-,-1,-1
RECMUS.txt,437311,438797,1486,10,Y,N,-,-1,-1
RECMUS.txt,437539,438877,1338,10,Y,N,-,-1,-1
RECMUS.txt,437655,438979,1324,10,N,N,-,-1,-1
RECMUS.txt,437739,439046,1307,10,N,N,-,-1,-1
RECMUS.txt,437929,439059,1130,10,N,N,-,-1,-1
RECMUS.txt,438028,439101,1073,10,N,N,-,-1,-1
RECMUS.txt,438248,439198,950,10,N,N,-,-1,-1
RECMUS.txt,438511,439317,806,10,N,N,-,-1,-1
RECMUS.txt,438615,439341,726,10,N,N,-,-1,-1
RECMUS.txt,438723,439397,674,10,N,N,-,-1,-1
RECMUS.txt,438798,439553,755,10,N,N,-,-1,-1
RECMUS.txt,438880,439610,730,10,N,N,-,-1,-1
RECMUS.txt,438980,439761,781,10,N,N,-,-1,-1
RECMUS.txt,439047,439866,819,10,N,N,-,-1,-1
RECMUS.txt,439060,439883,823,10,N,N,-,-1,-1
RECMUS.txt,439102,440003,901,10,N,N,-,-1,-1
RECMUS.txt,439199,440025,826,10,N,N,-,-1,-1
RECMUS.txt,439318,440069,751,10,N,N,-,-1,-1
RECMUS.txt,439342,440116,774,10,N,N,-,-1,-1
RECMUS.txt,439398,440288,890,10,N,N,-,-1,-1
RECMUS.txt,439554,440379,825,10,N,N,-,-1,-1
RECMUS.txt,439611,440455,844,10,N,N,-,-1,-1
RECMUS.txt,439762,440590,828,10,N,N,-,-1,-1
RECMUS.txt,439866,440779,913,10,N,N,-,-1,-1
RECMUS.txt,439888,440832,944,10,N,N,-,-1,-1
RECMUS.txt,440003,440995,992,10,N,N,-,-1,-1
RECMUS.txt,440026,441156,1130,10,N,N,-,-1,-1
RECMUS.txt,440072,441267,1195,10,N,N,-,-1,-1
RECMUS.txt,440117,441437,1320,10,N,N,-,-1,-1
RECMUS.txt,440290,441515,1225,10,N,N,-,-1,-1
RECMUS.txt,440382,441727,1345,10,N,N,-,-1,-1
RECMUS.txt,440456,441888,1432,10,N,N,-,-1,-1
RECMUS.txt,440591,442178,1587,10,Y,N,-,-1,-1
RECMUS.txt,440780,442227,1447,10,Y,N,-,-1,-1
RECMUS.txt,440835,442345,1510,10,Y,N,-,-1,-1
RECMUS.txt,440996,442415,1419,10,Y,N,-,-1,-1
RECMUS.txt,441157,442738,1581,10,Y,N,-,-1,-1
RECMUS.txt,441270,442907,1637,10,Y,N,-,-1,-1
RECMUS.txt,441439,443016,1577,10,Y,N,-,-1,-1
RECMUS.txt,441518,443165,1647,10,Y,N,-,-1,-1
RECMUS.txt,441730,443361,1631,10,Y,N,-,-1,-1
RECMUS.txt,441889,443527,1638,10,Y,N,-,-1,-1
RECMUS.txt,442183,443626,1443,10,Y,N,-,-1,-1
RECMUS.txt,442228,443936,1708,10,Y,N,-,-1,-1
RECMUS.txt,442348,444109,1761,10,Y,N,-,-1,-1
RECMUS.txt,442416,444331,1915,10,Y,N,-,-1,-1
RECMUS.txt,442739,444413,1674,10,Y,N,-,-1,-1
RECMUS.txt,442908,444535,1627,10,Y,N,-,-1,-1
RECMUS.txt,443017,444569,1552,10,Y,N,-,-1,-1
RECMUS.txt,443168,444681,1513,10,Y,N,-,-1,-1
RECMUS.txt,443364,444778,1414,10,N,N,-,-1,-1
RECMUS.txt,443529,444863,1334,10,N,Y,1448316586529,210063,210674
RECMUS.txt,443627,444986,1359,10,Y,Y,1448316586529,210063,210674
RECMUS.txt,443938,445292,1354,10,Y,Y,1448316586529,210063,210674
RECMUS.txt,444112,445577,1465,10,N,Y,1448316586529,210063,210674
RECMUS.txt,444332,445714,1382,10,N,Y,1448316586529,210063,210674
RECMUS.txt,444414,445828,1414,10,N,Y,1448316586529,210063,210674
RECMUS.txt,444540,446149,1609,10,N,Y,1448316586529,210063,210674
RECMUS.txt,444570,446328,1758,10,N,Y,1448316586529,210063,210674
RECMUS.txt,444684,446554,1870,10,N,Y,1448316586529,210063,210674
RECMUS.txt,444779,446751,1972,10,N,Y,1448316586529,210063,210674
RECMUS.txt,444864,446899,2035,10,Y,Y,1448316586529,210063,210674
RECMUS.txt,444987,447018,2031,10,N,N,-,-1,-1
RECMUS.txt,445293,447239,1946,10,N,N,-,-1,-1
RECMUS.txt,445578,447551,1973,10,N,N,-,-1,-1
RECMUS.txt,445715,447607,1892,10,N,N,-,-1,-1
RECMUS.txt,445829,447834,2005,10,N,N,-,-1,-1
RECMUS.txt,446150,447937,1787,10,N,N,-,-1,-1
RECMUS.txt,446331,448297,1966,10,N,N,-,-1,-1
RECMUS.txt,446555,448494,1939,10,Y,N,-,-1,-1
RECMUS.txt,446752,448529,1777,10,Y,N,-,-1,-1
RECMUS.txt,446904,448608,1704,10,Y,N,-,-1,-1
RECMUS.txt,447020,448751,1731,10,Y,N,-,-1,-1
RECMUS.txt,447240,448891,1651,10,Y,N,-,-1,-1
RECMUS.txt,447553,449175,1622,10,N,N,-,-1,-1
RECMUS.txt,447609,449279,1670,10,N,N,-,-1,-1
RECMUS.txt,447835,449291,1456,10,N,N,-,-1,-1
RECMUS.txt,447938,449539,1601,10,N,N,-,-1,-1
RECMUS.txt,448298,449704,1406,10,N,N,-,-1,-1
RECMUS.txt,448496,449753,1257,10,N,N,-,-1,-1
RECMUS.txt,448530,449790,1260,10,N,N,-,-1,-1
RECMUS.txt,448611,450076,1465,10,N,N,-,-1,-1
RECMUS.txt,448752,450217,1465,10,N,N,-,-1,-1
RECMUS.txt,448892,450298,1406,10,N,N,-,-1,-1
RECMUS.txt,449176,450482,1306,10,N,N,-,-1,-1
RECMUS.txt,449279,450597,1318,10,N,N,-,-1,-1
RECMUS.txt,449292,450676,1384,10,N,N,-,-1,-1
RECMUS.txt,449540,450767,1227,10,N,N,-,-1,-1
RECMUS.txt,449705,450829,1124,10,N,N,-,-1,-1
RECMUS.txt,449755,450990,1235,10,N,N,-,-1,-1
RECMUS.txt,449791,451045,1254,10,N,N,-,-1,-1
RECMUS.txt,450079,451219,1140,10,N,N,-,-1,-1
RECMUS.txt,450218,451334,1116,10,N,N,-,-1,-1
RECMUS.txt,450299,451438,1139,10,N,N,-,-1,-1
RECMUS.txt,450484,451516,1032,10,N,N,-,-1,-1
RECMUS.txt,450598,451740,1142,10,N,N,-,-1,-1
RECMUS.txt,450677,452451,1774,10,N,N,-,-1,-1
RECMUS.txt,450768,452575,1807,10,N,N,-,-1,-1
RECMUS.txt,450830,452697,1867,10,N,N,-,-1,-1
RECMUS.txt,450993,452790,1797,10,N,N,-,-1,-1
RECMUS.txt,451047,452864,1817,10,N,N,-,-1,-1
RECMUS.txt,451220,453017,1797,10,N,N,-,-1,-1
RECMUS.txt,451335,453062,1727,10,N,N,-,-1,-1
RECMUS.txt,451441,453232,1791,10,N,N,-,-1,-1
RECMUS.txt,451519,453331,1812,10,N,N,-,-1,-1
RECMUS.txt,451743,453490,1747,10,N,N,-,-1,-1
RECMUS.txt,452454,453595,1141,10,N,N,-,-1,-1
RECMUS.txt,452576,453612,1036,10,N,N,-,-1,-1
RECMUS.txt,452698,453619,921,10,N,N,-,-1,-1
RECMUS.txt,452791,454044,1253,10,N,N,-,-1,-1
RECMUS.txt,452866,454234,1368,10,N,N,-,-1,-1
RECMUS.txt,453018,454273,1255,10,N,N,-,-1,-1
RECMUS.txt,453063,454405,1342,10,N,N,-,-1,-1
RECMUS.txt,453233,454629,1396,10,Y,N,-,-1,-1
RECMUS.txt,453334,454840,1506,10,Y,N,-,-1,-1
RECMUS.txt,453491,455056,1565,10,Y,N,-,-1,-1
RECMUS.txt,453600,455198,1598,10,Y,N,-,-1,-1
RECMUS.txt,453614,455400,1786,10,Y,N,-,-1,-1
RECMUS.txt,453622,455527,1905,10,Y,N,-,-1,-1
RECMUS.txt,454047,455638,1591,10,N,N,-,-1,-1
RECMUS.txt,454235,455663,1428,10,N,N,-,-1,-1
RECMUS.txt,454276,455948,1672,10,N,N,-,-1,-1
RECMUS.txt,454406,456005,1599,10,N,N,-,-1,-1
RECMUS.txt,454631,456134,1503,10,N,N,-,-1,-1
RECMUS.txt,454841,456368,1527,10,N,N,-,-1,-1
RECMUS.txt,455058,456488,1430,10,N,N,-,-1,-1
RECMUS.txt,455201,456607,1406,10,N,N,-,-1,-1
RECMUS.txt,455401,456639,1238,10,N,N,-,-1,-1
RECMUS.txt,455530,456668,1138,10,N,N,-,-1,-1
RECMUS.txt,455640,456769,1129,10,N,N,-,-1,-1
RECMUS.txt,455664,456929,1265,10,N,N,-,-1,-1
RECMUS.txt,455949,457046,1097,10,N,N,-,-1,-1
RECMUS.txt,456006,457276,1270,10,N,N,-,-1,-1
RECMUS.txt,456135,457452,1317,10,Y,N,-,-1,-1
RECMUS.txt,456369,457554,1185,10,Y,N,-,-1,-1
RECMUS.txt,456489,457674,1185,10,Y,N,-,-1,-1
RECMUS.txt,456608,457792,1184,10,Y,N,-,-1,-1
RECMUS.txt,456640,457871,1231,10,Y,N,-,-1,-1
RECMUS.txt,456671,458115,1444,10,Y,N,-,-1,-1
RECMUS.txt,456770,458302,1532,10,N,N,-,-1,-1
RECMUS.txt,456930,458442,1512,10,N,N,-,-1,-1
RECMUS.txt,457047,458494,1447,10,N,N,-,-1,-1
RECMUS.txt,457277,458512,1235,10,N,N,-,-1,-1
RECMUS.txt,457453,458897,1444,10,N,N,-,-1,-1
RECMUS.txt,457555,459261,1706,10,N,N,-,-1,-1
RECMUS.txt,457675,459355,1680,10,N,N,-,-1,-1
RECMUS.txt,457795,459512,1717,10,N,N,-,-1,-1
RECMUS.txt,457872,459608,1736,10,N,N,-,-1,-1
RECMUS.txt,458117,459771,1654,10,N,N,-,-1,-1
RECMUS.txt,458303,459890,1587,10,N,N,-,-1,-1
RECMUS.txt,458442,460301,1859,10,Y,N,-,-1,-1
RECMUS.txt,458495,460416,1921,10,Y,N,-,-1,-1
RECMUS.txt,458513,460862,2349,10,Y,N,-,-1,-1
RECMUS.txt,458900,461066,2166,10,Y,N,-,-1,-1
RECMUS.txt,459262,461075,1813,10,Y,N,-,-1,-1
RECMUS.txt,459356,461084,1728,10,Y,N,-,-1,-1
RECMUS.txt,459513,461094,1581,10,Y,N,-,-1,-1
RECMUS.txt,459609,461103,1494,10,Y,N,-,-1,-1
RECMUS.txt,459772,461171,1399,10,Y,N,-,-1,-1
RECMUS.txt,459891,461200,1309,10,Y,N,-,-1,-1
RECMUS.txt,460306,461202,896,10,Y,N,-,-1,-1
RECMUS.txt,460417,461235,818,10,N,N,-,-1,-1
RECMUS.txt,460865,461256,391,10,N,N,-,-1,-1
RECMUS.txt,461070,461258,188,10,N,N,-,-1,-1
RECMUS.txt,461079,461269,190,10,N,N,-,-1,-1
RECMUS.txt,461088,461271,183,10,N,N,-,-1,-1
RECMUS.txt,461098,461294,196,10,N,N,-,-1,-1
RECMUS.txt,461107,461316,209,10,N,N,-,-1,-1
RECMUS.txt,461172,461327,155,10,N,N,-,-1,-1
RECMUS.txt,461201,461328,127,10,N,N,-,-1,-1
RECMUS.txt,461203,461357,154,10,N,N,-,-1,-1
RECMUS.txt,461236,461386,150,10,N,N,-,-1,-1
RECMUS.txt,461257,461387,130,10,N,N,-,-1,-1
RECMUS.txt,461262,461411,149,10,N,N,-,-1,-1
RECMUS.txt,461270,461439,169,10,N,N,-,-1,-1
RECMUS.txt,461272,461441,169,10,N,N,-,-1,-1
RECMUS.txt,461295,461556,261,10,N,N,-,-1,-1
RECMUS.txt,461320,461558,238,10,N,N,-,-1,-1
RECMUS.txt,461327,461587,260,10,N,N,-,-1,-1
RECMUS.txt,461329,461616,287,10,N,N,-,-1,-1
RECMUS.txt,461358,461618,260,10,N,N,-,-1,-1
RECMUS.txt,461386,461656,270,10,N,N,-,-1,-1
RECMUS.txt,461388,461658,270,10,N,N,-,-1,-1
RECMUS.txt,461412,461699,287,10,N,N,-,-1,-1
RECMUS.txt,461440,461701,261,10,N,N,-,-1,-1
RECMUS.txt,461442,461711,269,10,N,N,-,-1,-1
RECMUS.txt,461557,461712,155,10,N,N,-,-1,-1
RECMUS.txt,461559,461737,178,10,N,N,-,-1,-1
RECMUS.txt,461588,461739,151,10,N,N,-,-1,-1
RECMUS.txt,461617,461801,184,10,N,N,-,-1,-1
RECMUS.txt,461619,461803,184,10,N,N,-,-1,-1
RECMUS.txt,461657,461818,161,10,N,N,-,-1,-1
RECMUS.txt,461659,461819,160,10,N,N,-,-1,-1
RECMUS.txt,461700,461920,220,10,N,N,-,-1,-1
RECMUS.txt,461705,462187,482,10,N,N,-,-1,-1
RECMUS.txt,461711,462288,577,10,N,N,-,-1,-1
RECMUS.txt,461713,462351,638,10,N,N,-,-1,-1
RECMUS.txt,461738,462688,950,10,Y,N,-,-1,-1
RECMUS.txt,461743,462797,1054,10,Y,N,-,-1,-1
RECMUS.txt,461802,462921,1119,10,Y,N,-,-1,-1
RECMUS.txt,461807,463161,1354,10,Y,N,-,-1,-1
RECMUS.txt,461818,463299,1481,10,Y,N,-,-1,-1
RECMUS.txt,461820,463351,1531,10,Y,N,-,-1,-1
RECMUS.txt,461921,463425,1504,10,Y,N,-,-1,-1
RECMUS.txt,462188,463542,1354,10,Y,N,-,-1,-1
RECMUS.txt,462289,463589,1300,10,Y,N,-,-1,-1
RECMUS.txt,462352,463820,1468,10,Y,N,-,-1,-1
RECMUS.txt,462689,463941,1252,10,N,N,-,-1,-1
RECMUS.txt,462800,464120,1320,10,N,N,-,-1,-1
RECMUS.txt,462922,464284,1362,10,N,N,-,-1,-1
RECMUS.txt,463164,464388,1224,10,N,N,-,-1,-1
RECMUS.txt,463300,464502,1202,10,N,N,-,-1,-1
RECMUS.txt,463352,464698,1346,10,N,N,-,-1,-1
RECMUS.txt,463426,464798,1372,10,N,N,-,-1,-1
RECMUS.txt,463543,464859,1316,10,N,N,-,-1,-1
RECMUS.txt,463590,465221,1631,10,N,N,-,-1,-1
RECMUS.txt,463821,465513,1692,10,N,Y,1448314192885,179720,179950
RECMUS.txt,463942,465847,1905,10,Y,Y,1448314192885,179720,179950
RECMUS.txt,464121,466001,1880,10,Y,Y,1448314192885,179720,179950
RECMUS.txt,464285,466158,1873,10,N,Y,1448314192885,179720,179950
RECMUS.txt,464389,466444,2055,10,N,Y,1448314192885,179720,179950
RECMUS.txt,464503,466671,2168,10,N,Y,1448314192885,179720,179950
RECMUS.txt,464699,466729,2030,10,N,Y,1448314192885,179720,179950
RECMUS.txt,464799,466744,1945,10,N,Y,1448314192885,179720,179950
RECMUS.txt,464862,466894,2032,10,N,Y,1448314192885,179720,179950
RECMUS.txt,465222,466970,1748,10,N,Y,1448314192885,179720,179950
RECMUS.txt,465514,466975,1461,10,N,N,-,-1,-1
RECMUS.txt,465848,467169,1321,10,N,N,-,-1,-1
RECMUS.txt,466002,467337,1335,10,N,N,-,-1,-1
RECMUS.txt,466161,467625,1464,10,N,N,-,-1,-1
RECMUS.txt,466445,467711,1266,10,N,N,-,-1,-1
RECMUS.txt,466672,468046,1374,10,N,N,-,-1,-1
RECMUS.txt,466730,468363,1633,10,N,N,-,-1,-1
RECMUS.txt,466745,468505,1760,10,N,N,-,-1,-1
RECMUS.txt,466895,468616,1721,10,N,N,-,-1,-1
RECMUS.txt,466971,468834,1863,10,N,N,-,-1,-1
RECMUS.txt,466976,468931,1955,10,N,N,-,-1,-1
RECMUS.txt,467170,469061,1891,10,N,N,-,-1,-1
RECMUS.txt,467338,469156,1818,10,N,N,-,-1,-1
RECMUS.txt,467626,469272,1646,10,N,N,-,-1,-1
RECMUS.txt,467712,469380,1668,10,N,N,-,-1,-1
RECMUS.txt,468046,469459,1413,10,N,N,-,-1,-1
RECMUS.txt,468364,469516,1152,10,N,N,-,-1,-1
RECMUS.txt,468506,469534,1028,10,N,N,-,-1,-1
RECMUS.txt,468618,469546,928,10,N,N,-,-1,-1
RECMUS.txt,468835,470000,1165,10,N,N,-,-1,-1
RECMUS.txt,468932,470181,1249,10,N,N,-,-1,-1
RECMUS.txt,469062,470518,1456,10,N,N,-,-1,-1
RECMUS.txt,469159,470762,1603,10,N,N,-,-1,-1
RECMUS.txt,469274,470836,1562,10,N,N,-,-1,-1
RECMUS.txt,469381,471144,1763,10,Y,N,-,-1,-1
RECMUS.txt,469460,471285,1825,10,Y,N,-,-1,-1
RECMUS.txt,469521,471412,1891,10,Y,N,-,-1,-1
RECMUS.txt,469537,471522,1985,10,Y,N,-,-1,-1
RECMUS.txt,469547,471702,2155,10,Y,N,-,-1,-1
RECMUS.txt,470003,471861,1858,10,Y,N,-,-1,-1
RECMUS.txt,470182,471966,1784,10,Y,N,-,-1,-1
RECMUS.txt,470519,472167,1648,10,Y,N,-,-1,-1
RECMUS.txt,470764,472323,1559,10,Y,N,-,-1,-1
RECMUS.txt,470839,472378,1539,10,Y,N,-,-1,-1
RECMUS.txt,471147,472542,1395,10,N,N,-,-1,-1
RECMUS.txt,471286,472555,1269,10,N,N,-,-1,-1
RECMUS.txt,471413,472698,1285,10,N,N,-,-1,-1
RECMUS.txt,471525,472820,1295,10,N,N,-,-1,-1
RECMUS.txt,471703,472910,1207,10,N,N,-,-1,-1
RECMUS.txt,471862,472921,1059,10,N,N,-,-1,-1
RECMUS.txt,471967,473047,1080,10,N,N,-,-1,-1
RECMUS.txt,472169,473052,883,10,N,N,-,-1,-1
RECMUS.txt,472324,473064,740,10,N,N,-,-1,-1
RECMUS.txt,472379,473161,782,10,N,N,-,-1,-1
RECMUS.txt,472543,473218,675,10,N,N,-,-1,-1
RECMUS.txt,472556,473321,765,10,N,N,-,-1,-1
RECMUS.txt,472699,473467,768,10,N,N,-,-1,-1
RECMUS.txt,472822,473676,854,10,N,N,-,-1,-1
RECMUS.txt,472911,473794,883,10,N,N,-,-1,-1
RECMUS.txt,472922,473836,914,10,N,N,-,-1,-1
RECMUS.txt,473048,473942,894,10,N,N,-,-1,-1
RECMUS.txt,473055,474064,1009,10,N,N,-,-1,-1
RECMUS.txt,473065,474235,1170,10,N,N,-,-1,-1
RECMUS.txt,473162,474375,1213,10,N,N,-,-1,-1
RECMUS.txt,473221,474436,1215,10,N,N,-,-1,-1
RECMUS.txt,473322,474546,1224,10,N,N,-,-1,-1
RECMUS.txt,473468,474827,1359,10,N,N,-,-1,-1
RECMUS.txt,473678,474888,1210,10,N,N,-,-1,-1
RECMUS.txt,473799,475099,1300,10,N,N,-,-1,-1
RECMUS.txt,473836,475239,1403,10,N,N,-,-1,-1
RECMUS.txt,473943,475346,1403,10,N,N,-,-1,-1
RECMUS.txt,474067,475535,1468,10,N,N,-,-1,-1
RECMUS.txt,474236,475716,1480,10,N,N,-,-1,-1
RECMUS.txt,474376,475873,1497,10,N,N,-,-1,-1
RECMUS.txt,474437,476072,1635,10,N,N,-,-1,-1
RECMUS.txt,474547,476137,1590,10,N,N,-,-1,-1
RECMUS.txt,474829,476190,1361,10,N,N,-,-1,-1
RECMUS.txt,474890,476461,1571,10,N,N,-,-1,-1
RECMUS.txt,475100,476812,1712,10,N,N,-,-1,-1
RECMUS.txt,475242,476989,1747,10,N,N,-,-1,-1
RECMUS.txt,475347,477172,1825,10,N,N,-,-1,-1
RECMUS.txt,475536,477314,1778,10,N,N,-,-1,-1
RECMUS.txt,475717,477606,1889,10,Y,N,-,-1,-1
RECMUS.txt,475874,477704,1830,10,N,N,-,-1,-1
RECMUS.txt,476073,477810,1737,10,N,N,-,-1,-1
RECMUS.txt,476138,477865,1727,10,Y,N,-,-1,-1
RECMUS.txt,476191,478029,1838,10,Y,N,-,-1,-1
RECMUS.txt,476462,478075,1613,10,Y,N,-,-1,-1
RECMUS.txt,476815,478144,1329,10,Y,N,-,-1,-1
RECMUS.txt,476991,478304,1313,10,Y,N,-,-1,-1
RECMUS.txt,477175,478417,1242,10,N,N,-,-1,-1
RECMUS.txt,477315,478492,1177,10,N,N,-,-1,-1
RECMUS.txt,477607,478625,1018,10,N,N,-,-1,-1
RECMUS.txt,477707,478728,1021,10,N,N,-,-1,-1
RECMUS.txt,477811,478772,961,10,N,N,-,-1,-1
RECMUS.txt,477866,478806,940,10,N,N,-,-1,-1
RECMUS.txt,478030,478911,881,10,N,N,-,-1,-1
RECMUS.txt,478076,479105,1029,10,N,N,-,-1,-1
RECMUS.txt,478145,479162,1017,10,N,N,-,-1,-1
RECMUS.txt,478305,479268,963,10,N,N,-,-1,-1
RECMUS.txt,478418,479436,1018,10,N,N,-,-1,-1
RECMUS.txt,478495,479520,1025,10,N,N,-,-1,-1
RECMUS.txt,478626,479629,1003,10,N,N,-,-1,-1
RECMUS.txt,478729,479701,972,10,N,N,-,-1,-1
RECMUS.txt,478773,479747,974,10,N,N,-,-1,-1
RECMUS.txt,478807,479897,1090,10,N,N,-,-1,-1
RECMUS.txt,478912,479917,1005,10,N,N,-,-1,-1
RECMUS.txt,479106,479958,852,10,N,N,-,-1,-1
RECMUS.txt,479163,479996,833,10,N,N,-,-1,-1
RECMUS.txt,479269,480060,791,10,N,N,-,-1,-1
RECMUS.txt,479437,480176,739,10,N,N,-,-1,-1
RECMUS.txt,479522,480303,781,10,N,N,-,-1,-1
RECMUS.txt,479630,480500,870,10,N,N,-,-1,-1
RECMUS.txt,479702,480551,849,10,N,N,-,-1,-1
RECMUS.txt,479750,480625,875,10,N,N,-,-1,-1
RECMUS.txt,479898,480663,765,10,N,N,-,-1,-1
RECMUS.txt,479919,480742,823,10,N,N,-,-1,-1
RECMUS.txt,479959,480892,933,10,N,N,-,-1,-1
RECMUS.txt,479997,480969,972,10,N,N,-,-1,-1
RECMUS.txt,480061,481258,1197,10,N,N,-,-1,-1
RECMUS.txt,480177,481372,1195,10,N,N,-,-1,-1
RECMUS.txt,480304,481469,1165,10,N,N,-,-1,-1
RECMUS.txt,480501,481618,1117,10,N,N,-,-1,-1
RECMUS.txt,480552,481775,1223,10,N,N,-,-1,-1
RECMUS.txt,480627,482092,1465,10,N,N,-,-1,-1
RECMUS.txt,480664,482188,1524,10,N,N,-,-1,-1
RECMUS.txt,480745,482335,1590,10,N,N,-,-1,-1
RECMUS.txt,480894,482487,1593,10,N,N,-,-1,-1
RECMUS.txt,480970,482580,1610,10,N,N,-,-1,-1
RECMUS.txt,481259,482706,1447,10,N,N,-,-1,-1
RECMUS.txt,481373,482731,1358,10,N,N,-,-1,-1
RECMUS.txt,481471,482869,1398,10,N,N,-,-1,-1
RECMUS.txt,481619,482996,1377,10,N,N,-,-1,-1
RECMUS.txt,481776,483253,1477,10,N,N,-,-1,-1
RECMUS.txt,482093,483258,1165,10,N,N,-,-1,-1
RECMUS.txt,482189,483288,1099,10,N,N,-,-1,-1
RECMUS.txt,482336,483467,1131,10,N,N,-,-1,-1
RECMUS.txt,482488,483573,1085,10,N,N,-,-1,-1
RECMUS.txt,482581,483689,1108,10,N,N,-,-1,-1
RECMUS.txt,482707,483768,1061,10,N,N,-,-1,-1
RECMUS.txt,482732,483803,1071,10,Y,N,-,-1,-1
RECMUS.txt,482870,483889,1019,10,Y,N,-,-1,-1
RECMUS.txt,482997,483906,909,10,Y,N,-,-1,-1
RECMUS.txt,483253,484111,858,10,N,N,-,-1,-1
RECMUS.txt,483261,484264,1003,10,Y,N,-,-1,-1
RECMUS.txt,483289,484372,1083,10,Y,N,-,-1,-1
RECMUS.txt,483468,484546,1078,10,N,N,-,-1,-1
RECMUS.txt,483574,484775,1201,10,Y,N,-,-1,-1
RECMUS.txt,483690,484926,1236,10,N,N,-,-1,-1
RECMUS.txt,483769,485126,1357,10,N,N,-,-1,-1
RECMUS.txt,483804,485321,1517,10,Y,N,-,-1,-1
RECMUS.txt,483890,485363,1473,10,Y,N,-,-1,-1
RECMUS.txt,483907,485455,1548,10,Y,N,-,-1,-1
RECMUS.txt,484112,485558,1446,10,Y,N,-,-1,-1
RECMUS.txt,484265,485589,1324,10,N,N,-,-1,-1
RECMUS.txt,484373,485659,1286,10,N,N,-,-1,-1
RECMUS.txt,484547,485686,1139,10,Y,N,-,-1,-1
RECMUS.txt,484776,485730,954,10,N,N,-,-1,-1
RECMUS.txt,484927,485926,999,10,N,N,-,-1,-1
RECMUS.txt,485127,486133,1006,10,N,N,-,-1,-1
RECMUS.txt,485322,486165,843,10,N,N,-,-1,-1
RECMUS.txt,485364,486223,859,10,N,N,-,-1,-1
RECMUS.txt,485456,486310,854,10,N,N,-,-1,-1
RECMUS.txt,485559,486376,817,10,N,N,-,-1,-1
RECMUS.txt,485590,486436,846,10,N,N,-,-1,-1
RECMUS.txt,485660,486450,790,10,N,N,-,-1,-1
RECMUS.txt,485687,486568,881,10,N,N,-,-1,-1
RECMUS.txt,485731,486687,956,10,N,N,-,-1,-1
RECMUS.txt,485929,486822,893,10,N,N,-,-1,-1
RECMUS.txt,486134,486881,747,10,N,N,-,-1,-1
RECMUS.txt,486167,486994,827,10,N,N,-,-1,-1
RECMUS.txt,486225,487057,832,10,N,N,-,-1,-1
RECMUS.txt,486311,487083,772,10,N,N,-,-1,-1
RECMUS.txt,486377,487172,795,10,N,N,-,-1,-1
RECMUS.txt,486439,487303,864,10,N,N,-,-1,-1
RECMUS.txt,486451,487463,1012,10,N,N,-,-1,-1
RECMUS.txt,486569,487576,1007,10,N,N,-,-1,-1
RECMUS.txt,486688,487635,947,10,N,N,-,-1,-1
RECMUS.txt,486823,487759,936,10,N,N,-,-1,-1
RECMUS.txt,486882,487863,981,10,N,N,-,-1,-1
RECMUS.txt,486995,488042,1047,10,N,N,-,-1,-1
RECMUS.txt,487060,488062,1002,10,N,N,-,-1,-1
RECMUS.txt,487084,488109,1025,10,N,N,-,-1,-1
RECMUS.txt,487174,488197,1023,10,N,N,-,-1,-1
RECMUS.txt,487304,488276,972,10,N,N,-,-1,-1
RECMUS.txt,487464,488290,826,10,N,N,-,-1,-1
RECMUS.txt,487577,488361,784,10,N,N,-,-1,-1
RECMUS.txt,487636,488416,780,10,N,N,-,-1,-1
RECMUS.txt,487760,488555,795,10,N,N,-,-1,-1
RECMUS.txt,487864,488757,893,10,N,N,-,-1,-1
RECMUS.txt,488045,488799,754,10,N,N,-,-1,-1
RECMUS.txt,488063,488811,748,10,N,N,-,-1,-1
RECMUS.txt,488110,488917,807,10,N,N,-,-1,-1
RECMUS.txt,488198,488941,743,10,N,N,-,-1,-1
RECMUS.txt,488279,488976,697,10,N,N,-,-1,-1
RECMUS.txt,488291,489010,719,10,N,N,-,-1,-1
RECMUS.txt,488362,489092,730,10,N,N,-,-1,-1
RECMUS.txt,488417,489140,723,10,N,N,-,-1,-1
RECMUS.txt,488556,489208,652,10,N,N,-,-1,-1
RECMUS.txt,488758,489250,492,10,N,N,-,-1,-1
RECMUS.txt,488800,489340,540,10,N,N,-,-1,-1
RECMUS.txt,488812,489415,603,10,N,N,-,-1,-1
RECMUS.txt,488919,489570,651,10,N,N,-,-1,-1
RECMUS.txt,488942,489813,871,10,N,N,-,-1,-1
RECMUS.txt,488977,489979,1002,10,N,N,-,-1,-1
RECMUS.txt,489011,490022,1011,10,N,N,-,-1,-1
RECMUS.txt,489093,490143,1050,10,N,N,-,-1,-1
RECMUS.txt,489142,490151,1009,10,N,N,-,-1,-1
RECMUS.txt,489209,490290,1081,10,N,N,-,-1,-1
RECMUS.txt,489251,490379,1128,10,N,N,-,-1,-1
RECMUS.txt,489341,490462,1121,10,N,N,-,-1,-1
RECMUS.txt,489416,490532,1116,10,N,N,-,-1,-1
RECMUS.txt,489571,490572,1001,10,N,N,-,-1,-1
RECMUS.txt,489814,490644,830,10,N,N,-,-1,-1
RECMUS.txt,489980,490655,675,10,N,N,-,-1,-1
RECMUS.txt,490024,490717,693,10,N,N,-,-1,-1
RECMUS.txt,490144,490838,694,10,N,N,-,-1,-1
RECMUS.txt,490152,491047,895,10,N,N,-,-1,-1
RECMUS.txt,490291,491141,850,10,N,N,-,-1,-1
RECMUS.txt,490381,491149,768,10,N,N,-,-1,-1
RECMUS.txt,490463,491163,700,10,N,N,-,-1,-1
RECMUS.txt,490534,491220,686,10,N,N,-,-1,-1
RECMUS.txt,490573,491299,726,10,N,N,-,-1,-1
RECMUS.txt,490645,491363,718,10,N,N,-,-1,-1
RECMUS.txt,490656,491371,715,10,N,N,-,-1,-1
RECMUS.txt,490718,491472,754,10,N,N,-,-1,-1
RECMUS.txt,490839,491504,665,10,N,N,-,-1,-1
RECMUS.txt,491048,491548,500,10,N,N,-,-1,-1
RECMUS.txt,491142,491757,615,10,N,N,-,-1,-1
RECMUS.txt,491150,491833,683,10,N,N,-,-1,-1
RECMUS.txt,491166,492055,889,10,N,N,-,-1,-1
RECMUS.txt,491222,492113,891,10,N,N,-,-1,-1
RECMUS.txt,491300,492251,951,10,N,N,-,-1,-1
RECMUS.txt,491364,492405,1041,10,N,N,-,-1,-1
RECMUS.txt,491372,492509,1137,10,N,N,-,-1,-1
RECMUS.txt,491473,492677,1204,10,N,N,-,-1,-1
RECMUS.txt,491505,492817,1312,10,N,N,-,-1,-1
RECMUS.txt,491549,492862,1313,10,N,N,-,-1,-1
RECMUS.txt,491758,493047,1289,10,N,N,-,-1,-1
RECMUS.txt,491835,493407,1572,10,N,N,-,-1,-1
RECMUS.txt,492056,493635,1579,10,N,N,-,-1,-1
RECMUS.txt,492114,493752,1638,10,N,N,-,-1,-1
RECMUS.txt,492253,493834,1581,10,N,N,-,-1,-1
RECMUS.txt,492406,494024,1618,10,N,N,-,-1,-1
RECMUS.txt,492510,494100,1590,10,N,N,-,-1,-1
RECMUS.txt,492678,494312,1634,10,N,N,-,-1,-1
RECMUS.txt,492822,494507,1685,10,N,N,-,-1,-1
RECMUS.txt,492865,494617,1752,10,N,N,-,-1,-1
RECMUS.txt,493048,494727,1679,10,N,N,-,-1,-1
RECMUS.txt,493408,494875,1467,10,N,N,-,-1,-1
RECMUS.txt,493637,495033,1396,10,N,N,-,-1,-1
RECMUS.txt,493755,495172,1417,10,N,N,-,-1,-1
RECMUS.txt,493835,495312,1477,10,N,N,-,-1,-1
RECMUS.txt,494025,495486,1461,10,N,N,-,-1,-1
RECMUS.txt,494101,495684,1583,10,N,N,-,-1,-1
RECMUS.txt,494313,495867,1554,10,N,N,-,-1,-1
RECMUS.txt,494508,496280,1772,10,N,N,-,-1,-1
RECMUS.txt,494618,496581,1963,10,N,N,-,-1,-1
RECMUS.txt,494728,496716,1988,10,N,N,-,-1,-1
RECMUS.txt,494876,497037,2161,10,N,N,-,-1,-1
RECMUS.txt,495034,497072,2038,10,N,N,-,-1,-1
RECMUS.txt,495174,497377,2203,10,N,N,-,-1,-1
RECMUS.txt,495313,497529,2216,10,N,N,-,-1,-1
RECMUS.txt,495489,497632,2143,10,N,N,-,-1,-1
RECMUS.txt,495685,497698,2013,10,N,N,-,-1,-1
RECMUS.txt,495868,497733,1865,10,N,N,-,-1,-1
RECMUS.txt,496281,497779,1498,10,N,N,-,-1,-1
RECMUS.txt,496582,497849,1267,10,N,N,-,-1,-1
RECMUS.txt,496717,498051,1334,10,N,N,-,-1,-1
RECMUS.txt,497038,498115,1077,10,N,N,-,-1,-1
RECMUS.txt,497073,498289,1216,10,N,N,-,-1,-1
RECMUS.txt,497379,498471,1092,10,N,N,-,-1,-1
RECMUS.txt,497532,498554,1022,10,N,N,-,-1,-1
RECMUS.txt,497633,498743,1110,10,N,N,-,-1,-1
RECMUS.txt,497699,498819,1120,10,N,N,-,-1,-1
RECMUS.txt,497734,498937,1203,10,N,N,-,-1,-1
RECMUS.txt,497782,499034,1252,10,N,N,-,-1,-1
RECMUS.txt,497850,499052,1202,10,N,N,-,-1,-1
RECMUS.txt,498052,499152,1100,10,N,N,-,-1,-1
RECMUS.txt,498116,499319,1203,10,N,N,-,-1,-1
RECMUS.txt,498292,499385,1093,10,N,N,-,-1,-1
RECMUS.txt,498472,499429,957,10,N,N,-,-1,-1
RECMUS.txt,498555,499666,1111,10,N,N,-,-1,-1
RECMUS.txt,498745,499763,1018,10,N,N,-,-1,-1
RECMUS.txt,498820,499899,1079,10,N,N,-,-1,-1
RECMUS.txt,498938,500032,1094,10,N,N,-,-1,-1
RECMUS.txt,499036,500166,1130,10,N,N,-,-1,-1
RECMUS.txt,499053,500286,1233,10,N,N,-,-1,-1
RECMUS.txt,499153,500305,1152,10,N,N,-,-1,-1
RECMUS.txt,499321,500313,992,10,N,N,-,-1,-1
RECMUS.txt,499386,500705,1319,10,Y,N,-,-1,-1
RECMUS.txt,499430,500786,1356,10,Y,N,-,-1,-1
RECMUS.txt,499667,500938,1271,10,N,N,-,-1,-1
RECMUS.txt,499764,501164,1400,10,N,N,-,-1,-1
RECMUS.txt,499900,501274,1374,10,N,N,-,-1,-1
RECMUS.txt,500035,501493,1458,10,N,N,-,-1,-1
RECMUS.txt,500167,501586,1419,10,N,N,-,-1,-1
RECMUS.txt,500291,501665,1374,10,N,N,-,-1,-1
RECMUS.txt,500308,502124,1816,10,N,N,-,-1,-1
RECMUS.txt,500316,502171,1855,10,N,N,-,-1,-1
RECMUS.txt,500708,502321,1613,10,N,N,-,-1,-1
RECMUS.txt,500787,502668,1881,10,N,N,-,-1,-1
RECMUS.txt,500939,502825,1886,10,N,N,-,-1,-1
RECMUS.txt,501165,502861,1696,10,N,N,-,-1,-1
RECMUS.txt,501275,502950,1675,10,N,N,-,-1,-1
RECMUS.txt,501494,503107,1613,10,N,N,-,-1,-1
RECMUS.txt,501588,503301,1713,10,N,N,-,-1,-1
RECMUS.txt,501666,503408,1742,10,N,N,-,-1,-1
RECMUS.txt,502129,503784,1655,10,N,N,-,-1,-1
RECMUS.txt,502172,503874,1702,10,N,N,-,-1,-1
RECMUS.txt,502322,503990,1668,10,N,N,-,-1,-1
RECMUS.txt,502669,504018,1349,10,N,N,-,-1,-1
RECMUS.txt,502826,504213,1387,10,N,N,-,-1,-1
RECMUS.txt,502863,504533,1670,10,N,N,-,-1,-1
RECMUS.txt,502951,504580,1629,10,N,N,-,-1,-1
RECMUS.txt,503108,504797,1689,10,N,N,-,-1,-1
RECMUS.txt,503302,504851,1549,10,N,N,-,-1,-1
RECMUS.txt,503409,504921,1512,10,N,N,-,-1,-1
RECMUS.txt,503785,505069,1284,10,N,N,-,-1,-1
RECMUS.txt,503876,505145,1269,10,N,N,-,-1,-1
RECMUS.txt,503990,505370,1380,10,N,N,-,-1,-1
RECMUS.txt,504021,505590,1569,10,N,N,-,-1,-1
RECMUS.txt,504214,505658,1444,10,N,N,-,-1,-1
RECMUS.txt,504538,505697,1159,10,N,N,-,-1,-1
RECMUS.txt,504581,505715,1134,10,N,N,-,-1,-1
RECMUS.txt,504798,505950,1152,10,N,N,-,-1,-1
RECMUS.txt,504851,506120,1269,10,N,N,-,-1,-1
RECMUS.txt,504922,506127,1205,10,N,N,-,-1,-1
RECMUS.txt,505070,506366,1296,10,N,N,-,-1,-1
RECMUS.txt,505146,506694,1548,10,Y,Y,1448282044001,101941,102395
RECMUS.txt,505371,506774,1403,10,Y,Y,1448282044001,101941,102395
RECMUS.txt,505591,506852,1261,10,Y,Y,1448282044001,101941,102395
RECMUS.txt,505659,506864,1205,10,Y,Y,1448282044001,101941,102395
RECMUS.txt,505700,506974,1274,10,Y,Y,1448282044001,101941,102395
RECMUS.txt,505718,507137,1419,10,Y,Y,1448282044001,101941,102395
RECMUS.txt,505952,507291,1339,10,Y,Y,1448282044001,101941,102395
RECMUS.txt,506121,507361,1240,10,Y,Y,1448282044001,101941,102395
RECMUS.txt,506129,507460,1331,10,Y,Y,1448282044001,101941,102395
RECMUS.txt,506366,507672,1306,10,Y,Y,1448282044001,101941,102395
RECMUS.txt,506695,507804,1109,10,N,N,-,-1,-1
RECMUS.txt,506775,507834,1059,10,N,N,-,-1,-1
RECMUS.txt,506852,508054,1202,10,N,N,-,-1,-1
RECMUS.txt,506869,508230,1361,10,N,N,-,-1,-1
RECMUS.txt,506975,508498,1523,10,N,N,-,-1,-1
RECMUS.txt,507138,508631,1493,10,N,N,-,-1,-1
RECMUS.txt,507292,508911,1619,10,N,N,-,-1,-1
RECMUS.txt,507362,508969,1607,10,N,N,-,-1,-1
RECMUS.txt,507461,509071,1610,10,N,N,-,-1,-1
RECMUS.txt,507675,509153,1478,10,N,N,-,-1,-1
RECMUS.txt,507805,509289,1484,10,N,N,-,-1,-1
RECMUS.txt,507835,509306,1471,10,N,N,-,-1,-1
RECMUS.txt,508055,509601,1546,10,N,N,-,-1,-1
RECMUS.txt,508231,509791,1560,10,N,N,-,-1,-1
RECMUS.txt,508500,509857,1357,10,N,N,-,-1,-1
RECMUS.txt,508632,509936,1304,10,N,N,-,-1,-1
RECMUS.txt,508914,510263,1349,10,N,N,-,-1,-1
RECMUS.txt,508971,510542,1571,10,N,N,-,-1,-1
RECMUS.txt,509072,510643,1571,10,N,N,-,-1,-1
RECMUS.txt,509154,510752,1598,10,N,N,-,-1,-1
RECMUS.txt,509292,510909,1617,10,N,N,-,-1,-1
RECMUS.txt,509307,511132,1825,10,N,N,-,-1,-1
RECMUS.txt,509602,511326,1724,10,N,N,-,-1,-1
RECMUS.txt,509792,511407,1615,10,N,N,-,-1,-1
RECMUS.txt,509858,511824,1966,10,N,N,-,-1,-1
RECMUS.txt,509937,511940,2003,10,N,N,-,-1,-1
RECMUS.txt,510264,512262,1998,10,Y,N,-,-1,-1
RECMUS.txt,510544,512369,1825,10,Y,N,-,-1,-1
RECMUS.txt,510644,512515,1871,10,Y,N,-,-1,-1
RECMUS.txt,510753,512601,1848,10,Y,N,-,-1,-1
RECMUS.txt,510910,512754,1844,10,Y,N,-,-1,-1
RECMUS.txt,511133,513044,1911,10,Y,N,-,-1,-1
RECMUS.txt,511327,513140,1813,10,Y,N,-,-1,-1
RECMUS.txt,511409,513236,1827,10,Y,N,-,-1,-1
RECMUS.txt,511825,513317,1492,10,N,N,-,-1,-1
RECMUS.txt,511940,513676,1736,10,Y,N,-,-1,-1
RECMUS.txt,512263,513911,1648,10,N,N,-,-1,-1
RECMUS.txt,512370,514018,1648,10,N,N,-,-1,-1
RECMUS.txt,512518,514099,1581,10,N,N,-,-1,-1
RECMUS.txt,512602,514296,1694,10,N,N,-,-1,-1
RECMUS.txt,512757,514523,1766,10,N,N,-,-1,-1
RECMUS.txt,513045,514731,1686,10,N,N,-,-1,-1
RECMUS.txt,513141,514768,1627,10,N,N,-,-1,-1
RECMUS.txt,513237,514937,1700,10,N,N,-,-1,-1
RECMUS.txt,513318,515043,1725,10,Y,N,-,-1,-1
RECMUS.txt,513678,515161,1483,10,N,N,-,-1,-1
RECMUS.txt,513912,515263,1351,10,N,N,-,-1,-1
RECMUS.txt,514021,515311,1290,10,N,N,-,-1,-1
RECMUS.txt,514100,515441,1341,10,N,N,-,-1,-1
RECMUS.txt,514297,515517,1220,10,N,N,-,-1,-1
RECMUS.txt,514524,515744,1220,10,N,N,-,-1,-1
RECMUS.txt,514732,515876,1144,10,N,N,-,-1,-1
RECMUS.txt,514769,515942,1173,10,N,N,-,-1,-1
RECMUS.txt,514938,516231,1293,10,Y,N,-,-1,-1
RECMUS.txt,515044,516313,1269,10,Y,N,-,-1,-1
RECMUS.txt,515162,516386,1224,10,Y,N,-,-1,-1
RECMUS.txt,515264,516531,1267,10,N,N,-,-1,-1
RECMUS.txt,515312,516718,1406,10,N,N,-,-1,-1
RECMUS.txt,515442,516892,1450,10,N,N,-,-1,-1
RECMUS.txt,515518,517050,1532,10,N,N,-,-1,-1
RECMUS.txt,515746,517277,1531,10,N,Y,1448322273366,219239,219544
RECMUS.txt,515876,517529,1653,10,N,Y,1448322273366,219239,219544
RECMUS.txt,515943,517634,1691,10,N,Y,1448322273366,219239,219544
RECMUS.txt,516232,517695,1463,10,N,Y,1448322273366,219239,219544
RECMUS.txt,516314,517865,1551,10,N,Y,1448322273366,219239,219544
RECMUS.txt,516387,517958,1571,10,N,Y,1448322273366,219239,219544
RECMUS.txt,516532,518061,1529,10,N,Y,1448322273366,219239,219544
RECMUS.txt,516719,518132,1413,10,N,Y,1448322273366,219239,219544
RECMUS.txt,516893,518153,1260,10,N,Y,1448322273366,219239,219544
RECMUS.txt,517051,518304,1253,10,N,Y,1448322273366,219239,219544
RECMUS.txt,517279,518329,1050,10,N,Y,1448322273366,219239,219544
RECMUS.txt,517530,518494,964,10,N,N,-,-1,-1
RECMUS.txt,517635,518703,1068,10,N,N,-,-1,-1
RECMUS.txt,517696,518783,1087,10,N,N,-,-1,-1
RECMUS.txt,517866,518938,1072,10,N,N,-,-1,-1
RECMUS.txt,517961,519148,1187,10,N,N,-,-1,-1
RECMUS.txt,518062,519425,1363,10,N,N,-,-1,-1
RECMUS.txt,518134,519510,1376,10,N,N,-,-1,-1
RECMUS.txt,518154,519792,1638,10,N,N,-,-1,-1
RECMUS.txt,518305,519998,1693,10,N,N,-,-1,-1
RECMUS.txt,518330,520107,1777,10,N,N,-,-1,-1
RECMUS.txt,518495,520209,1714,10,N,N,-,-1,-1
RECMUS.txt,518704,520243,1539,10,N,N,-,-1,-1
RECMUS.txt,518784,520362,1578,10,N,N,-,-1,-1
RECMUS.txt,518939,520897,1958,10,N,Y,1448316079788,183824,184995
RECMUS.txt,519149,521007,1858,10,N,Y,1448316079788,183824,184995
RECMUS.txt,519426,521209,1783,10,N,Y,1448316079788,183824,184995
RECMUS.txt,519511,521336,1825,10,N,Y,1448316079788,183824,184995
RECMUS.txt,519793,521857,2064,10,N,Y,1448316079788,183824,184995
RECMUS.txt,519999,521913,1914,10,N,Y,1448316079788,183824,184995
RECMUS.txt,520108,521963,1855,10,N,Y,1448316079788,183824,184995
RECMUS.txt,520210,522167,1957,10,N,Y,1448316079788,183824,184995
RECMUS.txt,520244,522352,2108,10,N,Y,1448316079788,183824,184995
RECMUS.txt,520363,522506,2143,10,N,Y,1448316079788,183824,184995
RECMUS.txt,520898,522694,1796,10,N,N,-,-1,-1
RECMUS.txt,521008,522808,1800,10,N,N,-,-1,-1
RECMUS.txt,521214,523079,1865,10,N,N,-,-1,-1
RECMUS.txt,521337,523410,2073,10,N,N,-,-1,-1
RECMUS.txt,521858,523549,1691,10,N,N,-,-1,-1
RECMUS.txt,521914,523588,1674,10,N,N,-,-1,-1
RECMUS.txt,521964,523805,1841,10,N,N,-,-1,-1
RECMUS.txt,522168,524004,1836,10,N,N,-,-1,-1
RECMUS.txt,522355,524106,1751,10,N,N,-,-1,-1
RECMUS.txt,522507,524373,1866,10,N,N,-,-1,-1
RECMUS.txt,522695,524518,1823,10,N,N,-,-1,-1
RECMUS.txt,522811,524645,1834,10,N,N,-,-1,-1
RECMUS.txt,523080,524676,1596,10,N,N,-,-1,-1
RECMUS.txt,523411,524871,1460,10,N,N,-,-1,-1
RECMUS.txt,523554,525053,1499,10,N,N,-,-1,-1
RECMUS.txt,523589,525266,1677,10,N,N,-,-1,-1
RECMUS.txt,523806,525472,1666,10,N,N,-,-1,-1
RECMUS.txt,524007,525643,1636,10,N,N,-,-1,-1
RECMUS.txt,524107,525821,1714,10,N,N,-,-1,-1
RECMUS.txt,524374,525843,1469,10,N,N,-,-1,-1
RECMUS.txt,524519,525937,1418,10,N,N,-,-1,-1
RECMUS.txt,524646,526054,1408,10,N,N,-,-1,-1
RECMUS.txt,524677,526346,1669,10,N,N,-,-1,-1
RECMUS.txt,524872,526609,1737,10,N,N,-,-1,-1
RECMUS.txt,525054,526742,1688,10,N,N,-,-1,-1
RECMUS.txt,525267,526756,1489,10,N,N,-,-1,-1
RECMUS.txt,525473,526903,1430,10,N,N,-,-1,-1
RECMUS.txt,525644,527071,1427,10,N,N,-,-1,-1
RECMUS.txt,525822,527267,1445,10,N,N,-,-1,-1
RECMUS.txt,525844,527393,1549,10,N,N,-,-1,-1
RECMUS.txt,525938,527456,1518,10,N,N,-,-1,-1
RECMUS.txt,526055,527727,1672,10,N,N,-,-1,-1
RECMUS.txt,526349,527962,1613,10,N,N,-,-1,-1
RECMUS.txt,526610,528083,1473,10,N,N,-,-1,-1
RECMUS.txt,526743,528238,1495,10,N,N,-,-1,-1
RECMUS.txt,526757,528345,1588,10,N,N,-,-1,-1
RECMUS.txt,526904,528442,1538,10,N,N,-,-1,-1
RECMUS.txt,527072,528610,1538,10,N,N,-,-1,-1
RECMUS.txt,527268,528732,1464,10,N,N,-,-1,-1
RECMUS.txt,527394,528891,1497,10,N,N,-,-1,-1
RECMUS.txt,527459,529115,1656,10,N,N,-,-1,-1
RECMUS.txt,527728,529371,1643,10,N,N,-,-1,-1
RECMUS.txt,527963,529595,1632,10,N,N,-,-1,-1
RECMUS.txt,528086,529917,1831,10,N,N,-,-1,-1
RECMUS.txt,528239,530340,2101,10,N,N,-,-1,-1
RECMUS.txt,528346,530608,2262,10,N,N,-,-1,-1
RECMUS.txt,528443,530681,2238,10,N,N,-,-1,-1
RECMUS.txt,528611,530763,2152,10,N,N,-,-1,-1
RECMUS.txt,528733,530878,2145,10,N,N,-,-1,-1
RECMUS.txt,528892,530955,2063,10,N,N,-,-1,-1
RECMUS.txt,529116,531195,2079,10,N,N,-,-1,-1
RECMUS.txt,529374,531212,1838,10,N,N,-,-1,-1
RECMUS.txt,529596,531219,1623,10,N,N,-,-1,-1
RECMUS.txt,529920,531664,1744,10,N,N,-,-1,-1
RECMUS.txt,530341,531811,1470,10,N,N,-,-1,-1
RECMUS.txt,530609,531911,1302,10,N,N,-,-1,-1
RECMUS.txt,530682,531974,1292,10,N,N,-,-1,-1
RECMUS.txt,530764,532165,1401,10,N,N,-,-1,-1
RECMUS.txt,530879,532296,1417,10,N,N,-,-1,-1
RECMUS.txt,530956,532503,1547,10,N,N,-,-1,-1
RECMUS.txt,531200,532692,1492,10,N,N,-,-1,-1
RECMUS.txt,531214,532758,1544,10,N,N,-,-1,-1
RECMUS.txt,531222,533057,1835,10,N,N,-,-1,-1
RECMUS.txt,531667,533137,1470,10,N,N,-,-1,-1
RECMUS.txt,531812,533235,1423,10,N,N,-,-1,-1
RECMUS.txt,531912,533516,1604,10,N,N,-,-1,-1
RECMUS.txt,531975,533925,1950,10,N,N,-,-1,-1
RECMUS.txt,532166,534379,2213,10,Y,N,-,-1,-1
RECMUS.txt,532297,534726,2429,10,Y,N,-,-1,-1
RECMUS.txt,532504,534887,2383,10,Y,N,-,-1,-1
RECMUS.txt,532693,535101,2408,10,Y,Y,1448286880729,112151,113274
RECMUS.txt,532759,535377,2618,10,Y,Y,1448286880729,112151,113274
RECMUS.txt,533058,535588,2530,10,Y,Y,1448286880729,112151,113274
RECMUS.txt,533138,535626,2488,10,Y,Y,1448286880729,112151,113274
RECMUS.txt,533236,535674,2438,10,Y,Y,1448286880729,112151,113274
RECMUS.txt,533519,535866,2347,10,Y,Y,1448286880729,112151,113274
RECMUS.txt,533927,536285,2358,10,Y,Y,1448286880729,112151,113274
RECMUS.txt,534380,536434,2054,10,N,Y,1448286880729,112151,113274
RECMUS.txt,534727,536568,1841,10,N,Y,1448286880729,112151,113274
RECMUS.txt,534889,536952,2063,10,N,Y,1448286880729,112151,113274
RECMUS.txt,535104,537109,2005,10,N,N,-,-1,-1
RECMUS.txt,535378,537446,2068,10,Y,N,-,-1,-1
RECMUS.txt,535589,537585,1996,10,Y,N,-,-1,-1
RECMUS.txt,535627,537662,2035,10,Y,N,-,-1,-1
RECMUS.txt,535677,537804,2127,10,Y,N,-,-1,-1
RECMUS.txt,535867,537871,2004,10,Y,N,-,-1,-1
RECMUS.txt,536286,538134,1848,10,Y,N,-,-1,-1
RECMUS.txt,536435,538210,1775,10,Y,N,-,-1,-1
RECMUS.txt,536569,538369,1800,10,Y,N,-,-1,-1
RECMUS.txt,536953,538626,1673,10,N,N,-,-1,-1
RECMUS.txt,537110,538696,1586,10,N,N,-,-1,-1
RECMUS.txt,537447,538928,1481,10,N,N,-,-1,-1
RECMUS.txt,537588,539162,1574,10,N,N,-,-1,-1
RECMUS.txt,537663,539220,1557,10,N,N,-,-1,-1
RECMUS.txt,537805,539276,1471,10,N,N,-,-1,-1
RECMUS.txt,537872,539279,1407,10,N,N,-,-1,-1
RECMUS.txt,538135,539454,1319,10,N,N,-,-1,-1
RECMUS.txt,538213,539851,1638,10,Y,N,-,-1,-1
RECMUS.txt,538370,539873,1503,10,N,N,-,-1,-1
RECMUS.txt,538628,540103,1475,10,N,N,-,-1,-1
RECMUS.txt,538699,540215,1516,10,N,N,-,-1,-1
RECMUS.txt,538929,540394,1465,10,N,N,-,-1,-1
RECMUS.txt,539163,540703,1540,10,N,N,-,-1,-1
RECMUS.txt,539221,540803,1582,10,N,N,-,-1,-1
RECMUS.txt,539277,540837,1560,10,N,N,-,-1,-1
RECMUS.txt,539279,541065,1786,10,Y,N,-,-1,-1
RECMUS.txt,539455,541251,1796,10,N,N,-,-1,-1
RECMUS.txt,539852,541273,1421,10,N,N,-,-1,-1
RECMUS.txt,539875,541456,1581,10,N,Y,1448278279697,58861,59444
RECMUS.txt,540104,541519,1415,10,N,Y,1448278279697,58861,59444
RECMUS.txt,540216,541693,1477,10,N,Y,1448278279697,58861,59444
RECMUS.txt,540395,541885,1490,10,N,Y,1448278279697,58861,59444
RECMUS.txt,540704,541932,1228,10,N,Y,1448278279697,58861,59444
RECMUS.txt,540804,542208,1404,10,N,Y,1448278279697,58861,59444
RECMUS.txt,540838,542565,1727,10,N,Y,1448278279697,58861,59444
RECMUS.txt,541066,542805,1739,10,N,Y,1448278279697,58861,59444
RECMUS.txt,541253,542833,1580,10,N,Y,1448278279697,58861,59444
RECMUS.txt,541274,543209,1935,10,N,Y,1448278279697,58861,59444
RECMUS.txt,541457,543257,1800,10,N,Y,1448278279697,58861,59444
RECMUS.txt,541520,543421,1901,10,N,Y,1448278279697,58861,59444
RECMUS.txt,541694,543494,1800,10,N,N,-,-1,-1
RECMUS.txt,541886,543739,1853,10,N,N,-,-1,-1
RECMUS.txt,541933,543859,1926,10,N,N,-,-1,-1
RECMUS.txt,542209,543921,1712,10,N,N,-,-1,-1
RECMUS.txt,542567,544020,1453,10,N,N,-,-1,-1
RECMUS.txt,542810,544195,1385,10,N,N,-,-1,-1
RECMUS.txt,542834,544437,1603,10,N,N,-,-1,-1
RECMUS.txt,543210,544533,1323,10,N,N,-,-1,-1
RECMUS.txt,543259,544673,1414,10,N,N,-,-1,-1
RECMUS.txt,543422,544674,1252,10,N,N,-,-1,-1
RECMUS.txt,543495,544746,1251,10,N,N,-,-1,-1
RECMUS.txt,543742,544846,1104,10,N,N,-,-1,-1
RECMUS.txt,543860,544870,1010,10,N,N,-,-1,-1
RECMUS.txt,543922,544899,977,10,N,N,-,-1,-1
RECMUS.txt,544021,544901,880,10,N,N,-,-1,-1
RECMUS.txt,544198,545023,825,10,N,N,-,-1,-1
RECMUS.txt,544438,545077,639,10,N,N,-,-1,-1
RECMUS.txt,544534,545171,637,10,N,N,-,-1,-1
RECMUS.txt,544673,545218,545,10,N,N,-,-1,-1
RECMUS.txt,544675,545317,642,10,N,N,-,-1,-1
RECMUS.txt,544747,545500,753,10,N,N,-,-1,-1
RECMUS.txt,544846,545865,1019,10,N,N,-,-1,-1
RECMUS.txt,544871,545888,1017,10,N,N,-,-1,-1
RECMUS.txt,544899,545903,1004,10,N,N,-,-1,-1
RECMUS.txt,544902,545972,1070,10,N,N,-,-1,-1
RECMUS.txt,545024,546018,994,10,Y,N,-,-1,-1
RECMUS.txt,545078,546287,1209,10,Y,N,-,-1,-1
RECMUS.txt,545174,546550,1376,10,Y,N,-,-1,-1
RECMUS.txt,545219,546840,1621,10,Y,N,-,-1,-1
RECMUS.txt,545318,546919,1601,10,Y,N,-,-1,-1
RECMUS.txt,545501,547023,1522,10,Y,N,-,-1,-1
RECMUS.txt,545867,547231,1364,10,N,N,-,-1,-1
RECMUS.txt,545889,547298,1409,10,N,N,-,-1,-1
RECMUS.txt,545904,547391,1487,10,Y,N,-,-1,-1
RECMUS.txt,545973,547551,1578,10,Y,N,-,-1,-1
RECMUS.txt,546021,547587,1566,10,N,N,-,-1,-1
RECMUS.txt,546290,547756,1466,10,N,N,-,-1,-1
RECMUS.txt,546551,547879,1328,10,N,N,-,-1,-1
RECMUS.txt,546841,547931,1090,10,N,N,-,-1,-1
RECMUS.txt,546920,548056,1136,10,N,N,-,-1,-1
RECMUS.txt,547024,548215,1191,10,N,N,-,-1,-1
RECMUS.txt,547233,548305,1072,10,N,N,-,-1,-1
RECMUS.txt,547299,548425,1126,10,N,N,-,-1,-1
RECMUS.txt,547392,548582,1190,10,N,N,-,-1,-1
RECMUS.txt,547552,548802,1250,10,N,N,-,-1,-1
RECMUS.txt,547588,549203,1615,10,N,N,-,-1,-1
RECMUS.txt,547757,549314,1557,10,N,N,-,-1,-1
RECMUS.txt,547880,549542,1662,10,N,N,-,-1,-1
RECMUS.txt,547932,549861,1929,10,N,N,-,-1,-1
RECMUS.txt,548057,550163,2106,10,N,N,-,-1,-1
RECMUS.txt,548216,550179,1963,10,N,N,-,-1,-1
RECMUS.txt,548306,550186,1880,10,N,N,-,-1,-1
RECMUS.txt,548426,550488,2062,10,N,N,-,-1,-1
RECMUS.txt,548583,550645,2062,10,N,N,-,-1,-1
RECMUS.txt,548805,550774,1969,10,N,N,-,-1,-1
RECMUS.txt,549204,550826,1622,10,N,N,-,-1,-1
RECMUS.txt,549315,551049,1734,10,N,N,-,-1,-1
RECMUS.txt,549545,551312,1767,10,N,N,-,-1,-1
RECMUS.txt,549862,551766,1904,10,N,N,-,-1,-1
RECMUS.txt,550168,552097,1929,10,N,N,-,-1,-1
RECMUS.txt,550181,552149,1968,10,N,N,-,-1,-1
RECMUS.txt,550189,552181,1992,10,N,N,-,-1,-1
RECMUS.txt,550491,552296,1805,10,N,N,-,-1,-1
RECMUS.txt,550646,552481,1835,10,N,N,-,-1,-1
RECMUS.txt,550775,552572,1797,10,N,N,-,-1,-1
RECMUS.txt,550827,552690,1863,10,N,N,-,-1,-1
RECMUS.txt,551050,552739,1689,10,N,N,-,-1,-1
RECMUS.txt,551313,552931,1618,10,N,N,-,-1,-1
RECMUS.txt,551767,553440,1673,10,Y,N,-,-1,-1
RECMUS.txt,552098,553590,1492,10,Y,N,-,-1,-1
RECMUS.txt,552154,553659,1505,10,Y,N,-,-1,-1
RECMUS.txt,552182,553773,1591,10,Y,N,-,-1,-1
RECMUS.txt,552297,554189,1892,10,Y,N,-,-1,-1
RECMUS.txt,552482,554383,1901,10,Y,N,-,-1,-1
RECMUS.txt,552574,554579,2005,10,Y,N,-,-1,-1
RECMUS.txt,552692,554827,2135,10,Y,N,-,-1,-1
RECMUS.txt,552740,555004,2264,10,Y,N,-,-1,-1
RECMUS.txt,552932,555106,2174,10,Y,N,-,-1,-1
RECMUS.txt,553443,555154,1711,10,N,N,-,-1,-1
RECMUS.txt,553591,555378,1787,10,N,N,-,-1,-1
RECMUS.txt,553660,555562,1902,10,N,N,-,-1,-1
RECMUS.txt,553774,555713,1939,10,Y,N,-,-1,-1
RECMUS.txt,554190,555876,1686,10,N,N,-,-1,-1
RECMUS.txt,554384,555968,1584,10,N,N,-,-1,-1
RECMUS.txt,554580,555997,1417,10,N,N,-,-1,-1
RECMUS.txt,554829,556083,1254,10,N,N,-,-1,-1
RECMUS.txt,555006,556154,1148,10,N,N,-,-1,-1
RECMUS.txt,555107,556897,1790,10,N,N,-,-1,-1
RECMUS.txt,555157,557049,1892,10,N,N,-,-1,-1
RECMUS.txt,555379,557273,1894,10,N,N,-,-1,-1
RECMUS.txt,555563,557503,1940,10,N,N,-,-1,-1
RECMUS.txt,555714,557566,1852,10,N,N,-,-1,-1
RECMUS.txt,555878,557829,1951,10,N,N,-,-1,-1
RECMUS.txt,555969,558178,2209,10,Y,N,-,-1,-1
RECMUS.txt,555998,558536,2538,10,Y,N,-,-1,-1
RECMUS.txt,556084,558777,2693,10,Y,N,-,-1,-1
RECMUS.txt,556155,558879,2724,10,Y,N,-,-1,-1
RECMUS.txt,556898,559031,2133,10,N,N,-,-1,-1
RECMUS.txt,557052,559094,2042,10,N,N,-,-1,-1
RECMUS.txt,557274,559181,1907,10,N,N,-,-1,-1
RECMUS.txt,557504,559268,1764,10,Y,N,-,-1,-1
RECMUS.txt,557567,559442,1875,10,Y,N,-,-1,-1
RECMUS.txt,557830,559484,1654,10,Y,N,-,-1,-1
RECMUS.txt,558179,559601,1422,10,Y,N,-,-1,-1
RECMUS.txt,558537,559680,1143,10,N,N,-,-1,-1
RECMUS.txt,558778,559882,1104,10,N,N,-,-1,-1
RECMUS.txt,558880,560141,1261,10,N,N,-,-1,-1
RECMUS.txt,559033,560397,1364,10,Y,N,-,-1,-1
RECMUS.txt,559096,560701,1605,10,Y,N,-,-1,-1
RECMUS.txt,559184,560871,1687,10,Y,N,-,-1,-1
RECMUS.txt,559269,561078,1809,10,N,N,-,-1,-1
RECMUS.txt,559443,561211,1768,10,N,N,-,-1,-1
RECMUS.txt,559484,561451,1967,10,N,N,-,-1,-1
RECMUS.txt,559602,561655,2053,10,N,N,-,-1,-1
RECMUS.txt,559682,561940,2258,10,N,N,-,-1,-1
RECMUS.txt,559883,562002,2119,10,N,N,-,-1,-1
RECMUS.txt,560142,562333,2191,10,N,N,-,-1,-1
RECMUS.txt,560398,562452,2054,10,N,N,-,-1,-1
RECMUS.txt,560702,562616,1914,10,N,N,-,-1,-1
RECMUS.txt,560872,562705,1833,10,N,N,-,-1,-1
RECMUS.txt,561079,563095,2016,10,N,N,-,-1,-1
RECMUS.txt,561212,563413,2201,10,N,N,-,-1,-1
RECMUS.txt,561452,563589,2137,10,N,N,-,-1,-1
RECMUS.txt,561656,563845,2189,10,N,N,-,-1,-1
RECMUS.txt,561943,564065,2122,10,N,N,-,-1,-1
RECMUS.txt,562004,564162,2158,10,N,N,-,-1,-1
RECMUS.txt,562336,564384,2048,10,N,N,-,-1,-1
RECMUS.txt,562454,564434,1980,10,N,N,-,-1,-1
RECMUS.txt,562617,564474,1857,10,N,N,-,-1,-1
RECMUS.txt,562706,564622,1916,10,N,N,-,-1,-1
RECMUS.txt,563096,564801,1705,10,N,N,-,-1,-1
RECMUS.txt,563414,565109,1695,10,N,N,-,-1,-1
RECMUS.txt,563591,565294,1703,10,N,N,-,-1,-1
RECMUS.txt,563846,565497,1651,10,N,N,-,-1,-1
RECMUS.txt,564067,565704,1637,10,N,N,-,-1,-1
RECMUS.txt,564163,565864,1701,10,Y,N,-,-1,-1
RECMUS.txt,564385,566115,1730,10,Y,N,-,-1,-1
RECMUS.txt,564435,566237,1802,10,N,N,-,-1,-1
RECMUS.txt,564475,566652,2177,10,N,N,-,-1,-1
RECMUS.txt,564623,566759,2136,10,N,N,-,-1,-1
RECMUS.txt,564802,566989,2187,10,N,N,-,-1,-1
RECMUS.txt,565112,567117,2005,10,N,N,-,-1,-1
RECMUS.txt,565295,567268,1973,10,N,N,-,-1,-1
RECMUS.txt,565498,567364,1866,10,N,N,-,-1,-1
RECMUS.txt,565706,567595,1889,10,N,N,-,-1,-1
RECMUS.txt,565865,567612,1747,10,N,N,-,-1,-1
RECMUS.txt,566116,567619,1503,10,N,N,-,-1,-1
RECMUS.txt,566238,568037,1799,10,N,N,-,-1,-1
RECMUS.txt,566655,568164,1509,10,N,N,-,-1,-1
RECMUS.txt,566760,568289,1529,10,N,N,-,-1,-1
RECMUS.txt,566990,568373,1383,10,N,N,-,-1,-1
RECMUS.txt,567119,568687,1568,10,Y,N,-,-1,-1
RECMUS.txt,567269,568850,1581,10,Y,N,-,-1,-1
RECMUS.txt,567365,569011,1646,10,Y,N,-,-1,-1
RECMUS.txt,567600,569449,1849,10,Y,N,-,-1,-1
RECMUS.txt,567614,569486,1872,10,Y,N,-,-1,-1
RECMUS.txt,567622,569809,2187,10,Y,N,-,-1,-1
RECMUS.txt,568040,569933,1893,10,Y,N,-,-1,-1
RECMUS.txt,568165,570005,1840,10,Y,N,-,-1,-1
RECMUS.txt,568292,570039,1747,10,Y,N,-,-1,-1
RECMUS.txt,568374,570188,1814,10,Y,N,-,-1,-1
RECMUS.txt,568688,570327,1639,10,Y,N,-,-1,-1
RECMUS.txt,568851,570529,1678,10,Y,N,-,-1,-1
RECMUS.txt,569012,570586,1574,10,Y,N,-,-1,-1
RECMUS.txt,569454,570717,1263,10,N,N,-,-1,-1
RECMUS.txt,569489,570891,1402,10,N,N,-,-1,-1
RECMUS.txt,569810,571079,1269,10,N,N,-,-1,-1
RECMUS.txt,569934,571191,1257,10,N,N,-,-1,-1
RECMUS.txt,570006,571310,1304,10,N,N,-,-1,-1
RECMUS.txt,570040,571458,1418,10,N,N,-,-1,-1
RECMUS.txt,570189,571628,1439,10,N,N,-,-1,-1
RECMUS.txt,570328,571827,1499,10,N,N,-,-1,-1
RECMUS.txt,570530,571876,1346,10,N,N,-,-1,-1
RECMUS.txt,570587,572117,1530,10,N,N,-,-1,-1
RECMUS.txt,570718,572385,1667,10,N,N,-,-1,-1
RECMUS.txt,570892,572580,1688,10,N,N,-,-1,-1
RECMUS.txt,571080,572675,1595,10,N,N,-,-1,-1
RECMUS.txt,571192,572789,1597,10,N,N,-,-1,-1
RECMUS.txt,571313,573170,1857,10,N,N,-,-1,-1
RECMUS.txt,571461,573291,1830,10,N,N,-,-1,-1
RECMUS.txt,571629,573561,1932,10,N,N,-,-1,-1
RECMUS.txt,571832,573900,2068,10,N,N,-,-1,-1
RECMUS.txt,571877,574150,2273,10,N,N,-,-1,-1
RECMUS.txt,572118,574229,2111,10,N,N,-,-1,-1
RECMUS.txt,572386,574269,1883,10,N,N,-,-1,-1
RECMUS.txt,572583,574462,1879,10,N,N,-,-1,-1
RECMUS.txt,572676,574533,1857,10,N,N,-,-1,-1
RECMUS.txt,572790,574709,1919,10,N,N,-,-1,-1
RECMUS.txt,573171,574726,1555,10,N,N,-,-1,-1
RECMUS.txt,573292,575056,1764,10,N,N,-,-1,-1
RECMUS.txt,573562,575324,1762,10,N,N,-,-1,-1
RECMUS.txt,573901,575559,1658,10,N,N,-,-1,-1
RECMUS.txt,574151,575753,1602,10,N,N,-,-1,-1
RECMUS.txt,574230,575870,1640,10,N,N,-,-1,-1
RECMUS.txt,574272,576031,1759,10,N,N,-,-1,-1
RECMUS.txt,574463,576429,1966,10,N,N,-,-1,-1
RECMUS.txt,574534,576687,2153,10,N,N,-,-1,-1
RECMUS.txt,574710,576805,2095,10,N,N,-,-1,-1
RECMUS.txt,574729,576876,2147,10,N,N,-,-1,-1
RECMUS.txt,575059,576961,1902,10,N,N,-,-1,-1
RECMUS.txt,575325,577076,1751,10,N,N,-,-1,-1
RECMUS.txt,575560,577168,1608,10,N,N,-,-1,-1
RECMUS.txt,575754,577430,1676,10,N,N,-,-1,-1
RECMUS.txt,575871,577507,1636,10,N,N,-,-1,-1
RECMUS.txt,576032,577756,1724,10,N,N,-,-1,-1
RECMUS.txt,576431,577919,1488,10,N,N,-,-1,-1
RECMUS.txt,576688,578054,1366,10,N,N,-,-1,-1
RECMUS.txt,576807,578327,1520,10,N,N,-,-1,-1
RECMUS.txt,576877,578480,1603,10,N,N,-,-1,-1
RECMUS.txt,576962,578683,1721,10,N,N,-,-1,-1
RECMUS.txt,577077,578833,1756,10,N,N,-,-1,-1
RECMUS.txt,577169,578921,1752,10,N,N,-,-1,-1
RECMUS.txt,577431,579155,1724,10,N,N,-,-1,-1
RECMUS.txt,577508,579238,1730,10,N,N,-,-1,-1
RECMUS.txt,577758,579310,1552,10,N,N,-,-1,-1
RECMUS.txt,577920,579469,1549,10,Y,N,-,-1,-1
RECMUS.txt,578055,579637,1582,10,N,N,-,-1,-1
RECMUS.txt,578328,579769,1441,10,N,N,-,-1,-1
RECMUS.txt,578481,579981,1500,10,N,N,-,-1,-1
RECMUS.txt,578684,580121,1437,10,N,N,-,-1,-1
RECMUS.txt,578834,580176,1342,10,N,N,-,-1,-1
RECMUS.txt,578922,580405,1483,10,N,N,-,-1,-1
RECMUS.txt,579158,580668,1510,10,N,N,-,-1,-1
RECMUS.txt,579239,580672,1433,10,N,N,-,-1,-1
RECMUS.txt,579311,580719,1408,10,N,N,-,-1,-1
RECMUS.txt,579470,580831,1361,10,N,N,-,-1,-1
RECMUS.txt,579638,581047,1409,10,N,N,-,-1,-1
RECMUS.txt,579770,581114,1344,10,N,N,-,-1,-1
RECMUS.txt,579983,581217,1234,10,N,N,-,-1,-1
RECMUS.txt,580122,581386,1264,10,N,N,-,-1,-1
RECMUS.txt,580177,581451,1274,10,N,N,-,-1,-1
RECMUS.txt,580406,581529,1123,10,N,N,-,-1,-1
RECMUS.txt,580669,581574,905,10,N,N,-,-1,-1
RECMUS.txt,580672,581709,1037,10,N,N,-,-1,-1
RECMUS.txt,580720,581874,1154,10,N,N,-,-1,-1
RECMUS.txt,580832,582000,1168,10,N,N,-,-1,-1
RECMUS.txt,581048,582164,1116,10,N,N,-,-1,-1
RECMUS.txt,581116,582290,1174,10,N,N,-,-1,-1
RECMUS.txt,581218,582472,1254,10,N,Y,1448313800274,179025,179317
RECMUS.txt,581387,582524,1137,10,N,Y,1448313800274,179025,179317
RECMUS.txt,581452,582608,1156,10,N,Y,1448313800274,179025,179317
RECMUS.txt,581534,582687,1153,10,N,Y,1448313800274,179025,179317
RECMUS.txt,581575,582920,1345,10,N,Y,1448313800274,179025,179317
RECMUS.txt,581712,582995,1283,10,N,Y,1448313800274,179025,179317
RECMUS.txt,581875,583074,1199,10,N,Y,1448313800274,179025,179317
RECMUS.txt,582001,583140,1139,10,N,Y,1448313800274,179025,179317
RECMUS.txt,582165,583216,1051,10,N,Y,1448313800274,179025,179317
RECMUS.txt,582291,583282,991,10,N,Y,1448313800274,179025,179317
RECMUS.txt,582473,583441,968,10,N,Y,1448313800274,179025,179317
RECMUS.txt,582525,583641,1116,10,N,Y,1448313800274,179025,179317
RECMUS.txt,582609,583670,1061,10,N,Y,1448313800274,179025,179317
RECMUS.txt,582688,583822,1134,10,N,N,-,-1,-1
RECMUS.txt,582921,583897,976,10,N,N,-,-1,-1
RECMUS.txt,582996,583995,999,10,N,N,-,-1,-1
RECMUS.txt,583075,584012,937,10,N,N,-,-1,-1
RECMUS.txt,583141,584154,1013,10,N,N,-,-1,-1
RECMUS.txt,583217,584228,1011,10,N,N,-,-1,-1
RECMUS.txt,583283,584377,1094,10,N,N,-,-1,-1
RECMUS.txt,583442,584508,1066,10,N,N,-,-1,-1
RECMUS.txt,583642,584666,1024,10,N,N,-,-1,-1
RECMUS.txt,583672,584741,1069,10,N,N,-,-1,-1
RECMUS.txt,583823,584875,1052,10,N,N,-,-1,-1
RECMUS.txt,583898,585108,1210,10,N,N,-,-1,-1
RECMUS.txt,583998,585109,1111,10,N,N,-,-1,-1
RECMUS.txt,584013,585198,1185,10,N,N,-,-1,-1
RECMUS.txt,584155,585268,1113,10,N,N,-,-1,-1
RECMUS.txt,584229,585401,1172,10,N,N,-,-1,-1
RECMUS.txt,584378,585550,1172,10,N,N,-,-1,-1
RECMUS.txt,584509,585662,1153,10,N,N,-,-1,-1
RECMUS.txt,584667,585893,1226,10,N,N,-,-1,-1
RECMUS.txt,584742,586016,1274,10,N,Y,1448322713112,221941,223038
RECMUS.txt,584876,586101,1225,10,N,Y,1448322713112,221941,223038
RECMUS.txt,585108,586205,1097,10,N,Y,1448322713112,221941,223038
RECMUS.txt,585110,586334,1224,10,N,Y,1448322713112,221941,223038
RECMUS.txt,585199,586346,1147,10,N,Y,1448322713112,221941,223038
RECMUS.txt,585269,586460,1191,10,N,Y,1448322713112,221941,223038
RECMUS.txt,585402,586509,1107,10,N,Y,1448322713112,221941,223038
RECMUS.txt,585551,586664,1113,10,N,Y,1448322713112,221941,223038
RECMUS.txt,585663,586842,1179,10,N,Y,1448322713112,221941,223038
RECMUS.txt,585894,586928,1034,10,N,Y,1448322713112,221941,223038
RECMUS.txt,586017,587038,1021,10,N,N,-,-1,-1
RECMUS.txt,586102,587181,1079,10,N,N,-,-1,-1
RECMUS.txt,586206,587325,1119,10,N,N,-,-1,-1
RECMUS.txt,586335,587514,1179,10,N,N,-,-1,-1
RECMUS.txt,586347,587711,1364,10,N,N,-,-1,-1
RECMUS.txt,586461,587886,1425,10,N,N,-,-1,-1
RECMUS.txt,586510,588058,1548,10,N,N,-,-1,-1
RECMUS.txt,586665,588279,1614,10,N,N,-,-1,-1
RECMUS.txt,586843,588563,1720,10,N,N,-,-1,-1
RECMUS.txt,586929,588850,1921,10,N,N,-,-1,-1
RECMUS.txt,587039,588951,1912,10,N,N,-,-1,-1
RECMUS.txt,587182,589133,1951,10,N,N,-,-1,-1
RECMUS.txt,587326,589217,1891,10,N,N,-,-1,-1
RECMUS.txt,587515,589362,1847,10,N,N,-,-1,-1
RECMUS.txt,587712,589430,1718,10,N,N,-,-1,-1
RECMUS.txt,587887,589619,1732,10,N,N,-,-1,-1
RECMUS.txt,588061,589670,1609,10,N,N,-,-1,-1
RECMUS.txt,588282,589793,1511,10,N,N,-,-1,-1
RECMUS.txt,588564,590016,1452,10,N,N,-,-1,-1
RECMUS.txt,588850,590193,1343,10,Y,N,-,-1,-1
RECMUS.txt,588952,590347,1395,10,N,N,-,-1,-1
RECMUS.txt,589134,590365,1231,10,N,N,-,-1,-1
RECMUS.txt,589220,590373,1153,10,N,N,-,-1,-1
RECMUS.txt,589363,590796,1433,10,N,N,-,-1,-1
RECMUS.txt,589431,590937,1506,10,N,N,-,-1,-1
RECMUS.txt,589620,591125,1505,10,N,N,-,-1,-1
RECMUS.txt,589671,591289,1618,10,N,N,-,-1,-1
RECMUS.txt,589794,591373,1579,10,N,N,-,-1,-1
RECMUS.txt,590017,591605,1588,10,N,N,-,-1,-1
RECMUS.txt,590194,591735,1541,10,N,N,-,-1,-1
RECMUS.txt,590352,591862,1510,10,N,N,-,-1,-1
RECMUS.txt,590368,591983,1615,10,N,N,-,-1,-1
RECMUS.txt,590376,592049,1673,10,N,N,-,-1,-1
RECMUS.txt,590801,592091,1290,10,N,N,-,-1,-1
RECMUS.txt,590942,592155,1213,10,N,N,-,-1,-1
RECMUS.txt,591126,592191,1065,10,N,N,-,-1,-1
RECMUS.txt,591290,592485,1195,10,N,N,-,-1,-1
RECMUS.txt,591374,592749,1375,10,N,N,-,-1,-1
RECMUS.txt,591607,592868,1261,10,N,N,-,-1,-1
RECMUS.txt,591736,593051,1315,10,N,N,-,-1,-1
RECMUS.txt,591863,593233,1370,10,N,N,-,-1,-1
RECMUS.txt,591984,593383,1399,10,N,N,-,-1,-1
RECMUS.txt,592050,593480,1430,10,N,N,-,-1,-1
RECMUS.txt,592092,593543,1451,10,N,N,-,-1,-1
RECMUS.txt,592160,593699,1539,10,N,N,-,-1,-1
RECMUS.txt,592194,593827,1633,10,N,N,-,-1,-1
RECMUS.txt,592486,594078,1592,10,N,Y,1448039123601,19678,19935
RECMUS.txt,592750,594196,1446,10,N,Y,1448039123601,19678,19935
RECMUS.txt,592869,594257,1388,10,N,Y,1448039123601,19678,19935
RECMUS.txt,593052,594387,1335,10,N,Y,1448039123601,19678,19935
RECMUS.txt,593234,594569,1335,10,N,Y,1448039123601,19678,19935
RECMUS.txt,593384,594664,1280,10,N,Y,1448039123601,19678,19935
RECMUS.txt,593481,594902,1421,10,N,Y,1448039123601,19678,19935
RECMUS.txt,593545,595044,1499,10,N,Y,1448039123601,19678,19935
RECMUS.txt,593700,595171,1471,10,N,Y,1448039123601,19678,19935
RECMUS.txt,593829,595306,1477,10,N,Y,1448039123601,19678,19935
RECMUS.txt,594079,595403,1324,10,N,N,-,-1,-1
RECMUS.txt,594197,595703,1506,10,N,N,-,-1,-1
RECMUS.txt,594260,595937,1677,10,N,N,-,-1,-1
RECMUS.txt,594388,596031,1643,10,N,N,-,-1,-1
RECMUS.txt,594570,596182,1612,10,N,N,-,-1,-1
RECMUS.txt,594665,596259,1594,10,N,N,-,-1,-1
RECMUS.txt,594903,596372,1469,10,N,N,-,-1,-1
RECMUS.txt,595047,596489,1442,10,N,N,-,-1,-1
RECMUS.txt,595174,596644,1470,10,N,N,-,-1,-1
RECMUS.txt,595307,596795,1488,10,N,N,-,-1,-1
RECMUS.txt,595405,596891,1486,10,N,N,-,-1,-1
RECMUS.txt,595704,597087,1383,10,N,N,-,-1,-1
RECMUS.txt,595938,597194,1256,10,N,N,-,-1,-1
RECMUS.txt,596034,597490,1456,10,N,N,-,-1,-1
RECMUS.txt,596183,597630,1447,10,N,N,-,-1,-1
RECMUS.txt,596261,597812,1551,10,N,N,-,-1,-1
RECMUS.txt,596374,597919,1545,10,N,N,-,-1,-1
RECMUS.txt,596491,597998,1507,10,N,N,-,-1,-1
RECMUS.txt,596645,598104,1459,10,N,N,-,-1,-1
RECMUS.txt,596796,598140,1344,10,N,N,-,-1,-1
RECMUS.txt,596894,598437,1543,10,N,N,-,-1,-1
RECMUS.txt,597088,598529,1441,10,N,N,-,-1,-1
RECMUS.txt,597197,598597,1400,10,N,N,-,-1,-1
RECMUS.txt,597491,598643,1152,10,N,N,-,-1,-1
RECMUS.txt,597631,598781,1150,10,N,N,-,-1,-1
RECMUS.txt,597813,598876,1063,10,N,N,-,-1,-1
RECMUS.txt,597920,598905,985,10,N,N,-,-1,-1
RECMUS.txt,597999,598916,917,10,N,N,-,-1,-1
RECMUS.txt,598105,598948,843,10,N,N,-,-1,-1
RECMUS.txt,598142,599282,1140,10,N,N,-,-1,-1
RECMUS.txt,598438,599440,1002,10,N,N,-,-1,-1
RECMUS.txt,598530,599586,1056,10,N,N,-,-1,-1
RECMUS.txt,598598,599748,1150,10,Y,N,-,-1,-1
RECMUS.txt,598646,599855,1209,10,Y,N,-,-1,-1
RECMUS.txt,598782,600037,1255,10,Y,N,-,-1,-1
RECMUS.txt,598877,600168,1291,10,Y,N,-,-1,-1
RECMUS.txt,598906,600369,1463,10,Y,N,-,-1,-1
RECMUS.txt,598921,600493,1572,10,Y,Y,1448279813455,71525,72226
RECMUS.txt,598953,600635,1682,10,Y,Y,1448279813455,71525,72226
RECMUS.txt,599283,600758,1475,10,Y,Y,1448279813455,71525,72226
RECMUS.txt,599441,600855,1414,10,Y,Y,1448279813455,71525,72226
RECMUS.txt,599587,600974,1387,10,N,Y,1448279813455,71525,72226
RECMUS.txt,599749,601030,1281,10,N,Y,1448279813455,71525,72226
RECMUS.txt,599856,601212,1356,10,N,Y,1448279813455,71525,72226
RECMUS.txt,600038,601348,1310,10,N,Y,1448279813455,71525,72226
RECMUS.txt,600169,601360,1191,10,N,Y,1448279813455,71525,72226
RECMUS.txt,600370,601509,1139,10,N,Y,1448279813455,71525,72226
RECMUS.txt,600494,601568,1074,10,N,Y,1448279813455,71525,72226
RECMUS.txt,600636,601725,1089,10,N,N,-,-1,-1
RECMUS.txt,600760,601910,1150,10,N,N,-,-1,-1
RECMUS.txt,600858,602037,1179,10,N,N,-,-1,-1
RECMUS.txt,600975,602108,1133,10,N,N,-,-1,-1
RECMUS.txt,601031,602299,1268,10,N,N,-,-1,-1
RECMUS.txt,601213,602334,1121,10,N,N,-,-1,-1
RECMUS.txt,601351,602664,1313,10,N,N,-,-1,-1
RECMUS.txt,601361,602877,1516,10,N,N,-,-1,-1
RECMUS.txt,601510,603218,1708,10,Y,Y,1448281888079,98877,102290
RECMUS.txt,601569,603311,1742,10,Y,Y,1448281888079,98877,102290
RECMUS.txt,601726,603361,1635,10,Y,Y,1448281888079,98877,102290
RECMUS.txt,601911,603478,1567,10,Y,Y,1448281888079,98877,102290
RECMUS.txt,602039,603577,1538,10,Y,Y,1448281888079,98877,102290
RECMUS.txt,602109,603719,1610,10,Y,Y,1448281888079,98877,102290
RECMUS.txt,602300,603797,1497,10,Y,Y,1448281888079,98877,102290
RECMUS.txt,602335,603845,1510,10,Y,Y,1448281888079,98877,102290
RECMUS.txt,602665,603957,1292,10,N,Y,1448281888079,98877,102290
RECMUS.txt,602878,604038,1160,10,N,Y,1448281888079,98877,102290
RECMUS.txt,603219,604116,897,10,N,Y,1448281888079,98877,102290
RECMUS.txt,603314,604163,849,10,N,N,-,-1,-1
RECMUS.txt,603362,604197,835,10,N,N,-,-1,-1
RECMUS.txt,603479,604531,1052,10,N,N,-,-1,-1
RECMUS.txt,603580,604628,1048,10,N,N,-,-1,-1
RECMUS.txt,603724,604694,970,10,N,N,-,-1,-1
RECMUS.txt,603798,604858,1060,10,N,N,-,-1,-1
RECMUS.txt,603847,605079,1232,10,N,N,-,-1,-1
RECMUS.txt,603958,605095,1137,10,N,N,-,-1,-1
RECMUS.txt,604039,605135,1096,10,N,N,-,-1,-1
RECMUS.txt,604117,605148,1031,10,N,N,-,-1,-1
RECMUS.txt,604164,605199,1035,10,N,N,-,-1,-1
RECMUS.txt,604199,605212,1013,10,N,N,-,-1,-1
RECMUS.txt,604532,605340,808,10,N,N,-,-1,-1
RECMUS.txt,604629,605478,849,10,N,N,-,-1,-1
RECMUS.txt,604697,605509,812,10,N,N,-,-1,-1
RECMUS.txt,604859,605620,761,10,N,N,-,-1,-1
RECMUS.txt,605080,605777,697,10,N,N,-,-1,-1
RECMUS.txt,605096,605867,771,10,N,N,-,-1,-1
RECMUS.txt,605136,605932,796,10,N,N,-,-1,-1
RECMUS.txt,605149,605965,816,10,N,N,-,-1,-1
RECMUS.txt,605200,606062,862,10,N,N,-,-1,-1
RECMUS.txt,605213,606156,943,10,N,N,-,-1,-1
RECMUS.txt,605343,606331,988,10,N,N,-,-1,-1
RECMUS.txt,605479,606394,915,10,N,N,-,-1,-1
RECMUS.txt,605510,606756,1246,10,N,N,-,-1,-1
RECMUS.txt,605622,606800,1178,10,N,N,-,-1,-1
RECMUS.txt,605782,606823,1041,10,N,N,-,-1,-1
RECMUS.txt,605868,606896,1028,10,N,N,-,-1,-1
RECMUS.txt,605933,606921,988,10,N,N,-,-1,-1
RECMUS.txt,605966,607001,1035,10,N,N,-,-1,-1
RECMUS.txt,606063,607321,1258,10,N,N,-,-1,-1
RECMUS.txt,606157,607422,1265,10,N,N,-,-1,-1
RECMUS.txt,606332,607543,1211,10,N,N,-,-1,-1
RECMUS.txt,606395,607607,1212,10,N,N,-,-1,-1
RECMUS.txt,606757,607717,960,10,N,N,-,-1,-1
RECMUS.txt,606802,607794,992,10,N,N,-,-1,-1
RECMUS.txt,606824,607824,1000,10,N,N,-,-1,-1
RECMUS.txt,606897,608145,1248,10,N,N,-,-1,-1
RECMUS.txt,606922,608213,1291,10,N,N,-,-1,-1
RECMUS.txt,607002,608391,1389,10,N,N,-,-1,-1
RECMUS.txt,607322,608649,1327,10,N,N,-,-1,-1
RECMUS.txt,607423,608723,1300,10,N,N,-,-1,-1
RECMUS.txt,607544,608862,1318,10,N,N,-,-1,-1
RECMUS.txt,607608,608992,1384,10,N,N,-,-1,-1
RECMUS.txt,607718,609080,1362,10,N,N,-,-1,-1
RECMUS.txt,607799,609178,1379,10,N,N,-,-1,-1
RECMUS.txt,607829,609291,1462,10,N,N,-,-1,-1
RECMUS.txt,608146,609304,1158,10,N,N,-,-1,-1
RECMUS.txt,608214,609312,1098,10,N,N,-,-1,-1
RECMUS.txt,608393,609361,968,10,N,N,-,-1,-1
RECMUS.txt,608650,609406,756,10,N,N,-,-1,-1
RECMUS.txt,608724,609431,707,10,N,N,-,-1,-1
RECMUS.txt,608865,609457,592,10,N,N,-,-1,-1
RECMUS.txt,608993,609633,640,10,N,N,-,-1,-1
RECMUS.txt,609081,609827,746,10,N,N,-,-1,-1
RECMUS.txt,609179,609886,707,10,N,N,-,-1,-1
RECMUS.txt,609292,610031,739,10,N,N,-,-1,-1
RECMUS.txt,609305,610057,752,10,N,N,-,-1,-1
RECMUS.txt,609315,610149,834,10,N,N,-,-1,-1
RECMUS.txt,609364,610349,985,10,N,N,-,-1,-1
RECMUS.txt,609407,610426,1019,10,N,N,-,-1,-1
RECMUS.txt,609434,610601,1167,10,Y,N,-,-1,-1
RECMUS.txt,609458,610686,1228,10,Y,N,-,-1,-1
RECMUS.txt,609634,610706,1072,10,Y,N,-,-1,-1
RECMUS.txt,609829,610749,920,10,N,N,-,-1,-1
RECMUS.txt,609887,610803,916,10,N,N,-,-1,-1
RECMUS.txt,610036,611068,1032,10,N,Y,1437475017618,98942,100041
RECMUS.txt,610058,611238,1180,10,Y,Y,1437475017618,98942,100041
RECMUS.txt,610151,611249,1098,10,Y,Y,1437475017618,98942,100041
RECMUS.txt,610350,611333,983,10,N,Y,1437475017618,98942,100041
RECMUS.txt,610427,611377,950,10,N,Y,1437475017618,98942,100041
RECMUS.txt,610602,611446,844,10,N,Y,1437475017618,98942,100041
RECMUS.txt,610687,611470,783,10,N,Y,1437475017618,98942,100041
RECMUS.txt,610707,611559,852,10,N,Y,1437475017618,98942,100041
RECMUS.txt,610750,611609,859,10,N,Y,1437475017618,98942,100041
RECMUS.txt,610804,611777,973,10,N,Y,1437475017618,98942,100041
RECMUS.txt,611069,611797,728,10,N,Y,1437475017618,98942,100041
RECMUS.txt,611241,612049,808,10,N,N,-,-1,-1
RECMUS.txt,611250,612136,886,10,N,N,-,-1,-1
RECMUS.txt,611334,612166,832,10,N,N,-,-1,-1
RECMUS.txt,611378,612443,1065,10,N,N,-,-1,-1
RECMUS.txt,611449,612505,1056,10,N,N,-,-1,-1
RECMUS.txt,611471,612573,1102,10,N,N,-,-1,-1
RECMUS.txt,611561,612612,1051,10,N,N,-,-1,-1
RECMUS.txt,611610,612709,1099,10,N,N,-,-1,-1
RECMUS.txt,611778,612860,1082,10,N,N,-,-1,-1
RECMUS.txt,611800,613046,1246,10,N,N,-,-1,-1
RECMUS.txt,612054,613118,1064,10,N,N,-,-1,-1
RECMUS.txt,612137,613220,1083,10,N,N,-,-1,-1
RECMUS.txt,612167,613255,1088,10,N,N,-,-1,-1
RECMUS.txt,612444,613284,840,10,N,N,-,-1,-1
RECMUS.txt,612506,613325,819,10,N,N,-,-1,-1
RECMUS.txt,612574,613414,840,10,N,N,-,-1,-1
RECMUS.txt,612613,613554,941,10,N,N,-,-1,-1
RECMUS.txt,612712,613617,905,10,N,N,-,-1,-1
RECMUS.txt,612861,613698,837,10,N,N,-,-1,-1
RECMUS.txt,613047,613845,798,10,N,N,-,-1,-1
RECMUS.txt,613119,613914,795,10,N,N,-,-1,-1
RECMUS.txt,613226,613961,735,10,N,N,-,-1,-1
RECMUS.txt,613256,614104,848,10,N,N,-,-1,-1
RECMUS.txt,613286,614232,946,10,N,N,-,-1,-1
RECMUS.txt,613326,614342,1016,10,N,N,-,-1,-1
RECMUS.txt,613417,614463,1046,10,N,N,-,-1,-1
RECMUS.txt,613555,614529,974,10,N,N,-,-1,-1
RECMUS.txt,613618,614770,1152,10,Y,N,-,-1,-1
RECMUS.txt,613699,615007,1308,10,Y,N,-,-1,-1
RECMUS.txt,613846,615087,1241,10,Y,N,-,-1,-1
RECMUS.txt,613916,615119,1203,10,Y,N,-,-1,-1
RECMUS.txt,613962,615239,1277,10,Y,N,-,-1,-1
RECMUS.txt,614105,615274,1169,10,Y,N,-,-1,-1
RECMUS.txt,614233,615295,1062,10,Y,N,-,-1,-1
RECMUS.txt,614343,615421,1078,10,Y,N,-,-1,-1
RECMUS.txt,614464,615423,959,10,Y,N,-,-1,-1
RECMUS.txt,614530,615596,1066,10,N,N,-,-1,-1
RECMUS.txt,614771,615702,931,10,N,N,-,-1,-1
RECMUS.txt,615010,615714,704,10,N,N,-,-1,-1
RECMUS.txt,615090,615769,679,10,N,N,-,-1,-1
RECMUS.txt,615120,615814,694,10,N,N,-,-1,-1
RECMUS.txt,615242,616072,830,10,N,N,-,-1,-1
RECMUS.txt,615279,616263,984,10,N,N,-,-1,-1
RECMUS.txt,615296,616304,1008,10,N,N,-,-1,-1
RECMUS.txt,615422,616358,936,10,N,N,-,-1,-1
RECMUS.txt,615424,616387,963,10,N,N,-,-1,-1
RECMUS.txt,615599,616402,803,10,N,N,-,-1,-1
RECMUS.txt,615705,616449,744,10,N,N,-,-1,-1
RECMUS.txt,615715,616528,813,10,N,N,-,-1,-1
RECMUS.txt,615770,616543,773,10,N,N,-,-1,-1
RECMUS.txt,615816,616573,757,10,N,N,-,-1,-1
RECMUS.txt,616073,616603,530,10,N,N,-,-1,-1
RECMUS.txt,616264,616681,417,10,N,N,-,-1,-1
RECMUS.txt,616307,616757,450,10,N,N,-,-1,-1
RECMUS.txt,616360,616777,417,10,N,N,-,-1,-1
RECMUS.txt,616388,616866,478,10,N,N,-,-1,-1
RECMUS.txt,616403,616908,505,10,N,N,-,-1,-1
RECMUS.txt,616452,617004,552,10,N,N,-,-1,-1
RECMUS.txt,616531,617284,753,10,N,N,-,-1,-1
RECMUS.txt,616546,617344,798,10,N,N,-,-1,-1
RECMUS.txt,616573,617442,869,10,N,N,-,-1,-1
RECMUS.txt,616604,617464,860,10,N,N,-,-1,-1
RECMUS.txt,616682,617473,791,10,N,N,-,-1,-1
RECMUS.txt,616758,617757,999,10,N,N,-,-1,-1
RECMUS.txt,616779,617943,1164,10,N,N,-,-1,-1
RECMUS.txt,616867,617985,1118,10,N,N,-,-1,-1
RECMUS.txt,616909,618018,1109,10,N,N,-,-1,-1
RECMUS.txt,617007,618170,1163,10,N,N,-,-1,-1
RECMUS.txt,617285,618235,950,10,N,N,-,-1,-1
RECMUS.txt,617347,618366,1019,10,N,N,-,-1,-1
RECMUS.txt,617443,618628,1185,10,N,N,-,-1,-1
RECMUS.txt,617465,618832,1367,10,N,N,-,-1,-1
RECMUS.txt,617476,618940,1464,10,N,N,-,-1,-1
RECMUS.txt,617758,619114,1356,10,N,N,-,-1,-1
RECMUS.txt,617944,619172,1228,10,N,N,-,-1,-1
RECMUS.txt,617986,619293,1307,10,N,N,-,-1,-1
RECMUS.txt,618021,619301,1280,10,N,N,-,-1,-1
RECMUS.txt,618171,619368,1197,10,N,N,-,-1,-1
RECMUS.txt,618238,619397,1159,10,N,N,-,-1,-1
RECMUS.txt,618367,619544,1177,10,N,N,-,-1,-1
RECMUS.txt,618631,619583,952,10,N,N,-,-1,-1
RECMUS.txt,618833,619671,838,10,N,N,-,-1,-1
RECMUS.txt,618941,620016,1075,10,N,N,-,-1,-1
RECMUS.txt,619115,620348,1233,10,N,N,-,-1,-1
RECMUS.txt,619177,620451,1274,10,N,N,-,-1,-1
RECMUS.txt,619294,620609,1315,10,N,N,-,-1,-1
RECMUS.txt,619302,620763,1461,10,N,N,-,-1,-1
RECMUS.txt,619369,621158,1789,10,N,N,-,-1,-1
RECMUS.txt,619398,621213,1815,10,N,N,-,-1,-1
RECMUS.txt,619545,621719,2174,10,N,N,-,-1,-1
RECMUS.txt,619584,621856,2272,10,N,N,-,-1,-1
RECMUS.txt,619672,621970,2298,10,N,N,-,-1,-1
RECMUS.txt,620019,622119,2100,10,N,N,-,-1,-1
RECMUS.txt,620349,622257,1908,10,N,N,-,-1,-1
RECMUS.txt,620452,622423,1971,10,N,N,-,-1,-1
RECMUS.txt,620610,622864,2254,10,N,N,-,-1,-1
RECMUS.txt,620766,623011,2245,10,N,N,-,-1,-1
RECMUS.txt,621161,623134,1973,10,N,N,-,-1,-1
RECMUS.txt,621214,623152,1938,10,N,N,-,-1,-1
RECMUS.txt,621720,623159,1439,10,N,N,-,-1,-1
RECMUS.txt,621857,623330,1473,10,N,N,-,-1,-1
RECMUS.txt,621971,623367,1396,10,N,N,-,-1,-1
RECMUS.txt,622120,623516,1396,10,N,N,-,-1,-1
RECMUS.txt,622258,623545,1287,10,N,N,-,-1,-1
RECMUS.txt,622425,623660,1235,10,N,N,-,-1,-1
RECMUS.txt,622865,623696,831,10,N,N,-,-1,-1
RECMUS.txt,623012,623750,738,10,N,N,-,-1,-1
RECMUS.txt,623135,623769,634,10,N,N,-,-1,-1
RECMUS.txt,623152,624080,928,10,N,N,-,-1,-1
RECMUS.txt,623160,624362,1202,10,N,N,-,-1,-1
RECMUS.txt,623332,624446,1114,10,N,N,-,-1,-1
RECMUS.txt,623368,624602,1234,10,N,N,-,-1,-1
RECMUS.txt,623521,624691,1170,10,N,N,-,-1,-1
RECMUS.txt,623546,624741,1195,10,N,N,-,-1,-1
RECMUS.txt,623661,624931,1270,10,N,N,-,-1,-1
RECMUS.txt,623697,625064,1367,10,N,N,-,-1,-1
RECMUS.txt,623755,625226,1471,10,N,N,-,-1,-1
RECMUS.txt,623771,625279,1508,10,N,N,-,-1,-1
RECMUS.txt,624083,625365,1282,10,N,N,-,-1,-1
RECMUS.txt,624364,625603,1239,10,N,N,-,-1,-1
RECMUS.txt,624447,625666,1219,10,N,N,-,-1,-1
RECMUS.txt,624603,625801,1198,10,N,N,-,-1,-1
RECMUS.txt,624692,625944,1252,10,N,N,-,-1,-1
RECMUS.txt,624744,626198,1454,10,N,N,-,-1,-1
RECMUS.txt,624932,626288,1356,10,N,N,-,-1,-1
RECMUS.txt,625067,626859,1792,10,N,N,-,-1,-1
RECMUS.txt,625229,627045,1816,10,N,N,-,-1,-1
RECMUS.txt,625280,627226,1946,10,N,N,-,-1,-1
RECMUS.txt,625366,627432,2066,10,N,N,-,-1,-1
RECMUS.txt,625604,627634,2030,10,N,N,-,-1,-1
RECMUS.txt,625668,627773,2105,10,N,N,-,-1,-1
RECMUS.txt,625802,627833,2031,10,N,N,-,-1,-1
RECMUS.txt,625945,627885,1940,10,N,N,-,-1,-1
RECMUS.txt,626201,627928,1727,10,N,N,-,-1,-1
RECMUS.txt,626289,628263,1974,10,N,N,-,-1,-1
RECMUS.txt,626862,628446,1584,10,N,N,-,-1,-1
RECMUS.txt,627046,628621,1575,10,N,N,-,-1,-1
RECMUS.txt,627227,628862,1635,10,N,N,-,-1,-1
RECMUS.txt,627433,628968,1535,10,N,N,-,-1,-1
RECMUS.txt,627635,629106,1471,10,N,N,-,-1,-1
RECMUS.txt,627776,629140,1364,10,N,N,-,-1,-1
RECMUS.txt,627834,629353,1519,10,N,N,-,-1,-1
RECMUS.txt,627890,629428,1538,10,N,N,-,-1,-1
RECMUS.txt,627931,629620,1689,10,N,N,-,-1,-1
RECMUS.txt,628264,629810,1546,10,N,N,-,-1,-1
RECMUS.txt,628447,629993,1546,10,N,N,-,-1,-1
RECMUS.txt,628622,630115,1493,10,N,N,-,-1,-1
RECMUS.txt,628863,630290,1427,10,Y,N,-,-1,-1
RECMUS.txt,628969,630333,1364,10,Y,N,-,-1,-1
RECMUS.txt,629107,630339,1232,10,N,N,-,-1,-1
RECMUS.txt,629143,630444,1301,10,N,N,-,-1,-1
RECMUS.txt,629354,630917,1563,10,N,N,-,-1,-1
RECMUS.txt,629429,631004,1575,10,N,N,-,-1,-1
RECMUS.txt,629622,631176,1554,10,N,N,-,-1,-1
RECMUS.txt,629811,631409,1598,10,N,N,-,-1,-1
RECMUS.txt,629994,631569,1575,10,N,N,-,-1,-1
RECMUS.txt,630116,631933,1817,10,N,N,-,-1,-1
RECMUS.txt,630295,632110,1815,10,N,N,-,-1,-1
RECMUS.txt,630334,632295,1961,10,N,N,-,-1,-1
RECMUS.txt,630344,632524,2180,10,N,N,-,-1,-1
RECMUS.txt,630445,632535,2090,10,N,N,-,-1,-1
RECMUS.txt,630920,632642,1722,10,N,N,-,-1,-1
RECMUS.txt,631005,632678,1673,10,N,N,-,-1,-1
RECMUS.txt,631177,632729,1552,10,N,N,-,-1,-1
RECMUS.txt,631410,632885,1475,10,N,N,-,-1,-1
RECMUS.txt,631570,633025,1455,10,N,N,-,-1,-1
RECMUS.txt,631934,633533,1599,10,N,N,-,-1,-1
RECMUS.txt,632111,633739,1628,10,N,N,-,-1,-1
RECMUS.txt,632298,633789,1491,10,N,N,-,-1,-1
RECMUS.txt,632525,633848,1323,10,N,N,-,-1,-1
RECMUS.txt,632536,634134,1598,10,N,N,-,-1,-1
RECMUS.txt,632645,634477,1832,10,N,N,-,-1,-1
RECMUS.txt,632679,634712,2033,10,N,N,-,-1,-1
RECMUS.txt,632732,634808,2076,10,N,N,-,-1,-1
RECMUS.txt,632886,635071,2185,10,N,N,-,-1,-1
RECMUS.txt,633027,635142,2115,10,N,N,-,-1,-1
RECMUS.txt,633534,635178,1644,10,N,N,-,-1,-1
RECMUS.txt,633742,635193,1451,10,N,N,-,-1,-1
RECMUS.txt,633790,635545,1755,10,N,N,-,-1,-1
RECMUS.txt,633850,635627,1777,10,N,N,-,-1,-1
RECMUS.txt,634137,635682,1545,10,N,N,-,-1,-1
RECMUS.txt,634478,635982,1504,10,N,N,-,-1,-1
RECMUS.txt,634713,636048,1335,10,N,N,-,-1,-1
RECMUS.txt,634809,636392,1583,10,N,N,-,-1,-1
RECMUS.txt,635072,636621,1549,10,N,N,-,-1,-1
RECMUS.txt,635143,636817,1674,10,N,N,-,-1,-1
RECMUS.txt,635179,636938,1759,10,N,N,-,-1,-1
RECMUS.txt,635194,636970,1776,10,N,N,-,-1,-1
RECMUS.txt,635547,637159,1612,10,N,N,-,-1,-1
RECMUS.txt,635628,637304,1676,10,N,N,-,-1,-1
RECMUS.txt,635685,637363,1678,10,N,N,-,-1,-1
RECMUS.txt,635984,637381,1397,10,N,N,-,-1,-1
RECMUS.txt,636049,637389,1340,10,N,N,-,-1,-1
RECMUS.txt,636393,637785,1392,10,N,N,-,-1,-1
RECMUS.txt,636622,638015,1393,10,N,N,-,-1,-1
RECMUS.txt,636819,638137,1318,10,N,N,-,-1,-1
RECMUS.txt,636939,638244,1305,10,N,N,-,-1,-1
RECMUS.txt,636973,638287,1314,10,N,N,-,-1,-1
RECMUS.txt,637159,638426,1267,10,N,N,-,-1,-1
RECMUS.txt,637305,638542,1237,10,N,N,-,-1,-1
RECMUS.txt,637368,638682,1314,10,Y,N,-,-1,-1
RECMUS.txt,637384,638805,1421,10,Y,N,-,-1,-1
RECMUS.txt,637392,638918,1526,10,Y,N,-,-1,-1
RECMUS.txt,637788,639369,1581,10,N,N,-,-1,-1
RECMUS.txt,638016,639377,1361,10,N,N,-,-1,-1
RECMUS.txt,638139,639535,1396,10,N,N,-,-1,-1
RECMUS.txt,638245,639701,1456,10,N,N,-,-1,-1
RECMUS.txt,638288,639763,1475,10,N,N,-,-1,-1
RECMUS.txt,638428,639923,1495,10,N,N,-,-1,-1
RECMUS.txt,638544,640083,1539,10,N,Y,1437476486340,221621,222520
RECMUS.txt,638683,640281,1598,10,N,Y,1437476486340,221621,222520
RECMUS.txt,638806,640414,1608,10,N,Y,1437476486340,221621,222520
RECMUS.txt,638919,640632,1713,10,N,Y,1437476486340,221621,222520
RECMUS.txt,639370,640722,1352,10,N,Y,1437476486340,221621,222520
RECMUS.txt,639378,640861,1483,10,N,Y,1437476486340,221621,222520
RECMUS.txt,639536,640956,1420,10,N,Y,1437476486340,221621,222520
RECMUS.txt,639702,640997,1295,10,N,Y,1437476486340,221621,222520
RECMUS.txt,639764,641220,1456,10,N,Y,1437476486340,221621,222520
RECMUS.txt,639924,641223,1299,10,N,Y,1437476486340,221621,222520
RECMUS.txt,640084,641475,1391,10,N,Y,1437476486340,221621,222520
RECMUS.txt,640282,641477,1195,10,N,N,-,-1,-1
RECMUS.txt,640415,641587,1172,10,N,N,-,-1,-1
RECMUS.txt,640635,641602,967,10,N,N,-,-1,-1
RECMUS.txt,640723,641683,960,10,N,N,-,-1,-1
RECMUS.txt,640862,641774,912,10,N,N,-,-1,-1
RECMUS.txt,640956,641823,867,10,N,N,-,-1,-1
RECMUS.txt,640998,642005,1007,10,N,N,-,-1,-1
RECMUS.txt,641222,642052,830,10,N,N,-,-1,-1
RECMUS.txt,641224,642176,952,10,N,N,-,-1,-1
RECMUS.txt,641476,642310,834,10,N,N,-,-1,-1
RECMUS.txt,641478,642483,1005,10,N,N,-,-1,-1
RECMUS.txt,641588,642541,953,10,N,N,-,-1,-1
RECMUS.txt,641603,642822,1219,10,N,N,-,-1,-1
RECMUS.txt,641685,642866,1181,10,N,N,-,-1,-1
RECMUS.txt,641777,642932,1155,10,N,N,-,-1,-1
RECMUS.txt,641824,642964,1140,10,N,N,-,-1,-1
RECMUS.txt,642006,643024,1018,10,N,N,-,-1,-1
RECMUS.txt,642053,643045,992,10,N,N,-,-1,-1
RECMUS.txt,642177,643252,1075,10,N,N,-,-1,-1
RECMUS.txt,642311,643564,1253,10,N,N,-,-1,-1
RECMUS.txt,642484,643638,1154,10,N,N,-,-1,-1
RECMUS.txt,642544,643736,1192,10,N,N,-,-1,-1
RECMUS.txt,642823,643802,979,10,N,N,-,-1,-1
RECMUS.txt,642867,643851,984,10,N,N,-,-1,-1
RECMUS.txt,642933,643958,1025,10,N,N,-,-1,-1
RECMUS.txt,642965,643999,1034,10,N,N,-,-1,-1
RECMUS.txt,643025,644063,1038,10,N,N,-,-1,-1
RECMUS.txt,643048,644199,1151,10,N,N,-,-1,-1
RECMUS.txt,643253,644528,1275,10,N,N,-,-1,-1
RECMUS.txt,643565,644739,1174,10,N,N,-,-1,-1
RECMUS.txt,643639,644873,1234,10,N,N,-,-1,-1
RECMUS.txt,643739,644886,1147,10,N,N,-,-1,-1
RECMUS.txt,643803,644906,1103,10,N,N,-,-1,-1
RECMUS.txt,643852,645013,1161,10,N,N,-,-1,-1
RECMUS.txt,643959,645155,1196,10,N,N,-,-1,-1
RECMUS.txt,644000,645405,1405,10,N,N,-,-1,-1
RECMUS.txt,644068,645489,1421,10,N,N,-,-1,-1
RECMUS.txt,644200,645600,1400,10,N,N,-,-1,-1
RECMUS.txt,644529,645712,1183,10,N,N,-,-1,-1
RECMUS.txt,644740,645762,1022,10,N,N,-,-1,-1
RECMUS.txt,644874,646051,1177,10,N,N,-,-1,-1
RECMUS.txt,644887,646237,1350,10,N,N,-,-1,-1
RECMUS.txt,644907,646305,1398,10,N,N,-,-1,-1
RECMUS.txt,645014,646455,1441,10,N,N,-,-1,-1
RECMUS.txt,645156,646624,1468,10,N,N,-,-1,-1
RECMUS.txt,645406,646754,1348,10,N,N,-,-1,-1
RECMUS.txt,645490,647028,1538,10,N,N,-,-1,-1
RECMUS.txt,645601,647281,1680,10,N,N,-,-1,-1
RECMUS.txt,645713,647402,1689,10,N,N,-,-1,-1
RECMUS.txt,645763,647808,2045,10,N,N,-,-1,-1
RECMUS.txt,646052,648402,2350,10,N,N,-,-1,-1
RECMUS.txt,646240,648429,2189,10,N,N,-,-1,-1
RECMUS.txt,646306,648560,2254,10,N,N,-,-1,-1
RECMUS.txt,646460,648683,2223,10,N,N,-,-1,-1
RECMUS.txt,646625,648882,2257,10,N,N,-,-1,-1
RECMUS.txt,646755,649065,2310,10,N,N,-,-1,-1
RECMUS.txt,647029,649159,2130,10,N,N,-,-1,-1
RECMUS.txt,647282,649339,2057,10,N,N,-,-1,-1
RECMUS.txt,647404,649355,1951,10,N,N,-,-1,-1
RECMUS.txt,647810,649596,1786,10,N,N,-,-1,-1
RECMUS.txt,648407,649597,1190,10,N,N,-,-1,-1
RECMUS.txt,648434,649655,1221,10,N,N,-,-1,-1
RECMUS.txt,648562,649818,1256,10,N,N,-,-1,-1
RECMUS.txt,648685,649994,1309,10,N,N,-,-1,-1
RECMUS.txt,648883,650045,1162,10,N,N,-,-1,-1
RECMUS.txt,649066,650197,1131,10,N,N,-,-1,-1
RECMUS.txt,649161,650415,1254,10,N,N,-,-1,-1
RECMUS.txt,649339,650593,1254,10,N,N,-,-1,-1
RECMUS.txt,649356,650772,1416,10,N,N,-,-1,-1
RECMUS.txt,649596,650813,1217,10,N,N,-,-1,-1
RECMUS.txt,649598,651317,1719,10,Y,N,-,-1,-1
RECMUS.txt,649656,651475,1819,10,Y,N,-,-1,-1
RECMUS.txt,649819,651616,1797,10,Y,N,-,-1,-1
RECMUS.txt,649995,651788,1793,10,Y,N,-,-1,-1
RECMUS.txt,650046,652010,1964,10,N,N,-,-1,-1
RECMUS.txt,650200,652064,1864,10,N,N,-,-1,-1
RECMUS.txt,650416,652608,2192,10,Y,N,-,-1,-1
RECMUS.txt,650595,652878,2283,10,Y,N,-,-1,-1
RECMUS.txt,650772,652895,2123,10,N,N,-,-1,-1
RECMUS.txt,650818,652902,2084,10,N,N,-,-1,-1
RECMUS.txt,651320,653266,1946,10,N,N,-,-1,-1
RECMUS.txt,651476,653475,1999,10,N,N,-,-1,-1
RECMUS.txt,651618,653693,2075,10,N,N,-,-1,-1
RECMUS.txt,651789,653756,1967,10,N,N,-,-1,-1
RECMUS.txt,652011,653808,1797,10,N,N,-,-1,-1
RECMUS.txt,652067,653866,1799,10,N,N,-,-1,-1
RECMUS.txt,652609,654176,1567,10,N,N,-,-1,-1
RECMUS.txt,652883,654234,1351,10,N,N,-,-1,-1
RECMUS.txt,652897,654413,1516,10,N,N,-,-1,-1
RECMUS.txt,652905,654541,1636,10,N,N,-,-1,-1
RECMUS.txt,653269,654610,1341,10,N,N,-,-1,-1
RECMUS.txt,653476,654789,1313,10,N,N,-,-1,-1
RECMUS.txt,653694,654806,1112,10,N,N,-,-1,-1
RECMUS.txt,653757,654919,1162,10,N,N,-,-1,-1
RECMUS.txt,653808,654930,1122,10,N,N,-,-1,-1
RECMUS.txt,653867,655004,1137,10,N,N,-,-1,-1
RECMUS.txt,654177,655469,1292,10,Y,N,-,-1,-1
RECMUS.txt,654235,655549,1314,10,Y,N,-,-1,-1
RECMUS.txt,654414,655960,1546,10,Y,N,-,-1,-1
RECMUS.txt,654542,656280,1738,10,Y,N,-,-1,-1
RECMUS.txt,654611,656432,1821,10,Y,N,-,-1,-1
RECMUS.txt,654792,656542,1750,10,Y,N,-,-1,-1
RECMUS.txt,654807,656571,1764,10,Y,N,-,-1,-1
RECMUS.txt,654920,656619,1699,10,Y,N,-,-1,-1
RECMUS.txt,654931,656748,1817,10,Y,N,-,-1,-1
RECMUS.txt,655005,656810,1805,10,Y,N,-,-1,-1
RECMUS.txt,655470,656962,1492,10,Y,N,-,-1,-1
RECMUS.txt,655552,657017,1465,10,Y,N,-,-1,-1
RECMUS.txt,655962,657056,1094,10,N,N,-,-1,-1
RECMUS.txt,656281,657124,843,10,N,N,-,-1,-1
RECMUS.txt,656433,657279,846,10,N,N,-,-1,-1
RECMUS.txt,656545,657512,967,10,N,N,-,-1,-1
RECMUS.txt,656571,657593,1022,10,N,N,-,-1,-1
RECMUS.txt,656620,657793,1173,10,N,N,-,-1,-1
RECMUS.txt,656749,657972,1223,10,N,N,-,-1,-1
RECMUS.txt,656811,658130,1319,10,N,N,-,-1,-1
RECMUS.txt,656963,658398,1435,10,N,N,-,-1,-1
RECMUS.txt,657018,658479,1461,10,N,N,-,-1,-1
RECMUS.txt,657057,658554,1497,10,N,N,-,-1,-1
RECMUS.txt,657129,658866,1737,10,N,N,-,-1,-1
RECMUS.txt,657280,658923,1643,10,N,N,-,-1,-1
RECMUS.txt,657513,659028,1515,10,N,N,-,-1,-1
RECMUS.txt,657596,659136,1540,10,N,N,-,-1,-1
RECMUS.txt,657794,659403,1609,10,N,N,-,-1,-1
RECMUS.txt,657973,659443,1470,10,N,N,-,-1,-1
RECMUS.txt,658133,659611,1478,10,N,N,-,-1,-1
RECMUS.txt,658399,659701,1302,10,N,N,-,-1,-1
RECMUS.txt,658480,659824,1344,10,N,N,-,-1,-1
RECMUS.txt,658555,660044,1489,10,N,N,-,-1,-1
RECMUS.txt,658866,660221,1355,10,N,N,-,-1,-1
RECMUS.txt,658926,660305,1379,10,N,N,-,-1,-1
RECMUS.txt,659029,660373,1344,10,N,N,-,-1,-1
RECMUS.txt,659137,660505,1368,10,N,N,-,-1,-1
RECMUS.txt,659408,660610,1202,10,N,N,-,-1,-1
RECMUS.txt,659448,660647,1199,10,N,N,-,-1,-1
RECMUS.txt,659612,660726,1114,10,N,N,-,-1,-1
RECMUS.txt,659702,660890,1188,10,N,N,-,-1,-1
RECMUS.txt,659825,661148,1323,10,N,N,-,-1,-1
RECMUS.txt,660045,661253,1208,10,N,N,-,-1,-1
RECMUS.txt,660222,661482,1260,10,N,N,-,-1,-1
RECMUS.txt,660307,661511,1204,10,N,N,-,-1,-1
RECMUS.txt,660374,661559,1185,10,N,N,-,-1,-1
RECMUS.txt,660506,661727,1221,10,N,N,-,-1,-1
RECMUS.txt,660611,661757,1146,10,N,N,-,-1,-1
RECMUS.txt,660649,661904,1255,10,N,N,-,-1,-1
RECMUS.txt,660729,662083,1354,10,N,N,-,-1,-1
RECMUS.txt,660893,662197,1304,10,N,N,-,-1,-1
RECMUS.txt,661149,662304,1155,10,N,N,-,-1,-1
RECMUS.txt,661254,662514,1260,10,N,N,-,-1,-1
RECMUS.txt,661483,662625,1142,10,N,N,-,-1,-1
RECMUS.txt,661512,662753,1241,10,N,N,-,-1,-1
RECMUS.txt,661562,662922,1360,10,N,N,-,-1,-1
RECMUS.txt,661732,663199,1467,10,N,N,-,-1,-1
RECMUS.txt,661758,663370,1612,10,N,N,-,-1,-1
RECMUS.txt,661905,663529,1624,10,N,N,-,-1,-1
RECMUS.txt,662086,663814,1728,10,N,N,-,-1,-1
RECMUS.txt,662198,663907,1709,10,N,N,-,-1,-1
RECMUS.txt,662306,664063,1757,10,Y,N,-,-1,-1
RECMUS.txt,662515,664154,1639,10,Y,N,-,-1,-1
RECMUS.txt,662626,664495,1869,10,Y,N,-,-1,-1
RECMUS.txt,662754,664503,1749,10,Y,N,-,-1,-1
RECMUS.txt,662923,664764,1841,10,N,N,-,-1,-1
RECMUS.txt,663200,665009,1809,10,Y,N,-,-1,-1
RECMUS.txt,663371,665027,1656,10,Y,N,-,-1,-1
RECMUS.txt,663530,665034,1504,10,Y,N,-,-1,-1
RECMUS.txt,663815,665418,1603,10,N,N,-,-1,-1
RECMUS.txt,663910,665574,1664,10,N,N,-,-1,-1
RECMUS.txt,664068,665630,1562,10,N,N,-,-1,-1
RECMUS.txt,664155,665755,1600,10,N,N,-,-1,-1
RECMUS.txt,664496,665982,1486,10,N,N,-,-1,-1
RECMUS.txt,664504,666256,1752,10,N,N,-,-1,-1
RECMUS.txt,664767,666536,1769,10,N,N,-,-1,-1
RECMUS.txt,665014,666599,1585,10,N,N,-,-1,-1
RECMUS.txt,665029,666603,1574,10,N,N,-,-1,-1
RECMUS.txt,665037,666796,1759,10,N,Y,1437477480340,424837,425856
RECMUS.txt,665421,666861,1440,10,N,Y,1437477480340,424837,425856
RECMUS.txt,665575,666887,1312,10,N,Y,1437477480340,424837,425856
RECMUS.txt,665631,666905,1274,10,N,Y,1437477480340,424837,425856
RECMUS.txt,665756,666931,1175,10,N,Y,1437477480340,424837,425856
RECMUS.txt,665985,667189,1204,10,N,Y,1437477480340,424837,425856
RECMUS.txt,666257,667224,967,10,N,Y,1437477480340,424837,425856
RECMUS.txt,666537,667390,853,10,N,Y,1437477480340,424837,425856
RECMUS.txt,666602,667790,1188,10,N,Y,1437477480340,424837,425856
RECMUS.txt,666604,668030,1426,10,N,Y,1437477480340,424837,425856
RECMUS.txt,666797,668164,1367,10,N,Y,1437477480340,424837,425856
RECMUS.txt,666862,668242,1380,10,N,Y,1437477480340,424837,425856
RECMUS.txt,666888,668460,1572,10,Y,Y,1448310549245,137491,141408
RECMUS.txt,666905,668588,1683,10,Y,Y,1448310549245,137491,141408
RECMUS.txt,666934,668849,1915,10,Y,Y,1448310549245,137491,141408
RECMUS.txt,667190,668939,1749,10,N,Y,1448310549245,137491,141408
RECMUS.txt,667225,669148,1923,10,Y,Y,1437471855423,351318,351853
RECMUS.txt,667393,669226,1833,10,Y,Y,1437471855423,351318,351853
RECMUS.txt,667793,669279,1486,10,Y,Y,1437471855423,351318,351853
RECMUS.txt,668031,669302,1271,10,Y,Y,1437471855423,351318,351853
RECMUS.txt,668165,669325,1160,10,N,Y,1437471855423,351318,351853
RECMUS.txt,668243,669501,1258,10,Y,Y,1437471855423,351318,351853
RECMUS.txt,668461,669590,1129,10,N,Y,1437471855423,351318,351853
RECMUS.txt,668589,669618,1029,10,N,Y,1437471855423,351318,351853
RECMUS.txt,668850,669957,1107,10,Y,Y,1437471855423,351318,351853
RECMUS.txt,668940,670044,1104,10,Y,Y,1437471855423,351318,351853
RECMUS.txt,669149,670255,1106,10,N,N,-,-1,-1
RECMUS.txt,669227,670398,1171,10,N,Y,1448038803075,18895,19670
RECMUS.txt,669280,670515,1235,10,N,Y,1448038803075,18895,19670
RECMUS.txt,669302,670704,1402,10,N,Y,1448038803075,18895,19670
RECMUS.txt,669330,670931,1601,10,N,Y,1448038803075,18895,19670
RECMUS.txt,669502,671139,1637,10,N,Y,1448038803075,18895,19670
RECMUS.txt,669591,671197,1606,10,N,Y,1448038803075,18895,19670
RECMUS.txt,669621,671501,1880,10,N,Y,1448038803075,18895,19670
RECMUS.txt,669958,671556,1598,10,N,Y,1448038803075,18895,19670
RECMUS.txt,670045,671625,1580,10,N,Y,1448038803075,18895,19670
RECMUS.txt,670257,671699,1442,10,N,Y,1448038803075,18895,19670
RECMUS.txt,670399,671809,1410,10,N,Y,1448038803075,18895,19670
RECMUS.txt,670515,672073,1558,10,N,N,-,-1,-1
RECMUS.txt,670705,672131,1426,10,N,N,-,-1,-1
RECMUS.txt,670932,672291,1359,10,N,N,-,-1,-1
RECMUS.txt,671140,672541,1401,10,N,N,-,-1,-1
RECMUS.txt,671198,672648,1450,10,N,N,-,-1,-1
RECMUS.txt,671502,672807,1305,10,N,N,-,-1,-1
RECMUS.txt,671557,673014,1457,10,N,N,-,-1,-1
RECMUS.txt,671626,673074,1448,10,N,N,-,-1,-1
RECMUS.txt,671702,673107,1405,10,N,N,-,-1,-1
RECMUS.txt,671811,673206,1395,10,N,N,-,-1,-1
RECMUS.txt,672074,673390,1316,10,N,N,-,-1,-1
RECMUS.txt,672134,673442,1308,10,N,N,-,-1,-1
RECMUS.txt,672292,673495,1203,10,N,N,-,-1,-1
RECMUS.txt,672542,673519,977,10,N,N,-,-1,-1
RECMUS.txt,672649,673544,895,10,N,N,-,-1,-1
RECMUS.txt,672810,673676,866,10,N,N,-,-1,-1
RECMUS.txt,673015,673811,796,10,N,N,-,-1,-1
RECMUS.txt,673075,673888,813,10,N,N,-,-1,-1
RECMUS.txt,673108,674056,948,10,N,N,-,-1,-1
RECMUS.txt,673207,674171,964,10,N,N,-,-1,-1
RECMUS.txt,673391,674347,956,10,N,N,-,-1,-1
RECMUS.txt,673443,674486,1043,10,N,N,-,-1,-1
RECMUS.txt,673496,674636,1140,10,N,N,-,-1,-1
RECMUS.txt,673520,674700,1180,10,N,N,-,-1,-1
RECMUS.txt,673545,674774,1229,10,N,N,-,-1,-1
RECMUS.txt,673677,674816,1139,10,N,N,-,-1,-1
RECMUS.txt,673812,675026,1214,10,N,N,-,-1,-1
RECMUS.txt,673889,675166,1277,10,N,N,-,-1,-1
RECMUS.txt,674061,675223,1162,10,N,N,-,-1,-1
RECMUS.txt,674172,675307,1135,10,N,N,-,-1,-1
RECMUS.txt,674348,675396,1048,10,N,N,-,-1,-1
RECMUS.txt,674487,675633,1146,10,N,N,-,-1,-1
RECMUS.txt,674637,675746,1109,10,N,N,-,-1,-1
RECMUS.txt,674701,675816,1115,10,N,N,-,-1,-1
RECMUS.txt,674775,676010,1235,10,N,N,-,-1,-1
RECMUS.txt,674817,676091,1274,10,N,N,-,-1,-1
RECMUS.txt,675027,676208,1181,10,N,N,-,-1,-1
RECMUS.txt,675167,676344,1177,10,N,N,-,-1,-1
RECMUS.txt,675223,676401,1178,10,N,N,-,-1,-1
RECMUS.txt,675308,676484,1176,10,N,N,-,-1,-1
RECMUS.txt,675397,676603,1206,10,N,N,-,-1,-1
RECMUS.txt,675636,676819,1183,10,N,N,-,-1,-1
RECMUS.txt,675746,676852,1106,10,N,N,-,-1,-1
RECMUS.txt,675817,676891,1074,10,N,N,-,-1,-1
RECMUS.txt,676013,676912,899,10,N,N,-,-1,-1
RECMUS.txt,676092,677025,933,10,N,N,-,-1,-1
RECMUS.txt,676209,677226,1017,10,N,N,-,-1,-1
RECMUS.txt,676345,677283,938,10,N,N,-,-1,-1
RECMUS.txt,676404,677368,964,10,N,N,-,-1,-1
RECMUS.txt,676485,677567,1082,10,N,N,-,-1,-1
RECMUS.txt,676604,677663,1059,10,N,N,-,-1,-1
RECMUS.txt,676820,677723,903,10,N,N,-,-1,-1
RECMUS.txt,676853,677811,958,10,N,N,-,-1,-1
RECMUS.txt,676892,678012,1120,10,N,N,-,-1,-1
RECMUS.txt,676913,678032,1119,10,N,N,-,-1,-1
RECMUS.txt,677026,678074,1048,10,N,N,-,-1,-1
RECMUS.txt,677227,678255,1028,10,N,N,-,-1,-1
RECMUS.txt,677284,678348,1064,10,N,N,-,-1,-1
RECMUS.txt,677370,678407,1037,10,N,N,-,-1,-1
RECMUS.txt,677568,678484,916,10,N,N,-,-1,-1
RECMUS.txt,677666,678604,938,10,N,N,-,-1,-1
RECMUS.txt,677724,678871,1147,10,N,N,-,-1,-1
RECMUS.txt,677812,678945,1133,10,N,N,-,-1,-1
RECMUS.txt,678014,679046,1032,10,N,N,-,-1,-1
RECMUS.txt,678035,679117,1082,10,N,N,-,-1,-1
RECMUS.txt,678075,679306,1231,10,N,N,-,-1,-1
RECMUS.txt,678256,679392,1136,10,N,N,-,-1,-1
RECMUS.txt,678351,679496,1145,10,N,N,-,-1,-1
RECMUS.txt,678410,679620,1210,10,N,N,-,-1,-1
RECMUS.txt,678485,680070,1585,10,N,N,-,-1,-1
RECMUS.txt,678605,680120,1515,10,N,N,-,-1,-1
RECMUS.txt,678874,680206,1332,10,N,N,-,-1,-1
RECMUS.txt,678946,680330,1384,10,N,Y,1448312844411,173573,174472
RECMUS.txt,679047,680450,1403,10,N,Y,1448312844411,173573,174472
RECMUS.txt,679118,680520,1402,10,N,Y,1448312844411,173573,174472
RECMUS.txt,679307,680652,1345,10,N,Y,1448312844411,173573,174472
RECMUS.txt,679394,680670,1276,10,N,Y,1448312844411,173573,174472
RECMUS.txt,679497,680883,1386,10,N,Y,1448312844411,173573,174472
RECMUS.txt,679621,681120,1499,10,N,Y,1448312844411,173573,174472
RECMUS.txt,680071,681202,1131,10,N,Y,1448312844411,173573,174472
RECMUS.txt,680121,681357,1236,10,N,Y,1448312844411,173573,174472
RECMUS.txt,680209,681489,1280,10,N,Y,1448312844411,173573,174472
RECMUS.txt,680331,681566,1235,10,N,N,-,-1,-1
RECMUS.txt,680451,681738,1287,10,N,N,-,-1,-1
RECMUS.txt,680521,681859,1338,10,N,N,-,-1,-1
RECMUS.txt,680655,681943,1288,10,N,N,-,-1,-1
RECMUS.txt,680671,682067,1396,10,N,N,-,-1,-1
RECMUS.txt,680884,682134,1250,10,N,N,-,-1,-1
RECMUS.txt,681121,682310,1189,10,N,N,-,-1,-1
RECMUS.txt,681203,682487,1284,10,N,N,-,-1,-1
RECMUS.txt,681358,682685,1327,10,N,N,-,-1,-1
RECMUS.txt,681490,682848,1358,10,N,N,-,-1,-1
RECMUS.txt,681569,682963,1394,10,N,N,-,-1,-1
RECMUS.txt,681739,682994,1255,10,N,N,-,-1,-1
RECMUS.txt,681860,683150,1290,10,N,N,-,-1,-1
RECMUS.txt,681944,683297,1353,10,N,N,-,-1,-1
RECMUS.txt,682068,683459,1391,10,N,N,-,-1,-1
RECMUS.txt,682135,683626,1491,10,N,N,-,-1,-1
RECMUS.txt,682311,683781,1470,10,N,N,-,-1,-1
RECMUS.txt,682488,683877,1389,10,N,N,-,-1,-1
RECMUS.txt,682688,684012,1324,10,N,N,-,-1,-1
RECMUS.txt,682849,684126,1277,10,N,N,-,-1,-1
RECMUS.txt,682964,684139,1175,10,N,N,-,-1,-1
RECMUS.txt,682995,684386,1391,10,N,N,-,-1,-1
RECMUS.txt,683151,684552,1401,10,N,N,-,-1,-1
RECMUS.txt,683299,684675,1376,10,N,N,-,-1,-1
RECMUS.txt,683461,684819,1358,10,N,N,-,-1,-1
RECMUS.txt,683627,684995,1368,10,N,N,-,-1,-1
RECMUS.txt,683782,685030,1248,10,N,N,-,-1,-1
RECMUS.txt,683878,685218,1340,10,N,N,-,-1,-1
RECMUS.txt,684013,685304,1291,10,N,Y,1448314861876,180438,180657
RECMUS.txt,684127,685388,1261,10,N,Y,1448314861876,180438,180657
RECMUS.txt,684142,685540,1398,10,N,Y,1448314861876,180438,180657
RECMUS.txt,684387,685606,1219,10,N,Y,1448314861876,180438,180657
RECMUS.txt,684553,685631,1078,10,N,Y,1448314861876,180438,180657
RECMUS.txt,684676,685743,1067,10,N,Y,1448314861876,180438,180657
RECMUS.txt,684820,685898,1078,10,N,Y,1448314861876,180438,180657
RECMUS.txt,684996,686052,1056,10,N,Y,1448314861876,180438,180657
RECMUS.txt,685031,686198,1167,10,N,Y,1448314861876,180438,180657
RECMUS.txt,685219,686424,1205,10,N,Y,1448314861876,180438,180657
RECMUS.txt,685305,686543,1238,10,N,Y,1448314861876,180438,180657
RECMUS.txt,685391,686739,1348,10,N,Y,1448314861876,180438,180657
RECMUS.txt,685541,686980,1439,10,N,Y,1448314861876,180438,180657
RECMUS.txt,685607,687118,1511,10,N,Y,1448314861876,180438,180657
RECMUS.txt,685632,687242,1610,10,N,Y,1448314861876,180438,180657
RECMUS.txt,685745,687342,1597,10,N,Y,1448314861876,180438,180657
RECMUS.txt,685901,687348,1447,10,N,N,-,-1,-1
RECMUS.txt,686053,687478,1425,10,N,N,-,-1,-1
RECMUS.txt,686199,687506,1307,10,N,N,-,-1,-1
RECMUS.txt,686425,687745,1320,10,N,N,-,-1,-1
RECMUS.txt,686544,687764,1220,10,N,N,-,-1,-1
RECMUS.txt,686740,687771,1031,10,N,N,-,-1,-1
RECMUS.txt,686981,688175,1194,10,N,N,-,-1,-1
RECMUS.txt,687121,688319,1198,10,N,N,-,-1,-1
RECMUS.txt,687243,688390,1147,10,Y,N,-,-1,-1
RECMUS.txt,687344,688545,1201,10,N,N,-,-1,-1
RECMUS.txt,687349,688711,1362,10,N,N,-,-1,-1
RECMUS.txt,687479,688879,1400,10,N,N,-,-1,-1
RECMUS.txt,687506,688963,1457,10,N,N,-,-1,-1
RECMUS.txt,687750,688995,1245,10,N,N,-,-1,-1
RECMUS.txt,687766,689084,1318,10,N,N,-,-1,-1
RECMUS.txt,687774,689156,1382,10,N,N,-,-1,-1
RECMUS.txt,688178,689222,1044,10,N,N,-,-1,-1
RECMUS.txt,688320,689299,979,10,N,N,-,-1,-1
RECMUS.txt,688391,689310,919,10,N,N,-,-1,-1
RECMUS.txt,688546,689393,847,10,N,N,-,-1,-1
RECMUS.txt,688712,689404,692,10,N,N,-,-1,-1
RECMUS.txt,688880,689446,566,10,N,N,-,-1,-1
RECMUS.txt,688966,689501,535,10,N,N,-,-1,-1
RECMUS.txt,688998,689597,599,10,N,N,-,-1,-1
RECMUS.txt,689087,689690,603,10,N,N,-,-1,-1
RECMUS.txt,689157,689706,549,10,N,N,-,-1,-1
RECMUS.txt,689223,689843,620,10,N,N,-,-1,-1
RECMUS.txt,689299,689980,681,10,N,N,-,-1,-1
RECMUS.txt,689311,690128,817,10,N,N,-,-1,-1
RECMUS.txt,689396,690238,842,10,N,Y,1448039370049,20775,21297
RECMUS.txt,689405,690297,892,10,N,Y,1448039370049,20775,21297
RECMUS.txt,689447,690313,866,10,N,Y,1448039370049,20775,21297
RECMUS.txt,689504,690440,936,10,N,Y,1448039370049,20775,21297
RECMUS.txt,689598,690493,895,10,N,Y,1448039370049,20775,21297
RECMUS.txt,689693,690525,832,10,N,Y,1448039370049,20775,21297
RECMUS.txt,689707,690541,834,10,N,Y,1448039370049,20775,21297
RECMUS.txt,689846,690595,749,10,N,Y,1448039370049,20775,21297
RECMUS.txt,689981,690708,727,10,N,Y,1448039370049,20775,21297
RECMUS.txt,690130,690816,686,10,N,Y,1448039370049,20775,21297
RECMUS.txt,690239,691406,1167,10,N,Y,1448039370049,20775,21297
RECMUS.txt,690300,691472,1172,10,N,N,-,-1,-1
RECMUS.txt,690314,691659,1345,10,N,N,-,-1,-1
RECMUS.txt,690441,691669,1228,10,N,N,-,-1,-1
RECMUS.txt,690494,691690,1196,10,N,N,-,-1,-1
RECMUS.txt,690528,691948,1420,10,N,N,-,-1,-1
RECMUS.txt,690542,691953,1411,10,N,N,-,-1,-1
RECMUS.txt,690596,692027,1431,10,N,N,-,-1,-1
RECMUS.txt,690709,692186,1477,10,N,N,-,-1,-1
RECMUS.txt,690818,692441,1623,10,N,N,-,-1,-1
RECMUS.txt,691407,692633,1226,10,N,N,-,-1,-1
RECMUS.txt,691473,692874,1401,10,N,N,-,-1,-1
RECMUS.txt,691664,692936,1272,10,N,N,-,-1,-1
RECMUS.txt,691670,692941,1271,10,N,N,-,-1,-1
RECMUS.txt,691691,693140,1449,10,N,N,-,-1,-1
RECMUS.txt,691949,693322,1373,10,N,N,-,-1,-1
RECMUS.txt,691954,693584,1630,10,N,N,-,-1,-1
RECMUS.txt,692028,693771,1743,10,N,N,-,-1,-1
RECMUS.txt,692187,693852,1665,10,N,N,-,-1,-1
RECMUS.txt,692442,694014,1572,10,N,N,-,-1,-1
RECMUS.txt,692635,694143,1508,10,N,N,-,-1,-1
RECMUS.txt,692875,694197,1322,10,N,N,-,-1,-1
RECMUS.txt,692936,694274,1338,10,N,N,-,-1,-1
RECMUS.txt,692942,694520,1578,10,N,N,-,-1,-1
RECMUS.txt,693141,694566,1425,10,N,N,-,-1,-1
RECMUS.txt,693325,694907,1582,10,N,N,-,-1,-1
RECMUS.txt,693584,694913,1329,10,N,N,-,-1,-1
RECMUS.txt,693772,694929,1157,10,N,N,-,-1,-1
RECMUS.txt,693853,695022,1169,10,N,N,-,-1,-1
RECMUS.txt,694017,695220,1203,10,N,N,-,-1,-1
RECMUS.txt,694144,695307,1163,10,N,N,-,-1,-1
RECMUS.txt,694198,695405,1207,10,N,N,-,-1,-1
RECMUS.txt,694275,695430,1155,10,N,N,-,-1,-1
RECMUS.txt,694521,695570,1049,10,N,N,-,-1,-1
RECMUS.txt,694566,695622,1056,10,N,N,-,-1,-1
RECMUS.txt,694908,696193,1285,10,N,N,-,-1,-1
RECMUS.txt,694914,696579,1665,10,N,N,-,-1,-1
RECMUS.txt,694930,696860,1930,10,N,N,-,-1,-1
RECMUS.txt,695023,696877,1854,10,N,N,-,-1,-1
RECMUS.txt,695221,697219,1998,10,N,N,-,-1,-1
RECMUS.txt,695308,697357,2049,10,N,N,-,-1,-1
RECMUS.txt,695406,697537,2131,10,N,N,-,-1,-1
RECMUS.txt,695431,697722,2291,10,N,N,-,-1,-1
RECMUS.txt,695573,697824,2251,10,N,N,-,-1,-1
RECMUS.txt,695623,697917,2294,10,N,N,-,-1,-1
RECMUS.txt,696194,698028,1834,10,N,N,-,-1,-1
RECMUS.txt,696580,698084,1504,10,N,N,-,-1,-1
RECMUS.txt,696861,698133,1272,10,N,N,-,-1,-1
RECMUS.txt,696882,698237,1355,10,N,N,-,-1,-1
RECMUS.txt,697220,698395,1175,10,N,N,-,-1,-1
RECMUS.txt,697358,698538,1180,10,N,N,-,-1,-1
RECMUS.txt,697540,698636,1096,10,N,N,-,-1,-1
RECMUS.txt,697723,698863,1140,10,N,N,-,-1,-1
RECMUS.txt,697825,699074,1249,10,N,N,-,-1,-1
RECMUS.txt,697918,699264,1346,10,N,N,-,-1,-1
RECMUS.txt,698029,699335,1306,10,N,N,-,-1,-1
RECMUS.txt,698085,699450,1365,10,N,N,-,-1,-1
RECMUS.txt,698134,699667,1533,10,N,Y,1448315360596,182069,182233
RECMUS.txt,698238,699763,1525,10,N,Y,1448315360596,182069,182233
RECMUS.txt,698398,699948,1550,10,N,Y,1448315360596,182069,182233
RECMUS.txt,698539,700116,1577,10,Y,Y,1448315360596,182069,182233
RECMUS.txt,698637,700221,1584,10,Y,Y,1448315360596,182069,182233
RECMUS.txt,698864,700322,1458,10,Y,Y,1448315360596,182069,182233
RECMUS.txt,699075,700358,1283,10,Y,Y,1448315360596,182069,182233
RECMUS.txt,699265,700620,1355,10,Y,Y,1448315360596,182069,182233
RECMUS.txt,699336,700909,1573,10,Y,Y,1448315360596,182069,182233
RECMUS.txt,699452,701130,1678,10,Y,Y,1448315360596,182069,182233
RECMUS.txt,699668,701299,1631,10,Y,Y,1448315360596,182069,182233
RECMUS.txt,699766,701392,1626,10,Y,N,-,-1,-1
RECMUS.txt,699948,701674,1726,10,Y,N,-,-1,-1
RECMUS.txt,700118,701765,1647,10,Y,N,-,-1,-1
RECMUS.txt,700222,701886,1664,10,Y,N,-,-1,-1
RECMUS.txt,700323,702016,1693,10,N,N,-,-1,-1
RECMUS.txt,700359,702216,1857,10,Y,N,-,-1,-1
RECMUS.txt,700621,702675,2054,10,N,N,-,-1,-1
RECMUS.txt,700910,702852,1942,10,N,N,-,-1,-1
RECMUS.txt,701133,703126,1993,10,N,N,-,-1,-1
RECMUS.txt,701300,703402,2102,10,N,N,-,-1,-1
RECMUS.txt,701395,703561,2166,10,N,N,-,-1,-1
RECMUS.txt,701675,703689,2014,10,N,N,-,-1,-1
RECMUS.txt,701766,703984,2218,10,Y,N,-,-1,-1
RECMUS.txt,701887,704068,2181,10,N,N,-,-1,-1
RECMUS.txt,702017,704219,2202,10,Y,N,-,-1,-1
RECMUS.txt,702217,704296,2079,10,N,N,-,-1,-1
RECMUS.txt,702676,704440,1764,10,N,N,-,-1,-1
RECMUS.txt,702853,704651,1798,10,N,N,-,-1,-1
RECMUS.txt,703127,704656,1529,10,N,N,-,-1,-1
RECMUS.txt,703404,704674,1270,10,N,N,-,-1,-1
RECMUS.txt,703562,704689,1127,10,N,N,-,-1,-1
RECMUS.txt,703691,704756,1065,10,N,N,-,-1,-1
RECMUS.txt,703985,704892,907,10,N,N,-,-1,-1
RECMUS.txt,704073,704966,893,10,N,N,-,-1,-1
RECMUS.txt,704220,704989,769,10,N,N,-,-1,-1
RECMUS.txt,704298,705006,708,10,N,N,-,-1,-1
RECMUS.txt,704441,705103,662,10,N,N,-,-1,-1
RECMUS.txt,704652,705195,543,10,N,Y,1448274893770,25386,26202
RECMUS.txt,704659,705247,588,10,N,Y,1448274893770,25386,26202
RECMUS.txt,704677,705338,661,10,N,Y,1448274893770,25386,26202
RECMUS.txt,704690,705528,838,10,N,Y,1448274893770,25386,26202
RECMUS.txt,704757,705630,873,10,N,Y,1448274893770,25386,26202
RECMUS.txt,704893,705665,772,10,N,Y,1448274893770,25386,26202
RECMUS.txt,704967,705810,843,10,N,Y,1448274893770,25386,26202
RECMUS.txt,704992,706033,1041,10,N,Y,1448274893770,25386,26202
RECMUS.txt,705007,706062,1055,10,N,Y,1448274893770,25386,26202
RECMUS.txt,705104,706276,1172,10,N,Y,1448274893770,25386,26202
RECMUS.txt,705196,706328,1132,10,N,Y,1448274893770,25386,26202
RECMUS.txt,705248,706341,1093,10,N,N,-,-1,-1
RECMUS.txt,705340,706404,1064,10,N,N,-,-1,-1
RECMUS.txt,705529,706633,1104,10,N,N,-,-1,-1
RECMUS.txt,705632,706705,1073,10,N,N,-,-1,-1
RECMUS.txt,705666,706847,1181,10,N,N,-,-1,-1
RECMUS.txt,705811,706916,1105,10,N,N,-,-1,-1
RECMUS.txt,706034,706941,907,10,N,N,-,-1,-1
RECMUS.txt,706063,706979,916,10,N,N,-,-1,-1
RECMUS.txt,706277,707023,746,10,N,N,-,-1,-1
RECMUS.txt,706329,707074,745,10,N,N,-,-1,-1
RECMUS.txt,706342,707266,924,10,Y,N,-,-1,-1
RECMUS.txt,706405,707347,942,10,Y,N,-,-1,-1
RECMUS.txt,706635,707423,788,10,N,N,-,-1,-1
RECMUS.txt,706706,707464,758,10,N,N,-,-1,-1
RECMUS.txt,706848,707496,648,10,N,N,-,-1,-1
RECMUS.txt,706917,707626,709,10,N,N,-,-1,-1
RECMUS.txt,706942,707827,885,10,N,N,-,-1,-1
RECMUS.txt,706980,707847,867,10,N,N,-,-1,-1
RECMUS.txt,707024,708008,984,10,N,N,-,-1,-1
RECMUS.txt,707075,708286,1211,10,N,N,-,-1,-1
RECMUS.txt,707267,708340,1073,10,N,N,-,-1,-1
RECMUS.txt,707348,708546,1198,10,N,N,-,-1,-1
RECMUS.txt,707424,708569,1145,10,N,N,-,-1,-1
RECMUS.txt,707465,708636,1171,10,N,N,-,-1,-1
RECMUS.txt,707497,708678,1181,10,N,N,-,-1,-1
RECMUS.txt,707627,708969,1342,10,N,N,-,-1,-1
RECMUS.txt,707828,709112,1284,10,N,N,-,-1,-1
RECMUS.txt,707848,709154,1306,10,N,N,-,-1,-1
RECMUS.txt,708009,709307,1298,10,N,N,-,-1,-1
RECMUS.txt,708287,709450,1163,10,N,N,-,-1,-1
RECMUS.txt,708341,709588,1247,10,N,N,-,-1,-1
RECMUS.txt,708547,709787,1240,10,N,N,-,-1,-1
RECMUS.txt,708570,709896,1326,10,N,N,-,-1,-1
RECMUS.txt,708636,710080,1444,10,N,N,-,-1,-1
RECMUS.txt,708679,710376,1697,10,N,N,-,-1,-1
RECMUS.txt,708970,710526,1556,10,N,N,-,-1,-1
RECMUS.txt,709114,710603,1489,10,N,N,-,-1,-1
RECMUS.txt,709155,710828,1673,10,N,N,-,-1,-1
RECMUS.txt,709308,710991,1683,10,N,N,-,-1,-1
RECMUS.txt,709451,711074,1623,10,N,N,-,-1,-1
RECMUS.txt,709589,711146,1557,10,N,N,-,-1,-1
RECMUS.txt,709788,711245,1457,10,N,N,-,-1,-1
RECMUS.txt,709898,711423,1525,10,N,N,-,-1,-1
RECMUS.txt,710081,711897,1816,10,N,N,-,-1,-1
RECMUS.txt,710377,712132,1755,10,N,N,-,-1,-1
RECMUS.txt,710527,712172,1645,10,N,N,-,-1,-1
RECMUS.txt,710604,712273,1669,10,N,N,-,-1,-1
RECMUS.txt,710829,712303,1474,10,N,N,-,-1,-1
RECMUS.txt,710994,712338,1344,10,N,N,-,-1,-1
RECMUS.txt,711079,712507,1428,10,N,N,-,-1,-1
RECMUS.txt,711148,712680,1532,10,N,N,-,-1,-1
RECMUS.txt,711246,712882,1636,10,N,N,-,-1,-1
RECMUS.txt,711424,713038,1614,10,N,N,-,-1,-1
RECMUS.txt,711898,713199,1301,10,N,N,-,-1,-1
RECMUS.txt,712133,713257,1124,10,N,N,-,-1,-1
RECMUS.txt,712173,713433,1260,10,N,N,-,-1,-1
RECMUS.txt,712274,713643,1369,10,N,N,-,-1,-1
RECMUS.txt,712304,713807,1503,10,N,N,-,-1,-1
RECMUS.txt,712341,713959,1618,10,N,N,-,-1,-1
RECMUS.txt,712508,714201,1693,10,N,N,-,-1,-1
RECMUS.txt,712681,714257,1576,10,N,N,-,-1,-1
RECMUS.txt,712883,714307,1424,10,N,N,-,-1,-1
RECMUS.txt,713041,714582,1541,10,N,N,-,-1,-1
RECMUS.txt,713200,714691,1491,10,N,N,-,-1,-1
RECMUS.txt,713262,714825,1563,10,N,N,-,-1,-1
RECMUS.txt,713434,715346,1912,10,N,N,-,-1,-1
RECMUS.txt,713646,715469,1823,10,N,N,-,-1,-1
RECMUS.txt,713808,715489,1681,10,N,N,-,-1,-1
RECMUS.txt,713960,715497,1537,10,N,N,-,-1,-1
RECMUS.txt,714202,715931,1729,10,N,N,-,-1,-1
RECMUS.txt,714258,716190,1932,10,N,N,-,-1,-1
RECMUS.txt,714310,716634,2324,10,N,N,-,-1,-1
RECMUS.txt,714583,716671,2088,10,N,N,-,-1,-1
RECMUS.txt,714692,716851,2159,10,N,N,-,-1,-1
RECMUS.txt,714826,716912,2086,10,N,N,-,-1,-1
RECMUS.txt,715349,717487,2138,10,N,N,-,-1,-1
RECMUS.txt,715474,717498,2024,10,N,N,-,-1,-1
RECMUS.txt,715492,717615,2123,10,N,N,-,-1,-1
RECMUS.txt,715500,717848,2348,10,N,N,-,-1,-1
RECMUS.txt,715934,717928,1994,10,N,N,-,-1,-1
RECMUS.txt,716191,718019,1828,10,N,N,-,-1,-1
RECMUS.txt,716635,718450,1815,10,N,N,-,-1,-1
RECMUS.txt,716672,718576,1904,10,N,N,-,-1,-1
RECMUS.txt,716852,718841,1989,10,N,N,-,-1,-1
RECMUS.txt,716912,718870,1958,10,N,N,-,-1,-1
RECMUS.txt,717488,718936,1448,10,N,N,-,-1,-1
RECMUS.txt,717501,718957,1456,10,N,N,-,-1,-1
RECMUS.txt,717616,719073,1457,10,N,N,-,-1,-1
RECMUS.txt,717850,719235,1385,10,N,N,-,-1,-1
RECMUS.txt,717929,719326,1397,10,N,N,-,-1,-1
RECMUS.txt,718020,719464,1444,10,N,N,-,-1,-1
RECMUS.txt,718451,719506,1055,10,N,N,-,-1,-1
RECMUS.txt,718579,719580,1001,10,N,N,-,-1,-1
RECMUS.txt,718842,719666,824,10,N,N,-,-1,-1
RECMUS.txt,718872,719767,895,10,N,N,-,-1,-1
RECMUS.txt,718937,719847,910,10,N,N,-,-1,-1
RECMUS.txt,718958,719935,977,10,N,N,-,-1,-1
RECMUS.txt,719074,720072,998,10,N,N,-,-1,-1
RECMUS.txt,719236,720266,1030,10,N,N,-,-1,-1
RECMUS.txt,719327,720636,1309,10,N,N,-,-1,-1
RECMUS.txt,719465,720782,1317,10,N,N,-,-1,-1
RECMUS.txt,719507,721235,1728,10,N,N,-,-1,-1
RECMUS.txt,719583,721440,1857,10,N,N,-,-1,-1
RECMUS.txt,719667,721520,1853,10,N,N,-,-1,-1
RECMUS.txt,719768,721690,1922,10,N,N,-,-1,-1
RECMUS.txt,719852,721770,1918,10,N,N,-,-1,-1
RECMUS.txt,719936,721923,1987,10,N,N,-,-1,-1
RECMUS.txt,720075,722019,1944,10,N,N,-,-1,-1
RECMUS.txt,720267,722072,1805,10,N,N,-,-1,-1
RECMUS.txt,720637,722136,1499,10,N,N,-,-1,-1
RECMUS.txt,720784,722216,1432,10,N,N,-,-1,-1
RECMUS.txt,721236,722236,1000,10,N,N,-,-1,-1
RECMUS.txt,721442,722405,963,10,N,N,-,-1,-1
RECMUS.txt,721523,722591,1068,10,N,N,-,-1,-1
RECMUS.txt,721691,722905,1214,10,N,N,-,-1,-1
RECMUS.txt,721771,723147,1376,10,N,N,-,-1,-1
RECMUS.txt,721924,723311,1387,10,N,N,-,-1,-1
RECMUS.txt,722020,723455,1435,10,N,N,-,-1,-1
RECMUS.txt,722073,723651,1578,10,N,N,-,-1,-1
RECMUS.txt,722137,723836,1699,10,N,N,-,-1,-1
RECMUS.txt,722221,724087,1866,10,N,N,-,-1,-1
RECMUS.txt,722237,724136,1899,10,N,N,-,-1,-1
RECMUS.txt,722407,724424,2017,10,N,N,-,-1,-1
RECMUS.txt,722593,724482,1889,10,N,N,-,-1,-1
RECMUS.txt,722908,724735,1827,10,N,N,-,-1,-1
RECMUS.txt,723150,724889,1739,10,N,N,-,-1,-1
RECMUS.txt,723312,724987,1675,10,Y,N,-,-1,-1
RECMUS.txt,723456,725044,1588,10,Y,N,-,-1,-1
RECMUS.txt,723652,725140,1488,10,N,N,-,-1,-1
RECMUS.txt,723837,725322,1485,10,N,N,-,-1,-1
RECMUS.txt,724088,725453,1365,10,N,Y,1448314503640,180207,180355
RECMUS.txt,724137,725713,1576,10,Y,Y,1448314503640,180207,180355
RECMUS.txt,724425,725876,1451,10,Y,Y,1448314503640,180207,180355
RECMUS.txt,724483,726007,1524,10,Y,Y,1448314503640,180207,180355
RECMUS.txt,724736,726178,1442,10,N,Y,1448314503640,180207,180355
RECMUS.txt,724890,726347,1457,10,N,Y,1448314503640,180207,180355
RECMUS.txt,724990,726550,1560,10,N,Y,1448314503640,180207,180355
RECMUS.txt,725046,726864,1818,10,Y,Y,1448314503640,180207,180355
RECMUS.txt,725141,726955,1814,10,Y,Y,1448314503640,180207,180355
RECMUS.txt,725323,727242,1919,10,Y,Y,1448314503640,180207,180355
RECMUS.txt,725454,727361,1907,10,Y,Y,1448314503640,180207,180355
RECMUS.txt,725714,727532,1818,10,Y,Y,1448314503640,180207,180355
RECMUS.txt,725879,727748,1869,10,N,N,-,-1,-1
RECMUS.txt,726008,727960,1952,10,Y,N,-,-1,-1
RECMUS.txt,726181,728077,1896,10,N,N,-,-1,-1
RECMUS.txt,726348,728231,1883,10,N,N,-,-1,-1
RECMUS.txt,726551,728719,2168,10,N,N,-,-1,-1
RECMUS.txt,726867,728853,1986,10,N,N,-,-1,-1
RECMUS.txt,726958,729054,2096,10,N,N,-,-1,-1
RECMUS.txt,727243,729092,1849,10,N,N,-,-1,-1
RECMUS.txt,727363,729183,1820,10,N,N,-,-1,-1
RECMUS.txt,727533,729327,1794,10,N,N,-,-1,-1
RECMUS.txt,727749,729407,1658,10,N,N,-,-1,-1
RECMUS.txt,727963,729597,1634,10,N,N,-,-1,-1
RECMUS.txt,728079,729866,1787,10,N,N,-,-1,-1
RECMUS.txt,728232,729976,1744,10,N,Y,1448322514970,220165,221397
RECMUS.txt,728722,730064,1342,10,N,Y,1448322514970,220165,221397
RECMUS.txt,728854,730188,1334,10,N,Y,1448322514970,220165,221397
RECMUS.txt,729055,730317,1262,10,Y,Y,1448322514970,220165,221397
RECMUS.txt,729093,730504,1411,10,Y,Y,1448322514970,220165,221397
RECMUS.txt,729184,730583,1399,10,Y,Y,1448322514970,220165,221397
RECMUS.txt,729328,730627,1299,10,Y,Y,1448322514970,220165,221397
RECMUS.txt,729408,730661,1253,10,Y,Y,1448322514970,220165,221397
RECMUS.txt,729600,730698,1098,10,Y,Y,1448322514970,220165,221397
RECMUS.txt,729867,730765,898,10,N,Y,1448322514970,220165,221397
RECMUS.txt,729977,730804,827,10,N,Y,1448322514970,220165,221397
RECMUS.txt,730066,730811,745,10,N,Y,1448322514970,220165,221397
RECMUS.txt,730189,730841,652,10,N,N,-,-1,-1
RECMUS.txt,730318,730872,554,10,N,N,-,-1,-1
RECMUS.txt,730507,730893,386,10,N,N,-,-1,-1
RECMUS.txt,730586,730938,352,10,N,N,-,-1,-1
RECMUS.txt,730630,731092,462,10,N,N,-,-1,-1
RECMUS.txt,730664,731141,477,10,N,N,-,-1,-1
RECMUS.txt,730701,731236,535,10,N,N,-,-1,-1
RECMUS.txt,730768,731346,578,10,N,N,-,-1,-1
RECMUS.txt,730807,731391,584,10,N,N,-,-1,-1
RECMUS.txt,730811,731708,897,10,N,N,-,-1,-1
RECMUS.txt,730844,731923,1079,10,N,N,-,-1,-1
RECMUS.txt,730875,732086,1211,10,N,N,-,-1,-1
RECMUS.txt,730896,732278,1382,10,N,N,-,-1,-1
RECMUS.txt,730939,732500,1561,10,N,N,-,-1,-1
RECMUS.txt,731097,732659,1562,10,N,N,-,-1,-1
RECMUS.txt,731142,732853,1711,10,N,N,-,-1,-1
RECMUS.txt,731237,732868,1631,10,N,N,-,-1,-1
RECMUS.txt,731347,733143,1796,10,N,N,-,-1,-1
RECMUS.txt,731392,733305,1913,10,N,N,-,-1,-1
RECMUS.txt,731709,733463,1754,10,N,Y,1437471397525,350644,351290
RECMUS.txt,731925,733541,1616,10,N,Y,1437471397525,350644,351290
RECMUS.txt,732087,733692,1605,10,N,Y,1437471397525,350644,351290
RECMUS.txt,732280,733798,1518,10,N,Y,1437471397525,350644,351290
RECMUS.txt,732501,733915,1414,10,N,Y,1437471397525,350644,351290
RECMUS.txt,732660,734147,1487,10,N,Y,1437471397525,350644,351290
RECMUS.txt,732854,734396,1542,10,N,Y,1437471397525,350644,351290
RECMUS.txt,732869,734409,1540,10,N,Y,1437471397525,350644,351290
RECMUS.txt,733145,734457,1312,10,N,Y,1437471397525,350644,351290
RECMUS.txt,733306,734528,1222,10,N,Y,1437471397525,350644,351290
RECMUS.txt,733464,734675,1211,10,N,Y,1437471397525,350644,351290
RECMUS.txt,733544,734754,1210,10,N,N,-,-1,-1
RECMUS.txt,733693,734805,1112,10,N,N,-,-1,-1
RECMUS.txt,733799,734897,1098,10,N,N,-,-1,-1
RECMUS.txt,733918,735046,1128,10,N,N,-,-1,-1
RECMUS.txt,734149,735228,1079,10,N,N,-,-1,-1
RECMUS.txt,734396,735382,986,10,N,N,-,-1,-1
RECMUS.txt,734410,735487,1077,10,N,N,-,-1,-1
RECMUS.txt,734458,735622,1164,10,N,N,-,-1,-1
RECMUS.txt,734529,735643,1114,10,N,N,-,-1,-1
RECMUS.txt,734677,735776,1099,10,N,N,-,-1,-1
RECMUS.txt,734755,735810,1055,10,N,N,-,-1,-1
RECMUS.txt,734806,735952,1146,10,N,N,-,-1,-1
RECMUS.txt,734898,736326,1428,10,N,N,-,-1,-1
RECMUS.txt,735047,736344,1297,10,N,N,-,-1,-1
RECMUS.txt,735229,736365,1136,10,N,N,-,-1,-1
RECMUS.txt,735384,736403,1019,10,N,Y,1448279941918,72406,72905
RECMUS.txt,735488,736487,999,10,N,Y,1448279941918,72406,72905
RECMUS.txt,735623,736539,916,10,N,Y,1448279941918,72406,72905
RECMUS.txt,735644,736553,909,10,N,Y,1448279941918,72406,72905
RECMUS.txt,735781,736835,1054,10,N,Y,1448279941918,72406,72905
RECMUS.txt,735811,737034,1223,10,N,Y,1448279941918,72406,72905
RECMUS.txt,735955,737295,1340,10,N,Y,1448279941918,72406,72905
RECMUS.txt,736329,737441,1112,10,N,Y,1448279941918,72406,72905
RECMUS.txt,736345,737615,1270,10,N,Y,1448279941918,72406,72905
RECMUS.txt,736366,737633,1267,10,N,Y,1448279941918,72406,72905
RECMUS.txt,736404,737640,1236,10,N,Y,1448279941918,72406,72905
RECMUS.txt,736489,738040,1551,10,N,Y,1448279941918,72406,72905
RECMUS.txt,736540,738190,1650,10,N,N,-,-1,-1
RECMUS.txt,736554,738266,1712,10,N,N,-,-1,-1
RECMUS.txt,736836,738542,1706,10,N,N,-,-1,-1
RECMUS.txt,737037,738631,1594,10,N,N,-,-1,-1
RECMUS.txt,737296,738743,1447,10,N,N,-,-1,-1
RECMUS.txt,737443,738927,1484,10,N,N,-,-1,-1
RECMUS.txt,737620,738986,1366,10,N,N,-,-1,-1
RECMUS.txt,737635,739076,1441,10,N,N,-,-1,-1
RECMUS.txt,737643,739396,1753,10,N,N,-,-1,-1
RECMUS.txt,738043,739546,1503,10,N,N,-,-1,-1
RECMUS.txt,738191,739665,1474,10,N,N,-,-1,-1
RECMUS.txt,738267,739802,1535,10,N,N,-,-1,-1
RECMUS.txt,738543,740030,1487,10,N,N,-,-1,-1
RECMUS.txt,738632,740132,1500,10,N,N,-,-1,-1
RECMUS.txt,738744,740223,1479,10,N,N,-,-1,-1
RECMUS.txt,738928,740432,1504,10,N,N,-,-1,-1
RECMUS.txt,738989,740470,1481,10,N,N,-,-1,-1
RECMUS.txt,739077,740637,1560,10,N,N,-,-1,-1
RECMUS.txt,739397,740783,1386,10,Y,N,-,-1,-1
RECMUS.txt,739551,740854,1303,10,Y,N,-,-1,-1
RECMUS.txt,739667,741105,1438,10,N,N,-,-1,-1
RECMUS.txt,739803,741296,1493,10,Y,N,-,-1,-1
RECMUS.txt,740031,741561,1530,10,Y,N,-,-1,-1
RECMUS.txt,740133,741694,1561,10,Y,N,-,-1,-1
RECMUS.txt,740224,741695,1471,10,Y,N,-,-1,-1
RECMUS.txt,740434,741875,1441,10,Y,N,-,-1,-1
RECMUS.txt,740471,742115,1644,10,N,N,-,-1,-1
RECMUS.txt,740638,742233,1595,10,N,N,-,-1,-1
RECMUS.txt,740784,742338,1554,10,N,N,-,-1,-1
RECMUS.txt,740855,742458,1603,10,N,N,-,-1,-1
RECMUS.txt,741108,742609,1501,10,N,N,-,-1,-1
RECMUS.txt,741297,742680,1383,10,N,Y,1448311594480,155711,156312
RECMUS.txt,741562,742822,1260,10,N,Y,1448311594480,155711,156312
RECMUS.txt,741694,742870,1176,10,N,Y,1448311594480,155711,156312
RECMUS.txt,741696,743320,1624,10,N,Y,1448311594480,155711,156312
RECMUS.txt,741880,743472,1592,10,N,Y,1448311594480,155711,156312
RECMUS.txt,742116,743631,1515,10,N,Y,1448311594480,155711,156312
RECMUS.txt,742234,743839,1605,10,Y,Y,1448311594480,155711,156312
RECMUS.txt,742339,743857,1518,10,Y,Y,1448311594480,155711,156312
RECMUS.txt,742459,743897,1438,10,Y,Y,1448311594480,155711,156312
RECMUS.txt,742610,744125,1515,10,N,Y,1448311594480,155711,156312
RECMUS.txt,742681,744285,1604,10,N,Y,1448311594480,155711,156312
RECMUS.txt,742823,744525,1702,10,N,Y,1448311594480,155711,156312
RECMUS.txt,742871,744834,1963,10,N,Y,1448311594480,155711,156312
RECMUS.txt,743321,745051,1730,10,Y,Y,1448279089520,67624,69991
RECMUS.txt,743474,745214,1740,10,Y,Y,1448279089520,67624,69991
RECMUS.txt,743632,745332,1700,10,Y,Y,1448279089520,67624,69991
RECMUS.txt,743840,745507,1667,10,Y,Y,1448279089520,67624,69991
RECMUS.txt,743858,745683,1825,10,Y,Y,1448279089520,67624,69991
RECMUS.txt,743900,745721,1821,10,Y,Y,1448279089520,67624,69991
RECMUS.txt,744127,745730,1603,10,Y,Y,1448279089520,67624,69991
RECMUS.txt,744290,745821,1531,10,Y,Y,1448279089520,67624,69991
RECMUS.txt,744526,745838,1312,10,N,Y,1448279089520,67624,69991
RECMUS.txt,744837,745919,1082,10,N,Y,1448279089520,67624,69991
RECMUS.txt,745052,745930,878,10,N,N,-,-1,-1
RECMUS.txt,745215,746009,794,10,N,N,-,-1,-1
RECMUS.txt,745333,746272,939,10,N,N,-,-1,-1
RECMUS.txt,745508,746494,986,10,N,N,-,-1,-1
RECMUS.txt,745684,746600,916,10,N,N,-,-1,-1
RECMUS.txt,745722,746790,1068,10,N,N,-,-1,-1
RECMUS.txt,745732,747041,1309,10,N,N,-,-1,-1
RECMUS.txt,745822,747147,1325,10,N,N,-,-1,-1
RECMUS.txt,745839,747222,1383,10,N,N,-,-1,-1
RECMUS.txt,745920,747286,1366,10,Y,N,-,-1,-1
RECMUS.txt,745931,747506,1575,10,Y,N,-,-1,-1
RECMUS.txt,746010,747760,1750,10,Y,N,-,-1,-1
RECMUS.txt,746273,747974,1701,10,Y,N,-,-1,-1
RECMUS.txt,746495,748089,1594,10,Y,N,-,-1,-1
RECMUS.txt,746605,748156,1551,10,Y,N,-,-1,-1
RECMUS.txt,746792,748285,1493,10,Y,N,-,-1,-1
RECMUS.txt,747044,748472,1428,10,Y,N,-,-1,-1
RECMUS.txt,747148,748541,1393,10,N,N,-,-1,-1
RECMUS.txt,747223,748680,1457,10,N,N,-,-1,-1
RECMUS.txt,747287,748928,1641,10,Y,N,-,-1,-1
RECMUS.txt,747507,748947,1440,10,N,N,-,-1,-1
RECMUS.txt,747763,749038,1275,10,N,N,-,-1,-1
RECMUS.txt,747975,749203,1228,10,N,N,-,-1,-1
RECMUS.txt,748090,749330,1240,10,N,N,-,-1,-1
RECMUS.txt,748157,749545,1388,10,N,N,-,-1,-1
RECMUS.txt,748286,749579,1293,10,N,Y,1448287490368,120754,123385
RECMUS.txt,748475,749668,1193,10,N,Y,1448287490368,120754,123385
RECMUS.txt,748542,749909,1367,10,N,Y,1448287490368,120754,123385
RECMUS.txt,748681,749961,1280,10,N,Y,1448287490368,120754,123385
RECMUS.txt,748933,750051,1118,10,N,Y,1448287490368,120754,123385
RECMUS.txt,748948,750208,1260,10,N,Y,1448287490368,120754,123385
RECMUS.txt,749039,750305,1266,10,N,Y,1448287490368,120754,123385
RECMUS.txt,749204,750569,1365,10,N,Y,1448287490368,120754,123385
RECMUS.txt,749331,750625,1294,10,N,Y,1448287490368,120754,123385
RECMUS.txt,749545,750765,1220,10,N,Y,1448287490368,120754,123385
RECMUS.txt,749580,750905,1325,10,N,Y,1448287490368,120754,123385
RECMUS.txt,749669,751325,1656,10,N,Y,1448287490368,120754,123385
RECMUS.txt,749910,751332,1422,10,N,Y,1448287490368,120754,123385
RECMUS.txt,749962,751433,1471,10,N,Y,1448287490368,120754,123385
RECMUS.txt,750052,751646,1594,10,N,N,-,-1,-1
RECMUS.txt,750209,751904,1695,10,N,N,-,-1,-1
RECMUS.txt,750307,752027,1720,10,N,N,-,-1,-1
RECMUS.txt,750570,752122,1552,10,N,N,-,-1,-1
RECMUS.txt,750626,752124,1498,10,N,N,-,-1,-1
RECMUS.txt,750766,752170,1404,10,N,N,-,-1,-1
RECMUS.txt,750908,752174,1266,10,N,N,-,-1,-1
RECMUS.txt,751330,752387,1057,10,N,N,-,-1,-1
RECMUS.txt,751332,752493,1161,10,N,N,-,-1,-1
RECMUS.txt,751434,752684,1250,10,N,N,-,-1,-1
RECMUS.txt,751647,752771,1124,10,N,N,-,-1,-1
RECMUS.txt,751909,752784,875,10,N,N,-,-1,-1
RECMUS.txt,752028,752986,958,10,N,N,-,-1,-1
RECMUS.txt,752123,753126,1003,10,N,N,-,-1,-1
RECMUS.txt,752125,753227,1102,10,N,N,-,-1,-1
RECMUS.txt,752171,753327,1156,10,N,N,-,-1,-1
RECMUS.txt,752177,753329,1152,10,N,N,-,-1,-1
RECMUS.txt,752388,753452,1064,10,N,N,-,-1,-1
RECMUS.txt,752494,753789,1295,10,N,N,-,-1,-1
RECMUS.txt,752685,754128,1443,10,N,N,-,-1,-1
RECMUS.txt,752772,754252,1480,10,N,N,-,-1,-1
RECMUS.txt,752785,754337,1552,10,N,N,-,-1,-1
RECMUS.txt,752987,754575,1588,10,N,N,-,-1,-1
RECMUS.txt,753129,754682,1553,10,N,N,-,-1,-1
RECMUS.txt,753232,754987,1755,10,N,N,-,-1,-1
RECMUS.txt,753328,755063,1735,10,N,N,-,-1,-1
RECMUS.txt,753330,755147,1817,10,N,N,-,-1,-1
RECMUS.txt,753455,755476,2021,10,N,N,-,-1,-1
RECMUS.txt,753790,755491,1701,10,N,N,-,-1,-1
RECMUS.txt,754129,755561,1432,10,N,N,-,-1,-1
RECMUS.txt,754255,755626,1371,10,N,N,-,-1,-1
RECMUS.txt,754338,755648,1310,10,N,N,-,-1,-1
RECMUS.txt,754576,755769,1193,10,N,N,-,-1,-1
RECMUS.txt,754683,755841,1158,10,N,N,-,-1,-1
RECMUS.txt,754988,755864,876,10,N,N,-,-1,-1
RECMUS.txt,755064,755905,841,10,N,N,-,-1,-1
RECMUS.txt,755148,755989,841,10,N,N,-,-1,-1
RECMUS.txt,755477,756155,678,10,N,N,-,-1,-1
RECMUS.txt,755492,756187,695,10,N,N,-,-1,-1
RECMUS.txt,755562,756462,900,10,N,N,-,-1,-1
RECMUS.txt,755627,756475,848,10,N,N,-,-1,-1
RECMUS.txt,755649,756563,914,10,N,N,-,-1,-1
RECMUS.txt,755770,756820,1050,10,N,N,-,-1,-1
RECMUS.txt,755842,756924,1082,10,N,N,-,-1,-1
RECMUS.txt,755865,756937,1072,10,N,N,-,-1,-1
RECMUS.txt,755906,757120,1214,10,N,N,-,-1,-1
RECMUS.txt,755990,757133,1143,10,N,N,-,-1,-1
RECMUS.txt,756158,757169,1011,10,N,N,-,-1,-1
RECMUS.txt,756188,757345,1157,10,N,N,-,-1,-1
RECMUS.txt,756463,757371,908,10,N,N,-,-1,-1
RECMUS.txt,756476,757376,900,10,N,N,-,-1,-1
RECMUS.txt,756564,757428,864,10,N,N,-,-1,-1
RECMUS.txt,756821,757512,691,10,N,N,-,-1,-1
RECMUS.txt,756925,757599,674,10,N,N,-,-1,-1
RECMUS.txt,756938,757745,807,10,N,N,-,-1,-1
RECMUS.txt,757121,757847,726,10,N,N,-,-1,-1
RECMUS.txt,757134,757878,744,10,N,N,-,-1,-1
RECMUS.txt,757171,757918,747,10,N,N,-,-1,-1
RECMUS.txt,757346,758148,802,10,N,N,-,-1,-1
RECMUS.txt,757372,758312,940,10,N,N,-,-1,-1
RECMUS.txt,757377,758367,990,10,N,N,-,-1,-1
RECMUS.txt,757429,758552,1123,10,N,N,-,-1,-1
RECMUS.txt,757514,758719,1205,10,N,N,-,-1,-1
RECMUS.txt,757600,758842,1242,10,N,N,-,-1,-1
RECMUS.txt,757746,758973,1227,10,N,N,-,-1,-1
RECMUS.txt,757848,759015,1167,10,N,N,-,-1,-1
RECMUS.txt,757879,759256,1377,10,N,N,-,-1,-1
RECMUS.txt,757921,759590,1669,10,N,N,-,-1,-1
RECMUS.txt,758150,759679,1529,10,N,N,-,-1,-1
RECMUS.txt,758313,759757,1444,10,N,N,-,-1,-1
RECMUS.txt,758368,759816,1448,10,N,N,-,-1,-1
RECMUS.txt,758554,759985,1431,10,N,N,-,-1,-1
RECMUS.txt,758720,760170,1450,10,N,N,-,-1,-1
RECMUS.txt,758843,760270,1427,10,N,N,-,-1,-1
RECMUS.txt,758973,760627,1654,10,N,N,-,-1,-1
RECMUS.txt,759016,760774,1758,10,N,N,-,-1,-1
RECMUS.txt,759259,760795,1536,10,N,N,-,-1,-1
RECMUS.txt,759591,760995,1404,10,N,N,-,-1,-1
RECMUS.txt,759680,761133,1453,10,N,N,-,-1,-1
RECMUS.txt,759760,761445,1685,10,Y,N,-,-1,-1
RECMUS.txt,759817,761594,1777,10,Y,N,-,-1,-1
RECMUS.txt,759986,761746,1760,10,Y,N,-,-1,-1
RECMUS.txt,760173,761842,1669,10,N,N,-,-1,-1
RECMUS.txt,760275,761977,1702,10,N,N,-,-1,-1
RECMUS.txt,760628,762070,1442,10,N,N,-,-1,-1
RECMUS.txt,760775,762304,1529,10,N,N,-,-1,-1
RECMUS.txt,760796,762431,1635,10,N,N,-,-1,-1
RECMUS.txt,760995,762643,1648,10,N,N,-,-1,-1
RECMUS.txt,761134,762766,1632,10,N,N,-,-1,-1
RECMUS.txt,761446,762945,1499,10,N,N,-,-1,-1
RECMUS.txt,761595,763101,1506,10,N,N,-,-1,-1
RECMUS.txt,761747,763250,1503,10,N,N,-,-1,-1
RECMUS.txt,761843,763458,1615,10,N,Y,1437470299748,152207,152889
RECMUS.txt,761978,763570,1592,10,N,Y,1437470299748,152207,152889
RECMUS.txt,762071,763664,1593,10,N,Y,1437470299748,152207,152889
RECMUS.txt,762305,763847,1542,10,N,Y,1437470299748,152207,152889
RECMUS.txt,762432,764102,1670,10,N,Y,1437470299748,152207,152889
RECMUS.txt,762644,764212,1568,10,N,Y,1437470299748,152207,152889
RECMUS.txt,762771,764260,1489,10,N,Y,1437470299748,152207,152889
RECMUS.txt,762947,764308,1361,10,N,Y,1437470299748,152207,152889
RECMUS.txt,763104,764441,1337,10,N,Y,1437470299748,152207,152889
RECMUS.txt,763251,764476,1225,10,N,Y,1437470299748,152207,152889
RECMUS.txt,763459,764567,1108,10,N,Y,1437470299748,152207,152889
RECMUS.txt,763571,764628,1057,10,N,Y,1437470299748,152207,152889
RECMUS.txt,763667,764661,994,10,N,N,-,-1,-1
RECMUS.txt,763848,764775,927,10,N,N,-,-1,-1
RECMUS.txt,764103,764784,681,10,N,N,-,-1,-1
RECMUS.txt,764213,764812,599,10,N,N,-,-1,-1
RECMUS.txt,764261,764967,706,10,N,N,-,-1,-1
RECMUS.txt,764310,765109,799,10,N,N,-,-1,-1
RECMUS.txt,764442,765217,775,10,N,N,-,-1,-1
RECMUS.txt,764476,765363,887,10,N,N,-,-1,-1
RECMUS.txt,764570,765420,850,10,N,N,-,-1,-1
RECMUS.txt,764629,765561,932,10,N,N,-,-1,-1
RECMUS.txt,764662,765566,904,10,N,N,-,-1,-1
RECMUS.txt,764776,765702,926,10,N,N,-,-1,-1
RECMUS.txt,764786,765704,918,10,N,N,-,-1,-1
RECMUS.txt,764813,765706,893,10,N,N,-,-1,-1
RECMUS.txt,764968,765715,747,10,N,N,-,-1,-1
RECMUS.txt,765114,765746,632,10,N,N,-,-1,-1
RECMUS.txt,765218,765861,643,10,N,N,-,-1,-1
RECMUS.txt,765365,765973,608,10,N,N,-,-1,-1
RECMUS.txt,765422,766125,703,10,N,N,-,-1,-1
RECMUS.txt,765562,766211,649,10,N,N,-,-1,-1
RECMUS.txt,765567,766223,656,10,N,N,-,-1,-1
RECMUS.txt,765703,766391,688,10,N,N,-,-1,-1
RECMUS.txt,765705,766524,819,10,N,N,-,-1,-1
RECMUS.txt,765709,766713,1004,10,N,N,-,-1,-1
RECMUS.txt,765716,766765,1049,10,N,N,-,-1,-1
RECMUS.txt,765747,766850,1103,10,N,N,-,-1,-1
RECMUS.txt,765862,766910,1048,10,N,N,-,-1,-1
RECMUS.txt,765974,767049,1075,10,N,N,-,-1,-1
RECMUS.txt,766126,767226,1100,10,N,N,-,-1,-1
RECMUS.txt,766214,767379,1165,10,N,N,-,-1,-1
RECMUS.txt,766224,767564,1340,10,N,N,-,-1,-1
RECMUS.txt,766393,767686,1293,10,N,N,-,-1,-1
RECMUS.txt,766525,767827,1302,10,N,N,-,-1,-1
RECMUS.txt,766714,767891,1177,10,N,N,-,-1,-1
RECMUS.txt,766766,767951,1185,10,N,N,-,-1,-1
RECMUS.txt,766851,768138,1287,10,N,N,-,-1,-1
RECMUS.txt,766911,768252,1341,10,N,N,-,-1,-1
RECMUS.txt,767050,768476,1426,10,N,N,-,-1,-1
RECMUS.txt,767228,768613,1385,10,N,N,-,-1,-1
RECMUS.txt,767380,768666,1286,10,N,N,-,-1,-1
RECMUS.txt,767567,768837,1270,10,N,N,-,-1,-1
RECMUS.txt,767692,768955,1263,10,N,N,-,-1,-1
RECMUS.txt,767827,769212,1385,10,N,N,-,-1,-1
RECMUS.txt,767892,769384,1492,10,N,N,-,-1,-1
RECMUS.txt,767952,769485,1533,10,N,N,-,-1,-1
RECMUS.txt,768139,769587,1448,10,N,N,-,-1,-1
RECMUS.txt,768253,769778,1525,10,N,N,-,-1,-1
RECMUS.txt,768479,769959,1480,10,N,N,-,-1,-1
RECMUS.txt,768614,770093,1479,10,N,N,-,-1,-1
RECMUS.txt,768667,770420,1753,10,N,N,-,-1,-1
RECMUS.txt,768838,770595,1757,10,N,N,-,-1,-1
RECMUS.txt,768958,770687,1729,10,N,N,-,-1,-1
RECMUS.txt,769213,770875,1662,10,N,N,-,-1,-1
RECMUS.txt,769385,771042,1657,10,N,N,-,-1,-1
RECMUS.txt,769490,771129,1639,10,N,N,-,-1,-1
RECMUS.txt,769588,771371,1783,10,Y,N,-,-1,-1
RECMUS.txt,769779,771493,1714,10,N,N,-,-1,-1
RECMUS.txt,769961,771638,1677,10,N,N,-,-1,-1
RECMUS.txt,770094,771664,1570,10,N,N,-,-1,-1
RECMUS.txt,770422,771703,1281,10,N,N,-,-1,-1
RECMUS.txt,770597,771799,1202,10,N,N,-,-1,-1
RECMUS.txt,770688,772265,1577,10,N,N,-,-1,-1
RECMUS.txt,770876,772296,1420,10,N,N,-,-1,-1
RECMUS.txt,771043,772529,1486,10,N,N,-,-1,-1
RECMUS.txt,771132,772618,1486,10,N,N,-,-1,-1
RECMUS.txt,771373,772973,1600,10,N,N,-,-1,-1
RECMUS.txt,771494,773118,1624,10,N,N,-,-1,-1
RECMUS.txt,771639,773223,1584,10,N,N,-,-1,-1
RECMUS.txt,771667,773335,1668,10,N,N,-,-1,-1
RECMUS.txt,771706,773666,1960,10,N,N,-,-1,-1
RECMUS.txt,771804,773711,1907,10,N,N,-,-1,-1
RECMUS.txt,772266,773801,1535,10,N,N,-,-1,-1
RECMUS.txt,772299,773818,1519,10,N,N,-,-1,-1
RECMUS.txt,772530,773831,1301,10,N,N,-,-1,-1
RECMUS.txt,772619,774262,1643,10,N,N,-,-1,-1
RECMUS.txt,772976,774411,1435,10,N,N,-,-1,-1
RECMUS.txt,773119,774558,1439,10,N,N,-,-1,-1
RECMUS.txt,773224,774634,1410,10,N,N,-,-1,-1
RECMUS.txt,773336,774827,1491,10,N,N,-,-1,-1
RECMUS.txt,773667,775102,1435,10,N,N,-,-1,-1
RECMUS.txt,773712,775198,1486,10,N,Y,1448313482895,176553,176862
RECMUS.txt,773806,775493,1687,10,N,Y,1448313482895,176553,176862
RECMUS.txt,773820,775578,1758,10,N,Y,1448313482895,176553,176862
RECMUS.txt,773834,775656,1822,10,N,Y,1448313482895,176553,176862
RECMUS.txt,774265,775778,1513,10,N,Y,1448313482895,176553,176862
RECMUS.txt,774412,775833,1421,10,N,Y,1448313482895,176553,176862
RECMUS.txt,774559,776070,1511,10,N,Y,1448313482895,176553,176862
RECMUS.txt,774635,776293,1658,10,N,Y,1448313482895,176553,176862
RECMUS.txt,774828,776512,1684,10,Y,Y,1448313482895,176553,176862
RECMUS.txt,775102,776575,1473,10,Y,Y,1448313482895,176553,176862
RECMUS.txt,775200,776746,1546,10,Y,Y,1448313482895,176553,176862
RECMUS.txt,775494,776909,1415,10,N,N,-,-1,-1
RECMUS.txt,775579,777067,1488,10,Y,N,-,-1,-1
RECMUS.txt,775657,777173,1516,10,N,N,-,-1,-1
RECMUS.txt,775779,777188,1409,10,N,N,-,-1,-1
RECMUS.txt,775838,777346,1508,10,N,N,-,-1,-1
RECMUS.txt,776072,777596,1524,10,N,N,-,-1,-1
RECMUS.txt,776294,777633,1339,10,N,N,-,-1,-1
RECMUS.txt,776513,777923,1410,10,N,N,-,-1,-1
RECMUS.txt,776576,777947,1371,10,N,N,-,-1,-1
RECMUS.txt,776749,777989,1240,10,N,N,-,-1,-1
RECMUS.txt,776910,778162,1252,10,N,N,-,-1,-1
RECMUS.txt,777068,778219,1151,10,N,N,-,-1,-1
RECMUS.txt,777174,778226,1052,10,N,N,-,-1,-1
RECMUS.txt,777191,778335,1144,10,N,N,-,-1,-1
RECMUS.txt,777347,778564,1217,10,N,N,-,-1,-1
RECMUS.txt,777599,778570,971,10,N,N,-,-1,-1
RECMUS.txt,777634,778620,986,10,N,N,-,-1,-1
RECMUS.txt,777924,778749,825,10,N,N,-,-1,-1
RECMUS.txt,777948,778827,879,10,N,N,-,-1,-1
RECMUS.txt,777990,778864,874,10,N,N,-,-1,-1
RECMUS.txt,778167,779028,861,10,N,N,-,-1,-1
RECMUS.txt,778219,779091,872,10,N,N,-,-1,-1
RECMUS.txt,778227,779448,1221,10,N,N,-,-1,-1
RECMUS.txt,778336,779585,1249,10,N,N,-,-1,-1
RECMUS.txt,778565,779924,1359,10,N,N,-,-1,-1
RECMUS.txt,778571,780229,1658,10,N,N,-,-1,-1
RECMUS.txt,778621,780364,1743,10,N,N,-,-1,-1
RECMUS.txt,778750,780626,1876,10,N,N,-,-1,-1
RECMUS.txt,778828,780650,1822,10,N,N,-,-1,-1
RECMUS.txt,778865,780903,2038,10,N,N,-,-1,-1
RECMUS.txt,779029,781008,1979,10,N,N,-,-1,-1
RECMUS.txt,779092,781052,1960,10,N,N,-,-1,-1
RECMUS.txt,779449,781273,1824,10,N,N,-,-1,-1
RECMUS.txt,779586,781464,1878,10,N,N,-,-1,-1
RECMUS.txt,779925,781707,1782,10,N,N,-,-1,-1
RECMUS.txt,780232,781714,1482,10,N,N,-,-1,-1
RECMUS.txt,780365,781873,1508,10,N,N,-,-1,-1
RECMUS.txt,780631,781890,1259,10,N,N,-,-1,-1
RECMUS.txt,780651,782052,1401,10,N,N,-,-1,-1
RECMUS.txt,780904,782183,1279,10,N,N,-,-1,-1
RECMUS.txt,781009,782386,1377,10,N,N,-,-1,-1
RECMUS.txt,781055,782582,1527,10,Y,Y,1448277167610,40886,47737
RECMUS.txt,781274,782871,1597,10,N,Y,1448277167610,40886,47737
RECMUS.txt,781466,782993,1527,10,N,Y,1448277167610,40886,47737
RECMUS.txt,781709,783037,1328,10,N,Y,1448277167610,40886,47737
RECMUS.txt,781714,783135,1421,10,N,Y,1448277167610,40886,47737
RECMUS.txt,781876,783334,1458,10,N,Y,1448277167610,40886,47737
RECMUS.txt,781891,783714,1823,10,N,Y,1448277167610,40886,47737
RECMUS.txt,782053,783829,1776,10,N,Y,1448277167610,40886,47737
RECMUS.txt,782184,783915,1731,10,N,Y,1448277167610,40886,47737
RECMUS.txt,782389,784023,1634,10,N,Y,1448277167610,40886,47737
RECMUS.txt,782583,784162,1579,10,N,N,-,-1,-1
RECMUS.txt,782872,784314,1442,10,N,N,-,-1,-1
RECMUS.txt,782998,784405,1407,10,N,N,-,-1,-1
RECMUS.txt,783038,784599,1561,10,N,N,-,-1,-1
RECMUS.txt,783138,784758,1620,10,N,N,-,-1,-1
RECMUS.txt,783335,784848,1513,10,N,N,-,-1,-1
RECMUS.txt,783717,784921,1204,10,N,N,-,-1,-1
RECMUS.txt,783831,785079,1248,10,N,N,-,-1,-1
RECMUS.txt,783916,785254,1338,10,N,N,-,-1,-1
RECMUS.txt,784024,785363,1339,10,N,N,-,-1,-1
RECMUS.txt,784165,785527,1362,10,N,N,-,-1,-1
RECMUS.txt,784315,785645,1330,10,N,N,-,-1,-1
RECMUS.txt,784406,785796,1390,10,N,N,-,-1,-1
RECMUS.txt,784600,785971,1371,10,N,N,-,-1,-1
RECMUS.txt,784759,786108,1349,10,N,N,-,-1,-1
RECMUS.txt,784851,786159,1308,10,N,N,-,-1,-1
RECMUS.txt,784922,786321,1399,10,N,N,-,-1,-1
RECMUS.txt,785080,786429,1349,10,N,N,-,-1,-1
RECMUS.txt,785257,786487,1230,10,N,N,-,-1,-1
RECMUS.txt,785366,786696,1330,10,N,N,-,-1,-1
RECMUS.txt,785528,786944,1416,10,N,N,-,-1,-1
RECMUS.txt,785646,787059,1413,10,N,N,-,-1,-1
RECMUS.txt,785797,787455,1658,10,N,N,-,-1,-1
RECMUS.txt,785974,787624,1650,10,N,N,-,-1,-1
RECMUS.txt,786109,787695,1586,10,N,N,-,-1,-1
RECMUS.txt,786160,787776,1616,10,N,N,-,-1,-1
RECMUS.txt,786322,787985,1663,10,Y,N,-,-1,-1
RECMUS.txt,786430,788139,1709,10,Y,N,-,-1,-1
RECMUS.txt,786488,788344,1856,10,N,N,-,-1,-1
RECMUS.txt,786698,788431,1733,10,N,N,-,-1,-1
RECMUS.txt,786945,788528,1583,10,N,N,-,-1,-1
RECMUS.txt,787061,788708,1647,10,N,N,-,-1,-1
RECMUS.txt,787456,788956,1500,10,N,N,-,-1,-1
RECMUS.txt,787625,789059,1434,10,N,N,-,-1,-1
RECMUS.txt,787696,789146,1450,10,N,N,-,-1,-1
RECMUS.txt,787781,789237,1456,10,N,N,-,-1,-1
RECMUS.txt,787986,789299,1313,10,N,N,-,-1,-1
RECMUS.txt,788140,789422,1282,10,N,N,-,-1,-1
RECMUS.txt,788345,789634,1289,10,N,N,-,-1,-1
RECMUS.txt,788433,789819,1386,10,N,N,-,-1,-1
RECMUS.txt,788531,790025,1494,10,N,N,-,-1,-1
RECMUS.txt,788709,790192,1483,10,N,N,-,-1,-1
RECMUS.txt,788957,790370,1413,10,N,N,-,-1,-1
RECMUS.txt,789060,790405,1345,10,N,N,-,-1,-1
RECMUS.txt,789147,790414,1267,10,N,N,-,-1,-1
RECMUS.txt,789240,790556,1316,10,N,N,-,-1,-1
RECMUS.txt,789300,790711,1411,10,N,N,-,-1,-1
RECMUS.txt,789423,790796,1373,10,N,N,-,-1,-1
RECMUS.txt,789635,790968,1333,10,N,N,-,-1,-1
RECMUS.txt,789820,791033,1213,10,N,N,-,-1,-1
RECMUS.txt,790027,791127,1100,10,N,N,-,-1,-1
RECMUS.txt,790193,791299,1106,10,N,N,-,-1,-1
RECMUS.txt,790371,791343,972,10,N,N,-,-1,-1
RECMUS.txt,790406,791470,1064,10,N,Y,1437472380836,351899,352666
RECMUS.txt,790415,791709,1294,10,N,Y,1437472380836,351899,352666
RECMUS.txt,790558,791793,1235,10,N,Y,1437472380836,351899,352666
RECMUS.txt,790712,791895,1183,10,N,Y,1437472380836,351899,352666
RECMUS.txt,790797,792130,1333,10,N,Y,1437472380836,351899,352666
RECMUS.txt,790969,792274,1305,10,N,Y,1437472380836,351899,352666
RECMUS.txt,791034,792424,1390,10,Y,Y,1437472380836,351899,352666
RECMUS.txt,791128,792643,1515,10,Y,Y,1437472380836,351899,352666
RECMUS.txt,791300,792807,1507,10,Y,Y,1437472380836,351899,352666
RECMUS.txt,791346,792863,1517,10,Y,Y,1437472380836,351899,352666
RECMUS.txt,791471,792944,1473,10,Y,Y,1437472380836,351899,352666
RECMUS.txt,791710,793007,1297,10,Y,Y,1437472380836,351899,352666
RECMUS.txt,791794,793238,1444,10,Y,Y,1437472380836,351899,352666
RECMUS.txt,791896,793351,1455,10,Y,Y,1437472380836,351899,352666
RECMUS.txt,792131,793460,1329,10,Y,Y,1448278425221,65586,65914
RECMUS.txt,792279,793533,1254,10,Y,Y,1448278425221,65586,65914
RECMUS.txt,792425,793555,1130,10,N,Y,1448278425221,65586,65914
RECMUS.txt,792644,793562,918,10,N,N,-,-1,-1
RECMUS.txt,792808,793741,933,10,N,N,-,-1,-1
RECMUS.txt,792864,793845,981,10,N,N,-,-1,-1
RECMUS.txt,792945,794235,1290,10,N,N,-,-1,-1
RECMUS.txt,793008,794310,1302,10,N,N,-,-1,-1
RECMUS.txt,793239,794622,1383,10,N,N,-,-1,-1
RECMUS.txt,793354,794670,1316,10,N,N,-,-1,-1
RECMUS.txt,793461,794855,1394,10,N,N,-,-1,-1
RECMUS.txt,793534,795101,1567,10,N,N,-,-1,-1
RECMUS.txt,793556,795218,1662,10,N,N,-,-1,-1
RECMUS.txt,793563,795498,1935,10,N,N,-,-1,-1
RECMUS.txt,793744,795595,1851,10,N,N,-,-1,-1
RECMUS.txt,793846,795723,1877,10,N,N,-,-1,-1
RECMUS.txt,794236,795758,1522,10,N,N,-,-1,-1
RECMUS.txt,794311,795957,1646,10,N,N,-,-1,-1
RECMUS.txt,794623,796172,1549,10,N,N,-,-1,-1
RECMUS.txt,794673,796288,1615,10,N,N,-,-1,-1
RECMUS.txt,794856,796443,1587,10,N,N,-,-1,-1
RECMUS.txt,795104,796519,1415,10,N,N,-,-1,-1
RECMUS.txt,795219,796592,1373,10,N,N,-,-1,-1
RECMUS.txt,795499,796821,1322,10,N,Y,1448311811907,157566,161100
RECMUS.txt,795596,797100,1504,10,N,Y,1448311811907,157566,161100
RECMUS.txt,795724,797430,1706,10,Y,Y,1448311811907,157566,161100
RECMUS.txt,795761,797532,1771,10,Y,Y,1448311811907,157566,161100
RECMUS.txt,795958,797594,1636,10,Y,Y,1448311811907,157566,161100
RECMUS.txt,796174,797677,1503,10,N,Y,1448311811907,157566,161100
RECMUS.txt,796290,797726,1436,10,N,Y,1448311811907,157566,161100
RECMUS.txt,796444,797966,1522,10,N,Y,1448311811907,157566,161100
RECMUS.txt,796522,798126,1604,10,N,Y,1448311811907,157566,161100
RECMUS.txt,796593,798195,1602,10,N,Y,1448311811907,157566,161100
RECMUS.txt,796822,798408,1586,10,N,Y,1448311811907,157566,161100
RECMUS.txt,797101,798459,1358,10,N,Y,1448311811907,157566,161100
RECMUS.txt,797431,798544,1113,10,N,Y,1448311811907,157566,161100
RECMUS.txt,797533,798555,1022,10,N,N,-,-1,-1
RECMUS.txt,797595,798884,1289,10,N,N,-,-1,-1
RECMUS.txt,797678,798902,1224,10,N,N,-,-1,-1
RECMUS.txt,797729,798916,1187,10,N,N,-,-1,-1
RECMUS.txt,797968,799322,1354,10,N,N,-,-1,-1
RECMUS.txt,798129,799592,1463,10,N,N,-,-1,-1
RECMUS.txt,798196,799813,1617,10,N,N,-,-1,-1
RECMUS.txt,798409,799970,1561,10,N,N,-,-1,-1
RECMUS.txt,798460,800081,1621,10,N,N,-,-1,-1
RECMUS.txt,798545,800362,1817,10,N,N,-,-1,-1
RECMUS.txt,798556,800544,1988,10,N,N,-,-1,-1
RECMUS.txt,798889,800759,1870,10,N,N,-,-1,-1
RECMUS.txt,798904,801058,2154,10,N,N,-,-1,-1
RECMUS.txt,798919,801222,2303,10,N,N,-,-1,-1
RECMUS.txt,799325,801385,2060,10,N,N,-,-1,-1
RECMUS.txt,799593,801478,1885,10,N,N,-,-1,-1
RECMUS.txt,799814,801618,1804,10,N,N,-,-1,-1
RECMUS.txt,799971,801796,1825,10,N,N,-,-1,-1
RECMUS.txt,800082,802075,1993,10,Y,N,-,-1,-1
RECMUS.txt,800363,802223,1860,10,Y,N,-,-1,-1
RECMUS.txt,800547,802335,1788,10,Y,N,-,-1,-1
RECMUS.txt,800760,802603,1843,10,Y,N,-,-1,-1
RECMUS.txt,801060,802717,1657,10,Y,N,-,-1,-1
RECMUS.txt,801225,802877,1652,10,Y,N,-,-1,-1
RECMUS.txt,801386,802965,1579,10,Y,N,-,-1,-1
RECMUS.txt,801479,803054,1575,10,Y,N,-,-1,-1
RECMUS.txt,801619,803241,1622,10,Y,N,-,-1,-1
RECMUS.txt,801797,803304,1507,10,Y,N,-,-1,-1
RECMUS.txt,802076,803397,1321,10,N,N,-,-1,-1
RECMUS.txt,802224,803606,1382,10,N,N,-,-1,-1
RECMUS.txt,802336,803785,1449,10,Y,N,-,-1,-1
RECMUS.txt,802604,803870,1266,10,Y,N,-,-1,-1
RECMUS.txt,802718,803946,1228,10,Y,N,-,-1,-1
RECMUS.txt,802878,804112,1234,10,Y,N,-,-1,-1
RECMUS.txt,802966,804316,1350,10,Y,N,-,-1,-1
RECMUS.txt,803055,804408,1353,10,Y,N,-,-1,-1
RECMUS.txt,803242,804685,1443,10,N,N,-,-1,-1
RECMUS.txt,803309,804838,1529,10,Y,N,-,-1,-1
RECMUS.txt,803398,805019,1621,10,Y,N,-,-1,-1
RECMUS.txt,803607,805053,1446,10,Y,N,-,-1,-1
RECMUS.txt,803786,805060,1274,10,N,N,-,-1,-1
RECMUS.txt,803871,805157,1286,10,N,N,-,-1,-1
RECMUS.txt,803947,805332,1385,10,N,N,-,-1,-1
RECMUS.txt,804113,805573,1460,10,N,N,-,-1,-1
RECMUS.txt,804317,805881,1564,10,N,N,-,-1,-1
RECMUS.txt,804409,805915,1506,10,N,N,-,-1,-1
RECMUS.txt,804686,806015,1329,10,N,N,-,-1,-1
RECMUS.txt,804839,806117,1278,10,N,N,-,-1,-1
RECMUS.txt,805020,806215,1195,10,N,N,-,-1,-1
RECMUS.txt,805053,806413,1360,10,N,N,-,-1,-1
RECMUS.txt,805063,806747,1684,10,N,N,-,-1,-1
RECMUS.txt,805160,806960,1800,10,N,N,-,-1,-1
RECMUS.txt,805333,807124,1791,10,N,N,-,-1,-1
RECMUS.txt,805576,807303,1727,10,N,N,-,-1,-1
RECMUS.txt,805882,807378,1496,10,N,N,-,-1,-1
RECMUS.txt,805916,807487,1571,10,N,N,-,-1,-1
RECMUS.txt,806016,807575,1559,10,N,N,-,-1,-1
RECMUS.txt,806118,807769,1651,10,N,N,-,-1,-1
RECMUS.txt,806216,807925,1709,10,N,N,-,-1,-1
RECMUS.txt,806414,808087,1673,10,N,N,-,-1,-1
RECMUS.txt,806748,808165,1417,10,N,N,-,-1,-1
RECMUS.txt,806961,808589,1628,10,N,N,-,-1,-1
RECMUS.txt,807125,808747,1622,10,N,N,-,-1,-1
RECMUS.txt,807304,808752,1448,10,N,N,-,-1,-1
RECMUS.txt,807379,808907,1528,10,N,N,-,-1,-1
RECMUS.txt,807488,809110,1622,10,N,N,-,-1,-1
RECMUS.txt,807578,809133,1555,10,N,N,-,-1,-1
RECMUS.txt,807770,809225,1455,10,N,N,-,-1,-1
RECMUS.txt,807930,809241,1311,10,N,N,-,-1,-1
RECMUS.txt,808088,809403,1315,10,N,N,-,-1,-1
RECMUS.txt,808166,809563,1397,10,N,N,-,-1,-1
RECMUS.txt,808590,809885,1295,10,N,N,-,-1,-1
RECMUS.txt,808749,810089,1340,10,N,N,-,-1,-1
RECMUS.txt,808753,810155,1402,10,N,N,-,-1,-1
RECMUS.txt,808908,810389,1481,10,N,N,-,-1,-1
RECMUS.txt,809111,810767,1656,10,N,N,-,-1,-1
RECMUS.txt,809134,810883,1749,10,N,N,-,-1,-1
RECMUS.txt,809226,810982,1756,10,N,N,-,-1,-1
RECMUS.txt,809244,811118,1874,10,N,N,-,-1,-1
RECMUS.txt,809404,811152,1748,10,N,N,-,-1,-1
RECMUS.txt,809566,811163,1597,10,N,N,-,-1,-1
RECMUS.txt,809888,811320,1432,10,N,N,-,-1,-1
RECMUS.txt,810092,811435,1343,10,N,N,-,-1,-1
RECMUS.txt,810156,811715,1559,10,N,N,-,-1,-1
RECMUS.txt,810390,812026,1636,10,N,N,-,-1,-1
RECMUS.txt,810769,812270,1501,10,N,Y,1448285563397,102964,108476
RECMUS.txt,810884,812426,1542,10,N,Y,1448285563397,102964,108476
RECMUS.txt,810983,812532,1549,10,N,Y,1448275407308,26987,29181
RECMUS.txt,811119,812605,1486,10,N,Y,1448275407308,26987,29181
RECMUS.txt,811153,812829,1676,10,N,Y,1448275407308,26987,29181
RECMUS.txt,811164,813001,1837,10,N,Y,1448275407308,26987,29181
RECMUS.txt,811321,813240,1919,10,Y,Y,1448275407308,26987,29181
RECMUS.txt,811438,813532,2094,10,Y,Y,1448275407308,26987,29181
RECMUS.txt,811716,813632,1916,10,Y,Y,1448275407308,26987,29181
RECMUS.txt,812026,813721,1695,10,Y,Y,1448275407308,26987,29181
RECMUS.txt,812271,813990,1719,10,Y,Y,1448275407308,26987,29181
RECMUS.txt,812427,814021,1594,10,Y,Y,1448275407308,26987,29181
RECMUS.txt,812535,814084,1549,10,N,Y,1448275407308,26987,29181
RECMUS.txt,812606,814155,1549,10,Y,Y,1448275407308,26987,29181
RECMUS.txt,812831,814291,1460,10,Y,Y,1448275407308,26987,29181
RECMUS.txt,813002,814437,1435,10,N,N,-,-1,-1
RECMUS.txt,813243,814615,1372,10,N,N,-,-1,-1
RECMUS.txt,813533,815111,1578,10,N,N,-,-1,-1
RECMUS.txt,813633,815195,1562,10,N,N,-,-1,-1
RECMUS.txt,813722,815441,1719,10,Y,N,-,-1,-1
RECMUS.txt,813991,815731,1740,10,N,N,-,-1,-1
RECMUS.txt,814022,815877,1855,10,N,N,-,-1,-1
RECMUS.txt,814086,815878,1792,10,N,N,-,-1,-1
RECMUS.txt,814156,816010,1854,10,N,N,-,-1,-1
RECMUS.txt,814292,816182,1890,10,Y,N,-,-1,-1
RECMUS.txt,814438,816391,1953,10,Y,N,-,-1,-1
RECMUS.txt,814616,816574,1958,10,Y,N,-,-1,-1
RECMUS.txt,815112,816866,1754,10,Y,N,-,-1,-1
RECMUS.txt,815196,816951,1755,10,Y,N,-,-1,-1
RECMUS.txt,815444,817074,1630,10,Y,N,-,-1,-1
RECMUS.txt,815732,817229,1497,10,Y,N,-,-1,-1
RECMUS.txt,815877,817300,1423,10,Y,N,-,-1,-1
RECMUS.txt,815879,817436,1557,10,Y,N,-,-1,-1
RECMUS.txt,816013,817462,1449,10,Y,N,-,-1,-1
RECMUS.txt,816183,817690,1507,10,Y,N,-,-1,-1
RECMUS.txt,816392,817778,1386,10,N,N,-,-1,-1
RECMUS.txt,816575,818088,1513,10,Y,N,-,-1,-1
RECMUS.txt,816867,818225,1358,10,N,N,-,-1,-1
RECMUS.txt,816952,818504,1552,10,N,N,-,-1,-1
RECMUS.txt,817075,818539,1464,10,N,N,-,-1,-1
RECMUS.txt,817230,818796,1566,10,N,N,-,-1,-1
RECMUS.txt,817301,818911,1610,10,N,N,-,-1,-1
RECMUS.txt,817439,819154,1715,10,N,N,-,-1,-1
RECMUS.txt,817463,819304,1841,10,N,N,-,-1,-1
RECMUS.txt,817693,819355,1662,10,N,N,-,-1,-1
RECMUS.txt,817779,819444,1665,10,N,N,-,-1,-1
RECMUS.txt,818089,819521,1432,10,N,N,-,-1,-1
RECMUS.txt,818226,819630,1404,10,N,N,-,-1,-1
RECMUS.txt,818506,819708,1202,10,N,N,-,-1,-1
RECMUS.txt,818542,819722,1180,10,N,N,-,-1,-1
RECMUS.txt,818797,819930,1133,10,N,N,-,-1,-1
RECMUS.txt,818912,820092,1180,10,N,N,-,-1,-1
RECMUS.txt,819155,820266,1111,10,N,N,-,-1,-1
RECMUS.txt,819305,820367,1062,10,N,N,-,-1,-1
RECMUS.txt,819356,820386,1030,10,N,N,-,-1,-1
RECMUS.txt,819446,820394,948,10,N,N,-,-1,-1
RECMUS.txt,819522,820458,936,10,N,N,-,-1,-1
RECMUS.txt,819631,820727,1096,10,N,N,-,-1,-1
RECMUS.txt,819713,820780,1067,10,N,N,-,-1,-1
RECMUS.txt,819723,820935,1212,10,N,N,-,-1,-1
RECMUS.txt,819931,821155,1224,10,Y,N,-,-1,-1
RECMUS.txt,820093,821268,1175,10,Y,N,-,-1,-1
RECMUS.txt,820267,821453,1186,10,Y,N,-,-1,-1
RECMUS.txt,820372,821488,1116,10,Y,N,-,-1,-1
RECMUS.txt,820389,821587,1198,10,Y,N,-,-1,-1
RECMUS.txt,820397,821886,1489,10,Y,N,-,-1,-1
RECMUS.txt,820458,821986,1528,10,Y,N,-,-1,-1
RECMUS.txt,820728,822212,1484,10,N,N,-,-1,-1
RECMUS.txt,820780,822449,1669,10,N,N,-,-1,-1
RECMUS.txt,820936,822506,1570,10,N,N,-,-1,-1
RECMUS.txt,821156,822709,1553,10,N,N,-,-1,-1
RECMUS.txt,821269,822786,1517,10,N,N,-,-1,-1
RECMUS.txt,821454,822978,1524,10,N,N,-,-1,-1
RECMUS.txt,821489,823564,2075,10,Y,N,-,-1,-1
RECMUS.txt,821588,823610,2022,10,Y,N,-,-1,-1
RECMUS.txt,821887,823668,1781,10,N,N,-,-1,-1
RECMUS.txt,821987,823814,1827,10,N,N,-,-1,-1
RECMUS.txt,822213,823836,1623,10,N,N,-,-1,-1
RECMUS.txt,822450,824094,1644,10,N,N,-,-1,-1
RECMUS.txt,822507,824142,1635,10,N,N,-,-1,-1
RECMUS.txt,822710,824450,1740,10,Y,N,-,-1,-1
RECMUS.txt,822787,824560,1773,10,Y,N,-,-1,-1
RECMUS.txt,822979,824598,1619,10,Y,N,-,-1,-1
RECMUS.txt,823565,824782,1217,10,Y,N,-,-1,-1
RECMUS.txt,823611,824795,1184,10,Y,N,-,-1,-1
RECMUS.txt,823669,824954,1285,10,Y,N,-,-1,-1
RECMUS.txt,823815,825285,1470,10,Y,N,-,-1,-1
RECMUS.txt,823836,825380,1544,10,Y,N,-,-1,-1
RECMUS.txt,824095,825524,1429,10,N,N,-,-1,-1
RECMUS.txt,824143,825533,1390,10,N,N,-,-1,-1
RECMUS.txt,824451,825559,1108,10,N,N,-,-1,-1
RECMUS.txt,824561,825965,1404,10,N,N,-,-1,-1
RECMUS.txt,824599,826095,1496,10,N,N,-,-1,-1
RECMUS.txt,824783,826161,1378,10,N,N,-,-1,-1
RECMUS.txt,824796,826286,1490,10,N,N,-,-1,-1
RECMUS.txt,824957,826336,1379,10,N,N,-,-1,-1
RECMUS.txt,825286,826513,1227,10,N,N,-,-1,-1
RECMUS.txt,825381,826590,1209,10,N,N,-,-1,-1
RECMUS.txt,825526,826712,1186,10,N,N,-,-1,-1
RECMUS.txt,825534,826746,1212,10,N,N,-,-1,-1
RECMUS.txt,825560,826918,1358,10,N,N,-,-1,-1
RECMUS.txt,825966,826990,1024,10,N,N,-,-1,-1
RECMUS.txt,826098,827125,1027,10,N,N,-,-1,-1
RECMUS.txt,826162,827178,1016,10,N,N,-,-1,-1
RECMUS.txt,826287,827294,1007,10,N,N,-,-1,-1
RECMUS.txt,826337,827564,1227,10,N,N,-,-1,-1
RECMUS.txt,826514,827574,1060,10,N,N,-,-1,-1
RECMUS.txt,826591,827648,1057,10,N,N,-,-1,-1
RECMUS.txt,826713,827657,944,10,N,N,-,-1,-1
RECMUS.txt,826747,827659,912,10,N,N,-,-1,-1
RECMUS.txt,826919,827721,802,10,N,N,-,-1,-1
RECMUS.txt,826991,827861,870,10,N,N,-,-1,-1
RECMUS.txt,827130,827964,834,10,N,N,-,-1,-1
RECMUS.txt,827179,828250,1071,10,N,Y,1448314402792,179959,180202
RECMUS.txt,827295,828361,1066,10,N,Y,1448314402792,179959,180202
RECMUS.txt,827565,828526,961,10,N,Y,1448314402792,179959,180202
RECMUS.txt,827575,828636,1061,10,N,Y,1448314402792,179959,180202
RECMUS.txt,827649,828793,1144,10,N,Y,1448314402792,179959,180202
RECMUS.txt,827657,828914,1257,10,N,Y,1448314402792,179959,180202
RECMUS.txt,827660,829055,1395,10,N,Y,1448314402792,179959,180202
RECMUS.txt,827722,829228,1506,10,N,Y,1448314402792,179959,180202
RECMUS.txt,827863,829433,1570,10,N,Y,1448314402792,179959,180202
RECMUS.txt,827967,829699,1732,10,Y,Y,1448314402792,179959,180202
RECMUS.txt,828251,829904,1653,10,Y,Y,1448314402792,179959,180202
RECMUS.txt,828362,829991,1629,10,Y,Y,1448314402792,179959,180202
RECMUS.txt,828529,830032,1503,10,Y,N,-,-1,-1
RECMUS.txt,828637,830137,1500,10,Y,N,-,-1,-1
RECMUS.txt,828794,830197,1403,10,Y,N,-,-1,-1
RECMUS.txt,828915,830313,1398,10,Y,N,-,-1,-1
RECMUS.txt,829056,830487,1431,10,Y,N,-,-1,-1
RECMUS.txt,829229,830607,1378,10,Y,N,-,-1,-1
RECMUS.txt,829436,830837,1401,10,Y,Y,1448281320115,89144,91129
RECMUS.txt,829700,830978,1278,10,N,Y,1448281320115,89144,91129
RECMUS.txt,829905,831029,1124,10,N,Y,1448281320115,89144,91129
RECMUS.txt,829992,831311,1319,10,Y,Y,1448281320115,89144,91129
RECMUS.txt,830033,831382,1349,10,Y,Y,1448281320115,89144,91129
RECMUS.txt,830138,831497,1359,10,N,Y,1448281320115,89144,91129
RECMUS.txt,830200,831551,1351,10,N,Y,1448281320115,89144,91129
RECMUS.txt,830315,831607,1292,10,N,Y,1448281320115,89144,91129
RECMUS.txt,830488,831849,1361,10,N,Y,1448281320115,89144,91129
RECMUS.txt,830608,831902,1294,10,N,Y,1448281320115,89144,91129
RECMUS.txt,830838,832099,1261,10,N,Y,1448281320115,89144,91129
RECMUS.txt,830981,832119,1138,10,N,N,-,-1,-1
RECMUS.txt,831030,832126,1096,10,N,N,-,-1,-1
RECMUS.txt,831312,832552,1240,10,N,N,-,-1,-1
RECMUS.txt,831383,832622,1239,10,N,N,-,-1,-1
RECMUS.txt,831498,832863,1365,10,N,N,-,-1,-1
RECMUS.txt,831553,833016,1463,10,N,N,-,-1,-1
RECMUS.txt,831609,833123,1514,10,N,N,-,-1,-1
RECMUS.txt,831854,833294,1440,10,N,N,-,-1,-1
RECMUS.txt,831903,833555,1652,10,N,N,-,-1,-1
RECMUS.txt,832104,833635,1531,10,N,N,-,-1,-1
RECMUS.txt,832121,833809,1688,10,N,N,-,-1,-1
RECMUS.txt,832129,833862,1733,10,N,N,-,-1,-1
RECMUS.txt,832553,833981,1428,10,N,N,-,-1,-1
RECMUS.txt,832623,834029,1406,10,N,N,-,-1,-1
RECMUS.txt,832864,834108,1244,10,N,N,-,-1,-1
RECMUS.txt,833017,834327,1310,10,N,N,-,-1,-1
RECMUS.txt,833124,834952,1828,10,Y,N,-,-1,-1
RECMUS.txt,833295,835086,1791,10,Y,N,-,-1,-1
RECMUS.txt,833556,835260,1704,10,Y,N,-,-1,-1
RECMUS.txt,833636,835429,1793,10,N,N,-,-1,-1
RECMUS.txt,833811,835550,1739,10,N,N,-,-1,-1
RECMUS.txt,833863,835612,1749,10,N,N,-,-1,-1
RECMUS.txt,833983,835806,1823,10,N,N,-,-1,-1
RECMUS.txt,834032,835850,1818,10,N,N,-,-1,-1
RECMUS.txt,834113,836068,1955,10,N,N,-,-1,-1
RECMUS.txt,834328,836385,2057,10,Y,N,-,-1,-1
RECMUS.txt,834953,836421,1468,10,N,N,-,-1,-1
RECMUS.txt,835086,836473,1387,10,N,N,-,-1,-1
RECMUS.txt,835261,836586,1325,10,N,N,-,-1,-1
RECMUS.txt,835432,836717,1285,10,N,N,-,-1,-1
RECMUS.txt,835551,836931,1380,10,N,N,-,-1,-1
RECMUS.txt,835613,837192,1579,10,N,N,-,-1,-1
RECMUS.txt,835807,837203,1396,10,N,N,-,-1,-1
RECMUS.txt,835851,837418,1567,10,N,N,-,-1,-1
RECMUS.txt,836069,837546,1477,10,N,N,-,-1,-1
RECMUS.txt,836390,837701,1311,10,N,N,-,-1,-1
RECMUS.txt,836424,837844,1420,10,N,N,-,-1,-1
RECMUS.txt,836474,837976,1502,10,N,N,-,-1,-1
RECMUS.txt,836587,838266,1679,10,N,N,-,-1,-1
RECMUS.txt,836718,838370,1652,10,N,N,-,-1,-1
RECMUS.txt,836932,838620,1688,10,N,N,-,-1,-1
RECMUS.txt,837193,838882,1689,10,N,N,-,-1,-1
RECMUS.txt,837204,839230,2026,10,N,Y,1448280297446,84055,84972
RECMUS.txt,837419,839674,2255,10,N,Y,1448280297446,84055,84972
RECMUS.txt,837547,839809,2262,10,N,Y,1448280297446,84055,84972
RECMUS.txt,837704,839855,2151,10,N,Y,1448280297446,84055,84972
RECMUS.txt,837845,839937,2092,10,N,Y,1448277582432,52552,54595
RECMUS.txt,837977,839943,1966,10,N,Y,1448277582432,52552,54595
RECMUS.txt,838267,839950,1683,10,N,Y,1448277582432,52552,54595
RECMUS.txt,838371,840002,1631,10,N,Y,1448277582432,52552,54595
RECMUS.txt,838623,840084,1461,10,N,Y,1448277582432,52552,54595
RECMUS.txt,838882,840316,1434,10,Y,Y,1448277582432,52552,54595
RECMUS.txt,839232,840388,1156,10,N,Y,1448277582432,52552,54595
RECMUS.txt,839675,840449,774,10,N,Y,1448277582432,52552,54595
RECMUS.txt,839810,840466,656,10,N,Y,1448277582432,52552,54595
RECMUS.txt,839856,840624,768,10,N,Y,1448277582432,52552,54595
RECMUS.txt,839938,840843,905,10,N,Y,1448277582432,52552,54595
RECMUS.txt,839945,840860,915,10,N,Y,1448277582432,52552,54595
RECMUS.txt,839951,840865,914,10,N,Y,1448277582432,52552,54595
RECMUS.txt,840002,840894,892,10,N,Y,1448277582432,52552,54595
RECMUS.txt,840085,840932,847,10,Y,Y,1448277582432,52552,54595
RECMUS.txt,840317,841045,728,10,N,Y,1448277582432,52552,54595
RECMUS.txt,840389,841108,719,10,N,Y,1448277582432,52552,54595
RECMUS.txt,840450,841200,750,10,N,Y,1448277582432,52552,54595
RECMUS.txt,840467,841268,801,10,N,Y,1448277582432,52552,54595
RECMUS.txt,840625,841395,770,10,N,N,-,-1,-1
RECMUS.txt,840844,841595,751,10,N,N,-,-1,-1
RECMUS.txt,840861,841639,778,10,N,N,-,-1,-1
RECMUS.txt,840866,841712,846,10,Y,N,-,-1,-1
RECMUS.txt,840895,841943,1048,10,N,N,-,-1,-1
RECMUS.txt,840933,841967,1034,10,N,N,-,-1,-1
RECMUS.txt,841046,842316,1270,10,N,Y,1448037533268,13930,15031
RECMUS.txt,841109,842865,1756,10,Y,Y,1448037533268,13930,15031
RECMUS.txt,841201,843014,1813,10,Y,Y,1448037533268,13930,15031
RECMUS.txt,841271,843438,2167,10,Y,Y,1448037533268,13930,15031
RECMUS.txt,841396,843758,2362,10,Y,Y,1448037533268,13930,15031
RECMUS.txt,841596,843899,2303,10,Y,Y,1448037533268,13930,15031
RECMUS.txt,841640,844161,2521,10,Y,Y,1448037533268,13930,15031
RECMUS.txt,841713,844233,2520,10,Y,Y,1448037533268,13930,15031
RECMUS.txt,841944,844363,2419,10,Y,Y,1448037533268,13930,15031
RECMUS.txt,841968,844526,2558,10,Y,Y,1448037533268,13930,15031
RECMUS.txt,842317,844614,2297,10,Y,Y,1448037533268,13930,15031
RECMUS.txt,842866,844857,1991,10,N,N,-,-1,-1
RECMUS.txt,843015,845254,2239,10,Y,N,-,-1,-1
RECMUS.txt,843439,845453,2014,10,Y,N,-,-1,-1
RECMUS.txt,843759,845493,1734,10,Y,N,-,-1,-1
RECMUS.txt,843900,845592,1692,10,Y,N,-,-1,-1
RECMUS.txt,844164,845748,1584,10,Y,N,-,-1,-1
RECMUS.txt,844234,845837,1603,10,Y,N,-,-1,-1
RECMUS.txt,844364,845917,1553,10,Y,N,-,-1,-1
RECMUS.txt,844527,846045,1518,10,Y,N,-,-1,-1
RECMUS.txt,844615,846143,1528,10,N,N,-,-1,-1
RECMUS.txt,844858,846152,1294,10,N,N,-,-1,-1
RECMUS.txt,845255,846320,1065,10,N,N,-,-1,-1
RECMUS.txt,845456,846468,1012,10,N,N,-,-1,-1
RECMUS.txt,845494,846553,1059,10,N,N,-,-1,-1
RECMUS.txt,845593,846558,965,10,N,N,-,-1,-1
RECMUS.txt,845749,846721,972,10,N,N,-,-1,-1
RECMUS.txt,845838,846878,1040,10,N,N,-,-1,-1
RECMUS.txt,845918,846904,986,10,N,N,-,-1,-1
RECMUS.txt,846046,846943,897,10,N,N,-,-1,-1
RECMUS.txt,846146,847054,908,10,N,N,-,-1,-1
RECMUS.txt,846153,847167,1014,10,N,N,-,-1,-1
RECMUS.txt,846321,847271,950,10,N,N,-,-1,-1
RECMUS.txt,846469,847442,973,10,N,N,-,-1,-1
RECMUS.txt,846554,847567,1013,10,N,N,-,-1,-1
RECMUS.txt,846561,847617,1056,10,N,N,-,-1,-1
RECMUS.txt,846722,847737,1015,10,N,N,-,-1,-1
RECMUS.txt,846879,847930,1051,10,N,N,-,-1,-1
RECMUS.txt,846905,848099,1194,10,N,N,-,-1,-1
RECMUS.txt,846944,848543,1599,10,N,N,-,-1,-1
RECMUS.txt,847055,848652,1597,10,N,N,-,-1,-1
RECMUS.txt,847170,848711,1541,10,N,N,-,-1,-1
RECMUS.txt,847272,848860,1588,10,N,N,-,-1,-1
RECMUS.txt,847443,848948,1505,10,N,N,-,-1,-1
RECMUS.txt,847568,849058,1490,10,N,N,-,-1,-1
RECMUS.txt,847618,849232,1614,10,N,N,-,-1,-1
RECMUS.txt,847738,849399,1661,10,N,N,-,-1,-1
RECMUS.txt,847933,849543,1610,10,N,N,-,-1,-1
RECMUS.txt,848100,849642,1542,10,N,N,-,-1,-1
RECMUS.txt,848544,849923,1379,10,N,N,-,-1,-1
RECMUS.txt,848653,850102,1449,10,N,N,-,-1,-1
RECMUS.txt,848712,850355,1643,10,N,N,-,-1,-1
RECMUS.txt,848861,850490,1629,10,N,N,-,-1,-1
RECMUS.txt,848949,850729,1780,10,N,N,-,-1,-1
RECMUS.txt,849059,850797,1738,10,N,N,-,-1,-1
RECMUS.txt,849235,850900,1665,10,N,N,-,-1,-1
RECMUS.txt,849400,850941,1541,10,N,N,-,-1,-1
RECMUS.txt,849544,851018,1474,10,N,N,-,-1,-1
RECMUS.txt,849644,851199,1555,10,N,N,-,-1,-1
RECMUS.txt,849924,851209,1285,10,N,N,-,-1,-1
RECMUS.txt,850105,851553,1448,10,N,N,-,-1,-1
RECMUS.txt,850356,851580,1224,10,N,N,-,-1,-1
RECMUS.txt,850491,851745,1254,10,N,N,-,-1,-1
RECMUS.txt,850730,851904,1174,10,N,N,-,-1,-1
RECMUS.txt,850798,851923,1125,10,N,N,-,-1,-1
RECMUS.txt,850905,851936,1031,10,N,N,-,-1,-1
RECMUS.txt,850942,852324,1382,10,N,N,-,-1,-1
RECMUS.txt,851020,852490,1470,10,N,N,-,-1,-1
RECMUS.txt,851200,852592,1392,10,N,N,-,-1,-1
RECMUS.txt,851210,852790,1580,10,N,N,-,-1,-1
RECMUS.txt,851554,853057,1503,10,N,N,-,-1,-1
RECMUS.txt,851583,853459,1876,10,N,N,-,-1,-1
RECMUS.txt,851747,853736,1989,10,N,N,-,-1,-1
RECMUS.txt,851909,853854,1945,10,N,N,-,-1,-1
RECMUS.txt,851925,854040,2115,10,Y,N,-,-1,-1
RECMUS.txt,851939,854361,2422,10,Y,N,-,-1,-1
RECMUS.txt,852329,854652,2323,10,Y,N,-,-1,-1
RECMUS.txt,852491,854834,2343,10,Y,N,-,-1,-1
RECMUS.txt,852593,854941,2348,10,Y,N,-,-1,-1
RECMUS.txt,852792,854998,2206,10,Y,N,-,-1,-1
RECMUS.txt,853058,855006,1948,10,N,N,-,-1,-1
RECMUS.txt,853462,855223,1761,10,N,N,-,-1,-1
RECMUS.txt,853737,855228,1491,10,N,N,-,-1,-1
RECMUS.txt,853857,855267,1410,10,N,N,-,-1,-1
RECMUS.txt,854041,855295,1254,10,N,N,-,-1,-1
RECMUS.txt,854364,855308,944,10,N,N,-,-1,-1
RECMUS.txt,854654,855510,856,10,N,N,-,-1,-1
RECMUS.txt,854836,855673,837,10,N,N,-,-1,-1
RECMUS.txt,854942,855727,785,10,N,N,-,-1,-1
RECMUS.txt,854999,855927,928,10,N,N,-,-1,-1
RECMUS.txt,855007,856244,1237,10,N,N,-,-1,-1
RECMUS.txt,855224,856283,1059,10,N,N,-,-1,-1
RECMUS.txt,855229,856445,1216,10,N,N,-,-1,-1
RECMUS.txt,855268,856571,1303,10,N,N,-,-1,-1
RECMUS.txt,855296,856805,1509,10,N,N,-,-1,-1
RECMUS.txt,855310,856872,1562,10,N,N,-,-1,-1
RECMUS.txt,855511,857021,1510,10,N,N,-,-1,-1
RECMUS.txt,855675,857402,1727,10,N,N,-,-1,-1
RECMUS.txt,855728,857574,1846,10,N,N,-,-1,-1
RECMUS.txt,855930,857819,1889,10,N,N,-,-1,-1
RECMUS.txt,856245,857986,1741,10,N,N,-,-1,-1
RECMUS.txt,856284,858044,1760,10,N,N,-,-1,-1
RECMUS.txt,856446,858232,1786,10,N,N,-,-1,-1
RECMUS.txt,856572,858449,1877,10,N,N,-,-1,-1
RECMUS.txt,856806,858686,1880,10,N,N,-,-1,-1
RECMUS.txt,856873,858773,1900,10,N,N,-,-1,-1
RECMUS.txt,857022,858854,1832,10,N,N,-,-1,-1
RECMUS.txt,857403,858920,1517,10,N,N,-,-1,-1
RECMUS.txt,857575,859003,1428,10,N,N,-,-1,-1
RECMUS.txt,857820,859241,1421,10,N,N,-,-1,-1
RECMUS.txt,857987,859368,1381,10,N,N,-,-1,-1
RECMUS.txt,858045,859497,1452,10,N,N,-,-1,-1
RECMUS.txt,858233,859803,1570,10,N,N,-,-1,-1
RECMUS.txt,858450,860078,1628,10,N,N,-,-1,-1
RECMUS.txt,858691,860111,1420,10,N,N,-,-1,-1
RECMUS.txt,858774,860173,1399,10,N,N,-,-1,-1
RECMUS.txt,858855,860338,1483,10,N,N,-,-1,-1
RECMUS.txt,858921,860423,1502,10,N,N,-,-1,-1
RECMUS.txt,859004,860751,1747,10,N,N,-,-1,-1
RECMUS.txt,859244,860885,1641,10,N,N,-,-1,-1
RECMUS.txt,859369,860971,1602,10,N,N,-,-1,-1
RECMUS.txt,859498,861035,1537,10,N,N,-,-1,-1
RECMUS.txt,859805,861063,1258,10,N,N,-,-1,-1
RECMUS.txt,860079,861250,1171,10,N,N,-,-1,-1
RECMUS.txt,860112,861451,1339,10,N,N,-,-1,-1
RECMUS.txt,860174,861654,1480,10,N,N,-,-1,-1
RECMUS.txt,860339,861789,1450,10,N,N,-,-1,-1
RECMUS.txt,860424,862000,1576,10,N,N,-,-1,-1
RECMUS.txt,860752,862155,1403,10,N,N,-,-1,-1
RECMUS.txt,860886,862318,1432,10,N,N,-,-1,-1
RECMUS.txt,860972,862394,1422,10,N,N,-,-1,-1
RECMUS.txt,861036,862723,1687,10,N,N,-,-1,-1
RECMUS.txt,861064,862972,1908,10,N,N,-,-1,-1
RECMUS.txt,861253,863207,1954,10,N,N,-,-1,-1
RECMUS.txt,861452,863428,1976,10,N,N,-,-1,-1
RECMUS.txt,861655,863576,1921,10,N,N,-,-1,-1
RECMUS.txt,861791,863692,1901,10,N,N,-,-1,-1
RECMUS.txt,862001,863789,1788,10,N,N,-,-1,-1
RECMUS.txt,862156,863800,1644,10,N,N,-,-1,-1
RECMUS.txt,862319,863945,1626,10,N,N,-,-1,-1
RECMUS.txt,862397,864291,1894,10,N,N,-,-1,-1
RECMUS.txt,862724,864375,1651,10,N,N,-,-1,-1
RECMUS.txt,862973,864651,1678,10,N,N,-,-1,-1
RECMUS.txt,863209,864872,1663,10,N,N,-,-1,-1
RECMUS.txt,863431,865047,1616,10,N,N,-,-1,-1
RECMUS.txt,863577,865164,1587,10,N,N,-,-1,-1
RECMUS.txt,863693,865393,1700,10,N,N,-,-1,-1
RECMUS.txt,863792,865559,1767,10,N,N,-,-1,-1
RECMUS.txt,863801,865682,1881,10,N,N,-,-1,-1
RECMUS.txt,863946,865727,1781,10,N,N,-,-1,-1
RECMUS.txt,864292,865813,1521,10,N,N,-,-1,-1
RECMUS.txt,864376,866139,1763,10,N,N,-,-1,-1
RECMUS.txt,864652,866365,1713,10,N,N,-,-1,-1
RECMUS.txt,864873,866649,1776,10,N,N,-,-1,-1
RECMUS.txt,865048,866849,1801,10,N,Y,1448039533036,21326,21680
RECMUS.txt,865165,866880,1715,10,N,Y,1448039533036,21326,21680
RECMUS.txt,865394,867164,1770,10,N,Y,1448039533036,21326,21680
RECMUS.txt,865560,867259,1699,10,N,Y,1448039533036,21326,21680
RECMUS.txt,865683,867385,1702,10,N,Y,1448039533036,21326,21680
RECMUS.txt,865730,867502,1772,10,N,Y,1448039533036,21326,21680
RECMUS.txt,865818,867738,1920,10,N,Y,1448039533036,21326,21680
RECMUS.txt,866140,867816,1676,10,N,Y,1448039533036,21326,21680
RECMUS.txt,866366,867889,1523,10,N,Y,1448039533036,21326,21680
RECMUS.txt,866651,868057,1406,10,N,Y,1448039533036,21326,21680
RECMUS.txt,866850,868280,1430,10,N,Y,1448039533036,21326,21680
RECMUS.txt,866883,868302,1419,10,N,N,-,-1,-1
RECMUS.txt,867165,868405,1240,10,N,N,-,-1,-1
RECMUS.txt,867260,868445,1185,10,N,N,-,-1,-1
RECMUS.txt,867386,868574,1188,10,N,N,-,-1,-1
RECMUS.txt,867503,868594,1091,10,N,N,-,-1,-1
RECMUS.txt,867739,868717,978,10,N,N,-,-1,-1
RECMUS.txt,867817,869005,1188,10,N,N,-,-1,-1
RECMUS.txt,867890,869135,1245,10,N,N,-,-1,-1
RECMUS.txt,868058,869246,1188,10,N,N,-,-1,-1
RECMUS.txt,868283,869326,1043,10,N,N,-,-1,-1
RECMUS.txt,868303,869438,1135,10,N,N,-,-1,-1
RECMUS.txt,868406,869593,1187,10,N,N,-,-1,-1
RECMUS.txt,868446,869811,1365,10,N,N,-,-1,-1
RECMUS.txt,868575,869840,1265,10,N,N,-,-1,-1
RECMUS.txt,868595,870103,1508,10,N,N,-,-1,-1
RECMUS.txt,868718,870262,1544,10,N,N,-,-1,-1
RECMUS.txt,869006,870280,1274,10,N,N,-,-1,-1
RECMUS.txt,869136,870293,1157,10,N,N,-,-1,-1
RECMUS.txt,869247,870657,1410,10,N,N,-,-1,-1
RECMUS.txt,869327,870922,1595,10,N,N,-,-1,-1
RECMUS.txt,869439,871038,1599,10,N,N,-,-1,-1
RECMUS.txt,869594,871079,1485,10,N,N,-,-1,-1
RECMUS.txt,869812,871243,1431,10,N,N,-,-1,-1
RECMUS.txt,869841,871340,1499,10,Y,N,-,-1,-1
RECMUS.txt,870104,871363,1259,10,N,N,-,-1,-1
RECMUS.txt,870267,871409,1142,10,N,N,-,-1,-1
RECMUS.txt,870282,871466,1184,10,N,N,-,-1,-1
RECMUS.txt,870296,871534,1238,10,N,N,-,-1,-1
RECMUS.txt,870660,871597,937,10,N,N,-,-1,-1
RECMUS.txt,870923,871621,698,10,N,N,-,-1,-1
RECMUS.txt,871039,871658,619,10,N,N,-,-1,-1
RECMUS.txt,871080,871696,616,10,N,N,-,-1,-1
RECMUS.txt,871245,871748,503,10,N,N,-,-1,-1
RECMUS.txt,871342,871792,450,10,N,N,-,-1,-1
RECMUS.txt,871364,871820,456,10,N,N,-,-1,-1
RECMUS.txt,871410,871918,508,10,N,N,-,-1,-1
RECMUS.txt,871468,872138,670,10,N,N,-,-1,-1
RECMUS.txt,871535,872215,680,10,N,N,-,-1,-1
RECMUS.txt,871599,872412,813,10,N,N,-,-1,-1
RECMUS.txt,871622,872484,862,10,N,N,-,-1,-1
RECMUS.txt,871660,872653,993,10,N,N,-,-1,-1
RECMUS.txt,871697,872739,1042,10,N,N,-,-1,-1
RECMUS.txt,871750,872744,994,10,N,N,-,-1,-1
RECMUS.txt,871793,872871,1078,10,N,N,-,-1,-1
RECMUS.txt,871822,873030,1208,10,N,N,-,-1,-1
RECMUS.txt,871923,873311,1388,10,N,N,-,-1,-1
RECMUS.txt,872139,873415,1276,10,N,N,-,-1,-1
RECMUS.txt,872216,873821,1605,10,N,Y,1448315012079,181380,182053
RECMUS.txt,872413,873865,1452,10,N,Y,1448315012079,181380,182053
RECMUS.txt,872487,873994,1507,10,N,Y,1448315012079,181380,182053
RECMUS.txt,872654,874254,1600,10,N,Y,1448315012079,181380,182053
RECMUS.txt,872740,874333,1593,10,N,Y,1448315012079,181380,182053
RECMUS.txt,872747,874506,1759,10,N,Y,1448315012079,181380,182053
RECMUS.txt,872872,874685,1813,10,N,Y,1448315012079,181380,182053
RECMUS.txt,873030,874813,1783,10,N,Y,1448315012079,181380,182053
RECMUS.txt,873312,874900,1588,10,N,Y,1448315012079,181380,182053
RECMUS.txt,873416,875054,1638,10,N,Y,1448315012079,181380,182053
RECMUS.txt,873822,875163,1341,10,N,N,-,-1,-1
RECMUS.txt,873866,875599,1733,10,N,N,-,-1,-1
RECMUS.txt,873996,875835,1839,10,N,Y,1448281071558,89330,89524
RECMUS.txt,874255,875967,1712,10,N,Y,1448281071558,89330,89524
RECMUS.txt,874334,876207,1873,10,N,Y,1448281071558,89330,89524
RECMUS.txt,874507,876264,1757,10,N,Y,1448281071558,89330,89524
RECMUS.txt,874686,876553,1867,10,N,Y,1448281071558,89330,89524
RECMUS.txt,874814,876595,1781,10,N,Y,1448281071558,89330,89524
RECMUS.txt,874902,876722,1820,10,N,Y,1448281071558,89330,89524
RECMUS.txt,875055,876824,1769,10,N,Y,1448281071558,89330,89524
RECMUS.txt,875165,876957,1792,10,Y,Y,1448281071558,89330,89524
RECMUS.txt,875600,877022,1422,10,Y,Y,1448281071558,89330,89524
RECMUS.txt,875836,877105,1269,10,N,N,-,-1,-1
RECMUS.txt,875968,877219,1251,10,N,N,-,-1,-1
RECMUS.txt,876208,877308,1100,10,N,N,-,-1,-1
RECMUS.txt,876265,877461,1196,10,N,N,-,-1,-1
RECMUS.txt,876553,877624,1071,10,N,N,-,-1,-1
RECMUS.txt,876596,877762,1166,10,Y,N,-,-1,-1
RECMUS.txt,876723,877912,1189,10,Y,N,-,-1,-1
RECMUS.txt,876825,878036,1211,10,N,N,-,-1,-1
RECMUS.txt,876958,878230,1272,10,N,N,-,-1,-1
RECMUS.txt,877023,878304,1281,10,N,N,-,-1,-1
RECMUS.txt,877107,878735,1628,10,N,N,-,-1,-1
RECMUS.txt,877220,878848,1628,10,N,N,-,-1,-1
RECMUS.txt,877309,878929,1620,10,N,N,-,-1,-1
RECMUS.txt,877463,878951,1488,10,N,N,-,-1,-1
RECMUS.txt,877625,879101,1476,10,N,N,-,-1,-1
RECMUS.txt,877765,879132,1367,10,N,N,-,-1,-1
RECMUS.txt,877913,879370,1457,10,N,N,-,-1,-1
RECMUS.txt,878037,879455,1418,10,N,N,-,-1,-1
RECMUS.txt,878232,879594,1362,10,N,N,-,-1,-1
RECMUS.txt,878304,879788,1484,10,N,N,-,-1,-1
RECMUS.txt,878736,879953,1217,10,N,N,-,-1,-1
RECMUS.txt,878851,880090,1239,10,N,N,-,-1,-1
RECMUS.txt,878934,880135,1201,10,N,N,-,-1,-1
RECMUS.txt,878956,880375,1419,10,N,N,-,-1,-1
RECMUS.txt,879102,880529,1427,10,N,N,-,-1,-1
RECMUS.txt,879134,880686,1552,10,N,N,-,-1,-1
RECMUS.txt,879371,880795,1424,10,N,N,-,-1,-1
RECMUS.txt,879458,880888,1430,10,N,N,-,-1,-1
RECMUS.txt,879595,880946,1351,10,N,N,-,-1,-1
RECMUS.txt,879790,881172,1382,10,N,N,-,-1,-1
RECMUS.txt,879954,881185,1231,10,N,N,-,-1,-1
RECMUS.txt,880091,881484,1393,10,N,N,-,-1,-1
RECMUS.txt,880136,881647,1511,10,Y,N,-,-1,-1
RECMUS.txt,880376,881703,1327,10,N,N,-,-1,-1
RECMUS.txt,880530,881931,1401,10,N,N,-,-1,-1
RECMUS.txt,880687,882108,1421,10,N,N,-,-1,-1
RECMUS.txt,880796,882206,1410,10,N,N,-,-1,-1
RECMUS.txt,880889,882345,1456,10,N,N,-,-1,-1
RECMUS.txt,880949,882428,1479,10,N,N,-,-1,-1
RECMUS.txt,881173,882500,1327,10,N,N,-,-1,-1
RECMUS.txt,881186,882589,1403,10,N,N,-,-1,-1
RECMUS.txt,881485,882800,1315,10,Y,N,-,-1,-1
RECMUS.txt,881650,882860,1210,10,N,N,-,-1,-1
RECMUS.txt,881705,883037,1332,10,N,N,-,-1,-1
RECMUS.txt,881932,883137,1205,10,N,N,-,-1,-1
RECMUS.txt,882109,883342,1233,10,N,N,-,-1,-1
RECMUS.txt,882207,883426,1219,10,N,N,-,-1,-1
RECMUS.txt,882346,883543,1197,10,N,N,-,-1,-1
RECMUS.txt,882429,884066,1637,10,N,N,-,-1,-1
RECMUS.txt,882503,884151,1648,10,N,N,-,-1,-1
RECMUS.txt,882590,884396,1806,10,N,N,-,-1,-1
RECMUS.txt,882802,884403,1601,10,N,N,-,-1,-1
RECMUS.txt,882862,884526,1664,10,N,N,-,-1,-1
RECMUS.txt,883038,884532,1494,10,N,N,-,-1,-1
RECMUS.txt,883138,884722,1584,10,N,N,-,-1,-1
RECMUS.txt,883343,884985,1642,10,N,N,-,-1,-1
RECMUS.txt,883427,885116,1689,10,N,N,-,-1,-1
RECMUS.txt,883544,885253,1709,10,N,N,-,-1,-1
RECMUS.txt,884067,885386,1319,10,N,N,-,-1,-1
RECMUS.txt,884152,885407,1255,10,N,N,-,-1,-1
RECMUS.txt,884397,885549,1152,10,N,N,-,-1,-1
RECMUS.txt,884404,885606,1202,10,N,N,-,-1,-1
RECMUS.txt,884528,885650,1122,10,N,N,-,-1,-1
RECMUS.txt,884533,885692,1159,10,N,N,-,-1,-1
RECMUS.txt,884723,885769,1046,10,N,N,-,-1,-1
RECMUS.txt,884986,885800,814,10,N,N,-,-1,-1
RECMUS.txt,885117,885831,714,10,N,N,-,-1,-1
RECMUS.txt,885254,885918,664,10,N,N,-,-1,-1
RECMUS.txt,885387,886114,727,10,N,N,-,-1,-1
RECMUS.txt,885408,886156,748,10,N,N,-,-1,-1
RECMUS.txt,885550,886267,717,10,N,N,-,-1,-1
RECMUS.txt,885611,886335,724,10,N,N,-,-1,-1
RECMUS.txt,885651,886411,760,10,N,N,-,-1,-1
RECMUS.txt,885693,886559,866,10,N,N,-,-1,-1
RECMUS.txt,885770,886598,828,10,N,N,-,-1,-1
RECMUS.txt,885801,886636,835,10,N,N,-,-1,-1
RECMUS.txt,885832,886694,862,10,N,N,-,-1,-1
RECMUS.txt,885919,886747,828,10,N,N,-,-1,-1
RECMUS.txt,886115,886793,678,10,N,N,-,-1,-1
RECMUS.txt,886157,886823,666,10,N,N,-,-1,-1
RECMUS.txt,886270,886858,588,10,N,N,-,-1,-1
RECMUS.txt,886337,886887,550,10,N,N,-,-1,-1
RECMUS.txt,886414,886903,489,10,N,N,-,-1,-1
RECMUS.txt,886562,886922,360,10,N,N,-,-1,-1
RECMUS.txt,886600,887020,420,10,N,N,-,-1,-1
RECMUS.txt,886638,887089,451,10,N,N,-,-1,-1
RECMUS.txt,886697,887119,422,10,N,N,-,-1,-1
RECMUS.txt,886750,887146,396,10,N,N,-,-1,-1
RECMUS.txt,886795,887241,446,10,N,N,-,-1,-1
RECMUS.txt,886825,887445,620,10,N,N,-,-1,-1
RECMUS.txt,886860,887783,923,10,N,Y,1448287306770,114686,120152
RECMUS.txt,886890,888081,1191,10,N,Y,1448287306770,114686,120152
RECMUS.txt,886904,888163,1259,10,N,Y,1448287306770,114686,120152
RECMUS.txt,886925,888400,1475,10,Y,Y,1448287306770,114686,120152
RECMUS.txt,887023,888835,1812,10,Y,Y,1448287306770,114686,120152
RECMUS.txt,887091,888948,1857,10,Y,Y,1448287306770,114686,120152
RECMUS.txt,887122,889067,1945,10,Y,Y,1448287306770,114686,120152
RECMUS.txt,887151,889136,1985,10,Y,Y,1448287306770,114686,120152
RECMUS.txt,887242,889366,2124,10,Y,Y,1448287306770,114686,120152
RECMUS.txt,887446,889514,2068,10,Y,Y,1448287306770,114686,120152
RECMUS.txt,887784,889634,1850,10,Y,Y,1448287306770,114686,120152
RECMUS.txt,888082,889734,1652,10,N,Y,1448287306770,114686,120152
RECMUS.txt,888164,889874,1710,10,N,N,-,-1,-1
RECMUS.txt,888401,889927,1526,10,N,N,-,-1,-1
RECMUS.txt,888836,889948,1112,10,N,N,-,-1,-1
RECMUS.txt,888950,890105,1155,10,N,N,-,-1,-1
RECMUS.txt,889068,890338,1270,10,N,N,-,-1,-1
RECMUS.txt,889137,890402,1265,10,N,N,-,-1,-1
RECMUS.txt,889367,890473,1106,10,N,N,-,-1,-1
RECMUS.txt,889515,890693,1178,10,N,N,-,-1,-1
RECMUS.txt,889639,890774,1135,10,N,N,-,-1,-1
RECMUS.txt,889735,890999,1264,10,N,N,-,-1,-1
RECMUS.txt,889875,891258,1383,10,Y,N,-,-1,-1
RECMUS.txt,889927,891425,1498,10,Y,N,-,-1,-1
RECMUS.txt,889949,891477,1528,10,Y,N,-,-1,-1
RECMUS.txt,890106,891599,1493,10,Y,N,-,-1,-1
RECMUS.txt,890339,891646,1307,10,Y,N,-,-1,-1
RECMUS.txt,890403,891822,1419,10,Y,N,-,-1,-1
RECMUS.txt,890475,891939,1464,10,Y,N,-,-1,-1
RECMUS.txt,890694,892081,1387,10,Y,N,-,-1,-1
RECMUS.txt,890776,892166,1390,10,Y,N,-,-1,-1
RECMUS.txt,891000,892258,1258,10,Y,N,-,-1,-1
RECMUS.txt,891259,892361,1102,10,N,N,-,-1,-1
RECMUS.txt,891426,892574,1148,10,N,N,-,-1,-1
RECMUS.txt,891478,892722,1244,10,N,N,-,-1,-1
RECMUS.txt,891600,892903,1303,10,N,N,-,-1,-1
RECMUS.txt,891647,892981,1334,10,N,N,-,-1,-1
RECMUS.txt,891823,893234,1411,10,N,N,-,-1,-1
RECMUS.txt,891940,893419,1479,10,Y,N,-,-1,-1
RECMUS.txt,892086,893515,1429,10,Y,N,-,-1,-1
RECMUS.txt,892167,893710,1543,10,Y,N,-,-1,-1
RECMUS.txt,892259,893717,1458,10,Y,N,-,-1,-1
RECMUS.txt,892362,893934,1572,10,Y,N,-,-1,-1
RECMUS.txt,892579,894029,1450,10,Y,N,-,-1,-1
RECMUS.txt,892723,894171,1448,10,Y,N,-,-1,-1
RECMUS.txt,892905,894235,1330,10,Y,N,-,-1,-1
RECMUS.txt,892982,894491,1509,10,Y,N,-,-1,-1
RECMUS.txt,893235,894778,1543,10,Y,N,-,-1,-1
RECMUS.txt,893420,894890,1470,10,N,N,-,-1,-1
RECMUS.txt,893516,894895,1379,10,N,N,-,-1,-1
RECMUS.txt,893710,895065,1355,10,N,N,-,-1,-1
RECMUS.txt,893720,895573,1853,10,Y,N,-,-1,-1
RECMUS.txt,893939,895821,1882,10,Y,N,-,-1,-1
RECMUS.txt,894029,896124,2095,10,Y,N,-,-1,-1
RECMUS.txt,894172,896304,2132,10,Y,N,-,-1,-1
RECMUS.txt,894236,896317,2081,10,Y,N,-,-1,-1
RECMUS.txt,894492,896522,2030,10,Y,N,-,-1,-1
RECMUS.txt,894779,896896,2117,10,Y,N,-,-1,-1
RECMUS.txt,894891,896988,2097,10,Y,N,-,-1,-1
RECMUS.txt,894896,897217,2321,10,Y,N,-,-1,-1
RECMUS.txt,895066,897314,2248,10,N,N,-,-1,-1
RECMUS.txt,895574,897747,2173,10,Y,N,-,-1,-1
RECMUS.txt,895822,897793,1971,10,Y,N,-,-1,-1
RECMUS.txt,896125,897979,1854,10,Y,N,-,-1,-1
RECMUS.txt,896309,898405,2096,10,Y,N,-,-1,-1
RECMUS.txt,896322,898547,2225,10,Y,N,-,-1,-1
RECMUS.txt,896525,898706,2181,10,Y,N,-,-1,-1
RECMUS.txt,896897,898798,1901,10,Y,N,-,-1,-1
RECMUS.txt,896989,898991,2002,10,Y,N,-,-1,-1
RECMUS.txt,897219,899021,1802,10,Y,N,-,-1,-1
RECMUS.txt,897315,899218,1903,10,Y,N,-,-1,-1
RECMUS.txt,897748,899380,1632,10,N,N,-,-1,-1
RECMUS.txt,897794,899578,1784,10,N,N,-,-1,-1
RECMUS.txt,897980,899733,1753,10,Y,N,-,-1,-1
RECMUS.txt,898406,899775,1369,10,N,N,-,-1,-1
RECMUS.txt,898548,900026,1478,10,N,N,-,-1,-1
RECMUS.txt,898711,900088,1377,10,N,N,-,-1,-1
RECMUS.txt,898799,900188,1389,10,N,N,-,-1,-1
RECMUS.txt,898992,900282,1290,10,N,N,-,-1,-1
RECMUS.txt,899022,900463,1441,10,N,N,-,-1,-1
RECMUS.txt,899219,900591,1372,10,N,N,-,-1,-1
RECMUS.txt,899381,900706,1325,10,N,N,-,-1,-1
RECMUS.txt,899580,900774,1194,10,N,N,-,-1,-1
RECMUS.txt,899736,900899,1163,10,N,N,-,-1,-1
RECMUS.txt,899778,900989,1211,10,N,N,-,-1,-1
RECMUS.txt,900027,901107,1080,10,N,N,-,-1,-1
RECMUS.txt,900091,901175,1084,10,N,N,-,-1,-1
RECMUS.txt,900189,901330,1141,10,N,N,-,-1,-1
RECMUS.txt,900283,901474,1191,10,N,N,-,-1,-1
RECMUS.txt,900464,901541,1077,10,N,N,-,-1,-1
RECMUS.txt,900592,901581,989,10,N,N,-,-1,-1
RECMUS.txt,900707,901824,1117,10,N,N,-,-1,-1
RECMUS.txt,900775,902003,1228,10,N,N,-,-1,-1
RECMUS.txt,900900,902101,1201,10,N,N,-,-1,-1
RECMUS.txt,900990,902275,1285,10,N,N,-,-1,-1
RECMUS.txt,901108,902386,1278,10,N,N,-,-1,-1
RECMUS.txt,901176,902509,1333,10,N,N,-,-1,-1
RECMUS.txt,901331,902571,1240,10,N,N,-,-1,-1
RECMUS.txt,901474,902692,1218,10,N,N,-,-1,-1
RECMUS.txt,901542,902891,1349,10,N,N,-,-1,-1
RECMUS.txt,901582,902957,1375,10,N,N,-,-1,-1
RECMUS.txt,901825,903110,1285,10,N,N,-,-1,-1
RECMUS.txt,902004,903242,1238,10,N,N,-,-1,-1
RECMUS.txt,902102,903279,1177,10,N,N,-,-1,-1
RECMUS.txt,902278,903429,1151,10,N,N,-,-1,-1
RECMUS.txt,902387,903439,1052,10,N,N,-,-1,-1
RECMUS.txt,902510,903686,1176,10,N,N,-,-1,-1
RECMUS.txt,902572,903801,1229,10,N,N,-,-1,-1
RECMUS.txt,902693,904093,1400,10,N,N,-,-1,-1
RECMUS.txt,902892,904226,1334,10,N,N,-,-1,-1
RECMUS.txt,902957,904332,1375,10,N,N,-,-1,-1
RECMUS.txt,903113,904639,1526,10,N,N,-,-1,-1
RECMUS.txt,903247,904781,1534,10,N,N,-,-1,-1
RECMUS.txt,903282,904885,1603,10,N,N,-,-1,-1
RECMUS.txt,903430,905032,1602,10,N,N,-,-1,-1
RECMUS.txt,903442,905136,1694,10,N,N,-,-1,-1
RECMUS.txt,903687,905232,1545,10,N,N,-,-1,-1
RECMUS.txt,903802,905294,1492,10,N,N,-,-1,-1
RECMUS.txt,904094,905555,1461,10,N,N,-,-1,-1
RECMUS.txt,904227,905777,1550,10,N,N,-,-1,-1
RECMUS.txt,904333,905796,1463,10,N,N,-,-1,-1
RECMUS.txt,904640,905810,1170,10,N,N,-,-1,-1
RECMUS.txt,904782,906190,1408,10,N,N,-,-1,-1
RECMUS.txt,904886,906446,1560,10,N,N,-,-1,-1
RECMUS.txt,905033,906672,1639,10,N,N,-,-1,-1
RECMUS.txt,905137,906863,1726,10,N,N,-,-1,-1
RECMUS.txt,905235,907037,1802,10,N,N,-,-1,-1
RECMUS.txt,905296,907091,1795,10,N,N,-,-1,-1
RECMUS.txt,905556,907164,1608,10,N,N,-,-1,-1
RECMUS.txt,905782,907440,1658,10,N,N,-,-1,-1
RECMUS.txt,905799,907710,1911,10,N,N,-,-1,-1
RECMUS.txt,905813,907931,2118,10,N,N,-,-1,-1
RECMUS.txt,906193,908097,1904,10,N,N,-,-1,-1
RECMUS.txt,906447,908320,1873,10,Y,N,-,-1,-1
RECMUS.txt,906673,908630,1957,10,Y,N,-,-1,-1
RECMUS.txt,906864,908908,2044,10,Y,N,-,-1,-1
RECMUS.txt,907038,909029,1991,10,Y,N,-,-1,-1
RECMUS.txt,907092,909234,2142,10,Y,N,-,-1,-1
RECMUS.txt,907167,909529,2362,10,Y,N,-,-1,-1
RECMUS.txt,907441,909833,2392,10,Y,N,-,-1,-1
RECMUS.txt,907713,910026,2313,10,N,N,-,-1,-1
RECMUS.txt,907934,910059,2125,10,N,N,-,-1,-1
RECMUS.txt,908098,910087,1989,10,N,N,-,-1,-1
RECMUS.txt,908321,910318,1997,10,N,N,-,-1,-1
RECMUS.txt,908633,910566,1933,10,N,N,-,-1,-1
RECMUS.txt,908909,910744,1835,10,N,N,-,-1,-1
RECMUS.txt,909030,910892,1862,10,N,N,-,-1,-1
RECMUS.txt,909237,910969,1732,10,N,N,-,-1,-1
RECMUS.txt,909530,911062,1532,10,N,N,-,-1,-1
RECMUS.txt,909834,911360,1526,10,N,N,-,-1,-1
RECMUS.txt,910027,911511,1484,10,N,N,-,-1,-1
RECMUS.txt,910060,911527,1467,10,N,N,-,-1,-1
RECMUS.txt,910089,911961,1872,10,N,N,-,-1,-1
RECMUS.txt,910321,912149,1828,10,N,N,-,-1,-1
RECMUS.txt,910567,912170,1603,10,N,N,-,-1,-1
RECMUS.txt,910745,912392,1647,10,N,N,-,-1,-1
RECMUS.txt,910893,912473,1580,10,N,N,-,-1,-1
RECMUS.txt,910971,912540,1569,10,N,N,-,-1,-1
RECMUS.txt,911063,912726,1663,10,N,N,-,-1,-1
RECMUS.txt,911361,913300,1939,10,N,N,-,-1,-1
RECMUS.txt,911512,913386,1874,10,N,N,-,-1,-1
RECMUS.txt,911528,913608,2080,10,N,N,-,-1,-1
RECMUS.txt,911962,913703,1741,10,N,N,-,-1,-1
RECMUS.txt,912151,913988,1837,10,N,N,-,-1,-1
RECMUS.txt,912171,914559,2388,10,N,Y,1448038101349,15101,17486
RECMUS.txt,912393,914708,2315,10,N,Y,1448038101349,15101,17486
RECMUS.txt,912476,914929,2453,10,N,Y,1448038101349,15101,17486
RECMUS.txt,912541,914963,2422,10,N,Y,1448038101349,15101,17486
RECMUS.txt,912727,915069,2342,10,N,Y,1448038101349,15101,17486
RECMUS.txt,913301,915278,1977,10,N,Y,1448038101349,15101,17486
RECMUS.txt,913387,915584,2197,10,N,Y,1448038101349,15101,17486
RECMUS.txt,913609,915802,2193,10,N,Y,1448038101349,15101,17486
RECMUS.txt,913704,916021,2317,10,N,Y,1448038101349,15101,17486
RECMUS.txt,913989,916127,2138,10,N,Y,1448038101349,15101,17486
RECMUS.txt,914560,916268,1708,10,N,N,-,-1,-1
RECMUS.txt,914709,916458,1749,10,N,N,-,-1,-1
RECMUS.txt,914930,916594,1664,10,N,N,-,-1,-1
RECMUS.txt,914964,916651,1687,10,N,N,-,-1,-1
RECMUS.txt,915070,916882,1812,10,N,N,-,-1,-1
RECMUS.txt,915281,917309,2028,10,N,N,-,-1,-1
RECMUS.txt,915585,917510,1925,10,N,N,-,-1,-1
RECMUS.txt,915804,917523,1719,10,N,N,-,-1,-1
RECMUS.txt,916022,917622,1600,10,N,N,-,-1,-1
RECMUS.txt,916128,917631,1503,10,N,N,-,-1,-1
RECMUS.txt,916270,917758,1488,10,N,N,-,-1,-1
RECMUS.txt,916459,917851,1392,10,N,N,-,-1,-1
RECMUS.txt,916595,918045,1450,10,N,N,-,-1,-1
RECMUS.txt,916656,918121,1465,10,N,N,-,-1,-1
RECMUS.txt,916885,918619,1734,10,N,N,-,-1,-1
RECMUS.txt,917310,919110,1800,10,N,N,-,-1,-1
RECMUS.txt,917511,919349,1838,10,N,N,-,-1,-1
RECMUS.txt,917528,919386,1858,10,N,N,-,-1,-1
RECMUS.txt,917627,919558,1931,10,N,N,-,-1,-1
RECMUS.txt,917631,919845,2214,10,N,N,-,-1,-1
RECMUS.txt,917761,920144,2383,10,N,N,-,-1,-1
RECMUS.txt,917852,920368,2516,10,Y,N,-,-1,-1
RECMUS.txt,918046,920551,2505,10,Y,N,-,-1,-1
RECMUS.txt,918122,920819,2697,10,N,N,-,-1,-1
RECMUS.txt,918619,920960,2341,10,N,N,-,-1,-1
RECMUS.txt,919111,921009,1898,10,N,N,-,-1,-1
RECMUS.txt,919352,921180,1828,10,N,N,-,-1,-1
RECMUS.txt,919387,921475,2088,10,N,N,-,-1,-1
RECMUS.txt,919559,921684,2125,10,N,N,-,-1,-1
RECMUS.txt,919846,921814,1968,10,N,N,-,-1,-1
RECMUS.txt,920145,921926,1781,10,N,N,-,-1,-1
RECMUS.txt,920369,921976,1607,10,N,N,-,-1,-1
RECMUS.txt,920554,922085,1531,10,N,N,-,-1,-1
RECMUS.txt,920820,922173,1353,10,N,N,-,-1,-1
RECMUS.txt,920963,922562,1599,10,N,N,-,-1,-1
RECMUS.txt,921011,922816,1805,10,N,N,-,-1,-1
RECMUS.txt,921181,923014,1833,10,N,N,-,-1,-1
RECMUS.txt,921476,923294,1818,10,N,N,-,-1,-1
RECMUS.txt,921685,923500,1815,10,N,N,-,-1,-1
RECMUS.txt,921815,923899,2084,10,N,N,-,-1,-1
RECMUS.txt,921927,924037,2110,10,N,N,-,-1,-1
RECMUS.txt,921977,924127,2150,10,N,N,-,-1,-1
RECMUS.txt,922086,924168,2082,10,N,N,-,-1,-1
RECMUS.txt,922174,924378,2204,10,N,N,-,-1,-1
RECMUS.txt,922565,924703,2138,10,N,N,-,-1,-1
RECMUS.txt,922817,924884,2067,10,N,N,-,-1,-1
RECMUS.txt,923015,924889,1874,10,N,N,-,-1,-1
RECMUS.txt,923295,924996,1701,10,N,N,-,-1,-1
RECMUS.txt,923501,925194,1693,10,N,N,-,-1,-1
RECMUS.txt,923902,925435,1533,10,N,N,-,-1,-1
RECMUS.txt,924038,925627,1589,10,Y,N,-,-1,-1
RECMUS.txt,924128,925684,1556,10,Y,N,-,-1,-1
RECMUS.txt,924171,926116,1945,10,Y,Y,1448286451685,111065,112127
RECMUS.txt,924381,926251,1870,10,Y,Y,1448286451685,111065,112127
RECMUS.txt,924704,926497,1793,10,Y,Y,1448286451685,111065,112127
RECMUS.txt,924885,926721,1836,10,Y,Y,1448286451685,111065,112127
RECMUS.txt,924892,926991,2099,10,Y,Y,1448286451685,111065,112127
RECMUS.txt,924997,927183,2186,10,Y,Y,1448286451685,111065,112127
RECMUS.txt,925195,927461,2266,10,Y,Y,1448286451685,111065,112127
RECMUS.txt,925436,927614,2178,10,Y,Y,1448286451685,111065,112127
RECMUS.txt,925628,927837,2209,10,N,Y,1448286451685,111065,112127
RECMUS.txt,925685,928056,2371,10,N,Y,1448286451685,111065,112127
RECMUS.txt,926117,928187,2070,10,N,Y,1448286451685,111065,112127
RECMUS.txt,926252,928415,2163,10,N,N,-,-1,-1
RECMUS.txt,926498,928554,2056,10,N,N,-,-1,-1
RECMUS.txt,926724,928615,1891,10,N,N,-,-1,-1
RECMUS.txt,926992,928806,1814,10,N,N,-,-1,-1
RECMUS.txt,927184,928911,1727,10,N,N,-,-1,-1
RECMUS.txt,927462,929176,1714,10,N,N,-,-1,-1
RECMUS.txt,927615,929299,1684,10,N,N,-,-1,-1
RECMUS.txt,927839,929441,1602,10,N,N,-,-1,-1
RECMUS.txt,928059,929589,1530,10,N,N,-,-1,-1
RECMUS.txt,928188,929767,1579,10,N,N,-,-1,-1
RECMUS.txt,928418,929818,1400,10,N,N,-,-1,-1
RECMUS.txt,928555,929840,1285,10,N,N,-,-1,-1
RECMUS.txt,928616,929859,1243,10,N,N,-,-1,-1
RECMUS.txt,928809,930005,1196,10,N,N,-,-1,-1
RECMUS.txt,928916,930224,1308,10,N,N,-,-1,-1
RECMUS.txt,929177,930231,1054,10,N,N,-,-1,-1
RECMUS.txt,929300,930236,936,10,N,N,-,-1,-1
RECMUS.txt,929442,930308,866,10,N,N,-,-1,-1
RECMUS.txt,929590,930408,818,10,N,N,-,-1,-1
RECMUS.txt,929769,930547,778,10,N,N,-,-1,-1
RECMUS.txt,929823,930602,779,10,N,N,-,-1,-1
RECMUS.txt,929843,930607,764,10,N,N,-,-1,-1
RECMUS.txt,929860,930609,749,10,N,N,-,-1,-1
RECMUS.txt,930008,930852,844,10,N,N,-,-1,-1
RECMUS.txt,930225,931175,950,10,N,N,-,-1,-1
RECMUS.txt,930231,931284,1053,10,N,N,-,-1,-1
RECMUS.txt,930237,931364,1127,10,N,N,-,-1,-1
RECMUS.txt,930309,931445,1136,10,N,N,-,-1,-1
RECMUS.txt,930413,931570,1157,10,N,N,-,-1,-1
RECMUS.txt,930552,931780,1228,10,N,N,-,-1,-1
RECMUS.txt,930606,931817,1211,10,N,N,-,-1,-1
RECMUS.txt,930608,931894,1286,10,N,N,-,-1,-1
RECMUS.txt,930613,932126,1513,10,N,N,-,-1,-1
RECMUS.txt,930853,932211,1358,10,N,N,-,-1,-1
RECMUS.txt,931176,932295,1119,10,N,N,-,-1,-1
RECMUS.txt,931286,932372,1086,10,N,N,-,-1,-1
RECMUS.txt,931365,932530,1165,10,N,N,-,-1,-1
RECMUS.txt,931446,932642,1196,10,N,N,-,-1,-1
RECMUS.txt,931572,932666,1094,10,N,N,-,-1,-1
RECMUS.txt,931781,932937,1156,10,N,N,-,-1,-1
RECMUS.txt,931818,932995,1177,10,N,N,-,-1,-1
RECMUS.txt,931895,933075,1180,10,N,N,-,-1,-1
RECMUS.txt,932126,933303,1177,10,N,N,-,-1,-1
RECMUS.txt,932212,933495,1283,10,N,N,-,-1,-1
RECMUS.txt,932300,933675,1375,10,N,N,-,-1,-1
RECMUS.txt,932373,933923,1550,10,N,N,-,-1,-1
RECMUS.txt,932531,934053,1522,10,N,N,-,-1,-1
RECMUS.txt,932645,934085,1440,10,N,N,-,-1,-1
RECMUS.txt,932667,934272,1605,10,N,N,-,-1,-1
RECMUS.txt,932939,934451,1512,10,N,N,-,-1,-1
RECMUS.txt,932998,934587,1589,10,N,N,-,-1,-1
RECMUS.txt,933076,934649,1573,10,N,N,-,-1,-1
RECMUS.txt,933304,934708,1404,10,N,N,-,-1,-1
RECMUS.txt,933496,934714,1218,10,N,N,-,-1,-1
RECMUS.txt,933678,934773,1095,10,N,N,-,-1,-1
RECMUS.txt,933924,934786,862,10,N,N,-,-1,-1
RECMUS.txt,934054,934805,751,10,N,N,-,-1,-1
RECMUS.txt,934088,934813,725,10,N,N,-,-1,-1
RECMUS.txt,934273,934885,612,10,N,N,-,-1,-1
RECMUS.txt,934452,934900,448,10,N,N,-,-1,-1
RECMUS.txt,934592,934919,327,10,N,N,-,-1,-1
RECMUS.txt,934654,934927,273,10,N,N,-,-1,-1
RECMUS.txt,934711,934952,241,10,N,N,-,-1,-1
RECMUS.txt,934715,934974,259,10,N,N,-,-1,-1
RECMUS.txt,934776,934982,206,10,N,N,-,-1,-1
RECMUS.txt,934787,935014,227,10,N,N,-,-1,-1
RECMUS.txt,934807,935029,222,10,N,N,-,-1,-1
RECMUS.txt,934814,935054,240,10,N,N,-,-1,-1
RECMUS.txt,934886,935062,176,10,N,N,-,-1,-1
RECMUS.txt,934901,935122,221,10,N,N,-,-1,-1
RECMUS.txt,934921,935139,218,10,N,N,-,-1,-1
RECMUS.txt,934928,935155,227,10,N,N,-,-1,-1
RECMUS.txt,934953,935163,210,10,N,N,-,-1,-1
RECMUS.txt,934976,935218,242,10,N,N,-,-1,-1
RECMUS.txt,934983,935243,260,10,N,N,-,-1,-1
RECMUS.txt,935015,935252,237,10,N,N,-,-1,-1
RECMUS.txt,935030,935316,286,10,N,N,-,-1,-1
RECMUS.txt,935056,935339,283,10,N,N,-,-1,-1
RECMUS.txt,935063,935347,284,10,N,N,-,-1,-1
RECMUS.txt,935125,935379,254,10,N,N,-,-1,-1
RECMUS.txt,935140,935402,262,10,N,N,-,-1,-1
RECMUS.txt,935157,935410,253,10,N,N,-,-1,-1
RECMUS.txt,935164,935449,285,10,N,N,-,-1,-1
RECMUS.txt,935221,935465,244,10,N,N,-,-1,-1
RECMUS.txt,935245,935474,229,10,N,N,-,-1,-1
RECMUS.txt,935253,935543,290,10,N,N,-,-1,-1
RECMUS.txt,935317,935559,242,10,N,N,-,-1,-1
RECMUS.txt,935341,935564,223,10,N,N,-,-1,-1
RECMUS.txt,935348,935568,220,10,N,N,-,-1,-1
RECMUS.txt,935380,935650,270,10,N,N,-,-1,-1
RECMUS.txt,935404,935669,265,10,N,N,-,-1,-1
RECMUS.txt,935411,935678,267,10,N,N,-,-1,-1
RECMUS.txt,935450,935745,295,10,N,N,-,-1,-1
RECMUS.txt,935467,935765,298,10,N,N,-,-1,-1
RECMUS.txt,935475,935774,299,10,N,N,-,-1,-1
RECMUS.txt,935544,935793,249,10,N,N,-,-1,-1
RECMUS.txt,935561,935808,247,10,N,N,-,-1,-1
RECMUS.txt,935565,935824,259,10,N,N,-,-1,-1
RECMUS.txt,935569,935841,272,10,N,N,-,-1,-1
RECMUS.txt,935651,935863,212,10,N,N,-,-1,-1
RECMUS.txt,935671,935872,201,10,N,N,-,-1,-1
RECMUS.txt,935679,935890,211,10,N,N,-,-1,-1
RECMUS.txt,935746,935905,159,10,N,N,-,-1,-1
RECMUS.txt,935767,935928,161,10,N,N,-,-1,-1
RECMUS.txt,935775,935937,162,10,N,N,-,-1,-1
RECMUS.txt,935794,936009,215,10,N,N,-,-1,-1
RECMUS.txt,935809,936025,216,10,N,N,-,-1,-1
RECMUS.txt,935825,936034,209,10,N,N,-,-1,-1
RECMUS.txt,935842,936144,302,10,N,N,-,-1,-1
RECMUS.txt,935865,936168,303,10,N,N,-,-1,-1
RECMUS.txt,935873,936177,304,10,N,N,-,-1,-1
RECMUS.txt,935891,936217,326,10,N,N,-,-1,-1
RECMUS.txt,935906,936255,349,10,N,N,-,-1,-1
RECMUS.txt,935930,936275,345,10,N,N,-,-1,-1
RECMUS.txt,935938,936285,347,10,N,N,-,-1,-1
RECMUS.txt,936010,936318,308,10,N,N,-,-1,-1
RECMUS.txt,936027,936334,307,10,N,N,-,-1,-1
RECMUS.txt,936035,936342,307,10,N,N,-,-1,-1
RECMUS.txt,936147,936349,202,10,N,N,-,-1,-1
RECMUS.txt,936170,936356,186,10,N,N,-,-1,-1
RECMUS.txt,936178,936363,185,10,N,N,-,-1,-1
RECMUS.txt,936218,936370,152,10,N,N,-,-1,-1
RECMUS.txt,936256,936377,121,10,N,N,-,-1,-1
RECMUS.txt,936277,936384,107,10,N,N,-,-1,-1
RECMUS.txt,936286,936389,103,10,N,N,-,-1,-1
RECMUS.txt,936319,936396,77,10,N,N,-,-1,-1
RECMUS.txt,936339,936408,69,10,N,N,-,-1,-1
RECMUS.txt,936346,936413,67,10,N,N,-,-1,-1
RECMUS.txt,936353,936418,65,10,N,N,-,-1,-1
RECMUS.txt,936360,936425,65,10,N,N,-,-1,-1
RECMUS.txt,936367,936431,64,10,N,N,-,-1,-1
RECMUS.txt,936374,936436,62,10,N,N,-,-1,-1
RECMUS.txt,936381,936443,62,10,N,N,-,-1,-1
RECMUS.txt,936386,936448,62,10,N,N,-,-1,-1
RECMUS.txt,936393,936453,60,10,N,N,-,-1,-1
RECMUS.txt,936398,936460,62,10,N,N,-,-1,-1
RECMUS.txt,936410,936465,55,10,N,N,-,-1,-1
RECMUS.txt,936415,936470,55,10,N,N,-,-1,-1
RECMUS.txt,936422,936477,55,10,N,N,-,-1,-1
RECMUS.txt,936428,936482,54,10,N,N,-,-1,-1
RECMUS.txt,936433,936489,56,10,N,N,-,-1,-1
RECMUS.txt,936440,936494,54,10,N,N,-,-1,-1
RECMUS.txt,936445,936557,112,10,N,N,-,-1,-1
RECMUS.txt,936450,936581,131,10,N,N,-,-1,-1
RECMUS.txt,936457,936597,140,10,N,N,-,-1,-1
RECMUS.txt,936462,936620,158,10,N,N,-,-1,-1
RECMUS.txt,936467,936642,175,10,N,N,-,-1,-1
RECMUS.txt,936474,936667,193,10,N,N,-,-1,-1
RECMUS.txt,936479,936715,236,10,N,N,-,-1,-1
RECMUS.txt,936486,936736,250,10,N,N,-,-1,-1
RECMUS.txt,936491,936764,273,10,N,N,-,-1,-1
RECMUS.txt,936499,936780,281,10,N,N,-,-1,-1
RECMUS.txt,936558,936832,274,10,N,N,-,-1,-1
RECMUS.txt,936582,936857,275,10,N,N,-,-1,-1
RECMUS.txt,936599,936874,275,10,N,N,-,-1,-1
RECMUS.txt,936621,936889,268,10,N,N,-,-1,-1
RECMUS.txt,936643,936904,261,10,N,N,-,-1,-1
RECMUS.txt,936669,936914,245,10,N,N,-,-1,-1
RECMUS.txt,936716,936929,213,10,N,N,-,-1,-1
RECMUS.txt,936738,936945,207,10,N,N,-,-1,-1
RECMUS.txt,936765,937012,247,10,N,N,-,-1,-1
RECMUS.txt,936782,937027,245,10,N,N,-,-1,-1
RECMUS.txt,936833,937050,217,10,N,N,-,-1,-1
RECMUS.txt,936859,937076,217,10,N,N,-,-1,-1
RECMUS.txt,936875,937091,216,10,N,N,-,-1,-1
RECMUS.txt,936890,937114,224,10,N,N,-,-1,-1
RECMUS.txt,936906,937151,245,10,N,N,-,-1,-1
RECMUS.txt,936915,937167,252,10,N,N,-,-1,-1
RECMUS.txt,936930,937215,285,10,N,N,-,-1,-1
RECMUS.txt,936947,937267,320,10,N,N,-,-1,-1
RECMUS.txt,937013,937283,270,10,N,N,-,-1,-1
RECMUS.txt,937028,937325,297,10,N,N,-,-1,-1
RECMUS.txt,937052,937341,289,10,N,N,-,-1,-1
RECMUS.txt,937077,937353,276,10,N,N,-,-1,-1
RECMUS.txt,937092,937394,302,10,N,N,-,-1,-1
RECMUS.txt,937116,937440,324,10,N,N,-,-1,-1
RECMUS.txt,937152,937465,313,10,N,N,-,-1,-1
RECMUS.txt,937169,937553,384,10,N,N,-,-1,-1
RECMUS.txt,937216,937563,347,10,N,N,-,-1,-1
RECMUS.txt,937268,937608,340,10,N,N,-,-1,-1
RECMUS.txt,937285,937633,348,10,N,N,-,-1,-1
RECMUS.txt,937326,937642,316,10,N,N,-,-1,-1
RECMUS.txt,937344,937664,320,10,N,N,-,-1,-1
RECMUS.txt,937354,937705,351,10,N,N,-,-1,-1
RECMUS.txt,937395,937728,333,10,N,N,-,-1,-1
RECMUS.txt,937441,937737,296,10,N,N,-,-1,-1
RECMUS.txt,937466,937752,286,10,N,N,-,-1,-1
RECMUS.txt,937556,937807,251,10,N,N,-,-1,-1
RECMUS.txt,937564,937900,336,10,N,N,-,-1,-1
RECMUS.txt,937609,937909,300,10,N,N,-,-1,-1
RECMUS.txt,937635,937952,317,10,N,N,-,-1,-1
RECMUS.txt,937643,937976,333,10,N,N,-,-1,-1
RECMUS.txt,937665,937996,331,10,N,N,-,-1,-1
RECMUS.txt,937706,938005,299,10,N,N,-,-1,-1
RECMUS.txt,937730,938045,315,10,N,N,-,-1,-1
RECMUS.txt,937738,938097,359,10,N,N,-,-1,-1
RECMUS.txt,937753,938112,359,10,N,N,-,-1,-1
RECMUS.txt,937808,938121,313,10,N,N,-,-1,-1
RECMUS.txt,937902,938181,279,10,N,N,-,-1,-1
RECMUS.txt,937910,938194,284,10,N,N,-,-1,-1
RECMUS.txt,937953,938214,261,10,N,N,-,-1,-1
RECMUS.txt,937977,938223,246,10,N,N,-,-1,-1
RECMUS.txt,937998,938298,300,10,N,N,-,-1,-1
RECMUS.txt,938006,938318,312,10,N,N,-,-1,-1
RECMUS.txt,938046,938329,283,10,N,N,-,-1,-1
RECMUS.txt,938098,938375,277,10,N,N,-,-1,-1
RECMUS.txt,938114,938401,287,10,N,N,-,-1,-1
RECMUS.txt,938122,938466,344,10,N,N,-,-1,-1
RECMUS.txt,938184,938552,368,10,N,N,-,-1,-1
RECMUS.txt,938195,938575,380,10,N,N,-,-1,-1
RECMUS.txt,938216,938584,368,10,N,N,-,-1,-1
RECMUS.txt,938224,938598,374,10,N,N,-,-1,-1
RECMUS.txt,938299,938609,310,10,N,N,-,-1,-1
RECMUS.txt,938320,938635,315,10,N,N,-,-1,-1
RECMUS.txt,938330,938657,327,10,N,N,-,-1,-1
RECMUS.txt,938376,938666,290,10,N,N,-,-1,-1
RECMUS.txt,938402,938715,313,10,N,N,-,-1,-1
RECMUS.txt,938467,938804,337,10,N,N,-,-1,-1
RECMUS.txt,938553,938827,274,10,N,N,-,-1,-1
RECMUS.txt,938577,938836,259,10,N,N,-,-1,-1
RECMUS.txt,938585,938861,276,10,N,N,-,-1,-1
RECMUS.txt,938599,938925,326,10,N,N,-,-1,-1
RECMUS.txt,938610,938992,382,10,N,N,-,-1,-1
RECMUS.txt,938638,938993,355,10,N,N,-,-1,-1
RECMUS.txt,938659,939018,359,10,N,N,-,-1,-1
RECMUS.txt,938667,939047,380,10,N,N,-,-1,-1
RECMUS.txt,938716,939098,382,10,N,N,-,-1,-1
RECMUS.txt,938805,939143,338,10,N,N,-,-1,-1
RECMUS.txt,938829,939164,335,10,N,N,-,-1,-1
RECMUS.txt,938837,939217,380,10,N,N,-,-1,-1
RECMUS.txt,938862,939233,371,10,N,N,-,-1,-1
RECMUS.txt,938930,939318,388,10,N,N,-,-1,-1
RECMUS.txt,938992,939366,374,10,N,N,-,-1,-1
RECMUS.txt,938996,939386,390,10,N,N,-,-1,-1
RECMUS.txt,939019,939401,382,10,N,N,-,-1,-1
RECMUS.txt,939050,939441,391,10,N,N,-,-1,-1
RECMUS.txt,939099,939465,366,10,N,N,-,-1,-1
RECMUS.txt,939145,939494,349,10,N,N,-,-1,-1
RECMUS.txt,939165,939509,344,10,N,N,-,-1,-1
RECMUS.txt,939218,939578,360,10,N,N,-,-1,-1
RECMUS.txt,939235,939598,363,10,N,N,-,-1,-1
RECMUS.txt,939319,939621,302,10,N,N,-,-1,-1
RECMUS.txt,939367,939636,269,10,N,N,-,-1,-1
RECMUS.txt,939388,939661,273,10,N,N,-,-1,-1
RECMUS.txt,939402,939683,281,10,N,N,-,-1,-1
RECMUS.txt,939444,939756,312,10,N,N,-,-1,-1
RECMUS.txt,939466,939832,366,10,N,N,-,-1,-1
RECMUS.txt,939496,939870,374,10,N,N,-,-1,-1
RECMUS.txt,939510,939929,419,10,N,N,-,-1,-1
RECMUS.txt,939579,939949,370,10,N,N,-,-1,-1
RECMUS.txt,939600,939964,364,10,N,N,-,-1,-1
RECMUS.txt,939622,939995,373,10,N,N,-,-1,-1
RECMUS.txt,939637,940013,376,10,N,N,-,-1,-1
RECMUS.txt,939662,940043,381,10,N,N,-,-1,-1
RECMUS.txt,939685,940065,380,10,N,N,-,-1,-1
RECMUS.txt,939757,940080,323,10,N,N,-,-1,-1
RECMUS.txt,939833,940102,269,10,N,N,-,-1,-1
RECMUS.txt,939872,940125,253,10,N,N,-,-1,-1
RECMUS.txt,939932,940142,210,10,N,N,-,-1,-1
RECMUS.txt,939951,940181,230,10,N,N,-,-1,-1
RECMUS.txt,939965,940242,277,10,N,N,-,-1,-1
RECMUS.txt,939996,940265,269,10,N,N,-,-1,-1
RECMUS.txt,940014,940293,279,10,N,N,-,-1,-1
RECMUS.txt,940045,940341,296,10,N,N,-,-1,-1
RECMUS.txt,940066,940358,292,10,N,N,-,-1,-1
RECMUS.txt,940081,940441,360,10,N,N,-,-1,-1
RECMUS.txt,940104,940463,359,10,N,N,-,-1,-1
RECMUS.txt,940126,940519,393,10,N,N,-,-1,-1
RECMUS.txt,940143,940554,411,10,N,N,-,-1,-1
RECMUS.txt,940183,940607,424,10,N,N,-,-1,-1
RECMUS.txt,940245,940624,379,10,N,N,-,-1,-1
RECMUS.txt,940267,940641,374,10,N,N,-,-1,-1
RECMUS.txt,940294,940730,436,10,N,N,-,-1,-1
RECMUS.txt,940342,940752,410,10,N,N,-,-1,-1
RECMUS.txt,940359,940779,420,10,N,N,-,-1,-1
RECMUS.txt,940442,940806,364,10,N,N,-,-1,-1
RECMUS.txt,940465,940824,359,10,N,N,-,-1,-1
RECMUS.txt,940522,940838,316,10,N,N,-,-1,-1
RECMUS.txt,940555,940859,304,10,N,N,-,-1,-1
RECMUS.txt,940608,940904,296,10,N,N,-,-1,-1
RECMUS.txt,940625,940921,296,10,N,N,-,-1,-1
RECMUS.txt,940643,940944,301,10,N,N,-,-1,-1
RECMUS.txt,940731,940956,225,10,N,N,-,-1,-1
RECMUS.txt,940754,940971,217,10,N,N,-,-1,-1
RECMUS.txt,940780,940990,210,10,N,N,-,-1,-1
RECMUS.txt,940809,941023,214,10,N,N,-,-1,-1
RECMUS.txt,940825,941098,273,10,N,N,-,-1,-1
RECMUS.txt,940839,941130,291,10,N,N,-,-1,-1
RECMUS.txt,940861,941139,278,10,N,N,-,-1,-1
RECMUS.txt,940905,941156,251,10,N,N,-,-1,-1
RECMUS.txt,940922,941208,286,10,N,N,-,-1,-1
RECMUS.txt,940946,941231,285,10,N,N,-,-1,-1
RECMUS.txt,940957,941239,282,10,N,N,-,-1,-1
RECMUS.txt,940972,941246,274,10,N,N,-,-1,-1
RECMUS.txt,940992,941253,261,10,N,N,-,-1,-1
RECMUS.txt,941024,941260,236,10,N,N,-,-1,-1
RECMUS.txt,941099,941267,168,10,N,N,-,-1,-1
RECMUS.txt,941132,941274,142,10,N,N,-,-1,-1
RECMUS.txt,941140,941281,141,10,N,N,-,-1,-1
RECMUS.txt,941157,941288,131,10,N,N,-,-1,-1
RECMUS.txt,941209,941295,86,10,N,N,-,-1,-1
RECMUS.txt,941236,941302,66,10,N,N,-,-1,-1
RECMUS.txt,941243,941309,66,10,N,N,-,-1,-1
RECMUS.txt,941250,941323,73,10,N,N,-,-1,-1
RECMUS.txt,941257,941330,73,10,N,N,-,-1,-1
RECMUS.txt,941264,941337,73,10,N,N,-,-1,-1
RECMUS.txt,941271,941344,73,10,N,N,-,-1,-1
RECMUS.txt,941278,941351,73,10,N,N,-,-1,-1
RECMUS.txt,941285,941358,73,10,N,N,-,-1,-1
RECMUS.txt,941292,941365,73,10,N,N,-,-1,-1
RECMUS.txt,941299,941370,71,10,N,N,-,-1,-1
RECMUS.txt,941306,941382,76,10,N,N,-,-1,-1
RECMUS.txt,941313,941389,76,10,N,N,-,-1,-1
RECMUS.txt,941327,941403,76,10,N,N,-,-1,-1
RECMUS.txt,941334,941410,76,10,N,N,-,-1,-1
RECMUS.txt,941341,941417,76,10,N,N,-,-1,-1
RECMUS.txt,941348,941424,76,10,N,N,-,-1,-1
RECMUS.txt,941355,941431,76,10,N,N,-,-1,-1
RECMUS.txt,941362,941438,76,10,N,N,-,-1,-1
RECMUS.txt,941367,941445,78,10,N,N,-,-1,-1
RECMUS.txt,941374,941459,85,10,N,N,-,-1,-1
RECMUS.txt,941386,941466,80,10,N,N,-,-1,-1
RECMUS.txt,941393,941473,80,10,N,N,-,-1,-1
RECMUS.txt,941407,941480,73,10,N,N,-,-1,-1
RECMUS.txt,941414,941487,73,10,N,N,-,-1,-1
RECMUS.txt,941421,941492,71,10,N,N,-,-1,-1
RECMUS.txt,941428,941499,71,10,N,N,-,-1,-1
RECMUS.txt,941435,941505,70,10,N,N,-,-1,-1
RECMUS.txt,941442,941536,94,10,N,N,-,-1,-1
RECMUS.txt,941449,941599,150,10,N,N,-,-1,-1
RECMUS.txt,941463,941614,151,10,N,N,-,-1,-1
RECMUS.txt,941470,941633,163,10,N,N,-,-1,-1
RECMUS.txt,941477,941643,166,10,N,N,-,-1,-1
RECMUS.txt,941484,941665,181,10,N,N,-,-1,-1
RECMUS.txt,941489,941686,197,10,N,N,-,-1,-1
RECMUS.txt,941496,941704,208,10,N,N,-,-1,-1
RECMUS.txt,941502,941714,212,10,N,N,-,-1,-1
RECMUS.txt,941510,941821,311,10,N,N,-,-1,-1
RECMUS.txt,941537,941844,307,10,N,N,-,-1,-1
RECMUS.txt,941600,941854,254,10,N,N,-,-1,-1
RECMUS.txt,941615,941896,281,10,N,N,-,-1,-1
RECMUS.txt,941636,941911,275,10,N,N,-,-1,-1
RECMUS.txt,941644,941931,287,10,N,N,-,-1,-1
RECMUS.txt,941666,941941,275,10,N,N,-,-1,-1
RECMUS.txt,941687,941962,275,10,N,N,-,-1,-1
RECMUS.txt,941707,941978,271,10,N,N,-,-1,-1
RECMUS.txt,941715,942039,324,10,N,N,-,-1,-1
RECMUS.txt,941822,942062,240,10,N,N,-,-1,-1
RECMUS.txt,941847,942100,253,10,N,N,-,-1,-1
RECMUS.txt,941855,942110,255,10,N,N,-,-1,-1
RECMUS.txt,941897,942152,255,10,N,N,-,-1,-1
RECMUS.txt,941913,942172,259,10,N,N,-,-1,-1
RECMUS.txt,941934,942182,248,10,N,N,-,-1,-1
RECMUS.txt,941942,942236,294,10,N,N,-,-1,-1
RECMUS.txt,941963,942248,285,10,N,N,-,-1,-1
RECMUS.txt,941979,942267,288,10,N,N,-,-1,-1
RECMUS.txt,942040,942277,237,10,N,N,-,-1,-1
RECMUS.txt,942063,942281,218,10,N,N,-,-1,-1
RECMUS.txt,942103,942371,268,10,N,N,-,-1,-1
RECMUS.txt,942111,942386,275,10,N,N,-,-1,-1
RECMUS.txt,942153,942406,253,10,N,N,-,-1,-1
RECMUS.txt,942175,942416,241,10,N,N,-,-1,-1
RECMUS.txt,942183,942423,240,10,N,N,-,-1,-1
RECMUS.txt,942237,942443,206,10,N,N,-,-1,-1
RECMUS.txt,942249,942465,216,10,N,N,-,-1,-1
RECMUS.txt,942270,942481,211,10,N,N,-,-1,-1
RECMUS.txt,942278,942490,212,10,N,N,-,-1,-1
RECMUS.txt,942282,942500,218,10,N,N,-,-1,-1
RECMUS.txt,942372,942507,135,10,N,N,-,-1,-1
RECMUS.txt,942387,942529,142,10,N,N,-,-1,-1
RECMUS.txt,942409,942566,157,10,N,N,-,-1,-1
RECMUS.txt,942417,942575,158,10,N,N,-,-1,-1
RECMUS.txt,942424,942585,161,10,N,N,-,-1,-1
RECMUS.txt,942444,942639,195,10,N,N,-,-1,-1
RECMUS.txt,942466,942651,185,10,N,N,-,-1,-1
RECMUS.txt,942482,942660,178,10,N,N,-,-1,-1
RECMUS.txt,942493,942670,177,10,N,N,-,-1,-1
RECMUS.txt,942501,942694,193,10,N,N,-,-1,-1
RECMUS.txt,942508,942721,213,10,N,N,-,-1,-1
RECMUS.txt,942530,942730,200,10,N,N,-,-1,-1
RECMUS.txt,942567,942740,173,10,N,N,-,-1,-1
RECMUS.txt,942578,942762,184,10,N,N,-,-1,-1
RECMUS.txt,942586,942796,210,10,N,N,-,-1,-1
RECMUS.txt,942640,942844,204,10,N,N,-,-1,-1
RECMUS.txt,942652,942867,215,10,N,N,-,-1,-1
RECMUS.txt,942663,942894,231,10,N,N,-,-1,-1
RECMUS.txt,942671,942906,235,10,N,N,-,-1,-1
RECMUS.txt,942695,942923,228,10,N,N,-,-1,-1
RECMUS.txt,942722,942986,264,10,N,N,-,-1,-1
RECMUS.txt,942733,943002,269,10,N,N,-,-1,-1
RECMUS.txt,942741,943024,283,10,N,N,-,-1,-1
RECMUS.txt,942763,943034,271,10,N,N,-,-1,-1
RECMUS.txt,942798,943054,256,10,N,N,-,-1,-1
RECMUS.txt,942845,943100,255,10,N,N,-,-1,-1
RECMUS.txt,942868,943122,254,10,N,N,-,-1,-1
RECMUS.txt,942897,943132,235,10,N,N,-,-1,-1
RECMUS.txt,942907,943164,257,10,N,N,-,-1,-1
RECMUS.txt,942924,943196,272,10,N,N,-,-1,-1
RECMUS.txt,942987,943218,231,10,N,N,-,-1,-1
RECMUS.txt,943003,943228,225,10,N,N,-,-1,-1
RECMUS.txt,943027,943248,221,10,N,N,-,-1,-1
RECMUS.txt,943035,943280,245,10,N,N,-,-1,-1
RECMUS.txt,943055,943302,247,10,N,N,-,-1,-1
RECMUS.txt,943101,943312,211,10,N,N,-,-1,-1
RECMUS.txt,943125,943350,225,10,N,N,-,-1,-1
RECMUS.txt,943133,943388,255,10,N,N,-,-1,-1
RECMUS.txt,943165,943407,242,10,N,N,-,-1,-1
RECMUS.txt,943197,943441,244,10,N,N,-,-1,-1
RECMUS.txt,943221,943451,230,10,N,N,-,-1,-1
RECMUS.txt,943229,943493,264,10,N,N,-,-1,-1
RECMUS.txt,943249,943515,266,10,N,N,-,-1,-1
RECMUS.txt,943281,943548,267,10,N,N,-,-1,-1
RECMUS.txt,943305,943559,254,10,N,N,-,-1,-1
RECMUS.txt,943313,943568,255,10,N,N,-,-1,-1
RECMUS.txt,943351,943604,253,10,N,N,-,-1,-1
RECMUS.txt,943389,943625,236,10,N,N,-,-1,-1
RECMUS.txt,943408,943634,226,10,N,N,-,-1,-1
RECMUS.txt,943444,943644,200,10,N,N,-,-1,-1
RECMUS.txt,943452,943670,218,10,N,N,-,-1,-1
RECMUS.txt,943494,943705,211,10,N,N,-,-1,-1
RECMUS.txt,943518,943732,214,10,N,N,-,-1,-1
RECMUS.txt,943549,943741,192,10,N,N,-,-1,-1
RECMUS.txt,943560,943772,212,10,N,N,-,-1,-1
RECMUS.txt,943571,943782,211,10,N,N,-,-1,-1
RECMUS.txt,943605,943794,189,10,N,N,-,-1,-1
RECMUS.txt,943626,943856,230,10,N,N,-,-1,-1
RECMUS.txt,943637,943865,228,10,N,N,-,-1,-1
RECMUS.txt,943645,943921,276,10,N,N,-,-1,-1
RECMUS.txt,943671,943932,261,10,N,N,-,-1,-1
RECMUS.txt,943706,943963,257,10,N,N,-,-1,-1
RECMUS.txt,943733,943972,239,10,N,N,-,-1,-1
RECMUS.txt,943742,944007,265,10,N,N,-,-1,-1
RECMUS.txt,943775,944028,253,10,N,N,-,-1,-1
RECMUS.txt,943783,944037,254,10,N,N,-,-1,-1
RECMUS.txt,943795,944069,274,10,N,N,-,-1,-1
RECMUS.txt,943857,944147,290,10,N,N,-,-1,-1
RECMUS.txt,943870,944156,286,10,N,N,-,-1,-1
RECMUS.txt,943922,944166,244,10,N,N,-,-1,-1
RECMUS.txt,943933,944192,259,10,N,N,-,-1,-1
RECMUS.txt,943964,944237,273,10,N,N,-,-1,-1
RECMUS.txt,943975,944257,282,10,N,N,-,-1,-1
RECMUS.txt,944008,944292,284,10,N,N,-,-1,-1
RECMUS.txt,944029,944327,298,10,N,N,-,-1,-1
RECMUS.txt,944040,944410,370,10,N,N,-,-1,-1
RECMUS.txt,944070,944430,360,10,N,N,-,-1,-1
RECMUS.txt,944148,944458,310,10,N,N,-,-1,-1
RECMUS.txt,944159,944599,440,10,N,N,-,-1,-1
RECMUS.txt,944167,944647,480,10,N,N,-,-1,-1
RECMUS.txt,944193,944656,463,10,N,N,-,-1,-1
RECMUS.txt,944238,944695,457,10,N,N,-,-1,-1
RECMUS.txt,944258,944716,458,10,N,N,-,-1,-1
RECMUS.txt,944295,944726,431,10,N,N,-,-1,-1
RECMUS.txt,944327,944740,413,10,N,N,-,-1,-1
RECMUS.txt,944411,944813,402,10,N,N,-,-1,-1
RECMUS.txt,944433,944822,389,10,N,N,-,-1,-1
RECMUS.txt,944459,944852,393,10,N,N,-,-1,-1
RECMUS.txt,944600,944862,262,10,N,N,-,-1,-1
RECMUS.txt,944648,944873,225,10,N,N,-,-1,-1
RECMUS.txt,944657,944888,231,10,N,N,-,-1,-1
RECMUS.txt,944696,944897,201,10,N,N,-,-1,-1
RECMUS.txt,944719,944907,188,10,N,N,-,-1,-1
RECMUS.txt,944727,944937,210,10,N,N,-,-1,-1
RECMUS.txt,944741,944964,223,10,N,N,-,-1,-1
RECMUS.txt,944814,944985,171,10,N,N,-,-1,-1
RECMUS.txt,944823,944999,176,10,N,N,-,-1,-1
RECMUS.txt,944855,945022,167,10,N,N,-,-1,-1
RECMUS.txt,944863,945033,170,10,N,N,-,-1,-1
RECMUS.txt,944874,945102,228,10,N,N,-,-1,-1
RECMUS.txt,944889,945121,232,10,N,N,-,-1,-1
RECMUS.txt,944900,945151,251,10,N,N,-,-1,-1
RECMUS.txt,944908,945161,253,10,N,N,-,-1,-1
RECMUS.txt,944938,945179,241,10,N,N,-,-1,-1
RECMUS.txt,944966,945211,245,10,N,N,-,-1,-1
RECMUS.txt,944986,945221,235,10,N,N,-,-1,-1
RECMUS.txt,945000,945251,251,10,N,N,-,-1,-1
RECMUS.txt,945025,945261,236,10,N,N,-,-1,-1
RECMUS.txt,945034,945282,248,10,N,N,-,-1,-1
RECMUS.txt,945103,945315,212,10,N,N,-,-1,-1
RECMUS.txt,945122,945338,216,10,N,N,-,-1,-1
RECMUS.txt,945154,945426,272,10,N,N,-,-1,-1
RECMUS.txt,945162,945445,283,10,N,N,-,-1,-1
RECMUS.txt,945180,945570,390,10,N,N,-,-1,-1
RECMUS.txt,945213,945580,367,10,N,N,-,-1,-1
RECMUS.txt,945222,945590,368,10,N,N,-,-1,-1
RECMUS.txt,945254,945684,430,10,N,N,-,-1,-1
RECMUS.txt,945262,945693,431,10,N,N,-,-1,-1
RECMUS.txt,945283,945883,600,10,N,N,-,-1,-1
RECMUS.txt,945316,945893,577,10,N,N,-,-1,-1
RECMUS.txt,945341,945919,578,10,N,N,-,-1,-1
RECMUS.txt,945427,945963,536,10,N,N,-,-1,-1
RECMUS.txt,945448,945983,535,10,N,N,-,-1,-1
RECMUS.txt,945572,945993,421,10,N,N,-,-1,-1
RECMUS.txt,945583,946038,455,10,N,N,-,-1,-1
RECMUS.txt,945591,946058,467,10,N,N,-,-1,-1
RECMUS.txt,945685,946084,399,10,N,N,-,-1,-1
RECMUS.txt,945696,946130,434,10,N,N,-,-1,-1
RECMUS.txt,945886,946140,254,10,N,N,-,-1,-1
RECMUS.txt,945894,946222,328,10,N,N,-,-1,-1
RECMUS.txt,945920,946253,333,10,N,N,-,-1,-1
RECMUS.txt,945964,946267,303,10,N,N,-,-1,-1
RECMUS.txt,945986,946300,314,10,N,N,-,-1,-1
RECMUS.txt,945994,946317,323,10,N,N,-,-1,-1
RECMUS.txt,946039,946328,289,10,N,N,-,-1,-1
RECMUS.txt,946059,946336,277,10,N,N,-,-1,-1
RECMUS.txt,946085,946351,266,10,N,N,-,-1,-1
RECMUS.txt,946133,946370,237,10,N,N,-,-1,-1
RECMUS.txt,946141,946398,257,10,N,N,-,-1,-1
RECMUS.txt,946223,946431,208,10,N,N,-,-1,-1
RECMUS.txt,946254,946436,182,10,N,N,-,-1,-1
RECMUS.txt,946268,946470,202,10,N,N,-,-1,-1
RECMUS.txt,946301,946485,184,10,N,N,-,-1,-1
RECMUS.txt,946320,946507,187,10,N,N,-,-1,-1
RECMUS.txt,946329,946513,184,10,N,N,-,-1,-1
RECMUS.txt,946337,946518,181,10,N,N,-,-1,-1
RECMUS.txt,946352,946535,183,10,N,N,-,-1,-1
RECMUS.txt,946371,946601,230,10,N,N,-,-1,-1
RECMUS.txt,946403,946620,217,10,N,N,-,-1,-1
RECMUS.txt,946432,946641,209,10,N,N,-,-1,-1
RECMUS.txt,946437,946656,219,10,N,N,-,-1,-1
RECMUS.txt,946471,946665,194,10,N,N,-,-1,-1
RECMUS.txt,946486,946676,190,10,N,N,-,-1,-1
RECMUS.txt,946510,946687,177,10,N,N,-,-1,-1
RECMUS.txt,946514,946702,188,10,N,N,-,-1,-1
RECMUS.txt,946519,946711,192,10,N,N,-,-1,-1
RECMUS.txt,946536,946722,186,10,N,N,-,-1,-1
RECMUS.txt,946602,946786,184,10,N,N,-,-1,-1
RECMUS.txt,946623,946802,179,10,N,N,-,-1,-1
RECMUS.txt,946642,946813,171,10,N,N,-,-1,-1
RECMUS.txt,946657,946942,285,10,N,N,-,-1,-1
RECMUS.txt,946668,946961,293,10,N,N,-,-1,-1
RECMUS.txt,946677,946972,295,10,N,N,-,-1,-1
RECMUS.txt,946688,947047,359,10,N,N,-,-1,-1
RECMUS.txt,946703,947107,404,10,N,N,-,-1,-1
RECMUS.txt,946714,947116,402,10,N,N,-,-1,-1
RECMUS.txt,946723,947127,404,10,N,N,-,-1,-1
RECMUS.txt,946787,947227,440,10,N,N,-,-1,-1
RECMUS.txt,946805,947236,431,10,N,N,-,-1,-1
RECMUS.txt,946814,947247,433,10,N,N,-,-1,-1
RECMUS.txt,946943,947338,395,10,N,N,-,-1,-1
RECMUS.txt,946964,947360,396,10,N,N,-,-1,-1
RECMUS.txt,946973,947446,473,10,N,N,-,-1,-1
RECMUS.txt,947048,947461,413,10,N,N,-,-1,-1
RECMUS.txt,947108,947483,375,10,N,N,-,-1,-1
RECMUS.txt,947119,947489,370,10,N,N,-,-1,-1
RECMUS.txt,947128,947493,365,10,N,N,-,-1,-1
RECMUS.txt,947228,947511,283,10,N,N,-,-1,-1
RECMUS.txt,947239,947526,287,10,N,N,-,-1,-1
RECMUS.txt,947248,947537,289,10,N,N,-,-1,-1
RECMUS.txt,947339,947543,204,10,N,N,-,-1,-1
RECMUS.txt,947363,947548,185,10,N,N,-,-1,-1
RECMUS.txt,947447,947576,129,10,N,N,-,-1,-1
RECMUS.txt,947462,947591,129,10,N,N,-,-1,-1
RECMUS.txt,947486,947610,124,10,N,N,-,-1,-1
RECMUS.txt,947490,947688,198,10,N,N,-,-1,-1
RECMUS.txt,947494,947699,205,10,N,N,-,-1,-1
RECMUS.txt,947512,947748,236,10,N,N,-,-1,-1
RECMUS.txt,947527,947773,246,10,N,N,-,-1,-1
RECMUS.txt,947540,947784,244,10,N,N,-,-1,-1
RECMUS.txt,947544,947824,280,10,N,N,-,-1,-1
RECMUS.txt,947549,947889,340,10,N,N,-,-1,-1
RECMUS.txt,947577,947909,332,10,N,N,-,-1,-1
RECMUS.txt,947592,947920,328,10,N,N,-,-1,-1
RECMUS.txt,947611,947945,334,10,N,N,-,-1,-1
RECMUS.txt,947691,947997,306,10,N,N,-,-1,-1
RECMUS.txt,947700,948006,306,10,N,N,-,-1,-1
RECMUS.txt,947749,948017,268,10,N,N,-,-1,-1
RECMUS.txt,947776,948033,257,10,N,N,-,-1,-1
RECMUS.txt,947785,948059,274,10,N,N,-,-1,-1
RECMUS.txt,947825,948094,269,10,N,N,-,-1,-1
RECMUS.txt,947890,948103,213,10,N,N,-,-1,-1
RECMUS.txt,947912,948114,202,10,N,N,-,-1,-1
RECMUS.txt,947921,948127,206,10,N,N,-,-1,-1
RECMUS.txt,947946,948146,200,10,N,N,-,-1,-1
RECMUS.txt,947998,948203,205,10,N,N,-,-1,-1
RECMUS.txt,948009,948212,203,10,N,N,-,-1,-1
RECMUS.txt,948018,948223,205,10,N,N,-,-1,-1
RECMUS.txt,948034,948266,232,10,N,N,-,-1,-1
RECMUS.txt,948060,948305,245,10,N,N,-,-1,-1
RECMUS.txt,948095,948358,263,10,N,N,-,-1,-1
RECMUS.txt,948106,948377,271,10,N,N,-,-1,-1
RECMUS.txt,948115,948386,271,10,N,N,-,-1,-1
RECMUS.txt,948128,948397,269,10,N,N,-,-1,-1
RECMUS.txt,948147,948410,263,10,N,N,-,-1,-1
RECMUS.txt,948204,948426,222,10,N,N,-,-1,-1
RECMUS.txt,948215,948435,220,10,N,N,-,-1,-1
RECMUS.txt,948224,948446,222,10,N,N,-,-1,-1
RECMUS.txt,948267,948488,221,10,N,N,-,-1,-1
RECMUS.txt,948306,948583,277,10,N,N,-,-1,-1
RECMUS.txt,948359,948592,233,10,N,N,-,-1,-1
RECMUS.txt,948378,948603,225,10,N,N,-,-1,-1
RECMUS.txt,948389,948625,236,10,N,N,-,-1,-1
RECMUS.txt,948398,948636,238,10,N,N,-,-1,-1
RECMUS.txt,948411,948645,234,10,N,N,-,-1,-1
RECMUS.txt,948427,948656,229,10,N,N,-,-1,-1
RECMUS.txt,948438,948664,226,10,N,N,-,-1,-1
RECMUS.txt,948447,948737,290,10,N,N,-,-1,-1
RECMUS.txt,948489,948746,257,10,N,N,-,-1,-1
RECMUS.txt,948584,948757,173,10,N,N,-,-1,-1
RECMUS.txt,948595,948789,194,10,N,N,-,-1,-1
RECMUS.txt,948604,948813,209,10,N,N,-,-1,-1
RECMUS.txt,948626,948830,204,10,N,N,-,-1,-1
RECMUS.txt,948637,948841,204,10,N,N,-,-1,-1
RECMUS.txt,948648,948858,210,10,N,N,-,-1,-1
RECMUS.txt,948657,948896,239,10,N,N,-,-1,-1
RECMUS.txt,948665,948918,253,10,N,N,-,-1,-1
RECMUS.txt,948738,948931,193,10,N,N,-,-1,-1
RECMUS.txt,948749,948959,210,10,N,N,-,-1,-1
RECMUS.txt,948758,949006,248,10,N,N,-,-1,-1
RECMUS.txt,948790,949040,250,10,N,N,-,-1,-1
RECMUS.txt,948815,949055,240,10,N,N,-,-1,-1
RECMUS.txt,948833,949068,235,10,N,N,-,-1,-1
RECMUS.txt,948842,949132,290,10,N,N,-,-1,-1
RECMUS.txt,948859,949151,292,10,N,N,-,-1,-1
RECMUS.txt,948898,949162,264,10,N,N,-,-1,-1
RECMUS.txt,948921,949183,262,10,N,N,-,-1,-1
RECMUS.txt,948932,949194,262,10,N,N,-,-1,-1
RECMUS.txt,948960,949212,252,10,N,N,-,-1,-1
RECMUS.txt,949011,949223,212,10,N,N,-,-1,-1
RECMUS.txt,949041,949232,191,10,N,N,-,-1,-1
RECMUS.txt,949056,949247,191,10,N,N,-,-1,-1
RECMUS.txt,949069,949264,195,10,N,N,-,-1,-1
RECMUS.txt,949133,949275,142,10,N,N,-,-1,-1
RECMUS.txt,949154,949338,184,10,N,N,-,-1,-1
RECMUS.txt,949163,949357,194,10,N,N,-,-1,-1
RECMUS.txt,949184,949368,184,10,N,N,-,-1,-1
RECMUS.txt,949195,949379,184,10,N,N,-,-1,-1
RECMUS.txt,949215,949418,203,10,N,N,-,-1,-1
RECMUS.txt,949224,949434,210,10,N,N,-,-1,-1
RECMUS.txt,949233,949464,231,10,N,N,-,-1,-1
RECMUS.txt,949248,949475,227,10,N,N,-,-1,-1
RECMUS.txt,949267,949527,260,10,N,N,-,-1,-1
RECMUS.txt,949276,949552,276,10,N,N,-,-1,-1
RECMUS.txt,949339,949577,238,10,N,N,-,-1,-1
RECMUS.txt,949360,949597,237,10,N,N,-,-1,-1
RECMUS.txt,949369,949608,239,10,N,N,-,-1,-1
RECMUS.txt,949380,949650,270,10,N,N,-,-1,-1
RECMUS.txt,949419,949659,240,10,N,N,-,-1,-1
RECMUS.txt,949435,949670,235,10,N,N,-,-1,-1
RECMUS.txt,949467,949738,271,10,N,N,-,-1,-1
RECMUS.txt,949476,949892,416,10,N,N,-,-1,-1
RECMUS.txt,949529,949903,374,10,N,N,-,-1,-1
RECMUS.txt,949553,949922,369,10,N,N,-,-1,-1
RECMUS.txt,949579,949937,358,10,N,N,-,-1,-1
RECMUS.txt,949600,949968,368,10,N,N,-,-1,-1
RECMUS.txt,949609,949979,370,10,N,N,-,-1,-1
RECMUS.txt,949651,949988,337,10,N,N,-,-1,-1
RECMUS.txt,949662,950003,341,10,N,N,-,-1,-1
RECMUS.txt,949671,950026,355,10,N,N,-,-1,-1
RECMUS.txt,949739,950037,298,10,N,N,-,-1,-1
RECMUS.txt,949895,950066,171,10,N,N,-,-1,-1
RECMUS.txt,949904,950091,187,10,N,N,-,-1,-1
RECMUS.txt,949923,950102,179,10,N,N,-,-1,-1
RECMUS.txt,949938,950119,181,10,N,N,-,-1,-1
RECMUS.txt,949971,950136,165,10,N,N,-,-1,-1
RECMUS.txt,949980,950204,224,10,N,N,-,-1,-1
RECMUS.txt,949989,950215,226,10,N,N,-,-1,-1
RECMUS.txt,950004,950250,246,10,N,N,-,-1,-1
RECMUS.txt,950029,950378,349,10,N,N,-,-1,-1
RECMUS.txt,950038,950436,398,10,N,N,-,-1,-1
RECMUS.txt,950067,950456,389,10,N,N,-,-1,-1
RECMUS.txt,950094,950467,373,10,N,N,-,-1,-1
RECMUS.txt,950103,950497,394,10,N,N,-,-1,-1
RECMUS.txt,950120,950575,455,10,N,N,-,-1,-1
RECMUS.txt,950137,950585,448,10,N,N,-,-1,-1
RECMUS.txt,950207,950598,391,10,N,N,-,-1,-1
RECMUS.txt,950216,950656,440,10,N,N,-,-1,-1
RECMUS.txt,950251,950674,423,10,N,N,-,-1,-1
RECMUS.txt,950380,950685,305,10,N,N,-,-1,-1
RECMUS.txt,950438,950700,262,10,N,N,-,-1,-1
RECMUS.txt,950459,950760,301,10,N,N,-,-1,-1
RECMUS.txt,950468,950779,311,10,N,N,-,-1,-1
RECMUS.txt,950498,950790,292,10,N,N,-,-1,-1
RECMUS.txt,950577,950833,256,10,N,N,-,-1,-1
RECMUS.txt,950588,950850,262,10,N,N,-,-1,-1
RECMUS.txt,950599,950861,262,10,N,N,-,-1,-1
RECMUS.txt,950658,950905,247,10,N,N,-,-1,-1
RECMUS.txt,950677,950924,247,10,N,N,-,-1,-1
RECMUS.txt,950686,950955,269,10,N,N,-,-1,-1
RECMUS.txt,950701,950960,259,10,N,N,-,-1,-1
RECMUS.txt,950761,950983,222,10,N,N,-,-1,-1
RECMUS.txt,950782,951012,230,10,N,N,-,-1,-1
RECMUS.txt,950791,951032,241,10,N,N,-,-1,-1
RECMUS.txt,950834,951037,203,10,N,N,-,-1,-1
RECMUS.txt,950853,951098,245,10,N,N,-,-1,-1
RECMUS.txt,950862,951126,264,10,N,N,-,-1,-1
RECMUS.txt,950906,951131,225,10,N,N,-,-1,-1
RECMUS.txt,950929,951185,256,10,N,N,-,-1,-1
RECMUS.txt,950958,951202,244,10,N,N,-,-1,-1
RECMUS.txt,950961,951229,268,10,N,N,-,-1,-1
RECMUS.txt,950984,951253,269,10,N,N,-,-1,-1
RECMUS.txt,951013,951274,261,10,N,N,-,-1,-1
RECMUS.txt,951035,951293,258,10,N,N,-,-1,-1
RECMUS.txt,951038,951331,293,10,N,N,-,-1,-1
RECMUS.txt,951099,951336,237,10,N,N,-,-1,-1
RECMUS.txt,951129,951402,273,10,N,N,-,-1,-1
RECMUS.txt,951132,951419,287,10,N,N,-,-1,-1
RECMUS.txt,951186,951435,249,10,N,N,-,-1,-1
RECMUS.txt,951203,951440,237,10,N,N,-,-1,-1
RECMUS.txt,951230,951462,232,10,N,N,-,-1,-1
RECMUS.txt,951254,951489,235,10,N,N,-,-1,-1
RECMUS.txt,951275,951508,233,10,N,N,-,-1,-1
RECMUS.txt,951298,951513,215,10,N,N,-,-1,-1
RECMUS.txt,951334,951557,223,10,N,N,-,-1,-1
RECMUS.txt,951337,951624,287,10,N,N,-,-1,-1
RECMUS.txt,951405,951686,281,10,N,N,-,-1,-1
RECMUS.txt,951420,951718,298,10,N,N,-,-1,-1
RECMUS.txt,951438,951723,285,10,N,N,-,-1,-1
RECMUS.txt,951441,951756,315,10,N,N,-,-1,-1
RECMUS.txt,951463,951772,309,10,N,N,-,-1,-1
RECMUS.txt,951490,951820,330,10,N,N,-,-1,-1
RECMUS.txt,951511,951825,314,10,N,N,-,-1,-1
RECMUS.txt,951514,951864,350,10,N,N,-,-1,-1
RECMUS.txt,951558,951879,321,10,N,N,-,-1,-1
RECMUS.txt,951625,951900,275,10,N,N,-,-1,-1
RECMUS.txt,951687,951906,219,10,N,N,-,-1,-1
RECMUS.txt,951721,951922,201,10,N,N,-,-1,-1
RECMUS.txt,951724,951984,260,10,N,N,-,-1,-1
RECMUS.txt,951757,951993,236,10,N,N,-,-1,-1
RECMUS.txt,951773,951999,226,10,N,N,-,-1,-1
RECMUS.txt,951823,952042,219,10,N,N,-,-1,-1
RECMUS.txt,951826,952057,231,10,N,N,-,-1,-1
RECMUS.txt,951865,952081,216,10,N,N,-,-1,-1
RECMUS.txt,951882,952087,205,10,N,N,-,-1,-1
RECMUS.txt,951903,952147,244,10,N,N,-,-1,-1
RECMUS.txt,951907,952164,257,10,N,N,-,-1,-1
RECMUS.txt,951923,952182,259,10,N,N,-,-1,-1
RECMUS.txt,951985,952188,203,10,N,N,-,-1,-1
RECMUS.txt,951996,952228,232,10,N,N,-,-1,-1
RECMUS.txt,952000,952243,243,10,N,N,-,-1,-1
RECMUS.txt,952043,952266,223,10,N,N,-,-1,-1
RECMUS.txt,952060,952272,212,10,N,N,-,-1,-1
RECMUS.txt,952084,952309,225,10,N,N,-,-1,-1
RECMUS.txt,952088,952324,236,10,N,N,-,-1,-1
RECMUS.txt,952150,952345,195,10,N,N,-,-1,-1
RECMUS.txt,952165,952351,186,10,N,N,-,-1,-1
RECMUS.txt,952185,952456,271,10,N,N,-,-1,-1
RECMUS.txt,952189,952474,285,10,N,N,-,-1,-1
RECMUS.txt,952229,952480,251,10,N,N,-,-1,-1
RECMUS.txt,952244,952530,286,10,N,N,-,-1,-1
RECMUS.txt,952269,952548,279,10,N,N,-,-1,-1
RECMUS.txt,952273,952554,281,10,N,N,-,-1,-1
RECMUS.txt,952310,952609,299,10,N,N,-,-1,-1
RECMUS.txt,952325,952618,293,10,N,N,-,-1,-1
RECMUS.txt,952348,952624,276,10,N,N,-,-1,-1
RECMUS.txt,952352,952677,325,10,N,N,-,-1,-1
RECMUS.txt,952457,952694,237,10,N,N,-,-1,-1
RECMUS.txt,952477,952701,224,10,N,N,-,-1,-1
RECMUS.txt,952481,952707,226,10,N,N,-,-1,-1
RECMUS.txt,952531,952778,247,10,N,N,-,-1,-1
RECMUS.txt,952551,952799,248,10,N,N,-,-1,-1
RECMUS.txt,952555,952806,251,10,N,N,-,-1,-1
RECMUS.txt,952612,952812,200,10,N,N,-,-1,-1
RECMUS.txt,952621,952833,212,10,N,N,-,-1,-1
RECMUS.txt,952625,952848,223,10,N,N,-,-1,-1
RECMUS.txt,952678,952870,192,10,N,N,-,-1,-1
RECMUS.txt,952695,952876,181,10,N,N,-,-1,-1
RECMUS.txt,952704,952910,206,10,N,N,-,-1,-1
RECMUS.txt,952708,952951,243,10,N,N,-,-1,-1
RECMUS.txt,952779,953001,222,10,N,N,-,-1,-1
RECMUS.txt,952800,953016,216,10,N,N,-,-1,-1
RECMUS.txt,952809,953080,271,10,N,N,-,-1,-1
RECMUS.txt,952813,953086,273,10,N,N,-,-1,-1
RECMUS.txt,952834,953147,313,10,N,N,-,-1,-1
RECMUS.txt,952849,953172,323,10,N,N,-,-1,-1
RECMUS.txt,952873,953178,305,10,N,N,-,-1,-1
RECMUS.txt,952877,953205,328,10,N,N,-,-1,-1
RECMUS.txt,952911,953220,309,10,N,N,-,-1,-1
RECMUS.txt,952952,953234,282,10,N,N,-,-1,-1
RECMUS.txt,953002,953240,238,10,N,N,-,-1,-1
RECMUS.txt,953017,953271,254,10,N,N,-,-1,-1
RECMUS.txt,953083,953279,196,10,N,N,-,-1,-1
RECMUS.txt,953087,953285,198,10,N,N,-,-1,-1
RECMUS.txt,953150,953313,163,10,N,N,-,-1,-1
RECMUS.txt,953175,953328,153,10,N,N,-,-1,-1
RECMUS.txt,953179,953334,155,10,N,N,-,-1,-1
RECMUS.txt,953206,953364,158,10,N,N,-,-1,-1
RECMUS.txt,953221,953387,166,10,N,N,-,-1,-1
RECMUS.txt,953237,953393,156,10,N,N,-,-1,-1
RECMUS.txt,953241,953420,179,10,N,N,-,-1,-1
RECMUS.txt,953272,953438,166,10,N,N,-,-1,-1
RECMUS.txt,953282,953444,162,10,N,N,-,-1,-1
RECMUS.txt,953286,953475,189,10,N,N,-,-1,-1
RECMUS.txt,953314,953496,182,10,N,N,-,-1,-1
RECMUS.txt,953331,953515,184,10,N,N,-,-1,-1
RECMUS.txt,953335,953521,186,10,N,N,-,-1,-1
RECMUS.txt,953365,953564,199,10,N,N,-,-1,-1
RECMUS.txt,953390,953590,200,10,N,N,-,-1,-1
RECMUS.txt,953394,953602,208,10,N,N,-,-1,-1
RECMUS.txt,953421,953625,204,10,N,N,-,-1,-1
RECMUS.txt,953441,953644,203,10,N,N,-,-1,-1
RECMUS.txt,953445,953650,205,10,N,N,-,-1,-1
RECMUS.txt,953476,953731,255,10,N,N,-,-1,-1
RECMUS.txt,953497,953749,252,10,N,N,-,-1,-1
RECMUS.txt,953518,953801,283,10,N,N,-,-1,-1
RECMUS.txt,953522,953829,307,10,N,N,-,-1,-1
RECMUS.txt,953565,953842,277,10,N,N,-,-1,-1
RECMUS.txt,953591,953861,270,10,N,N,-,-1,-1
RECMUS.txt,953603,953875,272,10,N,N,-,-1,-1
RECMUS.txt,953626,953896,270,10,N,N,-,-1,-1
RECMUS.txt,953647,953920,273,10,N,N,-,-1,-1
RECMUS.txt,953651,953967,316,10,N,N,-,-1,-1
RECMUS.txt,953732,953994,262,10,N,N,-,-1,-1
RECMUS.txt,953754,954016,262,10,N,N,-,-1,-1
RECMUS.txt,953806,954030,224,10,N,N,-,-1,-1
RECMUS.txt,953831,954043,212,10,N,N,-,-1,-1
RECMUS.txt,953844,954056,212,10,N,N,-,-1,-1
RECMUS.txt,953863,954074,211,10,N,N,-,-1,-1
RECMUS.txt,953877,954100,223,10,N,N,-,-1,-1
RECMUS.txt,953898,954120,222,10,N,N,-,-1,-1
RECMUS.txt,953922,954134,212,10,N,N,-,-1,-1
RECMUS.txt,953969,954158,189,10,N,N,-,-1,-1
RECMUS.txt,953996,954177,181,10,N,N,-,-1,-1
RECMUS.txt,954018,954189,171,10,N,N,-,-1,-1
RECMUS.txt,954032,954203,171,10,N,N,-,-1,-1
RECMUS.txt,954045,954226,181,10,N,N,-,-1,-1
RECMUS.txt,954058,954240,182,10,N,N,-,-1,-1
RECMUS.txt,954076,954253,177,10,N,N,-,-1,-1
RECMUS.txt,954102,954276,174,10,N,N,-,-1,-1
RECMUS.txt,954122,954291,169,10,N,N,-,-1,-1
RECMUS.txt,954137,954306,169,10,N,N,-,-1,-1
RECMUS.txt,954160,954325,165,10,N,N,-,-1,-1
RECMUS.txt,954179,954340,161,10,N,N,-,-1,-1
RECMUS.txt,954191,954356,165,10,N,N,-,-1,-1
RECMUS.txt,954205,954380,175,10,N,N,-,-1,-1
RECMUS.txt,954228,954414,186,10,N,N,-,-1,-1
RECMUS.txt,954242,954435,193,10,N,N,-,-1,-1
RECMUS.txt,954255,954457,202,10,N,N,-,-1,-1
RECMUS.txt,954278,954483,205,10,N,N,-,-1,-1
RECMUS.txt,954293,954532,239,10,N,N,-,-1,-1
RECMUS.txt,954308,954547,239,10,N,N,-,-1,-1
RECMUS.txt,954327,954568,241,10,N,N,-,-1,-1
RECMUS.txt,954342,954619,277,10,N,N,-,-1,-1
RECMUS.txt,954358,954633,275,10,N,N,-,-1,-1
RECMUS.txt,954382,954661,279,10,N,N,-,-1,-1
RECMUS.txt,954416,954671,255,10,N,N,-,-1,-1
RECMUS.txt,954437,954694,257,10,N,N,-,-1,-1
RECMUS.txt,954459,954714,255,10,N,N,-,-1,-1
RECMUS.txt,954485,954741,256,10,N,N,-,-1,-1
RECMUS.txt,954534,954755,221,10,N,N,-,-1,-1
RECMUS.txt,954549,954783,234,10,N,N,-,-1,-1
RECMUS.txt,954570,954800,230,10,N,N,-,-1,-1
RECMUS.txt,954621,954815,194,10,N,N,-,-1,-1
RECMUS.txt,954636,954828,192,10,N,N,-,-1,-1
RECMUS.txt,954662,954845,183,10,N,N,-,-1,-1
RECMUS.txt,954673,954864,191,10,N,N,-,-1,-1
RECMUS.txt,954696,954923,227,10,N,N,-,-1,-1
RECMUS.txt,954716,954935,219,10,N,N,-,-1,-1
RECMUS.txt,954743,954954,211,10,N,N,-,-1,-1
RECMUS.txt,954760,954974,214,10,N,N,-,-1,-1
RECMUS.txt,954786,954991,205,10,N,N,-,-1,-1
RECMUS.txt,954803,955018,215,10,N,N,-,-1,-1
RECMUS.txt,954818,955034,216,10,N,N,-,-1,-1
RECMUS.txt,954831,955062,231,10,N,N,-,-1,-1
RECMUS.txt,954848,955077,229,10,N,N,-,-1,-1
RECMUS.txt,954867,955092,225,10,N,N,-,-1,-1
RECMUS.txt,954926,955116,190,10,N,N,-,-1,-1
RECMUS.txt,954938,955138,200,10,N,N,-,-1,-1
RECMUS.txt,954957,955164,207,10,N,N,-,-1,-1
RECMUS.txt,954977,955187,210,10,N,N,-,-1,-1
RECMUS.txt,954994,955201,207,10,N,N,-,-1,-1
RECMUS.txt,955021,955238,217,10,N,N,-,-1,-1
RECMUS.txt,955037,955263,226,10,N,N,-,-1,-1
RECMUS.txt,955065,955281,216,10,N,N,-,-1,-1
RECMUS.txt,955080,955296,216,10,N,N,-,-1,-1
RECMUS.txt,955095,955316,221,10,N,N,-,-1,-1
RECMUS.txt,955119,955339,220,10,N,N,-,-1,-1
RECMUS.txt,955141,955364,223,10,N,N,-,-1,-1
RECMUS.txt,955167,955384,217,10,N,N,-,-1,-1
RECMUS.txt,955190,955403,213,10,N,N,-,-1,-1
RECMUS.txt,955204,955466,262,10,N,N,-,-1,-1
RECMUS.txt,955241,955493,252,10,N,N,-,-1,-1
RECMUS.txt,955266,955511,245,10,N,N,-,-1,-1
RECMUS.txt,955284,955528,244,10,N,N,-,-1,-1
RECMUS.txt,955299,955580,281,10,N,N,-,-1,-1
RECMUS.txt,955319,955629,310,10,N,N,-,-1,-1
RECMUS.txt,955342,955653,311,10,N,N,-,-1,-1
RECMUS.txt,955367,955673,306,10,N,N,-,-1,-1
RECMUS.txt,955387,955687,300,10,N,N,-,-1,-1
RECMUS.txt,955406,955703,297,10,N,N,-,-1,-1
RECMUS.txt,955469,955725,256,10,N,N,-,-1,-1
RECMUS.txt,955496,955760,264,10,N,N,-,-1,-1
RECMUS.txt,955514,955796,282,10,N,N,-,-1,-1
RECMUS.txt,955531,955822,291,10,N,N,-,-1,-1
RECMUS.txt,955583,955850,267,10,N,N,-,-1,-1
RECMUS.txt,955632,955879,247,10,N,N,-,-1,-1
RECMUS.txt,955656,955903,247,10,N,N,-,-1,-1
RECMUS.txt,955676,955939,263,10,N,N,-,-1,-1
RECMUS.txt,955690,955985,295,10,N,N,-,-1,-1
RECMUS.txt,955706,956004,298,10,N,N,-,-1,-1
RECMUS.txt,955728,956019,291,10,N,N,-,-1,-1
RECMUS.txt,955763,956054,291,10,N,N,-,-1,-1
RECMUS.txt,955799,956127,328,10,N,N,-,-1,-1
RECMUS.txt,955827,956143,316,10,N,N,-,-1,-1
RECMUS.txt,955855,956161,306,10,N,N,-,-1,-1
RECMUS.txt,955882,956187,305,10,N,N,-,-1,-1
RECMUS.txt,955906,956204,298,10,N,N,-,-1,-1
RECMUS.txt,955942,956224,282,10,N,N,-,-1,-1
RECMUS.txt,955988,956272,284,10,N,N,-,-1,-1
RECMUS.txt,956007,956369,362,10,N,N,-,-1,-1
RECMUS.txt,956022,956399,377,10,N,N,-,-1,-1
RECMUS.txt,956057,956423,366,10,N,N,-,-1,-1
RECMUS.txt,956129,956443,314,10,N,N,-,-1,-1
RECMUS.txt,956145,956459,314,10,N,N,-,-1,-1
RECMUS.txt,956163,956475,312,10,N,N,-,-1,-1
RECMUS.txt,956189,956499,310,10,N,N,-,-1,-1
RECMUS.txt,956207,956524,317,10,N,N,-,-1,-1
RECMUS.txt,956226,956552,326,10,N,N,-,-1,-1
RECMUS.txt,956273,956577,304,10,N,N,-,-1,-1
RECMUS.txt,956372,956600,228,10,N,N,-,-1,-1
RECMUS.txt,956402,956616,214,10,N,N,-,-1,-1
RECMUS.txt,956426,956632,206,10,N,N,-,-1,-1
RECMUS.txt,956446,956648,202,10,N,N,-,-1,-1
RECMUS.txt,956462,956678,216,10,N,N,-,-1,-1
RECMUS.txt,956478,956696,218,10,N,N,-,-1,-1
RECMUS.txt,956502,956713,211,10,N,N,-,-1,-1
RECMUS.txt,956527,956745,218,10,N,N,-,-1,-1
RECMUS.txt,956555,956769,214,10,N,N,-,-1,-1
RECMUS.txt,956580,956792,212,10,N,N,-,-1,-1
RECMUS.txt,956603,956808,205,10,N,N,-,-1,-1
RECMUS.txt,956619,956831,212,10,N,N,-,-1,-1
RECMUS.txt,956635,956850,215,10,N,N,-,-1,-1
RECMUS.txt,956651,956879,228,10,N,N,-,-1,-1
RECMUS.txt,956681,956897,216,10,N,N,-,-1,-1
RECMUS.txt,956699,956917,218,10,N,N,-,-1,-1
RECMUS.txt,956716,956935,219,10,N,N,-,-1,-1
RECMUS.txt,956748,956951,203,10,N,N,-,-1,-1
RECMUS.txt,956772,956963,191,10,N,N,-,-1,-1
RECMUS.txt,956795,956989,194,10,N,N,-,-1,-1
RECMUS.txt,956811,957007,196,10,N,N,-,-1,-1
RECMUS.txt,956834,957032,198,10,N,N,-,-1,-1
RECMUS.txt,956853,957053,200,10,N,N,-,-1,-1
RECMUS.txt,956882,957096,214,10,N,N,-,-1,-1
RECMUS.txt,956900,957114,214,10,N,N,-,-1,-1
RECMUS.txt,956920,957139,219,10,N,N,-,-1,-1
RECMUS.txt,956937,957178,241,10,N,N,-,-1,-1
RECMUS.txt,956953,957180,227,10,N,N,-,-1,-1
RECMUS.txt,956965,957199,234,10,N,N,-,-1,-1
RECMUS.txt,956992,957213,221,10,N,N,-,-1,-1
RECMUS.txt,957010,957226,216,10,N,N,-,-1,-1
RECMUS.txt,957034,957259,225,10,N,N,-,-1,-1
RECMUS.txt,957055,957274,219,10,N,N,-,-1,-1
RECMUS.txt,957098,957295,197,10,N,N,-,-1,-1
RECMUS.txt,957117,957309,192,10,N,N,-,-1,-1
RECMUS.txt,957141,957330,189,10,N,N,-,-1,-1
RECMUS.txt,957179,957343,164,10,N,N,-,-1,-1
RECMUS.txt,957181,957368,187,10,N,N,-,-1,-1
RECMUS.txt,957202,957387,185,10,N,N,-,-1,-1
RECMUS.txt,957216,957439,223,10,N,N,-,-1,-1
RECMUS.txt,957229,957463,234,10,N,N,-,-1,-1
RECMUS.txt,957262,957484,222,10,N,N,-,-1,-1
RECMUS.txt,957279,957501,222,10,N,N,-,-1,-1
RECMUS.txt,957298,957521,223,10,N,N,-,-1,-1
RECMUS.txt,957312,957561,249,10,N,N,-,-1,-1
RECMUS.txt,957333,957584,251,10,N,N,-,-1,-1
RECMUS.txt,957346,957613,267,10,N,N,-,-1,-1
RECMUS.txt,957371,957630,259,10,N,N,-,-1,-1
RECMUS.txt,957390,957664,274,10,N,N,-,-1,-1
RECMUS.txt,957441,957679,238,10,N,N,-,-1,-1
RECMUS.txt,957465,957692,227,10,N,N,-,-1,-1
RECMUS.txt,957486,957721,235,10,N,N,-,-1,-1
RECMUS.txt,957503,957734,231,10,N,N,-,-1,-1
RECMUS.txt,957524,957750,226,10,N,N,-,-1,-1
RECMUS.txt,957563,957769,206,10,N,N,-,-1,-1
RECMUS.txt,957586,957786,200,10,N,N,-,-1,-1
RECMUS.txt,957615,957811,196,10,N,N,-,-1,-1
RECMUS.txt,957633,957835,202,10,N,N,-,-1,-1
RECMUS.txt,957666,957906,240,10,N,N,-,-1,-1
RECMUS.txt,957681,957925,244,10,N,N,-,-1,-1
RECMUS.txt,957695,957936,241,10,N,N,-,-1,-1
RECMUS.txt,957723,957961,238,10,N,N,-,-1,-1
RECMUS.txt,957736,957980,244,10,N,N,-,-1,-1
RECMUS.txt,957752,958012,260,10,N,N,-,-1,-1
RECMUS.txt,957771,958026,255,10,N,N,-,-1,-1
RECMUS.txt,957788,958046,258,10,N,N,-,-1,-1
RECMUS.txt,957813,958099,286,10,N,N,-,-1,-1
RECMUS.txt,957837,958119,282,10,N,N,-,-1,-1
RECMUS.txt,957908,958139,231,10,N,N,-,-1,-1
RECMUS.txt,957927,958154,227,10,N,N,-,-1,-1
RECMUS.txt,957939,958169,230,10,N,N,-,-1,-1
RECMUS.txt,957963,958184,221,10,N,N,-,-1,-1
RECMUS.txt,957982,958205,223,10,N,N,-,-1,-1
RECMUS.txt,958014,958224,210,10,N,N,-,-1,-1
RECMUS.txt,958028,958237,209,10,N,N,-,-1,-1
RECMUS.txt,958048,958274,226,10,N,N,-,-1,-1
RECMUS.txt,958101,958299,198,10,N,N,-,-1,-1
RECMUS.txt,958121,958330,209,10,N,N,-,-1,-1
RECMUS.txt,958141,958349,208,10,N,N,-,-1,-1
RECMUS.txt,958156,958377,221,10,N,N,-,-1,-1
RECMUS.txt,958171,958400,229,10,N,N,-,-1,-1
RECMUS.txt,958187,958422,235,10,N,N,-,-1,-1
RECMUS.txt,958207,958443,236,10,N,N,-,-1,-1
RECMUS.txt,958226,958468,242,10,N,N,-,-1,-1
RECMUS.txt,958240,958492,252,10,N,N,-,-1,-1
RECMUS.txt,958276,958513,237,10,N,N,-,-1,-1
RECMUS.txt,958301,958530,229,10,N,N,-,-1,-1
RECMUS.txt,958332,958553,221,10,N,N,-,-1,-1
RECMUS.txt,958351,958571,220,10,N,N,-,-1,-1
RECMUS.txt,958379,958594,215,10,N,N,-,-1,-1
RECMUS.txt,958402,958617,215,10,N,N,-,-1,-1
RECMUS.txt,958424,958643,219,10,N,N,-,-1,-1
RECMUS.txt,958445,958664,219,10,N,N,-,-1,-1
RECMUS.txt,958470,958684,214,10,N,N,-,-1,-1
RECMUS.txt,958494,958710,216,10,N,N,-,-1,-1
RECMUS.txt,958515,958726,211,10,N,N,-,-1,-1
RECMUS.txt,958532,958743,211,10,N,N,-,-1,-1
RECMUS.txt,958555,958753,198,10,N,N,-,-1,-1
RECMUS.txt,958573,958772,199,10,N,N,-,-1,-1
RECMUS.txt,958596,958821,225,10,N,N,-,-1,-1
RECMUS.txt,958619,958834,215,10,N,N,-,-1,-1
RECMUS.txt,958645,958885,240,10,N,N,-,-1,-1
RECMUS.txt,958669,958902,233,10,N,N,-,-1,-1
RECMUS.txt,958689,958919,230,10,N,N,-,-1,-1
RECMUS.txt,958713,958954,241,10,N,N,-,-1,-1
RECMUS.txt,958729,958970,241,10,N,N,-,-1,-1
RECMUS.txt,958744,958999,255,10,N,N,-,-1,-1
RECMUS.txt,958756,959031,275,10,N,N,-,-1,-1
RECMUS.txt,958775,959061,286,10,N,N,-,-1,-1
RECMUS.txt,958824,959077,253,10,N,N,-,-1,-1
RECMUS.txt,958837,959098,261,10,N,N,-,-1,-1
RECMUS.txt,958888,959119,231,10,N,N,-,-1,-1
RECMUS.txt,958905,959140,235,10,N,N,-,-1,-1
RECMUS.txt,958922,959152,230,10,N,N,-,-1,-1
RECMUS.txt,958957,959175,218,10,N,N,-,-1,-1
RECMUS.txt,958973,959201,228,10,N,N,-,-1,-1
RECMUS.txt,959002,959229,227,10,N,N,-,-1,-1
RECMUS.txt,959034,959295,261,10,N,N,-,-1,-1
RECMUS.txt,959066,959339,273,10,N,N,-,-1,-1
RECMUS.txt,959079,959361,282,10,N,N,-,-1,-1
RECMUS.txt,959100,959376,276,10,N,N,-,-1,-1
RECMUS.txt,959121,959386,265,10,N,N,-,-1,-1
RECMUS.txt,959142,959391,249,10,N,N,-,-1,-1
RECMUS.txt,959154,959410,256,10,N,N,-,-1,-1
RECMUS.txt,959177,959435,258,10,N,N,-,-1,-1
RECMUS.txt,959203,959439,236,10,N,N,-,-1,-1
RECMUS.txt,959231,959468,237,10,N,N,-,-1,-1
RECMUS.txt,959297,959492,195,10,N,N,-,-1,-1
RECMUS.txt,959340,959517,177,10,N,N,-,-1,-1
RECMUS.txt,959362,959532,170,10,N,N,-,-1,-1
RECMUS.txt,959377,959555,178,10,N,N,-,-1,-1
RECMUS.txt,959387,959590,203,10,N,N,-,-1,-1
RECMUS.txt,959393,959614,221,10,N,N,-,-1,-1
RECMUS.txt,959415,959658,243,10,N,N,-,-1,-1
RECMUS.txt,959436,959674,238,10,N,N,-,-1,-1
RECMUS.txt,959440,959698,258,10,N,N,-,-1,-1
RECMUS.txt,959470,959712,242,10,N,N,-,-1,-1
RECMUS.txt,959494,959725,231,10,N,N,-,-1,-1
RECMUS.txt,959519,959743,224,10,N,N,-,-1,-1
RECMUS.txt,959534,959764,230,10,N,N,-,-1,-1
RECMUS.txt,959557,959769,212,10,N,N,-,-1,-1
RECMUS.txt,959592,959805,213,10,N,N,-,-1,-1
RECMUS.txt,959616,959818,202,10,N,N,-,-1,-1
RECMUS.txt,959660,959839,179,10,N,N,-,-1,-1
RECMUS.txt,959676,959854,178,10,N,N,-,-1,-1
RECMUS.txt,959700,959874,174,10,N,N,-,-1,-1
RECMUS.txt,959714,959887,173,10,N,N,-,-1,-1
RECMUS.txt,959727,959900,173,10,N,N,-,-1,-1
RECMUS.txt,959745,959920,175,10,N,N,-,-1,-1
RECMUS.txt,959765,959951,186,10,N,N,-,-1,-1
RECMUS.txt,959770,959963,193,10,N,N,-,-1,-1
RECMUS.txt,959807,959987,180,10,N,N,-,-1,-1
RECMUS.txt,959820,960004,184,10,N,N,-,-1,-1
RECMUS.txt,959841,960018,177,10,N,N,-,-1,-1
RECMUS.txt,959856,960051,195,10,N,N,-,-1,-1
RECMUS.txt,959876,960085,209,10,N,N,-,-1,-1
RECMUS.txt,959889,960109,220,10,N,N,-,-1,-1
RECMUS.txt,959902,960130,228,10,N,N,-,-1,-1
RECMUS.txt,959922,960161,239,10,N,N,-,-1,-1
RECMUS.txt,959953,960178,225,10,N,N,-,-1,-1
RECMUS.txt,959966,960191,225,10,N,N,-,-1,-1
RECMUS.txt,959989,960205,216,10,N,N,-,-1,-1
RECMUS.txt,960006,960218,212,10,N,N,-,-1,-1
RECMUS.txt,960019,960229,210,10,N,N,-,-1,-1
RECMUS.txt,960056,960257,201,10,N,N,-,-1,-1
RECMUS.txt,960087,960272,185,10,N,N,-,-1,-1
RECMUS.txt,960111,960297,186,10,N,N,-,-1,-1
RECMUS.txt,960132,960320,188,10,N,N,-,-1,-1
RECMUS.txt,960163,960334,171,10,N,N,-,-1,-1
RECMUS.txt,960180,960348,168,10,N,N,-,-1,-1
RECMUS.txt,960193,960363,170,10,N,N,-,-1,-1
RECMUS.txt,960207,960378,171,10,N,N,-,-1,-1
RECMUS.txt,960220,960397,177,10,N,N,-,-1,-1
RECMUS.txt,960232,960411,179,10,N,N,-,-1,-1
RECMUS.txt,960259,960427,168,10,N,N,-,-1,-1
RECMUS.txt,960274,960439,165,10,N,N,-,-1,-1
RECMUS.txt,960299,960459,160,10,N,N,-,-1,-1
RECMUS.txt,960322,960485,163,10,N,N,-,-1,-1
RECMUS.txt,960336,960509,173,10,N,N,-,-1,-1
RECMUS.txt,960350,960523,173,10,N,N,-,-1,-1
RECMUS.txt,960365,960537,172,10,N,N,-,-1,-1
RECMUS.txt,960380,960549,169,10,N,N,-,-1,-1
RECMUS.txt,960399,960571,172,10,N,N,-,-1,-1
RECMUS.txt,960413,960627,214,10,N,N,-,-1,-1
RECMUS.txt,960429,960632,203,10,N,N,-,-1,-1
RECMUS.txt,960441,960678,237,10,N,N,-,-1,-1
RECMUS.txt,960461,960697,236,10,N,N,-,-1,-1
RECMUS.txt,960487,960748,261,10,N,N,-,-1,-1
RECMUS.txt,960511,960753,242,10,N,N,-,-1,-1
RECMUS.txt,960525,960768,243,10,N,N,-,-1,-1
RECMUS.txt,960539,960810,271,10,N,N,-,-1,-1
RECMUS.txt,960552,960831,279,10,N,N,-,-1,-1
RECMUS.txt,960573,960848,275,10,N,N,-,-1,-1
RECMUS.txt,960628,960864,236,10,N,N,-,-1,-1
RECMUS.txt,960633,960894,261,10,N,N,-,-1,-1
RECMUS.txt,960680,960921,241,10,N,N,-,-1,-1
RECMUS.txt,960699,960948,249,10,N,N,-,-1,-1
RECMUS.txt,960749,960966,217,10,N,N,-,-1,-1
RECMUS.txt,960754,960988,234,10,N,N,-,-1,-1
RECMUS.txt,960769,961004,235,10,N,N,-,-1,-1
RECMUS.txt,960812,961017,205,10,N,N,-,-1,-1
RECMUS.txt,960833,961035,202,10,N,N,-,-1,-1
RECMUS.txt,960850,961049,199,10,N,N,-,-1,-1
RECMUS.txt,960867,961092,225,10,N,N,-,-1,-1
RECMUS.txt,960896,961104,208,10,N,N,-,-1,-1
RECMUS.txt,960923,961117,194,10,N,N,-,-1,-1
RECMUS.txt,960950,961132,182,10,N,N,-,-1,-1
RECMUS.txt,960968,961143,175,10,N,N,-,-1,-1
RECMUS.txt,960990,961170,180,10,N,N,-,-1,-1
RECMUS.txt,961006,961188,182,10,N,N,-,-1,-1
RECMUS.txt,961020,961210,190,10,N,N,-,-1,-1
RECMUS.txt,961037,961236,199,10,N,N,-,-1,-1
RECMUS.txt,961051,961251,200,10,N,N,-,-1,-1
RECMUS.txt,961095,961274,179,10,N,N,-,-1,-1
RECMUS.txt,961106,961293,187,10,N,N,-,-1,-1
RECMUS.txt,961119,961339,220,10,N,N,-,-1,-1
RECMUS.txt,961134,961353,219,10,N,N,-,-1,-1
RECMUS.txt,961146,961372,226,10,N,N,-,-1,-1
RECMUS.txt,961172,961400,228,10,N,N,-,-1,-1
RECMUS.txt,961190,961422,232,10,N,N,-,-1,-1
RECMUS.txt,961211,961438,227,10,N,N,-,-1,-1
RECMUS.txt,961238,961453,215,10,N,N,-,-1,-1
RECMUS.txt,961253,961705,452,10,N,N,-,-1,-1
RECMUS.txt,961276,961754,478,10,N,N,-,-1,-1
RECMUS.txt,961295,961764,469,10,N,N,-,-1,-1
RECMUS.txt,961341,961769,428,10,N,N,-,-1,-1
RECMUS.txt,961355,961779,424,10,N,N,-,-1,-1
RECMUS.txt,961377,961800,423,10,N,N,-,-1,-1
RECMUS.txt,961405,961841,436,10,N,N,-,-1,-1
RECMUS.txt,961425,961865,440,10,N,N,-,-1,-1
RECMUS.txt,961441,961897,456,10,N,N,-,-1,-1
RECMUS.txt,961456,961923,467,10,N,N,-,-1,-1
RECMUS.txt,961708,961940,232,10,N,N,-,-1,-1
RECMUS.txt,961755,961962,207,10,N,N,-,-1,-1
RECMUS.txt,961765,961977,212,10,N,N,-,-1,-1
RECMUS.txt,961770,961990,220,10,N,N,-,-1,-1
RECMUS.txt,961780,962022,242,10,N,N,-,-1,-1
RECMUS.txt,961803,962073,270,10,N,N,-,-1,-1
RECMUS.txt,961844,962078,234,10,N,N,-,-1,-1
RECMUS.txt,961868,962109,241,10,N,N,-,-1,-1
RECMUS.txt,961900,962124,224,10,N,N,-,-1,-1
RECMUS.txt,961926,962152,226,10,N,N,-,-1,-1
RECMUS.txt,961943,962156,213,10,N,N,-,-1,-1
RECMUS.txt,961965,962177,212,10,N,N,-,-1,-1
RECMUS.txt,961980,962204,224,10,N,N,-,-1,-1
RECMUS.txt,961993,962231,238,10,N,N,-,-1,-1
RECMUS.txt,962025,962246,221,10,N,N,-,-1,-1
RECMUS.txt,962074,962267,193,10,N,N,-,-1,-1
RECMUS.txt,962079,962285,206,10,N,N,-,-1,-1
RECMUS.txt,962112,962307,195,10,N,N,-,-1,-1
RECMUS.txt,962127,962322,195,10,N,N,-,-1,-1
RECMUS.txt,962153,962347,194,10,N,N,-,-1,-1
RECMUS.txt,962159,962373,214,10,N,N,-,-1,-1
RECMUS.txt,962180,962394,214,10,N,N,-,-1,-1
RECMUS.txt,962207,962412,205,10,N,N,-,-1,-1
RECMUS.txt,962234,962432,198,10,N,N,-,-1,-1
RECMUS.txt,962249,962462,213,10,N,N,-,-1,-1
RECMUS.txt,962270,962477,207,10,N,N,-,-1,-1
RECMUS.txt,962288,962491,203,10,N,N,-,-1,-1
RECMUS.txt,962310,962510,200,10,N,N,-,-1,-1
RECMUS.txt,962325,962535,210,10,N,N,-,-1,-1
RECMUS.txt,962350,962550,200,10,N,N,-,-1,-1
RECMUS.txt,962376,962607,231,10,N,N,-,-1,-1
RECMUS.txt,962397,962630,233,10,N,N,-,-1,-1
RECMUS.txt,962415,962649,234,10,N,N,-,-1,-1
RECMUS.txt,962435,962692,257,10,N,N,-,-1,-1
RECMUS.txt,962465,962716,251,10,N,N,-,-1,-1
RECMUS.txt,962480,962734,254,10,N,N,-,-1,-1
RECMUS.txt,962493,962772,279,10,N,N,-,-1,-1
RECMUS.txt,962512,962788,276,10,N,N,-,-1,-1
RECMUS.txt,962537,962815,278,10,N,N,-,-1,-1
RECMUS.txt,962552,962830,278,10,N,N,-,-1,-1
RECMUS.txt,962609,962848,239,10,N,N,-,-1,-1
RECMUS.txt,962632,962863,231,10,N,N,-,-1,-1
RECMUS.txt,962652,962874,222,10,N,N,-,-1,-1
RECMUS.txt,962694,962913,219,10,N,N,-,-1,-1
RECMUS.txt,962719,962928,209,10,N,N,-,-1,-1
RECMUS.txt,962736,962965,229,10,N,N,-,-1,-1
RECMUS.txt,962774,962990,216,10,N,N,-,-1,-1
RECMUS.txt,962790,963022,232,10,N,N,-,-1,-1
RECMUS.txt,962817,963045,228,10,N,N,-,-1,-1
RECMUS.txt,962832,963071,239,10,N,N,-,-1,-1
RECMUS.txt,962851,963096,245,10,N,N,-,-1,-1
RECMUS.txt,962865,963120,255,10,N,N,-,-1,-1
RECMUS.txt,962876,963156,280,10,N,N,-,-1,-1
RECMUS.txt,962915,963171,256,10,N,N,-,-1,-1
RECMUS.txt,962933,963185,252,10,N,N,-,-1,-1
RECMUS.txt,962968,963202,234,10,N,N,-,-1,-1
RECMUS.txt,962993,963221,228,10,N,N,-,-1,-1
RECMUS.txt,963025,963244,219,10,N,N,-,-1,-1
RECMUS.txt,963048,963263,215,10,N,N,-,-1,-1
RECMUS.txt,963074,963283,209,10,N,N,-,-1,-1
RECMUS.txt,963099,963310,211,10,N,N,-,-1,-1
RECMUS.txt,963123,963331,208,10,N,N,-,-1,-1
RECMUS.txt,963159,963346,187,10,N,N,-,-1,-1
RECMUS.txt,963174,963376,202,10,N,N,-,-1,-1
RECMUS.txt,963188,963391,203,10,N,N,-,-1,-1
RECMUS.txt,963203,963412,209,10,N,N,-,-1,-1
RECMUS.txt,963224,963426,202,10,N,N,-,-1,-1
RECMUS.txt,963247,963443,196,10,N,N,-,-1,-1
RECMUS.txt,963266,963457,191,10,N,N,-,-1,-1
RECMUS.txt,963286,963477,191,10,N,N,-,-1,-1
RECMUS.txt,963313,963500,187,10,N,N,-,-1,-1
RECMUS.txt,963334,963514,180,10,N,N,-,-1,-1
RECMUS.txt,963349,963534,185,10,N,N,-,-1,-1
RECMUS.txt,963379,963546,167,10,N,N,-,-1,-1
RECMUS.txt,963394,963565,171,10,N,N,-,-1,-1
RECMUS.txt,963415,963586,171,10,N,N,-,-1,-1
RECMUS.txt,963429,963608,179,10,N,N,-,-1,-1
RECMUS.txt,963446,963662,216,10,N,N,-,-1,-1
RECMUS.txt,963460,963681,221,10,N,N,-,-1,-1
RECMUS.txt,963479,963694,215,10,N,N,-,-1,-1
RECMUS.txt,963502,963710,208,10,N,N,-,-1,-1
RECMUS.txt,963516,963743,227,10,N,N,-,-1,-1
RECMUS.txt,963536,963765,229,10,N,N,-,-1,-1
RECMUS.txt,963548,963780,232,10,N,N,-,-1,-1
RECMUS.txt,963567,963795,228,10,N,N,-,-1,-1
RECMUS.txt,963588,963808,220,10,N,N,-,-1,-1
RECMUS.txt,963610,963828,218,10,N,N,-,-1,-1
RECMUS.txt,963664,963843,179,10,N,N,-,-1,-1
RECMUS.txt,963683,963878,195,10,N,N,-,-1,-1
RECMUS.txt,963696,963883,187,10,N,N,-,-1,-1
RECMUS.txt,963713,963894,181,10,N,N,-,-1,-1
RECMUS.txt,963745,963919,174,10,N,N,-,-1,-1
RECMUS.txt,963767,963944,177,10,N,N,-,-1,-1
RECMUS.txt,963782,963956,174,10,N,N,-,-1,-1
RECMUS.txt,963797,963969,172,10,N,N,-,-1,-1
RECMUS.txt,963811,963999,188,10,N,N,-,-1,-1
RECMUS.txt,963829,964013,184,10,N,N,-,-1,-1
RECMUS.txt,963845,964035,190,10,N,N,-,-1,-1
RECMUS.txt,963879,964047,168,10,N,N,-,-1,-1
RECMUS.txt,963884,964065,181,10,N,N,-,-1,-1
RECMUS.txt,963895,964092,197,10,N,N,-,-1,-1
RECMUS.txt,963921,964107,186,10,N,N,-,-1,-1
RECMUS.txt,963946,964129,183,10,N,N,-,-1,-1
RECMUS.txt,963958,964142,184,10,N,N,-,-1,-1
RECMUS.txt,963972,964170,198,10,N,N,-,-1,-1
RECMUS.txt,964001,964200,199,10,N,N,-,-1,-1
RECMUS.txt,964015,964226,211,10,N,N,-,-1,-1
RECMUS.txt,964037,964267,230,10,N,N,-,-1,-1
RECMUS.txt,964049,964287,238,10,N,N,-,-1,-1
RECMUS.txt,964067,964302,235,10,N,N,-,-1,-1
RECMUS.txt,964094,964331,237,10,N,N,-,-1,-1
RECMUS.txt,964109,964401,292,10,N,N,-,-1,-1
RECMUS.txt,964131,964421,290,10,N,N,-,-1,-1
RECMUS.txt,964145,964426,281,10,N,N,-,-1,-1
RECMUS.txt,964172,964431,259,10,N,N,-,-1,-1
RECMUS.txt,964202,964447,245,10,N,N,-,-1,-1
RECMUS.txt,964228,964468,240,10,N,N,-,-1,-1
RECMUS.txt,964269,964490,221,10,N,N,-,-1,-1
RECMUS.txt,964289,964508,219,10,N,N,-,-1,-1
RECMUS.txt,964304,964524,220,10,N,N,-,-1,-1
RECMUS.txt,964336,964540,204,10,N,N,-,-1,-1
RECMUS.txt,964403,964555,152,10,N,N,-,-1,-1
RECMUS.txt,964422,964570,148,10,N,N,-,-1,-1
RECMUS.txt,964427,964597,170,10,N,N,-,-1,-1
RECMUS.txt,964434,964618,184,10,N,N,-,-1,-1
RECMUS.txt,964450,964633,183,10,N,N,-,-1,-1
RECMUS.txt,964471,964654,183,10,N,N,-,-1,-1
RECMUS.txt,964493,964670,177,10,N,N,-,-1,-1
RECMUS.txt,964511,964691,180,10,N,N,-,-1,-1
RECMUS.txt,964527,964714,187,10,N,N,-,-1,-1
RECMUS.txt,964543,964737,194,10,N,N,-,-1,-1
RECMUS.txt,964558,964817,259,10,N,N,-,-1,-1
RECMUS.txt,964573,964872,299,10,N,N,-,-1,-1
RECMUS.txt,964600,964891,291,10,N,N,-,-1,-1
RECMUS.txt,964621,964913,292,10,N,N,-,-1,-1
RECMUS.txt,964636,964935,299,10,N,N,-,-1,-1
RECMUS.txt,964657,964956,299,10,N,N,-,-1,-1
RECMUS.txt,964673,964993,320,10,N,N,-,-1,-1
RECMUS.txt,964694,965021,327,10,N,N,-,-1,-1
RECMUS.txt,964717,965053,336,10,N,N,-,-1,-1
RECMUS.txt,964740,965071,331,10,N,N,-,-1,-1
RECMUS.txt,964819,965092,273,10,N,N,-,-1,-1
RECMUS.txt,964874,965115,241,10,N,N,-,-1,-1
RECMUS.txt,964893,965182,289,10,N,N,-,-1,-1
RECMUS.txt,964915,965197,282,10,N,N,-,-1,-1
RECMUS.txt,964937,965211,274,10,N,N,-,-1,-1
RECMUS.txt,964958,965230,272,10,N,N,-,-1,-1
RECMUS.txt,964995,965241,246,10,N,N,-,-1,-1
RECMUS.txt,965023,965293,270,10,N,N,-,-1,-1
RECMUS.txt,965055,965303,248,10,N,N,-,-1,-1
RECMUS.txt,965074,965308,234,10,N,N,-,-1,-1
RECMUS.txt,965094,965313,219,10,N,N,-,-1,-1
RECMUS.txt,965117,965318,201,10,N,N,-,-1,-1
RECMUS.txt,965184,965323,139,10,N,N,-,-1,-1
RECMUS.txt,965199,965330,131,10,N,N,-,-1,-1
RECMUS.txt,965214,965400,186,10,N,N,-,-1,-1
RECMUS.txt,965231,965414,183,10,N,N,-,-1,-1
RECMUS.txt,965243,965433,190,10,N,N,-,-1,-1
RECMUS.txt,965294,965454,160,10,N,N,-,-1,-1
RECMUS.txt,965304,965468,164,10,N,N,-,-1,-1
RECMUS.txt,965309,965494,185,10,N,N,-,-1,-1
RECMUS.txt,965314,965510,196,10,N,N,-,-1,-1
RECMUS.txt,965319,965542,223,10,N,N,-,-1,-1
RECMUS.txt,965326,965564,238,10,N,N,-,-1,-1
RECMUS.txt,965332,965584,252,10,N,N,-,-1,-1
RECMUS.txt,965402,965606,204,10,N,N,-,-1,-1
RECMUS.txt,965416,965624,208,10,N,N,-,-1,-1
RECMUS.txt,965435,965650,215,10,N,N,-,-1,-1
RECMUS.txt,965456,965673,217,10,N,N,-,-1,-1
RECMUS.txt,965471,965693,222,10,N,N,-,-1,-1
RECMUS.txt,965496,965712,216,10,N,N,-,-1,-1
RECMUS.txt,965513,965735,222,10,N,N,-,-1,-1
RECMUS.txt,965544,965755,211,10,N,N,-,-1,-1
RECMUS.txt,965566,965766,200,10,N,N,-,-1,-1
RECMUS.txt,965586,965859,273,10,N,N,-,-1,-1
RECMUS.txt,965608,965911,303,10,N,N,-,-1,-1
RECMUS.txt,965626,965938,312,10,N,N,-,-1,-1
RECMUS.txt,965652,965966,314,10,N,N,-,-1,-1
RECMUS.txt,965675,965988,313,10,N,N,-,-1,-1
RECMUS.txt,965695,966038,343,10,N,N,-,-1,-1
RECMUS.txt,965714,966043,329,10,N,N,-,-1,-1
RECMUS.txt,965737,966048,311,10,N,N,-,-1,-1
RECMUS.txt,965757,966075,318,10,N,N,-,-1,-1
RECMUS.txt,965769,966092,323,10,N,N,-,-1,-1
RECMUS.txt,965864,966112,248,10,N,N,-,-1,-1
RECMUS.txt,965913,966143,230,10,N,N,-,-1,-1
RECMUS.txt,965940,966164,224,10,N,N,-,-1,-1
RECMUS.txt,965968,966192,224,10,N,N,-,-1,-1
RECMUS.txt,965990,966206,216,10,N,N,-,-1,-1
RECMUS.txt,966039,966234,195,10,N,N,-,-1,-1
RECMUS.txt,966044,966264,220,10,N,N,-,-1,-1
RECMUS.txt,966050,966296,246,10,N,N,-,-1,-1
RECMUS.txt,966077,966316,239,10,N,N,-,-1,-1
RECMUS.txt,966094,966331,237,10,N,N,-,-1,-1
RECMUS.txt,966114,966348,234,10,N,N,-,-1,-1
RECMUS.txt,966145,966377,232,10,N,N,-,-1,-1
RECMUS.txt,966166,966407,241,10,N,N,-,-1,-1
RECMUS.txt,966194,966424,230,10,N,N,-,-1,-1
RECMUS.txt,966209,966441,232,10,N,N,-,-1,-1
RECMUS.txt,966236,966462,226,10,N,N,-,-1,-1
RECMUS.txt,966266,966549,283,10,N,N,-,-1,-1
RECMUS.txt,966298,966574,276,10,N,N,-,-1,-1
RECMUS.txt,966318,966595,277,10,N,N,-,-1,-1
RECMUS.txt,966333,966614,281,10,N,N,-,-1,-1
RECMUS.txt,966350,966628,278,10,N,N,-,-1,-1
RECMUS.txt,966379,966647,268,10,N,N,-,-1,-1
RECMUS.txt,966410,966659,249,10,N,N,-,-1,-1
RECMUS.txt,966427,966687,260,10,N,N,-,-1,-1
RECMUS.txt,966444,966702,258,10,N,N,-,-1,-1
RECMUS.txt,966465,966718,253,10,N,N,-,-1,-1
RECMUS.txt,966551,966746,195,10,N,N,-,-1,-1
RECMUS.txt,966576,966761,185,10,N,N,-,-1,-1
RECMUS.txt,966597,966782,185,10,N,N,-,-1,-1
RECMUS.txt,966616,966804,188,10,N,N,-,-1,-1
RECMUS.txt,966630,966818,188,10,N,N,-,-1,-1
RECMUS.txt,966649,966838,189,10,N,N,-,-1,-1
RECMUS.txt,966662,966869,207,10,N,N,-,-1,-1
RECMUS.txt,966689,966897,208,10,N,N,-,-1,-1
RECMUS.txt,966705,966920,215,10,N,N,-,-1,-1
RECMUS.txt,966720,966944,224,10,N,N,-,-1,-1
RECMUS.txt,966748,966987,239,10,N,N,-,-1,-1
RECMUS.txt,966763,967002,239,10,N,N,-,-1,-1
RECMUS.txt,966784,967016,232,10,N,N,-,-1,-1
RECMUS.txt,966806,967035,229,10,N,N,-,-1,-1
RECMUS.txt,966820,967052,232,10,N,N,-,-1,-1
RECMUS.txt,966840,967064,224,10,N,N,-,-1,-1
RECMUS.txt,966871,967087,216,10,N,N,-,-1,-1
RECMUS.txt,966899,967108,209,10,N,N,-,-1,-1
RECMUS.txt,966922,967124,202,10,N,N,-,-1,-1
RECMUS.txt,966946,967165,219,10,N,N,-,-1,-1
RECMUS.txt,966989,967193,204,10,N,N,-,-1,-1
RECMUS.txt,967004,967222,218,10,N,N,-,-1,-1
RECMUS.txt,967018,967247,229,10,N,N,-,-1,-1
RECMUS.txt,967037,967261,224,10,N,N,-,-1,-1
RECMUS.txt,967055,967276,221,10,N,N,-,-1,-1
RECMUS.txt,967066,967304,238,10,N,N,-,-1,-1
RECMUS.txt,967090,967327,237,10,N,N,-,-1,-1
RECMUS.txt,967111,967346,235,10,N,N,-,-1,-1
RECMUS.txt,967127,967360,233,10,N,N,-,-1,-1
RECMUS.txt,967168,967377,209,10,N,N,-,-1,-1
RECMUS.txt,967196,967402,206,10,N,N,-,-1,-1
RECMUS.txt,967225,967433,208,10,N,N,-,-1,-1
RECMUS.txt,967250,967446,196,10,N,N,-,-1,-1
RECMUS.txt,967264,967477,213,10,N,N,-,-1,-1
RECMUS.txt,967281,967501,220,10,N,N,-,-1,-1
RECMUS.txt,967309,967522,213,10,N,N,-,-1,-1
RECMUS.txt,967330,967536,206,10,N,N,-,-1,-1
RECMUS.txt,967349,967550,201,10,N,N,-,-1,-1
RECMUS.txt,967363,967567,204,10,N,N,-,-1,-1
RECMUS.txt,967380,967594,214,10,N,N,-,-1,-1
RECMUS.txt,967405,967618,213,10,N,N,-,-1,-1
RECMUS.txt,967436,967632,196,10,N,N,-,-1,-1
RECMUS.txt,967449,967647,198,10,N,N,-,-1,-1
RECMUS.txt,967480,967662,182,10,N,N,-,-1,-1
RECMUS.txt,967504,967714,210,10,N,N,-,-1,-1
RECMUS.txt,967525,967727,202,10,N,N,-,-1,-1
RECMUS.txt,967539,967757,218,10,N,N,-,-1,-1
RECMUS.txt,967553,967779,226,10,N,N,-,-1,-1
RECMUS.txt,967572,967792,220,10,N,N,-,-1,-1
RECMUS.txt,967596,967809,213,10,N,N,-,-1,-1
RECMUS.txt,967621,967948,327,10,N,N,-,-1,-1
RECMUS.txt,967634,968000,366,10,N,N,-,-1,-1
RECMUS.txt,967650,968049,399,10,N,N,-,-1,-1
RECOLL.txt,0,1439,1439,10,N,N,-,-1,-1
RECOLL.txt,212,1708,1496,10,N,N,-,-1,-1
RECOLL.txt,309,1801,1492,10,N,N,-,-1,-1
RECOLL.txt,418,1995,1577,10,N,N,-,-1,-1
RECOLL.txt,486,2020,1534,10,N,N,-,-1,-1
RECOLL.txt,632,2138,1506,10,N,N,-,-1,-1
RECOLL.txt,823,2319,1496,10,N,N,-,-1,-1
RECOLL.txt,953,2478,1525,10,N,N,-,-1,-1
RECOLL.txt,1031,2605,1574,10,N,N,-,-1,-1
RECOLL.txt,1242,2658,1416,10,N,N,-,-1,-1
RECOLL.txt,1442,2793,1351,10,N,N,-,-1,-1
RECOLL.txt,1709,2912,1203,10,N,N,-,-1,-1
RECOLL.txt,1804,2995,1191,10,N,N,-,-1,-1
RECOLL.txt,1996,3003,1007,10,N,N,-,-1,-1
RECOLL.txt,2023,3180,1157,10,N,N,-,-1,-1
RECOLL.txt,2139,3692,1553,10,N,N,-,-1,-1
RECOLL.txt,2320,3894,1574,10,N,N,-,-1,-1
RECOLL.txt,2479,4299,1820,10,N,N,-,-1,-1
RECOLL.txt,2606,4404,1798,10,N,N,-,-1,-1
RECOLL.txt,2661,4649,1988,10,N,N,-,-1,-1
RECOLL.txt,2794,4732,1938,10,N,N,-,-1,-1
RECOLL.txt,2913,4928,2015,10,N,N,-,-1,-1
RECOLL.txt,2995,4976,1981,10,N,N,-,-1,-1
RECOLL.txt,3003,5020,2017,10,N,N,-,-1,-1
RECOLL.txt,3181,5035,1854,10,N,N,-,-1,-1
RECOLL.txt,3695,5038,1343,10,N,N,-,-1,-1
RECOLL.txt,3897,5039,1142,10,N,N,-,-1,-1
RECOLL.txt,4301,5102,801,10,N,N,-,-1,-1
RECOLL.txt,4407,5197,790,10,N,N,-,-1,-1
RECOLL.txt,4650,5291,641,10,N,N,-,-1,-1
RECOLL.txt,4735,5446,711,10,N,N,-,-1,-1
RECOLL.txt,4931,5505,574,10,N,N,-,-1,-1
RECOLL.txt,4979,5731,752,10,N,N,-,-1,-1
RECOLL.txt,5023,5894,871,10,N,N,-,-1,-1
RECOLL.txt,5036,6042,1006,10,N,N,-,-1,-1
RECOLL.txt,5038,6300,1262,10,N,N,-,-1,-1
RECOLL.txt,5044,6397,1353,10,N,N,-,-1,-1
RECOLL.txt,5103,6497,1394,10,N,N,-,-1,-1
RECOLL.txt,5198,6631,1433,10,N,N,-,-1,-1
RECOLL.txt,5292,6743,1451,10,N,N,-,-1,-1
RECOLL.txt,5449,7429,1980,10,N,N,-,-1,-1
RECOLL.txt,5506,7604,2098,10,N,N,-,-1,-1
RECOLL.txt,5734,7897,2163,10,N,N,-,-1,-1
RECOLL.txt,5895,8020,2125,10,N,N,-,-1,-1
RECOLL.txt,6043,8051,2008,10,N,N,-,-1,-1
RECOLL.txt,6301,8411,2110,10,N,N,-,-1,-1
RECOLL.txt,6400,8739,2339,10,N,N,-,-1,-1
RECOLL.txt,6497,8741,2244,10,N,N,-,-1,-1
RECOLL.txt,6634,8923,2289,10,N,N,-,-1,-1
RECOLL.txt,6744,9515,2771,10,Y,N,-,-1,-1
RECOLL.txt,7432,9517,2085,10,Y,N,-,-1,-1
RECOLL.txt,7605,12475,4870,10,Y,N,-,-1,-1
RECOLL.txt,7899,12909,5010,10,Y,N,-,-1,-1
RECOLL.txt,8023,12911,4888,10,Y,N,-,-1,-1
RECOLL.txt,8056,13391,5335,10,Y,N,-,-1,-1
RECOLL.txt,8412,13721,5309,10,Y,N,-,-1,-1
RECOLL.txt,8740,13887,5147,10,Y,N,-,-1,-1
RECOLL.txt,8742,13891,5149,10,Y,N,-,-1,-1
RECOLL.txt,8924,13892,4968,10,Y,N,-,-1,-1
RECOLL.txt,9516,13916,4400,10,Y,N,-,-1,-1
RECOLL.txt,9518,13940,4422,10,Y,N,-,-1,-1
RECOLL.txt,12476,13945,1469,10,N,N,-,-1,-1
RECOLL.txt,12910,13946,1036,10,N,N,-,-1,-1
RECOLL.txt,12912,14022,1110,10,N,N,-,-1,-1
RECOLL.txt,13392,14083,691,10,N,N,-,-1,-1
RECOLL.txt,13722,14163,441,10,N,N,-,-1,-1
RECOLL.txt,13887,14661,774,10,N,N,-,-1,-1
RECOLL.txt,13891,14933,1042,10,N,N,-,-1,-1
RECOLL.txt,13893,15245,1352,10,N,N,-,-1,-1
RECOLL.txt,13916,15423,1507,10,N,N,-,-1,-1
RECOLL.txt,13940,15432,1492,10,N,N,-,-1,-1
RECOLL.txt,13945,15543,1598,10,N,N,-,-1,-1
RECOLL.txt,13947,15659,1712,10,N,N,-,-1,-1
RECOLL.txt,14022,16009,1987,10,N,N,-,-1,-1
RECOLL.txt,14084,16414,2330,10,N,N,-,-1,-1
RECOLL.txt,14163,16461,2298,10,N,N,-,-1,-1
RECOLL.txt,14662,16532,1870,10,N,N,-,-1,-1
RECOLL.txt,14934,16662,1728,10,N,N,-,-1,-1
RECOLL.txt,15248,16752,1504,10,N,N,-,-1,-1
RECOLL.txt,15424,16808,1384,10,N,N,-,-1,-1
RECOLL.txt,15434,17038,1604,10,N,N,-,-1,-1
RECOLL.txt,15544,17175,1631,10,N,N,-,-1,-1
RECOLL.txt,15660,17369,1709,10,N,N,-,-1,-1
RECOLL.txt,16012,17506,1494,10,N,N,-,-1,-1
RECOLL.txt,16417,17608,1191,10,N,N,-,-1,-1
RECOLL.txt,16463,17740,1277,10,N,N,-,-1,-1
RECOLL.txt,16533,17911,1378,10,N,Y,1448279813455,71525,72226
RECOLL.txt,16663,18007,1344,10,N,Y,1448279813455,71525,72226
RECOLL.txt,16753,18229,1476,10,N,Y,1448279813455,71525,72226
RECOLL.txt,16809,18316,1507,10,N,Y,1448279813455,71525,72226
RECOLL.txt,17039,18430,1391,10,N,Y,1448279813455,71525,72226
RECOLL.txt,17176,18480,1304,10,N,Y,1448279813455,71525,72226
RECOLL.txt,17370,18549,1179,10,N,Y,1448279813455,71525,72226
RECOLL.txt,17508,18748,1240,10,N,Y,1448279813455,71525,72226
RECOLL.txt,17611,18968,1357,10,N,Y,1448279813455,71525,72226
RECOLL.txt,17741,19061,1320,10,Y,Y,1448279813455,71525,72226
RECOLL.txt,17912,19128,1216,10,Y,Y,1448279813455,71525,72226
RECOLL.txt,18008,19271,1263,10,Y,Y,1448279813455,71525,72226
RECOLL.txt,18230,19320,1090,10,Y,Y,1448279813455,71525,72226
RECOLL.txt,18321,19339,1018,10,Y,N,-,-1,-1
RECOLL.txt,18431,19524,1093,10,N,N,-,-1,-1
RECOLL.txt,18481,19936,1455,10,N,N,-,-1,-1
RECOLL.txt,18550,20018,1468,10,N,N,-,-1,-1
RECOLL.txt,18749,20245,1496,10,N,N,-,-1,-1
RECOLL.txt,18969,20275,1306,10,N,N,-,-1,-1
RECOLL.txt,19062,20463,1401,10,N,N,-,-1,-1
RECOLL.txt,19131,20548,1417,10,N,N,-,-1,-1
RECOLL.txt,19272,20633,1361,10,N,N,-,-1,-1
RECOLL.txt,19321,21078,1757,10,N,N,-,-1,-1
RECOLL.txt,19340,21294,1954,10,N,N,-,-1,-1
RECOLL.txt,19525,21357,1832,10,N,N,-,-1,-1
RECOLL.txt,19937,21592,1655,10,N,N,-,-1,-1
RECOLL.txt,20019,21686,1667,10,N,N,-,-1,-1
RECOLL.txt,20246,21977,1731,10,N,N,-,-1,-1
RECOLL.txt,20276,22031,1755,10,N,N,-,-1,-1
RECOLL.txt,20466,22175,1709,10,N,N,-,-1,-1
RECOLL.txt,20549,22339,1790,10,N,N,-,-1,-1
RECOLL.txt,20634,22472,1838,10,N,N,-,-1,-1
RECOLL.txt,21079,22669,1590,10,N,N,-,-1,-1
RECOLL.txt,21295,22743,1448,10,N,N,-,-1,-1
RECOLL.txt,21358,22905,1547,10,N,N,-,-1,-1
RECOLL.txt,21595,23127,1532,10,N,N,-,-1,-1
RECOLL.txt,21688,23249,1561,10,N,N,-,-1,-1
RECOLL.txt,21978,23345,1367,10,N,N,-,-1,-1
RECOLL.txt,22034,23467,1433,10,N,N,-,-1,-1
RECOLL.txt,22176,23566,1390,10,N,N,-,-1,-1
RECOLL.txt,22342,23704,1362,10,N,N,-,-1,-1
RECOLL.txt,22473,23916,1443,10,N,N,-,-1,-1
RECOLL.txt,22672,23998,1326,10,N,N,-,-1,-1
RECOLL.txt,22744,24132,1388,10,N,N,-,-1,-1
RECOLL.txt,22906,24416,1510,10,N,N,-,-1,-1
RECOLL.txt,23129,24536,1407,10,N,N,-,-1,-1
RECOLL.txt,23250,24704,1454,10,N,N,-,-1,-1
RECOLL.txt,23346,24917,1571,10,N,N,-,-1,-1
RECOLL.txt,23468,25186,1718,10,N,N,-,-1,-1
RECOLL.txt,23567,25306,1739,10,N,N,-,-1,-1
RECOLL.txt,23707,25443,1736,10,N,N,-,-1,-1
RECOLL.txt,23917,25711,1794,10,N,N,-,-1,-1
RECOLL.txt,24001,26028,2027,10,N,N,-,-1,-1
RECOLL.txt,24134,26244,2110,10,N,N,-,-1,-1
RECOLL.txt,24419,26285,1866,10,N,N,-,-1,-1
RECOLL.txt,24537,26398,1861,10,N,N,-,-1,-1
RECOLL.txt,24705,26684,1979,10,N,N,-,-1,-1
RECOLL.txt,24918,26861,1943,10,N,N,-,-1,-1
RECOLL.txt,25189,26911,1722,10,N,N,-,-1,-1
RECOLL.txt,25307,27143,1836,10,N,N,-,-1,-1
RECOLL.txt,25444,27411,1967,10,N,N,-,-1,-1
RECOLL.txt,25712,27612,1900,10,N,N,-,-1,-1
RECOLL.txt,26031,27652,1621,10,N,N,-,-1,-1
RECOLL.txt,26245,27825,1580,10,N,N,-,-1,-1
RECOLL.txt,26286,27967,1681,10,N,N,-,-1,-1
RECOLL.txt,26403,28076,1673,10,N,N,-,-1,-1
RECOLL.txt,26685,28097,1412,10,N,N,-,-1,-1
RECOLL.txt,26862,28270,1408,10,N,N,-,-1,-1
RECOLL.txt,26914,28336,1422,10,N,N,-,-1,-1
RECOLL.txt,27145,28429,1284,10,N,N,-,-1,-1
RECOLL.txt,27412,28668,1256,10,N,N,-,-1,-1
RECOLL.txt,27613,28776,1163,10,N,N,-,-1,-1
RECOLL.txt,27655,29034,1379,10,N,N,-,-1,-1
RECOLL.txt,27826,29071,1245,10,N,N,-,-1,-1
RECOLL.txt,27968,29120,1152,10,N,N,-,-1,-1
RECOLL.txt,28077,29257,1180,10,N,N,-,-1,-1
RECOLL.txt,28098,29354,1256,10,N,N,-,-1,-1
RECOLL.txt,28272,29441,1169,10,N,N,-,-1,-1
RECOLL.txt,28337,29517,1180,10,N,N,-,-1,-1
RECOLL.txt,28432,29699,1267,10,N,N,-,-1,-1
RECOLL.txt,28669,29791,1122,10,N,N,-,-1,-1
RECOLL.txt,28781,29860,1079,10,N,N,-,-1,-1
RECOLL.txt,29035,29952,917,10,N,N,-,-1,-1
RECOLL.txt,29072,30042,970,10,N,N,-,-1,-1
RECOLL.txt,29121,30151,1030,10,N,N,-,-1,-1
RECOLL.txt,29259,30309,1050,10,N,N,-,-1,-1
RECOLL.txt,29355,30344,989,10,N,N,-,-1,-1
RECOLL.txt,29442,30447,1005,10,N,N,-,-1,-1
RECOLL.txt,29520,30573,1053,10,N,N,-,-1,-1
RECOLL.txt,29700,30620,920,10,N,N,-,-1,-1
RECOLL.txt,29792,30642,850,10,N,N,-,-1,-1
RECOLL.txt,29861,30743,882,10,N,N,-,-1,-1
RECOLL.txt,29953,30825,872,10,N,N,-,-1,-1
RECOLL.txt,30047,31020,973,10,N,N,-,-1,-1
RECOLL.txt,30152,31184,1032,10,N,N,-,-1,-1
RECOLL.txt,30310,31275,965,10,N,N,-,-1,-1
RECOLL.txt,30346,31379,1033,10,N,N,-,-1,-1
RECOLL.txt,30448,31431,983,10,Y,Y,1448316411409,206556,208475
RECOLL.txt,30576,31515,939,10,Y,Y,1448316411409,206556,208475
RECOLL.txt,30622,31674,1052,10,Y,Y,1448316411409,206556,208475
RECOLL.txt,30643,31750,1107,10,Y,Y,1448316411409,206556,208475
RECOLL.txt,30744,31839,1095,10,Y,Y,1448316411409,206556,208475
RECOLL.txt,30826,31938,1112,10,Y,Y,1448316411409,206556,208475
RECOLL.txt,31021,32024,1003,10,Y,Y,1448316411409,206556,208475
RECOLL.txt,31185,32080,895,10,Y,Y,1448316411409,206556,208475
RECOLL.txt,31278,32118,840,10,N,Y,1448316411409,206556,208475
RECOLL.txt,31380,32340,960,10,Y,Y,1448316411409,206556,208475
RECOLL.txt,31432,32432,1000,10,N,Y,1448316411409,206556,208475
RECOLL.txt,31516,32497,981,10,N,Y,1448316411409,206556,208475
RECOLL.txt,31675,32692,1017,10,N,Y,1448316411409,206556,208475
RECOLL.txt,31751,32786,1035,10,N,Y,1448316411409,206556,208475
RECOLL.txt,31840,33056,1216,10,N,Y,1448316411409,206556,208475
RECOLL.txt,31939,33116,1177,10,N,Y,1448316411409,206556,208475
RECOLL.txt,32027,33267,1240,10,N,Y,1448316411409,206556,208475
RECOLL.txt,32081,33397,1316,10,N,Y,1448316411409,206556,208475
RECOLL.txt,32119,33512,1393,10,N,Y,1448316411409,206556,208475
RECOLL.txt,32341,33592,1251,10,N,Y,1448316411409,206556,208475
RECOLL.txt,32433,33764,1331,10,N,Y,1448316411409,206556,208475
RECOLL.txt,32498,33843,1345,10,N,Y,1448316411409,206556,208475
RECOLL.txt,32693,34018,1325,10,N,Y,1448316411409,206556,208475
RECOLL.txt,32787,34458,1671,10,Y,Y,1448316411409,206556,208475
RECOLL.txt,33057,34536,1479,10,Y,Y,1448280297446,84055,84972
RECOLL.txt,33119,34605,1486,10,Y,Y,1448280297446,84055,84972
RECOLL.txt,33268,34818,1550,10,Y,Y,1448280297446,84055,84972
RECOLL.txt,33399,35045,1646,10,N,Y,1448280297446,84055,84972
RECOLL.txt,33513,35107,1594,10,N,Y,1448278425221,65586,65914
RECOLL.txt,33593,35247,1654,10,Y,Y,1448278425221,65586,65914
RECOLL.txt,33767,35457,1690,10,N,Y,1448278425221,65586,65914
RECOLL.txt,33844,35551,1707,10,N,Y,1448278425221,65586,65914
RECOLL.txt,34019,35634,1615,10,N,Y,1448278425221,65586,65914
RECOLL.txt,34461,35835,1374,10,N,Y,1448278425221,65586,65914
RECOLL.txt,34537,35973,1436,10,N,Y,1448278425221,65586,65914
RECOLL.txt,34606,36278,1672,10,Y,Y,1448278425221,65586,65914
RECOLL.txt,34820,36715,1895,10,Y,Y,1448278425221,65586,65914
RECOLL.txt,35048,36927,1879,10,Y,Y,1448278425221,65586,65914
RECOLL.txt,35108,36996,1888,10,Y,Y,1448278425221,65586,65914
RECOLL.txt,35248,37076,1828,10,Y,Y,1448278425221,65586,65914
RECOLL.txt,35458,37226,1768,10,Y,Y,1448278425221,65586,65914
RECOLL.txt,35552,37344,1792,10,Y,Y,1448278425221,65586,65914
RECOLL.txt,35635,37486,1851,10,Y,Y,1448278425221,65586,65914
RECOLL.txt,35838,37664,1826,10,Y,Y,1448287490368,120754,123385
RECOLL.txt,35974,37768,1794,10,Y,Y,1448287490368,120754,123385
RECOLL.txt,36279,37948,1669,10,Y,Y,1448287490368,120754,123385
RECOLL.txt,36716,38182,1466,10,Y,Y,1448287490368,120754,123385
RECOLL.txt,36930,38229,1299,10,Y,Y,1448287490368,120754,123385
RECOLL.txt,36997,38349,1352,10,Y,Y,1448287490368,120754,123385
RECOLL.txt,37077,38533,1456,10,Y,Y,1448287490368,120754,123385
RECOLL.txt,37227,38584,1357,10,Y,Y,1448287490368,120754,123385
RECOLL.txt,37346,38678,1332,10,Y,Y,1448287490368,120754,123385
RECOLL.txt,37491,38957,1466,10,Y,Y,1448287490368,120754,123385
RECOLL.txt,37664,39024,1360,10,N,Y,1448287490368,120754,123385
RECOLL.txt,37769,39173,1404,10,N,Y,1448287490368,120754,123385
RECOLL.txt,37949,39197,1248,10,N,Y,1448287490368,120754,123385
RECOLL.txt,38185,39295,1110,10,N,N,-,-1,-1
RECOLL.txt,38231,39348,1117,10,N,N,-,-1,-1
RECOLL.txt,38350,39614,1264,10,N,N,-,-1,-1
RECOLL.txt,38538,39690,1152,10,N,N,-,-1,-1
RECOLL.txt,38585,39748,1163,10,N,N,-,-1,-1
RECOLL.txt,38679,39827,1148,10,N,Y,1448313800274,179025,179317
RECOLL.txt,38958,40102,1144,10,N,Y,1448313800274,179025,179317
RECOLL.txt,39027,40299,1272,10,N,Y,1448313800274,179025,179317
RECOLL.txt,39174,40551,1377,10,N,Y,1448313800274,179025,179317
RECOLL.txt,39198,40631,1433,10,N,Y,1448313800274,179025,179317
RECOLL.txt,39298,40795,1497,10,N,Y,1448313800274,179025,179317
RECOLL.txt,39349,40906,1557,10,N,Y,1448313800274,179025,179317
RECOLL.txt,39616,40999,1383,10,N,Y,1448313800274,179025,179317
RECOLL.txt,39691,41245,1554,10,Y,Y,1448313800274,179025,179317
RECOLL.txt,39750,41338,1588,10,Y,Y,1448313800274,179025,179317
RECOLL.txt,39828,41436,1608,10,Y,Y,1448313800274,179025,179317
RECOLL.txt,40105,41513,1408,10,N,Y,1448313800274,179025,179317
RECOLL.txt,40300,41692,1392,10,N,Y,1448313800274,179025,179317
RECOLL.txt,40552,41763,1211,10,N,Y,1448313800274,179025,179317
RECOLL.txt,40634,41816,1182,10,N,N,-,-1,-1
RECOLL.txt,40796,41944,1148,10,N,N,-,-1,-1
RECOLL.txt,40908,42016,1108,10,N,N,-,-1,-1
RECOLL.txt,41001,42081,1080,10,N,N,-,-1,-1
RECOLL.txt,41246,42195,949,10,N,N,-,-1,-1
RECOLL.txt,41339,42579,1240,10,N,N,-,-1,-1
RECOLL.txt,41437,42645,1208,10,N,N,-,-1,-1
RECOLL.txt,41514,42837,1323,10,N,N,-,-1,-1
RECOLL.txt,41693,42945,1252,10,N,N,-,-1,-1
RECOLL.txt,41766,43080,1314,10,N,N,-,-1,-1
RECOLL.txt,41817,43110,1293,10,N,N,-,-1,-1
RECOLL.txt,41946,43195,1249,10,N,N,-,-1,-1
RECOLL.txt,42017,43276,1259,10,N,N,-,-1,-1
RECOLL.txt,42082,43343,1261,10,N,N,-,-1,-1
RECOLL.txt,42196,43443,1247,10,N,N,-,-1,-1
RECOLL.txt,42581,43662,1081,10,N,N,-,-1,-1
RECOLL.txt,42646,43838,1192,10,N,N,-,-1,-1
RECOLL.txt,42838,43900,1062,10,N,N,-,-1,-1
RECOLL.txt,42946,43949,1003,10,N,N,-,-1,-1
RECOLL.txt,43081,44030,949,10,N,N,-,-1,-1
RECOLL.txt,43113,44087,974,10,N,N,-,-1,-1
RECOLL.txt,43196,44215,1019,10,N,N,-,-1,-1
RECOLL.txt,43277,44272,995,10,N,N,-,-1,-1
RECOLL.txt,43345,44341,996,10,N,N,-,-1,-1
RECOLL.txt,43444,44427,983,10,N,N,-,-1,-1
RECOLL.txt,43663,44476,813,10,N,N,-,-1,-1
RECOLL.txt,43839,44540,701,10,N,N,-,-1,-1
RECOLL.txt,43902,44605,703,10,N,N,-,-1,-1
RECOLL.txt,43951,44680,729,10,N,N,-,-1,-1
RECOLL.txt,44031,44810,779,10,N,N,-,-1,-1
RECOLL.txt,44090,44922,832,10,N,N,-,-1,-1
RECOLL.txt,44216,45046,830,10,N,N,-,-1,-1
RECOLL.txt,44273,45225,952,10,N,N,-,-1,-1
RECOLL.txt,44342,45389,1047,10,N,N,-,-1,-1
RECOLL.txt,44428,45645,1217,10,N,N,-,-1,-1
RECOLL.txt,44477,45750,1273,10,N,N,-,-1,-1
RECOLL.txt,44541,46053,1512,10,N,N,-,-1,-1
RECOLL.txt,44607,46226,1619,10,N,N,-,-1,-1
RECOLL.txt,44683,46319,1636,10,N,N,-,-1,-1
RECOLL.txt,44812,46385,1573,10,N,N,-,-1,-1
RECOLL.txt,44923,46623,1700,10,N,N,-,-1,-1
RECOLL.txt,45051,46808,1757,10,N,N,-,-1,-1
RECOLL.txt,45226,46944,1718,10,N,N,-,-1,-1
RECOLL.txt,45390,47026,1636,10,N,N,-,-1,-1
RECOLL.txt,45647,47109,1462,10,N,N,-,-1,-1
RECOLL.txt,45751,47271,1520,10,N,N,-,-1,-1
RECOLL.txt,46055,47359,1304,10,N,N,-,-1,-1
RECOLL.txt,46227,47380,1153,10,N,N,-,-1,-1
RECOLL.txt,46322,47535,1213,10,N,N,-,-1,-1
RECOLL.txt,46390,47629,1239,10,N,N,-,-1,-1
RECOLL.txt,46624,47892,1268,10,N,Y,1448039370049,20775,21297
RECOLL.txt,46809,48008,1199,10,N,Y,1448039370049,20775,21297
RECOLL.txt,46945,48216,1271,10,N,Y,1448039370049,20775,21297
RECOLL.txt,47029,48236,1207,10,N,Y,1448039370049,20775,21297
RECOLL.txt,47110,48285,1175,10,N,Y,1448039370049,20775,21297
RECOLL.txt,47272,48476,1204,10,N,Y,1448039370049,20775,21297
RECOLL.txt,47360,48711,1351,10,N,Y,1448039370049,20775,21297
RECOLL.txt,47381,48780,1399,10,N,Y,1448039370049,20775,21297
RECOLL.txt,47536,48897,1361,10,N,Y,1448039370049,20775,21297
RECOLL.txt,47630,48924,1294,10,N,Y,1448039370049,20775,21297
RECOLL.txt,47894,49106,1212,10,N,Y,1448039370049,20775,21297
RECOLL.txt,48009,49250,1241,10,N,Y,1448039370049,20775,21297
RECOLL.txt,48217,49432,1215,10,N,Y,1448039370049,20775,21297
RECOLL.txt,48237,49608,1371,10,N,Y,1448039370049,20775,21297
RECOLL.txt,48287,49679,1392,10,N,Y,1448039370049,20775,21297
RECOLL.txt,48478,49852,1374,10,N,Y,1448039370049,20775,21297
RECOLL.txt,48714,50013,1299,10,N,Y,1448039370049,20775,21297
RECOLL.txt,48781,50040,1259,10,N,Y,1448039370049,20775,21297
RECOLL.txt,48898,50057,1159,10,N,Y,1448039370049,20775,21297
RECOLL.txt,48925,50129,1204,10,N,Y,1448039370049,20775,21297
RECOLL.txt,49107,50279,1172,10,N,Y,1448039370049,20775,21297
RECOLL.txt,49251,50463,1212,10,N,Y,1448039370049,20775,21297
RECOLL.txt,49435,50623,1188,10,N,N,-,-1,-1
RECOLL.txt,49609,50938,1329,10,N,N,-,-1,-1
RECOLL.txt,49680,51087,1407,10,N,N,-,-1,-1
RECOLL.txt,49854,51225,1371,10,N,N,-,-1,-1
RECOLL.txt,50016,51290,1274,10,N,N,-,-1,-1
RECOLL.txt,50041,51332,1291,10,N,N,-,-1,-1
RECOLL.txt,50059,51513,1454,10,N,Y,1448037533268,13930,15031
RECOLL.txt,50130,51571,1441,10,N,Y,1448037533268,13930,15031
RECOLL.txt,50280,51865,1585,10,N,Y,1448037533268,13930,15031
RECOLL.txt,50464,51933,1469,10,N,Y,1448037533268,13930,15031
RECOLL.txt,50624,52154,1530,10,Y,Y,1448037533268,13930,15031
RECOLL.txt,50940,52284,1344,10,Y,Y,1448037533268,13930,15031
RECOLL.txt,51088,52456,1368,10,Y,Y,1448037533268,13930,15031
RECOLL.txt,51228,52494,1266,10,Y,Y,1448037533268,13930,15031
RECOLL.txt,51291,52622,1331,10,Y,Y,1448037533268,13930,15031
RECOLL.txt,51337,52686,1349,10,Y,Y,1448037533268,13930,15031
RECOLL.txt,51514,52803,1289,10,Y,Y,1448037533268,13930,15031
RECOLL.txt,51574,52948,1374,10,Y,Y,1448037533268,13930,15031
RECOLL.txt,51866,53104,1238,10,Y,Y,1448037533268,13930,15031
RECOLL.txt,51935,53466,1531,10,Y,Y,1448037533268,13930,15031
RECOLL.txt,52155,53697,1542,10,Y,Y,1448037533268,13930,15031
RECOLL.txt,52285,53788,1503,10,Y,Y,1448037533268,13930,15031
RECOLL.txt,52457,54040,1583,10,Y,Y,1448037533268,13930,15031
RECOLL.txt,52495,54071,1576,10,Y,Y,1448037533268,13930,15031
RECOLL.txt,52625,54286,1661,10,Y,Y,1448313123004,175370,176057
RECOLL.txt,52687,54390,1703,10,Y,Y,1448313123004,175370,176057
RECOLL.txt,52804,54615,1811,10,Y,Y,1448313123004,175370,176057
RECOLL.txt,52950,54970,2020,10,Y,Y,1448313123004,175370,176057
RECOLL.txt,53105,55142,2037,10,Y,Y,1448313123004,175370,176057
RECOLL.txt,53467,55301,1834,10,Y,Y,1448313123004,175370,176057
RECOLL.txt,53702,55361,1659,10,N,Y,1448313123004,175370,176057
RECOLL.txt,53790,55525,1735,10,N,Y,1448313123004,175370,176057
RECOLL.txt,54041,55545,1504,10,N,Y,1448313123004,175370,176057
RECOLL.txt,54074,55676,1602,10,Y,Y,1448313123004,175370,176057
RECOLL.txt,54287,55830,1543,10,Y,Y,1448313123004,175370,176057
RECOLL.txt,54391,55895,1504,10,Y,Y,1448313123004,175370,176057
RECOLL.txt,54616,56030,1414,10,Y,Y,1448313123004,175370,176057
RECOLL.txt,54971,56189,1218,10,Y,Y,1448313123004,175370,176057
RECOLL.txt,55145,56302,1157,10,Y,Y,1448313123004,175370,176057
RECOLL.txt,55302,56435,1133,10,Y,N,-,-1,-1
RECOLL.txt,55363,56476,1113,10,Y,N,-,-1,-1
RECOLL.txt,55526,56724,1198,10,Y,N,-,-1,-1
RECOLL.txt,55546,56955,1409,10,Y,N,-,-1,-1
RECOLL.txt,55679,57092,1413,10,Y,N,-,-1,-1
RECOLL.txt,55831,57158,1327,10,Y,N,-,-1,-1
RECOLL.txt,55898,57295,1397,10,Y,N,-,-1,-1
RECOLL.txt,56031,57491,1460,10,Y,N,-,-1,-1
RECOLL.txt,56190,57616,1426,10,N,N,-,-1,-1
RECOLL.txt,56307,57817,1510,10,N,N,-,-1,-1
RECOLL.txt,56437,57938,1501,10,N,Y,1448313994373,179347,179715
RECOLL.txt,56477,57996,1519,10,N,Y,1448313994373,179347,179715
RECOLL.txt,56726,58113,1387,10,N,Y,1448313994373,179347,179715
RECOLL.txt,56956,58193,1237,10,N,Y,1448313994373,179347,179715
RECOLL.txt,57093,58295,1202,10,N,Y,1448313994373,179347,179715
RECOLL.txt,57161,58489,1328,10,Y,Y,1448313994373,179347,179715
RECOLL.txt,57297,58793,1496,10,Y,Y,1448313994373,179347,179715
RECOLL.txt,57494,58893,1399,10,Y,Y,1448313994373,179347,179715
RECOLL.txt,57617,59021,1404,10,Y,Y,1448313994373,179347,179715
RECOLL.txt,57820,59136,1316,10,Y,Y,1448313994373,179347,179715
RECOLL.txt,57939,59209,1270,10,Y,Y,1448313994373,179347,179715
RECOLL.txt,57998,59273,1275,10,Y,Y,1448313994373,179347,179715
RECOLL.txt,58114,59374,1260,10,Y,Y,1448313994373,179347,179715
RECOLL.txt,58194,59422,1228,10,Y,Y,1448313994373,179347,179715
RECOLL.txt,58296,59471,1175,10,Y,Y,1448313994373,179347,179715
RECOLL.txt,58492,59643,1151,10,Y,Y,1448313994373,179347,179715
RECOLL.txt,58794,59751,957,10,Y,Y,1448313994373,179347,179715
RECOLL.txt,58894,59838,944,10,Y,Y,1448313994373,179347,179715
RECOLL.txt,59022,59958,936,10,Y,Y,1448313994373,179347,179715
RECOLL.txt,59137,60146,1009,10,N,Y,1448313994373,179347,179715
RECOLL.txt,59212,60204,992,10,N,N,-,-1,-1
RECOLL.txt,59274,60446,1172,10,N,N,-,-1,-1
RECOLL.txt,59375,60558,1183,10,N,N,-,-1,-1
RECOLL.txt,59423,60686,1263,10,N,N,-,-1,-1
RECOLL.txt,59474,60876,1402,10,N,N,-,-1,-1
RECOLL.txt,59644,60916,1272,10,N,N,-,-1,-1
RECOLL.txt,59752,60945,1193,10,N,N,-,-1,-1
RECOLL.txt,59840,61065,1225,10,N,N,-,-1,-1
RECOLL.txt,59961,61144,1183,10,N,N,-,-1,-1
RECOLL.txt,60147,61393,1246,10,N,N,-,-1,-1
RECOLL.txt,60205,61413,1208,10,N,N,-,-1,-1
RECOLL.txt,60447,61681,1234,10,N,N,-,-1,-1
RECOLL.txt,60560,62216,1656,10,N,N,-,-1,-1
RECOLL.txt,60687,62334,1647,10,N,N,-,-1,-1
RECOLL.txt,60877,62421,1544,10,N,N,-,-1,-1
RECOLL.txt,60917,62457,1540,10,N,N,-,-1,-1
RECOLL.txt,60948,62528,1580,10,N,N,-,-1,-1
RECOLL.txt,61066,62940,1874,10,N,N,-,-1,-1
RECOLL.txt,61145,63187,2042,10,N,N,-,-1,-1
RECOLL.txt,61398,63381,1983,10,N,N,-,-1,-1
RECOLL.txt,61418,63453,2035,10,N,N,-,-1,-1
RECOLL.txt,61684,63615,1931,10,N,N,-,-1,-1
RECOLL.txt,62217,63711,1494,10,N,N,-,-1,-1
RECOLL.txt,62335,63814,1479,10,N,N,-,-1,-1
RECOLL.txt,62422,63873,1451,10,N,Y,1437471397525,350644,351290
RECOLL.txt,62458,64048,1590,10,N,Y,1437471397525,350644,351290
RECOLL.txt,62531,64091,1560,10,N,Y,1437471397525,350644,351290
RECOLL.txt,62941,64192,1251,10,N,Y,1437471397525,350644,351290
RECOLL.txt,63188,64391,1203,10,N,Y,1437471397525,350644,351290
RECOLL.txt,63384,64558,1174,10,N,Y,1437471397525,350644,351290
RECOLL.txt,63454,64759,1305,10,N,Y,1437471397525,350644,351290
RECOLL.txt,63616,64847,1231,10,N,Y,1437471397525,350644,351290
RECOLL.txt,63712,64949,1237,10,N,Y,1437471397525,350644,351290
RECOLL.txt,63817,65014,1197,10,N,Y,1437471397525,350644,351290
RECOLL.txt,63874,65095,1221,10,N,Y,1437471397525,350644,351290
RECOLL.txt,64049,65177,1128,10,N,Y,1437471397525,350644,351290
RECOLL.txt,64092,65352,1260,10,N,Y,1437471397525,350644,351290
RECOLL.txt,64193,65611,1418,10,N,Y,1437471397525,350644,351290
RECOLL.txt,64394,65635,1241,10,N,Y,1448312844411,173573,174472
RECOLL.txt,64559,65821,1262,10,N,Y,1448312844411,173573,174472
RECOLL.txt,64760,65992,1232,10,N,Y,1448312844411,173573,174472
RECOLL.txt,64848,66191,1343,10,N,Y,1448312844411,173573,174472
RECOLL.txt,64950,66250,1300,10,N,Y,1448312844411,173573,174472
RECOLL.txt,65015,66255,1240,10,N,Y,1448312844411,173573,174472
RECOLL.txt,65096,66296,1200,10,N,Y,1448312844411,173573,174472
RECOLL.txt,65178,66301,1123,10,N,Y,1448312844411,173573,174472
RECOLL.txt,65353,66372,1019,10,N,Y,1448312844411,173573,174472
RECOLL.txt,65612,66493,881,10,N,Y,1448312844411,173573,174472
RECOLL.txt,65640,66627,987,10,N,N,-,-1,-1
RECOLL.txt,65822,66656,834,10,N,N,-,-1,-1
RECOLL.txt,65993,66661,668,10,N,N,-,-1,-1
RECOLL.txt,66192,66690,498,10,N,N,-,-1,-1
RECOLL.txt,66253,66695,442,10,N,N,-,-1,-1
RECOLL.txt,66256,66734,478,10,N,N,-,-1,-1
RECOLL.txt,66299,66739,440,10,N,N,-,-1,-1
RECOLL.txt,66302,66772,470,10,N,Y,1448366107348,271942,274308
RECOLL.txt,66373,67001,628,10,N,Y,1448366107348,271942,274308
RECOLL.txt,66494,67153,659,10,N,Y,1448366107348,271942,274308
RECOLL.txt,66628,67369,741,10,N,Y,1448366107348,271942,274308
RECOLL.txt,66659,67509,850,10,N,Y,1448366107348,271942,274308
RECOLL.txt,66662,67561,899,10,N,Y,1448366107348,271942,274308
RECOLL.txt,66693,67624,931,10,N,Y,1448366107348,271942,274308
RECOLL.txt,66696,67758,1062,10,N,Y,1448366107348,271942,274308
RECOLL.txt,66737,67902,1165,10,N,Y,1448366107348,271942,274308
RECOLL.txt,66740,68037,1297,10,N,Y,1448366107348,271942,274308
RECOLL.txt,66775,68219,1444,10,Y,Y,1448366107348,271942,274308
RECOLL.txt,67004,68239,1235,10,N,Y,1448366107348,271942,274308
RECOLL.txt,67154,68297,1143,10,N,Y,1448366107348,271942,274308
RECOLL.txt,67372,68498,1126,10,N,N,-,-1,-1
RECOLL.txt,67510,68569,1059,10,N,N,-,-1,-1
RECOLL.txt,67562,68660,1098,10,N,N,-,-1,-1
RECOLL.txt,67625,68701,1076,10,N,N,-,-1,-1
RECOLL.txt,67761,68750,989,10,N,N,-,-1,-1
RECOLL.txt,67903,68832,929,10,N,N,-,-1,-1
RECOLL.txt,68038,69136,1098,10,N,N,-,-1,-1
RECOLL.txt,68220,69460,1240,10,N,Y,1448321627053,211159,212725
RECOLL.txt,68240,69750,1510,10,Y,Y,1448321627053,211159,212725
RECOLL.txt,68300,69771,1471,10,Y,Y,1448321627053,211159,212725
RECOLL.txt,68499,69799,1300,10,Y,Y,1448321627053,211159,212725
RECOLL.txt,68570,69879,1309,10,Y,Y,1448321627053,211159,212725
RECOLL.txt,68661,70003,1342,10,Y,Y,1448321627053,211159,212725
RECOLL.txt,68702,70094,1392,10,Y,Y,1448321627053,211159,212725
RECOLL.txt,68752,70205,1453,10,Y,Y,1448321627053,211159,212725
RECOLL.txt,68835,70258,1423,10,Y,Y,1448321627053,211159,212725
RECOLL.txt,69137,70345,1208,10,Y,Y,1448321627053,211159,212725
RECOLL.txt,69461,70466,1005,10,Y,Y,1448321627053,211159,212725
RECOLL.txt,69753,70481,728,10,N,Y,1448321627053,211159,212725
RECOLL.txt,69772,70507,735,10,N,Y,1448321627053,211159,212725
RECOLL.txt,69800,70724,924,10,N,Y,1448321627053,211159,212725
RECOLL.txt,69880,70870,990,10,N,Y,1448321627053,211159,212725
RECOLL.txt,70004,70932,928,10,N,Y,1448321627053,211159,212725
RECOLL.txt,70095,71020,925,10,N,Y,1448321627053,211159,212725
RECOLL.txt,70207,71136,929,10,N,Y,1448321627053,211159,212725
RECOLL.txt,70259,71441,1182,10,N,Y,1448321627053,211159,212725
RECOLL.txt,70346,71545,1199,10,N,Y,1448321627053,211159,212725
RECOLL.txt,70467,71641,1174,10,N,Y,1448321627053,211159,212725
RECOLL.txt,70482,71666,1184,10,Y,Y,1448321627053,211159,212725
RECOLL.txt,70512,71697,1185,10,Y,Y,1448321627053,211159,212725
RECOLL.txt,70725,71763,1038,10,Y,Y,1448321627053,211159,212725
RECOLL.txt,70873,71905,1032,10,Y,Y,1436867017136,105674,106651
RECOLL.txt,70933,71951,1018,10,Y,Y,1436867017136,105674,106651
RECOLL.txt,71021,72055,1034,10,Y,Y,1436867017136,105674,106651
RECOLL.txt,71138,72185,1047,10,Y,Y,1436867017136,105674,106651
RECOLL.txt,71442,72289,847,10,Y,Y,1436867017136,105674,106651
RECOLL.txt,71548,72345,797,10,Y,Y,1436867017136,105674,106651
RECOLL.txt,71642,72386,744,10,N,Y,1436867017136,105674,106651
RECOLL.txt,71669,72417,748,10,N,Y,1436867017136,105674,106651
RECOLL.txt,71698,72425,727,10,N,Y,1436867017136,105674,106651
RECOLL.txt,71764,72430,666,10,N,Y,1436867017136,105674,106651
RECOLL.txt,71906,72456,550,10,N,Y,1436867017136,105674,106651
RECOLL.txt,71952,72483,531,10,N,Y,1436867017136,105674,106651
RECOLL.txt,72056,72488,432,10,N,N,-,-1,-1
RECOLL.txt,72186,72510,324,10,N,N,-,-1,-1
RECOLL.txt,72292,72515,223,10,N,N,-,-1,-1
RECOLL.txt,72346,72568,222,10,N,N,-,-1,-1
RECOLL.txt,72387,72573,186,10,N,N,-,-1,-1
RECOLL.txt,72418,72621,203,10,N,N,-,-1,-1
RECOLL.txt,72428,72636,208,10,N,N,-,-1,-1
RECOLL.txt,72431,72641,210,10,N,N,-,-1,-1
RECOLL.txt,72457,72685,228,10,N,N,-,-1,-1
RECOLL.txt,72486,72690,204,10,N,N,-,-1,-1
RECOLL.txt,72489,72777,288,10,N,N,-,-1,-1
RECOLL.txt,72513,72787,274,10,N,N,-,-1,-1
RECOLL.txt,72516,72792,276,10,N,N,-,-1,-1
RECOLL.txt,72571,72827,256,10,N,N,-,-1,-1
RECOLL.txt,72574,72829,255,10,N,N,-,-1,-1
RECOLL.txt,72623,72838,215,10,N,N,-,-1,-1
RECOLL.txt,72639,72843,204,10,N,N,-,-1,-1
RECOLL.txt,72642,72875,233,10,N,N,-,-1,-1
RECOLL.txt,72688,73001,313,10,N,N,-,-1,-1
RECOLL.txt,72691,73087,396,10,N,N,-,-1,-1
RECOLL.txt,72778,73189,411,10,N,N,-,-1,-1
RECOLL.txt,72790,73234,444,10,N,N,-,-1,-1
RECOLL.txt,72793,73343,550,10,N,N,-,-1,-1
RECOLL.txt,72828,73496,668,10,N,N,-,-1,-1
RECOLL.txt,72830,73568,738,10,N,N,-,-1,-1
RECOLL.txt,72840,73625,785,10,N,N,-,-1,-1
RECOLL.txt,72844,73714,870,10,N,N,-,-1,-1
RECOLL.txt,72876,73860,984,10,N,N,-,-1,-1
RECOLL.txt,73006,73887,881,10,N,N,-,-1,-1
RECOLL.txt,73088,74017,929,10,N,N,-,-1,-1
RECOLL.txt,73190,74105,915,10,N,N,-,-1,-1
RECOLL.txt,73235,74223,988,10,N,N,-,-1,-1
RECOLL.txt,73344,74323,979,10,N,N,-,-1,-1
RECOLL.txt,73499,74473,974,10,N,N,-,-1,-1
RECOLL.txt,73569,74678,1109,10,N,N,-,-1,-1
RECOLL.txt,73626,74806,1180,10,N,N,-,-1,-1
RECOLL.txt,73715,74988,1273,10,N,N,-,-1,-1
RECOLL.txt,73861,75068,1207,10,N,N,-,-1,-1
RECOLL.txt,73888,75154,1266,10,N,N,-,-1,-1
RECOLL.txt,74018,75328,1310,10,N,N,-,-1,-1
RECOLL.txt,74108,75493,1385,10,N,Y,1448275023016,26258,26837
RECOLL.txt,74224,75584,1360,10,Y,Y,1448275023016,26258,26837
RECOLL.txt,74324,75709,1385,10,Y,Y,1448275023016,26258,26837
RECOLL.txt,74475,75769,1294,10,Y,Y,1448275023016,26258,26837
RECOLL.txt,74681,75847,1166,10,Y,Y,1448275023016,26258,26837
RECOLL.txt,74807,75910,1103,10,Y,Y,1448275023016,26258,26837
RECOLL.txt,74989,76125,1136,10,N,Y,1448275023016,26258,26837
RECOLL.txt,75069,76406,1337,10,N,Y,1448275023016,26258,26837
RECOLL.txt,75157,76537,1380,10,N,Y,1448275023016,26258,26837
RECOLL.txt,75329,76653,1324,10,N,Y,1448275023016,26258,26837
RECOLL.txt,75494,76842,1348,10,N,Y,1448275023016,26258,26837
RECOLL.txt,75585,76944,1359,10,N,Y,1448275023016,26258,26837
RECOLL.txt,75711,77155,1444,10,N,Y,1448275023016,26258,26837
RECOLL.txt,75770,77245,1475,10,N,Y,1448275023016,26258,26837
RECOLL.txt,75850,77310,1460,10,N,Y,1448315841759,183531,183799
RECOLL.txt,75911,77376,1465,10,N,Y,1448315841759,183531,183799
RECOLL.txt,76126,77430,1304,10,N,Y,1448315841759,183531,183799
RECOLL.txt,76407,77623,1216,10,Y,Y,1448315841759,183531,183799
RECOLL.txt,76542,77796,1254,10,Y,Y,1448315841759,183531,183799
RECOLL.txt,76654,77921,1267,10,Y,Y,1448315841759,183531,183799
RECOLL.txt,76845,77973,1128,10,Y,Y,1448315841759,183531,183799
RECOLL.txt,76945,78064,1119,10,Y,Y,1448315841759,183531,183799
RECOLL.txt,77158,78361,1203,10,Y,Y,1448315841759,183531,183799
RECOLL.txt,77247,78445,1198,10,Y,Y,1448315841759,183531,183799
RECOLL.txt,77311,78549,1238,10,Y,Y,1448315841759,183531,183799
RECOLL.txt,77378,78713,1335,10,Y,Y,1448315841759,183531,183799
RECOLL.txt,77431,78827,1396,10,Y,Y,1448315841759,183531,183799
RECOLL.txt,77624,78995,1371,10,N,Y,1448315841759,183531,183799
RECOLL.txt,77801,79066,1265,10,N,N,-,-1,-1
RECOLL.txt,77922,79289,1367,10,N,N,-,-1,-1
RECOLL.txt,77975,79405,1430,10,N,N,-,-1,-1
RECOLL.txt,78067,79747,1680,10,N,N,-,-1,-1
RECOLL.txt,78362,79824,1462,10,N,N,-,-1,-1
RECOLL.txt,78447,80017,1570,10,Y,N,-,-1,-1
RECOLL.txt,78550,80143,1593,10,N,N,-,-1,-1
RECOLL.txt,78714,80246,1532,10,N,N,-,-1,-1
RECOLL.txt,78828,80290,1462,10,N,N,-,-1,-1
RECOLL.txt,78996,80394,1398,10,N,N,-,-1,-1
RECOLL.txt,79069,80505,1436,10,N,N,-,-1,-1
RECOLL.txt,79290,80590,1300,10,N,N,-,-1,-1
RECOLL.txt,79406,80859,1453,10,N,N,-,-1,-1
RECOLL.txt,79748,80995,1247,10,N,N,-,-1,-1
RECOLL.txt,79826,81155,1329,10,N,Y,1448282044001,101941,102395
RECOLL.txt,80018,81327,1309,10,N,Y,1448282044001,101941,102395
RECOLL.txt,80146,81400,1254,10,N,Y,1448282044001,101941,102395
RECOLL.txt,80247,81491,1244,10,N,Y,1448282044001,101941,102395
RECOLL.txt,80291,81617,1326,10,Y,Y,1448282044001,101941,102395
RECOLL.txt,80397,81682,1285,10,Y,Y,1448282044001,101941,102395
RECOLL.txt,80506,81937,1431,10,Y,Y,1448282044001,101941,102395
RECOLL.txt,80591,82080,1489,10,Y,Y,1448282044001,101941,102395
RECOLL.txt,80861,82275,1414,10,Y,Y,1448282044001,101941,102395
RECOLL.txt,81000,82428,1428,10,Y,Y,1448282044001,101941,102395
RECOLL.txt,81156,82523,1367,10,Y,Y,1448282044001,101941,102395
RECOLL.txt,81328,82709,1381,10,Y,Y,1448282044001,101941,102395
RECOLL.txt,81401,82926,1525,10,Y,Y,1448282044001,101941,102395
RECOLL.txt,81494,83023,1529,10,Y,Y,1448282044001,101941,102395
RECOLL.txt,81618,83197,1579,10,Y,Y,1448282044001,101941,102395
RECOLL.txt,81683,83255,1572,10,Y,Y,1448282044001,101941,102395
RECOLL.txt,81938,83434,1496,10,Y,Y,1448282044001,101941,102395
RECOLL.txt,82081,83594,1513,10,Y,Y,1448311594480,155711,156312
RECOLL.txt,82276,83661,1385,10,Y,Y,1448311594480,155711,156312
RECOLL.txt,82431,83761,1330,10,Y,Y,1448311594480,155711,156312
RECOLL.txt,82524,83981,1457,10,Y,Y,1448311594480,155711,156312
RECOLL.txt,82712,84054,1342,10,N,Y,1448311594480,155711,156312
RECOLL.txt,82929,84202,1273,10,N,Y,1448311594480,155711,156312
RECOLL.txt,83024,84343,1319,10,N,Y,1448311594480,155711,156312
RECOLL.txt,83198,84534,1336,10,N,Y,1448311594480,155711,156312
RECOLL.txt,83256,84556,1300,10,N,Y,1448311594480,155711,156312
RECOLL.txt,83437,84676,1239,10,N,Y,1448311594480,155711,156312
RECOLL.txt,83595,84762,1167,10,N,Y,1448311594480,155711,156312
RECOLL.txt,83662,84858,1196,10,Y,Y,1448311594480,155711,156312
RECOLL.txt,83762,84936,1174,10,Y,Y,1448311594480,155711,156312
RECOLL.txt,83984,85077,1093,10,N,N,-,-1,-1
RECOLL.txt,84055,85182,1127,10,N,N,-,-1,-1
RECOLL.txt,84204,85275,1071,10,N,N,-,-1,-1
RECOLL.txt,84345,85386,1041,10,N,N,-,-1,-1
RECOLL.txt,84539,85600,1061,10,Y,N,-,-1,-1
RECOLL.txt,84561,85672,1111,10,Y,N,-,-1,-1
RECOLL.txt,84679,85736,1057,10,Y,N,-,-1,-1
RECOLL.txt,84764,85829,1065,10,Y,Y,1448314503640,180207,180355
RECOLL.txt,84859,85940,1081,10,N,Y,1448314503640,180207,180355
RECOLL.txt,84937,86213,1276,10,N,Y,1448314503640,180207,180355
RECOLL.txt,85078,86399,1321,10,N,Y,1448314503640,180207,180355
RECOLL.txt,85185,86546,1361,10,N,Y,1448314503640,180207,180355
RECOLL.txt,85277,86821,1544,10,N,Y,1448314503640,180207,180355
RECOLL.txt,85389,86886,1497,10,N,Y,1448314503640,180207,180355
RECOLL.txt,85601,86976,1375,10,N,Y,1448314503640,180207,180355
RECOLL.txt,85673,87154,1481,10,N,Y,1448314503640,180207,180355
RECOLL.txt,85739,87403,1664,10,N,Y,1448314503640,180207,180355
RECOLL.txt,85830,87435,1605,10,N,Y,1448314503640,180207,180355
RECOLL.txt,85941,87549,1608,10,N,Y,1448314503640,180207,180355
RECOLL.txt,86214,87736,1522,10,N,Y,1448314503640,180207,180355
RECOLL.txt,86402,87815,1413,10,N,Y,1448314503640,180207,180355
RECOLL.txt,86547,87935,1388,10,N,Y,1448314503640,180207,180355
RECOLL.txt,86822,88125,1303,10,N,Y,1448314503640,180207,180355
RECOLL.txt,86887,88274,1387,10,N,Y,1448314503640,180207,180355
RECOLL.txt,86979,88626,1647,10,N,Y,1448314503640,180207,180355
RECOLL.txt,87156,88665,1509,10,N,Y,1448314503640,180207,180355
RECOLL.txt,87404,88817,1413,10,N,Y,1448314503640,180207,180355
RECOLL.txt,87437,88861,1424,10,N,Y,1448314503640,180207,180355
RECOLL.txt,87550,89069,1519,10,N,Y,1448314503640,180207,180355
RECOLL.txt,87739,89183,1444,10,N,Y,1448314503640,180207,180355
RECOLL.txt,87816,89385,1569,10,N,Y,1448314503640,180207,180355
RECOLL.txt,87936,89460,1524,10,N,Y,1448285563397,102964,108476
RECOLL.txt,88126,89538,1412,10,N,Y,1448285563397,102964,108476
RECOLL.txt,88275,89587,1312,10,N,Y,1448285563397,102964,108476
RECOLL.txt,88627,89809,1182,10,N,Y,1448285563397,102964,108476
RECOLL.txt,88666,89898,1232,10,N,Y,1448285563397,102964,108476
RECOLL.txt,88820,89929,1109,10,N,Y,1448285563397,102964,108476
RECOLL.txt,88863,90031,1168,10,N,Y,1448285563397,102964,108476
RECOLL.txt,89070,90153,1083,10,N,Y,1448285563397,102964,108476
RECOLL.txt,89184,90176,992,10,N,Y,1448285563397,102964,108476
RECOLL.txt,89388,90327,939,10,N,Y,1448285563397,102964,108476
RECOLL.txt,89461,90360,899,10,N,Y,1448285563397,102964,108476
RECOLL.txt,89539,90529,990,10,N,Y,1448285563397,102964,108476
RECOLL.txt,89588,90662,1074,10,Y,Y,1448285563397,102964,108476
RECOLL.txt,89810,90695,885,10,N,Y,1448285563397,102964,108476
RECOLL.txt,89899,90935,1036,10,N,Y,1448285563397,102964,108476
RECOLL.txt,89930,90952,1022,10,N,Y,1448285563397,102964,108476
RECOLL.txt,90032,90967,935,10,N,Y,1448285563397,102964,108476
RECOLL.txt,90154,90972,818,10,N,Y,1448285563397,102964,108476
RECOLL.txt,90179,91009,830,10,N,Y,1448285563397,102964,108476
RECOLL.txt,90330,91014,684,10,N,N,-,-1,-1
RECOLL.txt,90361,91029,668,10,N,N,-,-1,-1
RECOLL.txt,90530,91040,510,10,N,N,-,-1,-1
RECOLL.txt,90663,91059,396,10,N,N,-,-1,-1
RECOLL.txt,90698,91064,366,10,N,N,-,-1,-1
RECOLL.txt,90936,91085,149,10,N,N,-,-1,-1
RECOLL.txt,90953,91098,145,10,N,N,-,-1,-1
RECOLL.txt,90970,91112,142,10,N,N,-,-1,-1
RECOLL.txt,90973,91117,144,10,N,N,-,-1,-1
RECOLL.txt,91012,91142,130,10,N,N,-,-1,-1
RECOLL.txt,91015,91160,145,10,N,N,-,-1,-1
RECOLL.txt,91030,91165,135,10,N,N,-,-1,-1
RECOLL.txt,91043,91219,176,10,N,N,-,-1,-1
RECOLL.txt,91062,91224,162,10,N,N,-,-1,-1
RECOLL.txt,91065,91238,173,10,N,N,-,-1,-1
RECOLL.txt,91086,91244,158,10,N,N,-,-1,-1
RECOLL.txt,91101,91281,180,10,N,N,-,-1,-1
RECOLL.txt,91115,91299,184,10,N,N,-,-1,-1
RECOLL.txt,91118,91305,187,10,N,N,-,-1,-1
RECOLL.txt,91143,91345,202,10,N,N,-,-1,-1
RECOLL.txt,91163,91367,204,10,N,N,-,-1,-1
RECOLL.txt,91166,91379,213,10,N,N,-,-1,-1
RECOLL.txt,91222,91547,325,10,N,N,-,-1,-1
RECOLL.txt,91225,91634,409,10,N,N,-,-1,-1
RECOLL.txt,91241,91757,516,10,N,N,-,-1,-1
RECOLL.txt,91245,91955,710,10,N,N,-,-1,-1
RECOLL.txt,91284,92034,750,10,N,N,-,-1,-1
RECOLL.txt,91302,92242,940,10,N,Y,1437472380836,351899,352666
RECOLL.txt,91306,92272,966,10,N,Y,1437472380836,351899,352666
RECOLL.txt,91348,92315,967,10,N,Y,1437472380836,351899,352666
RECOLL.txt,91368,92472,1104,10,Y,Y,1437472380836,351899,352666
RECOLL.txt,91384,92689,1305,10,Y,Y,1437472380836,351899,352666
RECOLL.txt,91548,92800,1252,10,Y,Y,1437472380836,351899,352666
RECOLL.txt,91635,92874,1239,10,Y,Y,1437472380836,351899,352666
RECOLL.txt,91758,93023,1265,10,Y,Y,1437472380836,351899,352666
RECOLL.txt,91956,93101,1145,10,Y,Y,1437472380836,351899,352666
RECOLL.txt,92036,93169,1133,10,Y,Y,1437472380836,351899,352666
RECOLL.txt,92243,93388,1145,10,Y,Y,1437472380836,351899,352666
RECOLL.txt,92273,93684,1411,10,Y,Y,1437472380836,351899,352666
RECOLL.txt,92316,93878,1562,10,Y,Y,1437472380836,351899,352666
RECOLL.txt,92473,93946,1473,10,Y,Y,1437472380836,351899,352666
RECOLL.txt,92690,94169,1479,10,Y,Y,1437472380836,351899,352666
RECOLL.txt,92801,94322,1521,10,Y,Y,1437472380836,351899,352666
RECOLL.txt,92877,94493,1616,10,Y,Y,1437476486340,221621,222520
RECOLL.txt,93026,94609,1583,10,Y,Y,1437476486340,221621,222520
RECOLL.txt,93102,94795,1693,10,Y,Y,1437476486340,221621,222520
RECOLL.txt,93170,94846,1676,10,Y,Y,1437476486340,221621,222520
RECOLL.txt,93389,94935,1546,10,Y,N,-,-1,-1
RECOLL.txt,93689,95263,1574,10,N,N,-,-1,-1
RECOLL.txt,93879,95425,1546,10,N,N,-,-1,-1
RECOLL.txt,93947,95464,1517,10,N,N,-,-1,-1
RECOLL.txt,94170,95500,1330,10,N,N,-,-1,-1
RECOLL.txt,94325,95610,1285,10,N,N,-,-1,-1
RECOLL.txt,94494,95771,1277,10,N,N,-,-1,-1
RECOLL.txt,94610,95942,1332,10,N,N,-,-1,-1
RECOLL.txt,94796,96445,1649,10,N,N,-,-1,-1
RECOLL.txt,94847,96506,1659,10,Y,N,-,-1,-1
RECOLL.txt,94938,96622,1684,10,N,N,-,-1,-1
RECOLL.txt,95266,96686,1420,10,N,N,-,-1,-1
RECOLL.txt,95426,96849,1423,10,N,N,-,-1,-1
RECOLL.txt,95465,96906,1441,10,N,N,-,-1,-1
RECOLL.txt,95501,96942,1441,10,N,N,-,-1,-1
RECOLL.txt,95611,97212,1601,10,N,N,-,-1,-1
RECOLL.txt,95774,97351,1577,10,N,Y,1448281888079,98877,102290
RECOLL.txt,95943,97484,1541,10,N,Y,1448281888079,98877,102290
RECOLL.txt,96448,97825,1377,10,N,Y,1448281888079,98877,102290
RECOLL.txt,96507,98013,1506,10,N,Y,1448281888079,98877,102290
RECOLL.txt,96625,98061,1436,10,N,Y,1448281888079,98877,102290
RECOLL.txt,96687,98097,1410,10,N,Y,1448281888079,98877,102290
RECOLL.txt,96851,98425,1574,10,N,Y,1448281888079,98877,102290
RECOLL.txt,96907,98463,1556,10,N,Y,1448281888079,98877,102290
RECOLL.txt,96944,98628,1684,10,N,Y,1448281888079,98877,102290
RECOLL.txt,97213,98707,1494,10,N,Y,1448281888079,98877,102290
RECOLL.txt,97354,98767,1413,10,N,Y,1448281888079,98877,102290
RECOLL.txt,97485,98861,1376,10,N,Y,1448281888079,98877,102290
RECOLL.txt,97826,98976,1150,10,N,Y,1448281888079,98877,102290
RECOLL.txt,98014,99090,1076,10,Y,Y,1448281888079,98877,102290
RECOLL.txt,98062,99135,1073,10,Y,Y,1448281888079,98877,102290
RECOLL.txt,98098,99383,1285,10,Y,Y,1448281888079,98877,102290
RECOLL.txt,98428,99572,1144,10,N,Y,1448357159811,231190,232925
RECOLL.txt,98464,99813,1349,10,Y,Y,1448357159811,231190,232925
RECOLL.txt,98629,99948,1319,10,Y,Y,1448357159811,231190,232925
RECOLL.txt,98708,100042,1334,10,Y,Y,1448357159811,231190,232925
RECOLL.txt,98770,100173,1403,10,Y,Y,1448280884746,88496,89294
RECOLL.txt,98862,100281,1419,10,Y,Y,1448280884746,88496,89294
RECOLL.txt,98977,100388,1411,10,Y,Y,1448280884746,88496,89294
RECOLL.txt,99091,100575,1484,10,Y,Y,1448280884746,88496,89294
RECOLL.txt,99138,100732,1594,10,Y,Y,1448280884746,88496,89294
RECOLL.txt,99384,100999,1615,10,Y,Y,1448280884746,88496,89294
RECOLL.txt,99573,101159,1586,10,Y,Y,1448280884746,88496,89294
RECOLL.txt,99814,101252,1438,10,Y,Y,1448280884746,88496,89294
RECOLL.txt,99949,101365,1416,10,N,Y,1448280884746,88496,89294
RECOLL.txt,100045,101646,1601,10,N,Y,1448280884746,88496,89294
RECOLL.txt,100174,101690,1516,10,N,Y,1448280884746,88496,89294
RECOLL.txt,100282,101776,1494,10,N,Y,1448280884746,88496,89294
RECOLL.txt,100390,101807,1417,10,N,Y,1448280884746,88496,89294
RECOLL.txt,100578,101898,1320,10,N,N,-,-1,-1
RECOLL.txt,100733,102076,1343,10,N,Y,1437477878183,427206,428439
RECOLL.txt,101002,102440,1438,10,N,Y,1437477878183,427206,428439
RECOLL.txt,101160,103051,1891,10,N,Y,1437477878183,427206,428439
RECOLL.txt,101253,103219,1966,10,N,Y,1437477878183,427206,428439
RECOLL.txt,101370,103516,2146,10,N,Y,1437477878183,427206,428439
RECOLL.txt,101647,103634,1987,10,N,Y,1437477878183,427206,428439
RECOLL.txt,101691,103774,2083,10,N,Y,1437477878183,427206,428439
RECOLL.txt,101777,103823,2046,10,N,Y,1437477878183,427206,428439
RECOLL.txt,101810,103946,2136,10,N,Y,1437477878183,427206,428439
RECOLL.txt,101899,104259,2360,10,N,Y,1437477878183,427206,428439
RECOLL.txt,102079,104303,2224,10,N,Y,1437477878183,427206,428439
RECOLL.txt,102441,104390,1949,10,N,Y,1437477878183,427206,428439
RECOLL.txt,103052,104497,1445,10,N,Y,1437477878183,427206,428439
RECOLL.txt,103220,104566,1346,10,N,Y,1437477878183,427206,428439
RECOLL.txt,103519,104598,1079,10,N,Y,1437477878183,427206,428439
RECOLL.txt,103637,104708,1071,10,N,Y,1437477878183,427206,428439
RECOLL.txt,103776,104860,1084,10,N,Y,1437477878183,427206,428439
RECOLL.txt,103825,104960,1135,10,N,Y,1437477878183,427206,428439
RECOLL.txt,103947,105176,1229,10,N,Y,1437477878183,427206,428439
RECOLL.txt,104260,105324,1064,10,N,N,-,-1,-1
RECOLL.txt,104306,105411,1105,10,N,N,-,-1,-1
RECOLL.txt,104392,105525,1133,10,N,N,-,-1,-1
RECOLL.txt,104498,105616,1118,10,N,N,-,-1,-1
RECOLL.txt,104567,105778,1211,10,N,N,-,-1,-1
RECOLL.txt,104599,105938,1339,10,N,N,-,-1,-1
RECOLL.txt,104713,106055,1342,10,N,Y,1448325046337,230539,231128
RECOLL.txt,104863,106198,1335,10,N,Y,1448325046337,230539,231128
RECOLL.txt,104961,106325,1364,10,Y,Y,1448325046337,230539,231128
RECOLL.txt,105179,106365,1186,10,Y,Y,1448325046337,230539,231128
RECOLL.txt,105325,106539,1214,10,Y,Y,1448325046337,230539,231128
RECOLL.txt,105414,106897,1483,10,Y,Y,1448325046337,230539,231128
RECOLL.txt,105526,106989,1463,10,Y,Y,1448325046337,230539,231128
RECOLL.txt,105617,107032,1415,10,Y,Y,1437475017618,98942,100041
RECOLL.txt,105779,107168,1389,10,Y,Y,1437475017618,98942,100041
RECOLL.txt,105941,107218,1277,10,Y,Y,1437475017618,98942,100041
RECOLL.txt,106056,107245,1189,10,Y,Y,1437475017618,98942,100041
RECOLL.txt,106199,107447,1248,10,N,Y,1437475017618,98942,100041
RECOLL.txt,106326,107471,1145,10,N,Y,1437475017618,98942,100041
RECOLL.txt,106366,107507,1141,10,N,Y,1437475017618,98942,100041
RECOLL.txt,106540,107561,1021,10,N,Y,1437475017618,98942,100041
RECOLL.txt,106900,107666,766,10,Y,Y,1437475017618,98942,100041
RECOLL.txt,106990,107766,776,10,Y,Y,1437475017618,98942,100041
RECOLL.txt,107033,107884,851,10,Y,Y,1437475017618,98942,100041
RECOLL.txt,107169,107928,759,10,N,Y,1437475017618,98942,100041
RECOLL.txt,107219,108083,864,10,Y,Y,1437475017618,98942,100041
RECOLL.txt,107246,108253,1007,10,Y,Y,1437475017618,98942,100041
RECOLL.txt,107450,108489,1039,10,Y,Y,1448281320115,89144,91129
RECOLL.txt,107472,108563,1091,10,Y,Y,1448281320115,89144,91129
RECOLL.txt,107508,108668,1160,10,Y,Y,1448281320115,89144,91129
RECOLL.txt,107562,108738,1176,10,Y,Y,1448038803075,18895,19670
RECOLL.txt,107669,108886,1217,10,Y,Y,1448038803075,18895,19670
RECOLL.txt,107769,108941,1172,10,Y,Y,1448275407308,26987,29181
RECOLL.txt,107885,109058,1173,10,Y,Y,1448275407308,26987,29181
RECOLL.txt,107929,109132,1203,10,Y,Y,1448275407308,26987,29181
RECOLL.txt,108086,109300,1214,10,Y,Y,1448275407308,26987,29181
RECOLL.txt,108254,109366,1112,10,Y,Y,1448275407308,26987,29181
RECOLL.txt,108491,109478,987,10,N,Y,1448275407308,26987,29181
RECOLL.txt,108564,109588,1024,10,N,Y,1448275407308,26987,29181
RECOLL.txt,108671,109717,1046,10,N,Y,1448275407308,26987,29181
RECOLL.txt,108739,109794,1055,10,N,Y,1448275407308,26987,29181
RECOLL.txt,108887,110010,1123,10,N,Y,1448275407308,26987,29181
RECOLL.txt,108943,110152,1209,10,N,Y,1448275407308,26987,29181
RECOLL.txt,109059,110343,1284,10,N,Y,1448275407308,26987,29181
RECOLL.txt,109134,110490,1356,10,N,Y,1448275407308,26987,29181
RECOLL.txt,109301,110523,1222,10,N,Y,1448275407308,26987,29181
RECOLL.txt,109369,110791,1422,10,N,Y,1448314706721,180385,181191
RECOLL.txt,109483,111014,1531,10,N,Y,1448314706721,180385,181191
RECOLL.txt,109589,111211,1622,10,N,Y,1448314706721,180385,181191
RECOLL.txt,109718,111358,1640,10,N,Y,1448314706721,180385,181191
RECOLL.txt,109796,111471,1675,10,N,Y,1448314706721,180385,181191
RECOLL.txt,110011,111553,1542,10,N,Y,1448314706721,180385,181191
RECOLL.txt,110153,111659,1506,10,N,Y,1448314706721,180385,181191
RECOLL.txt,110344,111774,1430,10,N,Y,1448314706721,180385,181191
RECOLL.txt,110492,111843,1351,10,N,Y,1448314706721,180385,181191
RECOLL.txt,110524,111949,1425,10,N,Y,1448314706721,180385,181191
RECOLL.txt,110796,112196,1400,10,N,N,-,-1,-1
RECOLL.txt,111016,112283,1267,10,N,N,-,-1,-1
RECOLL.txt,111212,112395,1183,10,N,N,-,-1,-1
RECOLL.txt,111359,112724,1365,10,N,N,-,-1,-1
RECOLL.txt,111472,112829,1357,10,N,N,-,-1,-1
RECOLL.txt,111556,112999,1443,10,N,N,-,-1,-1
RECOLL.txt,111660,113168,1508,10,N,N,-,-1,-1
RECOLL.txt,111777,113319,1542,10,N,N,-,-1,-1
RECOLL.txt,111844,113550,1706,10,N,N,-,-1,-1
RECOLL.txt,111950,113965,2015,10,N,N,-,-1,-1
RECOLL.txt,112197,114144,1947,10,N,N,-,-1,-1
RECOLL.txt,112284,114218,1934,10,N,N,-,-1,-1
RECOLL.txt,112398,114412,2014,10,N,N,-,-1,-1
RECOLL.txt,112725,114481,1756,10,N,N,-,-1,-1
RECOLL.txt,112832,114859,2027,10,N,N,-,-1,-1
RECOLL.txt,113000,115153,2153,10,N,N,-,-1,-1
RECOLL.txt,113169,115239,2070,10,N,N,-,-1,-1
RECOLL.txt,113322,115344,2022,10,N,N,-,-1,-1
RECOLL.txt,113551,115518,1967,10,N,N,-,-1,-1
RECOLL.txt,113968,115617,1649,10,N,N,-,-1,-1
RECOLL.txt,114145,115736,1591,10,N,N,-,-1,-1
RECOLL.txt,114219,115911,1692,10,N,Y,1448313482895,176553,176862
RECOLL.txt,114413,116084,1671,10,N,Y,1448313482895,176553,176862
RECOLL.txt,114482,116285,1803,10,N,Y,1448313482895,176553,176862
RECOLL.txt,114862,116368,1506,10,N,Y,1448313482895,176553,176862
RECOLL.txt,115154,116478,1324,10,N,Y,1448313482895,176553,176862
RECOLL.txt,115240,116562,1322,10,N,Y,1448313482895,176553,176862
RECOLL.txt,115345,116653,1308,10,N,Y,1448313482895,176553,176862
RECOLL.txt,115519,116780,1261,10,N,Y,1448280673594,87462,88501
RECOLL.txt,115618,116904,1286,10,Y,Y,1448280673594,87462,88501
RECOLL.txt,115737,116941,1204,10,Y,Y,1448280673594,87462,88501
RECOLL.txt,115914,117016,1102,10,Y,Y,1448280673594,87462,88501
RECOLL.txt,116086,117120,1034,10,Y,Y,1448280673594,87462,88501
RECOLL.txt,116286,117194,908,10,N,Y,1448280673594,87462,88501
RECOLL.txt,116369,117263,894,10,N,Y,1448280673594,87462,88501
RECOLL.txt,116479,117409,930,10,N,Y,1448280673594,87462,88501
RECOLL.txt,116563,117592,1029,10,N,Y,1448280673594,87462,88501
RECOLL.txt,116654,117654,1000,10,N,Y,1448280673594,87462,88501
RECOLL.txt,116781,117762,981,10,N,Y,1448280673594,87462,88501
RECOLL.txt,116905,117881,976,10,N,Y,1448280673594,87462,88501
RECOLL.txt,116942,118046,1104,10,N,Y,1448280673594,87462,88501
RECOLL.txt,117019,118111,1092,10,N,N,-,-1,-1
RECOLL.txt,117121,118312,1191,10,N,N,-,-1,-1
RECOLL.txt,117195,118639,1444,10,N,N,-,-1,-1
RECOLL.txt,117264,118729,1465,10,N,N,-,-1,-1
RECOLL.txt,117410,118992,1582,10,N,N,-,-1,-1
RECOLL.txt,117595,119146,1551,10,N,N,-,-1,-1
RECOLL.txt,117655,119326,1671,10,N,N,-,-1,-1
RECOLL.txt,117763,119429,1666,10,N,N,-,-1,-1
RECOLL.txt,117882,119510,1628,10,N,N,-,-1,-1
RECOLL.txt,118047,119652,1605,10,N,N,-,-1,-1
RECOLL.txt,118114,119687,1573,10,N,N,-,-1,-1
RECOLL.txt,118315,119774,1459,10,N,N,-,-1,-1
RECOLL.txt,118640,119891,1251,10,N,N,-,-1,-1
RECOLL.txt,118730,119949,1219,10,N,Y,1448286880729,112151,113274
RECOLL.txt,118997,120154,1157,10,N,Y,1448286880729,112151,113274
RECOLL.txt,119147,120301,1154,10,N,Y,1448286880729,112151,113274
RECOLL.txt,119327,120338,1011,10,N,Y,1448286880729,112151,113274
RECOLL.txt,119432,120412,980,10,N,Y,1448286880729,112151,113274
RECOLL.txt,119511,120486,975,10,N,Y,1448286880729,112151,113274
RECOLL.txt,119653,120903,1250,10,N,Y,1448286880729,112151,113274
RECOLL.txt,119688,120921,1233,10,N,Y,1448286880729,112151,113274
RECOLL.txt,119777,120989,1212,10,N,Y,1448286880729,112151,113274
RECOLL.txt,119892,121085,1193,10,N,Y,1448286880729,112151,113274
RECOLL.txt,119950,121123,1173,10,N,Y,1448286880729,112151,113274
RECOLL.txt,120155,121186,1031,10,N,Y,1448286880729,112151,113274
RECOLL.txt,120304,121327,1023,10,N,Y,1448287094676,113323,113870
RECOLL.txt,120339,121373,1034,10,N,Y,1448287094676,113323,113870
RECOLL.txt,120413,121437,1024,10,Y,Y,1448287094676,113323,113870
RECOLL.txt,120487,121503,1016,10,N,Y,1448287094676,113323,113870
RECOLL.txt,120904,121756,852,10,N,Y,1448287094676,113323,113870
RECOLL.txt,120924,121822,898,10,N,Y,1448287094676,113323,113870
RECOLL.txt,120990,121880,890,10,N,Y,1448287094676,113323,113870
RECOLL.txt,121086,122024,938,10,N,Y,1448287094676,113323,113870
RECOLL.txt,121124,122140,1016,10,N,Y,1448287094676,113323,113870
RECOLL.txt,121187,122254,1067,10,N,Y,1448287094676,113323,113870
RECOLL.txt,121328,122335,1007,10,N,Y,1448285913012,108803,110925
RECOLL.txt,121376,122425,1049,10,N,Y,1448285913012,108803,110925
RECOLL.txt,121438,122630,1192,10,N,Y,1448285913012,108803,110925
RECOLL.txt,121504,122815,1311,10,N,Y,1448285913012,108803,110925
RECOLL.txt,121759,123005,1246,10,N,Y,1448285913012,108803,110925
RECOLL.txt,121823,123062,1239,10,N,Y,1448285913012,108803,110925
RECOLL.txt,121881,123406,1525,10,N,Y,1448285913012,108803,110925
RECOLL.txt,122026,123588,1562,10,N,Y,1448285913012,108803,110925
RECOLL.txt,122143,123670,1527,10,N,Y,1448285913012,108803,110925
RECOLL.txt,122257,123702,1445,10,N,Y,1448285913012,108803,110925
RECOLL.txt,122336,123744,1408,10,N,Y,1448285913012,108803,110925
RECOLL.txt,122427,123762,1335,10,N,Y,1448285913012,108803,110925
RECOLL.txt,122631,123767,1136,10,N,Y,1448285913012,108803,110925
RECOLL.txt,122818,123800,982,10,N,N,-,-1,-1
RECOLL.txt,123006,123802,796,10,N,N,-,-1,-1
RECOLL.txt,123063,123829,766,10,N,N,-,-1,-1
RECOLL.txt,123409,123834,425,10,N,N,-,-1,-1
RECOLL.txt,123591,123926,335,10,N,N,-,-1,-1
RECOLL.txt,123673,123939,266,10,N,N,-,-1,-1
RECOLL.txt,123703,123979,276,10,N,N,-,-1,-1
RECOLL.txt,123747,123984,237,10,N,N,-,-1,-1
RECOLL.txt,123765,124027,262,10,N,N,-,-1,-1
RECOLL.txt,123768,124046,278,10,N,N,-,-1,-1
RECOLL.txt,123801,124051,250,10,N,N,-,-1,-1
RECOLL.txt,123803,124080,277,10,N,N,-,-1,-1
RECOLL.txt,123832,124082,250,10,N,N,-,-1,-1
RECOLL.txt,123835,124111,276,10,N,N,-,-1,-1
RECOLL.txt,123929,124225,296,10,N,N,-,-1,-1
RECOLL.txt,123941,124326,385,10,N,N,-,-1,-1
RECOLL.txt,123982,124457,475,10,N,N,-,-1,-1
RECOLL.txt,123985,124710,725,10,N,N,-,-1,-1
RECOLL.txt,124030,124789,759,10,N,N,-,-1,-1
RECOLL.txt,124049,124872,823,10,N,N,-,-1,-1
RECOLL.txt,124052,125017,965,10,N,N,-,-1,-1
RECOLL.txt,124081,125153,1072,10,Y,N,-,-1,-1
RECOLL.txt,124083,125256,1173,10,Y,N,-,-1,-1
RECOLL.txt,124113,125484,1371,10,Y,N,-,-1,-1
RECOLL.txt,124226,125605,1379,10,Y,Y,1448315575026,182236,182361
RECOLL.txt,124329,125713,1384,10,Y,Y,1448315575026,182236,182361
RECOLL.txt,124458,125859,1401,10,Y,Y,1448315575026,182236,182361
RECOLL.txt,124711,125913,1202,10,N,Y,1448315575026,182236,182361
RECOLL.txt,124790,126086,1296,10,N,Y,1448315575026,182236,182361
RECOLL.txt,124874,126131,1257,10,N,Y,1448315575026,182236,182361
RECOLL.txt,125020,126234,1214,10,N,Y,1448315575026,182236,182361
RECOLL.txt,125155,126370,1215,10,N,Y,1448315575026,182236,182361
RECOLL.txt,125257,126510,1253,10,N,Y,1448315575026,182236,182361
RECOLL.txt,125487,126797,1310,10,N,Y,1448315575026,182236,182361
RECOLL.txt,125606,126990,1384,10,N,Y,1448315575026,182236,182361
RECOLL.txt,125715,127045,1330,10,N,Y,1448315575026,182236,182361
RECOLL.txt,125860,127244,1384,10,N,Y,1448315575026,182236,182361
RECOLL.txt,125916,127300,1384,10,N,Y,1448315575026,182236,182361
RECOLL.txt,126087,127429,1342,10,N,Y,1448315575026,182236,182361
RECOLL.txt,126132,127485,1353,10,N,Y,1448315575026,182236,182361
RECOLL.txt,126236,127670,1434,10,N,Y,1448315575026,182236,182361
RECOLL.txt,126372,127720,1348,10,N,Y,1448315575026,182236,182361
RECOLL.txt,126513,128141,1628,10,N,N,-,-1,-1
RECOLL.txt,126800,128192,1392,10,N,N,-,-1,-1
RECOLL.txt,126993,128434,1441,10,N,N,-,-1,-1
RECOLL.txt,127046,128743,1697,10,N,N,-,-1,-1
RECOLL.txt,127245,128776,1531,10,N,Y,1448279941918,72406,72905
RECOLL.txt,127303,128948,1645,10,N,Y,1448279941918,72406,72905
RECOLL.txt,127430,128989,1559,10,N,Y,1448279941918,72406,72905
RECOLL.txt,127487,129076,1589,10,N,Y,1448279941918,72406,72905
RECOLL.txt,127671,129222,1551,10,N,Y,1448279941918,72406,72905
RECOLL.txt,127722,129310,1588,10,N,Y,1448279941918,72406,72905
RECOLL.txt,128142,129471,1329,10,N,Y,1448279941918,72406,72905
RECOLL.txt,128195,129611,1416,10,N,Y,1448279941918,72406,72905
RECOLL.txt,128435,129736,1301,10,N,Y,1448279941918,72406,72905
RECOLL.txt,128746,129852,1106,10,N,Y,1448279941918,72406,72905
RECOLL.txt,128777,129954,1177,10,N,Y,1448279941918,72406,72905
RECOLL.txt,128949,130166,1217,10,N,Y,1448279941918,72406,72905
RECOLL.txt,128990,130338,1348,10,N,Y,1448279941918,72406,72905
RECOLL.txt,129079,130635,1556,10,N,Y,1448366492754,275659,275884
RECOLL.txt,129223,130843,1620,10,N,Y,1448366492754,275659,275884
RECOLL.txt,129311,130897,1586,10,N,Y,1448366492754,275659,275884
RECOLL.txt,129472,131040,1568,10,N,Y,1448366492754,275659,275884
RECOLL.txt,129614,131149,1535,10,N,Y,1448366492754,275659,275884
RECOLL.txt,129737,131247,1510,10,N,Y,1448366492754,275659,275884
RECOLL.txt,129853,131307,1454,10,N,Y,1448366492754,275659,275884
RECOLL.txt,129955,131430,1475,10,N,Y,1448366492754,275659,275884
RECOLL.txt,130167,131782,1615,10,N,N,-,-1,-1
RECOLL.txt,130341,131974,1633,10,N,N,-,-1,-1
RECOLL.txt,130638,132036,1398,10,N,N,-,-1,-1
RECOLL.txt,130844,132128,1284,10,N,N,-,-1,-1
RECOLL.txt,130900,132636,1736,10,N,Y,1448280423373,85694,86154
RECOLL.txt,131041,132736,1695,10,N,Y,1448280423373,85694,86154
RECOLL.txt,131150,132992,1842,10,N,Y,1448280423373,85694,86154
RECOLL.txt,131248,133026,1778,10,N,Y,1448280423373,85694,86154
RECOLL.txt,131310,133212,1902,10,N,Y,1448280423373,85694,86154
RECOLL.txt,131431,133372,1941,10,N,Y,1448280423373,85694,86154
RECOLL.txt,131783,133429,1646,10,N,Y,1448280423373,85694,86154
RECOLL.txt,131976,133604,1628,10,Y,Y,1448280423373,85694,86154
RECOLL.txt,132037,133651,1614,10,Y,Y,1448280423373,85694,86154
RECOLL.txt,132131,133841,1710,10,N,Y,1448280423373,85694,86154
RECOLL.txt,132637,133973,1336,10,Y,Y,1448280423373,85694,86154
RECOLL.txt,132739,134159,1420,10,N,Y,1448280423373,85694,86154
RECOLL.txt,132993,134376,1383,10,N,N,-,-1,-1
RECOLL.txt,133027,134468,1441,10,N,N,-,-1,-1
RECOLL.txt,133213,134540,1327,10,N,N,-,-1,-1
RECOLL.txt,133373,134903,1530,10,N,N,-,-1,-1
RECOLL.txt,133432,135025,1593,10,N,N,-,-1,-1
RECOLL.txt,133605,135096,1491,10,N,N,-,-1,-1
RECOLL.txt,133656,135130,1474,10,N,N,-,-1,-1
RECOLL.txt,133842,135240,1398,10,N,N,-,-1,-1
RECOLL.txt,133974,135329,1355,10,N,N,-,-1,-1
RECOLL.txt,134162,135486,1324,10,N,N,-,-1,-1
RECOLL.txt,134377,135608,1231,10,N,N,-,-1,-1
RECOLL.txt,134469,135728,1259,10,N,N,-,-1,-1
RECOLL.txt,134543,135832,1289,10,N,N,-,-1,-1
RECOLL.txt,134906,136017,1111,10,N,N,-,-1,-1
RECOLL.txt,135026,136221,1195,10,N,N,-,-1,-1
RECOLL.txt,135097,136332,1235,10,N,N,-,-1,-1
RECOLL.txt,135131,136430,1299,10,N,N,-,-1,-1
RECOLL.txt,135241,136520,1279,10,N,N,-,-1,-1
RECOLL.txt,135330,136697,1367,10,N,N,-,-1,-1
RECOLL.txt,135489,136832,1343,10,N,N,-,-1,-1
RECOLL.txt,135609,136918,1309,10,N,N,-,-1,-1
RECOLL.txt,135729,136969,1240,10,N,N,-,-1,-1
RECOLL.txt,135833,137082,1249,10,N,N,-,-1,-1
RECOLL.txt,136018,137117,1099,10,N,N,-,-1,-1
RECOLL.txt,136222,137256,1034,10,N,N,-,-1,-1
RECOLL.txt,136335,137457,1122,10,N,N,-,-1,-1
RECOLL.txt,136431,137487,1056,10,N,N,-,-1,-1
RECOLL.txt,136521,137937,1416,10,N,Y,1437470299748,152207,152889
RECOLL.txt,136700,138195,1495,10,N,Y,1437470299748,152207,152889
RECOLL.txt,136834,138238,1404,10,N,Y,1437470299748,152207,152889
RECOLL.txt,136920,138253,1333,10,N,Y,1437470299748,152207,152889
RECOLL.txt,136972,138355,1383,10,Y,Y,1437470299748,152207,152889
RECOLL.txt,137083,138577,1494,10,Y,Y,1437470299748,152207,152889
RECOLL.txt,137118,138725,1607,10,Y,Y,1437470299748,152207,152889
RECOLL.txt,137257,138869,1612,10,Y,Y,1437470299748,152207,152889
RECOLL.txt,137458,138908,1450,10,Y,Y,1437470299748,152207,152889
RECOLL.txt,137490,138969,1479,10,Y,Y,1437470299748,152207,152889
RECOLL.txt,137939,139060,1121,10,Y,Y,1437470299748,152207,152889
RECOLL.txt,138198,139163,965,10,Y,Y,1437470299748,152207,152889
RECOLL.txt,138240,139334,1094,10,Y,Y,1437470299748,152207,152889
RECOLL.txt,138254,139552,1298,10,Y,Y,1437470299748,152207,152889
RECOLL.txt,138356,139639,1283,10,N,Y,1437470299748,152207,152889
RECOLL.txt,138578,139929,1351,10,N,Y,1437470299748,152207,152889
RECOLL.txt,138728,139989,1261,10,N,N,-,-1,-1
RECOLL.txt,138872,140030,1158,10,N,N,-,-1,-1
RECOLL.txt,138909,140257,1348,10,N,N,-,-1,-1
RECOLL.txt,138970,140323,1353,10,N,N,-,-1,-1
RECOLL.txt,139061,140417,1356,10,N,N,-,-1,-1
RECOLL.txt,139164,140791,1627,10,N,N,-,-1,-1
RECOLL.txt,139335,140818,1483,10,N,N,-,-1,-1
RECOLL.txt,139553,140858,1305,10,N,N,-,-1,-1
RECOLL.txt,139640,140907,1267,10,N,N,-,-1,-1
RECOLL.txt,139930,141068,1138,10,N,N,-,-1,-1
RECOLL.txt,139992,141138,1146,10,N,N,-,-1,-1
RECOLL.txt,140031,141258,1227,10,N,N,-,-1,-1
RECOLL.txt,140260,141422,1162,10,N,N,-,-1,-1
RECOLL.txt,140324,141537,1213,10,N,N,-,-1,-1
RECOLL.txt,140418,141654,1236,10,N,N,-,-1,-1
RECOLL.txt,140792,141716,924,10,N,N,-,-1,-1
RECOLL.txt,140820,141802,982,10,N,N,-,-1,-1
RECOLL.txt,140859,141854,995,10,N,N,-,-1,-1
RECOLL.txt,140910,141941,1031,10,N,N,-,-1,-1
RECOLL.txt,141069,142206,1137,10,N,N,-,-1,-1
RECOLL.txt,141140,142300,1160,10,N,N,-,-1,-1
RECOLL.txt,141261,142418,1157,10,N,N,-,-1,-1
RECOLL.txt,141427,142651,1224,10,N,N,-,-1,-1
RECOLL.txt,141538,142731,1193,10,N,N,-,-1,-1
RECOLL.txt,141657,142854,1197,10,N,N,-,-1,-1
RECOLL.txt,141717,142977,1260,10,N,N,-,-1,-1
RECOLL.txt,141803,143077,1274,10,N,N,-,-1,-1
RECOLL.txt,141855,143138,1283,10,N,N,-,-1,-1
RECOLL.txt,141942,143208,1266,10,N,N,-,-1,-1
RECOLL.txt,142207,143237,1030,10,N,N,-,-1,-1
RECOLL.txt,142301,143299,998,10,N,N,-,-1,-1
RECOLL.txt,142421,143409,988,10,N,N,-,-1,-1
RECOLL.txt,142652,143472,820,10,N,N,-,-1,-1
RECOLL.txt,142733,143579,846,10,N,N,-,-1,-1
RECOLL.txt,142857,143649,792,10,N,N,-,-1,-1
RECOLL.txt,142978,143908,930,10,N,N,-,-1,-1
RECOLL.txt,143078,144410,1332,10,N,N,-,-1,-1
RECOLL.txt,143139,144503,1364,10,N,N,-,-1,-1
RECOLL.txt,143209,144575,1366,10,N,N,-,-1,-1
RECOLL.txt,143238,144765,1527,10,N,N,-,-1,-1
RECOLL.txt,143300,144853,1553,10,N,N,-,-1,-1
RECOLL.txt,143410,145014,1604,10,N,N,-,-1,-1
RECOLL.txt,143473,145140,1667,10,N,N,-,-1,-1
RECOLL.txt,143580,145251,1671,10,N,N,-,-1,-1
RECOLL.txt,143652,145369,1717,10,N,N,-,-1,-1
RECOLL.txt,143911,145396,1485,10,N,N,-,-1,-1
RECOLL.txt,144413,145511,1098,10,N,N,-,-1,-1
RECOLL.txt,144504,145926,1422,10,N,N,-,-1,-1
RECOLL.txt,144576,146062,1486,10,N,N,-,-1,-1
RECOLL.txt,144767,146292,1525,10,N,N,-,-1,-1
RECOLL.txt,144854,146370,1516,10,N,N,-,-1,-1
RECOLL.txt,145019,146494,1475,10,N,N,-,-1,-1
RECOLL.txt,145141,146697,1556,10,N,N,-,-1,-1
RECOLL.txt,145254,146777,1523,10,N,N,-,-1,-1
RECOLL.txt,145370,146931,1561,10,N,N,-,-1,-1
RECOLL.txt,145397,147022,1625,10,N,N,-,-1,-1
RECOLL.txt,145512,147099,1587,10,N,N,-,-1,-1
RECOLL.txt,145927,147214,1287,10,N,N,-,-1,-1
RECOLL.txt,146065,147252,1187,10,N,N,-,-1,-1
RECOLL.txt,146297,147312,1015,10,N,N,-,-1,-1
RECOLL.txt,146371,147548,1177,10,N,N,-,-1,-1
RECOLL.txt,146495,147706,1211,10,N,N,-,-1,-1
RECOLL.txt,146699,147758,1059,10,N,N,-,-1,-1
RECOLL.txt,146778,147781,1003,10,N,N,-,-1,-1
RECOLL.txt,146932,147791,859,10,N,N,-,-1,-1
RECOLL.txt,147023,147943,920,10,N,N,-,-1,-1
RECOLL.txt,147100,148035,935,10,N,N,-,-1,-1
RECOLL.txt,147215,148264,1049,10,N,N,-,-1,-1
RECOLL.txt,147253,148341,1088,10,N,N,-,-1,-1
RECOLL.txt,147313,148390,1077,10,N,N,-,-1,-1
RECOLL.txt,147553,148524,971,10,N,N,-,-1,-1
RECOLL.txt,147707,148848,1141,10,N,N,-,-1,-1
RECOLL.txt,147761,148938,1177,10,N,N,-,-1,-1
RECOLL.txt,147782,149083,1301,10,N,N,-,-1,-1
RECOLL.txt,147792,149164,1372,10,N,N,-,-1,-1
RECOLL.txt,147944,149372,1428,10,N,N,-,-1,-1
RECOLL.txt,148036,149395,1359,10,N,N,-,-1,-1
RECOLL.txt,148267,149540,1273,10,N,Y,1448039123601,19678,19935
RECOLL.txt,148342,149630,1288,10,N,Y,1448039123601,19678,19935
RECOLL.txt,148393,150065,1672,10,N,Y,1448039123601,19678,19935
RECOLL.txt,148526,150140,1614,10,N,Y,1448039123601,19678,19935
RECOLL.txt,148851,150267,1416,10,N,Y,1448039123601,19678,19935
RECOLL.txt,148939,150322,1383,10,N,Y,1448039123601,19678,19935
RECOLL.txt,149085,150492,1407,10,N,Y,1448039123601,19678,19935
RECOLL.txt,149167,150593,1426,10,N,Y,1448039123601,19678,19935
RECOLL.txt,149375,150649,1274,10,N,Y,1448039123601,19678,19935
RECOLL.txt,149400,150719,1319,10,N,Y,1448039123601,19678,19935
RECOLL.txt,149541,150869,1328,10,N,Y,1448039123601,19678,19935
RECOLL.txt,149632,150980,1348,10,N,Y,1448039123601,19678,19935
RECOLL.txt,150068,151188,1120,10,N,N,-,-1,-1
RECOLL.txt,150141,151233,1092,10,N,N,-,-1,-1
RECOLL.txt,150268,151340,1072,10,N,N,-,-1,-1
RECOLL.txt,150323,151433,1110,10,N,N,-,-1,-1
RECOLL.txt,150493,151649,1156,10,N,N,-,-1,-1
RECOLL.txt,150594,151712,1118,10,N,N,-,-1,-1
RECOLL.txt,150652,151891,1239,10,N,N,-,-1,-1
RECOLL.txt,150720,152064,1344,10,N,N,-,-1,-1
RECOLL.txt,150870,152152,1282,10,N,N,-,-1,-1
RECOLL.txt,150981,152241,1260,10,N,N,-,-1,-1
RECOLL.txt,151191,152309,1118,10,N,N,-,-1,-1
RECOLL.txt,151235,152420,1185,10,N,N,-,-1,-1
RECOLL.txt,151341,152643,1302,10,N,N,-,-1,-1
RECOLL.txt,151434,152698,1264,10,N,N,-,-1,-1
RECOLL.txt,151652,152783,1131,10,N,N,-,-1,-1
RECOLL.txt,151717,152939,1222,10,N,N,-,-1,-1
RECOLL.txt,151893,153214,1321,10,N,N,-,-1,-1
RECOLL.txt,152065,153268,1203,10,N,N,-,-1,-1
RECOLL.txt,152153,153476,1323,10,N,N,-,-1,-1
RECOLL.txt,152242,153617,1375,10,N,N,-,-1,-1
RECOLL.txt,152311,153858,1547,10,N,N,-,-1,-1
RECOLL.txt,152421,153986,1565,10,N,N,-,-1,-1
RECOLL.txt,152644,154217,1573,10,N,N,-,-1,-1
RECOLL.txt,152699,154395,1696,10,N,N,-,-1,-1
RECOLL.txt,152786,154540,1754,10,N,N,-,-1,-1
RECOLL.txt,152940,154615,1675,10,N,N,-,-1,-1
RECOLL.txt,153215,154699,1484,10,N,N,-,-1,-1
RECOLL.txt,153269,154843,1574,10,N,N,-,-1,-1
RECOLL.txt,153479,155322,1843,10,N,N,-,-1,-1
RECOLL.txt,153619,155419,1800,10,N,N,-,-1,-1
RECOLL.txt,153859,155537,1678,10,N,N,-,-1,-1
RECOLL.txt,153987,155701,1714,10,N,N,-,-1,-1
RECOLL.txt,154218,155800,1582,10,N,Y,1448322273366,219239,219544
RECOLL.txt,154398,155881,1483,10,N,Y,1448322273366,219239,219544
RECOLL.txt,154541,155992,1451,10,N,Y,1448322273366,219239,219544
RECOLL.txt,154617,156274,1657,10,N,Y,1448322273366,219239,219544
RECOLL.txt,154700,156358,1658,10,N,Y,1448322273366,219239,219544
RECOLL.txt,154845,156444,1599,10,N,Y,1448322273366,219239,219544
RECOLL.txt,155323,156586,1263,10,N,Y,1448322273366,219239,219544
RECOLL.txt,155422,156654,1232,10,N,Y,1448322273366,219239,219544
RECOLL.txt,155538,156820,1282,10,N,Y,1448322273366,219239,219544
RECOLL.txt,155702,156876,1174,10,N,Y,1448322273366,219239,219544
RECOLL.txt,155801,156945,1144,10,N,Y,1448322273366,219239,219544
RECOLL.txt,155882,157119,1237,10,N,Y,1448322273366,219239,219544
RECOLL.txt,155993,157206,1213,10,N,Y,1448322273366,219239,219544
RECOLL.txt,156274,157273,999,10,N,Y,1448322273366,219239,219544
RECOLL.txt,156361,157389,1028,10,N,N,-,-1,-1
RECOLL.txt,156446,157592,1146,10,N,N,-,-1,-1
RECOLL.txt,156587,158127,1540,10,N,N,-,-1,-1
RECOLL.txt,156655,158370,1715,10,N,N,-,-1,-1
RECOLL.txt,156821,158454,1633,10,N,Y,1448357582358,234204,234401
RECOLL.txt,156877,158537,1660,10,N,Y,1448357582358,234204,234401
RECOLL.txt,156946,158790,1844,10,N,Y,1448357582358,234204,234401
RECOLL.txt,157122,158805,1683,10,N,Y,1448357582358,234204,234401
RECOLL.txt,157207,158857,1650,10,N,Y,1448357582358,234204,234401
RECOLL.txt,157274,159000,1726,10,N,Y,1448357582358,234204,234401
RECOLL.txt,157390,159057,1667,10,N,Y,1448357582358,234204,234401
RECOLL.txt,157595,159215,1620,10,N,Y,1448357582358,234204,234401
RECOLL.txt,158128,159254,1126,10,N,Y,1448357582358,234204,234401
RECOLL.txt,158375,159335,960,10,N,Y,1448357582358,234204,234401
RECOLL.txt,158455,159436,981,10,N,Y,1448357582358,234204,234401
RECOLL.txt,158538,159487,949,10,N,Y,1448357582358,234204,234401
RECOLL.txt,158791,159566,775,10,N,Y,1448357582358,234204,234401
RECOLL.txt,158807,159631,824,10,N,Y,1448357582358,234204,234401
RECOLL.txt,158858,159748,890,10,N,Y,1448357582358,234204,234401
RECOLL.txt,159001,159802,801,10,N,Y,1448357582358,234204,234401
RECOLL.txt,159058,159917,859,10,N,Y,1448357582358,234204,234401
RECOLL.txt,159217,159997,780,10,N,Y,1448357582358,234204,234401
RECOLL.txt,159255,160039,784,10,N,Y,1448357582358,234204,234401
RECOLL.txt,159338,160059,721,10,N,Y,1448357582358,234204,234401
RECOLL.txt,159437,160085,648,10,N,N,-,-1,-1
RECOLL.txt,159488,160101,613,10,N,N,-,-1,-1
RECOLL.txt,159567,160333,766,10,N,N,-,-1,-1
RECOLL.txt,159634,160877,1243,10,N,Y,1448312128598,172353,173027
RECOLL.txt,159749,161033,1284,10,N,Y,1448312128598,172353,173027
RECOLL.txt,159803,161165,1362,10,N,Y,1448312128598,172353,173027
RECOLL.txt,159919,161349,1430,10,N,Y,1448312128598,172353,173027
RECOLL.txt,159998,161720,1722,10,N,Y,1448312128598,172353,173027
RECOLL.txt,160040,161997,1957,10,N,Y,1448312128598,172353,173027
RECOLL.txt,160061,162085,2024,10,N,Y,1448312128598,172353,173027
RECOLL.txt,160086,162219,2133,10,N,Y,1448312128598,172353,173027
RECOLL.txt,160103,162244,2141,10,N,Y,1448312128598,172353,173027
RECOLL.txt,160336,162425,2089,10,N,Y,1448312128598,172353,173027
RECOLL.txt,160878,162706,1828,10,N,Y,1448312128598,172353,173027
RECOLL.txt,161035,162889,1854,10,N,Y,1448312128598,172353,173027
RECOLL.txt,161166,162965,1799,10,N,Y,1448312128598,172353,173027
RECOLL.txt,161349,163075,1726,10,N,Y,1448281491382,97818,98860
RECOLL.txt,161721,163142,1421,10,N,Y,1448281491382,97818,98860
RECOLL.txt,161998,163270,1272,10,N,Y,1448281491382,97818,98860
RECOLL.txt,162086,163355,1269,10,N,Y,1448281491382,97818,98860
RECOLL.txt,162220,163641,1421,10,N,Y,1448281491382,97818,98860
RECOLL.txt,162245,163682,1437,10,N,Y,1448281491382,97818,98860
RECOLL.txt,162426,163828,1402,10,N,Y,1448281491382,97818,98860
RECOLL.txt,162707,163883,1176,10,N,Y,1448281491382,97818,98860
RECOLL.txt,162892,163917,1025,10,N,Y,1448281491382,97818,98860
RECOLL.txt,162968,164113,1145,10,N,Y,1448281491382,97818,98860
RECOLL.txt,163076,164226,1150,10,N,Y,1448281491382,97818,98860
RECOLL.txt,163144,164679,1535,10,N,Y,1448281491382,97818,98860
RECOLL.txt,163275,165098,1823,10,Y,Y,1448281491382,97818,98860
RECOLL.txt,163356,165121,1765,10,Y,Y,1448281491382,97818,98860
RECOLL.txt,163642,165257,1615,10,Y,Y,1448277167610,40886,47737
RECOLL.txt,163683,165323,1640,10,Y,Y,1448277167610,40886,47737
RECOLL.txt,163831,165379,1548,10,Y,Y,1448277167610,40886,47737
RECOLL.txt,163884,165411,1527,10,Y,Y,1448277167610,40886,47737
RECOLL.txt,163920,165440,1520,10,Y,Y,1448277167610,40886,47737
RECOLL.txt,164114,165499,1385,10,Y,Y,1448277167610,40886,47737
RECOLL.txt,164229,165532,1303,10,Y,Y,1448277167610,40886,47737
RECOLL.txt,164682,165559,877,10,N,Y,1448277167610,40886,47737
RECOLL.txt,165099,165644,545,10,N,N,-,-1,-1
RECOLL.txt,165122,165732,610,10,N,N,-,-1,-1
RECOLL.txt,165259,165926,667,10,N,N,-,-1,-1
RECOLL.txt,165324,166065,741,10,N,N,-,-1,-1
RECOLL.txt,165380,166211,831,10,N,N,-,-1,-1
RECOLL.txt,165412,166298,886,10,N,N,-,-1,-1
RECOLL.txt,165441,166383,942,10,N,N,-,-1,-1
RECOLL.txt,165500,166517,1017,10,N,N,-,-1,-1
RECOLL.txt,165533,166781,1248,10,N,N,-,-1,-1
RECOLL.txt,165560,167064,1504,10,N,N,-,-1,-1
RECOLL.txt,165645,167237,1592,10,N,N,-,-1,-1
RECOLL.txt,165735,167336,1601,10,N,N,-,-1,-1
RECOLL.txt,165927,167572,1645,10,N,N,-,-1,-1
RECOLL.txt,166066,167880,1814,10,N,N,-,-1,-1
RECOLL.txt,166214,168016,1802,10,N,N,-,-1,-1
RECOLL.txt,166299,168114,1815,10,N,N,-,-1,-1
RECOLL.txt,166384,168274,1890,10,N,N,-,-1,-1
RECOLL.txt,166520,168646,2126,10,N,N,-,-1,-1
RECOLL.txt,166782,168797,2015,10,N,N,-,-1,-1
RECOLL.txt,167065,169031,1966,10,N,N,-,-1,-1
RECOLL.txt,167240,169158,1918,10,N,N,-,-1,-1
RECOLL.txt,167337,169215,1878,10,N,N,-,-1,-1
RECOLL.txt,167573,169358,1785,10,N,N,-,-1,-1
RECOLL.txt,167881,169406,1525,10,N,Y,1448314861876,180438,180657
RECOLL.txt,168019,169513,1494,10,N,Y,1448314861876,180438,180657
RECOLL.txt,168115,169607,1492,10,N,Y,1448314861876,180438,180657
RECOLL.txt,168275,169690,1415,10,N,Y,1448314861876,180438,180657
RECOLL.txt,168649,169830,1181,10,N,Y,1448314861876,180438,180657
RECOLL.txt,168798,170011,1213,10,N,Y,1448314861876,180438,180657
RECOLL.txt,169032,170079,1047,10,N,Y,1448314861876,180438,180657
RECOLL.txt,169159,170188,1029,10,N,Y,1448314861876,180438,180657
RECOLL.txt,169216,170315,1099,10,N,Y,1448314861876,180438,180657
RECOLL.txt,169361,170449,1088,10,N,Y,1448314861876,180438,180657
RECOLL.txt,169407,170509,1102,10,N,Y,1448314861876,180438,180657
RECOLL.txt,169514,170646,1132,10,N,Y,1448314861876,180438,180657
RECOLL.txt,169608,170775,1167,10,N,Y,1448314861876,180438,180657
RECOLL.txt,169695,170902,1207,10,N,Y,1448314861876,180438,180657
RECOLL.txt,169831,171099,1268,10,N,Y,1448314861876,180438,180657
RECOLL.txt,170014,171215,1201,10,N,Y,1448314861876,180438,180657
RECOLL.txt,170080,171305,1225,10,N,Y,1448314861876,180438,180657
RECOLL.txt,170189,171377,1188,10,N,Y,1448314861876,180438,180657
RECOLL.txt,170316,171480,1164,10,N,Y,1448314861876,180438,180657
RECOLL.txt,170450,171619,1169,10,N,Y,1448314861876,180438,180657
RECOLL.txt,170510,171821,1311,10,N,N,-,-1,-1
RECOLL.txt,170649,171885,1236,10,N,N,-,-1,-1
RECOLL.txt,170776,171982,1206,10,N,N,-,-1,-1
RECOLL.txt,170903,172031,1128,10,N,N,-,-1,-1
RECOLL.txt,171100,172237,1137,10,N,N,-,-1,-1
RECOLL.txt,171218,172421,1203,10,N,N,-,-1,-1
RECOLL.txt,171307,172534,1227,10,N,N,-,-1,-1
RECOLL.txt,171378,172655,1277,10,N,N,-,-1,-1
RECOLL.txt,171481,172785,1304,10,N,N,-,-1,-1
RECOLL.txt,171622,172924,1302,10,N,N,-,-1,-1
RECOLL.txt,171822,173015,1193,10,N,N,-,-1,-1
RECOLL.txt,171886,173058,1172,10,N,N,-,-1,-1
RECOLL.txt,171983,173154,1171,10,N,N,-,-1,-1
RECOLL.txt,172034,173289,1255,10,N,N,-,-1,-1
RECOLL.txt,172238,173538,1300,10,N,N,-,-1,-1
RECOLL.txt,172422,173600,1178,10,N,N,-,-1,-1
RECOLL.txt,172535,173990,1455,10,N,N,-,-1,-1
RECOLL.txt,172656,174070,1414,10,N,N,-,-1,-1
RECOLL.txt,172787,174237,1450,10,N,N,-,-1,-1
RECOLL.txt,172926,174305,1379,10,N,N,-,-1,-1
RECOLL.txt,173017,174416,1399,10,N,N,-,-1,-1
RECOLL.txt,173061,174560,1499,10,N,N,-,-1,-1
RECOLL.txt,173156,174745,1589,10,N,N,-,-1,-1
RECOLL.txt,173291,174804,1513,10,N,N,-,-1,-1
RECOLL.txt,173539,175088,1549,10,N,N,-,-1,-1
RECOLL.txt,173601,175125,1524,10,Y,N,-,-1,-1
RECOLL.txt,173991,175457,1466,10,Y,Y,1448358276684,234999,235995
RECOLL.txt,174071,175601,1530,10,Y,Y,1448358276684,234999,235995
RECOLL.txt,174238,175656,1418,10,Y,Y,1448358276684,234999,235995
RECOLL.txt,174306,175866,1560,10,Y,Y,1448358276684,234999,235995
RECOLL.txt,174419,175935,1516,10,Y,Y,1448358276684,234999,235995
RECOLL.txt,174561,176075,1514,10,Y,Y,1448358276684,234999,235995
RECOLL.txt,174750,176217,1467,10,N,Y,1448358276684,234999,235995
RECOLL.txt,174805,176341,1536,10,N,Y,1448358276684,234999,235995
RECOLL.txt,175089,176532,1443,10,N,Y,1448358276684,234999,235995
RECOLL.txt,175128,176797,1669,10,N,Y,1448277582432,52552,54595
RECOLL.txt,175458,176828,1370,10,N,Y,1448277582432,52552,54595
RECOLL.txt,175602,176932,1330,10,N,Y,1448277582432,52552,54595
RECOLL.txt,175659,177081,1422,10,N,Y,1448277582432,52552,54595
RECOLL.txt,175869,177649,1780,10,N,Y,1448277582432,52552,54595
RECOLL.txt,175936,177714,1778,10,N,Y,1448277582432,52552,54595
RECOLL.txt,176076,177800,1724,10,N,Y,1448277582432,52552,54595
RECOLL.txt,176218,177968,1750,10,N,Y,1448277582432,52552,54595
RECOLL.txt,176342,178211,1869,10,N,Y,1448277582432,52552,54595
RECOLL.txt,176535,178282,1747,10,N,Y,1448277582432,52552,54595
RECOLL.txt,176799,178479,1680,10,N,Y,1448277582432,52552,54595
RECOLL.txt,176829,178569,1740,10,N,Y,1448277582432,52552,54595
RECOLL.txt,176934,178766,1832,10,N,Y,1448277582432,52552,54595
RECOLL.txt,177082,178911,1829,10,N,Y,1448277582432,52552,54595
RECOLL.txt,177652,179031,1379,10,N,Y,1448314192885,179720,179950
RECOLL.txt,177717,179110,1393,10,N,Y,1448314192885,179720,179950
RECOLL.txt,177801,179171,1370,10,N,Y,1448314192885,179720,179950
RECOLL.txt,177969,179262,1293,10,N,Y,1448314192885,179720,179950
RECOLL.txt,178212,179364,1152,10,N,Y,1448314192885,179720,179950
RECOLL.txt,178283,179486,1203,10,N,Y,1448314192885,179720,179950
RECOLL.txt,178480,179524,1044,10,N,Y,1448314192885,179720,179950
RECOLL.txt,178570,179603,1033,10,N,Y,1448314192885,179720,179950
RECOLL.txt,178767,179631,864,10,N,Y,1448314192885,179720,179950
RECOLL.txt,178912,179680,768,10,N,Y,1448314192885,179720,179950
RECOLL.txt,179032,179702,670,10,N,Y,1448314192885,179720,179950
RECOLL.txt,179111,179896,785,10,N,Y,1448314192885,179720,179950
RECOLL.txt,179172,179921,749,10,N,Y,1448314192885,179720,179950
RECOLL.txt,179263,179970,707,10,N,Y,1448314192885,179720,179950
RECOLL.txt,179365,180112,747,10,N,Y,1448314192885,179720,179950
RECOLL.txt,179489,180188,699,10,N,Y,1448314192885,179720,179950
RECOLL.txt,179525,180243,718,10,N,Y,1448314192885,179720,179950
RECOLL.txt,179604,180406,802,10,N,Y,1448314192885,179720,179950
RECOLL.txt,179632,180556,924,10,N,Y,1448314192885,179720,179950
RECOLL.txt,179681,180601,920,10,N,Y,1448314192885,179720,179950
RECOLL.txt,179703,180624,921,10,N,Y,1448314192885,179720,179950
RECOLL.txt,179897,180799,902,10,N,Y,1448314192885,179720,179950
RECOLL.txt,179922,180923,1001,10,N,Y,1448314192885,179720,179950
RECOLL.txt,179971,181217,1246,10,N,Y,1448314192885,179720,179950
RECOLL.txt,180113,181390,1277,10,N,Y,1448314192885,179720,179950
RECOLL.txt,180189,181465,1276,10,N,Y,1448314192885,179720,179950
RECOLL.txt,180244,181687,1443,10,N,Y,1448314192885,179720,179950
RECOLL.txt,180409,181780,1371,10,N,Y,1448278147591,54631,55869
RECOLL.txt,180557,181891,1334,10,N,Y,1448278147591,54631,55869
RECOLL.txt,180602,181969,1367,10,N,Y,1448278147591,54631,55869
RECOLL.txt,180625,182044,1419,10,N,Y,1448278147591,54631,55869
RECOLL.txt,180800,182202,1402,10,N,Y,1448278147591,54631,55869
RECOLL.txt,180926,182241,1315,10,N,Y,1448278147591,54631,55869
RECOLL.txt,181220,182368,1148,10,N,Y,1448278147591,54631,55869
RECOLL.txt,181391,182599,1208,10,N,Y,1448278147591,54631,55869
RECOLL.txt,181468,182770,1302,10,N,Y,1448278147591,54631,55869
RECOLL.txt,181690,182879,1189,10,N,Y,1448278147591,54631,55869
RECOLL.txt,181782,182990,1208,10,N,Y,1448278147591,54631,55869
RECOLL.txt,181892,183084,1192,10,N,Y,1448278147591,54631,55869
RECOLL.txt,181970,183313,1343,10,N,Y,1448278147591,54631,55869
RECOLL.txt,182045,183365,1320,10,N,Y,1448278147591,54631,55869
RECOLL.txt,182203,183627,1424,10,N,Y,1448278147591,54631,55869
RECOLL.txt,182242,183665,1423,10,N,Y,1448278147591,54631,55869
RECOLL.txt,182373,183766,1393,10,N,N,-,-1,-1
RECOLL.txt,182600,184110,1510,10,N,N,-,-1,-1
RECOLL.txt,182772,184218,1446,10,N,N,-,-1,-1
RECOLL.txt,182880,184266,1386,10,N,N,-,-1,-1
RECOLL.txt,182991,184541,1550,10,Y,Y,1448038101349,15101,17486
RECOLL.txt,183089,184650,1561,10,Y,Y,1448038101349,15101,17486
RECOLL.txt,183314,184707,1393,10,Y,Y,1448038101349,15101,17486
RECOLL.txt,183367,184786,1419,10,Y,Y,1448038101349,15101,17486
RECOLL.txt,183628,184964,1336,10,N,Y,1448038101349,15101,17486
RECOLL.txt,183668,185004,1336,10,N,Y,1448038101349,15101,17486
RECOLL.txt,183767,185251,1484,10,N,Y,1448038101349,15101,17486
RECOLL.txt,184111,185310,1199,10,N,Y,1448038101349,15101,17486
RECOLL.txt,184219,185541,1322,10,Y,Y,1448038101349,15101,17486
RECOLL.txt,184267,185659,1392,10,Y,Y,1448038101349,15101,17486
RECOLL.txt,184544,185861,1317,10,Y,Y,1448038101349,15101,17486
RECOLL.txt,184651,185938,1287,10,Y,Y,1448038101349,15101,17486
RECOLL.txt,184708,186056,1348,10,Y,Y,1448038101349,15101,17486
RECOLL.txt,184787,186117,1330,10,Y,Y,1448038101349,15101,17486
RECOLL.txt,184965,186180,1215,10,Y,Y,1448038101349,15101,17486
RECOLL.txt,185007,186278,1271,10,Y,Y,1448038101349,15101,17486
RECOLL.txt,185252,186581,1329,10,Y,Y,1448038101349,15101,17486
RECOLL.txt,185315,186745,1430,10,Y,Y,1448274783410,21836,25159
RECOLL.txt,185544,186754,1210,10,N,Y,1448274783410,21836,25159
RECOLL.txt,185660,186800,1140,10,N,Y,1448274783410,21836,25159
RECOLL.txt,185863,186963,1100,10,N,Y,1448274783410,21836,25159
RECOLL.txt,185939,186985,1046,10,N,Y,1448274783410,21836,25159
RECOLL.txt,186059,187063,1004,10,N,N,-,-1,-1
RECOLL.txt,186118,187181,1063,10,N,N,-,-1,-1
RECOLL.txt,186181,187249,1068,10,N,N,-,-1,-1
RECOLL.txt,186279,187298,1019,10,N,N,-,-1,-1
RECOLL.txt,186582,187377,795,10,N,N,-,-1,-1
RECOLL.txt,186748,187438,690,10,N,N,-,-1,-1
RECOLL.txt,186754,187579,825,10,N,N,-,-1,-1
RECOLL.txt,186801,187999,1198,10,N,N,-,-1,-1
RECOLL.txt,186964,188087,1123,10,N,N,-,-1,-1
RECOLL.txt,186986,188181,1195,10,N,N,-,-1,-1
RECOLL.txt,187065,188291,1226,10,N,N,-,-1,-1
RECOLL.txt,187182,188418,1236,10,N,N,-,-1,-1
RECOLL.txt,187254,188491,1237,10,N,N,-,-1,-1
RECOLL.txt,187299,188628,1329,10,N,N,-,-1,-1
RECOLL.txt,187378,188728,1350,10,N,N,-,-1,-1
RECOLL.txt,187439,188818,1379,10,N,N,-,-1,-1
RECOLL.txt,187582,188884,1302,10,N,N,-,-1,-1
RECOLL.txt,188000,189018,1018,10,N,N,-,-1,-1
RECOLL.txt,188088,189120,1032,10,N,N,-,-1,-1
RECOLL.txt,188182,189190,1008,10,N,N,-,-1,-1
RECOLL.txt,188296,189286,990,10,N,N,-,-1,-1
RECOLL.txt,188421,189489,1068,10,N,N,-,-1,-1
RECOLL.txt,188492,189738,1246,10,N,N,-,-1,-1
RECOLL.txt,188629,189844,1215,10,N,N,-,-1,-1
RECOLL.txt,188729,189976,1247,10,N,N,-,-1,-1
RECOLL.txt,188821,190123,1302,10,N,N,-,-1,-1
RECOLL.txt,188885,190285,1400,10,N,N,-,-1,-1
RECOLL.txt,189019,190370,1351,10,N,N,-,-1,-1
RECOLL.txt,189121,190511,1390,10,N,N,-,-1,-1
RECOLL.txt,189191,190586,1395,10,N,N,-,-1,-1
RECOLL.txt,189289,190623,1334,10,N,Y,1448322979449,227304,227638
RECOLL.txt,189490,190894,1404,10,N,Y,1448322979449,227304,227638
RECOLL.txt,189741,191143,1402,10,N,Y,1448322979449,227304,227638
RECOLL.txt,189845,191253,1408,10,N,Y,1448322979449,227304,227638
RECOLL.txt,189977,191402,1425,10,N,Y,1448322979449,227304,227638
RECOLL.txt,190124,191486,1362,10,N,Y,1448322979449,227304,227638
RECOLL.txt,190286,191602,1316,10,N,Y,1448322979449,227304,227638
RECOLL.txt,190373,191765,1392,10,N,Y,1448322979449,227304,227638
RECOLL.txt,190513,191919,1406,10,N,Y,1448322979449,227304,227638
RECOLL.txt,190589,192250,1661,10,N,Y,1448322979449,227304,227638
RECOLL.txt,190624,192532,1908,10,N,Y,1448322713112,221941,223038
RECOLL.txt,190895,192583,1688,10,N,Y,1448322713112,221941,223038
RECOLL.txt,191144,192612,1468,10,N,Y,1448322713112,221941,223038
RECOLL.txt,191256,192888,1632,10,N,Y,1448322713112,221941,223038
RECOLL.txt,191403,192922,1519,10,N,Y,1448322713112,221941,223038
RECOLL.txt,191487,192969,1482,10,N,Y,1448322713112,221941,223038
RECOLL.txt,191605,192998,1393,10,N,Y,1448322713112,221941,223038
RECOLL.txt,191766,193067,1301,10,N,Y,1448322713112,221941,223038
RECOLL.txt,191921,193237,1316,10,N,Y,1448322713112,221941,223038
RECOLL.txt,192253,193403,1150,10,N,Y,1448322713112,221941,223038
RECOLL.txt,192533,193633,1100,10,N,Y,1448322713112,221941,223038
RECOLL.txt,192584,193802,1218,10,N,Y,1448322713112,221941,223038
RECOLL.txt,192613,193945,1332,10,N,Y,1448322713112,221941,223038
RECOLL.txt,192889,194177,1288,10,N,Y,1448322713112,221941,223038
RECOLL.txt,192923,194301,1378,10,N,Y,1448322713112,221941,223038
RECOLL.txt,192970,194405,1435,10,N,Y,1448322713112,221941,223038
RECOLL.txt,193001,194464,1463,10,N,Y,1448322713112,221941,223038
RECOLL.txt,193068,194508,1440,10,N,Y,1448322713112,221941,223038
RECOLL.txt,193238,194563,1325,10,N,Y,1448322713112,221941,223038
RECOLL.txt,193404,194690,1286,10,N,Y,1448322713112,221941,223038
RECOLL.txt,193634,194903,1269,10,N,Y,1448322713112,221941,223038
RECOLL.txt,193805,194992,1187,10,N,Y,1448322713112,221941,223038
RECOLL.txt,193947,195093,1146,10,N,Y,1448322713112,221941,223038
RECOLL.txt,194178,195230,1052,10,N,Y,1448322713112,221941,223038
RECOLL.txt,194303,195287,984,10,N,N,-,-1,-1
RECOLL.txt,194408,195393,985,10,N,N,-,-1,-1
RECOLL.txt,194465,195484,1019,10,N,N,-,-1,-1
RECOLL.txt,194510,195526,1016,10,N,N,-,-1,-1
RECOLL.txt,194568,195612,1044,10,N,N,-,-1,-1
RECOLL.txt,194693,195784,1091,10,N,N,-,-1,-1
RECOLL.txt,194906,195832,926,10,N,N,-,-1,-1
RECOLL.txt,194993,195869,876,10,N,N,-,-1,-1
RECOLL.txt,195096,195932,836,10,N,N,-,-1,-1
RECOLL.txt,195233,195992,759,10,N,N,-,-1,-1
RECOLL.txt,195290,196130,840,10,N,N,-,-1,-1
RECOLL.txt,195394,196302,908,10,N,N,-,-1,-1
RECOLL.txt,195485,196364,879,10,N,N,-,-1,-1
RECOLL.txt,195527,196486,959,10,N,N,-,-1,-1
RECOLL.txt,195617,196546,929,10,N,N,-,-1,-1
RECOLL.txt,195785,196717,932,10,N,N,-,-1,-1
RECOLL.txt,195833,196797,964,10,N,N,-,-1,-1
RECOLL.txt,195870,196910,1040,10,N,N,-,-1,-1
RECOLL.txt,195933,197006,1073,10,N,N,-,-1,-1
RECOLL.txt,195993,197151,1158,10,N,N,-,-1,-1
RECOLL.txt,196133,197244,1111,10,N,N,-,-1,-1
RECOLL.txt,196303,197349,1046,10,N,N,-,-1,-1
RECOLL.txt,196366,197575,1209,10,N,N,-,-1,-1
RECOLL.txt,196487,197967,1480,10,N,N,-,-1,-1
RECOLL.txt,196547,198206,1659,10,N,N,-,-1,-1
RECOLL.txt,196718,198337,1619,10,N,N,-,-1,-1
RECOLL.txt,196798,198479,1681,10,N,N,-,-1,-1
RECOLL.txt,196913,198568,1655,10,N,N,-,-1,-1
RECOLL.txt,197007,198623,1616,10,N,Y,1437028092146,121457,123204
RECOLL.txt,197152,198682,1530,10,N,Y,1437028092146,121457,123204
RECOLL.txt,197247,198845,1598,10,Y,Y,1437028092146,121457,123204
RECOLL.txt,197350,198881,1531,10,Y,Y,1437028092146,121457,123204
RECOLL.txt,197578,198983,1405,10,Y,Y,1437028092146,121457,123204
RECOLL.txt,197970,199095,1125,10,Y,Y,1437028092146,121457,123204
RECOLL.txt,198208,199309,1101,10,Y,Y,1437028092146,121457,123204
RECOLL.txt,198338,199550,1212,10,Y,Y,1437028092146,121457,123204
RECOLL.txt,198480,199638,1158,10,Y,Y,1437028092146,121457,123204
RECOLL.txt,198571,199753,1182,10,Y,Y,1437028092146,121457,123204
RECOLL.txt,198624,199973,1349,10,Y,Y,1437028092146,121457,123204
RECOLL.txt,198683,200093,1410,10,Y,Y,1437028092146,121457,123204
RECOLL.txt,198847,200319,1472,10,Y,Y,1437028092146,121457,123204
RECOLL.txt,198884,200476,1592,10,Y,Y,1448322514970,220165,221397
RECOLL.txt,198984,200650,1666,10,Y,Y,1448322514970,220165,221397
RECOLL.txt,199097,200674,1577,10,Y,Y,1448322514970,220165,221397
RECOLL.txt,199310,200708,1398,10,Y,Y,1448322514970,220165,221397
RECOLL.txt,199553,200769,1216,10,Y,Y,1448322514970,220165,221397
RECOLL.txt,199639,200844,1205,10,Y,Y,1448322514970,220165,221397
RECOLL.txt,199754,200944,1190,10,N,Y,1448322514970,220165,221397
RECOLL.txt,199974,201041,1067,10,N,Y,1448322514970,220165,221397
RECOLL.txt,200095,201106,1011,10,N,Y,1448322514970,220165,221397
RECOLL.txt,200320,201172,852,10,N,Y,1448322514970,220165,221397
RECOLL.txt,200481,201238,757,10,N,Y,1448322514970,220165,221397
RECOLL.txt,200652,201358,706,10,N,Y,1448322514970,220165,221397
RECOLL.txt,200677,201404,727,10,N,Y,1448322514970,220165,221397
RECOLL.txt,200709,201596,887,10,N,Y,1448322514970,220165,221397
RECOLL.txt,200772,201616,844,10,N,Y,1448322514970,220165,221397
RECOLL.txt,200845,201917,1072,10,N,Y,1448322514970,220165,221397
RECOLL.txt,200945,202169,1224,10,N,Y,1448287306770,114686,120152
RECOLL.txt,201044,202307,1263,10,N,Y,1448287306770,114686,120152
RECOLL.txt,201107,202345,1238,10,N,Y,1448287306770,114686,120152
RECOLL.txt,201174,202428,1254,10,N,Y,1448287306770,114686,120152
RECOLL.txt,201241,202489,1248,10,N,Y,1448287306770,114686,120152
RECOLL.txt,201359,202521,1162,10,N,Y,1448287306770,114686,120152
RECOLL.txt,201405,202616,1211,10,N,Y,1448287306770,114686,120152
RECOLL.txt,201598,202761,1163,10,N,Y,1448287306770,114686,120152
RECOLL.txt,201617,202838,1221,10,N,Y,1448287306770,114686,120152
RECOLL.txt,201920,203138,1218,10,N,Y,1448287306770,114686,120152
RECOLL.txt,202170,203286,1116,10,N,Y,1448287306770,114686,120152
RECOLL.txt,202308,203467,1159,10,N,Y,1448287306770,114686,120152
RECOLL.txt,202346,203529,1183,10,N,Y,1448287306770,114686,120152
RECOLL.txt,202429,203614,1185,10,N,Y,1448287306770,114686,120152
RECOLL.txt,202490,203692,1202,10,N,Y,1448287306770,114686,120152
RECOLL.txt,202522,203771,1249,10,N,Y,1448287306770,114686,120152
RECOLL.txt,202617,203961,1344,10,N,Y,1448287306770,114686,120152
RECOLL.txt,202764,204073,1309,10,N,Y,1448287306770,114686,120152
RECOLL.txt,202839,204161,1322,10,N,Y,1448287306770,114686,120152
RECOLL.txt,203141,204292,1151,10,N,Y,1448287306770,114686,120152
RECOLL.txt,203287,204321,1034,10,N,Y,1448287306770,114686,120152
RECOLL.txt,203470,204357,887,10,N,Y,1448287306770,114686,120152
RECOLL.txt,203530,204493,963,10,N,Y,1448287306770,114686,120152
RECOLL.txt,203615,204912,1297,10,N,Y,1448287306770,114686,120152
RECOLL.txt,203693,205044,1351,10,N,Y,1448287306770,114686,120152
RECOLL.txt,203776,205195,1419,10,N,Y,1448313674408,176614,178600
RECOLL.txt,203962,205266,1304,10,N,Y,1448313674408,176614,178600
RECOLL.txt,204074,205439,1365,10,N,Y,1448313674408,176614,178600
RECOLL.txt,204162,205550,1388,10,N,Y,1448313674408,176614,178600
RECOLL.txt,204293,205730,1437,10,N,Y,1448313674408,176614,178600
RECOLL.txt,204324,205837,1513,10,Y,Y,1448313674408,176614,178600
RECOLL.txt,204358,205927,1569,10,Y,Y,1448313674408,176614,178600
RECOLL.txt,204494,205969,1475,10,Y,Y,1448313674408,176614,178600
RECOLL.txt,204913,206164,1251,10,Y,Y,1448313674408,176614,178600
RECOLL.txt,205045,206247,1202,10,Y,Y,1448313674408,176614,178600
RECOLL.txt,205198,206494,1296,10,Y,Y,1448313674408,176614,178600
RECOLL.txt,205267,206634,1367,10,Y,Y,1448313674408,176614,178600
RECOLL.txt,205440,206787,1347,10,Y,Y,1448313674408,176614,178600
RECOLL.txt,205553,206895,1342,10,Y,Y,1448313674408,176614,178600
RECOLL.txt,205731,207008,1277,10,Y,Y,1448313674408,176614,178600
RECOLL.txt,205838,207175,1337,10,Y,Y,1448313674408,176614,178600
RECOLL.txt,205928,207304,1376,10,Y,Y,1448313674408,176614,178600
RECOLL.txt,205972,207423,1451,10,Y,Y,1448313674408,176614,178600
RECOLL.txt,206167,207491,1324,10,Y,Y,1448310549245,137491,141408
RECOLL.txt,206248,207594,1346,10,Y,Y,1448310549245,137491,141408
RECOLL.txt,206495,207680,1185,10,Y,Y,1448310549245,137491,141408
RECOLL.txt,206637,207778,1141,10,Y,Y,1448310549245,137491,141408
RECOLL.txt,206790,207863,1073,10,Y,Y,1448310549245,137491,141408
RECOLL.txt,206896,207907,1011,10,Y,Y,1448310549245,137491,141408
RECOLL.txt,207009,208048,1039,10,Y,Y,1448310549245,137491,141408
RECOLL.txt,207176,208203,1027,10,N,Y,1448310549245,137491,141408
RECOLL.txt,207309,208416,1107,10,N,Y,1448310549245,137491,141408
RECOLL.txt,207426,208577,1151,10,N,Y,1448310549245,137491,141408
RECOLL.txt,207492,208807,1315,10,N,Y,1448310549245,137491,141408
RECOLL.txt,207595,208922,1327,10,N,Y,1448310549245,137491,141408
RECOLL.txt,207682,209096,1414,10,N,Y,1448310549245,137491,141408
RECOLL.txt,207779,209200,1421,10,N,Y,1448310549245,137491,141408
RECOLL.txt,207866,209245,1379,10,N,Y,1448310549245,137491,141408
RECOLL.txt,207909,209431,1522,10,N,Y,1448310549245,137491,141408
RECOLL.txt,208051,209530,1479,10,N,N,-,-1,-1
RECOLL.txt,208204,209617,1413,10,N,N,-,-1,-1
RECOLL.txt,208419,209686,1267,10,N,N,-,-1,-1
RECOLL.txt,208582,209734,1152,10,N,N,-,-1,-1
RECOLL.txt,208808,209832,1024,10,N,N,-,-1,-1
RECOLL.txt,208923,209940,1017,10,N,N,-,-1,-1
RECOLL.txt,209097,210004,907,10,N,N,-,-1,-1
RECOLL.txt,209201,210071,870,10,N,N,-,-1,-1
RECOLL.txt,209248,210190,942,10,N,N,-,-1,-1
RECOLL.txt,209432,210232,800,10,N,N,-,-1,-1
RECOLL.txt,209531,210264,733,10,N,N,-,-1,-1
RECOLL.txt,209618,210368,750,10,N,N,-,-1,-1
RECOLL.txt,209687,210517,830,10,N,N,-,-1,-1
RECOLL.txt,209736,210600,864,10,N,N,-,-1,-1
RECOLL.txt,209833,210734,901,10,N,N,-,-1,-1
RECOLL.txt,209941,211011,1070,10,N,N,-,-1,-1
RECOLL.txt,210007,211046,1039,10,N,N,-,-1,-1
RECOLL.txt,210072,211218,1146,10,N,N,-,-1,-1
RECOLL.txt,210192,211346,1154,10,N,N,-,-1,-1
RECOLL.txt,210233,211436,1203,10,N,N,-,-1,-1
RECOLL.txt,210265,211471,1206,10,N,N,-,-1,-1
RECOLL.txt,210369,211542,1173,10,N,N,-,-1,-1
RECOLL.txt,210518,211852,1334,10,N,N,-,-1,-1
RECOLL.txt,210603,211889,1286,10,N,N,-,-1,-1
RECOLL.txt,210736,212094,1358,10,N,N,-,-1,-1
RECOLL.txt,211014,212148,1134,10,N,N,-,-1,-1
RECOLL.txt,211047,212256,1209,10,N,N,-,-1,-1
RECOLL.txt,211219,212316,1097,10,N,N,-,-1,-1
RECOLL.txt,211347,212356,1009,10,N,N,-,-1,-1
RECOLL.txt,211439,212445,1006,10,N,N,-,-1,-1
RECOLL.txt,211472,212560,1088,10,N,N,-,-1,-1
RECOLL.txt,211543,212651,1108,10,N,N,-,-1,-1
RECOLL.txt,211854,212894,1040,10,N,N,-,-1,-1
RECOLL.txt,211890,212934,1044,10,N,N,-,-1,-1
RECOLL.txt,212096,213110,1014,10,N,N,-,-1,-1
RECOLL.txt,212149,213182,1033,10,N,N,-,-1,-1
RECOLL.txt,212257,213395,1138,10,N,N,-,-1,-1
RECOLL.txt,212318,213634,1316,10,N,N,-,-1,-1
RECOLL.txt,212357,213913,1556,10,N,N,-,-1,-1
RECOLL.txt,212450,213967,1517,10,N,N,-,-1,-1
RECOLL.txt,212561,214121,1560,10,N,N,-,-1,-1
RECOLL.txt,212652,214242,1590,10,N,N,-,-1,-1
RECOLL.txt,212895,214328,1433,10,N,N,-,-1,-1
RECOLL.txt,212935,214388,1453,10,N,N,-,-1,-1
RECOLL.txt,213111,214447,1336,10,N,N,-,-1,-1
RECOLL.txt,213185,214548,1363,10,N,N,-,-1,-1
RECOLL.txt,213396,214869,1473,10,N,N,-,-1,-1
RECOLL.txt,213635,215480,1845,10,N,N,-,-1,-1
RECOLL.txt,213915,215531,1616,10,N,N,-,-1,-1
RECOLL.txt,213968,215635,1667,10,N,N,-,-1,-1
RECOLL.txt,214122,215759,1637,10,N,N,-,-1,-1
RECOLL.txt,214243,215875,1632,10,N,N,-,-1,-1
RECOLL.txt,214331,216068,1737,10,N,N,-,-1,-1
RECOLL.txt,214389,216275,1886,10,N,N,-,-1,-1
RECOLL.txt,214448,216489,2041,10,N,N,-,-1,-1
RECOLL.txt,214549,216828,2279,10,N,N,-,-1,-1
RECOLL.txt,214870,216999,2129,10,N,N,-,-1,-1
RECOLL.txt,215483,217164,1681,10,N,N,-,-1,-1
RECOLL.txt,215532,217239,1707,10,N,N,-,-1,-1
RECOLL.txt,215636,217462,1826,10,N,Y,1448286451685,111065,112127
RECOLL.txt,215760,217504,1744,10,N,Y,1448286451685,111065,112127
RECOLL.txt,215878,217609,1731,10,N,Y,1448286451685,111065,112127
RECOLL.txt,216073,217706,1633,10,N,Y,1448286451685,111065,112127
RECOLL.txt,216277,217884,1607,10,N,Y,1448286451685,111065,112127
RECOLL.txt,216492,217920,1428,10,N,Y,1448286451685,111065,112127
RECOLL.txt,216829,218083,1254,10,N,Y,1448286451685,111065,112127
RECOLL.txt,217000,218209,1209,10,N,Y,1448286451685,111065,112127
RECOLL.txt,217165,218468,1303,10,N,Y,1448286451685,111065,112127
RECOLL.txt,217242,218745,1503,10,N,Y,1448286451685,111065,112127
RECOLL.txt,217464,218968,1504,10,N,Y,1448286451685,111065,112127
RECOLL.txt,217507,219145,1638,10,N,Y,1448286451685,111065,112127
RECOLL.txt,217610,219251,1641,10,N,Y,1448286451685,111065,112127
RECOLL.txt,217707,219376,1669,10,N,Y,1448286451685,111065,112127
RECOLL.txt,217885,219510,1625,10,N,Y,1448286451685,111065,112127
RECOLL.txt,217921,219805,1884,10,N,Y,1437490253936,460795,462238
RECOLL.txt,218086,219882,1796,10,N,Y,1437490253936,460795,462238
RECOLL.txt,218210,220080,1870,10,N,Y,1437490253936,460795,462238
RECOLL.txt,218469,220208,1739,10,N,Y,1437490253936,460795,462238
RECOLL.txt,218746,220502,1756,10,N,Y,1437490253936,460795,462238
RECOLL.txt,218971,220593,1622,10,N,Y,1437490253936,460795,462238
RECOLL.txt,219146,220736,1590,10,N,Y,1437490253936,460795,462238
RECOLL.txt,219253,221009,1756,10,N,Y,1437490253936,460795,462238
RECOLL.txt,219379,221166,1787,10,N,Y,1437490253936,460795,462238
RECOLL.txt,219511,221527,2016,10,N,Y,1437490253936,460795,462238
RECOLL.txt,219806,221882,2076,10,N,Y,1437490253936,460795,462238
RECOLL.txt,219883,221975,2092,10,N,Y,1437490253936,460795,462238
RECOLL.txt,220081,222157,2076,10,N,Y,1437490253936,460795,462238
RECOLL.txt,220209,222374,2165,10,N,Y,1437490253936,460795,462238
RECOLL.txt,220505,222454,1949,10,N,Y,1437490253936,460795,462238
RECOLL.txt,220594,222507,1913,10,N,Y,1437490253936,460795,462238
RECOLL.txt,220737,222641,1904,10,N,Y,1437490253936,460795,462238
RECOLL.txt,221010,222878,1868,10,N,Y,1437490253936,460795,462238
RECOLL.txt,221167,222989,1822,10,N,Y,1437490253936,460795,462238
RECOLL.txt,221530,223226,1696,10,N,Y,1437490253936,460795,462238
RECOLL.txt,221883,223340,1457,10,N,Y,1437490253936,460795,462238
RECOLL.txt,221976,223478,1502,10,N,Y,1437490253936,460795,462238
RECOLL.txt,222158,223654,1496,10,N,Y,1437490253936,460795,462238
RECOLL.txt,222377,223780,1403,10,N,Y,1437490253936,460795,462238
RECOLL.txt,222455,223881,1426,10,N,Y,1437490253936,460795,462238
RECOLL.txt,222508,223892,1384,10,N,Y,1437490253936,460795,462238
RECOLL.txt,222642,223910,1268,10,N,N,-,-1,-1
RECOLL.txt,222881,223938,1057,10,N,N,-,-1,-1
RECOLL.txt,222990,223955,965,10,N,N,-,-1,-1
RECOLL.txt,223229,224003,774,10,N,N,-,-1,-1
RECOLL.txt,223341,224091,750,10,N,N,-,-1,-1
RECOLL.txt,223479,224104,625,10,N,N,-,-1,-1
RECOLL.txt,223657,224116,459,10,N,N,-,-1,-1
RECOLL.txt,223781,224141,360,10,N,N,-,-1,-1
RECOLL.txt,223882,224160,278,10,N,N,-,-1,-1
RECOLL.txt,223893,224197,304,10,N,N,-,-1,-1
RECOLL.txt,223911,224317,406,10,N,N,-,-1,-1
RECOLL.txt,223939,224397,458,10,N,N,-,-1,-1
RECOLL.txt,223956,224669,713,10,N,N,-,-1,-1
RECOLL.txt,224006,224835,829,10,N,N,-,-1,-1
RECOLL.txt,224092,224910,818,10,N,N,-,-1,-1
RECOLL.txt,224105,225053,948,10,N,N,-,-1,-1
RECOLL.txt,224117,225234,1117,10,N,N,-,-1,-1
RECOLL.txt,224142,225404,1262,10,N,N,-,-1,-1
RECOLL.txt,224161,225541,1380,10,N,N,-,-1,-1
RECOLL.txt,224198,225643,1445,10,N,N,-,-1,-1
RECOLL.txt,224320,225728,1408,10,N,N,-,-1,-1
RECOLL.txt,224398,225995,1597,10,N,N,-,-1,-1
RECOLL.txt,224670,226148,1478,10,N,N,-,-1,-1
RECOLL.txt,224838,226286,1448,10,N,N,-,-1,-1
RECOLL.txt,224911,226309,1398,10,N,N,-,-1,-1
RECOLL.txt,225054,226448,1394,10,N,N,-,-1,-1
RECOLL.txt,225235,226541,1306,10,N,N,-,-1,-1
RECOLL.txt,225405,226620,1215,10,N,N,-,-1,-1
RECOLL.txt,225542,226786,1244,10,N,N,-,-1,-1
RECOLL.txt,225644,226805,1161,10,N,N,-,-1,-1
RECOLL.txt,225729,226888,1159,10,N,N,-,-1,-1
RECOLL.txt,225996,226917,921,10,N,N,-,-1,-1
RECOLL.txt,226151,226950,799,10,N,N,-,-1,-1
RECOLL.txt,226288,227190,902,10,N,N,-,-1,-1
RECOLL.txt,226310,227416,1106,10,N,N,-,-1,-1
RECOLL.txt,226449,227708,1259,10,N,N,-,-1,-1
RECOLL.txt,226542,227804,1262,10,N,N,-,-1,-1
RECOLL.txt,226621,227903,1282,10,N,N,-,-1,-1
RECOLL.txt,226787,228055,1268,10,N,N,-,-1,-1
RECOLL.txt,226806,228224,1418,10,N,N,-,-1,-1
RECOLL.txt,226891,228355,1464,10,N,N,-,-1,-1
RECOLL.txt,226918,228500,1582,10,N,N,-,-1,-1
RECOLL.txt,226951,228623,1672,10,N,N,-,-1,-1
RECOLL.txt,227191,228884,1693,10,N,N,-,-1,-1
RECOLL.txt,227417,228994,1577,10,N,N,-,-1,-1
RECOLL.txt,227709,229074,1365,10,N,N,-,-1,-1
RECOLL.txt,227807,229166,1359,10,N,N,-,-1,-1
RECOLL.txt,227904,229254,1350,10,N,N,-,-1,-1
RECOLL.txt,228056,229308,1252,10,N,N,-,-1,-1
RECOLL.txt,228225,229384,1159,10,N,N,-,-1,-1
RECOLL.txt,228356,229698,1342,10,N,N,-,-1,-1
RECOLL.txt,228503,229828,1325,10,N,N,-,-1,-1
RECOLL.txt,228624,229875,1251,10,N,N,-,-1,-1
RECOLL.txt,228887,229898,1011,10,N,N,-,-1,-1
RECOLL.txt,228995,229914,919,10,N,N,-,-1,-1
RECOLL.txt,229075,230147,1072,10,N,N,-,-1,-1
RECOLL.txt,229167,230271,1104,10,N,N,-,-1,-1
RECOLL.txt,229256,230424,1168,10,N,N,-,-1,-1
RECOLL.txt,229309,230526,1217,10,N,N,-,-1,-1
RECOLL.txt,229386,230864,1478,10,N,N,-,-1,-1
RECOLL.txt,229701,230944,1243,10,N,N,-,-1,-1
RECOLL.txt,229829,230971,1142,10,N,N,-,-1,-1
RECOLL.txt,229876,231122,1246,10,N,N,-,-1,-1
RECOLL.txt,229899,231326,1427,10,N,N,-,-1,-1
RECOLL.txt,229919,231386,1467,10,N,N,-,-1,-1
RECOLL.txt,230148,231488,1340,10,N,N,-,-1,-1
RECOLL.txt,230272,231715,1443,10,N,N,-,-1,-1
RECOLL.txt,230427,231823,1396,10,N,N,-,-1,-1
RECOLL.txt,230529,231889,1360,10,N,N,-,-1,-1
RECOLL.txt,230865,231906,1041,10,N,N,-,-1,-1
RECOLL.txt,230945,231959,1014,10,N,N,-,-1,-1
RECOLL.txt,230972,232075,1103,10,N,N,-,-1,-1
RECOLL.txt,231123,232270,1147,10,N,N,-,-1,-1
RECOLL.txt,231327,232655,1328,10,N,N,-,-1,-1
RECOLL.txt,231389,232703,1314,10,N,N,-,-1,-1
RECOLL.txt,231489,232888,1399,10,N,N,-,-1,-1
RECOLL.txt,231716,232991,1275,10,N,N,-,-1,-1
RECOLL.txt,231824,233229,1405,10,N,N,-,-1,-1
RECOLL.txt,231890,233254,1364,10,N,N,-,-1,-1
RECOLL.txt,231907,233286,1379,10,N,N,-,-1,-1
RECOLL.txt,231960,233524,1564,10,N,N,-,-1,-1
RECOLL.txt,232077,233649,1572,10,N,N,-,-1,-1
RECOLL.txt,232275,233730,1455,10,N,N,-,-1,-1
RECOLL.txt,232656,233852,1196,10,N,N,-,-1,-1
RECOLL.txt,232704,234149,1445,10,Y,N,-,-1,-1
RECOLL.txt,232891,234603,1712,10,Y,N,-,-1,-1
RECOLL.txt,232992,234766,1774,10,Y,N,-,-1,-1
RECOLL.txt,233230,234865,1635,10,N,N,-,-1,-1
RECOLL.txt,233255,235072,1817,10,N,N,-,-1,-1
RECOLL.txt,233289,235252,1963,10,N,N,-,-1,-1
RECOLL.txt,233527,235358,1831,10,N,N,-,-1,-1
RECOLL.txt,233650,235524,1874,10,N,N,-,-1,-1
RECOLL.txt,233731,235786,2055,10,N,N,-,-1,-1
RECOLL.txt,233853,235952,2099,10,N,N,-,-1,-1
RECOLL.txt,234152,236075,1923,10,N,N,-,-1,-1
RECOLL.txt,234608,236167,1559,10,N,N,-,-1,-1
RECOLL.txt,234767,236244,1477,10,N,N,-,-1,-1
RECOLL.txt,234866,236286,1420,10,N,N,-,-1,-1
RECOLL.txt,235073,236373,1300,10,N,N,-,-1,-1
RECOLL.txt,235253,236485,1232,10,N,N,-,-1,-1
RECOLL.txt,235359,236828,1469,10,N,N,-,-1,-1
RECOLL.txt,235525,237058,1533,10,N,N,-,-1,-1
RECOLL.txt,235789,237129,1340,10,N,N,-,-1,-1
RECOLL.txt,235953,237246,1293,10,N,N,-,-1,-1
RECOLL.txt,236076,237443,1367,10,N,N,-,-1,-1
RECOLL.txt,236168,237504,1336,10,N,N,-,-1,-1
RECOLL.txt,236245,237671,1426,10,N,N,-,-1,-1
RECOLL.txt,236288,237780,1492,10,N,N,-,-1,-1
RECOLL.txt,236375,237946,1571,10,N,N,-,-1,-1
RECOLL.txt,236486,238078,1592,10,N,N,-,-1,-1
RECOLL.txt,236829,238309,1480,10,N,N,-,-1,-1
RECOLL.txt,237059,238388,1329,10,N,N,-,-1,-1
RECOLL.txt,237132,238531,1399,10,N,N,-,-1,-1
RECOLL.txt,237247,238667,1420,10,N,N,-,-1,-1
RECOLL.txt,237444,238764,1320,10,N,N,-,-1,-1
RECOLL.txt,237505,238906,1401,10,N,N,-,-1,-1
RECOLL.txt,237674,239154,1480,10,N,N,-,-1,-1
RECOLL.txt,237781,239190,1409,10,N,N,-,-1,-1
RECOLL.txt,237947,239285,1338,10,N,N,-,-1,-1
RECOLL.txt,238079,239312,1233,10,N,N,-,-1,-1
RECOLL.txt,238310,239499,1189,10,N,N,-,-1,-1
RECOLL.txt,238389,239629,1240,10,N,N,-,-1,-1
RECOLL.txt,238536,239653,1117,10,N,N,-,-1,-1
RECOLL.txt,238669,239853,1184,10,N,N,-,-1,-1
RECOLL.txt,238765,240145,1380,10,N,N,-,-1,-1
RECOLL.txt,238909,240294,1385,10,N,N,-,-1,-1
RECOLL.txt,239155,240426,1271,10,N,N,-,-1,-1
RECOLL.txt,239191,240522,1331,10,N,N,-,-1,-1
RECOLL.txt,239286,240610,1324,10,N,Y,1448279620157,70041,71486
RECOLL.txt,239313,240909,1596,10,N,Y,1448279620157,70041,71486
RECOLL.txt,239500,241129,1629,10,N,Y,1448279620157,70041,71486
RECOLL.txt,239630,241268,1638,10,N,Y,1448279620157,70041,71486
RECOLL.txt,239656,241367,1711,10,N,Y,1448279620157,70041,71486
RECOLL.txt,239854,241569,1715,10,Y,Y,1437472966198,394609,395892
RECOLL.txt,240146,241675,1529,10,Y,Y,1437472966198,394609,395892
RECOLL.txt,240295,241845,1550,10,Y,Y,1437472966198,394609,395892
RECOLL.txt,240427,242035,1608,10,Y,Y,1437472966198,394609,395892
RECOLL.txt,240525,242187,1662,10,Y,Y,1437472966198,394609,395892
RECOLL.txt,240611,242286,1675,10,Y,Y,1437472966198,394609,395892
RECOLL.txt,240910,242366,1456,10,Y,Y,1437472966198,394609,395892
RECOLL.txt,241130,242470,1340,10,Y,Y,1437472966198,394609,395892
RECOLL.txt,241269,242544,1275,10,Y,Y,1437472966198,394609,395892
RECOLL.txt,241370,242663,1293,10,Y,Y,1437472966198,394609,395892
RECOLL.txt,241570,242855,1285,10,N,Y,1437472966198,394609,395892
RECOLL.txt,241676,243022,1346,10,N,Y,1437472966198,394609,395892
RECOLL.txt,241848,243505,1657,10,N,Y,1448315360596,182069,182233
RECOLL.txt,242036,243834,1798,10,Y,Y,1448315360596,182069,182233
RECOLL.txt,242188,244224,2036,10,Y,Y,1448315360596,182069,182233
RECOLL.txt,242287,244358,2071,10,Y,Y,1448315360596,182069,182233
RECOLL.txt,242371,244437,2066,10,Y,Y,1448315360596,182069,182233
RECOLL.txt,242473,244493,2020,10,Y,Y,1448315360596,182069,182233
RECOLL.txt,242545,244568,2023,10,Y,Y,1448315360596,182069,182233
RECOLL.txt,242664,244730,2066,10,Y,Y,1448315360596,182069,182233
RECOLL.txt,242858,244846,1988,10,Y,Y,1448315360596,182069,182233
RECOLL.txt,243023,244912,1889,10,Y,Y,1448315360596,182069,182233
RECOLL.txt,243506,245058,1552,10,Y,Y,1448315360596,182069,182233
RECOLL.txt,243837,245175,1338,10,N,Y,1448315360596,182069,182233
RECOLL.txt,244225,245360,1135,10,N,Y,1448315360596,182069,182233
RECOLL.txt,244359,245473,1114,10,Y,Y,1448315360596,182069,182233
RECOLL.txt,244439,245548,1109,10,Y,Y,1448315360596,182069,182233
RECOLL.txt,244496,245614,1118,10,Y,Y,1448315360596,182069,182233
RECOLL.txt,244569,245749,1180,10,Y,Y,1448315360596,182069,182233
RECOLL.txt,244731,245884,1153,10,Y,Y,1448315360596,182069,182233
RECOLL.txt,244847,246132,1285,10,Y,Y,1448315360596,182069,182233
RECOLL.txt,244917,246230,1313,10,Y,Y,1448315360596,182069,182233
RECOLL.txt,245059,246319,1260,10,Y,Y,1448315360596,182069,182233
RECOLL.txt,245176,246400,1224,10,Y,Y,1448315360596,182069,182233
RECOLL.txt,245363,246470,1107,10,N,N,-,-1,-1
RECOLL.txt,245474,246530,1056,10,N,N,-,-1,-1
RECOLL.txt,245551,246623,1072,10,N,N,-,-1,-1
RECOLL.txt,245615,246695,1080,10,N,N,-,-1,-1
RECOLL.txt,245750,246819,1069,10,N,N,-,-1,-1
RECOLL.txt,245887,246824,937,10,N,N,-,-1,-1
RECOLL.txt,246137,246876,739,10,N,N,-,-1,-1
RECOLL.txt,246231,246933,702,10,N,N,-,-1,-1
RECOLL.txt,246320,246967,647,10,N,N,-,-1,-1
RECOLL.txt,246402,246972,570,10,N,N,-,-1,-1
RECOLL.txt,246471,247004,533,10,N,N,-,-1,-1
RECOLL.txt,246531,247006,475,10,N,N,-,-1,-1
RECOLL.txt,246623,247018,395,10,N,N,-,-1,-1
RECOLL.txt,246698,247042,344,10,N,N,-,-1,-1
RECOLL.txt,246822,247072,250,10,N,N,-,-1,-1
RECOLL.txt,246825,247128,303,10,N,N,-,-1,-1
RECOLL.txt,246877,247133,256,10,N,N,-,-1,-1
RECOLL.txt,246935,247181,246,10,N,N,-,-1,-1
RECOLL.txt,246970,247243,273,10,N,N,-,-1,-1
RECOLL.txt,246973,247275,302,10,N,N,-,-1,-1
RECOLL.txt,247005,247321,316,10,N,N,-,-1,-1
RECOLL.txt,247007,247344,337,10,N,N,-,-1,-1
RECOLL.txt,247019,247349,330,10,N,N,-,-1,-1
RECOLL.txt,247045,247376,331,10,N,N,-,-1,-1
RECOLL.txt,247075,247378,303,10,N,N,-,-1,-1
RECOLL.txt,247131,247380,249,10,N,N,-,-1,-1
RECOLL.txt,247134,247389,255,10,N,N,-,-1,-1
RECOLL.txt,247184,247394,210,10,N,N,-,-1,-1
RECOLL.txt,247246,247442,196,10,N,N,-,-1,-1
RECOLL.txt,247280,247464,184,10,N,N,-,-1,-1
RECOLL.txt,247322,247469,147,10,N,N,-,-1,-1
RECOLL.txt,247347,247537,190,10,N,N,-,-1,-1
RECOLL.txt,247350,247543,193,10,N,N,-,-1,-1
RECOLL.txt,247377,247581,204,10,N,N,-,-1,-1
RECOLL.txt,247379,247588,209,10,N,N,-,-1,-1
RECOLL.txt,247381,247702,321,10,N,N,-,-1,-1
RECOLL.txt,247392,247708,316,10,N,N,-,-1,-1
RECOLL.txt,247395,247843,448,10,N,N,-,-1,-1
RECOLL.txt,247445,248056,611,10,N,N,-,-1,-1
RECOLL.txt,247467,248101,634,10,N,N,-,-1,-1
RECOLL.txt,247470,248208,738,10,N,N,-,-1,-1
RECOLL.txt,247540,248299,759,10,N,N,-,-1,-1
RECOLL.txt,247544,248342,798,10,N,N,-,-1,-1
RECOLL.txt,247582,248392,810,10,N,Y,1448315012079,181380,182053
RECOLL.txt,247591,248556,965,10,N,Y,1448315012079,181380,182053
RECOLL.txt,247705,248800,1095,10,N,Y,1448315012079,181380,182053
RECOLL.txt,247709,248982,1273,10,N,Y,1448315012079,181380,182053
RECOLL.txt,247848,249065,1217,10,N,Y,1448315012079,181380,182053
RECOLL.txt,248057,249137,1080,10,N,Y,1448315012079,181380,182053
RECOLL.txt,248102,249312,1210,10,N,Y,1448315012079,181380,182053
RECOLL.txt,248209,249545,1336,10,N,Y,1448315012079,181380,182053
RECOLL.txt,248302,249607,1305,10,N,Y,1448315012079,181380,182053
RECOLL.txt,248344,249716,1372,10,N,Y,1448315012079,181380,182053
RECOLL.txt,248394,249792,1398,10,N,Y,1448315012079,181380,182053
RECOLL.txt,248557,250130,1573,10,N,Y,1448315012079,181380,182053
RECOLL.txt,248801,250309,1508,10,N,Y,1448315012079,181380,182053
RECOLL.txt,248983,250425,1442,10,N,Y,1448315012079,181380,182053
RECOLL.txt,249068,250517,1449,10,N,Y,1448315012079,181380,182053
RECOLL.txt,249138,250693,1555,10,N,Y,1448315012079,181380,182053
RECOLL.txt,249313,250869,1556,10,N,Y,1448315012079,181380,182053
RECOLL.txt,249546,250963,1417,10,N,Y,1448315012079,181380,182053
RECOLL.txt,249610,251227,1617,10,Y,Y,1448357431466,233540,233770
RECOLL.txt,249717,251392,1675,10,Y,Y,1448357431466,233540,233770
RECOLL.txt,249793,251419,1626,10,Y,Y,1448357431466,233540,233770
RECOLL.txt,250131,251477,1346,10,Y,Y,1448357431466,233540,233770
RECOLL.txt,250310,251572,1262,10,Y,Y,1448357431466,233540,233770
RECOLL.txt,250428,251677,1249,10,Y,Y,1448357431466,233540,233770
RECOLL.txt,250519,251881,1362,10,Y,Y,1448322095209,213778,214023
RECOLL.txt,250694,251929,1235,10,Y,Y,1448322095209,213778,214023
RECOLL.txt,250870,252161,1291,10,Y,Y,1448322095209,213778,214023
RECOLL.txt,250966,252289,1323,10,Y,Y,1448322095209,213778,214023
RECOLL.txt,251228,252438,1210,10,Y,Y,1448322095209,213778,214023
RECOLL.txt,251393,252638,1245,10,Y,Y,1448322095209,213778,214023
RECOLL.txt,251422,252994,1572,10,Y,Y,1448322095209,213778,214023
RECOLL.txt,251482,253131,1649,10,Y,Y,1448322095209,213778,214023
RECOLL.txt,251574,253187,1613,10,Y,Y,1448322095209,213778,214023
RECOLL.txt,251680,253265,1585,10,N,Y,1448322095209,213778,214023
RECOLL.txt,251882,253372,1490,10,N,Y,1448322095209,213778,214023
RECOLL.txt,251930,253528,1598,10,N,Y,1448322095209,213778,214023
RECOLL.txt,252162,253613,1451,10,N,Y,1448322095209,213778,214023
RECOLL.txt,252292,253699,1407,10,N,N,-,-1,-1
RECOLL.txt,252439,254391,1952,10,N,N,-,-1,-1
RECOLL.txt,252639,254549,1910,10,N,N,-,-1,-1
RECOLL.txt,252995,254594,1599,10,N,N,-,-1,-1
RECOLL.txt,253132,254742,1610,10,N,N,-,-1,-1
RECOLL.txt,253188,254844,1656,10,N,N,-,-1,-1
RECOLL.txt,253266,255113,1847,10,N,N,-,-1,-1
RECOLL.txt,253375,255206,1831,10,N,N,-,-1,-1
RECOLL.txt,253531,255288,1757,10,N,N,-,-1,-1
RECOLL.txt,253615,255412,1797,10,N,Y,1448038356234,18463,18881
RECOLL.txt,253700,255669,1969,10,N,Y,1448038356234,18463,18881
RECOLL.txt,254394,255723,1329,10,N,Y,1448038356234,18463,18881
RECOLL.txt,254550,255883,1333,10,N,Y,1448038356234,18463,18881
RECOLL.txt,254599,255998,1399,10,N,Y,1448038356234,18463,18881
RECOLL.txt,254743,256262,1519,10,N,Y,1448038356234,18463,18881
RECOLL.txt,254845,256382,1537,10,N,Y,1448038356234,18463,18881
RECOLL.txt,255114,256514,1400,10,N,Y,1448038356234,18463,18881
RECOLL.txt,255207,256654,1447,10,N,Y,1448038356234,18463,18881
RECOLL.txt,255289,256838,1549,10,N,Y,1448038356234,18463,18881
RECOLL.txt,255413,257242,1829,10,Y,Y,1448038356234,18463,18881
RECOLL.txt,255670,257401,1731,10,Y,Y,1448038356234,18463,18881
RECOLL.txt,255725,257487,1762,10,Y,Y,1448038356234,18463,18881
RECOLL.txt,255884,257648,1764,10,Y,Y,1448038356234,18463,18881
RECOLL.txt,256001,257718,1717,10,Y,N,-,-1,-1
RECOLL.txt,256263,257832,1569,10,Y,N,-,-1,-1
RECOLL.txt,256383,257976,1593,10,Y,N,-,-1,-1
RECOLL.txt,256515,258034,1519,10,Y,N,-,-1,-1
RECOLL.txt,256657,258130,1473,10,N,N,-,-1,-1
RECOLL.txt,256839,258252,1413,10,Y,N,-,-1,-1
RECOLL.txt,257243,258274,1031,10,N,N,-,-1,-1
RECOLL.txt,257404,258431,1027,10,N,Y,1448323072174,227638,227786
RECOLL.txt,257488,258520,1032,10,N,Y,1448323072174,227638,227786
RECOLL.txt,257649,258602,953,10,N,Y,1448323072174,227638,227786
RECOLL.txt,257719,258711,992,10,N,Y,1448323072174,227638,227786
RECOLL.txt,257833,258778,945,10,N,Y,1448323072174,227638,227786
RECOLL.txt,257977,258846,869,10,N,Y,1448323072174,227638,227786
RECOLL.txt,258035,258942,907,10,N,Y,1448323072174,227638,227786
RECOLL.txt,258132,258979,847,10,N,Y,1448323072174,227638,227786
RECOLL.txt,258257,259043,786,10,N,Y,1448323072174,227638,227786
RECOLL.txt,258279,259248,969,10,N,Y,1448323072174,227638,227786
RECOLL.txt,258432,259408,976,10,Y,Y,1448323072174,227638,227786
RECOLL.txt,258521,259516,995,10,Y,Y,1448323072174,227638,227786
RECOLL.txt,258603,259658,1055,10,Y,Y,1448323072174,227638,227786
RECOLL.txt,258713,259846,1133,10,Y,Y,1448323072174,227638,227786
RECOLL.txt,258779,259977,1198,10,N,Y,1448323072174,227638,227786
RECOLL.txt,258848,260113,1265,10,N,Y,1448323072174,227638,227786
RECOLL.txt,258943,260201,1258,10,N,Y,1448323072174,227638,227786
RECOLL.txt,258981,260255,1274,10,N,Y,1448323072174,227638,227786
RECOLL.txt,259046,260506,1460,10,N,Y,1448323072174,227638,227786
RECOLL.txt,259249,260677,1428,10,N,Y,1448323072174,227638,227786
RECOLL.txt,259410,260878,1468,10,N,Y,1448323072174,227638,227786
RECOLL.txt,259521,261032,1511,10,N,N,-,-1,-1
RECOLL.txt,259659,261343,1684,10,N,N,-,-1,-1
RECOLL.txt,259847,261635,1788,10,N,N,-,-1,-1
RECOLL.txt,259978,261887,1909,10,N,N,-,-1,-1
RECOLL.txt,260114,262147,2033,10,N,N,-,-1,-1
RECOLL.txt,260202,262261,2059,10,N,N,-,-1,-1
RECOLL.txt,260256,262308,2052,10,N,N,-,-1,-1
RECOLL.txt,260507,262471,1964,10,N,N,-,-1,-1
RECOLL.txt,260678,262615,1937,10,N,N,-,-1,-1
RECOLL.txt,260879,262680,1801,10,N,N,-,-1,-1
RECOLL.txt,261035,262753,1718,10,N,N,-,-1,-1
RECOLL.txt,261346,262832,1486,10,N,N,-,-1,-1
RECOLL.txt,261638,262881,1243,10,N,N,-,-1,-1
RECOLL.txt,261888,263210,1322,10,N,N,-,-1,-1
RECOLL.txt,262150,263254,1104,10,N,N,-,-1,-1
RECOLL.txt,262262,263349,1087,10,N,N,-,-1,-1
RECOLL.txt,262311,263413,1102,10,N,N,-,-1,-1
RECOLL.txt,262472,263482,1010,10,N,N,-,-1,-1
RECOLL.txt,262616,263580,964,10,N,N,-,-1,-1
RECOLL.txt,262681,263757,1076,10,N,N,-,-1,-1
RECOLL.txt,262754,264017,1263,10,N,N,-,-1,-1
RECOLL.txt,262833,264189,1356,10,N,N,-,-1,-1
RECOLL.txt,262882,264269,1387,10,N,N,-,-1,-1
RECOLL.txt,263212,264415,1203,10,N,N,-,-1,-1
RECOLL.txt,263257,264481,1224,10,N,N,-,-1,-1
RECOLL.txt,263351,264533,1182,10,N,N,-,-1,-1
RECOLL.txt,263416,264634,1218,10,N,N,-,-1,-1
RECOLL.txt,263483,264697,1214,10,N,N,-,-1,-1
RECOLL.txt,263581,264909,1328,10,N,N,-,-1,-1
RECOLL.txt,263758,265110,1352,10,N,N,-,-1,-1
RECOLL.txt,264020,265178,1158,10,N,N,-,-1,-1
RECOLL.txt,264190,265219,1029,10,N,N,-,-1,-1
RECOLL.txt,264270,265275,1005,10,N,N,-,-1,-1
RECOLL.txt,264416,265396,980,10,N,Y,1448367094347,278355,278591
RECOLL.txt,264484,265486,1002,10,N,Y,1448367094347,278355,278591
RECOLL.txt,264534,265662,1128,10,N,Y,1448367094347,278355,278591
RECOLL.txt,264635,265768,1133,10,N,Y,1448367094347,278355,278591
RECOLL.txt,264699,265792,1093,10,N,Y,1448367094347,278355,278591
RECOLL.txt,264910,265912,1002,10,N,Y,1448367094347,278355,278591
RECOLL.txt,265113,266064,951,10,N,Y,1448367094347,278355,278591
RECOLL.txt,265179,266169,990,10,N,Y,1448367094347,278355,278591
RECOLL.txt,265220,266281,1061,10,N,Y,1448367094347,278355,278591
RECOLL.txt,265276,266412,1136,10,N,Y,1448367094347,278355,278591
RECOLL.txt,265397,266471,1074,10,N,Y,1448367094347,278355,278591
RECOLL.txt,265489,266577,1088,10,N,Y,1448367094347,278355,278591
RECOLL.txt,265663,266643,980,10,N,Y,1448367094347,278355,278591
RECOLL.txt,265769,266827,1058,10,N,Y,1448367094347,278355,278591
RECOLL.txt,265795,266891,1096,10,N,N,-,-1,-1
RECOLL.txt,265913,266902,989,10,N,N,-,-1,-1
RECOLL.txt,266066,266990,924,10,N,N,-,-1,-1
RECOLL.txt,266170,267145,975,10,N,N,-,-1,-1
RECOLL.txt,266282,267233,951,10,N,N,-,-1,-1
RECOLL.txt,266413,267394,981,10,N,N,-,-1,-1
RECOLL.txt,266474,267577,1103,10,N,N,-,-1,-1
RECOLL.txt,266578,267691,1113,10,N,N,-,-1,-1
RECOLL.txt,266644,267802,1158,10,N,N,-,-1,-1
RECOLL.txt,266828,267949,1121,10,N,N,-,-1,-1
RECOLL.txt,266892,268230,1338,10,N,N,-,-1,-1
RECOLL.txt,266903,268531,1628,10,N,N,-,-1,-1
RECOLL.txt,266991,268611,1620,10,N,N,-,-1,-1
RECOLL.txt,267146,268705,1559,10,N,N,-,-1,-1
RECOLL.txt,267234,269003,1769,10,N,N,-,-1,-1
RECOLL.txt,267397,269195,1798,10,N,N,-,-1,-1
RECOLL.txt,267579,269227,1648,10,N,N,-,-1,-1
RECOLL.txt,267694,269397,1703,10,N,N,-,-1,-1
RECOLL.txt,267803,269494,1691,10,N,N,-,-1,-1
RECOLL.txt,267950,269632,1682,10,N,N,-,-1,-1
RECOLL.txt,268231,269707,1476,10,N,N,-,-1,-1
RECOLL.txt,268532,269857,1325,10,N,N,-,-1,-1
RECOLL.txt,268612,269987,1375,10,N,N,-,-1,-1
RECOLL.txt,268708,270106,1398,10,N,N,-,-1,-1
RECOLL.txt,269004,270127,1123,10,N,N,-,-1,-1
RECOLL.txt,269196,270204,1008,10,N,N,-,-1,-1
RECOLL.txt,269228,270257,1029,10,N,N,-,-1,-1
RECOLL.txt,269398,270433,1035,10,N,N,-,-1,-1
RECOLL.txt,269495,270585,1090,10,N,N,-,-1,-1
RECOLL.txt,269633,270723,1090,10,N,N,-,-1,-1
RECOLL.txt,269708,270822,1114,10,N,N,-,-1,-1
RECOLL.txt,269859,270960,1101,10,N,N,-,-1,-1
RECOLL.txt,269988,271011,1023,10,N,N,-,-1,-1
RECOLL.txt,270107,271130,1023,10,N,N,-,-1,-1
RECOLL.txt,270132,271282,1150,10,N,N,-,-1,-1
RECOLL.txt,270205,271531,1326,10,N,N,-,-1,-1
RECOLL.txt,270258,271599,1341,10,N,N,-,-1,-1
RECOLL.txt,270434,271703,1269,10,N,N,-,-1,-1
RECOLL.txt,270586,271769,1183,10,N,N,-,-1,-1
RECOLL.txt,270726,271854,1128,10,N,N,-,-1,-1
RECOLL.txt,270823,271983,1160,10,N,N,-,-1,-1
RECOLL.txt,270961,272064,1103,10,N,N,-,-1,-1
RECOLL.txt,271012,272201,1189,10,N,Y,1448393918391,289044,290517
RECOLL.txt,271131,272414,1283,10,N,Y,1448393918391,289044,290517
RECOLL.txt,271283,272543,1260,10,N,Y,1448393918391,289044,290517
RECOLL.txt,271532,272666,1134,10,N,Y,1448393918391,289044,290517
RECOLL.txt,271600,272868,1268,10,N,Y,1448393918391,289044,290517
RECOLL.txt,271706,273049,1343,10,N,Y,1448393918391,289044,290517
RECOLL.txt,271770,273199,1429,10,N,Y,1448393918391,289044,290517
RECOLL.txt,271855,273572,1717,10,N,Y,1448393918391,289044,290517
RECOLL.txt,271984,273710,1726,10,N,Y,1448393918391,289044,290517
RECOLL.txt,272067,273942,1875,10,N,Y,1448393918391,289044,290517
RECOLL.txt,272202,273989,1787,10,N,Y,1448393918391,289044,290517
RECOLL.txt,272415,274092,1677,10,N,Y,1448393918391,289044,290517
RECOLL.txt,272544,274174,1630,10,N,Y,1448393918391,289044,290517
RECOLL.txt,272667,274340,1673,10,N,Y,1448393918391,289044,290517
RECOLL.txt,272869,274442,1573,10,N,Y,1448393918391,289044,290517
RECOLL.txt,273050,274693,1643,10,N,Y,1448393918391,289044,290517
RECOLL.txt,273200,274727,1527,10,N,Y,1448393918391,289044,290517
RECOLL.txt,273575,275106,1531,10,N,N,-,-1,-1
RECOLL.txt,273715,275511,1796,10,N,N,-,-1,-1
RECOLL.txt,273944,275645,1701,10,N,N,-,-1,-1
RECOLL.txt,273991,275720,1729,10,N,N,-,-1,-1
RECOLL.txt,274093,275979,1886,10,N,N,-,-1,-1
RECOLL.txt,274176,276085,1909,10,N,N,-,-1,-1
RECOLL.txt,274341,276494,2153,10,N,N,-,-1,-1
RECOLL.txt,274443,276677,2234,10,N,N,-,-1,-1
RECOLL.txt,274694,276730,2036,10,N,N,-,-1,-1
RECOLL.txt,274728,276815,2087,10,N,N,-,-1,-1
RECOLL.txt,275109,277212,2103,10,N,N,-,-1,-1
RECOLL.txt,275512,277293,1781,10,N,N,-,-1,-1
RECOLL.txt,275646,277552,1906,10,N,N,-,-1,-1
RECOLL.txt,275723,277731,2008,10,N,N,-,-1,-1
RECOLL.txt,275980,277861,1881,10,N,N,-,-1,-1
RECOLL.txt,276090,278046,1956,10,N,Y,1437471855423,351318,351853
RECOLL.txt,276495,278248,1753,10,N,Y,1437471855423,351318,351853
RECOLL.txt,276678,278392,1714,10,N,Y,1437471855423,351318,351853
RECOLL.txt,276732,278474,1742,10,N,Y,1437471855423,351318,351853
RECOLL.txt,276816,278509,1693,10,N,Y,1437471855423,351318,351853
RECOLL.txt,277213,278861,1648,10,N,Y,1437471855423,351318,351853
RECOLL.txt,277294,278963,1669,10,N,Y,1437471855423,351318,351853
RECOLL.txt,277553,279095,1542,10,N,Y,1437471855423,351318,351853
RECOLL.txt,277732,279282,1550,10,N,Y,1437471855423,351318,351853
RECOLL.txt,277864,279414,1550,10,N,Y,1437471855423,351318,351853
RECOLL.txt,278048,279877,1829,10,N,Y,1448314402792,179959,180202
RECOLL.txt,278249,280126,1877,10,N,Y,1448314402792,179959,180202
RECOLL.txt,278393,280229,1836,10,N,Y,1448314402792,179959,180202
RECOLL.txt,278475,280560,2085,10,N,Y,1448314402792,179959,180202
RECOLL.txt,278512,280688,2176,10,N,Y,1448314402792,179959,180202
RECOLL.txt,278862,280852,1990,10,N,Y,1448314402792,179959,180202
RECOLL.txt,278964,281006,2042,10,N,Y,1448314402792,179959,180202
RECOLL.txt,279096,281109,2013,10,N,Y,1448314402792,179959,180202
RECOLL.txt,279285,281216,1931,10,N,Y,1448314402792,179959,180202
RECOLL.txt,279415,281381,1966,10,N,Y,1448314402792,179959,180202
RECOLL.txt,279879,281452,1573,10,N,N,-,-1,-1
RECOLL.txt,280127,281594,1467,10,N,N,-,-1,-1
RECOLL.txt,280230,281689,1459,10,N,N,-,-1,-1
RECOLL.txt,280562,281747,1185,10,N,N,-,-1,-1
RECOLL.txt,280691,281948,1257,10,N,N,-,-1,-1
RECOLL.txt,280853,282054,1201,10,N,N,-,-1,-1
RECOLL.txt,281007,282230,1223,10,N,N,-,-1,-1
RECOLL.txt,281112,282340,1228,10,N,N,-,-1,-1
RECOLL.txt,281217,282487,1270,10,N,N,-,-1,-1
RECOLL.txt,281382,282601,1219,10,N,N,-,-1,-1
RECOLL.txt,281453,282857,1404,10,N,N,-,-1,-1
RECOLL.txt,281596,283286,1690,10,N,N,-,-1,-1
RECOLL.txt,281690,283384,1694,10,N,N,-,-1,-1
RECOLL.txt,281750,283662,1912,10,N,N,-,-1,-1
RECOLL.txt,281949,283754,1805,10,N,N,-,-1,-1
RECOLL.txt,282055,283910,1855,10,N,N,-,-1,-1
RECOLL.txt,282231,284005,1774,10,N,N,-,-1,-1
RECOLL.txt,282343,284105,1762,10,N,N,-,-1,-1
RECOLL.txt,282488,284243,1755,10,N,N,-,-1,-1
RECOLL.txt,282604,284313,1709,10,N,N,-,-1,-1
RECOLL.txt,282858,284404,1546,10,N,N,-,-1,-1
RECOLL.txt,283287,284507,1220,10,N,N,-,-1,-1
RECOLL.txt,283386,284559,1173,10,N,N,-,-1,-1
RECOLL.txt,283665,284599,934,10,N,N,-,-1,-1
RECOLL.txt,283756,284730,974,10,N,N,-,-1,-1
RECOLL.txt,283911,284780,869,10,N,N,-,-1,-1
RECOLL.txt,284006,284832,826,10,N,N,-,-1,-1
RECOLL.txt,284106,284973,867,10,N,N,-,-1,-1
RECOLL.txt,284244,285033,789,10,N,N,-,-1,-1
RECOLL.txt,284314,285140,826,10,N,N,-,-1,-1
RECOLL.txt,284405,285290,885,10,N,N,-,-1,-1
RECOLL.txt,284508,285440,932,10,N,N,-,-1,-1
RECOLL.txt,284560,285511,951,10,N,N,-,-1,-1
RECOLL.txt,284602,285654,1052,10,N,N,-,-1,-1
RECOLL.txt,284732,285785,1053,10,N,N,-,-1,-1
RECOLL.txt,284781,285945,1164,10,N,N,-,-1,-1
RECOLL.txt,284835,286157,1322,10,N,N,-,-1,-1
RECOLL.txt,284974,286293,1319,10,N,N,-,-1,-1
RECOLL.txt,285034,286369,1335,10,N,N,-,-1,-1
RECOLL.txt,285141,286447,1306,10,N,N,-,-1,-1
RECOLL.txt,285291,286599,1308,10,N,N,-,-1,-1
RECOLL.txt,285443,286717,1274,10,N,N,-,-1,-1
RECOLL.txt,285512,286836,1324,10,N,N,-,-1,-1
RECOLL.txt,285655,286913,1258,10,N,N,-,-1,-1
RECOLL.txt,285786,287150,1364,10,N,N,-,-1,-1
RECOLL.txt,285948,287243,1295,10,N,N,-,-1,-1
RECOLL.txt,286158,287377,1219,10,N,N,-,-1,-1
RECOLL.txt,286296,287547,1251,10,N,N,-,-1,-1
RECOLL.txt,286370,287706,1336,10,N,N,-,-1,-1
RECOLL.txt,286448,287873,1425,10,N,N,-,-1,-1
RECOLL.txt,286601,287971,1370,10,N,Y,1448281071558,89330,89524
RECOLL.txt,286718,288065,1347,10,N,Y,1448281071558,89330,89524
RECOLL.txt,286838,288401,1563,10,N,Y,1448281071558,89330,89524
RECOLL.txt,286918,288502,1584,10,N,Y,1448281071558,89330,89524
RECOLL.txt,287151,288666,1515,10,N,Y,1448281071558,89330,89524
RECOLL.txt,287246,288775,1529,10,N,Y,1448281071558,89330,89524
RECOLL.txt,287379,288808,1429,10,N,Y,1448281071558,89330,89524
RECOLL.txt,287548,288887,1339,10,N,Y,1448281071558,89330,89524
RECOLL.txt,287709,289026,1317,10,N,Y,1448281071558,89330,89524
RECOLL.txt,287876,289114,1238,10,N,Y,1448281071558,89330,89524
RECOLL.txt,287972,289214,1242,10,N,Y,1448281071558,89330,89524
RECOLL.txt,288066,289302,1236,10,N,Y,1448281071558,89330,89524
RECOLL.txt,288404,289344,940,10,N,Y,1448311366799,143137,146264
RECOLL.txt,288503,289545,1042,10,N,Y,1448311366799,143137,146264
RECOLL.txt,288669,289617,948,10,N,Y,1448311366799,143137,146264
RECOLL.txt,288776,289677,901,10,N,Y,1448311366799,143137,146264
RECOLL.txt,288809,289725,916,10,N,Y,1448278279697,58861,59444
RECOLL.txt,288890,289858,968,10,N,Y,1448278279697,58861,59444
RECOLL.txt,289027,289944,917,10,N,Y,1448278279697,58861,59444
RECOLL.txt,289115,290031,916,10,N,Y,1448278279697,58861,59444
RECOLL.txt,289215,290133,918,10,N,Y,1448278279697,58861,59444
RECOLL.txt,289303,290245,942,10,N,Y,1448278279697,58861,59444
RECOLL.txt,289345,290372,1027,10,N,Y,1448278279697,58861,59444
RECOLL.txt,289548,290470,922,10,N,Y,1448278279697,58861,59444
RECOLL.txt,289618,290698,1080,10,N,Y,1448278279697,58861,59444
RECOLL.txt,289678,290887,1209,10,N,Y,1448278279697,58861,59444
RECOLL.txt,289726,291034,1308,10,N,Y,1448278279697,58861,59444
RECOLL.txt,289861,291135,1274,10,N,Y,1448278279697,58861,59444
RECOLL.txt,289945,291216,1271,10,N,Y,1448278279697,58861,59444
RECOLL.txt,290032,291306,1274,10,N,Y,1448278279697,58861,59444
RECOLL.txt,290135,291446,1311,10,N,N,-,-1,-1
RECOLL.txt,290248,291478,1230,10,N,N,-,-1,-1
RECOLL.txt,290373,291781,1408,10,N,N,-,-1,-1
RECOLL.txt,290473,291869,1396,10,N,N,-,-1,-1
RECOLL.txt,290703,292033,1330,10,N,N,-,-1,-1
RECOLL.txt,290888,292217,1329,10,N,N,-,-1,-1
RECOLL.txt,291035,292355,1320,10,N,N,-,-1,-1
RECOLL.txt,291138,292455,1317,10,N,N,-,-1,-1
RECOLL.txt,291217,292552,1335,10,N,N,-,-1,-1
RECOLL.txt,291307,292796,1489,10,N,N,-,-1,-1
RECOLL.txt,291448,292829,1381,10,N,N,-,-1,-1
RECOLL.txt,291479,293038,1559,10,N,N,-,-1,-1
RECOLL.txt,291782,293090,1308,10,N,N,-,-1,-1
RECOLL.txt,291872,293187,1315,10,N,N,-,-1,-1
RECOLL.txt,292034,293247,1213,10,N,N,-,-1,-1
RECOLL.txt,292218,293361,1143,10,N,N,-,-1,-1
RECOLL.txt,292356,293537,1181,10,N,N,-,-1,-1
RECOLL.txt,292457,293636,1179,10,N,N,-,-1,-1
RECOLL.txt,292554,293718,1164,10,N,N,-,-1,-1
RECOLL.txt,292797,293939,1142,10,N,N,-,-1,-1
RECOLL.txt,292831,294010,1179,10,N,N,-,-1,-1
RECOLL.txt,293039,294101,1062,10,N,N,-,-1,-1
RECOLL.txt,293093,294334,1241,10,N,Y,1448311811907,157566,161100
RECOLL.txt,293188,294374,1186,10,N,Y,1448311811907,157566,161100
RECOLL.txt,293248,294412,1164,10,N,Y,1448311811907,157566,161100
RECOLL.txt,293363,294601,1238,10,N,Y,1448311811907,157566,161100
RECOLL.txt,293538,294705,1167,10,N,Y,1448311811907,157566,161100
RECOLL.txt,293639,294821,1182,10,N,Y,1448311811907,157566,161100
RECOLL.txt,293719,295013,1294,10,N,Y,1448311811907,157566,161100
RECOLL.txt,293939,295184,1245,10,N,Y,1448311811907,157566,161100
RECOLL.txt,294011,295239,1228,10,N,Y,1448311811907,157566,161100
RECOLL.txt,294102,295452,1350,10,N,Y,1448311811907,157566,161100
RECOLL.txt,294335,295587,1252,10,N,Y,1448311811907,157566,161100
RECOLL.txt,294375,295686,1311,10,N,Y,1448311811907,157566,161100
RECOLL.txt,294413,295705,1292,10,N,Y,1448311811907,157566,161100
RECOLL.txt,294606,295840,1234,10,N,Y,1448311811907,157566,161100
RECOLL.txt,294706,295901,1195,10,N,Y,1448276340407,30017,39003
RECOLL.txt,294822,296042,1220,10,N,Y,1448276340407,30017,39003
RECOLL.txt,295014,296118,1104,10,N,Y,1448276340407,30017,39003
RECOLL.txt,295187,296191,1004,10,N,Y,1448276340407,30017,39003
RECOLL.txt,295240,296263,1023,10,N,Y,1448276340407,30017,39003
RECOLL.txt,295455,296340,885,10,N,Y,1448276340407,30017,39003
RECOLL.txt,295588,296373,785,10,N,Y,1448276340407,30017,39003
RECOLL.txt,295688,296457,769,10,N,Y,1448276340407,30017,39003
RECOLL.txt,295706,296624,918,10,N,Y,1448276340407,30017,39003
RECOLL.txt,295841,296769,928,10,N,Y,1448276340407,30017,39003
RECOLL.txt,295902,296899,997,10,N,Y,1448276340407,30017,39003
RECOLL.txt,296043,297098,1055,10,N,Y,1448276340407,30017,39003
RECOLL.txt,296121,297143,1022,10,N,Y,1448276340407,30017,39003
RECOLL.txt,296192,297273,1081,10,N,Y,1448276340407,30017,39003
RECOLL.txt,296264,297385,1121,10,N,Y,1448276340407,30017,39003
RECOLL.txt,296341,297449,1108,10,N,Y,1437477480340,424837,425856
RECOLL.txt,296374,297634,1260,10,N,Y,1437477480340,424837,425856
RECOLL.txt,296460,297694,1234,10,N,Y,1437477480340,424837,425856
RECOLL.txt,296627,297775,1148,10,N,Y,1437477480340,424837,425856
RECOLL.txt,296771,297912,1141,10,N,Y,1437477480340,424837,425856
RECOLL.txt,296900,298073,1173,10,N,Y,1437477480340,424837,425856
RECOLL.txt,297101,298115,1014,10,N,Y,1437477480340,424837,425856
RECOLL.txt,297148,298184,1036,10,N,Y,1437477480340,424837,425856
RECOLL.txt,297274,298233,959,10,N,Y,1437477480340,424837,425856
RECOLL.txt,297388,298377,989,10,N,Y,1437477480340,424837,425856
RECOLL.txt,297450,298546,1096,10,N,Y,1437477480340,424837,425856
RECOLL.txt,297635,298790,1155,10,N,Y,1437477480340,424837,425856
RECOLL.txt,297695,298867,1172,10,N,Y,1437477480340,424837,425856
RECOLL.txt,297776,299039,1263,10,N,Y,1437477480340,424837,425856
RECOLL.txt,297915,299099,1184,10,N,Y,1437477480340,424837,425856
RECOLL.txt,298074,299178,1104,10,N,N,-,-1,-1
RECOLL.txt,298116,299295,1179,10,N,N,-,-1,-1
RECOLL.txt,298186,299333,1147,10,N,N,-,-1,-1
RECOLL.txt,298236,299581,1345,10,N,N,-,-1,-1
RECOLL.txt,298378,299640,1262,10,Y,N,-,-1,-1
RECOLL.txt,298547,299712,1165,10,N,N,-,-1,-1
RECOLL.txt,298791,299890,1099,10,N,N,-,-1,-1
RECOLL.txt,298870,299945,1075,10,N,N,-,-1,-1
RECOLL.txt,299040,300134,1094,10,N,N,-,-1,-1
RECOLL.txt,299100,300191,1091,10,N,N,-,-1,-1
RECOLL.txt,299179,300454,1275,10,N,Y,1448279089520,67624,69991
RECOLL.txt,299296,300542,1246,10,N,Y,1448279089520,67624,69991
RECOLL.txt,299336,300678,1342,10,N,Y,1448279089520,67624,69991
RECOLL.txt,299582,300969,1387,10,N,Y,1448279089520,67624,69991
RECOLL.txt,299641,301151,1510,10,N,Y,1448279089520,67624,69991
RECOLL.txt,299713,301230,1517,10,N,Y,1448279089520,67624,69991
RECOLL.txt,299893,301303,1410,10,N,Y,1448279089520,67624,69991
RECOLL.txt,299946,301385,1439,10,N,Y,1448279089520,67624,69991
RECOLL.txt,300135,301466,1331,10,N,Y,1448279089520,67624,69991
RECOLL.txt,300194,301560,1366,10,N,Y,1448279089520,67624,69991
RECOLL.txt,300455,301696,1241,10,N,Y,1448279089520,67624,69991
RECOLL.txt,300543,301856,1313,10,N,Y,1448279089520,67624,69991
RECOLL.txt,300679,302076,1397,10,N,Y,1448279089520,67624,69991
RECOLL.txt,300971,302205,1234,10,N,Y,1448279089520,67624,69991
RECOLL.txt,301153,302413,1260,10,N,Y,1448279089520,67624,69991
RECOLL.txt,301235,302651,1416,10,N,Y,1448279089520,67624,69991
RECOLL.txt,301304,302809,1505,10,N,Y,1448279089520,67624,69991
RECOLL.txt,301386,302940,1554,10,N,Y,1448279089520,67624,69991
RECOLL.txt,301467,303020,1553,10,N,Y,1448279089520,67624,69991
RECOLL.txt,301561,303275,1714,10,N,Y,1448279089520,67624,69991
RECOLL.txt,301699,303295,1596,10,N,N,-,-1,-1
RECOLL.txt,301857,303340,1483,10,N,N,-,-1,-1
RECOLL.txt,302077,303374,1297,10,N,N,-,-1,-1
RECOLL.txt,302208,303388,1180,10,N,N,-,-1,-1
RECOLL.txt,302414,303452,1038,10,N,N,-,-1,-1
RECOLL.txt,302652,303626,974,10,N,N,-,-1,-1
RECOLL.txt,302812,303752,940,10,N,N,-,-1,-1
RECOLL.txt,302941,304057,1116,10,N,N,-,-1,-1
RECOLL.txt,303021,304261,1240,10,N,N,-,-1,-1
RECOLL.txt,303276,304346,1070,10,N,N,-,-1,-1
RECOLL.txt,303296,304487,1191,10,N,N,-,-1,-1
RECOLL.txt,303341,304649,1308,10,N,N,-,-1,-1
RECOLL.txt,303376,304767,1391,10,N,N,-,-1,-1
RECOLL.txt,303389,304843,1454,10,N,N,-,-1,-1
RECOLL.txt,303455,305043,1588,10,N,N,-,-1,-1
RECOLL.txt,303627,305125,1498,10,N,N,-,-1,-1
RECOLL.txt,303757,305237,1480,10,N,N,-,-1,-1
RECOLL.txt,304060,305463,1403,10,N,N,-,-1,-1
RECOLL.txt,304262,305548,1286,10,N,N,-,-1,-1
RECOLL.txt,304347,305764,1417,10,N,N,-,-1,-1
RECOLL.txt,304490,305994,1504,10,N,N,-,-1,-1
RECOLL.txt,304650,306085,1435,10,N,N,-,-1,-1
RECOLL.txt,304768,306255,1487,10,Y,N,-,-1,-1
RECOLL.txt,304846,306420,1574,10,Y,N,-,-1,-1
RECOLL.txt,305044,306503,1459,10,Y,N,-,-1,-1
RECOLL.txt,305126,306576,1450,10,N,N,-,-1,-1
RECOLL.txt,305238,306642,1404,10,N,N,-,-1,-1
RECOLL.txt,305464,306825,1361,10,N,N,-,-1,-1
RECOLL.txt,305551,306943,1392,10,N,N,-,-1,-1
RECOLL.txt,305765,307002,1237,10,N,N,-,-1,-1
RECOLL.txt,305995,307413,1418,10,N,Y,1448039533036,21326,21680
RECOLL.txt,306086,307511,1425,10,N,Y,1448039533036,21326,21680
RECOLL.txt,306260,307632,1372,10,N,Y,1448039533036,21326,21680
RECOLL.txt,306421,307749,1328,10,N,Y,1448039533036,21326,21680
RECOLL.txt,306504,307824,1320,10,N,Y,1448039533036,21326,21680
RECOLL.txt,306577,307920,1343,10,N,Y,1448039533036,21326,21680
RECOLL.txt,306645,308039,1394,10,N,Y,1448039533036,21326,21680
RECOLL.txt,306826,308099,1273,10,N,Y,1448039533036,21326,21680
RECOLL.txt,306944,308232,1288,10,N,Y,1448039533036,21326,21680
RECOLL.txt,307003,308385,1382,10,N,Y,1448039533036,21326,21680
RECOLL.txt,307414,308539,1125,10,N,Y,1448039533036,21326,21680
RECOLL.txt,307512,308848,1336,10,N,Y,1448039533036,21326,21680
RECOLL.txt,307635,308948,1313,10,N,Y,1448039533036,21326,21680
RECOLL.txt,307750,309078,1328,10,N,Y,1448039533036,21326,21680
RECOLL.txt,307825,309189,1364,10,N,Y,1448039533036,21326,21680
RECOLL.txt,307921,309249,1328,10,N,Y,1448039533036,21326,21680
RECOLL.txt,308041,309373,1332,10,N,Y,1448039533036,21326,21680
RECOLL.txt,308102,309482,1380,10,N,Y,1448039533036,21326,21680
RECOLL.txt,308233,309657,1424,10,N,Y,1448039533036,21326,21680
RECOLL.txt,308386,309701,1315,10,N,Y,1448039533036,21326,21680
RECOLL.txt,308540,309838,1298,10,N,Y,1448039533036,21326,21680
RECOLL.txt,308849,310084,1235,10,N,Y,1448039533036,21326,21680
RECOLL.txt,308949,310128,1179,10,N,Y,1448039533036,21326,21680
RECOLL.txt,309079,310190,1111,10,N,Y,1448039533036,21326,21680
RECOLL.txt,309192,310210,1018,10,N,Y,1448039533036,21326,21680
RECOLL.txt,309250,310400,1150,10,N,Y,1448039533036,21326,21680
RECOLL.txt,309375,310508,1133,10,N,Y,1448039533036,21326,21680
RECOLL.txt,309485,310656,1171,10,N,Y,1448322397200,219547,220107
RECOLL.txt,309658,310728,1070,10,N,Y,1448322397200,219547,220107
RECOLL.txt,309702,310829,1127,10,N,Y,1448322397200,219547,220107
RECOLL.txt,309839,310881,1042,10,N,Y,1448322397200,219547,220107
RECOLL.txt,310085,311166,1081,10,N,Y,1448322397200,219547,220107
RECOLL.txt,310129,311183,1054,10,N,Y,1448322397200,219547,220107
RECOLL.txt,310191,311364,1173,10,N,Y,1448322397200,219547,220107
RECOLL.txt,310212,311419,1207,10,N,Y,1448322397200,219547,220107
RECOLL.txt,310401,311512,1111,10,N,Y,1448322397200,219547,220107
RECOLL.txt,310509,311583,1074,10,N,Y,1448322397200,219547,220107
RECOLL.txt,310657,311726,1069,10,N,Y,1448322397200,219547,220107
RECOLL.txt,310729,311897,1168,10,N,Y,1448322397200,219547,220107
RECOLL.txt,310830,311997,1167,10,N,Y,1448322397200,219547,220107
RECOLL.txt,310882,312163,1281,10,N,Y,1448322397200,219547,220107
RECOLL.txt,311167,312218,1051,10,N,Y,1448322397200,219547,220107
RECOLL.txt,311184,312299,1115,10,N,Y,1448322397200,219547,220107
RECOLL.txt,311366,312478,1112,10,N,Y,1448322397200,219547,220107
RECOLL.txt,311420,312704,1284,10,N,Y,1448322397200,219547,220107
RECOLL.txt,311515,312850,1335,10,N,N,-,-1,-1
RECOLL.txt,311586,313006,1420,10,N,N,-,-1,-1
RECOLL.txt,311728,313065,1337,10,N,N,-,-1,-1
RECOLL.txt,311898,313198,1300,10,N,N,-,-1,-1
RECOLL.txt,312000,313265,1265,10,N,N,-,-1,-1
RECOLL.txt,312164,313455,1291,10,N,N,-,-1,-1
RECOLL.txt,312219,313663,1444,10,N,N,-,-1,-1
RECOLL.txt,312300,313696,1396,10,N,N,-,-1,-1
RECOLL.txt,312479,313835,1356,10,N,N,-,-1,-1
RECOLL.txt,312705,314079,1374,10,N,N,-,-1,-1
RECOLL.txt,312851,314249,1398,10,N,N,-,-1,-1
RECOLL.txt,313008,314366,1358,10,N,N,-,-1,-1
RECOLL.txt,313068,314425,1357,10,N,N,-,-1,-1
RECOLL.txt,313199,314573,1374,10,N,N,-,-1,-1
RECOLL.txt,313266,314605,1339,10,N,N,-,-1,-1
RECOLL.txt,313456,314705,1249,10,N,N,-,-1,-1
RECOLL.txt,313664,314797,1133,10,N,N,-,-1,-1
RECOLL.txt,313697,314924,1227,10,N,N,-,-1,-1
RECOLL.txt,313838,314970,1132,10,N,N,-,-1,-1
RECOLL.txt,314080,315287,1207,10,N,N,-,-1,-1
RECOLL.txt,314251,315328,1077,10,N,N,-,-1,-1
RECOLL.txt,314367,315556,1189,10,N,N,-,-1,-1
RECOLL.txt,314428,315677,1249,10,N,N,-,-1,-1
RECOLL.txt,314574,315904,1330,10,N,N,-,-1,-1
RECOLL.txt,314606,315953,1347,10,N,N,-,-1,-1
RECOLL.txt,314706,316237,1531,10,N,Y,1448316586529,210063,210674
RECOLL.txt,314800,316422,1622,10,N,Y,1448316586529,210063,210674
RECOLL.txt,314925,316541,1616,10,N,Y,1448316586529,210063,210674
RECOLL.txt,314975,316616,1641,10,N,Y,1448316586529,210063,210674
RECOLL.txt,315288,316747,1459,10,N,Y,1448316586529,210063,210674
RECOLL.txt,315331,316800,1469,10,N,Y,1448316586529,210063,210674
RECOLL.txt,315558,316886,1328,10,N,Y,1448316586529,210063,210674
RECOLL.txt,315678,316996,1318,10,N,Y,1448316586529,210063,210674
RECOLL.txt,315905,317207,1302,10,N,Y,1448316586529,210063,210674
RECOLL.txt,315956,317277,1321,10,N,Y,1448316586529,210063,210674
RECOLL.txt,316238,317441,1203,10,N,Y,1448316586529,210063,210674
RECOLL.txt,316423,317479,1056,10,N,Y,1448316586529,210063,210674
RECOLL.txt,316542,317523,981,10,N,Y,1448316586529,210063,210674
RECOLL.txt,316619,317561,942,10,N,Y,1448316586529,210063,210674
RECOLL.txt,316748,317763,1015,10,N,N,-,-1,-1
RECOLL.txt,316803,317843,1040,10,N,N,-,-1,-1
RECOLL.txt,316887,317961,1074,10,N,N,-,-1,-1
RECOLL.txt,316997,318066,1069,10,N,N,-,-1,-1
RECOLL.txt,317209,318353,1144,10,N,N,-,-1,-1
RECOLL.txt,317278,318407,1129,10,N,N,-,-1,-1
RECOLL.txt,317442,318587,1145,10,N,N,-,-1,-1
RECOLL.txt,317482,318790,1308,10,N,N,-,-1,-1
RECOLL.txt,317525,318882,1357,10,N,N,-,-1,-1
RECOLL.txt,317562,319190,1628,10,N,N,-,-1,-1
RECOLL.txt,317764,319477,1713,10,N,N,-,-1,-1
RECOLL.txt,317844,319527,1683,10,N,N,-,-1,-1
RECOLL.txt,317962,319718,1756,10,N,N,-,-1,-1
RECOLL.txt,318067,319790,1723,10,N,Y,1448274893770,25386,26202
RECOLL.txt,318354,319929,1575,10,N,Y,1448274893770,25386,26202
RECOLL.txt,318408,320308,1900,10,N,Y,1448274893770,25386,26202
RECOLL.txt,318588,320330,1742,10,N,Y,1448274893770,25386,26202
RECOLL.txt,318792,320695,1903,10,N,Y,1448274893770,25386,26202
RECOLL.txt,318887,320870,1983,10,N,Y,1448274893770,25386,26202
RECOLL.txt,319192,320916,1724,10,N,Y,1448274893770,25386,26202
RECOLL.txt,319478,321181,1703,10,N,Y,1448274893770,25386,26202
RECOLL.txt,319528,321257,1729,10,N,Y,1448274893770,25386,26202
RECOLL.txt,319721,321337,1616,10,N,Y,1448274893770,25386,26202
RECOLL.txt,319791,321624,1833,10,N,Y,1448274893770,25386,26202
RECOLL.txt,319930,321780,1850,10,N,Y,1448274893770,25386,26202
RECOLL.txt,320309,321966,1657,10,N,Y,1448274893770,25386,26202
RECOLL.txt,320331,322091,1760,10,N,Y,1448274893770,25386,26202
RECOLL.txt,320696,322294,1598,10,N,Y,1448274893770,25386,26202
RECOLL.txt,320871,322359,1488,10,N,Y,1448274893770,25386,26202
RECOLL.txt,320921,322492,1571,10,N,N,-,-1,-1
RECOLL.txt,321184,322636,1452,10,N,N,-,-1,-1
RECOLL.txt,321258,322794,1536,10,N,N,-,-1,-1
RECOLL.txt,321338,322959,1621,10,N,N,-,-1,-1
RECOLL.txt,321625,323109,1484,10,N,N,-,-1,-1
RECOLL.txt,321781,323254,1473,10,N,N,-,-1,-1
RECOLL.txt,321967,323374,1407,10,N,N,-,-1,-1
RECOLL.txt,322094,323415,1321,10,N,N,-,-1,-1
RECOLL.txt,322295,323530,1235,10,N,N,-,-1,-1
RECOLL.txt,322360,323653,1293,10,N,N,-,-1,-1
RECOLL.txt,322495,323813,1318,10,N,N,-,-1,-1
RECOLL.txt,322637,323973,1336,10,N,N,-,-1,-1
RECOLL.txt,322795,324125,1330,10,N,N,-,-1,-1
RECOLL.txt,322960,324332,1372,10,N,N,-,-1,-1
RECOLL.txt,323112,324615,1503,10,N,N,-,-1,-1
RECOLL.txt,323255,324770,1515,10,N,N,-,-1,-1
RECOLL.txt,323375,324890,1515,10,N,N,-,-1,-1
RECOLL.txt,323416,325134,1718,10,Y,N,-,-1,-1
RECOLL.txt,323533,325240,1707,10,Y,N,-,-1,-1
RECOLL.txt,323656,325431,1775,10,N,N,-,-1,-1
RECOLL.txt,323814,325552,1738,10,N,N,-,-1,-1
RECOLL.txt,323974,325628,1654,10,N,N,-,-1,-1
RECOLL.txt,324128,325855,1727,10,N,N,-,-1,-1
RECOLL.txt,324333,325982,1649,10,N,N,-,-1,-1
RECOLL.txt,324618,326086,1468,10,N,N,-,-1,-1
RECOLL.txt,324771,326189,1418,10,N,N,-,-1,-1
RECOLL.txt,324891,326278,1387,10,N,N,-,-1,-1
RECOLL.txt,325135,326408,1273,10,N,N,-,-1,-1
RECOLL.txt,325243,326554,1311,10,N,N,-,-1,-1
RECOLL.txt,325433,326683,1250,10,N,N,-,-1,-1
RECOLL.txt,325553,326947,1394,10,N,N,-,-1,-1
RECOLL.txt,325631,327038,1407,10,N,N,-,-1,-1
RECOLL.txt,325858,327434,1576,10,N,N,-,-1,-1
RECOLL.txt,325984,327735,1751,10,N,N,-,-1,-1
RECOLL.txt,326087,327836,1749,10,N,N,-,-1,-1
RECOLL.txt,326190,327869,1679,10,N,N,-,-1,-1
RECOLL.txt,326281,327957,1676,10,N,N,-,-1,-1
RECOLL.txt,326409,328018,1609,10,N,N,-,-1,-1
RECOLL.txt,326555,328101,1546,10,N,N,-,-1,-1
RECOLL.txt,326684,328178,1494,10,N,N,-,-1,-1
RECOLL.txt,326950,328252,1302,10,N,N,-,-1,-1
RECOLL.txt,327039,328462,1423,10,N,N,-,-1,-1
RECOLL.txt,327437,328723,1286,10,N,N,-,-1,-1
RECOLL.txt,327736,328852,1116,10,N,N,-,-1,-1
RECOLL.txt,327837,329046,1209,10,N,N,-,-1,-1
RECOLL.txt,327869,329885,2016,10,N,N,-,-1,-1
RECOLL.txt,327958,330234,2276,10,N,N,-,-1,-1
RECOLL.txt,328019,330403,2384,10,N,N,-,-1,-1
RECOLL.txt,328102,330537,2435,10,N,N,-,-1,-1
RECOLL.txt,328179,330949,2770,10,N,N,-,-1,-1
RECOLL.txt,328257,331063,2806,10,N,N,-,-1,-1
RECOLL.txt,328463,331303,2840,10,N,N,-,-1,-1
RECOLL.txt,328724,331435,2711,10,N,N,-,-1,-1
RECOLL.txt,328853,331649,2796,10,N,N,-,-1,-1
RECOLL.txt,329047,331792,2745,10,N,N,-,-1,-1
RECOLL.txt,329888,331908,2020,10,N,N,-,-1,-1
RECOLL.txt,330239,331984,1745,10,N,N,-,-1,-1
RECOLL.txt,330404,332130,1726,10,N,N,-,-1,-1
RECOLL.txt,330540,332182,1642,10,N,N,-,-1,-1
RECOLL.txt,330950,332257,1307,10,N,N,-,-1,-1
RECOLL.txt,331066,332412,1346,10,N,N,-,-1,-1
RECOLL.txt,331304,332686,1382,10,N,N,-,-1,-1
RECOLL.txt,331437,332764,1327,10,N,N,-,-1,-1
RECOLL.txt,331652,332830,1178,10,N,N,-,-1,-1
RECOLL.txt,331794,332937,1143,10,N,N,-,-1,-1
RECOLL.txt,331909,333019,1110,10,N,N,-,-1,-1
RECOLL.txt,331986,333160,1174,10,N,N,-,-1,-1
RECOLL.txt,332132,333202,1070,10,N,N,-,-1,-1
RECOLL.txt,332183,333329,1146,10,N,N,-,-1,-1
RECOLL.txt,332260,333524,1264,10,N,N,-,-1,-1
RECOLL.txt,332413,333704,1291,10,N,N,-,-1,-1
RECOLL.txt,332687,333796,1109,10,N,N,-,-1,-1
RECOLL.txt,332767,334095,1328,10,N,N,-,-1,-1
RECOLL.txt,332831,334194,1363,10,N,N,-,-1,-1
RECOLL.txt,332938,334244,1306,10,N,N,-,-1,-1
RECOLL.txt,333020,334451,1431,10,N,N,-,-1,-1
RECOLL.txt,333161,334526,1365,10,N,N,-,-1,-1
RECOLL.txt,333205,334677,1472,10,N,N,-,-1,-1
RECOLL.txt,333330,334908,1578,10,N,N,-,-1,-1
RECOLL.txt,333525,335280,1755,10,N,N,-,-1,-1
RECOLL.txt,333705,335500,1795,10,N,N,-,-1,-1
RECOLL.txt,333801,335615,1814,10,N,N,-,-1,-1
RECOLL.txt,334096,335738,1642,10,N,N,-,-1,-1
RECOLL.txt,334195,335817,1622,10,N,N,-,-1,-1
RECOLL.txt,334245,335906,1661,10,N,N,-,-1,-1
RECOLL.txt,334454,336158,1704,10,N,N,-,-1,-1
RECOLL.txt,334527,336221,1694,10,N,N,-,-1,-1
RECOLL.txt,334678,336489,1811,10,N,N,-,-1,-1
RECOLL.txt,334911,336706,1795,10,N,N,-,-1,-1
RECOLL.txt,335285,336899,1614,10,N,N,-,-1,-1
RECOLL.txt,335503,336976,1473,10,N,N,-,-1,-1
RECOLL.txt,335616,337064,1448,10,N,N,-,-1,-1
RECOLL.txt,335739,337186,1447,10,N,N,-,-1,-1
RECOLL.txt,335819,337409,1590,10,N,N,-,-1,-1
RECOLL.txt,335909,337493,1584,10,N,N,-,-1,-1
RECOLL.txt,336159,337654,1495,10,N,N,-,-1,-1
RECOLL.txt,336222,337888,1666,10,Y,N,-,-1,-1
RECOLL.txt,336492,337940,1448,10,Y,N,-,-1,-1
RECOLL.txt,336708,338156,1448,10,Y,N,-,-1,-1
RECOLL.txt,336900,338339,1439,10,Y,N,-,-1,-1
RECOLL.txt,336977,338555,1578,10,Y,N,-,-1,-1
RECOLL.txt,337067,338686,1619,10,Y,N,-,-1,-1
RECOLL.txt,337187,338869,1682,10,Y,N,-,-1,-1
RECOLL.txt,337410,339101,1691,10,Y,N,-,-1,-1
RECOLL.txt,337498,339207,1709,10,Y,N,-,-1,-1
RECOLL.txt,337655,339315,1660,10,Y,N,-,-1,-1
RECOLL.txt,337889,339344,1455,10,N,N,-,-1,-1
RECOLL.txt,337942,339513,1571,10,N,N,-,-1,-1
RECOLL.txt,338157,339712,1555,10,N,N,-,-1,-1
RECOLL.txt,338342,339727,1385,10,N,N,-,-1,-1
RECOLL.txt,338556,339746,1190,10,N,N,-,-1,-1
REMKEL1.txt,3,784,781,10,N,N,-,-1,-1
REMKEL1.txt,172,846,674,10,N,N,-,-1,-1
REMKEL1.txt,297,910,613,10,N,N,-,-1,-1
REMKEL1.txt,298,927,629,10,N,N,-,-1,-1
REMKEL1.txt,346,1140,794,10,N,N,-,-1,-1
REMKEL1.txt,361,1581,1220,10,N,N,-,-1,-1
REMKEL1.txt,397,1623,1226,10,N,N,-,-1,-1
REMKEL1.txt,409,1661,1252,10,N,N,-,-1,-1
REMKEL1.txt,710,1729,1019,10,N,N,-,-1,-1
REMKEL1.txt,763,1780,1017,10,N,N,-,-1,-1
REMKEL1.txt,785,1808,1023,10,N,N,-,-1,-1
REMKEL1.txt,851,1856,1005,10,N,N,-,-1,-1
REMKEL1.txt,915,1910,995,10,N,N,-,-1,-1
REMKEL1.txt,932,1968,1036,10,N,N,-,-1,-1
REMKEL1.txt,1143,2021,878,10,N,N,-,-1,-1
REMKEL1.txt,1586,2047,461,10,N,N,-,-1,-1
REMKEL1.txt,1628,2086,458,10,N,N,-,-1,-1
REMKEL1.txt,1662,2142,480,10,N,N,-,-1,-1
REMKEL1.txt,1730,2191,461,10,N,N,-,-1,-1
REMKEL1.txt,1781,2237,456,10,N,N,-,-1,-1
REMKEL1.txt,1809,2256,447,10,N,N,-,-1,-1
REMKEL1.txt,1857,2287,430,10,N,N,-,-1,-1
REMKEL1.txt,1911,2314,403,10,N,N,-,-1,-1
REMKEL1.txt,1969,2349,380,10,N,N,-,-1,-1
REMKEL1.txt,2022,2366,344,10,N,N,-,-1,-1
REMKEL1.txt,2048,2436,388,10,N,N,-,-1,-1
REMKEL1.txt,2087,2456,369,10,N,N,-,-1,-1
REMKEL1.txt,2145,2498,353,10,N,N,-,-1,-1
REMKEL1.txt,2192,2510,318,10,N,N,-,-1,-1
REMKEL1.txt,2238,2545,307,10,N,N,-,-1,-1
REMKEL1.txt,2258,2579,321,10,N,N,-,-1,-1
REMKEL1.txt,2288,2636,348,10,N,N,-,-1,-1
REMKEL1.txt,2315,2653,338,10,N,N,-,-1,-1
REMKEL1.txt,2351,2668,317,10,N,N,-,-1,-1
REMKEL1.txt,2367,2686,319,10,N,N,-,-1,-1
REMKEL1.txt,2437,2772,335,10,N,N,-,-1,-1
REMKEL1.txt,2457,2832,375,10,N,N,-,-1,-1
REMKEL1.txt,2500,2968,468,10,N,N,-,-1,-1
REMKEL1.txt,2511,3020,509,10,N,N,-,-1,-1
REMKEL1.txt,2548,3060,512,10,N,N,-,-1,-1
REMKEL1.txt,2582,3094,512,10,N,N,-,-1,-1
REMKEL1.txt,2638,3152,514,10,N,N,-,-1,-1
REMKEL1.txt,2654,3178,524,10,N,N,-,-1,-1
REMKEL1.txt,2669,3236,567,10,N,N,-,-1,-1
REMKEL1.txt,2688,3284,596,10,N,N,-,-1,-1
REMKEL1.txt,2773,3326,553,10,N,N,-,-1,-1
REMKEL1.txt,2833,3380,547,10,N,N,-,-1,-1
REMKEL1.txt,2969,3415,446,10,N,N,-,-1,-1
REMKEL1.txt,3021,3506,485,10,N,N,-,-1,-1
REMKEL1.txt,3061,3606,545,10,N,N,-,-1,-1
REMKEL1.txt,3096,3682,586,10,N,N,-,-1,-1
REMKEL1.txt,3153,3782,629,10,N,N,-,-1,-1
REMKEL1.txt,3179,3794,615,10,N,N,-,-1,-1
REMKEL1.txt,3237,3811,574,10,N,N,-,-1,-1
REMKEL1.txt,3285,3829,544,10,N,N,-,-1,-1
REMKEL1.txt,3327,3877,550,10,N,N,-,-1,-1
REMKEL1.txt,3381,3898,517,10,N,N,-,-1,-1
REMKEL1.txt,3416,3932,516,10,N,N,-,-1,-1
REMKEL1.txt,3508,3946,438,10,N,N,-,-1,-1
REMKEL1.txt,3608,4018,410,10,N,N,-,-1,-1
REMKEL1.txt,3683,4031,348,10,N,N,-,-1,-1
REMKEL1.txt,3784,4090,306,10,N,N,-,-1,-1
REMKEL1.txt,3795,4125,330,10,N,N,-,-1,-1
REMKEL1.txt,3812,4207,395,10,N,N,-,-1,-1
REMKEL1.txt,3831,4253,422,10,N,N,-,-1,-1
REMKEL1.txt,3878,4306,428,10,N,N,-,-1,-1
REMKEL1.txt,3899,4387,488,10,N,N,-,-1,-1
REMKEL1.txt,3937,4467,530,10,N,N,-,-1,-1
REMKEL1.txt,3947,4475,528,10,N,N,-,-1,-1
REMKEL1.txt,4019,4499,480,10,N,N,-,-1,-1
REMKEL1.txt,4032,4532,500,10,N,N,-,-1,-1
REMKEL1.txt,4091,4571,480,10,N,N,-,-1,-1
REMKEL1.txt,4126,4621,495,10,N,N,-,-1,-1
REMKEL1.txt,4210,4706,496,10,N,N,-,-1,-1
REMKEL1.txt,4254,4726,472,10,N,N,-,-1,-1
REMKEL1.txt,4307,4743,436,10,N,N,-,-1,-1
REMKEL1.txt,4388,4795,407,10,N,N,-,-1,-1
REMKEL1.txt,4469,4813,344,10,N,N,-,-1,-1
REMKEL1.txt,4476,4881,405,10,N,N,-,-1,-1
REMKEL1.txt,4500,4890,390,10,N,N,-,-1,-1
REMKEL1.txt,4533,4902,369,10,N,N,-,-1,-1
REMKEL1.txt,4573,4937,364,10,N,N,-,-1,-1
REMKEL1.txt,4623,4964,341,10,N,N,-,-1,-1
REMKEL1.txt,4707,4987,280,10,N,N,-,-1,-1
REMKEL1.txt,4727,5019,292,10,N,N,-,-1,-1
REMKEL1.txt,4744,5098,354,10,N,N,-,-1,-1
REMKEL1.txt,4796,5139,343,10,N,N,-,-1,-1
REMKEL1.txt,4814,5146,332,10,N,N,-,-1,-1
REMKEL1.txt,4882,5152,270,10,N,N,-,-1,-1
REMKEL1.txt,4891,5190,299,10,N,N,-,-1,-1
REMKEL1.txt,4903,5241,338,10,N,N,-,-1,-1
REMKEL1.txt,4938,5279,341,10,N,N,-,-1,-1
REMKEL1.txt,4965,5290,325,10,N,N,-,-1,-1
REMKEL1.txt,4988,5339,351,10,N,N,-,-1,-1
REMKEL1.txt,5021,5414,393,10,N,N,-,-1,-1
REMKEL1.txt,5099,5510,411,10,N,N,-,-1,-1
REMKEL1.txt,5140,5530,390,10,N,N,-,-1,-1
REMKEL1.txt,5147,5569,422,10,N,N,-,-1,-1
REMKEL1.txt,5153,5644,491,10,N,N,-,-1,-1
REMKEL1.txt,5191,5703,512,10,N,N,-,-1,-1
REMKEL1.txt,5242,5744,502,10,N,N,-,-1,-1
REMKEL1.txt,5282,5807,525,10,N,N,-,-1,-1
REMKEL1.txt,5291,5839,548,10,N,N,-,-1,-1
REMKEL1.txt,5340,5900,560,10,N,N,-,-1,-1
REMKEL1.txt,5415,5915,500,10,N,N,-,-1,-1
REMKEL1.txt,5511,5935,424,10,N,N,-,-1,-1
REMKEL1.txt,5532,5999,467,10,N,N,-,-1,-1
REMKEL1.txt,5570,6019,449,10,N,N,-,-1,-1
REMKEL1.txt,5645,6098,453,10,N,N,-,-1,-1
REMKEL1.txt,5704,6107,403,10,N,N,-,-1,-1
REMKEL1.txt,5745,6128,383,10,N,N,-,-1,-1
REMKEL1.txt,5808,6244,436,10,N,N,-,-1,-1
REMKEL1.txt,5840,6264,424,10,N,N,-,-1,-1
REMKEL1.txt,5901,6295,394,10,N,N,-,-1,-1
REMKEL1.txt,5916,6335,419,10,N,N,-,-1,-1
REMKEL1.txt,5936,6417,481,10,N,N,-,-1,-1
REMKEL1.txt,6000,6451,451,10,N,N,-,-1,-1
REMKEL1.txt,6020,6467,447,10,N,N,-,-1,-1
REMKEL1.txt,6099,6493,394,10,N,N,-,-1,-1
REMKEL1.txt,6108,6529,421,10,N,N,-,-1,-1
REMKEL1.txt,6131,6569,438,10,N,N,-,-1,-1
REMKEL1.txt,6246,6596,350,10,N,N,-,-1,-1
REMKEL1.txt,6265,6683,418,10,N,N,-,-1,-1
REMKEL1.txt,6297,6701,404,10,N,N,-,-1,-1
REMKEL1.txt,6336,6741,405,10,N,N,-,-1,-1
REMKEL1.txt,6418,6791,373,10,N,N,-,-1,-1
REMKEL1.txt,6452,6830,378,10,N,N,-,-1,-1
REMKEL1.txt,6468,6872,404,10,N,N,-,-1,-1
REMKEL1.txt,6495,6902,407,10,N,N,-,-1,-1
REMKEL1.txt,6530,6921,391,10,N,N,-,-1,-1
REMKEL1.txt,6570,6943,373,10,N,N,-,-1,-1
REMKEL1.txt,6597,6957,360,10,N,N,-,-1,-1
REMKEL1.txt,6684,6964,280,10,N,N,-,-1,-1
REMKEL1.txt,6703,7029,326,10,N,N,-,-1,-1
REMKEL1.txt,6742,7090,348,10,N,N,-,-1,-1
REMKEL1.txt,6792,7122,330,10,N,N,-,-1,-1
REMKEL1.txt,6831,7138,307,10,N,N,-,-1,-1
REMKEL1.txt,6873,7209,336,10,N,N,-,-1,-1
REMKEL1.txt,6904,7237,333,10,N,N,-,-1,-1
REMKEL1.txt,6922,7299,377,10,N,N,-,-1,-1
REMKEL1.txt,6944,7328,384,10,N,N,-,-1,-1
REMKEL1.txt,6958,7374,416,10,N,N,-,-1,-1
REMKEL1.txt,6965,7460,495,10,N,N,-,-1,-1
REMKEL1.txt,7030,7484,454,10,N,N,-,-1,-1
REMKEL1.txt,7091,7539,448,10,N,N,-,-1,-1
REMKEL1.txt,7123,7572,449,10,N,N,-,-1,-1
REMKEL1.txt,7141,7686,545,10,N,N,-,-1,-1
REMKEL1.txt,7211,7707,496,10,N,N,-,-1,-1
REMKEL1.txt,7238,7709,471,10,N,N,-,-1,-1
REMKEL1.txt,7300,7798,498,10,N,N,-,-1,-1
REMKEL1.txt,7329,7836,507,10,N,N,-,-1,-1
REMKEL1.txt,7375,7891,516,10,N,N,-,-1,-1
REMKEL1.txt,7461,7918,457,10,N,N,-,-1,-1
REMKEL1.txt,7485,7927,442,10,N,N,-,-1,-1
REMKEL1.txt,7540,7948,408,10,N,N,-,-1,-1
REMKEL1.txt,7574,7956,382,10,N,N,-,-1,-1
REMKEL1.txt,7687,8002,315,10,N,N,-,-1,-1
REMKEL1.txt,7708,8094,386,10,N,N,-,-1,-1
REMKEL1.txt,7710,8126,416,10,N,N,-,-1,-1
REMKEL1.txt,7799,8174,375,10,N,N,-,-1,-1
REMKEL1.txt,7837,8198,361,10,N,N,-,-1,-1
REMKEL1.txt,7892,8217,325,10,N,N,-,-1,-1
REMKEL1.txt,7919,8250,331,10,N,N,-,-1,-1
REMKEL1.txt,7928,8274,346,10,N,N,-,-1,-1
REMKEL1.txt,7951,8323,372,10,N,N,-,-1,-1
REMKEL1.txt,7957,8349,392,10,N,N,-,-1,-1
REMKEL1.txt,8004,8390,386,10,N,N,-,-1,-1
REMKEL1.txt,8095,8421,326,10,N,N,-,-1,-1
REMKEL1.txt,8127,8475,348,10,N,N,-,-1,-1
REMKEL1.txt,8175,8499,324,10,N,N,-,-1,-1
REMKEL1.txt,8200,8523,323,10,N,N,-,-1,-1
REMKEL1.txt,8218,8544,326,10,N,N,-,-1,-1
REMKEL1.txt,8252,8630,378,10,N,N,-,-1,-1
REMKEL1.txt,8275,8686,411,10,N,N,-,-1,-1
REMKEL1.txt,8324,8714,390,10,N,N,-,-1,-1
REMKEL1.txt,8352,8740,388,10,N,N,-,-1,-1
REMKEL1.txt,8391,8765,374,10,N,N,-,-1,-1
REMKEL1.txt,8423,8852,429,10,N,N,-,-1,-1
REMKEL1.txt,8477,8879,402,10,N,N,-,-1,-1
REMKEL1.txt,8500,8912,412,10,N,N,-,-1,-1
REMKEL1.txt,8525,8948,423,10,N,N,-,-1,-1
REMKEL1.txt,8545,8971,426,10,N,N,-,-1,-1
REMKEL1.txt,8631,9007,376,10,N,N,-,-1,-1
REMKEL1.txt,8687,9124,437,10,N,N,-,-1,-1
REMKEL1.txt,8716,9141,425,10,N,N,-,-1,-1
REMKEL1.txt,8741,9170,429,10,N,N,-,-1,-1
REMKEL1.txt,8767,9243,476,10,N,N,-,-1,-1
REMKEL1.txt,8853,9263,410,10,N,N,-,-1,-1
REMKEL1.txt,8880,9405,525,10,N,N,-,-1,-1
REMKEL1.txt,8915,9440,525,10,N,N,-,-1,-1
REMKEL1.txt,8949,9502,553,10,N,N,-,-1,-1
REMKEL1.txt,8972,9590,618,10,N,N,-,-1,-1
REMKEL1.txt,9008,9615,607,10,N,N,-,-1,-1
REMKEL1.txt,9125,9655,530,10,N,N,-,-1,-1
REMKEL1.txt,9142,9678,536,10,N,N,-,-1,-1
REMKEL1.txt,9171,9719,548,10,N,N,-,-1,-1
REMKEL1.txt,9244,9732,488,10,N,N,-,-1,-1
REMKEL1.txt,9264,9759,495,10,N,N,-,-1,-1
REMKEL1.txt,9406,9802,396,10,N,N,-,-1,-1
REMKEL1.txt,9441,9903,462,10,N,N,-,-1,-1
REMKEL1.txt,9503,9923,420,10,N,N,-,-1,-1
REMKEL1.txt,9591,10048,457,10,N,N,-,-1,-1
REMKEL1.txt,9616,10111,495,10,N,N,-,-1,-1
REMKEL1.txt,9656,10150,494,10,N,N,-,-1,-1
REMKEL1.txt,9679,10202,523,10,N,N,-,-1,-1
REMKEL1.txt,9721,10246,525,10,N,N,-,-1,-1
REMKEL1.txt,9733,10395,662,10,N,N,-,-1,-1
REMKEL1.txt,9760,10428,668,10,N,N,-,-1,-1
REMKEL1.txt,9803,10462,659,10,N,N,-,-1,-1
REMKEL1.txt,9904,10509,605,10,N,N,-,-1,-1
REMKEL1.txt,9924,10537,613,10,N,N,-,-1,-1
REMKEL1.txt,10049,10561,512,10,N,N,-,-1,-1
REMKEL1.txt,10113,10636,523,10,Y,N,-,-1,-1
REMKEL1.txt,10151,10672,521,10,Y,N,-,-1,-1
REMKEL1.txt,10203,10722,519,10,Y,N,-,-1,-1
REMKEL1.txt,10247,10745,498,10,Y,N,-,-1,-1
REMKEL1.txt,10396,10832,436,10,N,N,-,-1,-1
REMKEL1.txt,10430,10864,434,10,N,N,-,-1,-1
REMKEL1.txt,10463,10888,425,10,N,N,-,-1,-1
REMKEL1.txt,10512,10902,390,10,N,N,-,-1,-1
REMKEL1.txt,10540,10969,429,10,N,N,-,-1,-1
REMKEL1.txt,10562,11006,444,10,N,N,-,-1,-1
REMKEL1.txt,10637,11035,398,10,N,N,-,-1,-1
REMKEL1.txt,10673,11073,400,10,N,N,-,-1,-1
REMKEL1.txt,10723,11119,396,10,N,N,-,-1,-1
REMKEL1.txt,10746,11142,396,10,N,N,-,-1,-1
REMKEL1.txt,10833,11203,370,10,N,N,-,-1,-1
REMKEL1.txt,10865,11290,425,10,N,N,-,-1,-1
REMKEL1.txt,10890,11358,468,10,N,N,-,-1,-1
REMKEL1.txt,10903,11452,549,10,N,N,-,-1,-1
REMKEL1.txt,10970,11629,659,10,N,N,-,-1,-1
REMKEL1.txt,11007,11663,656,10,N,N,-,-1,-1
REMKEL1.txt,11037,11833,796,10,N,N,-,-1,-1
REMKEL1.txt,11074,11881,807,10,N,N,-,-1,-1
REMKEL1.txt,11120,11897,777,10,N,N,-,-1,-1
REMKEL1.txt,11145,11955,810,10,N,N,-,-1,-1
REMKEL1.txt,11204,12045,841,10,N,N,-,-1,-1
REMKEL1.txt,11291,12115,824,10,N,N,-,-1,-1
REMKEL1.txt,11359,12156,797,10,N,N,-,-1,-1
REMKEL1.txt,11453,12282,829,10,N,N,-,-1,-1
REMKEL1.txt,11630,12321,691,10,N,N,-,-1,-1
REMKEL1.txt,11664,12333,669,10,N,N,-,-1,-1
REMKEL1.txt,11834,12370,536,10,N,N,-,-1,-1
REMKEL1.txt,11882,12397,515,10,N,N,-,-1,-1
REMKEL1.txt,11898,12405,507,10,N,N,-,-1,-1
REMKEL1.txt,11956,12491,535,10,N,N,-,-1,-1
REMKEL1.txt,12046,12527,481,10,N,N,-,-1,-1
REMKEL1.txt,12116,12546,430,10,N,N,-,-1,-1
REMKEL1.txt,12157,12579,422,10,N,N,-,-1,-1
REMKEL1.txt,12283,12589,306,10,N,N,-,-1,-1
REMKEL1.txt,12322,12605,283,10,N,N,-,-1,-1
REMKEL1.txt,12334,12630,296,10,N,N,-,-1,-1
REMKEL1.txt,12371,12762,391,10,N,N,-,-1,-1
REMKEL1.txt,12398,12801,403,10,N,N,-,-1,-1
REMKEL1.txt,12406,12860,454,10,N,N,-,-1,-1
REMKEL1.txt,12492,12879,387,10,N,N,-,-1,-1
REMKEL1.txt,12528,12903,375,10,N,N,-,-1,-1
REMKEL1.txt,12547,12926,379,10,N,N,-,-1,-1
REMKEL1.txt,12580,12953,373,10,N,N,-,-1,-1
REMKEL1.txt,12590,13008,418,10,N,N,-,-1,-1
REMKEL1.txt,12606,13023,417,10,N,N,-,-1,-1
REMKEL1.txt,12631,13078,447,10,N,N,-,-1,-1
REMKEL1.txt,12763,13090,327,10,N,N,-,-1,-1
REMKEL1.txt,12802,13114,312,10,N,N,-,-1,-1
REMKEL1.txt,12861,13137,276,10,N,N,-,-1,-1
REMKEL1.txt,12880,13162,282,10,N,N,-,-1,-1
REMKEL1.txt,12904,13181,277,10,N,N,-,-1,-1
REMKEL1.txt,12927,13228,301,10,N,N,-,-1,-1
REMKEL1.txt,12954,13248,294,10,N,N,-,-1,-1
REMKEL1.txt,13009,13273,264,10,N,N,-,-1,-1
REMKEL1.txt,13024,13293,269,10,N,N,-,-1,-1
REMKEL1.txt,13079,13309,230,10,N,N,-,-1,-1
REMKEL1.txt,13091,13358,267,10,N,N,-,-1,-1
REMKEL1.txt,13115,13368,253,10,N,N,-,-1,-1
REMKEL1.txt,13140,13375,235,10,N,N,-,-1,-1
REMKEL1.txt,13163,13389,226,10,N,N,-,-1,-1
REMKEL1.txt,13182,13406,224,10,N,N,-,-1,-1
REMKEL1.txt,13229,13499,270,10,N,N,-,-1,-1
REMKEL1.txt,13249,13551,302,10,N,N,-,-1,-1
REMKEL1.txt,13274,13580,306,10,N,N,-,-1,-1
REMKEL1.txt,13295,13608,313,10,N,N,-,-1,-1
REMKEL1.txt,13310,13621,311,10,N,N,-,-1,-1
REMKEL1.txt,13359,13654,295,10,N,N,-,-1,-1
REMKEL1.txt,13369,13777,408,10,N,N,-,-1,-1
REMKEL1.txt,13376,13812,436,10,N,N,-,-1,-1
REMKEL1.txt,13390,13841,451,10,N,N,-,-1,-1
REMKEL1.txt,13407,13884,477,10,N,N,-,-1,-1
REMKEL1.txt,13500,13905,405,10,N,N,-,-1,-1
REMKEL1.txt,13552,13931,379,10,N,N,-,-1,-1
REMKEL1.txt,13581,14017,436,10,N,N,-,-1,-1
REMKEL1.txt,13609,14043,434,10,N,N,-,-1,-1
REMKEL1.txt,13622,14207,585,10,N,N,-,-1,-1
REMKEL1.txt,13655,14262,607,10,N,N,-,-1,-1
REMKEL1.txt,13778,14299,521,10,N,N,-,-1,-1
REMKEL1.txt,13813,14319,506,10,N,N,-,-1,-1
REMKEL1.txt,13842,14343,501,10,N,N,-,-1,-1
REMKEL1.txt,13885,14371,486,10,N,N,-,-1,-1
REMKEL1.txt,13906,14464,558,10,N,N,-,-1,-1
REMKEL1.txt,13932,14489,557,10,N,N,-,-1,-1
REMKEL1.txt,14019,14518,499,10,N,N,-,-1,-1
REMKEL1.txt,14044,14551,507,10,N,N,-,-1,-1
REMKEL1.txt,14208,14598,390,10,N,N,-,-1,-1
REMKEL1.txt,14263,14639,376,10,N,N,-,-1,-1
REMKEL1.txt,14301,14669,368,10,N,N,-,-1,-1
REMKEL1.txt,14320,14701,381,10,N,N,-,-1,-1
REMKEL1.txt,14344,14750,406,10,N,N,-,-1,-1
REMKEL1.txt,14372,14797,425,10,N,N,-,-1,-1
REMKEL1.txt,14465,14834,369,10,N,N,-,-1,-1
REMKEL1.txt,14490,14916,426,10,N,N,-,-1,-1
REMKEL1.txt,14520,14974,454,10,N,N,-,-1,-1
REMKEL1.txt,14552,15026,474,10,N,N,-,-1,-1
REMKEL1.txt,14599,15062,463,10,N,N,-,-1,-1
REMKEL1.txt,14640,15099,459,10,N,N,-,-1,-1
REMKEL1.txt,14671,15145,474,10,N,N,-,-1,-1
REMKEL1.txt,14702,15195,493,10,N,N,-,-1,-1
REMKEL1.txt,14751,15238,487,10,N,N,-,-1,-1
REMKEL1.txt,14798,15282,484,10,N,N,-,-1,-1
REMKEL1.txt,14835,15322,487,10,Y,N,-,-1,-1
REMKEL1.txt,14917,15358,441,10,Y,N,-,-1,-1
REMKEL1.txt,14976,15369,393,10,N,N,-,-1,-1
REMKEL1.txt,15028,15396,368,10,N,N,-,-1,-1
REMKEL1.txt,15063,15425,362,10,N,N,-,-1,-1
REMKEL1.txt,15100,15492,392,10,N,N,-,-1,-1
REMKEL1.txt,15146,15569,423,10,N,N,-,-1,-1
REMKEL1.txt,15196,15659,463,10,N,N,-,-1,-1
REMKEL1.txt,15239,15675,436,10,N,N,-,-1,-1
REMKEL1.txt,15284,15709,425,10,N,N,-,-1,-1
REMKEL1.txt,15323,15771,448,10,N,N,-,-1,-1
REMKEL1.txt,15359,15803,444,10,N,N,-,-1,-1
REMKEL1.txt,15370,15848,478,10,N,N,-,-1,-1
REMKEL1.txt,15397,15883,486,10,N,N,-,-1,-1
REMKEL1.txt,15426,15892,466,10,N,N,-,-1,-1
REMKEL1.txt,15493,15980,487,10,N,N,-,-1,-1
REMKEL1.txt,15570,16002,432,10,N,N,-,-1,-1
REMKEL1.txt,15660,16026,366,10,N,N,-,-1,-1
REMKEL1.txt,15676,16138,462,10,N,N,-,-1,-1
REMKEL1.txt,15710,16162,452,10,N,N,-,-1,-1
REMKEL1.txt,15772,16202,430,10,N,N,-,-1,-1
REMKEL1.txt,15806,16229,423,10,N,N,-,-1,-1
REMKEL1.txt,15849,16242,393,10,N,N,-,-1,-1
REMKEL1.txt,15884,16251,367,10,N,N,-,-1,-1
REMKEL1.txt,15893,16262,369,10,N,N,-,-1,-1
REMKEL1.txt,15980,16270,290,10,N,N,-,-1,-1
REMKEL1.txt,16003,16330,327,10,N,N,-,-1,-1
REMKEL1.txt,16027,16385,358,10,N,N,-,-1,-1
REMKEL1.txt,16139,16424,285,10,N,N,-,-1,-1
REMKEL1.txt,16163,16465,302,10,N,N,-,-1,-1
REMKEL1.txt,16203,16489,286,10,N,N,-,-1,-1
REMKEL1.txt,16230,16524,294,10,N,N,-,-1,-1
REMKEL1.txt,16243,16571,328,10,N,N,-,-1,-1
REMKEL1.txt,16252,16620,368,10,N,N,-,-1,-1
REMKEL1.txt,16264,16679,415,10,N,N,-,-1,-1
REMKEL1.txt,16271,16723,452,10,N,N,-,-1,-1
REMKEL1.txt,16331,17015,684,10,N,N,-,-1,-1
REMKEL1.txt,16386,17224,838,10,N,N,-,-1,-1
REMKEL1.txt,16425,17248,823,10,N,N,-,-1,-1
REMKEL1.txt,16467,17410,943,10,N,N,-,-1,-1
REMKEL1.txt,16490,17424,934,10,N,N,-,-1,-1
REMKEL1.txt,16525,17612,1087,10,N,N,-,-1,-1
REMKEL1.txt,16572,17711,1139,10,N,N,-,-1,-1
REMKEL1.txt,16623,17806,1183,10,N,N,-,-1,-1
REMKEL1.txt,16684,18081,1397,10,N,N,-,-1,-1
REMKEL1.txt,16728,18293,1565,10,N,N,-,-1,-1
REMKEL1.txt,17016,18851,1835,10,N,N,-,-1,-1
REMKEL1.txt,17227,18873,1646,10,N,N,-,-1,-1
REMKEL1.txt,17249,18921,1672,10,N,N,-,-1,-1
REMKEL1.txt,17411,19037,1626,10,N,N,-,-1,-1
REMKEL1.txt,17425,19160,1735,10,N,N,-,-1,-1
REMKEL1.txt,17613,19225,1612,10,N,N,-,-1,-1
REMKEL1.txt,17712,19655,1943,10,N,N,-,-1,-1
REMKEL1.txt,17807,19835,2028,10,N,N,-,-1,-1
REMKEL1.txt,18082,19943,1861,10,N,N,-,-1,-1
REMKEL1.txt,18296,20057,1761,10,N,N,-,-1,-1
REMKEL1.txt,18859,20342,1483,10,N,N,-,-1,-1
REMKEL1.txt,18874,20448,1574,10,N,N,-,-1,-1
REMKEL1.txt,18923,20685,1762,10,N,N,-,-1,-1
REMKEL1.txt,19038,20720,1682,10,Y,N,-,-1,-1
REMKEL1.txt,19161,20807,1646,10,Y,N,-,-1,-1
REMKEL1.txt,19226,21119,1893,10,Y,N,-,-1,-1
REMKEL1.txt,19656,21253,1597,10,Y,N,-,-1,-1
REMKEL1.txt,19836,21312,1476,10,Y,N,-,-1,-1
REMKEL1.txt,19944,21381,1437,10,Y,N,-,-1,-1
REMKEL1.txt,20058,21497,1439,10,Y,N,-,-1,-1
REMKEL1.txt,20343,21614,1271,10,Y,N,-,-1,-1
REMKEL1.txt,20449,21686,1237,10,N,N,-,-1,-1
REMKEL1.txt,20686,21789,1103,10,N,N,-,-1,-1
REMKEL1.txt,20721,21974,1253,10,N,N,-,-1,-1
REMKEL1.txt,20808,22247,1439,10,N,N,-,-1,-1
REMKEL1.txt,21122,22389,1267,10,N,N,-,-1,-1
REMKEL1.txt,21254,22534,1280,10,N,N,-,-1,-1
REMKEL1.txt,21313,22648,1335,10,N,N,-,-1,-1
REMKEL1.txt,21382,22836,1454,10,N,N,-,-1,-1
REMKEL1.txt,21498,23142,1644,10,N,N,-,-1,-1
REMKEL1.txt,21615,23243,1628,10,N,N,-,-1,-1
REMKEL1.txt,21687,23485,1798,10,N,N,-,-1,-1
REMKEL1.txt,21791,23735,1944,10,N,N,-,-1,-1
REMKEL1.txt,21975,24009,2034,10,N,N,-,-1,-1
REMKEL1.txt,22248,24294,2046,10,N,N,-,-1,-1
REMKEL1.txt,22390,24456,2066,10,N,N,-,-1,-1
REMKEL1.txt,22536,24472,1936,10,N,N,-,-1,-1
REMKEL1.txt,22651,24644,1993,10,N,N,-,-1,-1
REMKEL1.txt,22837,24914,2077,10,Y,N,-,-1,-1
REMKEL1.txt,23143,24981,1838,10,Y,N,-,-1,-1
REMKEL1.txt,23244,25173,1929,10,Y,N,-,-1,-1
REMKEL1.txt,23486,25531,2045,10,Y,N,-,-1,-1
REMKEL1.txt,23736,25658,1922,10,Y,N,-,-1,-1
REMKEL1.txt,24010,25947,1937,10,Y,N,-,-1,-1
REMKEL1.txt,24297,26253,1956,10,Y,N,-,-1,-1
REMKEL1.txt,24457,26590,2133,10,Y,N,-,-1,-1
REMKEL1.txt,24473,26810,2337,10,Y,N,-,-1,-1
REMKEL1.txt,24645,27036,2391,10,Y,N,-,-1,-1
REMKEL1.txt,24917,27178,2261,10,Y,N,-,-1,-1
REMKEL1.txt,24982,27275,2293,10,Y,N,-,-1,-1
REMKEL1.txt,25174,27356,2182,10,Y,N,-,-1,-1
REMKEL1.txt,25532,27440,1908,10,Y,N,-,-1,-1
REMKEL1.txt,25660,27459,1799,10,Y,N,-,-1,-1
REMKEL1.txt,25952,27573,1621,10,Y,N,-,-1,-1
REMKEL1.txt,26256,27810,1554,10,N,N,-,-1,-1
REMKEL1.txt,26591,27862,1271,10,N,N,-,-1,-1
REMKEL1.txt,26811,27974,1163,10,N,N,-,-1,-1
REMKEL1.txt,27037,28520,1483,10,N,N,-,-1,-1
REMKEL1.txt,27179,28705,1526,10,N,N,-,-1,-1
REMKEL1.txt,27276,28809,1533,10,N,N,-,-1,-1
REMKEL1.txt,27357,29059,1702,10,Y,N,-,-1,-1
REMKEL1.txt,27445,29166,1721,10,Y,N,-,-1,-1
REMKEL1.txt,27460,29264,1804,10,Y,N,-,-1,-1
REMKEL1.txt,27574,29319,1745,10,Y,N,-,-1,-1
REMKEL1.txt,27811,29331,1520,10,Y,N,-,-1,-1
REMKEL1.txt,27863,29358,1495,10,Y,N,-,-1,-1
REMKEL1.txt,27977,29543,1566,10,Y,N,-,-1,-1
REMKEL1.txt,28523,29837,1314,10,Y,N,-,-1,-1
REMKEL1.txt,28706,29906,1200,10,Y,N,-,-1,-1
REMKEL1.txt,28810,30087,1277,10,N,N,-,-1,-1
REMKEL1.txt,29060,30246,1186,10,N,N,-,-1,-1
REMKEL1.txt,29167,30265,1098,10,N,N,-,-1,-1
REMKEL1.txt,29265,30378,1113,10,N,N,-,-1,-1
REMKEL1.txt,29320,30855,1535,10,Y,N,-,-1,-1
REMKEL1.txt,29333,31247,1914,10,Y,N,-,-1,-1
REMKEL1.txt,29359,31338,1979,10,Y,N,-,-1,-1
REMKEL1.txt,29544,31639,2095,10,Y,N,-,-1,-1
REMKEL1.txt,29840,31689,1849,10,N,N,-,-1,-1
REMKEL1.txt,29907,31743,1836,10,N,N,-,-1,-1
REMKEL1.txt,30090,32019,1929,10,N,N,-,-1,-1
REMKEL1.txt,30251,32340,2089,10,N,N,-,-1,-1
REMKEL1.txt,30266,32413,2147,10,Y,N,-,-1,-1
REMKEL1.txt,30379,32683,2304,10,N,N,-,-1,-1
REMKEL1.txt,30858,33002,2144,10,N,N,-,-1,-1
REMKEL1.txt,31248,33021,1773,10,N,N,-,-1,-1
REMKEL1.txt,31339,33357,2018,10,Y,N,-,-1,-1
REMKEL1.txt,31640,33567,1927,10,Y,N,-,-1,-1
REMKEL1.txt,31694,33699,2005,10,Y,N,-,-1,-1
REMKEL1.txt,31744,33830,2086,10,Y,N,-,-1,-1
REMKEL1.txt,32022,34014,1992,10,Y,N,-,-1,-1
REMKEL1.txt,32343,34332,1989,10,Y,N,-,-1,-1
REMKEL1.txt,32414,34592,2178,10,Y,N,-,-1,-1
REMKEL1.txt,32685,34848,2163,10,Y,N,-,-1,-1
REMKEL1.txt,33007,34972,1965,10,Y,N,-,-1,-1
REMKEL1.txt,33022,35295,2273,10,Y,N,-,-1,-1
REMKEL1.txt,33358,35346,1988,10,N,N,-,-1,-1
REMKEL1.txt,33570,35577,2007,10,Y,N,-,-1,-1
REMKEL1.txt,33700,35703,2003,10,Y,N,-,-1,-1
REMKEL1.txt,33831,35825,1994,10,Y,N,-,-1,-1
REMKEL1.txt,34016,36023,2007,10,Y,N,-,-1,-1
REMKEL1.txt,34333,36241,1908,10,N,N,-,-1,-1
REMKEL1.txt,34595,36405,1810,10,N,N,-,-1,-1
REMKEL1.txt,34849,36744,1895,10,N,N,-,-1,-1
REMKEL1.txt,34973,36885,1912,10,Y,N,-,-1,-1
REMKEL1.txt,35296,37008,1712,10,Y,N,-,-1,-1
REMKEL1.txt,35347,37176,1829,10,Y,N,-,-1,-1
REMKEL1.txt,35578,37310,1732,10,Y,N,-,-1,-1
REMKEL1.txt,35706,37436,1730,10,Y,N,-,-1,-1
REMKEL1.txt,35826,37521,1695,10,Y,N,-,-1,-1
REMKEL1.txt,36024,37679,1655,10,Y,N,-,-1,-1
REMKEL1.txt,36242,37895,1653,10,Y,N,-,-1,-1
REMKEL1.txt,36408,37900,1492,10,Y,N,-,-1,-1
REMKEL1.txt,36745,38242,1497,10,Y,N,-,-1,-1
REMKEL1.txt,36886,38424,1538,10,Y,N,-,-1,-1
REMKEL1.txt,37009,38571,1562,10,Y,N,-,-1,-1
REMKEL1.txt,37179,38614,1435,10,Y,N,-,-1,-1
REMKEL1.txt,37311,38699,1388,10,Y,N,-,-1,-1
REMKEL1.txt,37439,38921,1482,10,Y,N,-,-1,-1
REMKEL1.txt,37522,39058,1536,10,Y,N,-,-1,-1
REMKEL1.txt,37681,39107,1426,10,Y,N,-,-1,-1
REMKEL1.txt,37896,39162,1266,10,Y,N,-,-1,-1
REMKEL1.txt,37903,39320,1417,10,Y,N,-,-1,-1
REMKEL1.txt,38243,39421,1178,10,N,N,-,-1,-1
REMKEL1.txt,38425,39505,1080,10,N,N,-,-1,-1
REMKEL1.txt,38572,39700,1128,10,N,N,-,-1,-1
REMKEL1.txt,38615,39773,1158,10,N,N,-,-1,-1
REMKEL1.txt,38700,40200,1500,10,Y,N,-,-1,-1
REMKEL1.txt,38924,40326,1402,10,Y,N,-,-1,-1
REMKEL1.txt,39059,40575,1516,10,Y,N,-,-1,-1
REMKEL1.txt,39108,40730,1622,10,Y,N,-,-1,-1
REMKEL1.txt,39163,40822,1659,10,Y,N,-,-1,-1
REMKEL1.txt,39321,41116,1795,10,Y,N,-,-1,-1
REMKEL1.txt,39424,41405,1981,10,Y,N,-,-1,-1
REMKEL1.txt,39506,41481,1975,10,Y,N,-,-1,-1
REMKEL1.txt,39701,41485,1784,10,Y,N,-,-1,-1
REMKEL1.txt,39775,41549,1774,10,Y,N,-,-1,-1
REMKEL1.txt,40201,41574,1373,10,N,N,-,-1,-1
REMKEL1.txt,40327,41593,1266,10,N,N,-,-1,-1
REMKEL1.txt,40578,41614,1036,10,N,N,-,-1,-1
REMKEL1.txt,40730,41652,922,10,N,N,-,-1,-1
REMKEL1.txt,40825,41774,949,10,N,N,-,-1,-1
REMKEL1.txt,41117,41780,663,10,N,N,-,-1,-1
REMKEL1.txt,41407,42317,910,10,N,N,-,-1,-1
REMKEL1.txt,41484,42342,858,10,N,N,-,-1,-1
REMKEL1.txt,41488,42344,856,10,N,N,-,-1,-1
REMKEL1.txt,41551,42356,805,10,N,N,-,-1,-1
REMKEL1.txt,41579,42415,836,10,N,N,-,-1,-1
REMKEL1.txt,41594,42440,846,10,N,N,-,-1,-1
REMKEL1.txt,41615,42476,861,10,N,N,-,-1,-1
REMKEL1.txt,41653,42500,847,10,N,N,-,-1,-1
REMKEL1.txt,41777,42536,759,10,N,N,-,-1,-1
REMKEL1.txt,41781,42559,778,10,N,N,-,-1,-1
REMKEL1.txt,42320,42581,261,10,N,N,-,-1,-1
REMKEL1.txt,42343,42604,261,10,N,N,-,-1,-1
REMKEL1.txt,42345,42683,338,10,N,N,-,-1,-1
REMKEL1.txt,42358,43013,655,10,N,N,-,-1,-1
REMKEL1.txt,42418,43260,842,10,N,N,-,-1,-1
REMKEL1.txt,42443,43529,1086,10,N,N,-,-1,-1
REMKEL1.txt,42479,43630,1151,10,N,N,-,-1,-1
REMKEL1.txt,42503,43779,1276,10,N,N,-,-1,-1
REMKEL1.txt,42539,43923,1384,10,N,N,-,-1,-1
REMKEL1.txt,42562,44129,1567,10,N,N,-,-1,-1
REMKEL1.txt,42584,44276,1692,10,N,N,-,-1,-1
REMKEL1.txt,42607,44483,1876,10,N,N,-,-1,-1
REMKEL1.txt,42684,44649,1965,10,N,N,-,-1,-1
REMKEL1.txt,43016,44841,1825,10,N,N,-,-1,-1
REMKEL1.txt,43263,44938,1675,10,N,N,-,-1,-1
REMKEL1.txt,43530,45084,1554,10,N,N,-,-1,-1
REMKEL1.txt,43631,45225,1594,10,N,N,-,-1,-1
REMKEL1.txt,43782,45255,1473,10,N,N,-,-1,-1
REMKEL1.txt,43926,45354,1428,10,N,N,-,-1,-1
REMKEL1.txt,44134,45565,1431,10,N,N,-,-1,-1
REMKEL1.txt,44277,45656,1379,10,N,N,-,-1,-1
REMKEL1.txt,44485,45666,1181,10,N,N,-,-1,-1
REMKEL1.txt,44652,45699,1047,10,N,N,-,-1,-1
REMKEL1.txt,44842,45836,994,10,N,N,-,-1,-1
REMKEL1.txt,44939,45926,987,10,N,N,-,-1,-1
REMKEL1.txt,45085,46134,1049,10,N,N,-,-1,-1
REMKEL1.txt,45226,46224,998,10,N,N,-,-1,-1
REMKEL1.txt,45257,46251,994,10,N,N,-,-1,-1
REMKEL1.txt,45356,46515,1159,10,N,N,-,-1,-1
REMKEL1.txt,45566,46681,1115,10,N,N,-,-1,-1
REMKEL1.txt,45657,46863,1206,10,N,N,-,-1,-1
REMKEL1.txt,45667,46882,1215,10,N,N,-,-1,-1
REMKEL1.txt,45700,47149,1449,10,N,N,-,-1,-1
REMKEL1.txt,45837,47298,1461,10,N,N,-,-1,-1
REMKEL1.txt,45927,47410,1483,10,N,N,-,-1,-1
REMKEL1.txt,46135,47498,1363,10,N,N,-,-1,-1
REMKEL1.txt,46225,47866,1641,10,N,N,-,-1,-1
REMKEL1.txt,46252,47955,1703,10,N,N,-,-1,-1
REMKEL1.txt,46518,48097,1579,10,N,N,-,-1,-1
REMKEL1.txt,46682,48203,1521,10,N,N,-,-1,-1
REMKEL1.txt,46868,48621,1753,10,N,N,-,-1,-1
REMKEL1.txt,46883,48871,1988,10,N,N,-,-1,-1
REMKEL1.txt,47150,49128,1978,10,N,N,-,-1,-1
REMKEL1.txt,47301,49246,1945,10,N,N,-,-1,-1
REMKEL1.txt,47411,49700,2289,10,N,N,-,-1,-1
REMKEL1.txt,47501,49868,2367,10,N,N,-,-1,-1
REMKEL1.txt,47866,49977,2111,10,N,N,-,-1,-1
REMKEL1.txt,47956,50044,2088,10,N,N,-,-1,-1
REMKEL1.txt,48098,50063,1965,10,N,N,-,-1,-1
REMKEL1.txt,48204,50475,2271,10,N,N,-,-1,-1
REMKEL1.txt,48624,50643,2019,10,N,Y,1437472380836,351899,352666
REMKEL1.txt,48874,50817,1943,10,N,Y,1437472380836,351899,352666
REMKEL1.txt,49131,51141,2010,10,N,Y,1437472380836,351899,352666
REMKEL1.txt,49247,51345,2098,10,Y,Y,1437472380836,351899,352666
REMKEL1.txt,49701,51402,1701,10,Y,Y,1437472380836,351899,352666
REMKEL1.txt,49869,51802,1933,10,Y,Y,1437472380836,351899,352666
REMKEL1.txt,49978,52134,2156,10,Y,Y,1437472380836,351899,352666
REMKEL1.txt,50049,52384,2335,10,Y,Y,1437472380836,351899,352666
REMKEL1.txt,50064,52541,2477,10,Y,Y,1437472380836,351899,352666
REMKEL1.txt,50478,52724,2246,10,Y,Y,1437472380836,351899,352666
REMKEL1.txt,50644,52795,2151,10,Y,Y,1437472380836,351899,352666
REMKEL1.txt,50818,52953,2135,10,N,Y,1437472380836,351899,352666
REMKEL1.txt,51142,53331,2189,10,N,Y,1437472380836,351899,352666
REMKEL1.txt,51348,53543,2195,10,N,N,-,-1,-1
REMKEL1.txt,51403,53624,2221,10,N,N,-,-1,-1
REMKEL1.txt,51805,53880,2075,10,N,N,-,-1,-1
REMKEL1.txt,52135,54001,1866,10,N,N,-,-1,-1
REMKEL1.txt,52387,54214,1827,10,N,N,-,-1,-1
REMKEL1.txt,52542,54474,1932,10,N,N,-,-1,-1
REMKEL1.txt,52727,54587,1860,10,N,Y,1448313482895,176553,176862
REMKEL1.txt,52798,54699,1901,10,N,Y,1448313482895,176553,176862
REMKEL1.txt,52956,54795,1839,10,N,Y,1448313482895,176553,176862
REMKEL1.txt,53334,54863,1529,10,N,Y,1448313482895,176553,176862
REMKEL1.txt,53544,54973,1429,10,N,Y,1448313482895,176553,176862
REMKEL1.txt,53626,55117,1491,10,N,Y,1448313482895,176553,176862
REMKEL1.txt,53881,55260,1379,10,Y,Y,1448313482895,176553,176862
REMKEL1.txt,54004,55359,1355,10,N,Y,1448313482895,176553,176862
REMKEL1.txt,54217,55437,1220,10,N,Y,1448313482895,176553,176862
REMKEL1.txt,54477,55491,1014,10,N,Y,1448313482895,176553,176862
REMKEL1.txt,54588,55626,1038,10,N,Y,1448313482895,176553,176862
REMKEL1.txt,54700,55778,1078,10,N,Y,1448313482895,176553,176862
REMKEL1.txt,54796,55945,1149,10,N,Y,1448313482895,176553,176862
REMKEL1.txt,54866,56207,1341,10,N,Y,1448313482895,176553,176862
REMKEL1.txt,54974,56252,1278,10,N,Y,1448313482895,176553,176862
REMKEL1.txt,55119,56392,1273,10,N,Y,1448313482895,176553,176862
REMKEL1.txt,55261,56639,1378,10,N,Y,1448313482895,176553,176862
REMKEL1.txt,55360,56841,1481,10,N,N,-,-1,-1
REMKEL1.txt,55438,56958,1520,10,N,N,-,-1,-1
REMKEL1.txt,55492,57099,1607,10,N,N,-,-1,-1
REMKEL1.txt,55629,57147,1518,10,N,N,-,-1,-1
REMKEL1.txt,55779,57325,1546,10,N,N,-,-1,-1
REMKEL1.txt,55946,57714,1768,10,Y,N,-,-1,-1
REMKEL1.txt,56208,57833,1625,10,N,N,-,-1,-1
REMKEL1.txt,56255,57987,1732,10,N,N,-,-1,-1
REMKEL1.txt,56394,58174,1780,10,N,N,-,-1,-1
REMKEL1.txt,56641,58193,1552,10,N,N,-,-1,-1
REMKEL1.txt,56846,58320,1474,10,N,N,-,-1,-1
REMKEL1.txt,56959,58616,1657,10,N,N,-,-1,-1
REMKEL1.txt,57100,58705,1605,10,N,N,-,-1,-1
REMKEL1.txt,57150,59051,1901,10,N,N,-,-1,-1
REMKEL1.txt,57326,59173,1847,10,N,N,-,-1,-1
REMKEL1.txt,57715,59310,1595,10,N,N,-,-1,-1
REMKEL1.txt,57834,59461,1627,10,N,N,-,-1,-1
REMKEL1.txt,57988,59623,1635,10,N,N,-,-1,-1
REMKEL1.txt,58179,59726,1547,10,N,N,-,-1,-1
REMKEL1.txt,58196,59836,1640,10,N,N,-,-1,-1
REMKEL1.txt,58323,60069,1746,10,N,N,-,-1,-1
REMKEL1.txt,58618,60119,1501,10,N,N,-,-1,-1
REMKEL1.txt,58708,60495,1787,10,N,N,-,-1,-1
REMKEL1.txt,59054,60635,1581,10,N,N,-,-1,-1
REMKEL1.txt,59174,60770,1596,10,N,N,-,-1,-1
REMKEL1.txt,59311,61139,1828,10,N,N,-,-1,-1
REMKEL1.txt,59462,61158,1696,10,N,N,-,-1,-1
REMKEL1.txt,59625,61234,1609,10,N,N,-,-1,-1
REMKEL1.txt,59731,61524,1793,10,N,N,-,-1,-1
REMKEL1.txt,59837,61666,1829,10,N,N,-,-1,-1
REMKEL1.txt,60072,62163,2091,10,N,N,-,-1,-1
REMKEL1.txt,60121,62232,2111,10,N,N,-,-1,-1
REMKEL1.txt,60498,62307,1809,10,N,N,-,-1,-1
REMKEL1.txt,60636,62312,1676,10,N,N,-,-1,-1
REMKEL1.txt,60771,62444,1673,10,N,N,-,-1,-1
REMKEL1.txt,61144,62517,1373,10,N,N,-,-1,-1
REMKEL1.txt,61161,62610,1449,10,N,N,-,-1,-1
REMKEL1.txt,61235,62780,1545,10,N,N,-,-1,-1
REMKEL1.txt,61527,62851,1324,10,N,N,-,-1,-1
REMKEL1.txt,61667,62967,1300,10,N,N,-,-1,-1
REMKEL1.txt,62164,63077,913,10,N,N,-,-1,-1
REMKEL1.txt,62234,63458,1224,10,N,N,-,-1,-1
REMKEL1.txt,62308,63575,1267,10,N,N,-,-1,-1
REMKEL1.txt,62313,63644,1331,10,N,N,-,-1,-1
REMKEL1.txt,62447,63787,1340,10,N,N,-,-1,-1
REMKEL1.txt,62518,63806,1288,10,N,N,-,-1,-1
REMKEL1.txt,62611,63869,1258,10,N,N,-,-1,-1
REMKEL1.txt,62783,64222,1439,10,N,N,-,-1,-1
REMKEL1.txt,62852,64413,1561,10,N,N,-,-1,-1
REMKEL1.txt,62968,64746,1778,10,N,N,-,-1,-1
REMKEL1.txt,63078,64865,1787,10,N,N,-,-1,-1
REMKEL1.txt,63461,64940,1479,10,N,N,-,-1,-1
REMKEL1.txt,63578,65022,1444,10,N,N,-,-1,-1
REMKEL1.txt,63647,65168,1521,10,N,N,-,-1,-1
REMKEL1.txt,63792,65318,1526,10,N,N,-,-1,-1
REMKEL1.txt,63807,65402,1595,10,N,N,-,-1,-1
REMKEL1.txt,63870,65572,1702,10,N,N,-,-1,-1
REMKEL1.txt,64225,65664,1439,10,N,N,-,-1,-1
REMKEL1.txt,64416,66057,1641,10,N,N,-,-1,-1
REMKEL1.txt,64747,66136,1389,10,N,N,-,-1,-1
REMKEL1.txt,64866,66283,1417,10,N,N,-,-1,-1
REMKEL1.txt,64943,66425,1482,10,N,N,-,-1,-1
REMKEL1.txt,65023,66564,1541,10,N,N,-,-1,-1
REMKEL1.txt,65169,66656,1487,10,N,N,-,-1,-1
REMKEL1.txt,65319,67032,1713,10,N,N,-,-1,-1
REMKEL1.txt,65403,67198,1795,10,N,N,-,-1,-1
REMKEL1.txt,65573,67404,1831,10,N,N,-,-1,-1
REMKEL1.txt,65666,67799,2133,10,N,N,-,-1,-1
REMKEL1.txt,66060,67862,1802,10,N,N,-,-1,-1
REMKEL1.txt,66137,67976,1839,10,N,N,-,-1,-1
REMKEL1.txt,66284,68305,2021,10,N,N,-,-1,-1
REMKEL1.txt,66428,68494,2066,10,N,N,-,-1,-1
REMKEL1.txt,66565,68766,2201,10,N,N,-,-1,-1
REMKEL1.txt,66657,69166,2509,10,N,N,-,-1,-1
REMKEL1.txt,67034,69358,2324,10,N,N,-,-1,-1
REMKEL1.txt,67201,69392,2191,10,N,N,-,-1,-1
REMKEL1.txt,67407,69505,2098,10,N,N,-,-1,-1
REMKEL1.txt,67802,69524,1722,10,N,N,-,-1,-1
REMKEL1.txt,67864,69706,1842,10,N,N,-,-1,-1
REMKEL1.txt,67977,69816,1839,10,N,N,-,-1,-1
REMKEL1.txt,68306,69965,1659,10,N,N,-,-1,-1
REMKEL1.txt,68495,70188,1693,10,N,N,-,-1,-1
REMKEL1.txt,68769,70262,1493,10,N,N,-,-1,-1
REMKEL1.txt,69167,70356,1189,10,N,N,-,-1,-1
REMKEL1.txt,69359,70431,1072,10,N,N,-,-1,-1
REMKEL1.txt,69395,70814,1419,10,N,N,-,-1,-1
REMKEL1.txt,69510,70895,1385,10,N,N,-,-1,-1
REMKEL1.txt,69525,70938,1413,10,N,N,-,-1,-1
REMKEL1.txt,69709,71150,1441,10,N,N,-,-1,-1
REMKEL1.txt,69817,71360,1543,10,N,N,-,-1,-1
REMKEL1.txt,69967,71405,1438,10,N,N,-,-1,-1
REMKEL1.txt,70191,71582,1391,10,N,N,-,-1,-1
REMKEL1.txt,70263,71723,1460,10,N,N,-,-1,-1
REMKEL1.txt,70357,71917,1560,10,N,N,-,-1,-1
REMKEL1.txt,70433,72088,1655,10,N,N,-,-1,-1
REMKEL1.txt,70815,72259,1444,10,N,N,-,-1,-1
REMKEL1.txt,70900,72266,1366,10,N,N,-,-1,-1
REMKEL1.txt,70939,72364,1425,10,N,N,-,-1,-1
REMKEL1.txt,71153,72437,1284,10,N,N,-,-1,-1
REMKEL1.txt,71361,72574,1213,10,N,N,-,-1,-1
REMKEL1.txt,71407,72735,1328,10,N,N,-,-1,-1
REMKEL1.txt,71585,72895,1310,10,N,N,-,-1,-1
REMKEL1.txt,71724,73005,1281,10,N,N,-,-1,-1
REMKEL1.txt,71920,73141,1221,10,N,N,-,-1,-1
REMKEL1.txt,72091,73318,1227,10,N,N,-,-1,-1
REMKEL1.txt,72260,73714,1454,10,N,N,-,-1,-1
REMKEL1.txt,72266,73809,1543,10,N,Y,1448275023016,26258,26837
REMKEL1.txt,72365,74091,1726,10,N,Y,1448275023016,26258,26837
REMKEL1.txt,72440,74325,1885,10,N,Y,1448275023016,26258,26837
REMKEL1.txt,72575,74510,1935,10,N,Y,1448275023016,26258,26837
REMKEL1.txt,72738,74596,1858,10,N,Y,1448275023016,26258,26837
REMKEL1.txt,72896,74795,1899,10,N,Y,1448275023016,26258,26837
REMKEL1.txt,73008,75025,2017,10,Y,Y,1448275023016,26258,26837
REMKEL1.txt,73142,75238,2096,10,Y,Y,1448275023016,26258,26837
REMKEL1.txt,73319,75257,1938,10,Y,Y,1448275023016,26258,26837
REMKEL1.txt,73715,75437,1722,10,Y,Y,1448275023016,26258,26837
REMKEL1.txt,73814,75635,1821,10,Y,Y,1448275023016,26258,26837
REMKEL1.txt,74092,75863,1771,10,Y,Y,1448275023016,26258,26837
REMKEL1.txt,74326,75969,1643,10,N,Y,1437028092146,121457,123204
REMKEL1.txt,74511,76191,1680,10,Y,Y,1437028092146,121457,123204
REMKEL1.txt,74599,76247,1648,10,Y,Y,1437028092146,121457,123204
REMKEL1.txt,74798,76458,1660,10,Y,Y,1437028092146,121457,123204
REMKEL1.txt,75026,76881,1855,10,Y,Y,1437028092146,121457,123204
REMKEL1.txt,75243,76986,1743,10,Y,Y,1437028092146,121457,123204
REMKEL1.txt,75258,77065,1807,10,Y,Y,1437028092146,121457,123204
REMKEL1.txt,75438,77139,1701,10,Y,Y,1437028092146,121457,123204
REMKEL1.txt,75638,77180,1542,10,Y,Y,1437028092146,121457,123204
REMKEL1.txt,75866,77409,1543,10,Y,Y,1437028092146,121457,123204
REMKEL1.txt,75972,77491,1519,10,Y,Y,1437028092146,121457,123204
REMKEL1.txt,76192,77688,1496,10,Y,Y,1437028092146,121457,123204
REMKEL1.txt,76250,77940,1690,10,Y,Y,1437028092146,121457,123204
REMKEL1.txt,76459,78127,1668,10,Y,Y,1437028092146,121457,123204
REMKEL1.txt,76884,78200,1316,10,N,N,-,-1,-1
REMKEL1.txt,76987,78510,1523,10,N,N,-,-1,-1
REMKEL1.txt,77066,78634,1568,10,N,N,-,-1,-1
REMKEL1.txt,77142,78789,1647,10,N,N,-,-1,-1
REMKEL1.txt,77181,78838,1657,10,N,N,-,-1,-1
REMKEL1.txt,77412,78986,1574,10,N,N,-,-1,-1
REMKEL1.txt,77492,79059,1567,10,N,N,-,-1,-1
REMKEL1.txt,77689,79176,1487,10,N,N,-,-1,-1
REMKEL1.txt,77941,79480,1539,10,N,N,-,-1,-1
REMKEL1.txt,78130,79841,1711,10,N,N,-,-1,-1
REMKEL1.txt,78201,79993,1792,10,N,N,-,-1,-1
REMKEL1.txt,78513,80145,1632,10,N,N,-,-1,-1
REMKEL1.txt,78635,80274,1639,10,N,N,-,-1,-1
REMKEL1.txt,78790,80407,1617,10,N,N,-,-1,-1
REMKEL1.txt,78839,80506,1667,10,N,Y,1448281320115,89144,91129
REMKEL1.txt,78989,80666,1677,10,N,Y,1448281320115,89144,91129
REMKEL1.txt,79060,80685,1625,10,N,Y,1448281320115,89144,91129
REMKEL1.txt,79179,80760,1581,10,N,Y,1448281320115,89144,91129
REMKEL1.txt,79483,80806,1323,10,N,Y,1448281320115,89144,91129
REMKEL1.txt,79844,80953,1109,10,N,Y,1448281320115,89144,91129
REMKEL1.txt,79994,81098,1104,10,N,Y,1448281320115,89144,91129
REMKEL1.txt,80148,81312,1164,10,N,Y,1448281320115,89144,91129
REMKEL1.txt,80277,81521,1244,10,Y,Y,1448281320115,89144,91129
REMKEL1.txt,80408,81646,1238,10,Y,Y,1448281320115,89144,91129
REMKEL1.txt,80507,81693,1186,10,N,Y,1448281320115,89144,91129
REMKEL1.txt,80671,81941,1270,10,N,Y,1448281320115,89144,91129
REMKEL1.txt,80686,82054,1368,10,N,Y,1448281320115,89144,91129
REMKEL1.txt,80763,82206,1443,10,Y,Y,1448281320115,89144,91129
REMKEL1.txt,80807,82282,1475,10,N,Y,1448281320115,89144,91129
REMKEL1.txt,80956,82377,1421,10,Y,Y,1448038356234,18463,18881
REMKEL1.txt,81099,82485,1386,10,Y,Y,1448038356234,18463,18881
REMKEL1.txt,81315,82580,1265,10,Y,Y,1448038356234,18463,18881
REMKEL1.txt,81523,82683,1160,10,Y,Y,1448038356234,18463,18881
REMKEL1.txt,81647,82738,1091,10,Y,Y,1448038356234,18463,18881
REMKEL1.txt,81694,82953,1259,10,Y,Y,1448038356234,18463,18881
REMKEL1.txt,81944,82962,1018,10,Y,Y,1448279089520,67624,69991
REMKEL1.txt,82055,82983,928,10,Y,Y,1448279089520,67624,69991
REMKEL1.txt,82207,83002,795,10,Y,Y,1448279089520,67624,69991
REMKEL1.txt,82283,83033,750,10,Y,Y,1448279089520,67624,69991
REMKEL1.txt,82378,83059,681,10,N,Y,1448279089520,67624,69991
REMKEL1.txt,82486,83194,708,10,N,Y,1448279089520,67624,69991
REMKEL1.txt,82581,83209,628,10,N,Y,1448279089520,67624,69991
REMKEL1.txt,82686,83268,582,10,N,N,-,-1,-1
REMKEL1.txt,82739,83274,535,10,N,N,-,-1,-1
REMKEL1.txt,82954,83293,339,10,N,N,-,-1,-1
REMKEL1.txt,82963,83362,399,10,N,N,-,-1,-1
REMKEL1.txt,82984,83447,463,10,N,N,-,-1,-1
REMKEL1.txt,83003,83568,565,10,N,N,-,-1,-1
REMKEL1.txt,83034,83603,569,10,N,N,-,-1,-1
REMKEL1.txt,83060,83698,638,10,N,N,-,-1,-1
REMKEL1.txt,83195,83777,582,10,N,N,-,-1,-1
REMKEL1.txt,83210,84003,793,10,N,N,-,-1,-1
REMKEL1.txt,83270,84160,890,10,N,N,-,-1,-1
REMKEL1.txt,83275,84337,1062,10,N,N,-,-1,-1
REMKEL1.txt,83296,84459,1163,10,N,N,-,-1,-1
REMKEL1.txt,83363,84502,1139,10,N,N,-,-1,-1
REMKEL1.txt,83450,84610,1160,10,N,N,-,-1,-1
REMKEL1.txt,83569,84696,1127,10,N,Y,1448277167610,40886,47737
REMKEL1.txt,83605,84718,1113,10,N,Y,1448277167610,40886,47737
REMKEL1.txt,83699,84900,1201,10,N,Y,1448277167610,40886,47737
REMKEL1.txt,83780,85044,1264,10,N,Y,1448277167610,40886,47737
REMKEL1.txt,84004,85163,1159,10,N,Y,1448277167610,40886,47737
REMKEL1.txt,84161,85388,1227,10,N,Y,1448277167610,40886,47737
REMKEL1.txt,84338,85511,1173,10,N,Y,1448277167610,40886,47737
REMKEL1.txt,84460,85679,1219,10,Y,Y,1448277167610,40886,47737
REMKEL1.txt,84503,85743,1240,10,N,Y,1448277167610,40886,47737
REMKEL1.txt,84613,85777,1164,10,N,Y,1448277167610,40886,47737
REMKEL1.txt,84697,85812,1115,10,N,Y,1448277167610,40886,47737
REMKEL1.txt,84719,85950,1231,10,N,Y,1448277167610,40886,47737
REMKEL1.txt,84902,86124,1222,10,N,Y,1448277167610,40886,47737
REMKEL1.txt,85045,86256,1211,10,N,Y,1448277167610,40886,47737
REMKEL1.txt,85164,86387,1223,10,N,Y,1448314503640,180207,180355
REMKEL1.txt,85391,86447,1056,10,N,Y,1448314503640,180207,180355
REMKEL1.txt,85512,86557,1045,10,N,Y,1448314503640,180207,180355
REMKEL1.txt,85680,86611,931,10,N,Y,1448314503640,180207,180355
REMKEL1.txt,85744,86946,1202,10,N,Y,1448314503640,180207,180355
REMKEL1.txt,85778,87040,1262,10,N,Y,1448314503640,180207,180355
REMKEL1.txt,85813,87235,1422,10,N,Y,1448314503640,180207,180355
REMKEL1.txt,85952,87393,1441,10,N,Y,1448314503640,180207,180355
REMKEL1.txt,86125,87596,1471,10,N,Y,1448314503640,180207,180355
REMKEL1.txt,86257,87634,1377,10,N,N,-,-1,-1
REMKEL1.txt,86390,87902,1512,10,N,N,-,-1,-1
REMKEL1.txt,86448,88070,1622,10,N,N,-,-1,-1
REMKEL1.txt,86558,88494,1936,10,N,N,-,-1,-1
REMKEL1.txt,86612,88865,2253,10,N,N,-,-1,-1
REMKEL1.txt,86949,88939,1990,10,N,N,-,-1,-1
REMKEL1.txt,87041,89170,2129,10,N,N,-,-1,-1
REMKEL1.txt,87236,89379,2143,10,N,N,-,-1,-1
REMKEL1.txt,87396,89533,2137,10,N,N,-,-1,-1
REMKEL1.txt,87597,89732,2135,10,N,N,-,-1,-1
REMKEL1.txt,87636,89856,2220,10,N,N,-,-1,-1
REMKEL1.txt,87903,90016,2113,10,N,N,-,-1,-1
REMKEL1.txt,88071,90133,2062,10,N,N,-,-1,-1
REMKEL1.txt,88497,90400,1903,10,N,N,-,-1,-1
REMKEL1.txt,88866,90627,1761,10,N,N,-,-1,-1
REMKEL1.txt,88942,91200,2258,10,N,N,-,-1,-1
REMKEL1.txt,89171,91437,2266,10,N,N,-,-1,-1
REMKEL1.txt,89380,91558,2178,10,N,N,-,-1,-1
REMKEL1.txt,89536,91678,2142,10,N,N,-,-1,-1
REMKEL1.txt,89734,91982,2248,10,N,N,-,-1,-1
REMKEL1.txt,89857,92271,2414,10,N,N,-,-1,-1
REMKEL1.txt,90017,92683,2666,10,N,N,-,-1,-1
REMKEL1.txt,90134,92684,2550,10,N,N,-,-1,-1
REMKEL1.txt,90403,92918,2515,10,N,N,-,-1,-1
REMKEL1.txt,90628,93048,2420,10,N,N,-,-1,-1
REMKEL1.txt,91203,93253,2050,10,N,N,-,-1,-1
REMKEL1.txt,91438,93266,1828,10,N,N,-,-1,-1
REMKEL1.txt,91561,93278,1717,10,N,N,-,-1,-1
REMKEL1.txt,91679,93302,1623,10,N,N,-,-1,-1
REMKEL1.txt,91983,93326,1343,10,N,N,-,-1,-1
REMKEL1.txt,92272,93511,1239,10,N,N,-,-1,-1
REMKEL1.txt,92683,93627,944,10,N,N,-,-1,-1
REMKEL1.txt,92687,93701,1014,10,N,N,-,-1,-1
REMKEL1.txt,92919,93846,927,10,N,N,-,-1,-1
REMKEL1.txt,93049,93854,805,10,N,N,-,-1,-1
REMKEL1.txt,93254,93884,630,10,N,N,-,-1,-1
REMKEL1.txt,93267,93891,624,10,N,N,-,-1,-1
REMKEL1.txt,93279,93900,621,10,N,N,-,-1,-1
REMKEL1.txt,93303,94006,703,10,N,N,-,-1,-1
REMKEL1.txt,93327,94174,847,10,N,N,-,-1,-1
REMKEL1.txt,93512,94354,842,10,N,N,-,-1,-1
REMKEL1.txt,93628,94472,844,10,N,N,-,-1,-1
REMKEL1.txt,93702,94597,895,10,N,N,-,-1,-1
REMKEL1.txt,93847,94687,840,10,N,N,-,-1,-1
REMKEL1.txt,93855,94767,912,10,N,N,-,-1,-1
REMKEL1.txt,93885,95020,1135,10,N,N,-,-1,-1
REMKEL1.txt,93892,95203,1311,10,N,N,-,-1,-1
REMKEL1.txt,93901,95264,1363,10,N,N,-,-1,-1
REMKEL1.txt,94009,95450,1441,10,N,N,-,-1,-1
REMKEL1.txt,94175,95496,1321,10,N,N,-,-1,-1
REMKEL1.txt,94357,95688,1331,10,N,N,-,-1,-1
REMKEL1.txt,94473,95828,1355,10,N,N,-,-1,-1
REMKEL1.txt,94598,96096,1498,10,N,N,-,-1,-1
REMKEL1.txt,94688,96129,1441,10,N,N,-,-1,-1
REMKEL1.txt,94770,96344,1574,10,N,N,-,-1,-1
REMKEL1.txt,95022,96481,1459,10,N,N,-,-1,-1
REMKEL1.txt,95206,96574,1368,10,N,N,-,-1,-1
REMKEL1.txt,95265,96790,1525,10,N,N,-,-1,-1
REMKEL1.txt,95452,96965,1513,10,N,N,-,-1,-1
REMKEL1.txt,95498,97053,1555,10,N,Y,1448276340407,30017,39003
REMKEL1.txt,95689,97275,1586,10,N,Y,1448276340407,30017,39003
REMKEL1.txt,95829,97327,1498,10,N,Y,1448276340407,30017,39003
REMKEL1.txt,96097,97489,1392,10,N,Y,1448276340407,30017,39003
REMKEL1.txt,96130,97614,1484,10,N,Y,1448276340407,30017,39003
REMKEL1.txt,96345,97873,1528,10,N,Y,1448276340407,30017,39003
REMKEL1.txt,96484,98041,1557,10,N,Y,1448276340407,30017,39003
REMKEL1.txt,96576,98259,1683,10,N,Y,1448039370049,20775,21297
REMKEL1.txt,96791,98504,1713,10,N,Y,1448039370049,20775,21297
REMKEL1.txt,96968,98588,1620,10,N,Y,1448039370049,20775,21297
REMKEL1.txt,97054,98730,1676,10,N,Y,1448039370049,20775,21297
REMKEL1.txt,97276,98950,1674,10,N,Y,1448039370049,20775,21297
REMKEL1.txt,97329,99130,1801,10,N,Y,1448039370049,20775,21297
REMKEL1.txt,97490,99487,1997,10,Y,Y,1448039370049,20775,21297
REMKEL1.txt,97615,99658,2043,10,N,Y,1448039370049,20775,21297
REMKEL1.txt,97874,99768,1894,10,N,Y,1448039370049,20775,21297
REMKEL1.txt,98044,99954,1910,10,N,Y,1448039370049,20775,21297
REMKEL1.txt,98260,100045,1785,10,N,Y,1448039370049,20775,21297
REMKEL1.txt,98505,100220,1715,10,N,Y,1448039370049,20775,21297
REMKEL1.txt,98591,100420,1829,10,N,Y,1448322713112,221941,223038
REMKEL1.txt,98731,100551,1820,10,N,Y,1448322713112,221941,223038
REMKEL1.txt,98953,100619,1666,10,N,Y,1448322713112,221941,223038
REMKEL1.txt,99133,100823,1690,10,N,Y,1448322713112,221941,223038
REMKEL1.txt,99488,100937,1449,10,N,Y,1448322713112,221941,223038
REMKEL1.txt,99659,101050,1391,10,N,Y,1448322713112,221941,223038
REMKEL1.txt,99769,101350,1581,10,N,Y,1448322713112,221941,223038
REMKEL1.txt,99955,101403,1448,10,N,Y,1448322713112,221941,223038
REMKEL1.txt,100046,101605,1559,10,N,Y,1448322713112,221941,223038
REMKEL1.txt,100221,102092,1871,10,N,Y,1448322713112,221941,223038
REMKEL1.txt,100423,102284,1861,10,N,Y,1448322713112,221941,223038
REMKEL1.txt,100552,102367,1815,10,N,Y,1448322713112,221941,223038
REMKEL1.txt,100621,102747,2126,10,N,Y,1448322713112,221941,223038
REMKEL1.txt,100826,102766,1940,10,N,N,-,-1,-1
REMKEL1.txt,100938,102898,1960,10,N,N,-,-1,-1
REMKEL1.txt,101051,103050,1999,10,N,N,-,-1,-1
REMKEL1.txt,101351,103239,1888,10,N,N,-,-1,-1
REMKEL1.txt,101404,103339,1935,10,N,N,-,-1,-1
REMKEL1.txt,101606,103664,2058,10,N,Y,1448274893770,25386,26202
REMKEL1.txt,102095,103709,1614,10,N,Y,1448274893770,25386,26202
REMKEL1.txt,102285,103949,1664,10,N,Y,1448274893770,25386,26202
REMKEL1.txt,102368,104164,1796,10,N,Y,1448274893770,25386,26202
REMKEL1.txt,102752,104238,1486,10,N,Y,1448274893770,25386,26202
REMKEL1.txt,102767,104407,1640,10,N,Y,1448274893770,25386,26202
REMKEL1.txt,102899,104579,1680,10,N,Y,1448274893770,25386,26202
REMKEL1.txt,103051,104686,1635,10,N,Y,1448274893770,25386,26202
REMKEL1.txt,103242,104957,1715,10,N,Y,1448274893770,25386,26202
REMKEL1.txt,103341,105123,1782,10,Y,Y,1448274893770,25386,26202
REMKEL1.txt,103665,105292,1627,10,Y,Y,1448274893770,25386,26202
REMKEL1.txt,103710,105311,1601,10,Y,Y,1448274893770,25386,26202
REMKEL1.txt,103950,105445,1495,10,Y,Y,1448274893770,25386,26202
REMKEL1.txt,104165,105582,1417,10,Y,Y,1448274893770,25386,26202
REMKEL1.txt,104241,105646,1405,10,N,Y,1448274893770,25386,26202
REMKEL1.txt,104408,105891,1483,10,N,Y,1448274893770,25386,26202
REMKEL1.txt,104580,105942,1362,10,N,Y,1448274893770,25386,26202
REMKEL1.txt,104687,106135,1448,10,N,Y,1448274893770,25386,26202
REMKEL1.txt,104960,106342,1382,10,N,Y,1448274893770,25386,26202
REMKEL1.txt,105124,106624,1500,10,N,Y,1448274893770,25386,26202
REMKEL1.txt,105293,106854,1561,10,N,Y,1448274893770,25386,26202
REMKEL1.txt,105312,107038,1726,10,N,Y,1448274893770,25386,26202
REMKEL1.txt,105446,107175,1729,10,N,Y,1448274893770,25386,26202
REMKEL1.txt,105583,107368,1785,10,N,Y,1448274893770,25386,26202
REMKEL1.txt,105649,107443,1794,10,Y,Y,1448274893770,25386,26202
REMKEL1.txt,105892,107918,2026,10,N,Y,1448274893770,25386,26202
REMKEL1.txt,105943,108070,2127,10,N,Y,1448274893770,25386,26202
REMKEL1.txt,106138,108268,2130,10,N,Y,1448274893770,25386,26202
REMKEL1.txt,106343,108338,1995,10,N,Y,1448274893770,25386,26202
REMKEL1.txt,106625,108365,1740,10,N,Y,1448274893770,25386,26202
REMKEL1.txt,106855,108476,1621,10,N,Y,1448274893770,25386,26202
REMKEL1.txt,107041,108681,1640,10,N,Y,1448274893770,25386,26202
REMKEL1.txt,107176,109005,1829,10,N,Y,1448274893770,25386,26202
REMKEL1.txt,107369,109117,1748,10,N,Y,1448274893770,25386,26202
REMKEL1.txt,107445,109379,1934,10,N,Y,1448274893770,25386,26202
REMKEL1.txt,107919,109520,1601,10,N,Y,1448274893770,25386,26202
REMKEL1.txt,108071,109842,1771,10,Y,Y,1448274893770,25386,26202
REMKEL1.txt,108271,110047,1776,10,Y,Y,1448274893770,25386,26202
REMKEL1.txt,108339,110270,1931,10,Y,Y,1448274893770,25386,26202
REMKEL1.txt,108366,110492,2126,10,Y,Y,1448274893770,25386,26202
REMKEL1.txt,108477,110623,2146,10,N,Y,1448274893770,25386,26202
REMKEL1.txt,108682,110719,2037,10,N,Y,1448274893770,25386,26202
REMKEL1.txt,109006,110815,1809,10,N,Y,1448274893770,25386,26202
REMKEL1.txt,109120,111061,1941,10,N,Y,1448279941918,72406,72905
REMKEL1.txt,109382,111084,1702,10,N,Y,1448279941918,72406,72905
REMKEL1.txt,109521,111254,1733,10,N,Y,1448279941918,72406,72905
REMKEL1.txt,109845,111433,1588,10,N,N,-,-1,-1
REMKEL1.txt,110048,111562,1514,10,N,N,-,-1,-1
REMKEL1.txt,110271,111655,1384,10,N,N,-,-1,-1
REMKEL1.txt,110494,111974,1480,10,N,N,-,-1,-1
REMKEL1.txt,110624,112063,1439,10,N,N,-,-1,-1
REMKEL1.txt,110720,112204,1484,10,N,N,-,-1,-1
REMKEL1.txt,110818,112240,1422,10,N,N,-,-1,-1
REMKEL1.txt,111062,112387,1325,10,N,N,-,-1,-1
REMKEL1.txt,111085,112399,1314,10,N,N,-,-1,-1
REMKEL1.txt,111257,112614,1357,10,N,N,-,-1,-1
REMKEL1.txt,111434,112818,1384,10,N,N,-,-1,-1
REMKEL1.txt,111565,112948,1383,10,N,N,-,-1,-1
REMKEL1.txt,111656,113048,1392,10,N,N,-,-1,-1
REMKEL1.txt,111977,113166,1189,10,N,N,-,-1,-1
REMKEL1.txt,112064,113408,1344,10,N,N,-,-1,-1
REMKEL1.txt,112205,113589,1384,10,Y,N,-,-1,-1
REMKEL1.txt,112241,113702,1461,10,Y,N,-,-1,-1
REMKEL1.txt,112388,113910,1522,10,Y,N,-,-1,-1
REMKEL1.txt,112402,113979,1577,10,Y,N,-,-1,-1
REMKEL1.txt,112619,114039,1420,10,Y,N,-,-1,-1
REMKEL1.txt,112821,114252,1431,10,N,N,-,-1,-1
REMKEL1.txt,112949,114350,1401,10,N,Y,1448310549245,137491,141408
REMKEL1.txt,113049,114454,1405,10,N,Y,1448310549245,137491,141408
REMKEL1.txt,113168,114577,1409,10,N,Y,1448310549245,137491,141408
REMKEL1.txt,113409,114638,1229,10,N,Y,1448310549245,137491,141408
REMKEL1.txt,113590,114733,1143,10,N,Y,1448310549245,137491,141408
REMKEL1.txt,113703,115061,1358,10,N,Y,1448310549245,137491,141408
REMKEL1.txt,113911,115303,1392,10,N,Y,1448310549245,137491,141408
REMKEL1.txt,113980,115679,1699,10,N,Y,1448310549245,137491,141408
REMKEL1.txt,114040,115907,1867,10,N,Y,1448310549245,137491,141408
REMKEL1.txt,114255,116021,1766,10,Y,Y,1448310549245,137491,141408
REMKEL1.txt,114352,116133,1781,10,Y,Y,1448310549245,137491,141408
REMKEL1.txt,114456,116361,1905,10,Y,Y,1448310549245,137491,141408
REMKEL1.txt,114578,116405,1827,10,N,Y,1448310549245,137491,141408
REMKEL1.txt,114639,116677,2038,10,Y,Y,1448310549245,137491,141408
REMKEL1.txt,114734,116704,1970,10,N,Y,1448310549245,137491,141408
REMKEL1.txt,115062,116833,1771,10,N,Y,1448310549245,137491,141408
REMKEL1.txt,115304,116891,1587,10,N,N,-,-1,-1
REMKEL1.txt,115680,117064,1384,10,N,N,-,-1,-1
REMKEL1.txt,115909,117226,1317,10,N,N,-,-1,-1
REMKEL1.txt,116022,117343,1321,10,N,N,-,-1,-1
REMKEL1.txt,116134,117448,1314,10,N,N,-,-1,-1
REMKEL1.txt,116362,117840,1478,10,N,N,-,-1,-1
REMKEL1.txt,116406,117938,1532,10,N,N,-,-1,-1
REMKEL1.txt,116680,118173,1493,10,N,N,-,-1,-1
REMKEL1.txt,116705,118222,1517,10,N,N,-,-1,-1
REMKEL1.txt,116834,118303,1469,10,N,N,-,-1,-1
REMKEL1.txt,116892,118398,1506,10,N,N,-,-1,-1
REMKEL1.txt,117065,118628,1563,10,Y,N,-,-1,-1
REMKEL1.txt,117227,118794,1567,10,N,N,-,-1,-1
REMKEL1.txt,117344,118893,1549,10,N,N,-,-1,-1
REMKEL1.txt,117450,119049,1599,10,N,N,-,-1,-1
REMKEL1.txt,117841,119233,1392,10,N,N,-,-1,-1
REMKEL1.txt,117939,119407,1468,10,N,N,-,-1,-1
REMKEL1.txt,118174,119609,1435,10,N,N,-,-1,-1
REMKEL1.txt,118223,119677,1454,10,N,Y,1448311594480,155711,156312
REMKEL1.txt,118304,119879,1575,10,N,Y,1448311594480,155711,156312
REMKEL1.txt,118399,120020,1621,10,N,Y,1448311594480,155711,156312
REMKEL1.txt,118631,120176,1545,10,N,Y,1448311594480,155711,156312
REMKEL1.txt,118795,120247,1452,10,N,Y,1448311594480,155711,156312
REMKEL1.txt,118894,120418,1524,10,N,Y,1448311594480,155711,156312
REMKEL1.txt,119052,120568,1516,10,N,Y,1448311594480,155711,156312
REMKEL1.txt,119234,120835,1601,10,N,Y,1448311594480,155711,156312
REMKEL1.txt,119408,120902,1494,10,N,Y,1448311594480,155711,156312
REMKEL1.txt,119612,120987,1375,10,N,Y,1448311594480,155711,156312
REMKEL1.txt,119678,121062,1384,10,N,Y,1448311594480,155711,156312
REMKEL1.txt,119880,121081,1201,10,N,Y,1448311594480,155711,156312
REMKEL1.txt,120021,121125,1104,10,N,Y,1448311594480,155711,156312
REMKEL1.txt,120177,121170,993,10,N,Y,1448311594480,155711,156312
REMKEL1.txt,120248,121210,962,10,N,Y,1448311594480,155711,156312
REMKEL1.txt,120419,121231,812,10,N,Y,1448311594480,155711,156312
REMKEL1.txt,120569,121259,690,10,N,Y,1448311594480,155711,156312
REMKEL1.txt,120838,121382,544,10,N,N,-,-1,-1
REMKEL1.txt,120903,121439,536,10,N,N,-,-1,-1
REMKEL1.txt,120988,121464,476,10,N,N,-,-1,-1
REMKEL1.txt,121063,121486,423,10,N,N,-,-1,-1
REMKEL1.txt,121086,121510,424,10,N,N,-,-1,-1
REMKEL1.txt,121126,121537,411,10,N,N,-,-1,-1
REMKEL1.txt,121171,121562,391,10,N,N,-,-1,-1
REMKEL1.txt,121211,121656,445,10,N,N,-,-1,-1
REMKEL1.txt,121232,121793,561,10,N,N,-,-1,-1
REMKEL1.txt,121260,121880,620,10,N,N,-,-1,-1
REMKEL1.txt,121383,122010,627,10,N,N,-,-1,-1
REMKEL1.txt,121440,122229,789,10,N,N,-,-1,-1
REMKEL1.txt,121465,122510,1045,10,N,N,-,-1,-1
REMKEL1.txt,121487,122543,1056,10,N,N,-,-1,-1
REMKEL1.txt,121511,122716,1205,10,N,N,-,-1,-1
REMKEL1.txt,121538,123123,1585,10,N,N,-,-1,-1
REMKEL1.txt,121563,123382,1819,10,N,N,-,-1,-1
REMKEL1.txt,121657,123727,2070,10,N,N,-,-1,-1
REMKEL1.txt,121794,123815,2021,10,N,N,-,-1,-1
REMKEL1.txt,121881,123964,2083,10,N,N,-,-1,-1
REMKEL1.txt,122013,124058,2045,10,N,N,-,-1,-1
REMKEL1.txt,122230,124249,2019,10,N,N,-,-1,-1
REMKEL1.txt,122511,124375,1864,10,N,N,-,-1,-1
REMKEL1.txt,122546,124527,1981,10,N,N,-,-1,-1
REMKEL1.txt,122717,124715,1998,10,N,N,-,-1,-1
REMKEL1.txt,123124,124907,1783,10,N,N,-,-1,-1
REMKEL1.txt,123385,125111,1726,10,N,Y,1448314402792,179959,180202
REMKEL1.txt,123728,125327,1599,10,N,Y,1448314402792,179959,180202
REMKEL1.txt,123816,125384,1568,10,N,Y,1448314402792,179959,180202
REMKEL1.txt,123965,125675,1710,10,N,Y,1448314402792,179959,180202
REMKEL1.txt,124059,125758,1699,10,N,Y,1448314402792,179959,180202
REMKEL1.txt,124252,125870,1618,10,N,Y,1448314402792,179959,180202
REMKEL1.txt,124376,125958,1582,10,N,Y,1448314402792,179959,180202
REMKEL1.txt,124530,126091,1561,10,N,Y,1448314402792,179959,180202
REMKEL1.txt,124716,126213,1497,10,N,Y,1448314402792,179959,180202
REMKEL1.txt,124910,126357,1447,10,N,Y,1448314402792,179959,180202
REMKEL1.txt,125112,126591,1479,10,N,Y,1448314402792,179959,180202
REMKEL1.txt,125328,126981,1653,10,N,Y,1448314402792,179959,180202
REMKEL1.txt,125386,127280,1894,10,N,Y,1448314402792,179959,180202
REMKEL1.txt,125676,127530,1854,10,N,Y,1448314402792,179959,180202
REMKEL1.txt,125759,127785,2026,10,N,Y,1448314402792,179959,180202
REMKEL1.txt,125872,127895,2023,10,N,Y,1448314402792,179959,180202
REMKEL1.txt,125959,127955,1996,10,N,Y,1448314402792,179959,180202
REMKEL1.txt,126094,128061,1967,10,N,N,-,-1,-1
REMKEL1.txt,126214,128113,1899,10,N,N,-,-1,-1
REMKEL1.txt,126360,128160,1800,10,N,N,-,-1,-1
REMKEL1.txt,126592,128181,1589,10,N,N,-,-1,-1
REMKEL1.txt,126982,128323,1341,10,N,N,-,-1,-1
REMKEL1.txt,127283,128554,1271,10,N,N,-,-1,-1
REMKEL1.txt,127531,128736,1205,10,N,N,-,-1,-1
REMKEL1.txt,127786,129134,1348,10,N,N,-,-1,-1
REMKEL1.txt,127896,129233,1337,10,N,N,-,-1,-1
REMKEL1.txt,127956,129370,1414,10,N,N,-,-1,-1
REMKEL1.txt,128062,129515,1453,10,N,N,-,-1,-1
REMKEL1.txt,128114,129532,1418,10,N,N,-,-1,-1
REMKEL1.txt,128162,129550,1388,10,N,N,-,-1,-1
REMKEL1.txt,128182,129846,1664,10,N,N,-,-1,-1
REMKEL1.txt,128326,130068,1742,10,N,N,-,-1,-1
REMKEL1.txt,128555,130238,1683,10,N,N,-,-1,-1
REMKEL1.txt,128738,130478,1740,10,N,N,-,-1,-1
REMKEL1.txt,129137,130633,1496,10,Y,N,-,-1,-1
REMKEL1.txt,129235,130769,1534,10,Y,N,-,-1,-1
REMKEL1.txt,129371,130822,1451,10,N,N,-,-1,-1
REMKEL1.txt,129517,130846,1329,10,N,N,-,-1,-1
REMKEL1.txt,129533,130926,1393,10,N,N,-,-1,-1
REMKEL1.txt,129551,131235,1684,10,N,N,-,-1,-1
REMKEL1.txt,129847,131643,1796,10,N,N,-,-1,-1
REMKEL1.txt,130069,132004,1935,10,N,N,-,-1,-1
REMKEL1.txt,130239,132162,1923,10,N,N,-,-1,-1
REMKEL1.txt,130481,132307,1826,10,N,N,-,-1,-1
REMKEL1.txt,130634,132486,1852,10,N,N,-,-1,-1
REMKEL1.txt,130770,132612,1842,10,N,N,-,-1,-1
REMKEL1.txt,130823,132749,1926,10,N,N,-,-1,-1
REMKEL1.txt,130847,132942,2095,10,N,N,-,-1,-1
REMKEL1.txt,130927,133070,2143,10,N,N,-,-1,-1
REMKEL1.txt,131236,133245,2009,10,N,N,-,-1,-1
REMKEL1.txt,131646,133514,1868,10,N,N,-,-1,-1
REMKEL1.txt,132005,133645,1640,10,N,N,-,-1,-1
REMKEL1.txt,132163,133658,1495,10,N,N,-,-1,-1
REMKEL1.txt,132309,133823,1514,10,N,N,-,-1,-1
REMKEL1.txt,132487,133966,1479,10,N,N,-,-1,-1
REMKEL1.txt,132614,134068,1454,10,N,N,-,-1,-1
REMKEL1.txt,132750,134117,1367,10,N,N,-,-1,-1
REMKEL1.txt,132945,134682,1737,10,N,N,-,-1,-1
REMKEL1.txt,133071,134760,1689,10,N,N,-,-1,-1
REMKEL1.txt,133246,135010,1764,10,N,N,-,-1,-1
REMKEL1.txt,133515,135143,1628,10,N,N,-,-1,-1
REMKEL1.txt,133646,135654,2008,10,N,N,-,-1,-1
REMKEL1.txt,133659,135801,2142,10,N,N,-,-1,-1
REMKEL1.txt,133824,135894,2070,10,N,N,-,-1,-1
REMKEL1.txt,133967,136006,2039,10,N,N,-,-1,-1
REMKEL1.txt,134069,136101,2032,10,N,N,-,-1,-1
REMKEL1.txt,134118,136364,2246,10,N,N,-,-1,-1
REMKEL1.txt,134685,136433,1748,10,N,N,-,-1,-1
REMKEL1.txt,134761,136499,1738,10,N,N,-,-1,-1
REMKEL1.txt,135011,136674,1663,10,N,N,-,-1,-1
REMKEL1.txt,135144,136694,1550,10,N,N,-,-1,-1
REMKEL1.txt,135655,136745,1090,10,N,N,-,-1,-1
REMKEL1.txt,135802,136887,1085,10,N,N,-,-1,-1
REMKEL1.txt,135895,136989,1094,10,N,N,-,-1,-1
REMKEL1.txt,136009,137091,1082,10,N,N,-,-1,-1
REMKEL1.txt,136103,137391,1288,10,N,N,-,-1,-1
REMKEL1.txt,136367,137453,1086,10,N,N,-,-1,-1
REMKEL1.txt,136434,137732,1298,10,N,N,-,-1,-1
REMKEL1.txt,136500,137860,1360,10,N,N,-,-1,-1
REMKEL1.txt,136675,138171,1496,10,N,N,-,-1,-1
REMKEL1.txt,136696,138310,1614,10,Y,N,-,-1,-1
REMKEL1.txt,136747,138387,1640,10,N,N,-,-1,-1
REMKEL1.txt,136888,138672,1784,10,Y,N,-,-1,-1
REMKEL1.txt,136990,138756,1766,10,Y,N,-,-1,-1
REMKEL1.txt,137092,138847,1755,10,Y,N,-,-1,-1
REMKEL1.txt,137392,139009,1617,10,N,N,-,-1,-1
REMKEL1.txt,137454,139106,1652,10,N,N,-,-1,-1
REMKEL1.txt,137733,139347,1614,10,N,N,-,-1,-1
REMKEL1.txt,137865,139387,1522,10,Y,N,-,-1,-1
REMKEL1.txt,138174,139541,1367,10,N,N,-,-1,-1
REMKEL1.txt,138311,139607,1296,10,N,N,-,-1,-1
REMKEL1.txt,138388,139693,1305,10,N,N,-,-1,-1
REMKEL1.txt,138674,139840,1166,10,N,N,-,-1,-1
REMKEL1.txt,138757,139941,1184,10,N,N,-,-1,-1
REMKEL1.txt,138848,140087,1239,10,N,N,-,-1,-1
REMKEL1.txt,139010,140311,1301,10,N,N,-,-1,-1
REMKEL1.txt,139109,140393,1284,10,N,N,-,-1,-1
REMKEL1.txt,139348,140688,1340,10,N,N,-,-1,-1
REMKEL1.txt,139388,140999,1611,10,N,N,-,-1,-1
REMKEL1.txt,139542,141129,1587,10,N,N,-,-1,-1
REMKEL1.txt,139608,141194,1586,10,N,N,-,-1,-1
REMKEL1.txt,139694,141339,1645,10,N,N,-,-1,-1
REMKEL1.txt,139841,141457,1616,10,N,N,-,-1,-1
REMKEL1.txt,139942,141522,1580,10,N,N,-,-1,-1
REMKEL1.txt,140090,141761,1671,10,N,N,-,-1,-1
REMKEL1.txt,140312,142070,1758,10,N,N,-,-1,-1
REMKEL1.txt,140394,142107,1713,10,N,N,-,-1,-1
REMKEL1.txt,140689,142256,1567,10,N,N,-,-1,-1
REMKEL1.txt,141000,142347,1347,10,N,Y,1448311811907,157566,161100
REMKEL1.txt,141130,142489,1359,10,N,Y,1448311811907,157566,161100
REMKEL1.txt,141195,142579,1384,10,N,Y,1448311811907,157566,161100
REMKEL1.txt,141340,142845,1505,10,N,Y,1448311811907,157566,161100
REMKEL1.txt,141460,143270,1810,10,N,Y,1448311811907,157566,161100
REMKEL1.txt,141523,143462,1939,10,N,Y,1448311811907,157566,161100
REMKEL1.txt,141762,143583,1821,10,N,Y,1448311811907,157566,161100
REMKEL1.txt,142071,143691,1620,10,N,Y,1448311811907,157566,161100
REMKEL1.txt,142108,143861,1753,10,N,Y,1448311811907,157566,161100
REMKEL1.txt,142259,144247,1988,10,N,Y,1448311811907,157566,161100
REMKEL1.txt,142348,144305,1957,10,N,Y,1448311811907,157566,161100
REMKEL1.txt,142490,144592,2102,10,N,Y,1448311811907,157566,161100
REMKEL1.txt,142580,144780,2200,10,N,Y,1448311811907,157566,161100
REMKEL1.txt,142846,144899,2053,10,N,Y,1448311811907,157566,161100
REMKEL1.txt,143271,144977,1706,10,N,Y,1448311811907,157566,161100
REMKEL1.txt,143467,144996,1529,10,N,N,-,-1,-1
REMKEL1.txt,143584,145163,1579,10,N,N,-,-1,-1
REMKEL1.txt,143692,145341,1649,10,N,N,-,-1,-1
REMKEL1.txt,143862,145555,1693,10,N,N,-,-1,-1
REMKEL1.txt,144250,145635,1385,10,N,N,-,-1,-1
REMKEL1.txt,144306,145764,1458,10,N,N,-,-1,-1
REMKEL1.txt,144593,145883,1290,10,N,N,-,-1,-1
REMKEL1.txt,144782,145940,1158,10,N,N,-,-1,-1
REMKEL1.txt,144900,146032,1132,10,N,N,-,-1,-1
REMKEL1.txt,144982,146118,1136,10,N,N,-,-1,-1
REMKEL1.txt,144997,146302,1305,10,N,N,-,-1,-1
REMKEL1.txt,145164,146430,1266,10,N,N,-,-1,-1
REMKEL1.txt,145342,146757,1415,10,N,N,-,-1,-1
REMKEL1.txt,145556,146898,1342,10,N,N,-,-1,-1
REMKEL1.txt,145636,147160,1524,10,N,N,-,-1,-1
REMKEL1.txt,145766,147452,1686,10,N,N,-,-1,-1
REMKEL1.txt,145884,147775,1891,10,N,N,-,-1,-1
REMKEL1.txt,145943,147917,1974,10,N,N,-,-1,-1
REMKEL1.txt,146033,147984,1951,10,N,N,-,-1,-1
REMKEL1.txt,146119,148185,2066,10,N,N,-,-1,-1
REMKEL1.txt,146304,148253,1949,10,N,N,-,-1,-1
REMKEL1.txt,146431,148422,1991,10,N,N,-,-1,-1
REMKEL1.txt,146758,148511,1753,10,N,N,-,-1,-1
REMKEL1.txt,146900,148689,1789,10,Y,N,-,-1,-1
REMKEL1.txt,147161,148868,1707,10,N,N,-,-1,-1
REMKEL1.txt,147453,148997,1544,10,N,N,-,-1,-1
REMKEL1.txt,147776,149212,1436,10,N,N,-,-1,-1
REMKEL1.txt,147920,149456,1536,10,N,N,-,-1,-1
REMKEL1.txt,147985,149488,1503,10,N,N,-,-1,-1
REMKEL1.txt,148186,149689,1503,10,Y,N,-,-1,-1
REMKEL1.txt,148254,149727,1473,10,Y,N,-,-1,-1
REMKEL1.txt,148423,149784,1361,10,N,N,-,-1,-1
REMKEL1.txt,148512,149908,1396,10,Y,N,-,-1,-1
REMKEL1.txt,148691,149970,1279,10,N,N,-,-1,-1
REMKEL1.txt,148871,150052,1181,10,N,N,-,-1,-1
REMKEL1.txt,148998,150324,1326,10,N,N,-,-1,-1
REMKEL1.txt,149215,150468,1253,10,N,N,-,-1,-1
REMKEL1.txt,149457,150745,1288,10,N,N,-,-1,-1
REMKEL1.txt,149491,150768,1277,10,N,N,-,-1,-1
REMKEL1.txt,149692,150879,1187,10,N,Y,1448315012079,181380,182053
REMKEL1.txt,149728,151098,1370,10,N,Y,1448315012079,181380,182053
REMKEL1.txt,149785,151245,1460,10,N,Y,1448315012079,181380,182053
REMKEL1.txt,149911,151370,1459,10,N,Y,1448315012079,181380,182053
REMKEL1.txt,149973,151546,1573,10,N,Y,1448315012079,181380,182053
REMKEL1.txt,150053,151803,1750,10,N,Y,1448315012079,181380,182053
REMKEL1.txt,150325,151927,1602,10,N,Y,1448315012079,181380,182053
REMKEL1.txt,150470,152121,1651,10,N,Y,1448315012079,181380,182053
REMKEL1.txt,150748,152147,1399,10,N,Y,1448315012079,181380,182053
REMKEL1.txt,150769,152233,1464,10,N,Y,1448315012079,181380,182053
REMKEL1.txt,150880,152278,1398,10,N,Y,1448315012079,181380,182053
REMKEL1.txt,151099,152417,1318,10,N,Y,1448315012079,181380,182053
REMKEL1.txt,151246,152562,1316,10,N,Y,1448315012079,181380,182053
REMKEL1.txt,151372,152972,1600,10,N,Y,1437476486340,221621,222520
REMKEL1.txt,151547,153032,1485,10,N,Y,1437476486340,221621,222520
REMKEL1.txt,151806,153159,1353,10,N,Y,1437476486340,221621,222520
REMKEL1.txt,151928,153286,1358,10,N,Y,1437476486340,221621,222520
REMKEL1.txt,152122,153393,1271,10,N,Y,1437476486340,221621,222520
REMKEL1.txt,152148,153523,1375,10,N,Y,1437476486340,221621,222520
REMKEL1.txt,152234,153618,1384,10,N,Y,1437476486340,221621,222520
REMKEL1.txt,152280,153811,1531,10,Y,Y,1437476486340,221621,222520
REMKEL1.txt,152418,154015,1597,10,Y,Y,1437476486340,221621,222520
REMKEL1.txt,152563,154093,1530,10,Y,Y,1437476486340,221621,222520
REMKEL1.txt,152975,154283,1308,10,Y,N,-,-1,-1
REMKEL1.txt,153033,154362,1329,10,Y,N,-,-1,-1
REMKEL1.txt,153161,154461,1300,10,Y,N,-,-1,-1
REMKEL1.txt,153287,154494,1207,10,Y,N,-,-1,-1
REMKEL1.txt,153394,154673,1279,10,N,N,-,-1,-1
REMKEL1.txt,153524,154746,1222,10,N,N,-,-1,-1
REMKEL1.txt,153619,154829,1210,10,N,N,-,-1,-1
REMKEL1.txt,153812,154910,1098,10,N,N,-,-1,-1
REMKEL1.txt,154016,155006,990,10,N,N,-,-1,-1
REMKEL1.txt,154095,155322,1227,10,N,N,-,-1,-1
REMKEL1.txt,154286,155364,1078,10,N,N,-,-1,-1
REMKEL1.txt,154363,155443,1080,10,N,N,-,-1,-1
REMKEL1.txt,154462,155518,1056,10,N,N,-,-1,-1
REMKEL1.txt,154495,155607,1112,10,N,N,-,-1,-1
REMKEL1.txt,154674,155676,1002,10,N,N,-,-1,-1
REMKEL1.txt,154747,155949,1202,10,N,N,-,-1,-1
REMKEL1.txt,154831,156109,1278,10,N,N,-,-1,-1
REMKEL1.txt,154911,156221,1310,10,N,N,-,-1,-1
REMKEL1.txt,155008,156332,1324,10,Y,N,-,-1,-1
REMKEL1.txt,155323,156393,1070,10,Y,N,-,-1,-1
REMKEL1.txt,155365,156495,1130,10,Y,N,-,-1,-1
REMKEL1.txt,155444,156571,1127,10,N,N,-,-1,-1
REMKEL1.txt,155519,156862,1343,10,N,N,-,-1,-1
REMKEL1.txt,155608,157202,1594,10,N,N,-,-1,-1
REMKEL1.txt,155678,157349,1671,10,N,N,-,-1,-1
REMKEL1.txt,155950,157415,1465,10,N,N,-,-1,-1
REMKEL1.txt,156110,157583,1473,10,N,N,-,-1,-1
REMKEL1.txt,156224,157728,1504,10,N,N,-,-1,-1
REMKEL1.txt,156333,157859,1526,10,N,N,-,-1,-1
REMKEL1.txt,156394,157975,1581,10,N,N,-,-1,-1
REMKEL1.txt,156497,158299,1802,10,N,N,-,-1,-1
REMKEL1.txt,156572,158492,1920,10,N,N,-,-1,-1
REMKEL1.txt,156865,158644,1779,10,N,N,-,-1,-1
REMKEL1.txt,157203,158705,1502,10,N,N,-,-1,-1
REMKEL1.txt,157352,158916,1564,10,N,N,-,-1,-1
REMKEL1.txt,157418,159031,1613,10,N,N,-,-1,-1
REMKEL1.txt,157584,159101,1517,10,N,N,-,-1,-1
REMKEL1.txt,157729,159127,1398,10,N,N,-,-1,-1
REMKEL1.txt,157860,159190,1330,10,N,N,-,-1,-1
REMKEL1.txt,157976,159449,1473,10,Y,N,-,-1,-1
REMKEL1.txt,158300,159492,1192,10,N,N,-,-1,-1
REMKEL1.txt,158493,159893,1400,10,Y,N,-,-1,-1
REMKEL1.txt,158645,160132,1487,10,Y,N,-,-1,-1
REMKEL1.txt,158707,160278,1571,10,Y,N,-,-1,-1
REMKEL1.txt,158917,160531,1614,10,Y,N,-,-1,-1
REMKEL1.txt,159032,160572,1540,10,Y,N,-,-1,-1
REMKEL1.txt,159102,160684,1582,10,Y,N,-,-1,-1
REMKEL1.txt,159128,161031,1903,10,Y,N,-,-1,-1
REMKEL1.txt,159193,161151,1958,10,Y,N,-,-1,-1
REMKEL1.txt,159450,161327,1877,10,N,N,-,-1,-1
REMKEL1.txt,159493,161600,2107,10,N,N,-,-1,-1
REMKEL1.txt,159896,161732,1836,10,N,N,-,-1,-1
REMKEL1.txt,160133,161902,1769,10,N,N,-,-1,-1
REMKEL1.txt,160281,161983,1702,10,N,N,-,-1,-1
REMKEL1.txt,160532,162171,1639,10,N,N,-,-1,-1
REMKEL1.txt,160575,162230,1655,10,N,N,-,-1,-1
REMKEL1.txt,160685,162511,1826,10,N,N,-,-1,-1
REMKEL1.txt,161034,162636,1602,10,N,N,-,-1,-1
REMKEL1.txt,161152,162730,1578,10,N,N,-,-1,-1
REMKEL1.txt,161328,162839,1511,10,N,N,-,-1,-1
REMKEL1.txt,161601,162892,1291,10,N,N,-,-1,-1
REMKEL1.txt,161733,163105,1372,10,N,N,-,-1,-1
REMKEL1.txt,161903,163374,1471,10,N,N,-,-1,-1
REMKEL1.txt,161985,163438,1453,10,N,Y,1448323072174,227638,227786
REMKEL1.txt,162174,163590,1416,10,Y,Y,1448323072174,227638,227786
REMKEL1.txt,162231,163707,1476,10,Y,Y,1448323072174,227638,227786
REMKEL1.txt,162512,163823,1311,10,N,Y,1448323072174,227638,227786
REMKEL1.txt,162637,164032,1395,10,N,Y,1448323072174,227638,227786
REMKEL1.txt,162733,164330,1597,10,N,Y,1448323072174,227638,227786
REMKEL1.txt,162840,164563,1723,10,N,Y,1448323072174,227638,227786
REMKEL1.txt,162893,164615,1722,10,N,Y,1448323072174,227638,227786
REMKEL1.txt,163106,164632,1526,10,N,Y,1448323072174,227638,227786
REMKEL1.txt,163377,164962,1585,10,N,Y,1448323072174,227638,227786
REMKEL1.txt,163439,165150,1711,10,N,Y,1448323072174,227638,227786
REMKEL1.txt,163591,165273,1682,10,N,Y,1448323072174,227638,227786
REMKEL1.txt,163708,165392,1684,10,N,Y,1448323072174,227638,227786
REMKEL1.txt,163825,165679,1854,10,N,Y,1448323072174,227638,227786
REMKEL1.txt,164035,165864,1829,10,N,Y,1448323072174,227638,227786
REMKEL1.txt,164331,166072,1741,10,N,Y,1448275407308,26987,29181
REMKEL1.txt,164564,166151,1587,10,N,Y,1448275407308,26987,29181
REMKEL1.txt,164616,166366,1750,10,N,Y,1448275407308,26987,29181
REMKEL1.txt,164633,166372,1739,10,N,Y,1448275407308,26987,29181
REMKEL1.txt,164963,166400,1437,10,N,Y,1448275407308,26987,29181
REMKEL1.txt,165151,166511,1360,10,N,Y,1448275407308,26987,29181
REMKEL1.txt,165276,166595,1319,10,N,Y,1448275407308,26987,29181
REMKEL1.txt,165393,166728,1335,10,N,Y,1448275407308,26987,29181
REMKEL1.txt,165680,166777,1097,10,N,Y,1448275407308,26987,29181
REMKEL1.txt,165867,167204,1337,10,N,Y,1448275407308,26987,29181
REMKEL1.txt,166073,167353,1280,10,N,Y,1448275407308,26987,29181
REMKEL1.txt,166152,167440,1288,10,Y,Y,1448275407308,26987,29181
REMKEL1.txt,166367,167580,1213,10,Y,Y,1448275407308,26987,29181
REMKEL1.txt,166373,167624,1251,10,Y,Y,1448275407308,26987,29181
REMKEL1.txt,166401,167759,1358,10,Y,Y,1448275407308,26987,29181
REMKEL1.txt,166512,167833,1321,10,Y,Y,1448275407308,26987,29181
REMKEL1.txt,166597,167865,1268,10,Y,Y,1448275407308,26987,29181
REMKEL1.txt,166729,167909,1180,10,Y,Y,1448275407308,26987,29181
REMKEL1.txt,166778,167985,1207,10,Y,Y,1448275407308,26987,29181
REMKEL1.txt,167205,168367,1162,10,Y,Y,1448275407308,26987,29181
REMKEL1.txt,167354,168438,1084,10,Y,Y,1448275407308,26987,29181
REMKEL1.txt,167441,168498,1057,10,N,N,-,-1,-1
REMKEL1.txt,167581,168544,963,10,N,N,-,-1,-1
REMKEL1.txt,167625,168981,1356,10,Y,N,-,-1,-1
REMKEL1.txt,167761,169156,1395,10,Y,N,-,-1,-1
REMKEL1.txt,167834,169254,1420,10,Y,N,-,-1,-1
REMKEL1.txt,167867,169568,1701,10,Y,N,-,-1,-1
REMKEL1.txt,167910,169728,1818,10,Y,N,-,-1,-1
REMKEL1.txt,167986,169837,1851,10,N,N,-,-1,-1
REMKEL1.txt,168370,169968,1598,10,N,Y,1448281888079,98877,102290
REMKEL1.txt,168439,170143,1704,10,N,Y,1448281888079,98877,102290
REMKEL1.txt,168499,170213,1714,10,N,Y,1448281888079,98877,102290
REMKEL1.txt,168545,170387,1842,10,Y,Y,1448281888079,98877,102290
REMKEL1.txt,168982,170518,1536,10,N,Y,1448281888079,98877,102290
REMKEL1.txt,169157,170840,1683,10,N,Y,1448281888079,98877,102290
REMKEL1.txt,169255,171022,1767,10,Y,Y,1448281888079,98877,102290
REMKEL1.txt,169569,171189,1620,10,Y,Y,1448281888079,98877,102290
REMKEL1.txt,169729,171365,1636,10,Y,Y,1448281888079,98877,102290
REMKEL1.txt,169840,171662,1822,10,Y,Y,1448281888079,98877,102290
REMKEL1.txt,169969,171828,1859,10,Y,Y,1448281888079,98877,102290
REMKEL1.txt,170145,171938,1793,10,Y,Y,1448281888079,98877,102290
REMKEL1.txt,170214,172006,1792,10,Y,Y,1448281888079,98877,102290
REMKEL1.txt,170390,172078,1688,10,Y,Y,1448322979449,227304,227638
REMKEL1.txt,170519,172173,1654,10,Y,Y,1448322979449,227304,227638
REMKEL1.txt,170842,172283,1441,10,Y,Y,1448322979449,227304,227638
REMKEL1.txt,171023,172428,1405,10,Y,Y,1448322979449,227304,227638
REMKEL1.txt,171190,172569,1379,10,Y,Y,1448322979449,227304,227638
REMKEL1.txt,171366,172685,1319,10,N,Y,1448322979449,227304,227638
REMKEL1.txt,171663,172786,1123,10,N,Y,1448322979449,227304,227638
REMKEL1.txt,171831,172928,1097,10,N,Y,1448322979449,227304,227638
REMKEL1.txt,171939,173056,1117,10,N,Y,1448322979449,227304,227638
REMKEL1.txt,172007,173110,1103,10,N,Y,1448322979449,227304,227638
REMKEL1.txt,172079,173235,1156,10,N,Y,1448322979449,227304,227638
REMKEL1.txt,172174,173365,1191,10,N,Y,1448322979449,227304,227638
REMKEL1.txt,172285,173922,1637,10,N,N,-,-1,-1
REMKEL1.txt,172429,174022,1593,10,N,N,-,-1,-1
REMKEL1.txt,172572,174160,1588,10,N,N,-,-1,-1
REMKEL1.txt,172686,174373,1687,10,Y,N,-,-1,-1
REMKEL1.txt,172787,174494,1707,10,Y,N,-,-1,-1
REMKEL1.txt,172929,174980,2051,10,Y,N,-,-1,-1
REMKEL1.txt,173057,175083,2026,10,Y,N,-,-1,-1
REMKEL1.txt,173112,175202,2090,10,Y,N,-,-1,-1
REMKEL1.txt,173236,175444,2208,10,Y,N,-,-1,-1
REMKEL1.txt,173368,175623,2255,10,Y,N,-,-1,-1
REMKEL1.txt,173923,175842,1919,10,Y,N,-,-1,-1
REMKEL1.txt,174023,175863,1840,10,Y,N,-,-1,-1
REMKEL1.txt,174163,175939,1776,10,Y,N,-,-1,-1
REMKEL1.txt,174374,176014,1640,10,N,N,-,-1,-1
REMKEL1.txt,174497,176204,1707,10,N,N,-,-1,-1
REMKEL1.txt,174981,176313,1332,10,N,N,-,-1,-1
REMKEL1.txt,175086,176720,1634,10,N,N,-,-1,-1
REMKEL1.txt,175203,176803,1600,10,N,N,-,-1,-1
REMKEL1.txt,175445,176940,1495,10,N,N,-,-1,-1
REMKEL1.txt,175624,177079,1455,10,N,N,-,-1,-1
REMKEL1.txt,175843,177299,1456,10,N,N,-,-1,-1
REMKEL1.txt,175864,177454,1590,10,N,N,-,-1,-1
REMKEL1.txt,175942,177519,1577,10,N,N,-,-1,-1
REMKEL1.txt,176015,177651,1636,10,N,N,-,-1,-1
REMKEL1.txt,176205,177712,1507,10,N,N,-,-1,-1
REMKEL1.txt,176316,177910,1594,10,N,N,-,-1,-1
REMKEL1.txt,176722,178159,1437,10,N,N,-,-1,-1
REMKEL1.txt,176804,178287,1483,10,N,N,-,-1,-1
REMKEL1.txt,176941,178519,1578,10,N,N,-,-1,-1
REMKEL1.txt,177082,178590,1508,10,N,N,-,-1,-1
REMKEL1.txt,177300,178661,1361,10,N,N,-,-1,-1
REMKEL1.txt,177455,178824,1369,10,N,N,-,-1,-1
REMKEL1.txt,177520,178844,1324,10,N,N,-,-1,-1
REMKEL1.txt,177652,178923,1271,10,N,N,-,-1,-1
REMKEL1.txt,177713,178935,1222,10,N,N,-,-1,-1
REMKEL1.txt,177911,178994,1083,10,N,N,-,-1,-1
REMKEL1.txt,178162,179207,1045,10,N,N,-,-1,-1
REMKEL1.txt,178288,179302,1014,10,N,N,-,-1,-1
REMKEL1.txt,178520,179547,1027,10,N,N,-,-1,-1
REMKEL1.txt,178591,179634,1043,10,N,N,-,-1,-1
REMKEL1.txt,178661,179787,1126,10,N,N,-,-1,-1
REMKEL1.txt,178825,179932,1107,10,N,N,-,-1,-1
REMKEL1.txt,178845,180128,1283,10,N,N,-,-1,-1
REMKEL1.txt,178925,180257,1332,10,N,N,-,-1,-1
REMKEL1.txt,178936,180423,1487,10,N,N,-,-1,-1
REMKEL1.txt,178997,180494,1497,10,N,N,-,-1,-1
REMKEL1.txt,179208,180742,1534,10,N,N,-,-1,-1
REMKEL1.txt,179305,180967,1662,10,N,N,-,-1,-1
REMKEL1.txt,179549,181212,1663,10,N,N,-,-1,-1
REMKEL1.txt,179635,181335,1700,10,N,N,-,-1,-1
REMKEL1.txt,179788,181340,1552,10,N,N,-,-1,-1
REMKEL1.txt,179934,181359,1425,10,N,N,-,-1,-1
REMKEL1.txt,180131,181428,1297,10,N,N,-,-1,-1
REMKEL1.txt,180258,181487,1229,10,N,N,-,-1,-1
REMKEL1.txt,180424,181700,1276,10,N,N,-,-1,-1
REMKEL1.txt,180497,181828,1331,10,N,N,-,-1,-1
REMKEL1.txt,180744,181840,1096,10,N,N,-,-1,-1
REMKEL1.txt,180968,181871,903,10,N,N,-,-1,-1
REMKEL1.txt,181213,181982,769,10,N,N,-,-1,-1
REMKEL1.txt,181336,182231,895,10,N,N,-,-1,-1
REMKEL1.txt,181341,182333,992,10,N,N,-,-1,-1
REMKEL1.txt,181360,182728,1368,10,N,N,-,-1,-1
REMKEL1.txt,181430,182928,1498,10,N,N,-,-1,-1
REMKEL1.txt,181488,183098,1610,10,N,N,-,-1,-1
REMKEL1.txt,181703,183258,1555,10,N,N,-,-1,-1
REMKEL1.txt,181829,183386,1557,10,N,N,-,-1,-1
REMKEL1.txt,181841,183761,1920,10,N,N,-,-1,-1
REMKEL1.txt,181872,183814,1942,10,N,N,-,-1,-1
REMKEL1.txt,181983,183923,1940,10,N,N,-,-1,-1
REMKEL1.txt,182232,184034,1802,10,N,N,-,-1,-1
REMKEL1.txt,182334,184061,1727,10,N,N,-,-1,-1
REMKEL1.txt,182731,184358,1627,10,Y,N,-,-1,-1
REMKEL1.txt,182929,184762,1833,10,N,N,-,-1,-1
REMKEL1.txt,183099,184952,1853,10,N,N,-,-1,-1
REMKEL1.txt,183259,185140,1881,10,N,N,-,-1,-1
REMKEL1.txt,183387,185262,1875,10,N,N,-,-1,-1
REMKEL1.txt,183762,185355,1593,10,N,N,-,-1,-1
REMKEL1.txt,183817,185410,1593,10,N,N,-,-1,-1
REMKEL1.txt,183924,185495,1571,10,N,N,-,-1,-1
REMKEL1.txt,184035,185525,1490,10,N,N,-,-1,-1
REMKEL1.txt,184062,185788,1726,10,N,N,-,-1,-1
REMKEL1.txt,184361,185990,1629,10,N,N,-,-1,-1
REMKEL1.txt,184763,186206,1443,10,N,N,-,-1,-1
REMKEL1.txt,184953,186327,1374,10,N,N,-,-1,-1
REMKEL1.txt,185141,186459,1318,10,N,Y,1437477480340,424837,425856
REMKEL1.txt,185264,186607,1343,10,N,Y,1437477480340,424837,425856
REMKEL1.txt,185358,186735,1377,10,N,Y,1437477480340,424837,425856
REMKEL1.txt,185411,186793,1382,10,N,Y,1437477480340,424837,425856
REMKEL1.txt,185496,187016,1520,10,N,Y,1437477480340,424837,425856
REMKEL1.txt,185526,187172,1646,10,N,Y,1437477480340,424837,425856
REMKEL1.txt,185790,187335,1545,10,N,Y,1437477480340,424837,425856
REMKEL1.txt,185991,187468,1477,10,N,Y,1437477480340,424837,425856
REMKEL1.txt,186207,187691,1484,10,N,Y,1437477480340,424837,425856
REMKEL1.txt,186330,187775,1445,10,N,Y,1437477480340,424837,425856
REMKEL1.txt,186460,187799,1339,10,N,Y,1437477480340,424837,425856
REMKEL1.txt,186608,187901,1293,10,N,Y,1437477480340,424837,425856
REMKEL1.txt,186736,187996,1260,10,N,Y,1437477480340,424837,425856
REMKEL1.txt,186796,188006,1210,10,N,Y,1437477480340,424837,425856
REMKEL1.txt,187017,188030,1013,10,N,Y,1437477480340,424837,425856
REMKEL1.txt,187175,188148,973,10,N,N,-,-1,-1
REMKEL1.txt,187336,188191,855,10,N,N,-,-1,-1
REMKEL1.txt,187469,188249,780,10,N,N,-,-1,-1
REMKEL1.txt,187692,188324,632,10,N,N,-,-1,-1
REMKEL1.txt,187776,188408,632,10,N,N,-,-1,-1
REMKEL1.txt,187800,188564,764,10,N,N,-,-1,-1
REMKEL1.txt,187902,188656,754,10,N,N,-,-1,-1
REMKEL1.txt,187999,188850,851,10,N,N,-,-1,-1
REMKEL1.txt,188007,188992,985,10,N,N,-,-1,-1
REMKEL1.txt,188031,189063,1032,10,N,N,-,-1,-1
REMKEL1.txt,188153,189556,1403,10,N,N,-,-1,-1
REMKEL1.txt,188192,189756,1564,10,N,N,-,-1,-1
REMKEL1.txt,188250,189907,1657,10,N,N,-,-1,-1
REMKEL1.txt,188325,190047,1722,10,N,N,-,-1,-1
REMKEL1.txt,188411,190068,1657,10,N,N,-,-1,-1
REMKEL1.txt,188565,190351,1786,10,N,N,-,-1,-1
REMKEL1.txt,188657,190426,1769,10,N,N,-,-1,-1
REMKEL1.txt,188852,190629,1777,10,N,N,-,-1,-1
REMKEL1.txt,188995,190831,1836,10,N,N,-,-1,-1
REMKEL1.txt,189064,191010,1946,10,N,N,-,-1,-1
REMKEL1.txt,189557,191064,1507,10,N,N,-,-1,-1
REMKEL1.txt,189759,191178,1419,10,N,N,-,-1,-1
REMKEL1.txt,189909,191437,1528,10,N,N,-,-1,-1
REMKEL1.txt,190048,191480,1432,10,N,N,-,-1,-1
REMKEL1.txt,190069,191534,1465,10,N,Y,1448280673594,87462,88501
REMKEL1.txt,190352,191709,1357,10,N,Y,1448280673594,87462,88501
REMKEL1.txt,190429,191835,1406,10,Y,Y,1448280673594,87462,88501
REMKEL1.txt,190631,191967,1336,10,N,Y,1448280673594,87462,88501
REMKEL1.txt,190832,192122,1290,10,Y,Y,1448280673594,87462,88501
REMKEL1.txt,191013,192150,1137,10,Y,Y,1448280673594,87462,88501
REMKEL1.txt,191065,192279,1214,10,Y,Y,1448280673594,87462,88501
REMKEL1.txt,191179,192308,1129,10,Y,Y,1448280673594,87462,88501
REMKEL1.txt,191438,192357,919,10,N,Y,1448280673594,87462,88501
REMKEL1.txt,191481,192463,982,10,N,Y,1448280673594,87462,88501
REMKEL1.txt,191535,192593,1058,10,N,Y,1448277582432,52552,54595
REMKEL1.txt,191710,192903,1193,10,Y,Y,1448277582432,52552,54595
REMKEL1.txt,191836,193026,1190,10,Y,Y,1448277582432,52552,54595
REMKEL1.txt,191968,193102,1134,10,Y,Y,1448277582432,52552,54595
REMKEL1.txt,192123,193248,1125,10,Y,Y,1448277582432,52552,54595
REMKEL1.txt,192151,193657,1506,10,Y,Y,1448277582432,52552,54595
REMKEL1.txt,192280,193774,1494,10,Y,Y,1448277582432,52552,54595
REMKEL1.txt,192309,193894,1585,10,Y,Y,1448277582432,52552,54595
REMKEL1.txt,192358,194019,1661,10,Y,Y,1448277582432,52552,54595
REMKEL1.txt,192466,194366,1900,10,Y,Y,1448277582432,52552,54595
REMKEL1.txt,192594,194670,2076,10,Y,Y,1448277582432,52552,54595
REMKEL1.txt,192904,194757,1853,10,Y,Y,1448277582432,52552,54595
REMKEL1.txt,193028,194891,1863,10,N,Y,1448277582432,52552,54595
REMKEL1.txt,193103,194976,1873,10,N,Y,1448277582432,52552,54595
REMKEL1.txt,193249,195028,1779,10,N,Y,1448277582432,52552,54595
REMKEL1.txt,193658,195340,1682,10,N,Y,1448277582432,52552,54595
REMKEL1.txt,193777,195535,1758,10,N,N,-,-1,-1
REMKEL1.txt,193895,195727,1832,10,N,N,-,-1,-1
REMKEL1.txt,194020,195876,1856,10,N,N,-,-1,-1
REMKEL1.txt,194367,196355,1988,10,N,N,-,-1,-1
REMKEL1.txt,194672,196538,1866,10,N,N,-,-1,-1
REMKEL1.txt,194757,196760,2003,10,N,N,-,-1,-1
REMKEL1.txt,194892,196796,1904,10,N,N,-,-1,-1
REMKEL1.txt,194977,196825,1848,10,N,N,-,-1,-1
REMKEL1.txt,195030,197383,2353,10,N,N,-,-1,-1
REMKEL1.txt,195341,197486,2145,10,N,N,-,-1,-1
REMKEL1.txt,195536,197645,2109,10,N,N,-,-1,-1
REMKEL1.txt,195728,197838,2110,10,N,N,-,-1,-1
REMKEL1.txt,195877,197982,2105,10,N,N,-,-1,-1
REMKEL1.txt,196356,198337,1981,10,N,N,-,-1,-1
REMKEL1.txt,196541,198619,2078,10,N,N,-,-1,-1
REMKEL1.txt,196763,198729,1966,10,N,N,-,-1,-1
REMKEL1.txt,196797,199106,2309,10,N,N,-,-1,-1
REMKEL1.txt,196826,199280,2454,10,N,N,-,-1,-1
REMKEL1.txt,197384,199357,1973,10,N,N,-,-1,-1
REMKEL1.txt,197487,199487,2000,10,N,N,-,-1,-1
REMKEL1.txt,197646,199677,2031,10,N,N,-,-1,-1
REMKEL1.txt,197839,199923,2084,10,N,N,-,-1,-1
REMKEL1.txt,197985,200036,2051,10,N,N,-,-1,-1
REMKEL1.txt,198339,200224,1885,10,N,N,-,-1,-1
REMKEL1.txt,198620,200279,1659,10,N,N,-,-1,-1
REMKEL1.txt,198730,200414,1684,10,N,N,-,-1,-1
REMKEL1.txt,199109,200610,1501,10,N,N,-,-1,-1
REMKEL1.txt,199281,200884,1603,10,N,N,-,-1,-1
REMKEL1.txt,199358,201033,1675,10,N,N,-,-1,-1
REMKEL1.txt,199488,201119,1631,10,N,N,-,-1,-1
REMKEL1.txt,199679,201201,1522,10,N,N,-,-1,-1
REMKEL1.txt,199926,201329,1403,10,N,N,-,-1,-1
REMKEL1.txt,200037,201476,1439,10,N,N,-,-1,-1
REMKEL1.txt,200226,201864,1638,10,N,N,-,-1,-1
REMKEL1.txt,200280,201995,1715,10,N,N,-,-1,-1
REMKEL1.txt,200415,202294,1879,10,N,N,-,-1,-1
REMKEL1.txt,200611,202407,1796,10,N,N,-,-1,-1
REMKEL1.txt,200885,202451,1566,10,N,N,-,-1,-1
REMKEL1.txt,201036,202820,1784,10,N,N,-,-1,-1
REMKEL1.txt,201120,203402,2282,10,N,N,-,-1,-1
REMKEL1.txt,201202,203824,2622,10,N,N,-,-1,-1
REMKEL1.txt,201332,203963,2631,10,N,N,-,-1,-1
REMKEL1.txt,201478,204132,2654,10,N,N,-,-1,-1
REMKEL1.txt,201867,204153,2286,10,N,N,-,-1,-1
REMKEL1.txt,201996,204185,2189,10,N,N,-,-1,-1
REMKEL1.txt,202296,204193,1897,10,N,N,-,-1,-1
REMKEL1.txt,202408,204259,1851,10,N,N,-,-1,-1
REMKEL1.txt,202452,204281,1829,10,N,N,-,-1,-1
REMKEL1.txt,202823,204291,1468,10,N,N,-,-1,-1
REMKEL1.txt,203403,204338,935,10,N,N,-,-1,-1
REMKEL1.txt,203825,204583,758,10,N,N,-,-1,-1
REMKEL1.txt,203966,204769,803,10,N,N,-,-1,-1
REMKEL1.txt,204133,204971,838,10,N,N,-,-1,-1
REMKEL1.txt,204154,205407,1253,10,N,N,-,-1,-1
REMKEL1.txt,204186,205609,1423,10,N,N,-,-1,-1
REMKEL1.txt,204194,205676,1482,10,N,N,-,-1,-1
REMKEL1.txt,204260,205983,1723,10,N,N,-,-1,-1
REMKEL1.txt,204282,206157,1875,10,N,N,-,-1,-1
REMKEL1.txt,204292,206275,1983,10,N,N,-,-1,-1
REMKEL1.txt,204339,206361,2022,10,N,N,-,-1,-1
REMKEL1.txt,204584,206921,2337,10,N,N,-,-1,-1
REMKEL1.txt,204770,207066,2296,10,N,N,-,-1,-1
REMKEL1.txt,204974,207233,2259,10,N,N,-,-1,-1
REMKEL1.txt,205408,207460,2052,10,N,N,-,-1,-1
REMKEL1.txt,205610,207624,2014,10,N,N,-,-1,-1
REMKEL1.txt,205679,207926,2247,10,N,N,-,-1,-1
REMKEL1.txt,205984,208150,2166,10,N,N,-,-1,-1
REMKEL1.txt,206160,208172,2012,10,N,N,-,-1,-1
REMKEL1.txt,206276,208492,2216,10,N,N,-,-1,-1
REMKEL1.txt,206362,208634,2272,10,N,Y,1437490253936,460795,462238
REMKEL1.txt,206922,208710,1788,10,N,Y,1437490253936,460795,462238
REMKEL1.txt,207067,208760,1693,10,N,Y,1437490253936,460795,462238
REMKEL1.txt,207234,208973,1739,10,N,Y,1437490253936,460795,462238
REMKEL1.txt,207462,209160,1698,10,N,Y,1437490253936,460795,462238
REMKEL1.txt,207625,209204,1579,10,N,Y,1437490253936,460795,462238
REMKEL1.txt,207927,209258,1331,10,N,Y,1437490253936,460795,462238
REMKEL1.txt,208153,209323,1170,10,N,Y,1437490253936,460795,462238
REMKEL1.txt,208173,209537,1364,10,N,Y,1437490253936,460795,462238
REMKEL1.txt,208495,209588,1093,10,N,Y,1437490253936,460795,462238
REMKEL1.txt,208635,209661,1026,10,N,Y,1437490253936,460795,462238
REMKEL1.txt,208711,209832,1121,10,N,Y,1437490253936,460795,462238
REMKEL1.txt,208761,209962,1201,10,N,Y,1437490253936,460795,462238
REMKEL1.txt,208974,210390,1416,10,N,Y,1437490253936,460795,462238
REMKEL1.txt,209161,210488,1327,10,N,Y,1437490253936,460795,462238
REMKEL1.txt,209205,210691,1486,10,N,Y,1437490253936,460795,462238
REMKEL1.txt,209259,210893,1634,10,N,Y,1437490253936,460795,462238
REMKEL1.txt,209324,211005,1681,10,N,N,-,-1,-1
REMKEL1.txt,209538,211108,1570,10,N,N,-,-1,-1
REMKEL1.txt,209589,211329,1740,10,N,N,-,-1,-1
REMKEL1.txt,209664,211553,1889,10,N,N,-,-1,-1
REMKEL1.txt,209833,211605,1772,10,N,N,-,-1,-1
REMKEL1.txt,209963,211791,1828,10,N,N,-,-1,-1
REMKEL1.txt,210391,211945,1554,10,N,N,-,-1,-1
REMKEL1.txt,210489,211976,1487,10,N,N,-,-1,-1
REMKEL1.txt,210694,212093,1399,10,N,N,-,-1,-1
REMKEL1.txt,210895,212176,1281,10,N,N,-,-1,-1
REMKEL1.txt,211006,212278,1272,10,N,N,-,-1,-1
REMKEL1.txt,211109,212443,1334,10,N,N,-,-1,-1
REMKEL1.txt,211332,212663,1331,10,N,N,-,-1,-1
REMKEL1.txt,211554,213006,1452,10,N,N,-,-1,-1
REMKEL1.txt,211606,213155,1549,10,N,N,-,-1,-1
REMKEL1.txt,211794,213603,1809,10,N,N,-,-1,-1
REMKEL1.txt,211947,213692,1745,10,N,Y,1448279620157,70041,71486
REMKEL1.txt,211977,213803,1826,10,N,Y,1448279620157,70041,71486
REMKEL1.txt,212094,213868,1774,10,N,Y,1448279620157,70041,71486
REMKEL1.txt,212177,213923,1746,10,N,Y,1448279620157,70041,71486
REMKEL1.txt,212279,214114,1835,10,N,Y,1448279620157,70041,71486
REMKEL1.txt,212446,214290,1844,10,N,Y,1448279620157,70041,71486
REMKEL1.txt,212664,214356,1692,10,N,Y,1448279620157,70041,71486
REMKEL1.txt,213008,214569,1561,10,N,Y,1448279620157,70041,71486
REMKEL1.txt,213158,214676,1518,10,N,Y,1448279620157,70041,71486
REMKEL1.txt,213606,214932,1326,10,N,Y,1448279620157,70041,71486
REMKEL1.txt,213693,215024,1331,10,N,Y,1448279620157,70041,71486
REMKEL1.txt,213805,215118,1313,10,N,Y,1448279620157,70041,71486
REMKEL1.txt,213869,215266,1397,10,N,Y,1448279620157,70041,71486
REMKEL1.txt,213926,215382,1456,10,N,Y,1448279620157,70041,71486
REMKEL1.txt,214115,215527,1412,10,N,Y,1448279620157,70041,71486
REMKEL1.txt,214293,215789,1496,10,N,N,-,-1,-1
REMKEL1.txt,214357,215895,1538,10,N,N,-,-1,-1
REMKEL1.txt,214570,215948,1378,10,N,N,-,-1,-1
REMKEL1.txt,214679,216066,1387,10,N,N,-,-1,-1
REMKEL1.txt,214933,216121,1188,10,N,N,-,-1,-1
REMKEL1.txt,215025,216346,1321,10,N,N,-,-1,-1
REMKEL1.txt,215121,216528,1407,10,N,N,-,-1,-1
REMKEL1.txt,215267,216801,1534,10,N,N,-,-1,-1
REMKEL1.txt,215383,217003,1620,10,N,N,-,-1,-1
REMKEL1.txt,215528,217090,1562,10,N,N,-,-1,-1
REMKEL1.txt,215792,217182,1390,10,N,N,-,-1,-1
REMKEL1.txt,215896,217435,1539,10,N,N,-,-1,-1
REMKEL1.txt,215949,217544,1595,10,N,N,-,-1,-1
REMKEL1.txt,216067,217795,1728,10,N,N,-,-1,-1
REMKEL1.txt,216122,217875,1753,10,N,N,-,-1,-1
REMKEL1.txt,216347,218236,1889,10,N,N,-,-1,-1
REMKEL1.txt,216530,218387,1857,10,Y,N,-,-1,-1
REMKEL1.txt,216802,218451,1649,10,Y,N,-,-1,-1
REMKEL1.txt,217004,218671,1667,10,N,N,-,-1,-1
REMKEL1.txt,217093,218887,1794,10,N,N,-,-1,-1
REMKEL1.txt,217183,218917,1734,10,N,N,-,-1,-1
REMKEL1.txt,217437,218975,1538,10,N,N,-,-1,-1
REMKEL1.txt,217545,219001,1456,10,N,N,-,-1,-1
REMKEL1.txt,217796,219031,1235,10,N,N,-,-1,-1
REMKEL1.txt,217876,219123,1247,10,N,N,-,-1,-1
REMKEL1.txt,218238,219480,1242,10,N,N,-,-1,-1
REMKEL1.txt,218388,219646,1258,10,N,N,-,-1,-1
REMKEL1.txt,218452,219750,1298,10,N,N,-,-1,-1
REMKEL1.txt,218673,219851,1178,10,N,N,-,-1,-1
REMKEL1.txt,218890,219977,1087,10,N,N,-,-1,-1
REMKEL1.txt,218918,220077,1159,10,N,N,-,-1,-1
REMKEL1.txt,218976,220402,1426,10,N,N,-,-1,-1
REMKEL1.txt,219002,220640,1638,10,N,N,-,-1,-1
REMKEL1.txt,219032,220693,1661,10,N,N,-,-1,-1
REMKEL1.txt,219126,220774,1648,10,N,N,-,-1,-1
REMKEL1.txt,219483,220904,1421,10,N,N,-,-1,-1
REMKEL1.txt,219647,221040,1393,10,N,N,-,-1,-1
REMKEL1.txt,219751,221135,1384,10,N,N,-,-1,-1
REMKEL1.txt,219852,221185,1333,10,N,N,-,-1,-1
REMKEL1.txt,219978,221250,1272,10,N,N,-,-1,-1
REMKEL1.txt,220078,221306,1228,10,N,N,-,-1,-1
REMKEL1.txt,220405,221341,936,10,N,N,-,-1,-1
REMKEL1.txt,220641,221402,761,10,N,N,-,-1,-1
REMKEL1.txt,220694,221441,747,10,N,N,-,-1,-1
REMKEL1.txt,220775,221608,833,10,N,N,-,-1,-1
REMKEL1.txt,220905,221643,738,10,N,N,-,-1,-1
REMKEL1.txt,221041,221833,792,10,N,N,-,-1,-1
REMKEL1.txt,221137,222120,983,10,N,N,-,-1,-1
REMKEL1.txt,221190,222326,1136,10,N,N,-,-1,-1
REMKEL1.txt,221251,222516,1265,10,N,N,-,-1,-1
REMKEL1.txt,221307,222573,1266,10,N,N,-,-1,-1
REMKEL1.txt,221342,222723,1381,10,N,N,-,-1,-1
REMKEL1.txt,221404,222986,1582,10,N,N,-,-1,-1
REMKEL1.txt,221444,223266,1822,10,N,N,-,-1,-1
REMKEL1.txt,221609,223360,1751,10,N,Y,1437471397525,350644,351290
REMKEL1.txt,221645,223449,1804,10,N,Y,1437471397525,350644,351290
REMKEL1.txt,221834,223513,1679,10,N,Y,1437471397525,350644,351290
REMKEL1.txt,222121,223675,1554,10,N,Y,1437471397525,350644,351290
REMKEL1.txt,222327,223703,1376,10,N,Y,1437471397525,350644,351290
REMKEL1.txt,222517,223912,1395,10,N,Y,1437471397525,350644,351290
REMKEL1.txt,222574,224141,1567,10,N,Y,1437471397525,350644,351290
REMKEL1.txt,222726,224240,1514,10,N,Y,1437471397525,350644,351290
REMKEL1.txt,222987,224349,1362,10,N,Y,1437471397525,350644,351290
REMKEL1.txt,223269,224514,1245,10,N,Y,1437471397525,350644,351290
REMKEL1.txt,223362,224687,1325,10,N,Y,1437471397525,350644,351290
REMKEL1.txt,223450,224797,1347,10,N,Y,1437471397525,350644,351290
REMKEL1.txt,223515,224910,1395,10,Y,Y,1437471397525,350644,351290
REMKEL1.txt,223676,225174,1498,10,Y,Y,1437471397525,350644,351290
REMKEL1.txt,223704,225201,1497,10,Y,Y,1437471397525,350644,351290
REMKEL1.txt,223913,225318,1405,10,Y,Y,1437471397525,350644,351290
REMKEL1.txt,224144,225383,1239,10,N,Y,1448287306770,114686,120152
REMKEL1.txt,224242,225556,1314,10,N,Y,1448287306770,114686,120152
REMKEL1.txt,224352,225864,1512,10,N,Y,1448287306770,114686,120152
REMKEL1.txt,224515,225989,1474,10,N,Y,1448287306770,114686,120152
REMKEL1.txt,224688,226110,1422,10,N,Y,1448287306770,114686,120152
REMKEL1.txt,224798,226352,1554,10,N,Y,1448287306770,114686,120152
REMKEL1.txt,224912,226453,1541,10,N,N,-,-1,-1
REMKEL1.txt,225177,226524,1347,10,N,N,-,-1,-1
REMKEL1.txt,225202,226638,1436,10,N,N,-,-1,-1
REMKEL1.txt,225320,226691,1371,10,N,N,-,-1,-1
REMKEL1.txt,225384,226708,1324,10,N,N,-,-1,-1
REMKEL1.txt,225557,226783,1226,10,N,N,-,-1,-1
REMKEL1.txt,225865,226916,1051,10,N,N,-,-1,-1
REMKEL1.txt,225990,226999,1009,10,N,N,-,-1,-1
REMKEL1.txt,226111,227067,956,10,N,N,-,-1,-1
REMKEL1.txt,226354,227171,817,10,N,N,-,-1,-1
REMKEL1.txt,226456,227239,783,10,N,N,-,-1,-1
REMKEL1.txt,226525,227284,759,10,N,N,-,-1,-1
REMKEL1.txt,226639,227397,758,10,N,N,-,-1,-1
REMKEL1.txt,226692,227439,747,10,N,N,-,-1,-1
REMKEL1.txt,226709,227597,888,10,N,N,-,-1,-1
REMKEL1.txt,226784,227715,931,10,N,N,-,-1,-1
REMKEL1.txt,226917,227832,915,10,N,N,-,-1,-1
REMKEL1.txt,227000,227969,969,10,N,N,-,-1,-1
REMKEL1.txt,227068,228233,1165,10,N,N,-,-1,-1
REMKEL1.txt,227172,228256,1084,10,N,N,-,-1,-1
REMKEL1.txt,227241,228541,1300,10,N,N,-,-1,-1
REMKEL1.txt,227285,229062,1777,10,N,N,-,-1,-1
REMKEL1.txt,227398,229364,1966,10,N,N,-,-1,-1
REMKEL1.txt,227440,229433,1993,10,N,N,-,-1,-1
REMKEL1.txt,227598,229857,2259,10,N,N,-,-1,-1
REMKEL1.txt,227716,230103,2387,10,N,N,-,-1,-1
REMKEL1.txt,227833,230249,2416,10,N,N,-,-1,-1
REMKEL1.txt,227970,230401,2431,10,N,N,-,-1,-1
REMKEL1.txt,228236,230671,2435,10,N,N,-,-1,-1
REMKEL1.txt,228257,230890,2633,10,N,N,-,-1,-1
REMKEL1.txt,228544,231144,2600,10,N,N,-,-1,-1
REMKEL1.txt,229065,231304,2239,10,N,N,-,-1,-1
REMKEL1.txt,229365,231516,2151,10,N,N,-,-1,-1
REMKEL1.txt,229435,232184,2749,10,N,N,-,-1,-1
REMKEL1.txt,229860,232294,2434,10,N,N,-,-1,-1
REMKEL1.txt,230104,232779,2675,10,N,N,-,-1,-1
REMKEL1.txt,230250,233066,2816,10,N,N,-,-1,-1
REMKEL1.txt,230402,233344,2942,10,N,N,-,-1,-1
REMKEL1.txt,230672,233659,2987,10,N,N,-,-1,-1
REMKEL1.txt,230891,233775,2884,10,N,N,-,-1,-1
REMKEL1.txt,231145,233802,2657,10,N,N,-,-1,-1
REMKEL1.txt,231307,233821,2514,10,N,N,-,-1,-1
REMKEL1.txt,231517,234127,2610,10,N,N,-,-1,-1
REMKEL1.txt,232187,234432,2245,10,N,N,-,-1,-1
REMKEL1.txt,232295,234567,2272,10,N,N,-,-1,-1
REMKEL1.txt,232782,234623,1841,10,N,N,-,-1,-1
REMKEL1.txt,233067,234717,1650,10,N,N,-,-1,-1
REMKEL1.txt,233345,234914,1569,10,N,N,-,-1,-1
REMKEL1.txt,233662,235144,1482,10,N,N,-,-1,-1
REMKEL1.txt,233776,235463,1687,10,N,N,-,-1,-1
REMKEL1.txt,233807,235678,1871,10,N,N,-,-1,-1
REMKEL1.txt,233822,236131,2309,10,N,N,-,-1,-1
REMKEL1.txt,234128,236442,2314,10,N,N,-,-1,-1
REMKEL1.txt,234433,236510,2077,10,N,N,-,-1,-1
REMKEL1.txt,234570,236646,2076,10,N,N,-,-1,-1
REMKEL1.txt,234623,236882,2259,10,N,N,-,-1,-1
REMKEL1.txt,234720,237020,2300,10,N,N,-,-1,-1
REMKEL1.txt,234916,237222,2306,10,N,N,-,-1,-1
REMKEL1.txt,235145,237428,2283,10,N,N,-,-1,-1
REMKEL1.txt,235464,237588,2124,10,N,N,-,-1,-1
REMKEL1.txt,235681,237849,2168,10,N,N,-,-1,-1
REMKEL1.txt,236132,238014,1882,10,N,N,-,-1,-1
REMKEL1.txt,236443,238191,1748,10,N,N,-,-1,-1
REMKEL1.txt,236511,238362,1851,10,N,N,-,-1,-1
REMKEL1.txt,236649,238473,1824,10,N,N,-,-1,-1
REMKEL1.txt,236883,238891,2008,10,Y,N,-,-1,-1
REMKEL1.txt,237021,239097,2076,10,Y,N,-,-1,-1
REMKEL1.txt,237225,239116,1891,10,Y,N,-,-1,-1
REMKEL1.txt,237430,239257,1827,10,Y,N,-,-1,-1
REMKEL1.txt,237589,239491,1902,10,Y,N,-,-1,-1
REMKEL1.txt,237850,239698,1848,10,Y,N,-,-1,-1
REMKEL1.txt,238015,239777,1762,10,Y,N,-,-1,-1
REMKEL1.txt,238192,239897,1705,10,Y,N,-,-1,-1
REMKEL1.txt,238363,240295,1932,10,N,N,-,-1,-1
REMKEL1.txt,238474,240387,1913,10,N,N,-,-1,-1
REMKEL1.txt,238892,240393,1501,10,N,N,-,-1,-1
REMKEL1.txt,239102,240821,1719,10,N,N,-,-1,-1
REMKEL1.txt,239117,240888,1771,10,N,N,-,-1,-1
REMKEL1.txt,239260,241208,1948,10,N,N,-,-1,-1
REMKEL1.txt,239492,241458,1966,10,N,N,-,-1,-1
REMKEL1.txt,239699,241828,2129,10,N,N,-,-1,-1
REMKEL1.txt,239778,241868,2090,10,N,N,-,-1,-1
REMKEL1.txt,239898,242048,2150,10,N,N,-,-1,-1
REMKEL1.txt,240298,242302,2004,10,N,Y,1448039123601,19678,19935
REMKEL1.txt,240388,242441,2053,10,N,Y,1448039123601,19678,19935
REMKEL1.txt,240394,242459,2065,10,N,Y,1448039123601,19678,19935
REMKEL1.txt,240822,242724,1902,10,Y,Y,1448039123601,19678,19935
REMKEL1.txt,240889,242875,1986,10,Y,Y,1448039123601,19678,19935
REMKEL1.txt,241209,243005,1796,10,Y,Y,1448039123601,19678,19935
REMKEL1.txt,241461,243033,1572,10,Y,Y,1448039123601,19678,19935
REMKEL1.txt,241829,243071,1242,10,Y,Y,1448039123601,19678,19935
REMKEL1.txt,241869,243093,1224,10,Y,Y,1448039123601,19678,19935
REMKEL1.txt,242051,243226,1175,10,Y,Y,1448039123601,19678,19935
REMKEL1.txt,242303,243464,1161,10,Y,Y,1448039123601,19678,19935
REMKEL1.txt,242442,243579,1137,10,Y,Y,1448039123601,19678,19935
REMKEL1.txt,242460,243711,1251,10,Y,Y,1448039123601,19678,19935
REMKEL1.txt,242725,243935,1210,10,N,Y,1448039123601,19678,19935
REMKEL1.txt,242877,244378,1501,10,N,Y,1448039123601,19678,19935
REMKEL1.txt,243006,244494,1488,10,N,Y,1448039123601,19678,19935
REMKEL1.txt,243034,244548,1514,10,N,Y,1448039123601,19678,19935
REMKEL1.txt,243072,244680,1608,10,N,Y,1448039123601,19678,19935
REMKEL1.txt,243094,244823,1729,10,N,Y,1448039123601,19678,19935
REMKEL1.txt,243227,245041,1814,10,Y,Y,1448039123601,19678,19935
REMKEL1.txt,243467,245338,1871,10,N,Y,1448286880729,112151,113274
REMKEL1.txt,243580,245449,1869,10,Y,Y,1448286880729,112151,113274
REMKEL1.txt,243712,245703,1991,10,Y,Y,1448286880729,112151,113274
REMKEL1.txt,243938,245989,2051,10,Y,Y,1448286880729,112151,113274
REMKEL1.txt,244381,246110,1729,10,N,Y,1448286880729,112151,113274
REMKEL1.txt,244495,246604,2109,10,N,Y,1448286880729,112151,113274
REMKEL1.txt,244549,246940,2391,10,N,Y,1448286880729,112151,113274
REMKEL1.txt,244681,247406,2725,10,Y,Y,1448286880729,112151,113274
REMKEL1.txt,244824,247425,2601,10,Y,Y,1448286880729,112151,113274
REMKEL1.txt,245042,247562,2520,10,N,Y,1448286880729,112151,113274
REMKEL1.txt,245339,247837,2498,10,N,Y,1448286880729,112151,113274
REMKEL1.txt,245452,247888,2436,10,N,N,-,-1,-1
REMKEL1.txt,245704,247941,2237,10,N,N,-,-1,-1
REMKEL1.txt,245994,248169,2175,10,N,N,-,-1,-1
REMKEL1.txt,246111,248299,2188,10,N,N,-,-1,-1
REMKEL1.txt,246605,248579,1974,10,N,N,-,-1,-1
REMKEL1.txt,246943,248682,1739,10,N,N,-,-1,-1
REMKEL1.txt,247411,248907,1496,10,N,N,-,-1,-1
REMKEL1.txt,247426,248969,1543,10,N,N,-,-1,-1
REMKEL1.txt,247563,249421,1858,10,N,N,-,-1,-1
REMKEL1.txt,247838,249522,1684,10,N,N,-,-1,-1
REMKEL1.txt,247889,249722,1833,10,N,N,-,-1,-1
REMKEL1.txt,247944,249971,2027,10,N,N,-,-1,-1
REMKEL1.txt,248170,250133,1963,10,N,N,-,-1,-1
REMKEL1.txt,248300,250156,1856,10,N,N,-,-1,-1
REMKEL1.txt,248582,250298,1716,10,N,N,-,-1,-1
REMKEL1.txt,248683,251149,2466,10,N,N,-,-1,-1
REMKEL1.txt,248910,251366,2456,10,N,N,-,-1,-1
REMKEL1.txt,248972,251534,2562,10,N,N,-,-1,-1
REMKEL1.txt,249424,251589,2165,10,N,N,-,-1,-1
REMKEL1.txt,249523,251835,2312,10,N,N,-,-1,-1
REMKEL1.txt,249723,251963,2240,10,N,N,-,-1,-1
REMKEL1.txt,249972,252176,2204,10,N,N,-,-1,-1
REMKEL1.txt,250136,252962,2826,10,N,N,-,-1,-1
REMKEL1.txt,250157,253082,2925,10,N,N,-,-1,-1
REMKEL1.txt,250299,253133,2834,10,N,N,-,-1,-1
REMKEL1.txt,251150,253247,2097,10,N,N,-,-1,-1
REMKEL1.txt,251367,253300,1933,10,N,N,-,-1,-1
REMKEL1.txt,251537,253472,1935,10,N,N,-,-1,-1
REMKEL1.txt,251590,254132,2542,10,N,Y,1448313800274,179025,179317
REMKEL1.txt,251835,254388,2553,10,N,Y,1448313800274,179025,179317
REMKEL1.txt,251964,254918,2954,10,N,Y,1448313800274,179025,179317
REMKEL1.txt,252177,254995,2818,10,N,Y,1448313800274,179025,179317
REMKEL1.txt,252965,255358,2393,10,N,Y,1448313800274,179025,179317
REMKEL1.txt,253083,255600,2517,10,N,Y,1448313800274,179025,179317
REMKEL1.txt,253134,255724,2590,10,N,Y,1448313800274,179025,179317
REMKEL1.txt,253247,255913,2666,10,N,Y,1448313800274,179025,179317
REMKEL1.txt,253302,255925,2623,10,N,Y,1448313800274,179025,179317
REMKEL1.txt,253473,256048,2575,10,N,Y,1448313800274,179025,179317
REMKEL1.txt,254135,256086,1951,10,N,N,-,-1,-1
REMKEL1.txt,254389,256148,1759,10,N,N,-,-1,-1
REMKEL1.txt,254919,256282,1363,10,N,N,-,-1,-1
REMKEL1.txt,254998,256546,1548,10,N,N,-,-1,-1
REMKEL1.txt,255359,256775,1416,10,N,N,-,-1,-1
REMKEL1.txt,255602,256918,1316,10,N,N,-,-1,-1
REMKEL1.txt,255725,257068,1343,10,N,N,-,-1,-1
REMKEL1.txt,255914,257112,1198,10,N,N,-,-1,-1
REMKEL1.txt,255926,257294,1368,10,N,N,-,-1,-1
REMKEL1.txt,256049,257430,1381,10,N,N,-,-1,-1
REMKEL1.txt,256087,257545,1458,10,N,N,-,-1,-1
REMKEL1.txt,256149,258181,2032,10,N,N,-,-1,-1
REMKEL1.txt,256283,258283,2000,10,N,N,-,-1,-1
REMKEL1.txt,256547,258440,1893,10,N,N,-,-1,-1
REMKEL1.txt,256778,258604,1826,10,N,N,-,-1,-1
REMKEL1.txt,256920,258767,1847,10,N,N,-,-1,-1
REMKEL1.txt,257069,259061,1992,10,N,N,-,-1,-1
REMKEL1.txt,257113,259343,2230,10,N,N,-,-1,-1
REMKEL1.txt,257299,259582,2283,10,N,N,-,-1,-1
REMKEL1.txt,257431,260249,2818,10,Y,Y,1448038101349,15101,17486
REMKEL1.txt,257546,260344,2798,10,Y,Y,1448038101349,15101,17486
REMKEL1.txt,258182,260716,2534,10,Y,Y,1448038101349,15101,17486
REMKEL1.txt,258286,261178,2892,10,Y,Y,1448038101349,15101,17486
REMKEL1.txt,258442,261408,2966,10,Y,Y,1448038101349,15101,17486
REMKEL1.txt,258605,261594,2989,10,Y,Y,1448038101349,15101,17486
REMKEL1.txt,258768,261651,2883,10,Y,Y,1448038101349,15101,17486
REMKEL1.txt,259062,261777,2715,10,Y,Y,1448038101349,15101,17486
REMKEL1.txt,259345,262050,2705,10,Y,Y,1448038101349,15101,17486
REMKEL1.txt,259585,262296,2711,10,N,Y,1448038101349,15101,17486
REMKEL1.txt,260250,262645,2395,10,N,N,-,-1,-1
REMKEL1.txt,260345,262749,2404,10,N,N,-,-1,-1
REMKEL1.txt,260719,262878,2159,10,N,N,-,-1,-1
REMKEL1.txt,261180,263042,1862,10,N,N,-,-1,-1
REMKEL1.txt,261409,263239,1830,10,N,N,-,-1,-1
REMKEL1.txt,261595,263390,1795,10,N,N,-,-1,-1
REMKEL1.txt,261652,263628,1976,10,Y,N,-,-1,-1
REMKEL1.txt,261778,263725,1947,10,Y,N,-,-1,-1
REMKEL1.txt,262053,263870,1817,10,Y,N,-,-1,-1
REMKEL1.txt,262299,264002,1703,10,Y,N,-,-1,-1
REMKEL1.txt,262648,264222,1574,10,Y,N,-,-1,-1
REMKEL1.txt,262751,264361,1610,10,Y,N,-,-1,-1
REMKEL1.txt,262879,264377,1498,10,Y,N,-,-1,-1
REMKEL1.txt,263043,264465,1422,10,Y,N,-,-1,-1
REMKEL1.txt,263242,264525,1283,10,Y,N,-,-1,-1
REMKEL1.txt,263392,264659,1267,10,N,N,-,-1,-1
REMKEL1.txt,263629,264803,1174,10,N,N,-,-1,-1
REMKEL1.txt,263726,265125,1399,10,N,N,-,-1,-1
REMKEL1.txt,263871,265598,1727,10,N,N,-,-1,-1
REMKEL1.txt,264003,265856,1853,10,N,N,-,-1,-1
REMKEL1.txt,264223,266080,1857,10,N,N,-,-1,-1
REMKEL1.txt,264362,266194,1832,10,N,N,-,-1,-1
REMKEL1.txt,264378,266495,2117,10,N,N,-,-1,-1
REMKEL1.txt,264468,266585,2117,10,N,N,-,-1,-1
REMKEL1.txt,264526,266664,2138,10,N,N,-,-1,-1
REMKEL1.txt,264660,266799,2139,10,N,N,-,-1,-1
REMKEL1.txt,264806,266945,2139,10,N,N,-,-1,-1
REMKEL1.txt,265126,266989,1863,10,N,N,-,-1,-1
REMKEL1.txt,265599,267016,1417,10,N,N,-,-1,-1
REMKEL1.txt,265859,267098,1239,10,N,N,-,-1,-1
REMKEL1.txt,266081,267169,1088,10,N,N,-,-1,-1
REMKEL1.txt,266195,267247,1052,10,N,N,-,-1,-1
REMKEL1.txt,266498,267445,947,10,N,N,-,-1,-1
REMKEL1.txt,266586,267632,1046,10,N,N,-,-1,-1
REMKEL1.txt,266665,267909,1244,10,N,N,-,-1,-1
REMKEL1.txt,266801,268253,1452,10,N,N,-,-1,-1
REMKEL1.txt,266948,268381,1433,10,N,N,-,-1,-1
REMKEL1.txt,266990,268854,1864,10,N,N,-,-1,-1
REMKEL1.txt,267017,269123,2106,10,N,N,-,-1,-1
REMKEL1.txt,267100,269216,2116,10,N,N,-,-1,-1
REMKEL1.txt,267170,269446,2276,10,N,N,-,-1,-1
REMKEL1.txt,267248,269526,2278,10,N,N,-,-1,-1
REMKEL1.txt,267446,269538,2092,10,N,N,-,-1,-1
REMKEL1.txt,267635,269620,1985,10,N,N,-,-1,-1
REMKEL1.txt,267910,269707,1797,10,Y,N,-,-1,-1
REMKEL1.txt,268256,269887,1631,10,N,N,-,-1,-1
REMKEL1.txt,268382,269999,1617,10,N,N,-,-1,-1
REMKEL1.txt,268855,270070,1215,10,N,N,-,-1,-1
REMKEL1.txt,269124,270141,1017,10,N,N,-,-1,-1
REMKEL1.txt,269219,270276,1057,10,N,N,-,-1,-1
REMKEL1.txt,269447,270434,987,10,N,N,-,-1,-1
REMKEL1.txt,269528,270680,1152,10,Y,N,-,-1,-1
REMKEL1.txt,269539,270775,1236,10,Y,N,-,-1,-1
REMKEL1.txt,269622,270972,1350,10,Y,N,-,-1,-1
REMKEL1.txt,269708,271197,1489,10,Y,N,-,-1,-1
REMKEL1.txt,269888,271513,1625,10,Y,N,-,-1,-1
REMKEL1.txt,270000,271616,1616,10,Y,N,-,-1,-1
REMKEL1.txt,270071,271739,1668,10,Y,N,-,-1,-1
REMKEL1.txt,270144,271930,1786,10,Y,N,-,-1,-1
REMKEL1.txt,270277,272057,1780,10,N,N,-,-1,-1
REMKEL1.txt,270435,272706,2271,10,N,N,-,-1,-1
REMKEL1.txt,270683,272803,2120,10,N,N,-,-1,-1
REMKEL1.txt,270776,272827,2051,10,N,N,-,-1,-1
REMKEL1.txt,270975,273030,2055,10,N,N,-,-1,-1
REMKEL1.txt,271198,273166,1968,10,N,N,-,-1,-1
REMKEL1.txt,271515,273480,1965,10,N,N,-,-1,-1
REMKEL1.txt,271617,273648,2031,10,N,N,-,-1,-1
REMKEL1.txt,271742,273776,2034,10,N,N,-,-1,-1
REMKEL1.txt,271931,273956,2025,10,N,N,-,-1,-1
REMKEL1.txt,272058,274032,1974,10,N,N,-,-1,-1
REMKEL1.txt,272707,274105,1398,10,N,N,-,-1,-1
REMKEL1.txt,272804,274178,1374,10,N,N,-,-1,-1
REMKEL1.txt,272828,274278,1450,10,N,N,-,-1,-1
REMKEL1.txt,273033,274431,1398,10,Y,N,-,-1,-1
REMKEL1.txt,273167,274637,1470,10,Y,N,-,-1,-1
REMKEL1.txt,273481,275034,1553,10,N,N,-,-1,-1
REMKEL1.txt,273651,275411,1760,10,N,N,-,-1,-1
REMKEL1.txt,273777,275513,1736,10,N,N,-,-1,-1
REMKEL1.txt,273957,275606,1649,10,N,Y,1448278279697,58861,59444
REMKEL1.txt,274033,275772,1739,10,N,Y,1448278279697,58861,59444
REMKEL1.txt,274106,275885,1779,10,N,Y,1448278279697,58861,59444
REMKEL1.txt,274179,276048,1869,10,N,Y,1448278279697,58861,59444
REMKEL1.txt,274279,276198,1919,10,N,Y,1448278279697,58861,59444
REMKEL1.txt,274432,276390,1958,10,N,Y,1448278279697,58861,59444
REMKEL1.txt,274640,276545,1905,10,N,Y,1448278279697,58861,59444
REMKEL1.txt,275035,276904,1869,10,N,Y,1448278279697,58861,59444
REMKEL1.txt,275412,277437,2025,10,N,Y,1448278279697,58861,59444
REMKEL1.txt,275514,277628,2114,10,Y,Y,1448278279697,58861,59444
REMKEL1.txt,275607,278119,2512,10,Y,Y,1448278279697,58861,59444
REMKEL1.txt,275773,278390,2617,10,N,N,-,-1,-1
REMKEL1.txt,275888,278691,2803,10,N,N,-,-1,-1
REMKEL1.txt,276049,278991,2942,10,Y,N,-,-1,-1
REMKEL1.txt,276199,279210,3011,10,Y,N,-,-1,-1
REMKEL1.txt,276391,279410,3019,10,N,N,-,-1,-1
REMKEL1.txt,276547,279691,3144,10,N,N,-,-1,-1
REMKEL1.txt,276907,280328,3421,10,N,N,-,-1,-1
REMKEL1.txt,277438,280550,3112,10,N,N,-,-1,-1
REMKEL1.txt,277629,280661,3032,10,N,N,-,-1,-1
REMKEL1.txt,278122,280856,2734,10,N,N,-,-1,-1
REMKEL1.txt,278391,281008,2617,10,N,Y,1437477878183,427206,428439
REMKEL1.txt,278692,281115,2423,10,N,Y,1437477878183,427206,428439
REMKEL1.txt,278992,281236,2244,10,N,Y,1437477878183,427206,428439
REMKEL1.txt,279213,281251,2038,10,N,Y,1437477878183,427206,428439
REMKEL1.txt,279411,281456,2045,10,N,Y,1437477878183,427206,428439
REMKEL1.txt,279694,281853,2159,10,N,Y,1437477878183,427206,428439
REMKEL1.txt,280330,281986,1656,10,N,Y,1437477878183,427206,428439
REMKEL1.txt,280551,282336,1785,10,N,Y,1437477878183,427206,428439
REMKEL1.txt,280662,282481,1819,10,N,Y,1437477878183,427206,428439
REMKEL1.txt,280859,282535,1676,10,N,Y,1437477878183,427206,428439
REMKEL1.txt,281009,282592,1583,10,N,Y,1437477878183,427206,428439
REMKEL1.txt,281117,282747,1630,10,N,Y,1437477878183,427206,428439
REMKEL1.txt,281237,282954,1717,10,N,Y,1437477878183,427206,428439
REMKEL1.txt,281252,283098,1846,10,N,Y,1437477878183,427206,428439
REMKEL1.txt,281457,283635,2178,10,N,Y,1437477878183,427206,428439
REMKEL1.txt,281855,284006,2151,10,N,N,-,-1,-1
REMKEL1.txt,281987,284060,2073,10,N,N,-,-1,-1
REMKEL1.txt,282336,284104,1768,10,N,N,-,-1,-1
REMKEL1.txt,282481,284255,1774,10,N,N,-,-1,-1
REMKEL1.txt,282535,284386,1851,10,N,N,-,-1,-1
REMKEL1.txt,282597,284504,1907,10,N,N,-,-1,-1
REMKEL1.txt,282748,284584,1836,10,N,N,-,-1,-1
REMKEL1.txt,282955,284839,1884,10,N,N,-,-1,-1
REMKEL1.txt,283099,285005,1906,10,N,N,-,-1,-1
REMKEL1.txt,283638,285167,1529,10,N,N,-,-1,-1
REMKEL1.txt,284007,285201,1194,10,N,N,-,-1,-1
REMKEL1.txt,284062,285322,1260,10,N,N,-,-1,-1
REMKEL1.txt,284105,285388,1283,10,N,N,-,-1,-1
REMKEL1.txt,284258,285489,1231,10,N,N,-,-1,-1
REMKEL1.txt,284387,285587,1200,10,N,N,-,-1,-1
REMKEL1.txt,284505,285880,1375,10,N,N,-,-1,-1
REMKEL1.txt,284585,286335,1750,10,N,N,-,-1,-1
REMKEL1.txt,284840,286569,1729,10,N,N,-,-1,-1
REMKEL1.txt,285006,286756,1750,10,N,N,-,-1,-1
REMKEL1.txt,285167,286765,1598,10,N,N,-,-1,-1
REMKEL1.txt,285202,286837,1635,10,N,N,-,-1,-1
REMKEL1.txt,285323,287148,1825,10,N,N,-,-1,-1
REMKEL1.txt,285389,287233,1844,10,N,N,-,-1,-1
REMKEL1.txt,285490,287287,1797,10,N,N,-,-1,-1
REMKEL1.txt,285590,287554,1964,10,N,N,-,-1,-1
REMKEL1.txt,285882,287779,1897,10,N,N,-,-1,-1
REMKEL1.txt,286338,287991,1653,10,N,N,-,-1,-1
REMKEL1.txt,286570,288156,1586,10,N,N,-,-1,-1
REMKEL1.txt,286759,288249,1490,10,N,N,-,-1,-1
REMKEL1.txt,286766,288377,1611,10,N,N,-,-1,-1
REMKEL1.txt,286840,288466,1626,10,N,N,-,-1,-1
REMKEL1.txt,287149,288542,1393,10,N,N,-,-1,-1
REMKEL1.txt,287234,288693,1459,10,N,N,-,-1,-1
REMKEL1.txt,287288,288881,1593,10,N,N,-,-1,-1
REMKEL1.txt,287555,289024,1469,10,N,N,-,-1,-1
REMKEL1.txt,287782,289081,1299,10,N,N,-,-1,-1
REMKEL1.txt,287992,289353,1361,10,N,N,-,-1,-1
REMKEL1.txt,288157,289456,1299,10,N,N,-,-1,-1
REMKEL1.txt,288250,289509,1259,10,N,N,-,-1,-1
REMKEL1.txt,288378,289540,1162,10,N,N,-,-1,-1
REMKEL1.txt,288467,289681,1214,10,N,N,-,-1,-1
REMKEL1.txt,288543,289707,1164,10,N,N,-,-1,-1
REMKEL1.txt,288694,289870,1176,10,N,N,-,-1,-1
REMKEL1.txt,288883,289962,1079,10,N,N,-,-1,-1
REMKEL1.txt,289027,290065,1038,10,N,N,-,-1,-1
REMKEL1.txt,289082,290169,1087,10,N,N,-,-1,-1
REMKEL1.txt,289354,290254,900,10,N,N,-,-1,-1
REMKEL1.txt,289457,290389,932,10,N,N,-,-1,-1
REMKEL1.txt,289510,290540,1030,10,N,N,-,-1,-1
REMKEL1.txt,289541,290730,1189,10,N,N,-,-1,-1
REMKEL1.txt,289684,290826,1142,10,N,N,-,-1,-1
REMKEL1.txt,289708,291081,1373,10,N,N,-,-1,-1
REMKEL1.txt,289871,291234,1363,10,N,N,-,-1,-1
REMKEL1.txt,289963,291385,1422,10,N,N,-,-1,-1
REMKEL1.txt,290066,291543,1477,10,N,N,-,-1,-1
REMKEL1.txt,290171,291606,1435,10,N,N,-,-1,-1
REMKEL1.txt,290257,291758,1501,10,N,N,-,-1,-1
REMKEL1.txt,290390,291805,1415,10,N,N,-,-1,-1
REMKEL1.txt,290541,291944,1403,10,N,N,-,-1,-1
REMKEL1.txt,290731,292077,1346,10,N,N,-,-1,-1
REMKEL1.txt,290827,292151,1324,10,N,N,-,-1,-1
REMKEL1.txt,291082,292267,1185,10,N,N,-,-1,-1
REMKEL1.txt,291235,292293,1058,10,N,N,-,-1,-1
REMKEL1.txt,291386,292880,1494,10,N,N,-,-1,-1
REMKEL1.txt,291544,292938,1394,10,N,N,-,-1,-1
REMKEL1.txt,291607,293006,1399,10,N,N,-,-1,-1
REMKEL1.txt,291759,293096,1337,10,N,N,-,-1,-1
REMKEL1.txt,291808,293344,1536,10,N,N,-,-1,-1
REMKEL1.txt,291945,293360,1415,10,N,N,-,-1,-1
REMKEL1.txt,292078,293550,1472,10,N,N,-,-1,-1
REMKEL1.txt,292153,293655,1502,10,N,N,-,-1,-1
REMKEL1.txt,292268,293818,1550,10,N,N,-,-1,-1
REMKEL1.txt,292294,293885,1591,10,N,N,-,-1,-1
REMKEL1.txt,292883,294059,1176,10,N,N,-,-1,-1
REMKEL1.txt,292939,294266,1327,10,N,N,-,-1,-1
REMKEL1.txt,293007,294432,1425,10,N,N,-,-1,-1
REMKEL1.txt,293097,294596,1499,10,N,N,-,-1,-1
REMKEL1.txt,293345,294706,1361,10,N,N,-,-1,-1
REMKEL1.txt,293361,294903,1542,10,N,N,-,-1,-1
REMKEL1.txt,293551,294970,1419,10,N,N,-,-1,-1
REMKEL1.txt,293656,294999,1343,10,N,N,-,-1,-1
REMKEL1.txt,293819,295311,1492,10,N,N,-,-1,-1
REMKEL1.txt,293887,295477,1590,10,N,N,-,-1,-1
REMKEL1.txt,294062,295674,1612,10,N,N,-,-1,-1
REMKEL1.txt,294267,295759,1492,10,N,N,-,-1,-1
REMKEL1.txt,294433,295820,1387,10,N,N,-,-1,-1
REMKEL1.txt,294597,296048,1451,10,N,N,-,-1,-1
REMKEL1.txt,294709,296162,1453,10,N,N,-,-1,-1
REMKEL1.txt,294905,296380,1475,10,N,N,-,-1,-1
REMKEL1.txt,294971,296548,1577,10,N,N,-,-1,-1
REMKEL1.txt,295000,297106,2106,10,N,N,-,-1,-1
REMKEL1.txt,295312,297234,1922,10,N,N,-,-1,-1
REMKEL1.txt,295480,297356,1876,10,N,N,-,-1,-1
REMKEL1.txt,295675,297543,1868,10,N,N,-,-1,-1
REMKEL1.txt,295761,297655,1894,10,N,N,-,-1,-1
REMKEL1.txt,295821,297744,1923,10,N,N,-,-1,-1
REMKEL1.txt,296050,297798,1748,10,N,N,-,-1,-1
REMKEL1.txt,296165,298028,1863,10,N,N,-,-1,-1
REMKEL1.txt,296381,298117,1736,10,N,N,-,-1,-1
REMKEL1.txt,296549,298245,1696,10,N,N,-,-1,-1
REMKEL1.txt,297108,298370,1262,10,N,N,-,-1,-1
REMKEL1.txt,297235,298595,1360,10,N,N,-,-1,-1
REMKEL1.txt,297357,298654,1297,10,N,N,-,-1,-1
REMKEL1.txt,297546,298978,1432,10,N,N,-,-1,-1
REMKEL1.txt,297658,299092,1434,10,N,N,-,-1,-1
REMKEL1.txt,297745,299310,1565,10,N,N,-,-1,-1
REMKEL1.txt,297799,299506,1707,10,N,N,-,-1,-1
REMKEL1.txt,298029,299618,1589,10,N,N,-,-1,-1
REMKEL1.txt,298120,299805,1685,10,N,N,-,-1,-1
REMKEL1.txt,298246,299945,1699,10,N,N,-,-1,-1
REMKEL1.txt,298371,300091,1720,10,N,N,-,-1,-1
REMKEL1.txt,298596,300160,1564,10,N,N,-,-1,-1
REMKEL1.txt,298655,300261,1606,10,N,N,-,-1,-1
REMKEL1.txt,298979,300450,1471,10,N,N,-,-1,-1
REMKEL1.txt,299093,300532,1439,10,N,N,-,-1,-1
REMKEL1.txt,299311,300560,1249,10,N,N,-,-1,-1
REMKEL1.txt,299509,300602,1093,10,N,N,-,-1,-1
REMKEL1.txt,299619,300793,1174,10,N,N,-,-1,-1
REMKEL1.txt,299806,300855,1049,10,Y,N,-,-1,-1
REMKEL1.txt,299948,301361,1413,10,Y,N,-,-1,-1
REMKEL1.txt,300092,301479,1387,10,N,N,-,-1,-1
REMKEL1.txt,300161,301717,1556,10,N,N,-,-1,-1
REMKEL1.txt,300262,301921,1659,10,N,N,-,-1,-1
REMKEL1.txt,300451,302068,1617,10,N,N,-,-1,-1
REMKEL1.txt,300533,302225,1692,10,N,N,-,-1,-1
REMKEL1.txt,300561,302382,1821,10,N,N,-,-1,-1
REMKEL1.txt,300603,302734,2131,10,N,N,-,-1,-1
REMKEL1.txt,300794,303060,2266,10,N,N,-,-1,-1
REMKEL1.txt,300856,303444,2588,10,N,N,-,-1,-1
REMKEL1.txt,301362,303523,2161,10,N,N,-,-1,-1
REMKEL1.txt,301482,303617,2135,10,N,N,-,-1,-1
REMKEL1.txt,301718,303862,2144,10,N,N,-,-1,-1
REMKEL1.txt,301922,304015,2093,10,N,N,-,-1,-1
REMKEL1.txt,302069,304103,2034,10,N,N,-,-1,-1
REMKEL1.txt,302226,304374,2148,10,N,N,-,-1,-1
REMKEL1.txt,302383,304557,2174,10,N,N,-,-1,-1
REMKEL1.txt,302737,304765,2028,10,N,N,-,-1,-1
REMKEL1.txt,303061,304870,1809,10,N,N,-,-1,-1
REMKEL1.txt,303445,304909,1464,10,N,N,-,-1,-1
REMKEL1.txt,303526,305000,1474,10,N,N,-,-1,-1
REMKEL1.txt,303618,305233,1615,10,N,N,-,-1,-1
REMKEL1.txt,303865,305367,1502,10,N,N,-,-1,-1
REMKEL1.txt,304016,305679,1663,10,N,N,-,-1,-1
REMKEL1.txt,304104,305823,1719,10,N,N,-,-1,-1
REMKEL1.txt,304375,306021,1646,10,N,N,-,-1,-1
REMKEL1.txt,304560,306500,1940,10,N,N,-,-1,-1
REMKEL1.txt,304767,306690,1923,10,N,N,-,-1,-1
REMKEL1.txt,304871,306885,2014,10,N,N,-,-1,-1
REMKEL1.txt,304910,307217,2307,10,N,N,-,-1,-1
REMKEL1.txt,305000,307316,2316,10,N,N,-,-1,-1
REMKEL1.txt,305234,307518,2284,10,N,N,-,-1,-1
REMKEL1.txt,305368,307563,2195,10,N,N,-,-1,-1
REMKEL1.txt,305682,307791,2109,10,N,N,-,-1,-1
REMKEL1.txt,305824,308015,2191,10,N,N,-,-1,-1
REMKEL1.txt,306022,308247,2225,10,N,N,-,-1,-1
REMKEL1.txt,306501,308280,1779,10,N,N,-,-1,-1
REMKEL1.txt,306691,308306,1615,10,N,N,-,-1,-1
REMKEL1.txt,306888,308763,1875,10,N,N,-,-1,-1
REMKEL1.txt,307218,308845,1627,10,N,N,-,-1,-1
REMKEL1.txt,307317,308901,1584,10,N,N,-,-1,-1
REMKEL1.txt,307519,309014,1495,10,N,N,-,-1,-1
REMKEL1.txt,307564,309429,1865,10,N,N,-,-1,-1
REMKEL1.txt,307794,309522,1728,10,N,N,-,-1,-1
REMKEL1.txt,308016,309656,1640,10,N,N,-,-1,-1
REMKEL1.txt,308248,310027,1779,10,N,N,-,-1,-1
REMKEL1.txt,308281,310120,1839,10,N,N,-,-1,-1
REMKEL1.txt,308307,310171,1864,10,N,N,-,-1,-1
REMKEL1.txt,308766,310296,1530,10,N,N,-,-1,-1
REMKEL1.txt,308846,310535,1689,10,N,N,-,-1,-1
REMKEL1.txt,308904,310660,1756,10,N,N,-,-1,-1
REMKEL1.txt,309017,310721,1704,10,N,N,-,-1,-1
REMKEL1.txt,309430,310829,1399,10,N,N,-,-1,-1
REMKEL1.txt,309523,311010,1487,10,N,N,-,-1,-1
REMKEL1.txt,309658,311122,1464,10,N,N,-,-1,-1
REMKEL1.txt,310028,311278,1250,10,N,N,-,-1,-1
REMKEL1.txt,310123,311364,1241,10,N,N,-,-1,-1
REMKEL1.txt,310173,311665,1492,10,N,N,-,-1,-1
REMKEL1.txt,310297,311734,1437,10,N,N,-,-1,-1
REMKEL1.txt,310536,311804,1268,10,N,N,-,-1,-1
REMKEL1.txt,310661,312274,1613,10,N,N,-,-1,-1
REMKEL1.txt,310722,312390,1668,10,N,N,-,-1,-1
REMKEL1.txt,310830,312527,1697,10,N,N,-,-1,-1
REMKEL1.txt,311013,312583,1570,10,N,N,-,-1,-1
REMKEL1.txt,311123,312720,1597,10,N,N,-,-1,-1
REMKEL1.txt,311279,312894,1615,10,N,N,-,-1,-1
REMKEL1.txt,311365,313015,1650,10,N,N,-,-1,-1
REMKEL1.txt,311668,313193,1525,10,N,N,-,-1,-1
REMKEL1.txt,311735,313270,1535,10,N,N,-,-1,-1
REMKEL1.txt,311805,313301,1496,10,N,N,-,-1,-1
REMKEL1.txt,312275,313541,1266,10,N,N,-,-1,-1
REMKEL1.txt,312393,313751,1358,10,N,N,-,-1,-1
REMKEL1.txt,312528,313864,1336,10,N,N,-,-1,-1
REMKEL1.txt,312585,314059,1474,10,N,N,-,-1,-1
REMKEL1.txt,312721,314477,1756,10,N,N,-,-1,-1
REMKEL1.txt,312895,314552,1657,10,N,N,-,-1,-1
REMKEL1.txt,313016,314690,1674,10,N,N,-,-1,-1
REMKEL1.txt,313194,314748,1554,10,N,N,-,-1,-1
REMKEL1.txt,313271,314839,1568,10,N,N,-,-1,-1
REMKEL1.txt,313304,315003,1699,10,N,N,-,-1,-1
REMKEL1.txt,313542,315282,1740,10,N,N,-,-1,-1
REMKEL1.txt,313753,315406,1653,10,N,N,-,-1,-1
REMKEL1.txt,313865,315594,1729,10,N,N,-,-1,-1
REMKEL1.txt,314062,315667,1605,10,N,N,-,-1,-1
REMKEL1.txt,314480,315819,1339,10,N,N,-,-1,-1
REMKEL1.txt,314555,316227,1672,10,N,N,-,-1,-1
REMKEL1.txt,314691,316370,1679,10,N,N,-,-1,-1
REMKEL1.txt,314749,316539,1790,10,N,N,-,-1,-1
REMKEL1.txt,314840,316603,1763,10,N,N,-,-1,-1
REMKEL1.txt,315005,316702,1697,10,N,N,-,-1,-1
REMKEL1.txt,315283,316797,1514,10,N,N,-,-1,-1
REMKEL1.txt,315408,316942,1534,10,N,N,-,-1,-1
REMKEL1.txt,315595,316972,1377,10,N,N,-,-1,-1
REMKEL1.txt,315668,317007,1339,10,N,N,-,-1,-1
REMKEL1.txt,315824,317131,1307,10,N,N,-,-1,-1
REMKEL1.txt,316228,317216,988,10,N,N,-,-1,-1
REMKEL1.txt,316371,317477,1106,10,N,N,-,-1,-1
REMKEL1.txt,316540,317722,1182,10,N,N,-,-1,-1
REMKEL1.txt,316606,317922,1316,10,Y,N,-,-1,-1
REMKEL1.txt,316704,317961,1257,10,Y,N,-,-1,-1
REMKEL1.txt,316799,318185,1386,10,Y,N,-,-1,-1
REMKEL1.txt,316943,318496,1553,10,Y,N,-,-1,-1
REMKEL1.txt,316973,318559,1586,10,Y,N,-,-1,-1
REMKEL1.txt,317008,318718,1710,10,Y,N,-,-1,-1
REMKEL1.txt,317132,318982,1850,10,Y,N,-,-1,-1
REMKEL1.txt,317217,319268,2051,10,Y,N,-,-1,-1
REMKEL1.txt,317478,319378,1900,10,Y,N,-,-1,-1
REMKEL1.txt,317725,319536,1811,10,Y,N,-,-1,-1
REMKEL1.txt,317923,319649,1726,10,N,N,-,-1,-1
REMKEL1.txt,317963,319836,1873,10,N,N,-,-1,-1
REMKEL1.txt,318186,319901,1715,10,N,N,-,-1,-1
REMKEL1.txt,318497,319940,1443,10,N,N,-,-1,-1
REMKEL1.txt,318560,320103,1543,10,N,N,-,-1,-1
REMKEL1.txt,318721,320138,1417,10,N,N,-,-1,-1
REMKEL1.txt,318983,320252,1269,10,N,N,-,-1,-1
REMKEL1.txt,319271,320433,1162,10,N,N,-,-1,-1
REMKEL1.txt,319379,320500,1121,10,N,N,-,-1,-1
REMKEL1.txt,319537,320669,1132,10,N,N,-,-1,-1
REMKEL1.txt,319650,320834,1184,10,N,N,-,-1,-1
REMKEL1.txt,319839,321096,1257,10,N,N,-,-1,-1
REMKEL1.txt,319904,321531,1627,10,N,Y,1448322514970,220165,221397
REMKEL1.txt,319941,321583,1642,10,N,Y,1448322514970,220165,221397
REMKEL1.txt,320104,321785,1681,10,N,Y,1448322514970,220165,221397
REMKEL1.txt,320141,321942,1801,10,N,Y,1448322514970,220165,221397
REMKEL1.txt,320253,322120,1867,10,Y,Y,1448322514970,220165,221397
REMKEL1.txt,320434,322182,1748,10,N,Y,1448322514970,220165,221397
REMKEL1.txt,320503,322208,1705,10,N,Y,1448322514970,220165,221397
REMKEL1.txt,320672,322255,1583,10,N,Y,1448322514970,220165,221397
REMKEL1.txt,320835,322309,1474,10,N,Y,1448322514970,220165,221397
REMKEL1.txt,321097,322431,1334,10,Y,Y,1448322514970,220165,221397
REMKEL1.txt,321532,322619,1087,10,N,Y,1448322514970,220165,221397
REMKEL1.txt,321584,322693,1109,10,N,Y,1448322514970,220165,221397
REMKEL1.txt,321786,322722,936,10,N,Y,1448322514970,220165,221397
REMKEL1.txt,321945,322762,817,10,N,Y,1448322514970,220165,221397
REMKEL1.txt,322121,322773,652,10,N,Y,1448322514970,220165,221397
REMKEL1.txt,322183,322877,694,10,N,Y,1448322514970,220165,221397
REMKEL1.txt,322209,323033,824,10,N,Y,1448322514970,220165,221397
REMKEL1.txt,322256,323105,849,10,N,Y,1448322514970,220165,221397
REMKEL1.txt,322310,323113,803,10,N,Y,1448322514970,220165,221397
REMKEL1.txt,322432,323183,751,10,N,Y,1448322514970,220165,221397
REMKEL1.txt,322622,323543,921,10,N,Y,1448322514970,220165,221397
REMKEL1.txt,322694,323796,1102,10,N,Y,1448322514970,220165,221397
REMKEL1.txt,322724,324097,1373,10,N,Y,1448322514970,220165,221397
REMKEL1.txt,322763,324186,1423,10,N,Y,1448322514970,220165,221397
REMKEL1.txt,322775,324295,1520,10,N,Y,1448322514970,220165,221397
REMKEL1.txt,322878,324447,1569,10,Y,Y,1448322514970,220165,221397
REMKEL1.txt,323034,324641,1607,10,Y,Y,1448322514970,220165,221397
REMKEL1.txt,323106,324726,1620,10,Y,Y,1448322514970,220165,221397
REMKEL1.txt,323115,324901,1786,10,Y,Y,1448322514970,220165,221397
REMKEL1.txt,323186,325139,1953,10,Y,Y,1448322514970,220165,221397
REMKEL1.txt,323544,325310,1766,10,N,Y,1448322514970,220165,221397
REMKEL1.txt,323799,325361,1562,10,N,N,-,-1,-1
REMKEL1.txt,324098,325479,1381,10,N,N,-,-1,-1
REMKEL1.txt,324187,325561,1374,10,N,N,-,-1,-1
REMKEL1.txt,324298,325720,1422,10,N,N,-,-1,-1
REMKEL1.txt,324449,325842,1393,10,N,N,-,-1,-1
REMKEL1.txt,324642,325963,1321,10,N,Y,1448280884746,88496,89294
REMKEL1.txt,324727,326018,1291,10,N,Y,1448280884746,88496,89294
REMKEL1.txt,324902,326112,1210,10,N,Y,1448280884746,88496,89294
REMKEL1.txt,325140,326197,1057,10,N,Y,1448280884746,88496,89294
REMKEL1.txt,325311,326279,968,10,N,Y,1448280884746,88496,89294
REMKEL1.txt,325366,326336,970,10,N,Y,1448280884746,88496,89294
REMKEL1.txt,325480,326494,1014,10,N,Y,1448280884746,88496,89294
REMKEL1.txt,325563,326637,1074,10,N,Y,1448280884746,88496,89294
REMKEL1.txt,325723,326695,972,10,N,Y,1448280884746,88496,89294
REMKEL1.txt,325843,326745,902,10,N,Y,1448280884746,88496,89294
REMKEL1.txt,325964,326856,892,10,N,Y,1448280884746,88496,89294
REMKEL1.txt,326019,326920,901,10,N,Y,1448280884746,88496,89294
REMKEL1.txt,326113,327090,977,10,Y,Y,1448280884746,88496,89294
REMKEL1.txt,326198,327214,1016,10,Y,Y,1448280884746,88496,89294
REMKEL1.txt,326280,327488,1208,10,Y,Y,1448280884746,88496,89294
REMKEL1.txt,326337,327861,1524,10,N,Y,1448280884746,88496,89294
REMKEL1.txt,326495,327974,1479,10,N,Y,1448280884746,88496,89294
REMKEL1.txt,326638,328133,1495,10,N,Y,1448280884746,88496,89294
REMKEL1.txt,326696,328143,1447,10,N,Y,1448280884746,88496,89294
REMKEL1.txt,326746,328146,1400,10,N,Y,1448280884746,88496,89294
REMKEL1.txt,326857,328174,1317,10,N,Y,1448280884746,88496,89294
REMKEL1.txt,326921,328179,1258,10,N,Y,1448280884746,88496,89294
REMKEL1.txt,327091,328182,1091,10,N,Y,1448280884746,88496,89294
REMKEL1.txt,327217,328192,975,10,N,Y,1448280884746,88496,89294
REMKEL1.txt,327489,328209,720,10,N,Y,1448280884746,88496,89294
REMKEL1.txt,327862,328596,734,10,N,Y,1448280884746,88496,89294
REMKEL1.txt,327975,328828,853,10,N,N,-,-1,-1
REMKEL1.txt,328133,328959,826,10,N,N,-,-1,-1
REMKEL1.txt,328143,329304,1161,10,N,N,-,-1,-1
REMKEL1.txt,328146,329424,1278,10,N,N,-,-1,-1
REMKEL1.txt,328175,329425,1250,10,N,N,-,-1,-1
REMKEL1.txt,328180,329426,1246,10,N,N,-,-1,-1
REMKEL1.txt,328183,329434,1251,10,N,N,-,-1,-1
REMKEL1.txt,328193,329453,1260,10,N,N,-,-1,-1
REMKEL1.txt,328216,329554,1338,10,N,N,-,-1,-1
REMKEL1.txt,328596,329821,1225,10,N,N,-,-1,-1
REMKEL1.txt,328828,329885,1057,10,N,N,-,-1,-1
REMKEL1.txt,328962,330367,1405,10,N,N,-,-1,-1
REMKEL1.txt,329306,330491,1185,10,N,N,-,-1,-1
REMKEL1.txt,329424,330658,1234,10,N,N,-,-1,-1
REMKEL1.txt,329425,330821,1396,10,N,N,-,-1,-1
REMKEL1.txt,329427,330989,1562,10,N,N,-,-1,-1
REMKEL1.txt,329439,331063,1624,10,N,N,-,-1,-1
REMKEL1.txt,329456,331190,1734,10,N,N,-,-1,-1
REMKEL1.txt,329555,331343,1788,10,Y,N,-,-1,-1
REMKEL1.txt,329822,331571,1749,10,Y,N,-,-1,-1
REMKEL1.txt,329888,331788,1900,10,Y,N,-,-1,-1
REMKEL1.txt,330368,332048,1680,10,Y,N,-,-1,-1
REMKEL1.txt,330492,332258,1766,10,Y,Y,1448285563397,102964,108476
REMKEL1.txt,330661,332277,1616,10,Y,Y,1448285563397,102964,108476
REMKEL1.txt,330826,332429,1603,10,Y,Y,1448285563397,102964,108476
REMKEL1.txt,330990,332586,1596,10,Y,Y,1448285563397,102964,108476
REMKEL1.txt,331064,332650,1586,10,Y,Y,1448285563397,102964,108476
REMKEL1.txt,331192,332925,1733,10,Y,Y,1448285563397,102964,108476
REMKEL1.txt,331345,333111,1766,10,Y,Y,1448285563397,102964,108476
REMKEL1.txt,331572,333218,1646,10,Y,Y,1448285563397,102964,108476
REMKEL1.txt,331789,333352,1563,10,Y,Y,1448285563397,102964,108476
REMKEL1.txt,332051,333413,1362,10,Y,Y,1448285563397,102964,108476
REMKEL1.txt,332263,333565,1302,10,Y,Y,1448285563397,102964,108476
REMKEL1.txt,332278,333814,1536,10,Y,Y,1448285563397,102964,108476
REMKEL1.txt,332430,333964,1534,10,N,Y,1448285563397,102964,108476
REMKEL1.txt,332587,334072,1485,10,N,Y,1448285563397,102964,108476
REMKEL1.txt,332651,334507,1856,10,Y,Y,1448285563397,102964,108476
REMKEL1.txt,332928,334603,1675,10,Y,Y,1448285563397,102964,108476
REMKEL1.txt,333112,334791,1679,10,N,Y,1448285563397,102964,108476
REMKEL1.txt,333221,335092,1871,10,Y,Y,1448285563397,102964,108476
REMKEL1.txt,333353,335115,1762,10,Y,Y,1448285563397,102964,108476
REMKEL1.txt,333414,335797,2383,10,Y,Y,1448285563397,102964,108476
REMKEL1.txt,333566,335952,2386,10,Y,Y,1448285563397,102964,108476
REMKEL1.txt,333815,336160,2345,10,Y,N,-,-1,-1
REMKEL1.txt,333965,336640,2675,10,Y,N,-,-1,-1
REMKEL1.txt,334074,336750,2676,10,Y,N,-,-1,-1
REMKEL1.txt,334508,336895,2387,10,Y,N,-,-1,-1
REMKEL1.txt,334606,337027,2421,10,N,N,-,-1,-1
REMKEL1.txt,334792,337261,2469,10,N,N,-,-1,-1
REMKEL1.txt,335093,337659,2566,10,N,N,-,-1,-1
REMKEL1.txt,335118,338152,3034,10,N,N,-,-1,-1
REMKEL1.txt,335800,338171,2371,10,N,N,-,-1,-1
REMKEL1.txt,335953,338449,2496,10,N,N,-,-1,-1
REMKEL1.txt,336161,338499,2338,10,N,N,-,-1,-1
REMKEL1.txt,336641,338596,1955,10,N,N,-,-1,-1
REMKEL1.txt,336753,338690,1937,10,N,N,-,-1,-1
REMKEL1.txt,336896,338828,1932,10,N,N,-,-1,-1
REMKEL1.txt,337028,339042,2014,10,N,N,-,-1,-1
REMKEL1.txt,337262,339171,1909,10,Y,N,-,-1,-1
REMKEL1.txt,337660,339381,1721,10,Y,N,-,-1,-1
REMKEL1.txt,338157,339630,1473,10,Y,N,-,-1,-1
REMKEL1.txt,338172,339720,1548,10,Y,N,-,-1,-1
REMKEL1.txt,338450,339880,1430,10,Y,N,-,-1,-1
REMKEL1.txt,338502,340143,1641,10,Y,N,-,-1,-1
REMKEL1.txt,338597,340392,1795,10,Y,N,-,-1,-1
REMKEL1.txt,338691,340804,2113,10,Y,N,-,-1,-1
REMKEL1.txt,338829,340929,2100,10,Y,N,-,-1,-1
REMKEL1.txt,339043,341007,1964,10,Y,N,-,-1,-1
REMKEL1.txt,339172,341104,1932,10,Y,N,-,-1,-1
REMKEL1.txt,339384,341440,2056,10,Y,N,-,-1,-1
REMKEL1.txt,339631,341664,2033,10,Y,N,-,-1,-1
REMKEL1.txt,339723,341768,2045,10,Y,N,-,-1,-1
REMKEL1.txt,339881,341873,1992,10,N,Y,1448278425221,65586,65914
REMKEL1.txt,340144,341962,1818,10,N,Y,1448278425221,65586,65914
REMKEL1.txt,340393,342390,1997,10,Y,Y,1448278425221,65586,65914
REMKEL1.txt,340807,342573,1766,10,N,Y,1448278425221,65586,65914
REMKEL1.txt,340930,342716,1786,10,N,Y,1448278425221,65586,65914
REMKEL1.txt,341008,342799,1791,10,Y,Y,1448278425221,65586,65914
REMKEL1.txt,341105,342874,1769,10,N,Y,1448278425221,65586,65914
REMKEL1.txt,341441,343030,1589,10,N,Y,1448278425221,65586,65914
REMKEL1.txt,341665,343794,2129,10,N,Y,1448278425221,65586,65914
REMKEL1.txt,341771,344026,2255,10,Y,Y,1448278425221,65586,65914
REMKEL1.txt,341874,344045,2171,10,N,Y,1448278425221,65586,65914
REMKEL1.txt,341964,344094,2130,10,N,Y,1448278425221,65586,65914
REMKEL1.txt,342391,344311,1920,10,N,N,-,-1,-1
REMKEL1.txt,342576,344428,1852,10,N,N,-,-1,-1
REMKEL1.txt,342718,344461,1743,10,N,N,-,-1,-1
REMKEL1.txt,342800,344633,1833,10,Y,N,-,-1,-1
REMKEL1.txt,342875,344709,1834,10,Y,N,-,-1,-1
REMKEL1.txt,343031,345083,2052,10,N,N,-,-1,-1
REMKEL1.txt,343795,345234,1439,10,N,N,-,-1,-1
REMKEL1.txt,344031,345347,1316,10,N,N,-,-1,-1
REMKEL1.txt,344046,345535,1489,10,N,N,-,-1,-1
REMKEL1.txt,344095,345619,1524,10,N,N,-,-1,-1
REMKEL1.txt,344312,345817,1505,10,N,N,-,-1,-1
REMKEL1.txt,344431,346050,1619,10,N,N,-,-1,-1
REMKEL1.txt,344462,346268,1806,10,N,N,-,-1,-1
REMKEL1.txt,344634,346358,1724,10,N,N,-,-1,-1
REMKEL1.txt,344710,346576,1866,10,N,N,-,-1,-1
REMKEL1.txt,345086,346604,1518,10,N,N,-,-1,-1
REMKEL1.txt,345236,346714,1478,10,N,N,-,-1,-1
REMKEL1.txt,345348,346738,1390,10,N,N,-,-1,-1
REMKEL1.txt,345536,346878,1342,10,N,N,-,-1,-1
REMKEL1.txt,345620,346897,1277,10,N,N,-,-1,-1
REMKEL1.txt,345819,347385,1566,10,N,N,-,-1,-1
REMKEL1.txt,346051,347486,1435,10,N,N,-,-1,-1
REMKEL1.txt,346270,347614,1344,10,N,N,-,-1,-1
REMKEL1.txt,346361,347767,1406,10,N,N,-,-1,-1
REMKEL1.txt,346577,347861,1284,10,N,N,-,-1,-1
REMKEL1.txt,346607,348072,1465,10,Y,N,-,-1,-1
REMKEL1.txt,346715,348079,1364,10,Y,N,-,-1,-1
REMKEL1.txt,346739,348120,1381,10,Y,N,-,-1,-1
REMKEL1.txt,346879,348139,1260,10,Y,N,-,-1,-1
REMKEL1.txt,346898,348149,1251,10,Y,N,-,-1,-1
REMKEL1.txt,347386,348165,779,10,Y,N,-,-1,-1
REMKEL1.txt,347487,348251,764,10,Y,N,-,-1,-1
REMKEL1.txt,347615,348333,718,10,Y,N,-,-1,-1
REMKEL1.txt,347768,348522,754,10,N,N,-,-1,-1
REMKEL1.txt,347862,348623,761,10,N,N,-,-1,-1
REMKEL1.txt,348073,348670,597,10,N,Y,1448325046337,230539,231128
REMKEL1.txt,348082,349182,1100,10,N,Y,1448325046337,230539,231128
REMKEL1.txt,348123,349418,1295,10,Y,Y,1448325046337,230539,231128
REMKEL1.txt,348140,349506,1366,10,Y,Y,1448325046337,230539,231128
REMKEL1.txt,348152,349608,1456,10,Y,Y,1448325046337,230539,231128
REMKEL1.txt,348170,349649,1479,10,N,Y,1448325046337,230539,231128
REMKEL1.txt,348252,349731,1479,10,N,Y,1448325046337,230539,231128
REMKEL1.txt,348336,349866,1530,10,N,Y,1448325046337,230539,231128
REMKEL1.txt,348523,350290,1767,10,N,Y,1448325046337,230539,231128
REMKEL1.txt,348624,350405,1781,10,N,Y,1448325046337,230539,231128
REMKEL1.txt,348671,350718,2047,10,Y,Y,1448325046337,230539,231128
REMKEL1.txt,349183,350804,1621,10,N,Y,1448325046337,230539,231128
REMKEL1.txt,349419,350995,1576,10,N,Y,1448325046337,230539,231128
REMKEL1.txt,349507,351223,1716,10,Y,Y,1448325046337,230539,231128
REMKEL1.txt,349611,351368,1757,10,Y,Y,1448325046337,230539,231128
REMKEL1.txt,349650,351548,1898,10,Y,Y,1448325046337,230539,231128
REMKEL1.txt,349732,351672,1940,10,Y,Y,1448325046337,230539,231128
REMKEL1.txt,349869,351962,2093,10,Y,Y,1448325046337,230539,231128
REMKEL1.txt,350293,352166,1873,10,Y,N,-,-1,-1
REMKEL1.txt,350406,352296,1890,10,N,N,-,-1,-1
REMKEL1.txt,350719,352365,1646,10,N,N,-,-1,-1
REMKEL1.txt,350805,352439,1634,10,N,N,-,-1,-1
REMKEL1.txt,350996,352574,1578,10,N,N,-,-1,-1
REMKEL1.txt,351224,352654,1430,10,N,N,-,-1,-1
REMKEL1.txt,351371,352724,1353,10,N,N,-,-1,-1
REMKEL1.txt,351549,352785,1236,10,N,N,-,-1,-1
REMKEL1.txt,351673,352872,1199,10,N,N,-,-1,-1
REMKEL1.txt,351965,352997,1032,10,N,N,-,-1,-1
REMKEL1.txt,352167,353102,935,10,N,N,-,-1,-1
REMKEL1.txt,352299,353198,899,10,N,N,-,-1,-1
REMKEL1.txt,352368,353399,1031,10,N,N,-,-1,-1
REMKEL1.txt,352440,353481,1041,10,N,N,-,-1,-1
REMKEL1.txt,352575,353704,1129,10,N,N,-,-1,-1
REMKEL1.txt,352654,353711,1057,10,N,N,-,-1,-1
REMKEL1.txt,352725,353809,1084,10,N,N,-,-1,-1
REMKEL1.txt,352786,353884,1098,10,N,N,-,-1,-1
REMKEL1.txt,352873,354146,1273,10,N,N,-,-1,-1
REMKEL1.txt,352998,354318,1320,10,N,N,-,-1,-1
REMKEL1.txt,353104,354671,1567,10,N,N,-,-1,-1
REMKEL1.txt,353199,354771,1572,10,N,N,-,-1,-1
REMKEL1.txt,353401,354949,1548,10,N,N,-,-1,-1
REMKEL1.txt,353482,355100,1618,10,N,N,-,-1,-1
REMKEL1.txt,353707,355218,1511,10,N,N,-,-1,-1
REMKEL1.txt,353712,355350,1638,10,N,N,-,-1,-1
REMKEL1.txt,353810,355457,1647,10,N,N,-,-1,-1
REMKEL1.txt,353886,355616,1730,10,N,N,-,-1,-1
REMKEL1.txt,354149,355680,1531,10,N,N,-,-1,-1
REMKEL1.txt,354319,355907,1588,10,N,N,-,-1,-1
REMKEL1.txt,354672,355993,1321,10,N,N,-,-1,-1
REMKEL1.txt,354774,356097,1323,10,N,N,-,-1,-1
REMKEL1.txt,354950,356270,1320,10,N,N,-,-1,-1
REMKEL1.txt,355101,356317,1216,10,N,N,-,-1,-1
REMKEL1.txt,355219,356450,1231,10,N,N,-,-1,-1
REMKEL1.txt,355353,356637,1284,10,N,N,-,-1,-1
REMKEL1.txt,355458,356776,1318,10,N,N,-,-1,-1
REMKEL1.txt,355617,356865,1248,10,N,N,-,-1,-1
REMKEL1.txt,355681,356986,1305,10,N,N,-,-1,-1
REMKEL1.txt,355908,357089,1181,10,N,N,-,-1,-1
REMKEL1.txt,355994,357347,1353,10,N,N,-,-1,-1
REMKEL1.txt,356098,357518,1420,10,N,N,-,-1,-1
REMKEL1.txt,356271,357547,1276,10,N,N,-,-1,-1
REMKEL1.txt,356320,357694,1374,10,N,N,-,-1,-1
REMKEL1.txt,356451,357788,1337,10,N,N,-,-1,-1
REMKEL1.txt,356638,357815,1177,10,N,N,-,-1,-1
REMKEL1.txt,356779,357864,1085,10,N,N,-,-1,-1
REMKEL1.txt,356866,358105,1239,10,N,N,-,-1,-1
REMKEL1.txt,356987,358205,1218,10,N,N,-,-1,-1
REMKEL1.txt,357090,358383,1293,10,N,N,-,-1,-1
REMKEL1.txt,357347,358440,1093,10,N,N,-,-1,-1
REMKEL1.txt,357519,358641,1122,10,N,N,-,-1,-1
REMKEL1.txt,357548,358759,1211,10,N,N,-,-1,-1
REMKEL1.txt,357697,359003,1306,10,N,N,-,-1,-1
REMKEL1.txt,357789,359161,1372,10,N,N,-,-1,-1
REMKEL1.txt,357818,359338,1520,10,N,N,-,-1,-1
REMKEL1.txt,357865,359422,1557,10,N,N,-,-1,-1
REMKEL1.txt,358106,359600,1494,10,N,N,-,-1,-1
REMKEL1.txt,358208,359768,1560,10,N,N,-,-1,-1
REMKEL1.txt,358386,359867,1481,10,N,N,-,-1,-1
REMKEL1.txt,358441,359966,1525,10,N,N,-,-1,-1
REMKEL1.txt,358642,360105,1463,10,N,N,-,-1,-1
REMKEL1.txt,358760,360215,1455,10,N,N,-,-1,-1
REMKEL1.txt,359004,360453,1449,10,N,N,-,-1,-1
REMKEL1.txt,359166,360472,1306,10,N,N,-,-1,-1
REMKEL1.txt,359340,360636,1296,10,N,N,-,-1,-1
REMKEL1.txt,359423,360958,1535,10,N,N,-,-1,-1
REMKEL1.txt,359601,361102,1501,10,N,N,-,-1,-1
REMKEL1.txt,359769,361396,1627,10,N,N,-,-1,-1
REMKEL1.txt,359868,361821,1953,10,N,N,-,-1,-1
REMKEL1.txt,359967,362084,2117,10,N,N,-,-1,-1
REMKEL1.txt,360106,362230,2124,10,N,N,-,-1,-1
REMKEL1.txt,360218,362406,2188,10,N,N,-,-1,-1
REMKEL1.txt,360458,362651,2193,10,N,N,-,-1,-1
REMKEL1.txt,360473,362931,2458,10,N,N,-,-1,-1
REMKEL1.txt,360639,363000,2361,10,N,N,-,-1,-1
REMKEL1.txt,360961,363155,2194,10,N,N,-,-1,-1
REMKEL1.txt,361103,363188,2085,10,N,N,-,-1,-1
REMKEL1.txt,361399,363268,1869,10,N,Y,1437475017618,98942,100041
REMKEL1.txt,361824,363292,1468,10,N,Y,1437475017618,98942,100041
REMKEL1.txt,362085,363349,1264,10,N,Y,1437475017618,98942,100041
REMKEL1.txt,362231,363550,1319,10,N,Y,1437475017618,98942,100041
REMKEL1.txt,362407,363685,1278,10,N,Y,1437475017618,98942,100041
REMKEL1.txt,362654,363883,1229,10,N,Y,1437475017618,98942,100041
REMKEL1.txt,362934,364027,1093,10,N,Y,1437475017618,98942,100041
REMKEL1.txt,363001,364062,1061,10,N,Y,1437475017618,98942,100041
REMKEL1.txt,363156,364266,1110,10,N,Y,1437475017618,98942,100041
REMKEL1.txt,363191,364355,1164,10,N,Y,1437475017618,98942,100041
REMKEL1.txt,363269,364601,1332,10,N,Y,1437475017618,98942,100041
REMKEL1.txt,363293,364737,1444,10,N,Y,1437475017618,98942,100041
REMKEL1.txt,363350,364856,1506,10,Y,Y,1437475017618,98942,100041
REMKEL1.txt,363551,364984,1433,10,Y,Y,1437475017618,98942,100041
REMKEL1.txt,363686,365130,1444,10,Y,Y,1437475017618,98942,100041
REMKEL1.txt,363884,365444,1560,10,Y,Y,1437475017618,98942,100041
REMKEL1.txt,364028,365559,1531,10,Y,Y,1437475017618,98942,100041
REMKEL1.txt,364065,365721,1656,10,Y,N,-,-1,-1
REMKEL1.txt,364267,365725,1458,10,Y,N,-,-1,-1
REMKEL1.txt,364356,366227,1871,10,Y,N,-,-1,-1
REMKEL1.txt,364604,366413,1809,10,Y,N,-,-1,-1
REMKEL1.txt,364738,366524,1786,10,Y,N,-,-1,-1
REMKEL1.txt,364857,366640,1783,10,Y,N,-,-1,-1
REMKEL1.txt,364986,366716,1730,10,Y,N,-,-1,-1
REMKEL1.txt,365132,367022,1890,10,Y,N,-,-1,-1
REMKEL1.txt,365447,367041,1594,10,Y,N,-,-1,-1
REMKEL1.txt,365560,367049,1489,10,Y,N,-,-1,-1
REMKEL1.txt,365722,367206,1484,10,Y,N,-,-1,-1
REMKEL1.txt,365726,367424,1698,10,Y,N,-,-1,-1
REMKEL1.txt,366230,367555,1325,10,Y,N,-,-1,-1
REMKEL1.txt,366416,367848,1432,10,Y,N,-,-1,-1
REMKEL1.txt,366525,367974,1449,10,Y,N,-,-1,-1
REMKEL1.txt,366641,368113,1472,10,N,N,-,-1,-1
REMKEL1.txt,366717,368277,1560,10,Y,N,-,-1,-1
REMKEL1.txt,367025,368387,1362,10,N,N,-,-1,-1
REMKEL1.txt,367041,368600,1559,10,N,N,-,-1,-1
REMKEL1.txt,367050,368742,1692,10,N,N,-,-1,-1
REMKEL1.txt,367211,368915,1704,10,Y,N,-,-1,-1
REMKEL1.txt,367425,368971,1546,10,N,N,-,-1,-1
REMKEL1.txt,367556,369118,1562,10,N,N,-,-1,-1
REMKEL1.txt,367851,369250,1399,10,Y,Y,1437472966198,394609,395892
REMKEL1.txt,367975,369579,1604,10,Y,Y,1437472966198,394609,395892
REMKEL1.txt,368114,369790,1676,10,Y,Y,1437472966198,394609,395892
REMKEL1.txt,368280,369976,1696,10,N,Y,1437472966198,394609,395892
REMKEL1.txt,368390,370132,1742,10,N,Y,1437472966198,394609,395892
REMKEL1.txt,368601,370283,1682,10,N,Y,1437472966198,394609,395892
REMKEL1.txt,368743,370342,1599,10,N,Y,1437472966198,394609,395892
REMKEL1.txt,368916,370403,1487,10,N,Y,1437472966198,394609,395892
REMKEL1.txt,368972,370657,1685,10,N,Y,1437472966198,394609,395892
REMKEL1.txt,369121,370896,1775,10,N,Y,1437472966198,394609,395892
REMKEL1.txt,369251,370954,1703,10,N,Y,1437472966198,394609,395892
REMKEL1.txt,369582,371164,1582,10,N,N,-,-1,-1
REMKEL1.txt,369791,371428,1637,10,N,N,-,-1,-1
REMKEL1.txt,369977,371507,1530,10,N,N,-,-1,-1
REMKEL1.txt,370133,371559,1426,10,N,N,-,-1,-1
REMKEL1.txt,370284,371724,1440,10,N,N,-,-1,-1
REMKEL1.txt,370344,371865,1521,10,N,N,-,-1,-1
REMKEL1.txt,370404,372047,1643,10,N,N,-,-1,-1
REMKEL1.txt,370660,372097,1437,10,N,N,-,-1,-1
REMKEL1.txt,370897,372168,1271,10,N,N,-,-1,-1
REMKEL1.txt,370955,372211,1256,10,Y,N,-,-1,-1
REMKEL1.txt,371167,372401,1234,10,Y,N,-,-1,-1
REMKEL1.txt,371431,372597,1166,10,Y,N,-,-1,-1
REMKEL1.txt,371508,372804,1296,10,Y,N,-,-1,-1
REMKEL1.txt,371560,372923,1363,10,Y,N,-,-1,-1
REMKEL1.txt,371725,373006,1281,10,Y,N,-,-1,-1
REMKEL1.txt,371866,373014,1148,10,Y,N,-,-1,-1
REMKEL1.txt,372050,373335,1285,10,Y,N,-,-1,-1
REMKEL1.txt,372098,373343,1245,10,Y,N,-,-1,-1
REMKEL1.txt,372169,373380,1211,10,Y,N,-,-1,-1
REMKEL1.txt,372212,373514,1302,10,Y,N,-,-1,-1
REMKEL1.txt,372402,373654,1252,10,Y,N,-,-1,-1
REMKEL1.txt,372598,373900,1302,10,Y,N,-,-1,-1
REMKEL1.txt,372805,374049,1244,10,Y,N,-,-1,-1
REMKEL1.txt,372924,374068,1144,10,Y,N,-,-1,-1
REMKEL1.txt,373007,374208,1201,10,Y,N,-,-1,-1
REMKEL1.txt,373015,374603,1588,10,Y,N,-,-1,-1
REMKEL1.txt,373336,374922,1586,10,Y,N,-,-1,-1
REMKEL1.txt,373344,375027,1683,10,Y,N,-,-1,-1
REMKEL1.txt,373381,375192,1811,10,Y,N,-,-1,-1
REMKEL1.txt,373515,375234,1719,10,N,N,-,-1,-1
REMKEL1.txt,373655,375283,1628,10,N,N,-,-1,-1
REMKEL1.txt,373901,375367,1466,10,N,N,-,-1,-1
REMKEL1.txt,374054,375387,1333,10,N,N,-,-1,-1
REMKEL1.txt,374069,375523,1454,10,N,N,-,-1,-1
REMKEL1.txt,374209,375665,1456,10,N,N,-,-1,-1
REMKEL1.txt,374605,375809,1204,10,N,N,-,-1,-1
REMKEL1.txt,374925,375892,967,10,N,N,-,-1,-1
REMKEL1.txt,375028,376208,1180,10,N,N,-,-1,-1
REMKEL1.txt,375193,376357,1164,10,N,N,-,-1,-1
REMKEL1.txt,375235,376785,1550,10,N,N,-,-1,-1
REMKEL1.txt,375284,376899,1615,10,N,N,-,-1,-1
REMKEL1.txt,375367,376918,1551,10,N,N,-,-1,-1
REMKEL1.txt,375388,377073,1685,10,N,N,-,-1,-1
REMKEL1.txt,375524,377207,1683,10,N,N,-,-1,-1
REMKEL1.txt,375668,377353,1685,10,N,N,-,-1,-1
REMKEL1.txt,375810,377455,1645,10,N,N,-,-1,-1
REMKEL1.txt,375893,377476,1583,10,N,N,-,-1,-1
REMKEL1.txt,376209,378011,1802,10,N,N,-,-1,-1
REMKEL1.txt,376360,378154,1794,10,N,N,-,-1,-1
REMKEL1.txt,376786,378540,1754,10,N,N,-,-1,-1
REMKEL1.txt,376904,379215,2311,10,N,N,-,-1,-1
REMKEL1.txt,376919,379350,2431,10,N,N,-,-1,-1
REMKEL1.txt,377074,379526,2452,10,N,N,-,-1,-1
REMKEL1.txt,377208,379679,2471,10,N,N,-,-1,-1
REMKEL1.txt,377354,379723,2369,10,N,N,-,-1,-1
REMKEL1.txt,377456,379815,2359,10,N,N,-,-1,-1
REMKEL1.txt,377479,379912,2433,10,N,N,-,-1,-1
REMKEL1.txt,378012,379995,1983,10,N,N,-,-1,-1
REMKEL1.txt,378157,380111,1954,10,N,N,-,-1,-1
REMKEL1.txt,378543,380114,1571,10,N,N,-,-1,-1
REMKEL1.txt,379216,380232,1016,10,N,N,-,-1,-1
REMKEL1.txt,379351,380472,1121,10,N,N,-,-1,-1
REMKEL1.txt,379527,380578,1051,10,N,N,-,-1,-1
REMKEL1.txt,379680,380822,1142,10,N,N,-,-1,-1
REMKEL1.txt,379724,381066,1342,10,N,N,-,-1,-1
REMKEL1.txt,379816,381200,1384,10,N,N,-,-1,-1
REMKEL1.txt,379913,381324,1411,10,N,N,-,-1,-1
REMKEL1.txt,379996,381394,1398,10,N,N,-,-1,-1
REMKEL1.txt,380112,381534,1422,10,N,N,-,-1,-1
REMKEL1.txt,380114,381572,1458,10,N,N,-,-1,-1
REMKEL1.txt,380233,381719,1486,10,N,N,-,-1,-1
REMKEL1.txt,380473,381883,1410,10,N,N,-,-1,-1
REMKEL1.txt,380579,381915,1336,10,N,N,-,-1,-1
REMKEL1.txt,380823,382135,1312,10,N,N,-,-1,-1
REMKEL1.txt,381067,382344,1277,10,N,N,-,-1,-1
REMKEL1.txt,381201,382395,1194,10,N,N,-,-1,-1
REMKEL1.txt,381327,382530,1203,10,N,N,-,-1,-1
REMKEL1.txt,381395,382585,1190,10,N,N,-,-1,-1
REMKEL1.txt,381535,382817,1282,10,N,N,-,-1,-1
REMKEL1.txt,381573,382935,1362,10,N,N,-,-1,-1
REMKEL1.txt,381720,383034,1314,10,N,N,-,-1,-1
REMKEL1.txt,381884,383062,1178,10,N,N,-,-1,-1
REMKEL1.txt,381916,383205,1289,10,N,N,-,-1,-1
REMKEL1.txt,382138,383348,1210,10,N,N,-,-1,-1
REMKEL1.txt,382345,383476,1131,10,N,N,-,-1,-1
REMKEL1.txt,382396,383511,1115,10,N,N,-,-1,-1
REMKEL1.txt,382531,383685,1154,10,N,N,-,-1,-1
REMKEL1.txt,382586,383803,1217,10,N,N,-,-1,-1
REMKEL1.txt,382818,384050,1232,10,N,N,-,-1,-1
REMKEL1.txt,382936,384194,1258,10,N,N,-,-1,-1
REMKEL1.txt,383035,384247,1212,10,N,N,-,-1,-1
REMKEL1.txt,383063,384259,1196,10,N,N,-,-1,-1
REMKEL1.txt,383206,384321,1115,10,N,N,-,-1,-1
REMKEL1.txt,383351,384379,1028,10,N,N,-,-1,-1
REMKEL1.txt,383476,384538,1062,10,N,N,-,-1,-1
REMKEL1.txt,383512,384702,1190,10,N,N,-,-1,-1
REMKEL1.txt,383686,384746,1060,10,N,N,-,-1,-1
REMKEL1.txt,383804,384792,988,10,N,N,-,-1,-1
REMKEL1.txt,384051,385040,989,10,N,N,-,-1,-1
REMKEL1.txt,384195,385063,868,10,N,N,-,-1,-1
REMKEL1.txt,384248,385271,1023,10,N,N,-,-1,-1
REMKEL1.txt,384262,385351,1089,10,N,N,-,-1,-1
REMKEL1.txt,384322,385455,1133,10,N,N,-,-1,-1
REMKEL1.txt,384380,385587,1207,10,N,N,-,-1,-1
REMKEL1.txt,384539,385756,1217,10,N,N,-,-1,-1
REMKEL1.txt,384703,385855,1152,10,N,N,-,-1,-1
REMKEL1.txt,384749,385964,1215,10,N,N,-,-1,-1
REMKEL1.txt,384795,386028,1233,10,N,N,-,-1,-1
REMKEL1.txt,385043,386271,1228,10,N,N,-,-1,-1
REMKEL1.txt,385064,386391,1327,10,N,N,-,-1,-1
REMKEL1.txt,385272,386461,1189,10,N,N,-,-1,-1
REMKEL1.txt,385353,386659,1306,10,N,N,-,-1,-1
REMKEL1.txt,385458,386816,1358,10,N,N,-,-1,-1
REMKEL1.txt,385588,386917,1329,10,N,N,-,-1,-1
REMKEL1.txt,385757,386950,1193,10,N,N,-,-1,-1
REMKEL1.txt,385856,387037,1181,10,N,N,-,-1,-1
REMKEL1.txt,385965,387121,1156,10,N,N,-,-1,-1
REMKEL1.txt,386031,387190,1159,10,N,N,-,-1,-1
REMKEL1.txt,386272,387290,1018,10,N,N,-,-1,-1
REMKEL1.txt,386392,387417,1025,10,N,N,-,-1,-1
REMKEL1.txt,386462,387662,1200,10,N,N,-,-1,-1
REMKEL1.txt,386660,387796,1136,10,N,N,-,-1,-1
REMKEL1.txt,386817,387954,1137,10,N,N,-,-1,-1
REMKEL1.txt,386918,388026,1108,10,N,N,-,-1,-1
REMKEL1.txt,386952,388116,1164,10,N,N,-,-1,-1
REMKEL1.txt,387038,388285,1247,10,N,N,-,-1,-1
REMKEL1.txt,387122,388641,1519,10,N,N,-,-1,-1
REMKEL1.txt,387191,388853,1662,10,N,N,-,-1,-1
REMKEL1.txt,387292,389000,1708,10,N,N,-,-1,-1
REMKEL1.txt,387420,389302,1882,10,N,N,-,-1,-1
REMKEL1.txt,387663,389450,1787,10,N,N,-,-1,-1
REMKEL1.txt,387801,389633,1832,10,N,N,-,-1,-1
REMKEL1.txt,387955,389857,1902,10,N,N,-,-1,-1
REMKEL1.txt,388027,389906,1879,10,N,N,-,-1,-1
REMKEL1.txt,388117,390124,2007,10,N,N,-,-1,-1
REMKEL1.txt,388286,390203,1917,10,N,N,-,-1,-1
REMKEL1.txt,388643,390316,1673,10,N,N,-,-1,-1
REMKEL1.txt,388854,390412,1558,10,N,N,-,-1,-1
REMKEL1.txt,389002,390503,1501,10,N,N,-,-1,-1
REMKEL1.txt,389303,390647,1344,10,N,N,-,-1,-1
REMKEL1.txt,389451,391068,1617,10,N,N,-,-1,-1
REMKEL1.txt,389636,391195,1559,10,N,N,-,-1,-1
REMKEL1.txt,389858,391279,1421,10,N,N,-,-1,-1
REMKEL1.txt,389907,391445,1538,10,N,N,-,-1,-1
REMKEL1.txt,390127,391660,1533,10,N,N,-,-1,-1
REMKEL1.txt,390204,391956,1752,10,N,N,-,-1,-1
REMKEL1.txt,390317,391999,1682,10,N,N,-,-1,-1
REMKEL1.txt,390413,392130,1717,10,N,N,-,-1,-1
REMKEL1.txt,390504,392427,1923,10,N,N,-,-1,-1
REMKEL1.txt,390650,392468,1818,10,N,N,-,-1,-1
REMKEL1.txt,391069,392963,1894,10,Y,N,-,-1,-1
REMKEL1.txt,391196,393021,1825,10,Y,N,-,-1,-1
REMKEL1.txt,391280,393139,1859,10,Y,N,-,-1,-1
REMKEL1.txt,391448,393229,1781,10,N,N,-,-1,-1
REMKEL1.txt,391661,393241,1580,10,N,N,-,-1,-1
REMKEL1.txt,391957,393306,1349,10,N,N,-,-1,-1
REMKEL1.txt,392002,393687,1685,10,N,N,-,-1,-1
REMKEL1.txt,392133,394146,2013,10,N,N,-,-1,-1
REMKEL1.txt,392430,394356,1926,10,N,N,-,-1,-1
REMKEL1.txt,392469,394551,2082,10,N,N,-,-1,-1
REMKEL1.txt,392966,394694,1728,10,N,N,-,-1,-1
REMKEL1.txt,393022,394958,1936,10,N,N,-,-1,-1
REMKEL1.txt,393140,395064,1924,10,N,N,-,-1,-1
REMKEL1.txt,393230,395237,2007,10,N,N,-,-1,-1
REMKEL1.txt,393242,395528,2286,10,N,N,-,-1,-1
REMKEL1.txt,393307,395695,2388,10,N,N,-,-1,-1
REMKEL1.txt,393690,395795,2105,10,N,N,-,-1,-1
REMKEL1.txt,394149,396009,1860,10,N,N,-,-1,-1
REMKEL1.txt,394357,396029,1672,10,N,N,-,-1,-1
REMKEL1.txt,394554,396107,1553,10,N,N,-,-1,-1
REMKEL1.txt,394695,396285,1590,10,N,N,-,-1,-1
REMKEL1.txt,394960,396395,1435,10,N,N,-,-1,-1
REMKEL1.txt,395065,396453,1388,10,N,N,-,-1,-1
REMKEL1.txt,395238,396701,1463,10,N,N,-,-1,-1
REMKEL1.txt,395529,396824,1295,10,N,N,-,-1,-1
REMKEL1.txt,395696,396944,1248,10,N,N,-,-1,-1
REMKEL1.txt,395796,396981,1185,10,N,N,-,-1,-1
REMKEL1.txt,396009,397139,1130,10,N,N,-,-1,-1
REMKEL1.txt,396034,397310,1276,10,N,N,-,-1,-1
REMKEL1.txt,396108,397417,1309,10,N,N,-,-1,-1
REMKEL1.txt,396286,397522,1236,10,N,N,-,-1,-1
REMKEL1.txt,396396,397616,1220,10,N,N,-,-1,-1
REMKEL1.txt,396454,397800,1346,10,N,N,-,-1,-1
REMKEL1.txt,396702,397886,1184,10,N,N,-,-1,-1
REMKEL1.txt,396825,398148,1323,10,N,N,-,-1,-1
REMKEL1.txt,396947,398230,1283,10,N,N,-,-1,-1
REMKEL1.txt,396982,398360,1378,10,N,N,-,-1,-1
REMKEL1.txt,397141,398764,1623,10,N,N,-,-1,-1
REMKEL1.txt,397311,398879,1568,10,N,N,-,-1,-1
REMKEL1.txt,397418,399030,1612,10,N,N,-,-1,-1
REMKEL1.txt,397525,399261,1736,10,N,N,-,-1,-1
REMKEL1.txt,397617,399480,1863,10,N,N,-,-1,-1
REMKEL1.txt,397803,399885,2082,10,N,N,-,-1,-1
REMKEL1.txt,397887,400062,2175,10,N,Y,1437471855423,351318,351853
REMKEL1.txt,398150,400300,2150,10,N,Y,1437471855423,351318,351853
REMKEL1.txt,398231,400395,2164,10,N,Y,1437471855423,351318,351853
REMKEL1.txt,398361,400895,2534,10,N,Y,1437471855423,351318,351853
REMKEL1.txt,398765,401113,2348,10,N,Y,1437471855423,351318,351853
REMKEL1.txt,398880,401250,2370,10,N,Y,1437471855423,351318,351853
REMKEL1.txt,399033,401320,2287,10,N,Y,1437471855423,351318,351853
REMKEL1.txt,399262,401445,2183,10,N,Y,1437471855423,351318,351853
REMKEL1.txt,399482,401582,2100,10,N,Y,1437471855423,351318,351853
REMKEL1.txt,399888,401656,1768,10,N,Y,1437471855423,351318,351853
REMKEL1.txt,400063,401849,1786,10,N,Y,1437471855423,351318,351853
REMKEL1.txt,400301,401998,1697,10,N,Y,1437471855423,351318,351853
REMKEL1.txt,400398,402243,1845,10,N,N,-,-1,-1
REMKEL1.txt,400896,402262,1366,10,N,N,-,-1,-1
REMKEL1.txt,401114,402338,1224,10,N,N,-,-1,-1
REMKEL1.txt,401251,402877,1626,10,N,N,-,-1,-1
REMKEL1.txt,401323,403030,1707,10,N,N,-,-1,-1
REMKEL1.txt,401446,403077,1631,10,N,N,-,-1,-1
REMKEL1.txt,401583,403275,1692,10,N,N,-,-1,-1
REMKEL1.txt,401657,403371,1714,10,N,N,-,-1,-1
REMKEL1.txt,401850,403579,1729,10,N,N,-,-1,-1
REMKEL1.txt,401999,403901,1902,10,Y,N,-,-1,-1
REMKEL1.txt,402246,404301,2055,10,Y,N,-,-1,-1
REMKEL1.txt,402265,404368,2103,10,Y,N,-,-1,-1
REMKEL1.txt,402339,404690,2351,10,Y,N,-,-1,-1
REMKEL1.txt,402878,404773,1895,10,Y,N,-,-1,-1
REMKEL1.txt,403031,404858,1827,10,Y,Y,1448038803075,18895,19670
REMKEL1.txt,403078,405064,1986,10,Y,Y,1448038803075,18895,19670
REMKEL1.txt,403276,405350,2074,10,Y,Y,1448038803075,18895,19670
REMKEL1.txt,403372,405491,2119,10,Y,Y,1448038803075,18895,19670
REMKEL1.txt,403580,405653,2073,10,Y,Y,1448038803075,18895,19670
REMKEL1.txt,403904,406324,2420,10,Y,Y,1448038803075,18895,19670
REMKEL1.txt,404304,406612,2308,10,N,Y,1448038803075,18895,19670
REMKEL1.txt,404369,406751,2382,10,N,Y,1448038803075,18895,19670
REMKEL1.txt,404691,406873,2182,10,N,Y,1448038803075,18895,19670
REMKEL1.txt,404776,407263,2487,10,N,Y,1448038803075,18895,19670
REMKEL1.txt,404859,407338,2479,10,N,Y,1448038803075,18895,19670
REMKEL1.txt,405065,407450,2385,10,N,Y,1448038803075,18895,19670
REMKEL1.txt,405351,407526,2175,10,N,N,-,-1,-1
REMKEL1.txt,405492,407728,2236,10,N,N,-,-1,-1
REMKEL1.txt,405656,407998,2342,10,N,N,-,-1,-1
REMKEL1.txt,406326,408037,1711,10,N,N,-,-1,-1
REMKEL1.txt,406613,408618,2005,10,N,N,-,-1,-1
REMKEL1.txt,406752,408911,2159,10,Y,N,-,-1,-1
REMKEL1.txt,406876,409410,2534,10,Y,N,-,-1,-1
REMKEL1.txt,407264,409970,2706,10,Y,N,-,-1,-1
REMKEL1.txt,407339,410189,2850,10,Y,N,-,-1,-1
REMKEL1.txt,407451,410361,2910,10,Y,N,-,-1,-1
REMKEL1.txt,407527,410606,3079,10,Y,N,-,-1,-1
REMKEL1.txt,407731,410772,3041,10,Y,N,-,-1,-1
REMKEL1.txt,407999,410941,2942,10,Y,N,-,-1,-1
REMKEL1.txt,408040,410997,2957,10,Y,N,-,-1,-1
REMKEL1.txt,408619,411400,2781,10,Y,N,-,-1,-1
REMKEL1.txt,408913,411747,2834,10,Y,N,-,-1,-1
REMKEL1.txt,409413,411946,2533,10,Y,N,-,-1,-1
REMKEL1.txt,409973,412401,2428,10,Y,N,-,-1,-1
REMKEL1.txt,410190,412523,2333,10,N,Y,1448278147591,54631,55869
REMKEL1.txt,410362,412790,2428,10,Y,Y,1448278147591,54631,55869
REMKEL1.txt,410607,412980,2373,10,Y,Y,1448278147591,54631,55869
REMKEL1.txt,410775,413015,2240,10,Y,Y,1448278147591,54631,55869
REMKEL1.txt,410942,413150,2208,10,N,Y,1448278147591,54631,55869
REMKEL1.txt,410998,413333,2335,10,N,Y,1448278147591,54631,55869
REMKEL1.txt,411403,413519,2116,10,Y,Y,1448278147591,54631,55869
REMKEL1.txt,411748,413784,2036,10,Y,Y,1448278147591,54631,55869
REMKEL1.txt,411949,413984,2035,10,Y,Y,1448278147591,54631,55869
REMKEL1.txt,412404,414162,1758,10,Y,Y,1448278147591,54631,55869
REMKEL1.txt,412524,414383,1859,10,Y,Y,1448278147591,54631,55869
REMKEL1.txt,412791,414456,1665,10,Y,Y,1448278147591,54631,55869
REMKEL1.txt,412981,414696,1715,10,Y,Y,1448278147591,54631,55869
REMKEL1.txt,413016,414772,1756,10,Y,Y,1448278147591,54631,55869
REMKEL1.txt,413151,414903,1752,10,Y,Y,1448278147591,54631,55869
REMKEL1.txt,413334,415246,1912,10,Y,Y,1448278147591,54631,55869
REMKEL1.txt,413520,415322,1802,10,Y,Y,1448278147591,54631,55869
REMKEL1.txt,413785,415365,1580,10,Y,Y,1448278147591,54631,55869
REMKEL1.txt,413985,415430,1445,10,Y,Y,1448278147591,54631,55869
REMKEL1.txt,414165,415443,1278,10,Y,Y,1448278147591,54631,55869
REMKEL1.txt,414384,415467,1083,10,Y,Y,1448278147591,54631,55869
REMKEL1.txt,414457,415854,1397,10,Y,Y,1448278147591,54631,55869
REMKEL1.txt,414697,415882,1185,10,Y,Y,1448278147591,54631,55869
REMKEL1.txt,414773,416014,1241,10,Y,Y,1448278147591,54631,55869
REMKEL1.txt,414904,416256,1352,10,Y,Y,1448278147591,54631,55869
REMKEL1.txt,415249,416564,1315,10,N,Y,1448278147591,54631,55869
REMKEL1.txt,415323,416839,1516,10,N,Y,1448278147591,54631,55869
REMKEL1.txt,415366,416954,1588,10,N,Y,1448278147591,54631,55869
REMKEL1.txt,415431,417353,1922,10,N,Y,1448278147591,54631,55869
REMKEL1.txt,415445,417501,2056,10,N,Y,1448278147591,54631,55869
REMKEL1.txt,415468,417713,2245,10,N,Y,1448278147591,54631,55869
REMKEL1.txt,415855,418186,2331,10,N,N,-,-1,-1
REMKEL1.txt,415885,418290,2405,10,N,N,-,-1,-1
REMKEL1.txt,416017,418636,2619,10,N,N,-,-1,-1
REMKEL1.txt,416257,418898,2641,10,N,N,-,-1,-1
REMKEL1.txt,416565,419216,2651,10,N,N,-,-1,-1
REMKEL1.txt,416840,419413,2573,10,N,N,-,-1,-1
REMKEL1.txt,416957,419716,2759,10,N,N,-,-1,-1
REMKEL1.txt,417354,419806,2452,10,N,N,-,-1,-1
REMKEL1.txt,417502,419922,2420,10,N,N,-,-1,-1
REMKEL1.txt,417716,420008,2292,10,N,N,-,-1,-1
REMKEL1.txt,418187,420065,1878,10,N,N,-,-1,-1
REMKEL1.txt,418293,420605,2312,10,N,N,-,-1,-1
REMKEL1.txt,418637,420896,2259,10,N,N,-,-1,-1
REMKEL1.txt,418900,421125,2225,10,N,N,-,-1,-1
REMKEL1.txt,419217,421232,2015,10,N,N,-,-1,-1
REMKEL1.txt,419414,421444,2030,10,Y,N,-,-1,-1
REMKEL1.txt,419717,421465,1748,10,Y,N,-,-1,-1
REMKEL1.txt,419809,421628,1819,10,Y,N,-,-1,-1
REMKEL1.txt,419923,421732,1809,10,Y,N,-,-1,-1
REMKEL1.txt,420009,421886,1877,10,Y,N,-,-1,-1
REMKEL1.txt,420066,421994,1928,10,Y,N,-,-1,-1
REMKEL1.txt,420606,422149,1543,10,Y,N,-,-1,-1
REMKEL1.txt,420897,422304,1407,10,Y,N,-,-1,-1
REMKEL1.txt,421128,422459,1331,10,Y,N,-,-1,-1
REMKEL1.txt,421233,422552,1319,10,Y,N,-,-1,-1
REMKEL1.txt,421445,422618,1173,10,N,N,-,-1,-1
REMKEL1.txt,421466,422873,1407,10,N,N,-,-1,-1
REMKEL1.txt,421631,423098,1467,10,N,Y,1448039533036,21326,21680
REMKEL1.txt,421734,423296,1562,10,N,Y,1448039533036,21326,21680
REMKEL1.txt,421887,423567,1680,10,N,Y,1448039533036,21326,21680
REMKEL1.txt,421995,423646,1651,10,N,Y,1448039533036,21326,21680
REMKEL1.txt,422152,423707,1555,10,Y,Y,1448039533036,21326,21680
REMKEL1.txt,422305,423873,1568,10,Y,Y,1448039533036,21326,21680
REMKEL1.txt,422460,424018,1558,10,Y,Y,1448039533036,21326,21680
REMKEL1.txt,422553,424120,1567,10,Y,Y,1448039533036,21326,21680
REMKEL1.txt,422619,424139,1520,10,Y,Y,1448039533036,21326,21680
REMKEL1.txt,422874,424302,1428,10,Y,Y,1448039533036,21326,21680
REMKEL1.txt,423101,424335,1234,10,Y,Y,1448039533036,21326,21680
REMKEL1.txt,423298,424402,1104,10,Y,Y,1448039533036,21326,21680
REMKEL1.txt,423568,424790,1222,10,Y,Y,1448039533036,21326,21680
REMKEL1.txt,423647,424898,1251,10,N,Y,1448039533036,21326,21680
REMKEL1.txt,423708,425268,1560,10,N,Y,1448039533036,21326,21680
REMKEL1.txt,423874,425477,1603,10,N,Y,1448039533036,21326,21680
REMKEL1.txt,424021,425933,1912,10,N,N,-,-1,-1
REMKEL1.txt,424125,426541,2416,10,N,N,-,-1,-1
REMKEL1.txt,424140,426752,2612,10,N,N,-,-1,-1
REMKEL1.txt,424303,426911,2608,10,N,N,-,-1,-1
REMKEL1.txt,424336,427104,2768,10,N,N,-,-1,-1
REMKEL1.txt,424405,427327,2922,10,N,N,-,-1,-1
REMKEL1.txt,424791,427459,2668,10,N,N,-,-1,-1
REMKEL1.txt,424900,427520,2620,10,N,N,-,-1,-1
REMKEL1.txt,425269,427688,2419,10,N,N,-,-1,-1
REMKEL1.txt,425477,427783,2306,10,N,N,-,-1,-1
REMKEL1.txt,425936,427854,1918,10,N,N,-,-1,-1
REMKEL1.txt,426544,427873,1329,10,N,N,-,-1,-1
REMKEL1.txt,426753,427998,1245,10,N,N,-,-1,-1
REMKEL1.txt,426912,428166,1254,10,N,N,-,-1,-1
REMKEL1.txt,427105,428271,1166,10,N,N,-,-1,-1
REMKEL1.txt,427330,428355,1025,10,N,N,-,-1,-1
REMKEL1.txt,427460,428483,1023,10,N,N,-,-1,-1
REMKEL1.txt,427521,428712,1191,10,N,N,-,-1,-1
REMKEL1.txt,427691,428787,1096,10,N,N,-,-1,-1
REMKEL1.txt,427784,428915,1131,10,N,N,-,-1,-1
REMKEL1.txt,427855,429100,1245,10,N,N,-,-1,-1
REMKEL1.txt,427874,429284,1410,10,N,N,-,-1,-1
REMKEL1.txt,427999,429512,1513,10,N,N,-,-1,-1
REMKEL1.txt,428171,429567,1396,10,N,N,-,-1,-1
REMKEL1.txt,428274,429643,1369,10,N,N,-,-1,-1
REMKEL1.txt,428356,429911,1555,10,N,Y,1448315575026,182236,182361
REMKEL1.txt,428484,430106,1622,10,N,Y,1448315575026,182236,182361
REMKEL1.txt,428713,430155,1442,10,N,Y,1448315575026,182236,182361
REMKEL1.txt,428788,430224,1436,10,N,Y,1448315575026,182236,182361
REMKEL1.txt,428918,430446,1528,10,N,Y,1448315575026,182236,182361
REMKEL1.txt,429103,430588,1485,10,N,Y,1448315575026,182236,182361
REMKEL1.txt,429285,430670,1385,10,N,Y,1448315575026,182236,182361
REMKEL1.txt,429513,430777,1264,10,N,Y,1448315575026,182236,182361
REMKEL1.txt,429569,430901,1332,10,N,Y,1448315575026,182236,182361
REMKEL1.txt,429646,431182,1536,10,Y,Y,1448315575026,182236,182361
REMKEL1.txt,429914,431569,1655,10,N,Y,1448315575026,182236,182361
REMKEL1.txt,430108,431656,1548,10,N,Y,1437470299748,152207,152889
REMKEL1.txt,430157,431997,1840,10,Y,Y,1437470299748,152207,152889
REMKEL1.txt,430225,432066,1841,10,Y,Y,1437470299748,152207,152889
REMKEL1.txt,430448,432253,1805,10,N,Y,1437470299748,152207,152889
REMKEL1.txt,430589,432321,1732,10,N,Y,1437470299748,152207,152889
REMKEL1.txt,430673,432476,1803,10,Y,Y,1437470299748,152207,152889
REMKEL1.txt,430778,432533,1755,10,Y,Y,1437470299748,152207,152889
REMKEL1.txt,430902,432758,1856,10,Y,Y,1437470299748,152207,152889
REMKEL1.txt,431185,433071,1886,10,Y,Y,1437470299748,152207,152889
REMKEL1.txt,431572,433407,1835,10,Y,Y,1437470299748,152207,152889
REMKEL1.txt,431657,433596,1939,10,Y,Y,1437470299748,152207,152889
REMKEL1.txt,431998,433708,1710,10,Y,Y,1437470299748,152207,152889
REMKEL1.txt,432067,433885,1818,10,Y,Y,1437470299748,152207,152889
REMKEL1.txt,432254,434021,1767,10,Y,Y,1437470299748,152207,152889
REMKEL1.txt,432322,434204,1882,10,Y,Y,1437470299748,152207,152889
REMKEL1.txt,432477,434376,1899,10,Y,Y,1437470299748,152207,152889
REMKEL1.txt,432534,434599,2065,10,Y,Y,1437470299748,152207,152889
REMKEL1.txt,432761,434688,1927,10,Y,Y,1437470299748,152207,152889
REMKEL1.txt,433072,434763,1691,10,Y,Y,1437470299748,152207,152889
REMKEL1.txt,433410,434879,1469,10,Y,Y,1437470299748,152207,152889
REMKEL1.txt,433599,435203,1604,10,N,Y,1437470299748,152207,152889
REMKEL1.txt,433709,435378,1669,10,N,Y,1437470299748,152207,152889
REMKEL1.txt,433886,435450,1564,10,N,Y,1437470299748,152207,152889
REMKEL1.txt,434022,435611,1589,10,N,Y,1437470299748,152207,152889
REMKEL1.txt,434205,435919,1714,10,N,Y,1437470299748,152207,152889
REMKEL1.txt,434379,436366,1987,10,N,Y,1437470299748,152207,152889
REMKEL1.txt,434600,436558,1958,10,N,Y,1448312844411,173573,174472
REMKEL1.txt,434689,436767,2078,10,N,Y,1448312844411,173573,174472
REMKEL1.txt,434766,436808,2042,10,N,Y,1448312844411,173573,174472
REMKEL1.txt,434880,437120,2240,10,N,Y,1448312844411,173573,174472
REMKEL1.txt,435204,437631,2427,10,N,Y,1448312844411,173573,174472
REMKEL1.txt,435379,437706,2327,10,N,Y,1448312844411,173573,174472
REMKEL1.txt,435453,437840,2387,10,N,Y,1448312844411,173573,174472
REMKEL1.txt,435612,437957,2345,10,N,Y,1448312844411,173573,174472
REMKEL1.txt,435922,438245,2323,10,N,Y,1448312844411,173573,174472
REMKEL1.txt,436367,438575,2208,10,N,Y,1448312844411,173573,174472
REMKEL1.txt,436559,439019,2460,10,N,Y,1448312844411,173573,174472
REMKEL1.txt,436768,439068,2300,10,N,Y,1448312844411,173573,174472
REMKEL1.txt,436811,439539,2728,10,N,Y,1448312844411,173573,174472
REMKEL1.txt,437121,439708,2587,10,N,Y,1448312844411,173573,174472
REMKEL1.txt,437634,439774,2140,10,N,Y,1448312844411,173573,174472
REMKEL1.txt,437709,439812,2103,10,N,N,-,-1,-1
REMKEL1.txt,437842,439920,2078,10,N,N,-,-1,-1
REMKEL1.txt,437958,439949,1991,10,N,N,-,-1,-1
REMKEL1.txt,438246,440023,1777,10,N,N,-,-1,-1
REMKEL1.txt,438576,440029,1453,10,N,N,-,-1,-1
REMKEL1.txt,439022,440052,1030,10,N,N,-,-1,-1
REMKEL1.txt,439070,440083,1013,10,N,N,-,-1,-1
REMKEL1.txt,439540,440104,564,10,N,N,-,-1,-1
REMKEL1.txt,439709,440175,466,10,N,N,-,-1,-1
REMKEL1.txt,439776,440245,469,10,N,N,-,-1,-1
REMKEL1.txt,439813,440480,667,10,N,N,-,-1,-1
REMKEL1.txt,439921,440558,637,10,N,Y,1448281071558,89330,89524
REMKEL1.txt,439950,440722,772,10,N,Y,1448281071558,89330,89524
REMKEL1.txt,440024,440834,810,10,N,Y,1448281071558,89330,89524
REMKEL1.txt,440030,440956,926,10,N,Y,1448281071558,89330,89524
REMKEL1.txt,440053,441164,1111,10,N,Y,1448281071558,89330,89524
REMKEL1.txt,440084,441318,1234,10,N,Y,1448281071558,89330,89524
REMKEL1.txt,440105,441402,1297,10,N,Y,1448281071558,89330,89524
REMKEL1.txt,440178,442006,1828,10,N,Y,1448281071558,89330,89524
REMKEL1.txt,440246,442373,2127,10,N,Y,1448281071558,89330,89524
REMKEL1.txt,440483,442403,1920,10,N,Y,1448281071558,89330,89524
REMKEL1.txt,440559,442828,2269,10,N,Y,1448281071558,89330,89524
REMKEL1.txt,440724,443035,2311,10,N,Y,1448281071558,89330,89524
REMKEL1.txt,440835,443261,2426,10,N,Y,1448281071558,89330,89524
REMKEL1.txt,440959,443456,2497,10,N,Y,1448322273366,219239,219544
REMKEL1.txt,441165,443699,2534,10,N,Y,1448322273366,219239,219544
REMKEL1.txt,441319,443906,2587,10,N,Y,1448322273366,219239,219544
REMKEL1.txt,441405,444035,2630,10,N,Y,1448286451685,111065,112127
REMKEL1.txt,442009,444156,2147,10,N,Y,1448286451685,111065,112127
REMKEL1.txt,442374,444568,2194,10,N,Y,1448286451685,111065,112127
REMKEL1.txt,442406,444877,2471,10,N,Y,1448286451685,111065,112127
REMKEL1.txt,442829,445164,2335,10,N,Y,1448286451685,111065,112127
REMKEL1.txt,443036,445208,2172,10,N,Y,1448286451685,111065,112127
REMKEL1.txt,443264,445277,2013,10,N,Y,1448286451685,111065,112127
REMKEL1.txt,443458,445363,1905,10,N,Y,1448286451685,111065,112127
REMKEL1.txt,443701,445396,1695,10,N,Y,1448286451685,111065,112127
REMKEL1.txt,443909,445634,1725,10,N,Y,1448286451685,111065,112127
REMKEL1.txt,444036,445698,1662,10,N,Y,1448357582358,234204,234401
REMKEL1.txt,444157,445824,1667,10,N,Y,1448357582358,234204,234401
REMKEL1.txt,444571,446051,1480,10,N,Y,1448357582358,234204,234401
REMKEL1.txt,444878,446290,1412,10,N,Y,1448357582358,234204,234401
REMKEL1.txt,445165,446444,1279,10,N,Y,1448357582358,234204,234401
REMKEL1.txt,445209,446791,1582,10,N,Y,1448357582358,234204,234401
REMKEL1.txt,445278,447031,1753,10,N,Y,1448357582358,234204,234401
REMKEL1.txt,445364,447342,1978,10,N,Y,1448357582358,234204,234401
REMKEL1.txt,445397,447609,2212,10,N,Y,1448357582358,234204,234401
REMKEL1.txt,445635,447748,2113,10,N,Y,1448357582358,234204,234401
REMKEL1.txt,445699,447901,2202,10,N,Y,1448357582358,234204,234401
REMKEL1.txt,445825,448197,2372,10,N,Y,1448357582358,234204,234401
REMKEL1.txt,446052,448385,2333,10,N,Y,1448357582358,234204,234401
REMKEL1.txt,446291,448411,2120,10,N,N,-,-1,-1
REMKEL1.txt,446445,448649,2204,10,N,N,-,-1,-1
REMKEL1.txt,446794,448771,1977,10,N,N,-,-1,-1
REMKEL1.txt,447036,449098,2062,10,N,N,-,-1,-1
REMKEL1.txt,447343,449216,1873,10,N,N,-,-1,-1
REMKEL1.txt,447610,449352,1742,10,N,N,-,-1,-1
REMKEL1.txt,447749,449582,1833,10,N,N,-,-1,-1
REMKEL1.txt,447902,449739,1837,10,N,Y,1448037533268,13930,15031
REMKEL1.txt,448200,449954,1754,10,N,Y,1448037533268,13930,15031
REMKEL1.txt,448386,450236,1850,10,N,Y,1448037533268,13930,15031
REMKEL1.txt,448416,450255,1839,10,N,Y,1448037533268,13930,15031
REMKEL1.txt,448650,450298,1648,10,N,Y,1448037533268,13930,15031
REMKEL1.txt,448772,450393,1621,10,N,Y,1448037533268,13930,15031
REMKEL1.txt,449099,450505,1406,10,N,Y,1448037533268,13930,15031
REMKEL1.txt,449219,450995,1776,10,N,Y,1448037533268,13930,15031
REMKEL1.txt,449353,451074,1721,10,N,Y,1448037533268,13930,15031
REMKEL1.txt,449585,451178,1593,10,N,Y,1448037533268,13930,15031
REMKEL1.txt,449740,451234,1494,10,N,Y,1448037533268,13930,15031
REMKEL1.txt,449955,451755,1800,10,N,Y,1448037533268,13930,15031
REMKEL1.txt,450237,451868,1631,10,N,Y,1448037533268,13930,15031
REMKEL1.txt,450256,451996,1740,10,N,Y,1448037533268,13930,15031
REMKEL1.txt,450301,452092,1791,10,N,Y,1448037533268,13930,15031
REMKEL1.txt,450395,452244,1849,10,N,Y,1448037533268,13930,15031
REMKEL1.txt,450506,452544,2038,10,N,Y,1448037533268,13930,15031
REMKEL1.txt,450996,452986,1990,10,N,Y,1448037533268,13930,15031
REMKEL1.txt,451075,453399,2324,10,N,Y,1448037533268,13930,15031
REMKEL1.txt,451179,453725,2546,10,Y,Y,1448037533268,13930,15031
REMKEL1.txt,451236,453947,2711,10,Y,Y,1448037533268,13930,15031
REMKEL1.txt,451758,453969,2211,10,Y,N,-,-1,-1
REMKEL1.txt,451869,454120,2251,10,Y,N,-,-1,-1
REMKEL1.txt,451998,454383,2385,10,N,N,-,-1,-1
REMKEL1.txt,452094,454593,2499,10,N,N,-,-1,-1
REMKEL1.txt,452245,454767,2522,10,N,N,-,-1,-1
REMKEL1.txt,452545,455120,2575,10,N,N,-,-1,-1
REMKEL1.txt,452989,455362,2373,10,N,N,-,-1,-1
REMKEL1.txt,453400,455468,2068,10,Y,N,-,-1,-1
REMKEL1.txt,453726,455646,1920,10,N,N,-,-1,-1
REMKEL1.txt,453948,455738,1790,10,N,N,-,-1,-1
REMKEL1.txt,453970,455814,1844,10,N,N,-,-1,-1
REMKEL1.txt,454121,455827,1706,10,N,N,-,-1,-1
REMKEL1.txt,454385,455845,1460,10,N,N,-,-1,-1
REMKEL1.txt,454595,455858,1263,10,N,N,-,-1,-1
REMKEL1.txt,454768,455878,1110,10,N,N,-,-1,-1
REMKEL1.txt,455123,455889,766,10,N,N,-,-1,-1
REMKEL1.txt,455367,455906,539,10,N,N,-,-1,-1
REMKEL1.txt,455469,455919,450,10,N,N,-,-1,-1
REMKEL1.txt,455647,455935,288,10,N,N,-,-1,-1
REMKEL1.txt,455741,455948,207,10,N,N,-,-1,-1
REMKEL1.txt,455815,456171,356,10,N,N,-,-1,-1
REMKEL1.txt,455830,456304,474,10,N,N,-,-1,-1
REMKEL1.txt,455846,456453,607,10,N,N,-,-1,-1
REMKEL1.txt,455861,456535,674,10,N,N,-,-1,-1
REMKEL1.txt,455879,456665,786,10,N,N,-,-1,-1
REMKEL1.txt,455892,456684,792,10,N,N,-,-1,-1
REMKEL1.txt,455907,456807,900,10,N,N,-,-1,-1
REMKEL1.txt,455922,456985,1063,10,N,Y,1448280423373,85694,86154
REMKEL1.txt,455936,457054,1118,10,N,Y,1448280423373,85694,86154
REMKEL1.txt,455951,457055,1104,10,N,Y,1448280423373,85694,86154
REMKEL1.txt,456172,457324,1152,10,N,Y,1448280423373,85694,86154
REMKEL1.txt,456305,457355,1050,10,N,Y,1448280423373,85694,86154
REMKEL1.txt,456454,457551,1097,10,N,Y,1448280423373,85694,86154
REMKEL1.txt,456536,457687,1151,10,N,Y,1448280423373,85694,86154
REMKEL1.txt,456670,457913,1243,10,N,Y,1448280423373,85694,86154
REMKEL1.txt,456685,458298,1613,10,N,Y,1448280423373,85694,86154
REMKEL1.txt,456808,458636,1828,10,N,Y,1448280423373,85694,86154
REMKEL1.txt,456986,458845,1859,10,N,Y,1448279813455,71525,72226
REMKEL1.txt,457054,458890,1836,10,N,Y,1448279813455,71525,72226
REMKEL1.txt,457056,459023,1967,10,N,Y,1448279813455,71525,72226
REMKEL1.txt,457327,459232,1905,10,N,Y,1448279813455,71525,72226
REMKEL1.txt,457356,459349,1993,10,N,Y,1436867017136,105674,106651
REMKEL1.txt,457554,459375,1821,10,N,Y,1436867017136,105674,106651
REMKEL1.txt,457688,459528,1840,10,N,Y,1436867017136,105674,106651
REMKEL1.txt,457914,459548,1634,10,N,Y,1436867017136,105674,106651
REMKEL1.txt,458299,459559,1260,10,N,Y,1436867017136,105674,106651
REMKEL1.txt,458639,459586,947,10,N,Y,1436867017136,105674,106651
REMKEL1.txt,458846,459615,769,10,N,Y,1436867017136,105674,106651
REMKEL1.txt,458891,459636,745,10,N,Y,1436867017136,105674,106651
REMKEL1.txt,459024,459638,614,10,N,Y,1436867017136,105674,106651
REMKEL1.txt,459235,459651,416,10,N,Y,1436867017136,105674,106651
REMKEL1.txt,459350,459662,312,10,N,Y,1436867017136,105674,106651
REMKEL1.txt,459376,459669,293,10,N,Y,1436867017136,105674,106651
REMKEL1.txt,459531,459690,159,10,N,Y,1436867017136,105674,106651
REMKEL1.txt,459549,459700,151,10,N,Y,1436867017136,105674,106651
REMKEL1.txt,459562,459706,144,10,N,Y,1436867017136,105674,106651
REMKEL1.txt,459589,459710,121,10,N,Y,1436867017136,105674,106651
REMKEL1.txt,459618,459717,99,10,N,Y,1436867017136,105674,106651
REMKEL1.txt,459637,459740,103,10,N,Y,1436867017136,105674,106651
REMKEL1.txt,459639,459759,120,10,N,Y,1436867017136,105674,106651
REMKEL1.txt,459654,459783,129,10,N,Y,1436867017136,105674,106651
REMKEL1.txt,459663,459802,139,10,N,Y,1436867017136,105674,106651
REMKEL1.txt,459672,459815,143,10,N,Y,1436867017136,105674,106651
REMKEL1.txt,459693,459840,147,10,N,Y,1436867017136,105674,106651
REMKEL1.txt,459701,459860,159,10,N,Y,1436867017136,105674,106651
REMKEL1.txt,459707,459885,178,10,N,Y,1436867017136,105674,106651
REMKEL1.txt,459711,460026,315,10,N,Y,1436867017136,105674,106651
REMKEL1.txt,459720,460169,449,10,N,Y,1436867017136,105674,106651
REMKEL1.txt,459743,460242,499,10,N,Y,1436867017136,105674,106651
REMKEL1.txt,459762,460388,626,10,N,Y,1436867017136,105674,106651
REMKEL1.txt,459786,460813,1027,10,Y,Y,1436867017136,105674,106651
REMKEL1.txt,459803,460910,1107,10,Y,Y,1436867017136,105674,106651
REMKEL1.txt,459818,461130,1312,10,Y,Y,1436867017136,105674,106651
REMKEL1.txt,459843,461264,1421,10,Y,Y,1436867017136,105674,106651
REMKEL1.txt,459863,461387,1524,10,Y,Y,1436867017136,105674,106651
REMKEL1.txt,459888,461590,1702,10,Y,Y,1436867017136,105674,106651
REMKEL1.txt,460027,461798,1771,10,Y,Y,1436867017136,105674,106651
REMKEL1.txt,460170,461867,1697,10,Y,Y,1436867017136,105674,106651
REMKEL1.txt,460243,461972,1729,10,Y,Y,1436867017136,105674,106651
REMKEL1.txt,460389,462194,1805,10,Y,Y,1436867017136,105674,106651
REMKEL1.txt,460816,462460,1644,10,Y,Y,1448281491382,97818,98860
REMKEL1.txt,460911,462461,1550,10,Y,Y,1448281491382,97818,98860
REMKEL1.txt,461131,462503,1372,10,Y,Y,1448281491382,97818,98860
REMKEL1.txt,461265,462697,1432,10,Y,Y,1448281491382,97818,98860
REMKEL1.txt,461388,463090,1702,10,Y,Y,1448281491382,97818,98860
REMKEL1.txt,461591,463222,1631,10,Y,Y,1448281491382,97818,98860
REMKEL1.txt,461801,463293,1492,10,Y,Y,1448281491382,97818,98860
REMKEL1.txt,461868,463521,1653,10,Y,Y,1448281491382,97818,98860
REMKEL1.txt,461974,463658,1684,10,Y,Y,1448281491382,97818,98860
REMKEL1.txt,462195,463793,1598,10,Y,Y,1448281491382,97818,98860
REMKEL1.txt,462460,463863,1403,10,Y,Y,1448281491382,97818,98860
REMKEL1.txt,462462,464044,1582,10,Y,Y,1448281491382,97818,98860
REMKEL1.txt,462504,464071,1567,10,Y,Y,1448281491382,97818,98860
REMKEL1.txt,462699,464118,1419,10,Y,Y,1448281491382,97818,98860
REMKEL1.txt,463093,464358,1265,10,N,Y,1448281491382,97818,98860
REMKEL1.txt,463223,464460,1237,10,N,Y,1448314192885,179720,179950
REMKEL1.txt,463294,464644,1350,10,N,Y,1448314192885,179720,179950
REMKEL1.txt,463523,464710,1187,10,N,Y,1448314192885,179720,179950
REMKEL1.txt,463659,464829,1170,10,N,Y,1448314192885,179720,179950
REMKEL1.txt,463794,464981,1187,10,N,Y,1448314192885,179720,179950
REMKEL1.txt,463866,465056,1190,10,N,Y,1448314192885,179720,179950
REMKEL1.txt,464045,465124,1079,10,N,Y,1448282044001,101941,102395
REMKEL1.txt,464072,465131,1059,10,Y,Y,1448282044001,101941,102395
REMKEL1.txt,464120,465224,1104,10,Y,Y,1448282044001,101941,102395
REMKEL1.txt,464359,465473,1114,10,Y,Y,1448282044001,101941,102395
REMKEL1.txt,464463,465787,1324,10,Y,Y,1448282044001,101941,102395
REMKEL1.txt,464647,465955,1308,10,N,Y,1448282044001,101941,102395
REMKEL1.txt,464713,466033,1320,10,N,Y,1448282044001,101941,102395
REMKEL1.txt,464830,466281,1451,10,N,Y,1448282044001,101941,102395
REMKEL1.txt,464984,466528,1544,10,N,Y,1448282044001,101941,102395
REMKEL1.txt,465057,466836,1779,10,N,Y,1448282044001,101941,102395
REMKEL1.txt,465124,467150,2026,10,N,Y,1448282044001,101941,102395
REMKEL1.txt,465132,467479,2347,10,N,Y,1448282044001,101941,102395
REMKEL1.txt,465225,467640,2415,10,N,Y,1448282044001,101941,102395
REMKEL1.txt,465474,467945,2471,10,N,Y,1448282044001,101941,102395
REMKEL1.txt,465788,468192,2404,10,N,Y,1448282044001,101941,102395
REMKEL1.txt,465956,468316,2360,10,Y,Y,1448282044001,101941,102395
REMKEL1.txt,466034,468431,2397,10,Y,Y,1448282044001,101941,102395
REMKEL1.txt,466282,468613,2331,10,Y,Y,1448282044001,101941,102395
REMKEL1.txt,466531,468844,2313,10,Y,Y,1448282044001,101941,102395
REMKEL1.txt,466839,468914,2075,10,N,Y,1448282044001,101941,102395
REMKEL1.txt,467153,469208,2055,10,N,Y,1448282044001,101941,102395
REMKEL1.txt,467482,469328,1846,10,N,Y,1448282044001,101941,102395
REMKEL1.txt,467643,469401,1758,10,N,Y,1448282044001,101941,102395
REMKEL1.txt,467946,469648,1702,10,Y,Y,1448282044001,101941,102395
REMKEL1.txt,468193,469876,1683,10,Y,Y,1448282044001,101941,102395
REMKEL1.txt,468319,470034,1715,10,N,Y,1448282044001,101941,102395
REMKEL1.txt,468432,470148,1716,10,N,Y,1448282044001,101941,102395
REMKEL1.txt,468614,470232,1618,10,N,Y,1448282044001,101941,102395
REMKEL1.txt,468844,470383,1539,10,N,N,-,-1,-1
REMKEL1.txt,468917,470463,1546,10,N,N,-,-1,-1
REMKEL1.txt,469210,470522,1312,10,N,N,-,-1,-1
REMKEL1.txt,469329,470851,1522,10,N,N,-,-1,-1
REMKEL1.txt,469404,471190,1786,10,N,N,-,-1,-1
REMKEL1.txt,469650,471287,1637,10,N,N,-,-1,-1
REMKEL1.txt,469877,471497,1620,10,N,N,-,-1,-1
REMKEL1.txt,470035,471638,1603,10,N,N,-,-1,-1
REMKEL1.txt,470149,471692,1543,10,N,N,-,-1,-1
REMKEL1.txt,470233,471832,1599,10,N,N,-,-1,-1
REMKEL1.txt,470384,471896,1512,10,N,N,-,-1,-1
REMKEL1.txt,470464,472036,1572,10,N,N,-,-1,-1
REMKEL1.txt,470523,472152,1629,10,Y,N,-,-1,-1
REMKEL1.txt,470852,472190,1338,10,Y,N,-,-1,-1
REMKEL1.txt,471191,472337,1146,10,Y,N,-,-1,-1
REMKEL1.txt,471290,472549,1259,10,Y,N,-,-1,-1
REMKEL1.txt,471498,472574,1076,10,Y,N,-,-1,-1
REMKEL1.txt,471639,472627,988,10,Y,N,-,-1,-1
REMKEL1.txt,471693,472634,941,10,Y,N,-,-1,-1
REMKEL1.txt,471833,472688,855,10,Y,N,-,-1,-1
REMKEL1.txt,471899,472831,932,10,Y,N,-,-1,-1
REMKEL1.txt,472037,472839,802,10,N,N,-,-1,-1
REMKEL1.txt,472155,472962,807,10,N,N,-,-1,-1
REMKEL1.txt,472191,472981,790,10,N,N,-,-1,-1
REMKEL1.txt,472338,473054,716,10,N,N,-,-1,-1
REMKEL1.txt,472550,473163,613,10,N,N,-,-1,-1
REMKEL1.txt,472575,473298,723,10,N,N,-,-1,-1
REMKEL1.txt,472628,473580,952,10,N,N,-,-1,-1
REMKEL1.txt,472635,473715,1080,10,N,N,-,-1,-1
REMKEL1.txt,472689,473793,1104,10,N,N,-,-1,-1
REMKEL1.txt,472832,473948,1116,10,N,N,-,-1,-1
REMKEL1.txt,472840,474081,1241,10,N,N,-,-1,-1
REMKEL1.txt,472967,474216,1249,10,N,Y,1448280297446,84055,84972
REMKEL1.txt,472984,474403,1419,10,N,Y,1448280297446,84055,84972
REMKEL1.txt,473055,474638,1583,10,N,Y,1448280297446,84055,84972
REMKEL1.txt,473164,474816,1652,10,Y,Y,1448280297446,84055,84972
REMKEL1.txt,473299,474889,1590,10,N,Y,1448280297446,84055,84972
REMKEL1.txt,473581,475039,1458,10,Y,Y,1448280297446,84055,84972
REMKEL1.txt,473716,475143,1427,10,Y,Y,1448280297446,84055,84972
REMKEL1.txt,473794,475338,1544,10,Y,Y,1448280297446,84055,84972
REMKEL1.txt,473949,475459,1510,10,Y,Y,1448280297446,84055,84972
REMKEL1.txt,474084,475701,1617,10,Y,Y,1448280297446,84055,84972
REMKEL1.txt,474217,475847,1630,10,Y,Y,1448280297446,84055,84972
REMKEL1.txt,474404,475921,1517,10,Y,Y,1448280297446,84055,84972
REMKEL1.txt,474641,476339,1698,10,Y,Y,1448280297446,84055,84972
REMKEL1.txt,474817,476472,1655,10,Y,Y,1448280297446,84055,84972
REMKEL1.txt,474891,476639,1748,10,Y,Y,1448280297446,84055,84972
REMKEL1.txt,475042,476799,1757,10,Y,N,-,-1,-1
REMKEL1.txt,475144,476985,1841,10,Y,N,-,-1,-1
REMKEL1.txt,475341,477116,1775,10,Y,N,-,-1,-1
REMKEL1.txt,475460,477173,1713,10,Y,N,-,-1,-1
REMKEL1.txt,475702,477191,1489,10,Y,N,-,-1,-1
REMKEL1.txt,475848,477328,1480,10,N,N,-,-1,-1
REMKEL1.txt,475924,477395,1471,10,N,N,-,-1,-1
REMKEL1.txt,476340,477551,1211,10,N,N,-,-1,-1
REMKEL1.txt,476473,477658,1185,10,N,Y,1448313994373,179347,179715
REMKEL1.txt,476640,477909,1269,10,Y,Y,1448313994373,179347,179715
REMKEL1.txt,476802,478032,1230,10,Y,Y,1448313994373,179347,179715
REMKEL1.txt,476990,478178,1188,10,N,Y,1448313994373,179347,179715
REMKEL1.txt,477117,478316,1199,10,N,Y,1448313994373,179347,179715
REMKEL1.txt,477174,478653,1479,10,N,Y,1448313994373,179347,179715
REMKEL1.txt,477192,478696,1504,10,N,Y,1448313994373,179347,179715
REMKEL1.txt,477331,478922,1591,10,N,Y,1448313994373,179347,179715
REMKEL1.txt,477396,479227,1831,10,N,Y,1448313994373,179347,179715
REMKEL1.txt,477554,479358,1804,10,N,Y,1448313994373,179347,179715
REMKEL1.txt,477659,479491,1832,10,N,Y,1448313994373,179347,179715
REMKEL1.txt,477910,480264,2354,10,N,Y,1448313994373,179347,179715
REMKEL1.txt,478033,480610,2577,10,N,Y,1448313994373,179347,179715
REMKEL1.txt,478179,480939,2760,10,N,Y,1448313994373,179347,179715
REMKEL1.txt,478317,481102,2785,10,N,Y,1448313994373,179347,179715
REMKEL1.txt,478654,481147,2493,10,N,Y,1448313994373,179347,179715
REMKEL1.txt,478699,481328,2629,10,N,Y,1448311366799,143137,146264
REMKEL1.txt,478923,481456,2533,10,N,Y,1448311366799,143137,146264
REMKEL1.txt,479230,481724,2494,10,N,Y,1448311366799,143137,146264
REMKEL1.txt,479359,481877,2518,10,N,Y,1448311366799,143137,146264
REMKEL1.txt,479492,482151,2659,10,N,Y,1448311366799,143137,146264
REMKEL1.txt,480267,482366,2099,10,N,Y,1448311366799,143137,146264
REMKEL1.txt,480611,482549,1938,10,N,Y,1448311366799,143137,146264
REMKEL1.txt,480942,482643,1701,10,N,N,-,-1,-1
REMKEL1.txt,481103,482719,1616,10,N,N,-,-1,-1
REMKEL1.txt,481148,482911,1763,10,N,N,-,-1,-1
REMKEL1.txt,481331,483145,1814,10,N,N,-,-1,-1
REMKEL1.txt,481457,483313,1856,10,N,N,-,-1,-1
REMKEL1.txt,481727,483425,1698,10,N,N,-,-1,-1
REMKEL1.txt,481879,483644,1765,10,N,N,-,-1,-1
REMKEL1.txt,482152,483798,1646,10,N,N,-,-1,-1
REMKEL1.txt,482369,483849,1480,10,N,N,-,-1,-1
REMKEL1.txt,482550,483871,1321,10,N,N,-,-1,-1
REMKEL1.txt,482645,484104,1459,10,N,N,-,-1,-1
REMKEL1.txt,482720,484370,1650,10,N,N,-,-1,-1
REMKEL1.txt,482912,484547,1635,10,N,N,-,-1,-1
REMKEL1.txt,483148,484918,1770,10,N,N,-,-1,-1
REMKEL1.txt,483314,484950,1636,10,N,N,-,-1,-1
REMKEL1.txt,483426,485140,1714,10,N,N,-,-1,-1
REMKEL1.txt,483645,485154,1509,10,N,N,-,-1,-1
REMKEL1.txt,483799,485232,1433,10,N,N,-,-1,-1
REMKEL1.txt,483857,485277,1420,10,N,N,-,-1,-1
REMKEL1.txt,483872,485345,1473,10,N,N,-,-1,-1
REMKEL1.txt,484105,485797,1692,10,N,N,-,-1,-1
REMKEL1.txt,484371,485889,1518,10,N,N,-,-1,-1
REMKEL1.txt,484548,485968,1420,10,N,N,-,-1,-1
REMKEL1.txt,484919,486162,1243,10,N,N,-,-1,-1
REMKEL1.txt,484951,486219,1268,10,N,N,-,-1,-1
REMKEL1.txt,485141,486439,1298,10,N,N,-,-1,-1
REMKEL1.txt,485155,486503,1348,10,N,N,-,-1,-1
REMKEL1.txt,485233,486610,1377,10,N,N,-,-1,-1
REMKEL1.txt,485278,486641,1363,10,N,N,-,-1,-1
REMKEL1.txt,485346,486726,1380,10,N,N,-,-1,-1
REMKEL1.txt,485800,486894,1094,10,N,N,-,-1,-1
REMKEL1.txt,485890,487036,1146,10,N,N,-,-1,-1
REMKEL1.txt,485969,487246,1277,10,N,N,-,-1,-1
REMKEL1.txt,486163,487513,1350,10,N,N,-,-1,-1
REMKEL1.txt,486220,487625,1405,10,N,N,-,-1,-1
REMKEL1.txt,486440,487764,1324,10,N,N,-,-1,-1
REMKEL1.txt,486506,488035,1529,10,N,N,-,-1,-1
REMKEL1.txt,486611,488126,1515,10,N,N,-,-1,-1
REMKEL1.txt,486642,488183,1541,10,N,N,-,-1,-1
REMKEL1.txt,486727,488381,1654,10,N,N,-,-1,-1
REMKEL1.txt,486895,488510,1615,10,N,N,-,-1,-1
REMKEL1.txt,487037,488639,1602,10,N,N,-,-1,-1
REMKEL1.txt,487247,488762,1515,10,N,N,-,-1,-1
REMKEL1.txt,487514,489094,1580,10,N,N,-,-1,-1
REMKEL1.txt,487626,489374,1748,10,N,N,-,-1,-1
REMKEL1.txt,487765,489490,1725,10,N,N,-,-1,-1
REMKEL1.txt,488038,489503,1465,10,N,N,-,-1,-1
REMKEL1.txt,488127,489634,1507,10,N,N,-,-1,-1
REMKEL1.txt,488184,489952,1768,10,N,Y,1448285913012,108803,110925
REMKEL1.txt,488382,490055,1673,10,N,Y,1448285913012,108803,110925
REMKEL1.txt,488513,490466,1953,10,N,Y,1448285913012,108803,110925
REMKEL1.txt,488642,490643,2001,10,N,Y,1448285913012,108803,110925
REMKEL1.txt,488763,490799,2036,10,N,Y,1448285913012,108803,110925
REMKEL1.txt,489095,490953,1858,10,N,Y,1448285913012,108803,110925
REMKEL1.txt,489376,491153,1777,10,N,Y,1448285913012,108803,110925
REMKEL1.txt,489491,491278,1787,10,N,Y,1448285913012,108803,110925
REMKEL1.txt,489504,491546,2042,10,N,Y,1448285913012,108803,110925
REMKEL1.txt,489635,491659,2024,10,N,Y,1448285913012,108803,110925
REMKEL1.txt,489953,491801,1848,10,N,Y,1448285913012,108803,110925
REMKEL1.txt,490058,492075,2017,10,N,Y,1448285913012,108803,110925
REMKEL1.txt,490467,492279,1812,10,N,Y,1448285913012,108803,110925
REMKEL1.txt,490646,492346,1700,10,N,N,-,-1,-1
REMKEL1.txt,490800,492507,1707,10,N,N,-,-1,-1
REMKEL1.txt,490954,492617,1663,10,N,N,-,-1,-1
REMKEL1.txt,491154,492695,1541,10,N,N,-,-1,-1
REMKEL1.txt,491279,492802,1523,10,N,N,-,-1,-1
REMKEL1.txt,491549,493107,1558,10,N,N,-,-1,-1
REMKEL1.txt,491660,493277,1617,10,N,N,-,-1,-1
REMKEL1.txt,491802,493649,1847,10,N,N,-,-1,-1
REMKEL1.txt,492076,493954,1878,10,N,N,-,-1,-1
REMKEL1.txt,492280,494071,1791,10,N,N,-,-1,-1
REMKEL1.txt,492347,494324,1977,10,N,N,-,-1,-1
REMKEL1.txt,492508,494502,1994,10,N,N,-,-1,-1
REMKEL1.txt,492618,494686,2068,10,N,N,-,-1,-1
REMKEL1.txt,492698,494745,2047,10,N,N,-,-1,-1
REMKEL1.txt,492803,494863,2060,10,N,N,-,-1,-1
REMKEL1.txt,493108,495038,1930,10,Y,N,-,-1,-1
REMKEL1.txt,493278,495066,1788,10,Y,N,-,-1,-1
REMKEL1.txt,493654,495159,1505,10,Y,N,-,-1,-1
REMKEL1.txt,493957,495380,1423,10,N,N,-,-1,-1
REMKEL1.txt,494072,495487,1415,10,N,N,-,-1,-1
REMKEL1.txt,494325,495639,1314,10,N,N,-,-1,-1
REMKEL1.txt,494503,495721,1218,10,N,N,-,-1,-1
REMKEL1.txt,494689,495783,1094,10,N,N,-,-1,-1
REMKEL1.txt,494746,496168,1422,10,N,N,-,-1,-1
REMKEL1.txt,494864,496342,1478,10,N,N,-,-1,-1
REMKEL1.txt,495039,496430,1391,10,N,N,-,-1,-1
REMKEL1.txt,495067,496535,1468,10,N,N,-,-1,-1
REMKEL1.txt,495160,496637,1477,10,N,N,-,-1,-1
REMKEL1.txt,495381,496985,1604,10,N,N,-,-1,-1
REMKEL1.txt,495489,497152,1663,10,N,N,-,-1,-1
REMKEL1.txt,495641,497281,1640,10,N,N,-,-1,-1
REMKEL1.txt,495722,497459,1737,10,N,N,-,-1,-1
REMKEL1.txt,495784,497799,2015,10,N,N,-,-1,-1
REMKEL1.txt,496169,497883,1714,10,N,N,-,-1,-1
REMKEL1.txt,496345,497967,1622,10,N,N,-,-1,-1
REMKEL1.txt,496431,498084,1653,10,N,N,-,-1,-1
REMKEL1.txt,496536,498185,1649,10,N,N,-,-1,-1
REMKEL1.txt,496638,498272,1634,10,N,N,-,-1,-1
REMKEL1.txt,496986,498332,1346,10,N,N,-,-1,-1
REMKEL1.txt,497153,498560,1407,10,N,N,-,-1,-1
REMKEL1.txt,497282,498802,1520,10,N,N,-,-1,-1
REMKEL1.txt,497462,498995,1533,10,N,Y,1448274783410,21836,25159
REMKEL1.txt,497800,499122,1322,10,N,Y,1448274783410,21836,25159
REMKEL1.txt,497886,499319,1433,10,N,Y,1448274783410,21836,25159
REMKEL1.txt,497968,499519,1551,10,N,Y,1448274783410,21836,25159
REMKEL1.txt,498086,499660,1574,10,N,Y,1448274783410,21836,25159
REMKEL1.txt,498186,500074,1888,10,N,Y,1448274783410,21836,25159
REMKEL1.txt,498273,500434,2161,10,N,Y,1448274783410,21836,25159
REMKEL1.txt,498333,500554,2221,10,N,Y,1448274783410,21836,25159
REMKEL1.txt,498563,500697,2134,10,N,Y,1448274783410,21836,25159
REMKEL1.txt,498805,500813,2008,10,N,Y,1448274783410,21836,25159
REMKEL1.txt,498996,501172,2176,10,N,Y,1448274783410,21836,25159
REMKEL1.txt,499123,501188,2065,10,N,Y,1448274783410,21836,25159
REMKEL1.txt,499320,501254,1934,10,N,Y,1448274783410,21836,25159
REMKEL1.txt,499521,501263,1742,10,N,Y,1448274783410,21836,25159
REMKEL1.txt,499661,501308,1647,10,N,Y,1448274783410,21836,25159
REMKEL1.txt,500075,501309,1234,10,N,Y,1448274783410,21836,25159
REMKEL1.txt,500437,501334,897,10,N,N,-,-1,-1
REMKEL1.txt,500555,501399,844,10,N,N,-,-1,-1
REMKEL1.txt,500698,501400,702,10,N,N,-,-1,-1
REMKEL1.txt,500816,501417,601,10,N,N,-,-1,-1
REMKEL1.txt,501177,501418,241,10,N,N,-,-1,-1
REMKEL1.txt,501189,501421,232,10,N,N,-,-1,-1
REMKEL1.txt,501262,501467,205,10,N,N,-,-1,-1
REMKEL2.txt,0,528,528,10,N,N,-,-1,-1
REMKEL2.txt,6,534,528,10,N,N,-,-1,-1
REMKEL2.txt,26,538,512,10,N,N,-,-1,-1
REMKEL2.txt,37,588,551,10,N,N,-,-1,-1
REMKEL2.txt,47,596,549,10,N,N,-,-1,-1
REMKEL2.txt,63,661,598,10,N,N,-,-1,-1
REMKEL2.txt,67,704,637,10,N,N,-,-1,-1
REMKEL2.txt,74,755,681,10,N,N,-,-1,-1
REMKEL2.txt,495,787,292,10,N,N,-,-1,-1
REMKEL2.txt,513,861,348,10,N,N,-,-1,-1
REMKEL2.txt,530,923,393,10,N,N,-,-1,-1
REMKEL2.txt,535,957,422,10,N,N,-,-1,-1
REMKEL2.txt,541,979,438,10,N,N,-,-1,-1
REMKEL2.txt,591,1016,425,10,N,N,-,-1,-1
REMKEL2.txt,601,1070,469,10,N,N,-,-1,-1
REMKEL2.txt,666,1110,444,10,N,N,-,-1,-1
REMKEL2.txt,709,1152,443,10,N,N,-,-1,-1
REMKEL2.txt,756,1218,462,10,N,N,-,-1,-1
REMKEL2.txt,788,1312,524,10,N,N,-,-1,-1
REMKEL2.txt,862,1359,497,10,N,N,-,-1,-1
REMKEL2.txt,925,1412,487,10,N,N,-,-1,-1
REMKEL2.txt,958,1463,505,10,N,N,-,-1,-1
REMKEL2.txt,980,1496,516,10,N,N,-,-1,-1
REMKEL2.txt,1017,1544,527,10,N,N,-,-1,-1
REMKEL2.txt,1071,1590,519,10,N,N,-,-1,-1
REMKEL2.txt,1111,1626,515,10,N,N,-,-1,-1
REMKEL2.txt,1153,1670,517,10,N,N,-,-1,-1
REMKEL2.txt,1219,1693,474,10,N,N,-,-1,-1
REMKEL2.txt,1313,1734,421,10,N,N,-,-1,-1
REMKEL2.txt,1360,1778,418,10,N,N,-,-1,-1
REMKEL2.txt,1413,1833,420,10,N,N,-,-1,-1
REMKEL2.txt,1464,1868,404,10,N,N,-,-1,-1
REMKEL2.txt,1497,1978,481,10,N,N,-,-1,-1
REMKEL2.txt,1545,2017,472,10,N,N,-,-1,-1
REMKEL2.txt,1591,2048,457,10,N,N,-,-1,-1
REMKEL2.txt,1627,2094,467,10,N,N,-,-1,-1
REMKEL2.txt,1673,2131,458,10,N,N,-,-1,-1
REMKEL2.txt,1694,2238,544,10,N,N,-,-1,-1
REMKEL2.txt,1735,2326,591,10,N,N,-,-1,-1
REMKEL2.txt,1779,2345,566,10,N,N,-,-1,-1
REMKEL2.txt,1834,2390,556,10,N,N,-,-1,-1
REMKEL2.txt,1869,2414,545,10,N,N,-,-1,-1
REMKEL2.txt,1980,2474,494,10,N,N,-,-1,-1
REMKEL2.txt,2018,2502,484,10,N,N,-,-1,-1
REMKEL2.txt,2049,2522,473,10,N,N,-,-1,-1
REMKEL2.txt,2095,2566,471,10,N,N,-,-1,-1
REMKEL2.txt,2132,2588,456,10,N,N,-,-1,-1
REMKEL2.txt,2241,2639,398,10,N,N,-,-1,-1
REMKEL2.txt,2327,2700,373,10,N,N,-,-1,-1
REMKEL2.txt,2346,2792,446,10,N,N,-,-1,-1
REMKEL2.txt,2391,2929,538,10,N,N,-,-1,-1
REMKEL2.txt,2416,2991,575,10,N,N,-,-1,-1
REMKEL2.txt,2475,3024,549,10,N,N,-,-1,-1
REMKEL2.txt,2503,3075,572,10,N,N,-,-1,-1
REMKEL2.txt,2523,3148,625,10,N,N,-,-1,-1
REMKEL2.txt,2568,3215,647,10,N,N,-,-1,-1
REMKEL2.txt,2589,3250,661,10,N,N,-,-1,-1
REMKEL2.txt,2640,3293,653,10,N,N,-,-1,-1
REMKEL2.txt,2701,3346,645,10,N,N,-,-1,-1
REMKEL2.txt,2793,3376,583,10,N,N,-,-1,-1
REMKEL2.txt,2930,3414,484,10,N,N,-,-1,-1
REMKEL2.txt,2992,3458,466,10,N,N,-,-1,-1
REMKEL2.txt,3025,3504,479,10,N,N,-,-1,-1
REMKEL2.txt,3077,3546,469,10,N,N,-,-1,-1
REMKEL2.txt,3149,3618,469,10,N,N,-,-1,-1
REMKEL2.txt,3216,3640,424,10,N,N,-,-1,-1
REMKEL2.txt,3251,3697,446,10,N,N,-,-1,-1
REMKEL2.txt,3294,3733,439,10,N,N,-,-1,-1
REMKEL2.txt,3347,3778,431,10,N,N,-,-1,-1
REMKEL2.txt,3377,3803,426,10,N,N,-,-1,-1
REMKEL2.txt,3415,3860,445,10,N,N,-,-1,-1
REMKEL2.txt,3459,3926,467,10,N,N,-,-1,-1
REMKEL2.txt,3505,3985,480,10,N,N,-,-1,-1
REMKEL2.txt,3547,4004,457,10,N,N,-,-1,-1
REMKEL2.txt,3619,4036,417,10,N,N,-,-1,-1
REMKEL2.txt,3642,4055,413,10,N,N,-,-1,-1
REMKEL2.txt,3698,4074,376,10,N,N,-,-1,-1
REMKEL2.txt,3734,4100,366,10,N,N,-,-1,-1
REMKEL2.txt,3779,4151,372,10,N,N,-,-1,-1
REMKEL2.txt,3804,4158,354,10,N,N,-,-1,-1
REMKEL2.txt,3861,4217,356,10,N,N,-,-1,-1
REMKEL2.txt,3927,4241,314,10,N,N,-,-1,-1
REMKEL2.txt,3986,4283,297,10,N,N,-,-1,-1
REMKEL2.txt,4005,4342,337,10,N,N,-,-1,-1
REMKEL2.txt,4037,4363,326,10,N,N,-,-1,-1
REMKEL2.txt,4056,4391,335,10,N,N,-,-1,-1
REMKEL2.txt,4075,4413,338,10,N,N,-,-1,-1
REMKEL2.txt,4101,4430,329,10,N,N,-,-1,-1
REMKEL2.txt,4152,4476,324,10,N,N,-,-1,-1
REMKEL2.txt,4159,4480,321,10,N,N,-,-1,-1
REMKEL2.txt,4218,4542,324,10,N,N,-,-1,-1
REMKEL2.txt,4243,4558,315,10,N,N,-,-1,-1
REMKEL2.txt,4284,4583,299,10,N,N,-,-1,-1
REMKEL2.txt,4344,4646,302,10,N,N,-,-1,-1
REMKEL2.txt,4364,4690,326,10,N,N,-,-1,-1
REMKEL2.txt,4394,4723,329,10,N,N,-,-1,-1
REMKEL2.txt,4416,4767,351,10,N,N,-,-1,-1
REMKEL2.txt,4431,4850,419,10,N,N,-,-1,-1
REMKEL2.txt,4477,4905,428,10,N,N,-,-1,-1
REMKEL2.txt,4481,4942,461,10,N,N,-,-1,-1
REMKEL2.txt,4544,4982,438,10,N,N,-,-1,-1
REMKEL2.txt,4559,5069,510,10,N,N,-,-1,-1
REMKEL2.txt,4584,5114,530,10,N,N,-,-1,-1
REMKEL2.txt,4647,5142,495,10,N,N,-,-1,-1
REMKEL2.txt,4692,5178,486,10,N,N,-,-1,-1
REMKEL2.txt,4724,5216,492,10,N,N,-,-1,-1
REMKEL2.txt,4768,5273,505,10,N,N,-,-1,-1
REMKEL2.txt,4851,5310,459,10,N,N,-,-1,-1
REMKEL2.txt,4906,5348,442,10,N,N,-,-1,-1
REMKEL2.txt,4945,5381,436,10,N,N,-,-1,-1
REMKEL2.txt,4983,5423,440,10,N,N,-,-1,-1
REMKEL2.txt,5070,5472,402,10,N,N,-,-1,-1
REMKEL2.txt,5115,5506,391,10,N,N,-,-1,-1
REMKEL2.txt,5143,5520,377,10,N,N,-,-1,-1
REMKEL2.txt,5179,5590,411,10,N,N,-,-1,-1
REMKEL2.txt,5217,5644,427,10,N,N,-,-1,-1
REMKEL2.txt,5274,5690,416,10,N,N,-,-1,-1
REMKEL2.txt,5311,5725,414,10,N,N,-,-1,-1
REMKEL2.txt,5349,5756,407,10,N,N,-,-1,-1
REMKEL2.txt,5382,5768,386,10,N,N,-,-1,-1
REMKEL2.txt,5424,5807,383,10,N,N,-,-1,-1
REMKEL2.txt,5473,5846,373,10,N,N,-,-1,-1
REMKEL2.txt,5507,5879,372,10,N,N,-,-1,-1
REMKEL2.txt,5521,5944,423,10,N,N,-,-1,-1
REMKEL2.txt,5591,5996,405,10,N,N,-,-1,-1
REMKEL2.txt,5645,6016,371,10,N,N,-,-1,-1
REMKEL2.txt,5691,6049,358,10,N,N,-,-1,-1
REMKEL2.txt,5726,6071,345,10,N,N,-,-1,-1
REMKEL2.txt,5757,6097,340,10,N,N,-,-1,-1
REMKEL2.txt,5769,6127,358,10,N,N,-,-1,-1
REMKEL2.txt,5808,6199,391,10,N,N,-,-1,-1
REMKEL2.txt,5847,6273,426,10,N,N,-,-1,-1
REMKEL2.txt,5880,6292,412,10,N,N,-,-1,-1
REMKEL2.txt,5945,6331,386,10,N,N,-,-1,-1
REMKEL2.txt,5997,6434,437,10,N,N,-,-1,-1
REMKEL2.txt,6017,6448,431,10,N,N,-,-1,-1
REMKEL2.txt,6050,6514,464,10,N,N,-,-1,-1
REMKEL2.txt,6073,6545,472,10,N,N,-,-1,-1
REMKEL2.txt,6098,6584,486,10,N,N,-,-1,-1
REMKEL2.txt,6128,6662,534,10,N,N,-,-1,-1
REMKEL2.txt,6200,6669,469,10,N,N,-,-1,-1
REMKEL2.txt,6274,6679,405,10,N,N,-,-1,-1
REMKEL2.txt,6293,6720,427,10,N,N,-,-1,-1
REMKEL2.txt,6332,6759,427,10,N,N,-,-1,-1
REMKEL2.txt,6435,6806,371,10,N,N,-,-1,-1
REMKEL2.txt,6450,6815,365,10,N,N,-,-1,-1
REMKEL2.txt,6515,6848,333,10,N,N,-,-1,-1
REMKEL2.txt,6547,6885,338,10,N,N,-,-1,-1
REMKEL2.txt,6585,6935,350,10,N,N,-,-1,-1
REMKEL2.txt,6663,6969,306,10,N,N,-,-1,-1
REMKEL2.txt,6669,7063,394,10,N,N,-,-1,-1
REMKEL2.txt,6680,7102,422,10,N,N,-,-1,-1
REMKEL2.txt,6721,7123,402,10,N,N,-,-1,-1
REMKEL2.txt,6760,7140,380,10,N,N,-,-1,-1
REMKEL2.txt,6807,7173,366,10,N,N,-,-1,-1
REMKEL2.txt,6816,7193,377,10,N,N,-,-1,-1
REMKEL2.txt,6849,7271,422,10,N,N,-,-1,-1
REMKEL2.txt,6886,7319,433,10,N,N,-,-1,-1
REMKEL2.txt,6938,7391,453,10,N,N,-,-1,-1
REMKEL2.txt,6972,7408,436,10,N,N,-,-1,-1
REMKEL2.txt,7064,7449,385,10,N,N,-,-1,-1
REMKEL2.txt,7103,7494,391,10,N,N,-,-1,-1
REMKEL2.txt,7125,7561,436,10,N,N,-,-1,-1
REMKEL2.txt,7141,7598,457,10,N,N,-,-1,-1
REMKEL2.txt,7175,7650,475,10,N,N,-,-1,-1
REMKEL2.txt,7194,7652,458,10,N,N,-,-1,-1
REMKEL2.txt,7272,7654,382,10,N,N,-,-1,-1
REMKEL2.txt,7320,7704,384,10,N,N,-,-1,-1
REMKEL2.txt,7392,7760,368,10,N,N,-,-1,-1
REMKEL2.txt,7409,7824,415,10,N,N,-,-1,-1
REMKEL2.txt,7450,7856,406,10,N,N,-,-1,-1
REMKEL2.txt,7495,7876,381,10,N,N,-,-1,-1
REMKEL2.txt,7562,7921,359,10,N,N,-,-1,-1
REMKEL2.txt,7599,7943,344,10,N,N,-,-1,-1
REMKEL2.txt,7651,7989,338,10,N,N,-,-1,-1
REMKEL2.txt,7653,8007,354,10,N,N,-,-1,-1
REMKEL2.txt,7655,8034,379,10,N,N,-,-1,-1
REMKEL2.txt,7705,8083,378,10,N,N,-,-1,-1
REMKEL2.txt,7761,8095,334,10,N,N,-,-1,-1
REMKEL2.txt,7825,8140,315,10,N,N,-,-1,-1
REMKEL2.txt,7857,8160,303,10,N,N,-,-1,-1
REMKEL2.txt,7877,8224,347,10,N,N,-,-1,-1
REMKEL2.txt,7923,8241,318,10,N,N,-,-1,-1
REMKEL2.txt,7944,8282,338,10,N,N,-,-1,-1
REMKEL2.txt,7990,8325,335,10,N,N,-,-1,-1
REMKEL2.txt,8008,8377,369,10,N,N,-,-1,-1
REMKEL2.txt,8035,8428,393,10,N,N,-,-1,-1
REMKEL2.txt,8084,8463,379,10,N,N,-,-1,-1
REMKEL2.txt,8096,8542,446,10,N,N,-,-1,-1
REMKEL2.txt,8141,8572,431,10,N,N,-,-1,-1
REMKEL2.txt,8163,8596,433,10,N,N,-,-1,-1
REMKEL2.txt,8226,8635,409,10,N,N,-,-1,-1
REMKEL2.txt,8242,8661,419,10,N,N,-,-1,-1
REMKEL2.txt,8283,8752,469,10,N,N,-,-1,-1
REMKEL2.txt,8326,8801,475,10,N,N,-,-1,-1
REMKEL2.txt,8378,8827,449,10,N,N,-,-1,-1
REMKEL2.txt,8429,8901,472,10,N,N,-,-1,-1
REMKEL2.txt,8464,8935,471,10,N,N,-,-1,-1
REMKEL2.txt,8543,8983,440,10,N,N,-,-1,-1
REMKEL2.txt,8573,9008,435,10,N,N,-,-1,-1
REMKEL2.txt,8599,9094,495,10,N,N,-,-1,-1
REMKEL2.txt,8636,9149,513,10,N,N,-,-1,-1
REMKEL2.txt,8663,9169,506,10,N,N,-,-1,-1
REMKEL2.txt,8753,9204,451,10,N,N,-,-1,-1
REMKEL2.txt,8802,9225,423,10,N,N,-,-1,-1
REMKEL2.txt,8828,9232,404,10,N,N,-,-1,-1
REMKEL2.txt,8902,9278,376,10,N,N,-,-1,-1
REMKEL2.txt,8936,9286,350,10,N,N,-,-1,-1
REMKEL2.txt,8984,9295,311,10,N,N,-,-1,-1
REMKEL2.txt,9009,9391,382,10,N,N,-,-1,-1
REMKEL2.txt,9095,9427,332,10,N,N,-,-1,-1
REMKEL2.txt,9150,9481,331,10,N,N,-,-1,-1
REMKEL2.txt,9170,9524,354,10,N,N,-,-1,-1
REMKEL2.txt,9206,9561,355,10,N,N,-,-1,-1
REMKEL2.txt,9226,9577,351,10,N,N,-,-1,-1
REMKEL2.txt,9233,9614,381,10,N,N,-,-1,-1
REMKEL2.txt,9279,9739,460,10,N,N,-,-1,-1
REMKEL2.txt,9287,9770,483,10,N,N,-,-1,-1
REMKEL2.txt,9296,9794,498,10,N,N,-,-1,-1
REMKEL2.txt,9392,9811,419,10,N,N,-,-1,-1
REMKEL2.txt,9428,9845,417,10,N,N,-,-1,-1
REMKEL2.txt,9482,9871,389,10,N,N,-,-1,-1
REMKEL2.txt,9525,9918,393,10,N,N,-,-1,-1
REMKEL2.txt,9566,9939,373,10,N,N,-,-1,-1
REMKEL2.txt,9580,9970,390,10,N,N,-,-1,-1
REMKEL2.txt,9615,9983,368,10,N,N,-,-1,-1
REMKEL2.txt,9740,10024,284,10,N,N,-,-1,-1
REMKEL2.txt,9771,10049,278,10,N,N,-,-1,-1
REMKEL2.txt,9795,10074,279,10,N,N,-,-1,-1
REMKEL2.txt,9813,10096,283,10,N,N,-,-1,-1
REMKEL2.txt,9846,10168,322,10,N,N,-,-1,-1
REMKEL2.txt,9872,10225,353,10,N,N,-,-1,-1
REMKEL2.txt,9919,10264,345,10,N,N,-,-1,-1
REMKEL2.txt,9940,10308,368,10,N,N,-,-1,-1
REMKEL2.txt,9971,10337,366,10,N,N,-,-1,-1
REMKEL2.txt,9984,10366,382,10,N,N,-,-1,-1
REMKEL2.txt,10025,10399,374,10,N,N,-,-1,-1
REMKEL2.txt,10050,10413,363,10,N,N,-,-1,-1
REMKEL2.txt,10075,10454,379,10,N,N,-,-1,-1
REMKEL2.txt,10097,10477,380,10,N,N,-,-1,-1
REMKEL2.txt,10169,10513,344,10,N,N,-,-1,-1
REMKEL2.txt,10227,10572,345,10,N,N,-,-1,-1
REMKEL2.txt,10265,10591,326,10,N,N,-,-1,-1
REMKEL2.txt,10309,10629,320,10,N,N,-,-1,-1
REMKEL2.txt,10338,10667,329,10,N,N,-,-1,-1
REMKEL2.txt,10368,10682,314,10,N,N,-,-1,-1
REMKEL2.txt,10400,10701,301,10,N,N,-,-1,-1
REMKEL2.txt,10414,10725,311,10,N,N,-,-1,-1
REMKEL2.txt,10455,10759,304,10,N,N,-,-1,-1
REMKEL2.txt,10478,10800,322,10,N,N,-,-1,-1
REMKEL2.txt,10516,10817,301,10,N,N,-,-1,-1
REMKEL2.txt,10573,10864,291,10,N,N,-,-1,-1
REMKEL2.txt,10592,10911,319,10,N,N,-,-1,-1
REMKEL2.txt,10630,10942,312,10,N,N,-,-1,-1
REMKEL2.txt,10668,10995,327,10,N,N,-,-1,-1
REMKEL2.txt,10684,11065,381,10,N,N,-,-1,-1
REMKEL2.txt,10702,11107,405,10,N,N,-,-1,-1
REMKEL2.txt,10726,11163,437,10,N,N,-,-1,-1
REMKEL2.txt,10760,11224,464,10,N,N,-,-1,-1
REMKEL2.txt,10801,11257,456,10,N,N,-,-1,-1
REMKEL2.txt,10818,11295,477,10,N,N,-,-1,-1
REMKEL2.txt,10865,11334,469,10,N,N,-,-1,-1
REMKEL2.txt,10912,11345,433,10,N,N,-,-1,-1
REMKEL2.txt,10943,11402,459,10,N,N,-,-1,-1
REMKEL2.txt,10998,11466,468,10,N,N,-,-1,-1
REMKEL2.txt,11067,11498,431,10,N,N,-,-1,-1
REMKEL2.txt,11108,11525,417,10,N,N,-,-1,-1
REMKEL2.txt,11165,11568,403,10,N,N,-,-1,-1
REMKEL2.txt,11225,11593,368,10,N,N,-,-1,-1
REMKEL2.txt,11258,11629,371,10,N,N,-,-1,-1
REMKEL2.txt,11296,11636,340,10,N,N,-,-1,-1
REMKEL2.txt,11335,11663,328,10,N,N,-,-1,-1
REMKEL2.txt,11346,11673,327,10,N,N,-,-1,-1
REMKEL2.txt,11403,11697,294,10,N,N,-,-1,-1
REMKEL2.txt,11467,11748,281,10,N,N,-,-1,-1
REMKEL2.txt,11499,11799,300,10,N,N,-,-1,-1
REMKEL2.txt,11526,11842,316,10,N,N,-,-1,-1
REMKEL2.txt,11569,11867,298,10,N,N,-,-1,-1
REMKEL2.txt,11595,11914,319,10,N,N,-,-1,-1
REMKEL2.txt,11630,11960,330,10,N,N,-,-1,-1
REMKEL2.txt,11637,11989,352,10,N,N,-,-1,-1
REMKEL2.txt,11664,12053,389,10,N,N,-,-1,-1
REMKEL2.txt,11674,12118,444,10,N,N,-,-1,-1
REMKEL2.txt,11698,12129,431,10,N,N,-,-1,-1
REMKEL2.txt,11749,12206,457,10,N,N,-,-1,-1
REMKEL2.txt,11800,12219,419,10,N,N,-,-1,-1
REMKEL2.txt,11844,12307,463,10,N,N,-,-1,-1
REMKEL2.txt,11868,12502,634,10,N,N,-,-1,-1
REMKEL2.txt,11915,12553,638,10,N,N,-,-1,-1
REMKEL2.txt,11961,12640,679,10,N,N,-,-1,-1
REMKEL2.txt,11990,12754,764,10,N,N,-,-1,-1
REMKEL2.txt,12055,12830,775,10,N,N,-,-1,-1
REMKEL2.txt,12121,12899,778,10,N,N,-,-1,-1
REMKEL2.txt,12130,12919,789,10,N,N,-,-1,-1
REMKEL2.txt,12207,12921,714,10,N,N,-,-1,-1
REMKEL2.txt,12220,13223,1003,10,N,Y,1448285563397,102964,108476
REMKEL2.txt,12308,13277,969,10,N,Y,1448285563397,102964,108476
REMKEL2.txt,12503,13416,913,10,N,Y,1448285563397,102964,108476
REMKEL2.txt,12554,13576,1022,10,N,Y,1448285563397,102964,108476
REMKEL2.txt,12641,13694,1053,10,N,Y,1448285563397,102964,108476
REMKEL2.txt,12755,13775,1020,10,N,Y,1448285563397,102964,108476
REMKEL2.txt,12831,13779,948,10,N,Y,1448285563397,102964,108476
REMKEL2.txt,12900,13863,963,10,N,Y,1448285563397,102964,108476
REMKEL2.txt,12920,14315,1395,10,N,Y,1448285563397,102964,108476
REMKEL2.txt,12922,14409,1487,10,N,Y,1448285563397,102964,108476
REMKEL2.txt,13224,14542,1318,10,N,Y,1437470299748,152207,152889
REMKEL2.txt,13278,14662,1384,10,N,Y,1437470299748,152207,152889
REMKEL2.txt,13417,14820,1403,10,Y,Y,1437470299748,152207,152889
REMKEL2.txt,13577,14857,1280,10,Y,Y,1437470299748,152207,152889
REMKEL2.txt,13695,15110,1415,10,N,Y,1437470299748,152207,152889
REMKEL2.txt,13776,15129,1353,10,N,Y,1437470299748,152207,152889
REMKEL2.txt,13780,15377,1597,10,N,Y,1437470299748,152207,152889
REMKEL2.txt,13864,15624,1760,10,Y,Y,1437470299748,152207,152889
REMKEL2.txt,14316,16270,1954,10,Y,Y,1437470299748,152207,152889
REMKEL2.txt,14412,16696,2284,10,Y,Y,1437470299748,152207,152889
REMKEL2.txt,14543,17445,2902,10,Y,Y,1437470299748,152207,152889
REMKEL2.txt,14663,17775,3112,10,Y,Y,1437470299748,152207,152889
REMKEL2.txt,14821,17796,2975,10,Y,Y,1437470299748,152207,152889
REMKEL2.txt,14858,17921,3063,10,Y,Y,1437470299748,152207,152889
REMKEL2.txt,15115,18253,3138,10,N,Y,1437471397525,350644,351290
REMKEL2.txt,15130,18420,3290,10,N,Y,1437471397525,350644,351290
REMKEL2.txt,15379,18602,3223,10,N,Y,1437471397525,350644,351290
REMKEL2.txt,15627,18834,3207,10,N,Y,1448286880729,112151,113274
REMKEL2.txt,16273,18842,2569,10,N,Y,1448286880729,112151,113274
REMKEL2.txt,16697,18880,2183,10,N,Y,1448286880729,112151,113274
REMKEL2.txt,17446,19026,1580,10,N,Y,1448286880729,112151,113274
REMKEL2.txt,17776,19055,1279,10,N,Y,1448286880729,112151,113274
REMKEL2.txt,17797,19206,1409,10,N,Y,1448286880729,112151,113274
REMKEL2.txt,17924,19212,1288,10,N,N,-,-1,-1
REMKEL2.txt,18255,19358,1103,10,N,N,-,-1,-1
REMKEL2.txt,18421,19364,943,10,N,N,-,-1,-1
REMKEL2.txt,18603,19512,909,10,N,N,-,-1,-1
REMKEL2.txt,18837,20071,1234,10,N,Y,1448314402792,179959,180202
REMKEL2.txt,18843,20103,1260,10,N,Y,1448314402792,179959,180202
REMKEL2.txt,18882,20261,1379,10,N,Y,1448314402792,179959,180202
REMKEL2.txt,19031,20329,1298,10,N,Y,1448314402792,179959,180202
REMKEL2.txt,19058,20493,1435,10,N,Y,1448314402792,179959,180202
REMKEL2.txt,19209,20599,1390,10,N,Y,1448314402792,179959,180202
REMKEL2.txt,19215,20673,1458,10,N,Y,1448314402792,179959,180202
REMKEL2.txt,19361,20784,1423,10,N,Y,1448314402792,179959,180202
REMKEL2.txt,19367,21074,1707,10,N,Y,1448314402792,179959,180202
REMKEL2.txt,19515,21509,1994,10,N,Y,1448314402792,179959,180202
REMKEL2.txt,20072,21767,1695,10,N,N,-,-1,-1
REMKEL2.txt,20104,21896,1792,10,N,N,-,-1,-1
REMKEL2.txt,20262,22040,1778,10,Y,N,-,-1,-1
REMKEL2.txt,20330,22438,2108,10,Y,Y,1448395538701,294934,295016
REMKEL2.txt,20494,22605,2111,10,Y,Y,1448395538701,294934,295016
REMKEL2.txt,20601,22636,2035,10,Y,Y,1448395538701,294934,295016
REMKEL2.txt,20676,22726,2050,10,Y,Y,1448395538701,294934,295016
REMKEL2.txt,20787,22904,2117,10,Y,Y,1448395538701,294934,295016
REMKEL2.txt,21076,23083,2007,10,N,Y,1448395538701,294934,295016
REMKEL2.txt,21512,23416,1904,10,N,Y,1448395538701,294934,295016
REMKEL2.txt,21768,23518,1750,10,N,Y,1448315012079,181380,182053
REMKEL2.txt,21899,23698,1799,10,N,Y,1448315012079,181380,182053
REMKEL2.txt,22043,23900,1857,10,N,Y,1448315012079,181380,182053
REMKEL2.txt,22439,24259,1820,10,N,Y,1448315012079,181380,182053
REMKEL2.txt,22606,24370,1764,10,N,Y,1448315012079,181380,182053
REMKEL2.txt,22641,24389,1748,10,N,Y,1448315012079,181380,182053
REMKEL2.txt,22727,24490,1763,10,N,Y,1448315012079,181380,182053
REMKEL2.txt,22905,24618,1713,10,N,Y,1448315012079,181380,182053
REMKEL2.txt,23084,24811,1727,10,N,Y,1448315012079,181380,182053
REMKEL2.txt,23417,24938,1521,10,N,Y,1448315012079,181380,182053
REMKEL2.txt,23518,25490,1972,10,N,Y,1448315012079,181380,182053
REMKEL2.txt,23699,25614,1915,10,N,Y,1448315012079,181380,182053
REMKEL2.txt,23901,25812,1911,10,N,Y,1448315012079,181380,182053
REMKEL2.txt,24260,25962,1702,10,N,Y,1448315012079,181380,182053
REMKEL2.txt,24371,26111,1740,10,N,Y,1448315012079,181380,182053
REMKEL2.txt,24390,26217,1827,10,N,Y,1448315012079,181380,182053
REMKEL2.txt,24491,26359,1868,10,N,Y,1448315012079,181380,182053
REMKEL2.txt,24619,26603,1984,10,N,Y,1448315012079,181380,182053
REMKEL2.txt,24812,26727,1915,10,N,Y,1448315012079,181380,182053
REMKEL2.txt,24939,26890,1951,10,N,Y,1448315012079,181380,182053
REMKEL2.txt,25491,27123,1632,10,N,Y,1448315012079,181380,182053
REMKEL2.txt,25617,27270,1653,10,N,N,-,-1,-1
REMKEL2.txt,25813,27371,1558,10,N,N,-,-1,-1
REMKEL2.txt,25963,27908,1945,10,N,Y,1448369133400,279084,280004
REMKEL2.txt,26114,28010,1896,10,N,Y,1448369133400,279084,280004
REMKEL2.txt,26218,28159,1941,10,N,Y,1448369133400,279084,280004
REMKEL2.txt,26360,28178,1818,10,N,Y,1448369133400,279084,280004
REMKEL2.txt,26604,28296,1692,10,N,Y,1448369133400,279084,280004
REMKEL2.txt,26728,28585,1857,10,N,Y,1448369133400,279084,280004
REMKEL2.txt,26893,28642,1749,10,N,Y,1448369133400,279084,280004
REMKEL2.txt,27124,28722,1598,10,N,Y,1448369133400,279084,280004
REMKEL2.txt,27273,28960,1687,10,N,Y,1448369133400,279084,280004
REMKEL2.txt,27374,29017,1643,10,N,Y,1448369133400,279084,280004
REMKEL2.txt,27909,29124,1215,10,N,Y,1448369133400,279084,280004
REMKEL2.txt,28011,29268,1257,10,N,Y,1448369133400,279084,280004
REMKEL2.txt,28164,29363,1199,10,N,Y,1448369133400,279084,280004
REMKEL2.txt,28179,29407,1228,10,N,Y,1448369133400,279084,280004
REMKEL2.txt,28297,29481,1184,10,N,Y,1448369133400,279084,280004
REMKEL2.txt,28586,29545,959,10,N,Y,1448369133400,279084,280004
REMKEL2.txt,28643,29692,1049,10,N,Y,1448369133400,279084,280004
REMKEL2.txt,28723,29787,1064,10,N,Y,1448369133400,279084,280004
REMKEL2.txt,28961,29959,998,10,N,Y,1448369133400,279084,280004
REMKEL2.txt,29018,30009,991,10,N,Y,1448369133400,279084,280004
REMKEL2.txt,29127,30252,1125,10,N,N,-,-1,-1
REMKEL2.txt,29269,30321,1052,10,N,N,-,-1,-1
REMKEL2.txt,29364,30331,967,10,N,N,-,-1,-1
REMKEL2.txt,29412,30387,975,10,N,N,-,-1,-1
REMKEL2.txt,29482,30504,1022,10,N,N,-,-1,-1
REMKEL2.txt,29548,30660,1112,10,N,N,-,-1,-1
REMKEL2.txt,29693,30729,1036,10,N,N,-,-1,-1
REMKEL2.txt,29790,30805,1015,10,N,N,-,-1,-1
REMKEL2.txt,29960,30945,985,10,N,N,-,-1,-1
REMKEL2.txt,30010,31004,994,10,N,N,-,-1,-1
REMKEL2.txt,30253,31270,1017,10,N,N,-,-1,-1
REMKEL2.txt,30322,31458,1136,10,N,N,-,-1,-1
REMKEL2.txt,30332,31538,1206,10,N,Y,1448287490368,120754,123385
REMKEL2.txt,30390,31676,1286,10,N,Y,1448287490368,120754,123385
REMKEL2.txt,30505,31699,1194,10,N,Y,1448287490368,120754,123385
REMKEL2.txt,30663,31872,1209,10,N,Y,1448287490368,120754,123385
REMKEL2.txt,30730,32025,1295,10,N,Y,1448287490368,120754,123385
REMKEL2.txt,30806,32327,1521,10,N,Y,1448287490368,120754,123385
REMKEL2.txt,30946,32555,1609,10,N,Y,1448287490368,120754,123385
REMKEL2.txt,31005,32914,1909,10,N,Y,1448287490368,120754,123385
REMKEL2.txt,31273,33041,1768,10,N,Y,1448287490368,120754,123385
REMKEL2.txt,31459,33230,1771,10,N,Y,1448287490368,120754,123385
REMKEL2.txt,31539,33416,1877,10,N,Y,1448287490368,120754,123385
REMKEL2.txt,31678,33473,1795,10,N,Y,1448287490368,120754,123385
REMKEL2.txt,31700,33499,1799,10,N,Y,1448287490368,120754,123385
REMKEL2.txt,31875,33649,1774,10,N,Y,1448366833867,275966,276698
REMKEL2.txt,32026,33788,1762,10,Y,Y,1448366833867,275966,276698
REMKEL2.txt,32328,33900,1572,10,Y,Y,1448366833867,275966,276698
REMKEL2.txt,32556,33993,1437,10,Y,Y,1448366833867,275966,276698
REMKEL2.txt,32915,34143,1228,10,Y,Y,1448366833867,275966,276698
REMKEL2.txt,33044,34360,1316,10,Y,Y,1448366833867,275966,276698
REMKEL2.txt,33231,34721,1490,10,Y,Y,1448366833867,275966,276698
REMKEL2.txt,33417,34844,1427,10,N,Y,1448366833867,275966,276698
REMKEL2.txt,33474,34962,1488,10,N,N,-,-1,-1
REMKEL2.txt,33500,35382,1882,10,Y,N,-,-1,-1
REMKEL2.txt,33650,35592,1942,10,N,N,-,-1,-1
REMKEL2.txt,33789,35788,1999,10,N,N,-,-1,-1
REMKEL2.txt,33901,35976,2075,10,N,N,-,-1,-1
REMKEL2.txt,33994,36271,2277,10,N,N,-,-1,-1
REMKEL2.txt,34144,36382,2238,10,N,N,-,-1,-1
REMKEL2.txt,34362,36626,2264,10,N,N,-,-1,-1
REMKEL2.txt,34723,36776,2053,10,N,N,-,-1,-1
REMKEL2.txt,34845,36917,2072,10,N,N,-,-1,-1
REMKEL2.txt,34963,37100,2137,10,N,N,-,-1,-1
REMKEL2.txt,35383,37230,1847,10,N,N,-,-1,-1
REMKEL2.txt,35595,37337,1742,10,N,N,-,-1,-1
REMKEL2.txt,35790,37707,1917,10,N,N,-,-1,-1
REMKEL2.txt,35977,37857,1880,10,N,N,-,-1,-1
REMKEL2.txt,36272,37985,1713,10,N,N,-,-1,-1
REMKEL2.txt,36385,38113,1728,10,N,N,-,-1,-1
REMKEL2.txt,36627,38179,1552,10,N,N,-,-1,-1
REMKEL2.txt,36778,38283,1505,10,N,N,-,-1,-1
REMKEL2.txt,36920,38403,1483,10,N,N,-,-1,-1
REMKEL2.txt,37103,38671,1568,10,N,N,-,-1,-1
REMKEL2.txt,37231,38857,1626,10,N,N,-,-1,-1
REMKEL2.txt,37338,38979,1641,10,N,N,-,-1,-1
REMKEL2.txt,37708,39030,1322,10,N,N,-,-1,-1
REMKEL2.txt,37858,39325,1467,10,N,N,-,-1,-1
REMKEL2.txt,37988,39506,1518,10,N,N,-,-1,-1
REMKEL2.txt,38116,39660,1544,10,N,N,-,-1,-1
REMKEL2.txt,38180,40007,1827,10,N,N,-,-1,-1
REMKEL2.txt,38284,40216,1932,10,N,N,-,-1,-1
REMKEL2.txt,38404,40684,2280,10,N,N,-,-1,-1
REMKEL2.txt,38672,40845,2173,10,N,N,-,-1,-1
REMKEL2.txt,38860,41062,2202,10,N,N,-,-1,-1
REMKEL2.txt,38980,41317,2337,10,N,N,-,-1,-1
REMKEL2.txt,39031,41585,2554,10,N,N,-,-1,-1
REMKEL2.txt,39328,41727,2399,10,N,N,-,-1,-1
REMKEL2.txt,39507,41918,2411,10,N,N,-,-1,-1
REMKEL2.txt,39663,41983,2320,10,N,N,-,-1,-1
REMKEL2.txt,40008,42532,2524,10,N,Y,1448315360596,182069,182233
REMKEL2.txt,40217,43020,2803,10,N,Y,1448315360596,182069,182233
REMKEL2.txt,40685,43367,2682,10,N,Y,1448315360596,182069,182233
REMKEL2.txt,40848,43635,2787,10,N,Y,1448315360596,182069,182233
REMKEL2.txt,41065,43836,2771,10,N,Y,1448315360596,182069,182233
REMKEL2.txt,41318,43957,2639,10,N,Y,1448315360596,182069,182233
REMKEL2.txt,41586,44079,2493,10,N,Y,1448315360596,182069,182233
REMKEL2.txt,41732,44145,2413,10,N,Y,1448315360596,182069,182233
REMKEL2.txt,41919,44195,2276,10,N,Y,1448315360596,182069,182233
REMKEL2.txt,41986,44465,2479,10,N,Y,1448315360596,182069,182233
REMKEL2.txt,42535,44591,2056,10,N,Y,1448315360596,182069,182233
REMKEL2.txt,43021,44702,1681,10,N,N,-,-1,-1
REMKEL2.txt,43368,45010,1642,10,N,N,-,-1,-1
REMKEL2.txt,43638,45093,1455,10,N,N,-,-1,-1
REMKEL2.txt,43837,45122,1285,10,N,N,-,-1,-1
REMKEL2.txt,43958,45384,1426,10,N,N,-,-1,-1
REMKEL2.txt,44080,45590,1510,10,N,N,-,-1,-1
REMKEL2.txt,44148,45865,1717,10,N,N,-,-1,-1
REMKEL2.txt,44196,46008,1812,10,N,N,-,-1,-1
REMKEL2.txt,44467,46108,1641,10,N,N,-,-1,-1
REMKEL2.txt,44592,46572,1980,10,N,N,-,-1,-1
REMKEL2.txt,44705,46969,2264,10,N,N,-,-1,-1
REMKEL2.txt,45011,47117,2106,10,N,N,-,-1,-1
REMKEL2.txt,45094,47394,2300,10,N,N,-,-1,-1
REMKEL2.txt,45123,47413,2290,10,N,N,-,-1,-1
REMKEL2.txt,45387,47673,2286,10,N,N,-,-1,-1
REMKEL2.txt,45591,47789,2198,10,N,N,-,-1,-1
REMKEL2.txt,45866,47893,2027,10,N,N,-,-1,-1
REMKEL2.txt,46009,48306,2297,10,N,N,-,-1,-1
REMKEL2.txt,46111,48679,2568,10,N,N,-,-1,-1
REMKEL2.txt,46573,48799,2226,10,N,N,-,-1,-1
REMKEL2.txt,46971,49244,2273,10,N,N,-,-1,-1
REMKEL2.txt,47118,49436,2318,10,N,N,-,-1,-1
REMKEL2.txt,47399,49574,2175,10,N,N,-,-1,-1
REMKEL2.txt,47414,49710,2296,10,N,N,-,-1,-1
REMKEL2.txt,47675,49789,2114,10,N,N,-,-1,-1
REMKEL2.txt,47790,49994,2204,10,N,N,-,-1,-1
REMKEL2.txt,47896,50064,2168,10,N,N,-,-1,-1
REMKEL2.txt,48309,50265,1956,10,N,N,-,-1,-1
REMKEL2.txt,48680,50274,1594,10,N,N,-,-1,-1
REMKEL2.txt,48802,50609,1807,10,N,N,-,-1,-1
REMKEL2.txt,49245,50872,1627,10,N,N,-,-1,-1
REMKEL2.txt,49437,50912,1475,10,N,N,-,-1,-1
REMKEL2.txt,49575,51235,1660,10,N,N,-,-1,-1
REMKEL2.txt,49711,51320,1609,10,N,N,-,-1,-1
REMKEL2.txt,49792,51556,1764,10,N,N,-,-1,-1
REMKEL2.txt,49996,51948,1952,10,N,N,-,-1,-1
REMKEL2.txt,50065,52143,2078,10,N,N,-,-1,-1
REMKEL2.txt,50266,52348,2082,10,N,N,-,-1,-1
REMKEL2.txt,50276,52529,2253,10,N,N,-,-1,-1
REMKEL2.txt,50612,52694,2082,10,N,N,-,-1,-1
REMKEL2.txt,50873,52838,1965,10,N,N,-,-1,-1
REMKEL2.txt,50915,52891,1976,10,N,N,-,-1,-1
REMKEL2.txt,51238,53073,1835,10,N,N,-,-1,-1
REMKEL2.txt,51321,53235,1914,10,N,N,-,-1,-1
REMKEL2.txt,51557,53408,1851,10,N,N,-,-1,-1
REMKEL2.txt,51949,53422,1473,10,N,Y,1448281320115,89144,91129
REMKEL2.txt,52144,53564,1420,10,N,Y,1448281320115,89144,91129
REMKEL2.txt,52349,53751,1402,10,N,Y,1448281320115,89144,91129
REMKEL2.txt,52532,53956,1424,10,N,Y,1448281320115,89144,91129
REMKEL2.txt,52695,54036,1341,10,N,Y,1448281320115,89144,91129
REMKEL2.txt,52839,54281,1442,10,N,Y,1448281320115,89144,91129
REMKEL2.txt,52893,54322,1429,10,N,Y,1448281320115,89144,91129
REMKEL2.txt,53076,54440,1364,10,N,Y,1448281320115,89144,91129
REMKEL2.txt,53236,54534,1298,10,N,Y,1448281320115,89144,91129
REMKEL2.txt,53409,54715,1306,10,N,Y,1448281320115,89144,91129
REMKEL2.txt,53422,54836,1414,10,N,Y,1448281320115,89144,91129
REMKEL2.txt,53567,54949,1382,10,N,Y,1448281320115,89144,91129
REMKEL2.txt,53752,55169,1417,10,N,Y,1448281320115,89144,91129
REMKEL2.txt,53957,55306,1349,10,N,Y,1448281320115,89144,91129
REMKEL2.txt,54037,55502,1465,10,N,Y,1448281320115,89144,91129
REMKEL2.txt,54282,55560,1278,10,N,Y,1448281320115,89144,91129
REMKEL2.txt,54325,55632,1307,10,N,Y,1448311811907,157566,161100
REMKEL2.txt,54441,55651,1210,10,N,Y,1448311811907,157566,161100
REMKEL2.txt,54535,55717,1182,10,N,Y,1448311811907,157566,161100
REMKEL2.txt,54717,55872,1155,10,N,Y,1448311811907,157566,161100
REMKEL2.txt,54837,56057,1220,10,N,Y,1448311811907,157566,161100
REMKEL2.txt,54950,56242,1292,10,N,Y,1448311811907,157566,161100
REMKEL2.txt,55172,56311,1139,10,N,Y,1448311811907,157566,161100
REMKEL2.txt,55307,56784,1477,10,N,Y,1448311811907,157566,161100
REMKEL2.txt,55503,57100,1597,10,N,Y,1448311811907,157566,161100
REMKEL2.txt,55561,57239,1678,10,N,Y,1448311811907,157566,161100
REMKEL2.txt,55637,57544,1907,10,N,Y,1448280423373,85694,86154
REMKEL2.txt,55654,57708,2054,10,N,Y,1448280423373,85694,86154
REMKEL2.txt,55720,57790,2070,10,N,Y,1448280423373,85694,86154
REMKEL2.txt,55873,57938,2065,10,Y,Y,1448280423373,85694,86154
REMKEL2.txt,56060,58076,2016,10,Y,Y,1448280423373,85694,86154
REMKEL2.txt,56243,58200,1957,10,Y,Y,1448280423373,85694,86154
REMKEL2.txt,56312,58303,1991,10,Y,Y,1448280423373,85694,86154
REMKEL2.txt,56787,58363,1576,10,Y,Y,1448280423373,85694,86154
REMKEL2.txt,57101,58519,1418,10,Y,Y,1448280423373,85694,86154
REMKEL2.txt,57242,59020,1778,10,Y,Y,1448280423373,85694,86154
REMKEL2.txt,57545,59191,1646,10,Y,Y,1448280423373,85694,86154
REMKEL2.txt,57711,59400,1689,10,Y,Y,1448280423373,85694,86154
REMKEL2.txt,57791,59653,1862,10,Y,Y,1448280423373,85694,86154
REMKEL2.txt,57939,59729,1790,10,N,Y,1448280423373,85694,86154
REMKEL2.txt,58079,59934,1855,10,N,Y,1448280423373,85694,86154
REMKEL2.txt,58201,59954,1753,10,N,N,-,-1,-1
REMKEL2.txt,58304,60261,1957,10,N,N,-,-1,-1
REMKEL2.txt,58364,60461,2097,10,N,N,-,-1,-1
REMKEL2.txt,58520,60594,2074,10,N,Y,1448393386565,284140,284575
REMKEL2.txt,59021,60697,1676,10,N,Y,1448393386565,284140,284575
REMKEL2.txt,59194,60805,1611,10,N,Y,1448393386565,284140,284575
REMKEL2.txt,59401,60808,1407,10,N,Y,1448393386565,284140,284575
REMKEL2.txt,59654,60811,1157,10,N,Y,1448393386565,284140,284575
REMKEL2.txt,59730,60815,1085,10,N,Y,1448393386565,284140,284575
REMKEL2.txt,59935,60990,1055,10,N,Y,1448393386565,284140,284575
REMKEL2.txt,59955,61101,1146,10,N,Y,1448393386565,284140,284575
REMKEL2.txt,60262,61283,1021,10,N,Y,1448393386565,284140,284575
REMKEL2.txt,60464,61504,1040,10,N,Y,1448393386565,284140,284575
REMKEL2.txt,60595,61516,921,10,N,Y,1448393386565,284140,284575
REMKEL2.txt,60698,61542,844,10,N,Y,1448367229258,278623,278697
REMKEL2.txt,60806,61709,903,10,N,Y,1448367229258,278623,278697
REMKEL2.txt,60809,61792,983,10,N,Y,1448367229258,278623,278697
REMKEL2.txt,60812,61925,1113,10,N,Y,1448367229258,278623,278697
REMKEL2.txt,60816,62192,1376,10,N,Y,1448367229258,278623,278697
REMKEL2.txt,60993,62281,1288,10,N,N,-,-1,-1
REMKEL2.txt,61102,62408,1306,10,N,N,-,-1,-1
REMKEL2.txt,61284,62489,1205,10,N,N,-,-1,-1
REMKEL2.txt,61505,62548,1043,10,N,N,-,-1,-1
REMKEL2.txt,61517,62818,1301,10,N,N,-,-1,-1
REMKEL2.txt,61544,62892,1348,10,N,N,-,-1,-1
REMKEL2.txt,61710,62965,1255,10,N,N,-,-1,-1
REMKEL2.txt,61795,63124,1329,10,N,N,-,-1,-1
REMKEL2.txt,61926,63355,1429,10,N,N,-,-1,-1
REMKEL2.txt,62194,63568,1374,10,N,N,-,-1,-1
REMKEL2.txt,62282,63635,1353,10,N,N,-,-1,-1
REMKEL2.txt,62409,63817,1408,10,N,N,-,-1,-1
REMKEL2.txt,62490,64229,1739,10,N,N,-,-1,-1
REMKEL2.txt,62553,64340,1787,10,N,N,-,-1,-1
REMKEL2.txt,62819,64416,1597,10,N,N,-,-1,-1
REMKEL2.txt,62893,64634,1741,10,N,N,-,-1,-1
REMKEL2.txt,62966,64764,1798,10,N,N,-,-1,-1
REMKEL2.txt,63125,64982,1857,10,N,N,-,-1,-1
REMKEL2.txt,63358,65181,1823,10,N,N,-,-1,-1
REMKEL2.txt,63569,65294,1725,10,N,N,-,-1,-1
REMKEL2.txt,63638,66043,2405,10,N,N,-,-1,-1
REMKEL2.txt,63820,66161,2341,10,N,N,-,-1,-1
REMKEL2.txt,64230,66310,2080,10,N,N,-,-1,-1
REMKEL2.txt,64341,66369,2028,10,N,N,-,-1,-1
REMKEL2.txt,64418,66504,2086,10,N,N,-,-1,-1
REMKEL2.txt,64637,66767,2130,10,N,N,-,-1,-1
REMKEL2.txt,64765,66839,2074,10,N,N,-,-1,-1
REMKEL2.txt,64987,67130,2143,10,N,N,-,-1,-1
REMKEL2.txt,65182,67374,2192,10,N,N,-,-1,-1
REMKEL2.txt,65295,67447,2152,10,N,N,-,-1,-1
REMKEL2.txt,66046,67761,1715,10,N,N,-,-1,-1
REMKEL2.txt,66162,67987,1825,10,N,N,-,-1,-1
REMKEL2.txt,66311,68072,1761,10,N,N,-,-1,-1
REMKEL2.txt,66370,68216,1846,10,N,N,-,-1,-1
REMKEL2.txt,66507,68332,1825,10,N,N,-,-1,-1
REMKEL2.txt,66770,68537,1767,10,N,N,-,-1,-1
REMKEL2.txt,66840,68662,1822,10,N,N,-,-1,-1
REMKEL2.txt,67133,68786,1653,10,N,N,-,-1,-1
REMKEL2.txt,67376,68879,1503,10,N,N,-,-1,-1
REMKEL2.txt,67450,68945,1495,10,N,N,-,-1,-1
REMKEL2.txt,67762,69174,1412,10,N,N,-,-1,-1
REMKEL2.txt,67988,69326,1338,10,N,N,-,-1,-1
REMKEL2.txt,68073,69476,1403,10,N,N,-,-1,-1
REMKEL2.txt,68219,69712,1493,10,N,N,-,-1,-1
REMKEL2.txt,68333,69950,1617,10,N,N,-,-1,-1
REMKEL2.txt,68540,70048,1508,10,N,N,-,-1,-1
REMKEL2.txt,68665,70141,1476,10,N,N,-,-1,-1
REMKEL2.txt,68787,70206,1419,10,N,N,-,-1,-1
REMKEL2.txt,68882,70256,1374,10,N,N,-,-1,-1
REMKEL2.txt,68946,70293,1347,10,N,N,-,-1,-1
REMKEL2.txt,69175,70496,1321,10,N,N,-,-1,-1
REMKEL2.txt,69329,70560,1231,10,N,N,-,-1,-1
REMKEL2.txt,69477,70601,1124,10,N,N,-,-1,-1
REMKEL2.txt,69713,70821,1108,10,N,N,-,-1,-1
REMKEL2.txt,69953,70986,1033,10,N,N,-,-1,-1
REMKEL2.txt,70050,71589,1539,10,N,N,-,-1,-1
REMKEL2.txt,70144,71670,1526,10,N,N,-,-1,-1
REMKEL2.txt,70207,71689,1482,10,N,N,-,-1,-1
REMKEL2.txt,70257,71848,1591,10,N,N,-,-1,-1
REMKEL2.txt,70298,72374,2076,10,N,N,-,-1,-1
REMKEL2.txt,70497,72513,2016,10,N,N,-,-1,-1
REMKEL2.txt,70563,72664,2101,10,N,N,-,-1,-1
REMKEL2.txt,70602,72809,2207,10,N,N,-,-1,-1
REMKEL2.txt,70822,72830,2008,10,N,N,-,-1,-1
REMKEL2.txt,70989,73178,2189,10,N,N,-,-1,-1
REMKEL2.txt,71590,73311,1721,10,N,N,-,-1,-1
REMKEL2.txt,71675,73480,1805,10,N,N,-,-1,-1
REMKEL2.txt,71690,73754,2064,10,N,N,-,-1,-1
REMKEL2.txt,71849,73891,2042,10,N,N,-,-1,-1
REMKEL2.txt,72375,74056,1681,10,N,N,-,-1,-1
REMKEL2.txt,72514,74097,1583,10,N,N,-,-1,-1
REMKEL2.txt,72667,74196,1529,10,N,N,-,-1,-1
REMKEL2.txt,72811,74227,1416,10,N,N,-,-1,-1
REMKEL2.txt,72831,74391,1560,10,N,N,-,-1,-1
REMKEL2.txt,73179,74433,1254,10,N,N,-,-1,-1
REMKEL2.txt,73312,74510,1198,10,N,N,-,-1,-1
REMKEL2.txt,73481,74540,1059,10,N,N,-,-1,-1
REMKEL2.txt,73757,74605,848,10,N,N,-,-1,-1
REMKEL2.txt,73892,74747,855,10,N,N,-,-1,-1
REMKEL2.txt,74057,74835,778,10,N,N,-,-1,-1
REMKEL2.txt,74099,75003,904,10,N,N,-,-1,-1
REMKEL2.txt,74197,75226,1029,10,N,N,-,-1,-1
REMKEL2.txt,74228,75329,1101,10,N,N,-,-1,-1
REMKEL2.txt,74392,75652,1260,10,N,N,-,-1,-1
REMKEL2.txt,74434,75680,1246,10,N,N,-,-1,-1
REMKEL2.txt,74511,75922,1411,10,N,N,-,-1,-1
REMKEL2.txt,74541,76265,1724,10,N,N,-,-1,-1
REMKEL2.txt,74606,76444,1838,10,N,N,-,-1,-1
REMKEL2.txt,74748,76508,1760,10,N,N,-,-1,-1
REMKEL2.txt,74836,76585,1749,10,N,N,-,-1,-1
REMKEL2.txt,75004,76815,1811,10,N,N,-,-1,-1
REMKEL2.txt,75227,77118,1891,10,N,N,-,-1,-1
REMKEL2.txt,75330,77307,1977,10,N,N,-,-1,-1
REMKEL2.txt,75653,77372,1719,10,N,N,-,-1,-1
REMKEL2.txt,75681,77397,1716,10,N,N,-,-1,-1
REMKEL2.txt,75925,77551,1626,10,N,N,-,-1,-1
REMKEL2.txt,76268,77707,1439,10,N,N,-,-1,-1
REMKEL2.txt,76445,77888,1443,10,N,N,-,-1,-1
REMKEL2.txt,76509,78002,1493,10,N,N,-,-1,-1
REMKEL2.txt,76586,78116,1530,10,N,N,-,-1,-1
REMKEL2.txt,76816,78298,1482,10,N,N,-,-1,-1
REMKEL2.txt,77120,78447,1327,10,N,N,-,-1,-1
REMKEL2.txt,77310,78454,1144,10,N,N,-,-1,-1
REMKEL2.txt,77373,78552,1179,10,N,N,-,-1,-1
REMKEL2.txt,77398,78557,1159,10,N,N,-,-1,-1
REMKEL2.txt,77554,78570,1016,10,N,N,-,-1,-1
REMKEL2.txt,77708,78582,874,10,N,N,-,-1,-1
REMKEL2.txt,77891,78820,929,10,N,N,-,-1,-1
REMKEL2.txt,78003,78824,821,10,N,N,-,-1,-1
REMKEL2.txt,78117,78903,786,10,N,N,-,-1,-1
REMKEL2.txt,78301,79028,727,10,N,N,-,-1,-1
REMKEL2.txt,78448,79109,661,10,N,N,-,-1,-1
REMKEL2.txt,78456,79488,1032,10,N,N,-,-1,-1
REMKEL2.txt,78553,79664,1111,10,N,N,-,-1,-1
REMKEL2.txt,78559,79838,1279,10,N,N,-,-1,-1
REMKEL2.txt,78571,80045,1474,10,N,N,-,-1,-1
REMKEL2.txt,78583,80213,1630,10,N,N,-,-1,-1
REMKEL2.txt,78821,80257,1436,10,N,N,-,-1,-1
REMKEL2.txt,78825,80452,1627,10,N,N,-,-1,-1
REMKEL2.txt,78905,80700,1795,10,N,N,-,-1,-1
REMKEL2.txt,79029,80814,1785,10,N,N,-,-1,-1
REMKEL2.txt,79110,80851,1741,10,N,N,-,-1,-1
REMKEL2.txt,79489,80856,1367,10,N,N,-,-1,-1
REMKEL2.txt,79667,80873,1206,10,N,N,-,-1,-1
REMKEL2.txt,79839,81088,1249,10,N,N,-,-1,-1
REMKEL2.txt,80048,81145,1097,10,N,N,-,-1,-1
REMKEL2.txt,80214,81191,977,10,N,N,-,-1,-1
REMKEL2.txt,80258,81341,1083,10,N,Y,1448277582432,52552,54595
REMKEL2.txt,80453,81472,1019,10,N,Y,1448277582432,52552,54595
REMKEL2.txt,80703,81552,849,10,N,Y,1448277582432,52552,54595
REMKEL2.txt,80815,81697,882,10,N,Y,1448277582432,52552,54595
REMKEL2.txt,80852,81826,974,10,N,Y,1448277582432,52552,54595
REMKEL2.txt,80857,81996,1139,10,N,Y,1448277582432,52552,54595
REMKEL2.txt,80874,82074,1200,10,N,Y,1448277582432,52552,54595
REMKEL2.txt,81090,82316,1226,10,N,Y,1448277582432,52552,54595
REMKEL2.txt,81146,82523,1377,10,N,Y,1448277582432,52552,54595
REMKEL2.txt,81194,82717,1523,10,N,Y,1448277582432,52552,54595
REMKEL2.txt,81342,82859,1517,10,N,Y,1448277582432,52552,54595
REMKEL2.txt,81473,82972,1499,10,N,Y,1448277582432,52552,54595
REMKEL2.txt,81554,83241,1687,10,N,Y,1448277582432,52552,54595
REMKEL2.txt,81698,83449,1751,10,N,Y,1448277582432,52552,54595
REMKEL2.txt,81829,83687,1858,10,N,Y,1448277582432,52552,54595
REMKEL2.txt,81999,83826,1827,10,N,N,-,-1,-1
REMKEL2.txt,82075,84113,2038,10,N,N,-,-1,-1
REMKEL2.txt,82317,84320,2003,10,N,N,-,-1,-1
REMKEL2.txt,82526,84672,2146,10,N,N,-,-1,-1
REMKEL2.txt,82719,84761,2042,10,N,N,-,-1,-1
REMKEL2.txt,82862,85105,2243,10,N,N,-,-1,-1
REMKEL2.txt,82973,85243,2270,10,N,N,-,-1,-1
REMKEL2.txt,83243,85287,2044,10,N,N,-,-1,-1
REMKEL2.txt,83450,85701,2251,10,N,N,-,-1,-1
REMKEL2.txt,83688,85754,2066,10,N,N,-,-1,-1
REMKEL2.txt,83827,85943,2116,10,N,N,-,-1,-1
REMKEL2.txt,84116,86156,2040,10,N,N,-,-1,-1
REMKEL2.txt,84322,86286,1964,10,N,N,-,-1,-1
REMKEL2.txt,84673,86733,2060,10,N,N,-,-1,-1
REMKEL2.txt,84764,87004,2240,10,N,N,-,-1,-1
REMKEL2.txt,85106,87473,2367,10,N,Y,1448369703497,282374,282547
REMKEL2.txt,85246,87658,2412,10,N,Y,1448369703497,282374,282547
REMKEL2.txt,85289,87926,2637,10,N,Y,1448369703497,282374,282547
REMKEL2.txt,85702,88024,2322,10,N,Y,1448369703497,282374,282547
REMKEL2.txt,85755,88149,2394,10,N,Y,1448369703497,282374,282547
REMKEL2.txt,85944,88486,2542,10,N,Y,1448369703497,282374,282547
REMKEL2.txt,86157,88512,2355,10,N,Y,1448369703497,282374,282547
REMKEL2.txt,86289,88524,2235,10,N,Y,1448369703497,282374,282547
REMKEL2.txt,86736,88961,2225,10,N,Y,1448369703497,282374,282547
REMKEL2.txt,87005,89184,2179,10,Y,Y,1448369703497,282374,282547
REMKEL2.txt,87474,89518,2044,10,Y,Y,1448369703497,282374,282547
REMKEL2.txt,87661,89660,1999,10,Y,N,-,-1,-1
REMKEL2.txt,87927,89804,1877,10,N,N,-,-1,-1
REMKEL2.txt,88025,89985,1960,10,N,N,-,-1,-1
REMKEL2.txt,88152,90087,1935,10,N,N,-,-1,-1
REMKEL2.txt,88487,90122,1635,10,N,N,-,-1,-1
REMKEL2.txt,88513,90132,1619,10,N,N,-,-1,-1
REMKEL2.txt,88525,90147,1622,10,N,N,-,-1,-1
REMKEL2.txt,88964,90157,1193,10,N,N,-,-1,-1
REMKEL2.txt,89187,90181,994,10,N,N,-,-1,-1
REMKEL2.txt,89519,90207,688,10,N,N,-,-1,-1
REMKEL2.txt,89663,90299,636,10,N,N,-,-1,-1
REMKEL2.txt,89806,90883,1077,10,N,N,-,-1,-1
REMKEL2.txt,89986,90994,1008,10,N,N,-,-1,-1
REMKEL2.txt,90090,91250,1160,10,N,N,-,-1,-1
REMKEL2.txt,90123,91599,1476,10,N,N,-,-1,-1
REMKEL2.txt,90134,91678,1544,10,N,N,-,-1,-1
REMKEL2.txt,90148,91874,1726,10,N,N,-,-1,-1
REMKEL2.txt,90159,92092,1933,10,Y,N,-,-1,-1
REMKEL2.txt,90184,92246,2062,10,Y,N,-,-1,-1
REMKEL2.txt,90210,92846,2636,10,Y,N,-,-1,-1
REMKEL2.txt,90302,93052,2750,10,Y,N,-,-1,-1
REMKEL2.txt,90886,93089,2203,10,Y,N,-,-1,-1
REMKEL2.txt,90995,93225,2230,10,Y,N,-,-1,-1
REMKEL2.txt,91253,93354,2101,10,Y,N,-,-1,-1
REMKEL2.txt,91602,93400,1798,10,N,N,-,-1,-1
REMKEL2.txt,91679,93511,1832,10,N,N,-,-1,-1
REMKEL2.txt,91875,93581,1706,10,N,N,-,-1,-1
REMKEL2.txt,92093,93594,1501,10,N,N,-,-1,-1
REMKEL2.txt,92249,93921,1672,10,N,N,-,-1,-1
REMKEL2.txt,92847,94016,1169,10,N,N,-,-1,-1
REMKEL2.txt,93053,94155,1102,10,Y,N,-,-1,-1
REMKEL2.txt,93090,94597,1507,10,N,N,-,-1,-1
REMKEL2.txt,93226,95095,1869,10,Y,N,-,-1,-1
REMKEL2.txt,93356,95200,1844,10,Y,N,-,-1,-1
REMKEL2.txt,93403,95373,1970,10,Y,N,-,-1,-1
REMKEL2.txt,93512,95535,2023,10,Y,N,-,-1,-1
REMKEL2.txt,93582,95652,2070,10,Y,N,-,-1,-1
REMKEL2.txt,93596,95816,2220,10,Y,N,-,-1,-1
REMKEL2.txt,93923,95942,2019,10,Y,N,-,-1,-1
REMKEL2.txt,94019,95978,1959,10,Y,N,-,-1,-1
REMKEL2.txt,94156,95988,1832,10,Y,N,-,-1,-1
REMKEL2.txt,94598,96174,1576,10,Y,N,-,-1,-1
REMKEL2.txt,95098,96273,1175,10,N,N,-,-1,-1
REMKEL2.txt,95205,96365,1160,10,N,N,-,-1,-1
REMKEL2.txt,95376,96479,1103,10,N,N,-,-1,-1
REMKEL2.txt,95536,96601,1065,10,N,N,-,-1,-1
REMKEL2.txt,95653,96732,1079,10,N,N,-,-1,-1
REMKEL2.txt,95817,96808,991,10,N,N,-,-1,-1
REMKEL2.txt,95943,97055,1112,10,N,N,-,-1,-1
REMKEL2.txt,95978,97080,1102,10,N,N,-,-1,-1
REMKEL2.txt,95989,97203,1214,10,N,N,-,-1,-1
REMKEL2.txt,96177,97456,1279,10,N,N,-,-1,-1
REMKEL2.txt,96275,97537,1262,10,N,N,-,-1,-1
REMKEL2.txt,96366,97613,1247,10,N,N,-,-1,-1
REMKEL2.txt,96481,97915,1434,10,N,N,-,-1,-1
REMKEL2.txt,96602,97980,1378,10,N,N,-,-1,-1
REMKEL2.txt,96733,98201,1468,10,N,Y,1448313482895,176553,176862
REMKEL2.txt,96809,98339,1530,10,N,Y,1448313482895,176553,176862
REMKEL2.txt,97056,98513,1457,10,N,Y,1448313482895,176553,176862
REMKEL2.txt,97083,98597,1514,10,N,Y,1448313482895,176553,176862
REMKEL2.txt,97204,98784,1580,10,N,Y,1448313482895,176553,176862
REMKEL2.txt,97459,98935,1476,10,N,Y,1448313482895,176553,176862
REMKEL2.txt,97538,99194,1656,10,N,Y,1448313482895,176553,176862
REMKEL2.txt,97616,99323,1707,10,N,Y,1448313482895,176553,176862
REMKEL2.txt,97916,99431,1515,10,N,Y,1448313482895,176553,176862
REMKEL2.txt,97983,99589,1606,10,N,Y,1448313482895,176553,176862
REMKEL2.txt,98202,99894,1692,10,N,Y,1448313482895,176553,176862
REMKEL2.txt,98342,100447,2105,10,N,N,-,-1,-1
REMKEL2.txt,98514,100553,2039,10,N,N,-,-1,-1
REMKEL2.txt,98598,100849,2251,10,N,N,-,-1,-1
REMKEL2.txt,98787,100958,2171,10,N,N,-,-1,-1
REMKEL2.txt,98937,101052,2115,10,N,Y,1448323254416,230223,230526
REMKEL2.txt,99195,101198,2003,10,N,Y,1448323254416,230223,230526
REMKEL2.txt,99324,101301,1977,10,N,Y,1448323254416,230223,230526
REMKEL2.txt,99432,101429,1997,10,N,Y,1448323254416,230223,230526
REMKEL2.txt,99590,101610,2020,10,N,Y,1448323254416,230223,230526
REMKEL2.txt,99897,101718,1821,10,N,Y,1448323254416,230223,230526
REMKEL2.txt,100449,101879,1430,10,N,Y,1448323254416,230223,230526
REMKEL2.txt,100553,101955,1402,10,N,Y,1448323254416,230223,230526
REMKEL2.txt,100850,102031,1181,10,N,Y,1448323254416,230223,230526
REMKEL2.txt,100961,102179,1218,10,N,Y,1448323254416,230223,230526
REMKEL2.txt,101053,102387,1334,10,N,Y,1448323254416,230223,230526
REMKEL2.txt,101199,102520,1321,10,Y,Y,1448323254416,230223,230526
REMKEL2.txt,101302,102683,1381,10,Y,Y,1448323254416,230223,230526
REMKEL2.txt,101430,102815,1385,10,Y,Y,1448323254416,230223,230526
REMKEL2.txt,101613,103072,1459,10,Y,Y,1448367094347,278355,278591
REMKEL2.txt,101719,103107,1388,10,Y,Y,1448367094347,278355,278591
REMKEL2.txt,101880,103273,1393,10,Y,Y,1448367094347,278355,278591
REMKEL2.txt,101956,103536,1580,10,Y,Y,1448367094347,278355,278591
REMKEL2.txt,102032,103637,1605,10,Y,Y,1448367094347,278355,278591
REMKEL2.txt,102180,103681,1501,10,Y,Y,1448367094347,278355,278591
REMKEL2.txt,102388,103702,1314,10,N,Y,1448367094347,278355,278591
REMKEL2.txt,102521,103712,1191,10,N,Y,1448367094347,278355,278591
REMKEL2.txt,102684,103739,1055,10,N,Y,1448367094347,278355,278591
REMKEL2.txt,102818,103783,965,10,N,N,-,-1,-1
REMKEL2.txt,103075,103821,746,10,N,N,-,-1,-1
REMKEL2.txt,103108,103828,720,10,N,N,-,-1,-1
REMKEL2.txt,103275,103954,679,10,N,Y,1448322514970,220165,221397
REMKEL2.txt,103537,104024,487,10,N,Y,1448322514970,220165,221397
REMKEL2.txt,103638,104223,585,10,N,Y,1448322514970,220165,221397
REMKEL2.txt,103682,104306,624,10,N,Y,1448322514970,220165,221397
REMKEL2.txt,103703,104680,977,10,N,Y,1448322514970,220165,221397
REMKEL2.txt,103713,104744,1031,10,N,Y,1448322514970,220165,221397
REMKEL2.txt,103740,104763,1023,10,N,Y,1448322514970,220165,221397
REMKEL2.txt,103784,104883,1099,10,N,Y,1448322514970,220165,221397
REMKEL2.txt,103822,105033,1211,10,N,Y,1448322514970,220165,221397
REMKEL2.txt,103831,105383,1552,10,N,Y,1448276340407,30017,39003
REMKEL2.txt,103955,105632,1677,10,N,Y,1448276340407,30017,39003
REMKEL2.txt,104027,105763,1736,10,N,Y,1448276340407,30017,39003
REMKEL2.txt,104224,105936,1712,10,N,Y,1448276340407,30017,39003
REMKEL2.txt,104307,106080,1773,10,N,Y,1448276340407,30017,39003
REMKEL2.txt,104681,106291,1610,10,N,Y,1448276340407,30017,39003
REMKEL2.txt,104749,106446,1697,10,N,Y,1448276340407,30017,39003
REMKEL2.txt,104764,106526,1762,10,N,Y,1448276340407,30017,39003
REMKEL2.txt,104886,106570,1684,10,N,Y,1448276340407,30017,39003
REMKEL2.txt,105034,106738,1704,10,N,Y,1448276340407,30017,39003
REMKEL2.txt,105386,106789,1403,10,N,Y,1448276340407,30017,39003
REMKEL2.txt,105635,106796,1161,10,N,N,-,-1,-1
REMKEL2.txt,105764,106804,1040,10,N,N,-,-1,-1
REMKEL2.txt,105937,106809,872,10,N,N,-,-1,-1
REMKEL2.txt,106081,106820,739,10,N,N,-,-1,-1
REMKEL2.txt,106292,106943,651,10,N,N,-,-1,-1
REMKEL2.txt,106447,107135,688,10,N,N,-,-1,-1
REMKEL2.txt,106527,107194,667,10,N,N,-,-1,-1
REMKEL2.txt,106571,107445,874,10,N,N,-,-1,-1
REMKEL2.txt,106739,107566,827,10,N,N,-,-1,-1
REMKEL2.txt,106790,107668,878,10,N,N,-,-1,-1
REMKEL2.txt,106797,107761,964,10,N,N,-,-1,-1
REMKEL2.txt,106805,107848,1043,10,N,N,-,-1,-1
REMKEL2.txt,106811,108086,1275,10,N,N,-,-1,-1
REMKEL2.txt,106821,108358,1537,10,N,N,-,-1,-1
REMKEL2.txt,106946,108471,1525,10,N,N,-,-1,-1
REMKEL2.txt,107136,108566,1430,10,N,N,-,-1,-1
REMKEL2.txt,107196,108652,1456,10,N,N,-,-1,-1
REMKEL2.txt,107448,108690,1242,10,N,N,-,-1,-1
REMKEL2.txt,107567,108816,1249,10,N,N,-,-1,-1
REMKEL2.txt,107670,108920,1250,10,N,N,-,-1,-1
REMKEL2.txt,107762,109182,1420,10,N,N,-,-1,-1
REMKEL2.txt,107849,109255,1406,10,N,N,-,-1,-1
REMKEL2.txt,108087,109507,1420,10,N,N,-,-1,-1
REMKEL2.txt,108359,109595,1236,10,N,N,-,-1,-1
REMKEL2.txt,108474,109779,1305,10,Y,N,-,-1,-1
REMKEL2.txt,108568,110058,1490,10,N,Y,1448281071558,89330,89524
REMKEL2.txt,108653,110365,1712,10,N,Y,1448281071558,89330,89524
REMKEL2.txt,108691,110399,1708,10,N,Y,1448281071558,89330,89524
REMKEL2.txt,108817,110479,1662,10,N,Y,1448281071558,89330,89524
REMKEL2.txt,108921,110652,1731,10,Y,Y,1448281071558,89330,89524
REMKEL2.txt,109183,110791,1608,10,Y,Y,1448281071558,89330,89524
REMKEL2.txt,109256,110869,1613,10,Y,Y,1448281071558,89330,89524
REMKEL2.txt,109508,110929,1421,10,Y,Y,1448281071558,89330,89524
REMKEL2.txt,109598,111210,1612,10,Y,Y,1437477480340,424837,425856
REMKEL2.txt,109782,111584,1802,10,Y,Y,1437477480340,424837,425856
REMKEL2.txt,110059,111699,1640,10,Y,Y,1437477480340,424837,425856
REMKEL2.txt,110366,111751,1385,10,Y,Y,1437477480340,424837,425856
REMKEL2.txt,110400,111800,1400,10,Y,Y,1437477480340,424837,425856
REMKEL2.txt,110482,111804,1322,10,N,Y,1437477480340,424837,425856
REMKEL2.txt,110653,112010,1357,10,N,Y,1437477480340,424837,425856
REMKEL2.txt,110792,112109,1317,10,N,Y,1437477480340,424837,425856
REMKEL2.txt,110870,112190,1320,10,N,Y,1437477480340,424837,425856
REMKEL2.txt,110930,112508,1578,10,Y,Y,1437477480340,424837,425856
REMKEL2.txt,111211,112724,1513,10,Y,Y,1437477480340,424837,425856
REMKEL2.txt,111585,112790,1205,10,N,Y,1437477480340,424837,425856
REMKEL2.txt,111702,112928,1226,10,N,Y,1448316586529,210063,210674
REMKEL2.txt,111751,112958,1207,10,N,Y,1448316586529,210063,210674
REMKEL2.txt,111801,113047,1246,10,N,Y,1448316586529,210063,210674
REMKEL2.txt,111805,113134,1329,10,N,Y,1448316586529,210063,210674
REMKEL2.txt,112011,113302,1291,10,N,Y,1448316586529,210063,210674
REMKEL2.txt,112110,113588,1478,10,N,Y,1448316586529,210063,210674
REMKEL2.txt,112192,113681,1489,10,N,Y,1448316586529,210063,210674
REMKEL2.txt,112509,113840,1331,10,N,Y,1448316586529,210063,210674
REMKEL2.txt,112727,114039,1312,10,N,Y,1448316586529,210063,210674
REMKEL2.txt,112795,114513,1718,10,N,Y,1448316586529,210063,210674
REMKEL2.txt,112929,114622,1693,10,N,Y,1448316586529,210063,210674
REMKEL2.txt,112959,114898,1939,10,N,Y,1448316586529,210063,210674
REMKEL2.txt,113050,115010,1960,10,N,Y,1448393918391,289044,290517
REMKEL2.txt,113135,115097,1962,10,Y,Y,1448393918391,289044,290517
REMKEL2.txt,113303,115153,1850,10,Y,Y,1448393918391,289044,290517
REMKEL2.txt,113589,115378,1789,10,Y,Y,1448393918391,289044,290517
REMKEL2.txt,113682,115450,1768,10,Y,Y,1448393918391,289044,290517
REMKEL2.txt,113841,115620,1779,10,N,Y,1448393918391,289044,290517
REMKEL2.txt,114042,115894,1852,10,N,Y,1448315841759,183531,183799
REMKEL2.txt,114516,115913,1397,10,N,Y,1448315841759,183531,183799
REMKEL2.txt,114623,116060,1437,10,N,Y,1448315841759,183531,183799
REMKEL2.txt,114899,116158,1259,10,N,Y,1448315841759,183531,183799
REMKEL2.txt,115012,116447,1435,10,N,Y,1448315841759,183531,183799
REMKEL2.txt,115100,116644,1544,10,N,Y,1448315841759,183531,183799
REMKEL2.txt,115154,116760,1606,10,N,Y,1448315841759,183531,183799
REMKEL2.txt,115379,117009,1630,10,N,Y,1448315841759,183531,183799
REMKEL2.txt,115451,117061,1610,10,N,Y,1448315575026,182236,182361
REMKEL2.txt,115622,117147,1525,10,N,Y,1448315575026,182236,182361
REMKEL2.txt,115899,117271,1372,10,N,Y,1448315575026,182236,182361
REMKEL2.txt,115914,117527,1613,10,N,Y,1448315575026,182236,182361
REMKEL2.txt,116061,117660,1599,10,N,Y,1448315575026,182236,182361
REMKEL2.txt,116159,117735,1576,10,N,Y,1448315575026,182236,182361
REMKEL2.txt,116450,117789,1339,10,N,Y,1448315575026,182236,182361
REMKEL2.txt,116645,117995,1350,10,N,Y,1448315575026,182236,182361
REMKEL2.txt,116762,118333,1571,10,N,Y,1448315575026,182236,182361
REMKEL2.txt,117012,118508,1496,10,N,Y,1448315575026,182236,182361
REMKEL2.txt,117062,118616,1554,10,N,Y,1448315575026,182236,182361
REMKEL2.txt,117148,118687,1539,10,N,Y,1448315575026,182236,182361
REMKEL2.txt,117272,118922,1650,10,N,Y,1448315575026,182236,182361
REMKEL2.txt,117528,118984,1456,10,N,Y,1448315575026,182236,182361
REMKEL2.txt,117661,119165,1504,10,N,Y,1448315575026,182236,182361
REMKEL2.txt,117736,119304,1568,10,Y,Y,1448315575026,182236,182361
REMKEL2.txt,117790,119548,1758,10,Y,Y,1448315575026,182236,182361
REMKEL2.txt,117996,119630,1634,10,Y,Y,1448315575026,182236,182361
REMKEL2.txt,118334,119707,1373,10,N,Y,1448315575026,182236,182361
REMKEL2.txt,118509,119729,1220,10,N,Y,1448315575026,182236,182361
REMKEL2.txt,118618,119785,1167,10,N,Y,1448315575026,182236,182361
REMKEL2.txt,118688,119865,1177,10,N,Y,1448315575026,182236,182361
REMKEL2.txt,118923,119883,960,10,N,Y,1448315575026,182236,182361
REMKEL2.txt,118985,120052,1067,10,N,Y,1448315575026,182236,182361
REMKEL2.txt,119168,120160,992,10,N,N,-,-1,-1
REMKEL2.txt,119305,120220,915,10,N,N,-,-1,-1
REMKEL2.txt,119549,120267,718,10,N,N,-,-1,-1
REMKEL2.txt,119632,120353,721,10,N,N,-,-1,-1
REMKEL2.txt,119709,120364,655,10,N,N,-,-1,-1
REMKEL2.txt,119730,120544,814,10,N,N,-,-1,-1
REMKEL2.txt,119787,120551,764,10,N,N,-,-1,-1
REMKEL2.txt,119867,120735,868,10,N,N,-,-1,-1
REMKEL2.txt,119884,120753,869,10,N,N,-,-1,-1
REMKEL2.txt,120057,120873,816,10,N,N,-,-1,-1
REMKEL2.txt,120162,121026,864,10,N,N,-,-1,-1
REMKEL2.txt,120220,121176,956,10,Y,N,-,-1,-1
REMKEL2.txt,120270,121317,1047,10,Y,N,-,-1,-1
REMKEL2.txt,120354,121345,991,10,N,N,-,-1,-1
REMKEL2.txt,120365,121373,1008,10,N,N,-,-1,-1
REMKEL2.txt,120547,121382,835,10,N,N,-,-1,-1
REMKEL2.txt,120552,121442,890,10,N,N,-,-1,-1
REMKEL2.txt,120738,121446,708,10,N,N,-,-1,-1
REMKEL2.txt,120756,121499,743,10,N,N,-,-1,-1
REMKEL2.txt,120876,121598,722,10,N,N,-,-1,-1
REMKEL2.txt,121027,121679,652,10,N,N,-,-1,-1
REMKEL2.txt,121179,121860,681,10,N,N,-,-1,-1
REMKEL2.txt,121317,121974,657,10,N,Y,1448279813455,71525,72226
REMKEL2.txt,121346,122226,880,10,N,Y,1448279813455,71525,72226
REMKEL2.txt,121374,122359,985,10,N,Y,1448279813455,71525,72226
REMKEL2.txt,121385,122496,1111,10,N,Y,1448279813455,71525,72226
REMKEL2.txt,121443,122651,1208,10,N,Y,1448279813455,71525,72226
REMKEL2.txt,121447,122825,1378,10,Y,Y,1448279813455,71525,72226
REMKEL2.txt,121500,122918,1418,10,Y,Y,1448279813455,71525,72226
REMKEL2.txt,121598,123184,1586,10,Y,Y,1448279813455,71525,72226
REMKEL2.txt,121680,123362,1682,10,Y,Y,1448279813455,71525,72226
REMKEL2.txt,121863,123579,1716,10,Y,Y,1448279813455,71525,72226
REMKEL2.txt,121975,124070,2095,10,Y,Y,1448279813455,71525,72226
REMKEL2.txt,122227,124172,1945,10,Y,Y,1448279813455,71525,72226
REMKEL2.txt,122360,124208,1848,10,Y,Y,1448279813455,71525,72226
REMKEL2.txt,122497,124306,1809,10,Y,Y,1448279813455,71525,72226
REMKEL2.txt,122652,124425,1773,10,N,Y,1448279813455,71525,72226
REMKEL2.txt,122826,124560,1734,10,N,Y,1448279813455,71525,72226
REMKEL2.txt,122921,124600,1679,10,N,N,-,-1,-1
REMKEL2.txt,123185,124927,1742,10,N,N,-,-1,-1
REMKEL2.txt,123364,124990,1626,10,N,N,-,-1,-1
REMKEL2.txt,123580,125265,1685,10,N,N,-,-1,-1
REMKEL2.txt,124073,125492,1419,10,N,N,-,-1,-1
REMKEL2.txt,124174,125597,1423,10,N,N,-,-1,-1
REMKEL2.txt,124209,125752,1543,10,N,N,-,-1,-1
REMKEL2.txt,124307,125972,1665,10,N,N,-,-1,-1
REMKEL2.txt,124426,126039,1613,10,N,N,-,-1,-1
REMKEL2.txt,124561,126241,1680,10,N,N,-,-1,-1
REMKEL2.txt,124601,126487,1886,10,N,N,-,-1,-1
REMKEL2.txt,124928,126782,1854,10,N,N,-,-1,-1
REMKEL2.txt,124993,126833,1840,10,N,N,-,-1,-1
REMKEL2.txt,125266,126955,1689,10,Y,N,-,-1,-1
REMKEL2.txt,125493,127147,1654,10,Y,N,-,-1,-1
REMKEL2.txt,125600,127364,1764,10,Y,N,-,-1,-1
REMKEL2.txt,125754,127779,2025,10,Y,N,-,-1,-1
REMKEL2.txt,125972,127849,1877,10,Y,N,-,-1,-1
REMKEL2.txt,126041,128065,2024,10,Y,N,-,-1,-1
REMKEL2.txt,126244,128102,1858,10,Y,N,-,-1,-1
REMKEL2.txt,126488,128410,1922,10,Y,N,-,-1,-1
REMKEL2.txt,126785,128831,2046,10,Y,N,-,-1,-1
REMKEL2.txt,126835,128962,2127,10,Y,N,-,-1,-1
REMKEL2.txt,126956,129022,2066,10,N,N,-,-1,-1
REMKEL2.txt,127148,129532,2384,10,N,N,-,-1,-1
REMKEL2.txt,127365,129685,2320,10,N,N,-,-1,-1
REMKEL2.txt,127780,129756,1976,10,N,N,-,-1,-1
REMKEL2.txt,127850,130203,2353,10,N,N,-,-1,-1
REMKEL2.txt,128068,130344,2276,10,N,N,-,-1,-1
REMKEL2.txt,128103,130559,2456,10,N,N,-,-1,-1
REMKEL2.txt,128413,130845,2432,10,N,N,-,-1,-1
REMKEL2.txt,128832,130988,2156,10,N,N,-,-1,-1
REMKEL2.txt,128963,131180,2217,10,N,N,-,-1,-1
REMKEL2.txt,129023,131305,2282,10,N,N,-,-1,-1
REMKEL2.txt,129533,131540,2007,10,N,N,-,-1,-1
REMKEL2.txt,129688,131898,2210,10,N,N,-,-1,-1
REMKEL2.txt,129757,131938,2181,10,N,N,-,-1,-1
REMKEL2.txt,130204,132104,1900,10,N,N,-,-1,-1
REMKEL2.txt,130345,132511,2166,10,N,N,-,-1,-1
REMKEL2.txt,130560,132648,2088,10,N,N,-,-1,-1
REMKEL2.txt,130848,132709,1861,10,N,N,-,-1,-1
REMKEL2.txt,130991,132923,1932,10,N,N,-,-1,-1
REMKEL2.txt,131181,132965,1784,10,N,N,-,-1,-1
REMKEL2.txt,131306,133054,1748,10,N,N,-,-1,-1
REMKEL2.txt,131545,133218,1673,10,N,N,-,-1,-1
REMKEL2.txt,131899,133524,1625,10,N,N,-,-1,-1
REMKEL2.txt,131941,133844,1903,10,N,N,-,-1,-1
REMKEL2.txt,132105,134080,1975,10,N,N,-,-1,-1
REMKEL2.txt,132512,134407,1895,10,N,N,-,-1,-1
REMKEL2.txt,132650,134684,2034,10,N,Y,1448357582358,234204,234401
REMKEL2.txt,132712,134860,2148,10,N,Y,1448357582358,234204,234401
REMKEL2.txt,132924,134956,2032,10,N,Y,1448357582358,234204,234401
REMKEL2.txt,132966,134997,2031,10,N,Y,1448357582358,234204,234401
REMKEL2.txt,133055,135301,2246,10,N,Y,1448357582358,234204,234401
REMKEL2.txt,133220,135431,2211,10,N,Y,1448357582358,234204,234401
REMKEL2.txt,133527,135651,2124,10,N,Y,1448357582358,234204,234401
REMKEL2.txt,133845,135739,1894,10,N,Y,1448357582358,234204,234401
REMKEL2.txt,134083,135844,1761,10,N,Y,1448357582358,234204,234401
REMKEL2.txt,134410,136025,1615,10,N,Y,1448357582358,234204,234401
REMKEL2.txt,134685,136093,1408,10,N,Y,1448357582358,234204,234401
REMKEL2.txt,134863,136241,1378,10,N,N,-,-1,-1
REMKEL2.txt,134958,136482,1524,10,N,N,-,-1,-1
REMKEL2.txt,134998,136594,1596,10,N,N,-,-1,-1
REMKEL2.txt,135302,136735,1433,10,N,N,-,-1,-1
REMKEL2.txt,135432,136903,1471,10,N,N,-,-1,-1
REMKEL2.txt,135652,136965,1313,10,N,N,-,-1,-1
REMKEL2.txt,135740,137046,1306,10,N,N,-,-1,-1
REMKEL2.txt,135845,137626,1781,10,N,N,-,-1,-1
REMKEL2.txt,136026,137665,1639,10,N,N,-,-1,-1
REMKEL2.txt,136094,137671,1577,10,N,N,-,-1,-1
REMKEL2.txt,136242,137745,1503,10,N,N,-,-1,-1
REMKEL2.txt,136484,137843,1359,10,N,N,-,-1,-1
REMKEL2.txt,136595,137879,1284,10,N,N,-,-1,-1
REMKEL2.txt,136738,137957,1219,10,N,N,-,-1,-1
REMKEL2.txt,136904,138226,1322,10,N,N,-,-1,-1
REMKEL2.txt,136966,138419,1453,10,N,N,-,-1,-1
REMKEL2.txt,137049,138494,1445,10,N,N,-,-1,-1
REMKEL2.txt,137628,138545,917,10,N,N,-,-1,-1
REMKEL2.txt,137666,138610,944,10,N,N,-,-1,-1
REMKEL2.txt,137674,138728,1054,10,N,N,-,-1,-1
REMKEL2.txt,137746,138874,1128,10,N,N,-,-1,-1
REMKEL2.txt,137846,138970,1124,10,N,N,-,-1,-1
REMKEL2.txt,137880,139083,1203,10,N,N,-,-1,-1
REMKEL2.txt,137958,139386,1428,10,N,N,-,-1,-1
REMKEL2.txt,138229,139771,1542,10,N,N,-,-1,-1
REMKEL2.txt,138420,139959,1539,10,N,N,-,-1,-1
REMKEL2.txt,138495,140346,1851,10,N,N,-,-1,-1
REMKEL2.txt,138546,140399,1853,10,N,N,-,-1,-1
REMKEL2.txt,138611,140691,2080,10,N,N,-,-1,-1
REMKEL2.txt,138731,140949,2218,10,N,N,-,-1,-1
REMKEL2.txt,138875,141115,2240,10,N,N,-,-1,-1
REMKEL2.txt,138971,141177,2206,10,N,N,-,-1,-1
REMKEL2.txt,139084,141279,2195,10,N,N,-,-1,-1
REMKEL2.txt,139389,141303,1914,10,N,N,-,-1,-1
REMKEL2.txt,139774,141366,1592,10,N,N,-,-1,-1
REMKEL2.txt,139960,141766,1806,10,N,N,-,-1,-1
REMKEL2.txt,140347,141893,1546,10,N,N,-,-1,-1
REMKEL2.txt,140400,141973,1573,10,N,N,-,-1,-1
REMKEL2.txt,140694,142150,1456,10,N,N,-,-1,-1
REMKEL2.txt,140952,142212,1260,10,N,N,-,-1,-1
REMKEL2.txt,141116,142552,1436,10,N,N,-,-1,-1
REMKEL2.txt,141178,142938,1760,10,N,N,-,-1,-1
REMKEL2.txt,141280,143042,1762,10,N,N,-,-1,-1
REMKEL2.txt,141304,143485,2181,10,N,N,-,-1,-1
REMKEL2.txt,141367,143624,2257,10,N,N,-,-1,-1
REMKEL2.txt,141768,143717,1949,10,N,N,-,-1,-1
REMKEL2.txt,141896,144020,2124,10,N,N,-,-1,-1
REMKEL2.txt,141974,144082,2108,10,N,N,-,-1,-1
REMKEL2.txt,142152,144090,1938,10,N,N,-,-1,-1
REMKEL2.txt,142215,144106,1891,10,N,N,-,-1,-1
REMKEL2.txt,142554,144124,1570,10,N,N,-,-1,-1
REMKEL2.txt,142941,144143,1202,10,N,N,-,-1,-1
REMKEL2.txt,143043,144182,1139,10,N,N,-,-1,-1
REMKEL2.txt,143486,144311,825,10,N,N,-,-1,-1
REMKEL2.txt,143627,144374,747,10,N,N,-,-1,-1
REMKEL2.txt,143719,144503,784,10,N,N,-,-1,-1
REMKEL2.txt,144021,144751,730,10,N,N,-,-1,-1
REMKEL2.txt,144083,144842,759,10,N,N,-,-1,-1
REMKEL2.txt,144090,144899,809,10,N,N,-,-1,-1
REMKEL2.txt,144107,145024,917,10,N,N,-,-1,-1
REMKEL2.txt,144126,145336,1210,10,N,N,-,-1,-1
REMKEL2.txt,144144,145340,1196,10,N,N,-,-1,-1
REMKEL2.txt,144183,145400,1217,10,N,N,-,-1,-1
REMKEL2.txt,144312,145669,1357,10,N,N,-,-1,-1
REMKEL2.txt,144377,146213,1836,10,N,N,-,-1,-1
REMKEL2.txt,144504,146290,1786,10,N,N,-,-1,-1
REMKEL2.txt,144752,146456,1704,10,N,N,-,-1,-1
REMKEL2.txt,144843,146649,1806,10,N,N,-,-1,-1
REMKEL2.txt,144900,146717,1817,10,N,N,-,-1,-1
REMKEL2.txt,145027,146851,1824,10,N,N,-,-1,-1
REMKEL2.txt,145337,147105,1768,10,N,N,-,-1,-1
REMKEL2.txt,145341,147210,1869,10,N,N,-,-1,-1
REMKEL2.txt,145401,147478,2077,10,N,N,-,-1,-1
REMKEL2.txt,145672,147638,1966,10,N,N,-,-1,-1
REMKEL2.txt,146214,147947,1733,10,N,N,-,-1,-1
REMKEL2.txt,146291,148206,1915,10,N,N,-,-1,-1
REMKEL2.txt,146459,148480,2021,10,N,N,-,-1,-1
REMKEL2.txt,146652,148713,2061,10,N,N,-,-1,-1
REMKEL2.txt,146718,148904,2186,10,N,N,-,-1,-1
REMKEL2.txt,146852,149197,2345,10,N,N,-,-1,-1
REMKEL2.txt,147108,149224,2116,10,N,N,-,-1,-1
REMKEL2.txt,147211,149284,2073,10,N,N,-,-1,-1
REMKEL2.txt,147479,149337,1858,10,N,N,-,-1,-1
REMKEL2.txt,147641,149361,1720,10,N,N,-,-1,-1
REMKEL2.txt,147950,149424,1474,10,N,N,-,-1,-1
REMKEL2.txt,148207,149770,1563,10,N,N,-,-1,-1
REMKEL2.txt,148483,149917,1434,10,N,N,-,-1,-1
REMKEL2.txt,148714,150207,1493,10,N,N,-,-1,-1
REMKEL2.txt,148905,150290,1385,10,N,N,-,-1,-1
REMKEL2.txt,149198,150421,1223,10,N,N,-,-1,-1
REMKEL2.txt,149225,150520,1295,10,N,N,-,-1,-1
REMKEL2.txt,149285,150938,1653,10,N,N,-,-1,-1
REMKEL2.txt,149338,151054,1716,10,N,N,-,-1,-1
REMKEL2.txt,149362,151312,1950,10,N,N,-,-1,-1
REMKEL2.txt,149427,151605,2178,10,N,N,-,-1,-1
REMKEL2.txt,149773,151754,1981,10,N,N,-,-1,-1
REMKEL2.txt,149918,151851,1933,10,N,N,-,-1,-1
REMKEL2.txt,150209,151959,1750,10,N,N,-,-1,-1
REMKEL2.txt,150291,152053,1762,10,N,N,-,-1,-1
REMKEL2.txt,150422,152074,1652,10,N,N,-,-1,-1
REMKEL2.txt,150523,152196,1673,10,N,N,-,-1,-1
REMKEL2.txt,150939,152236,1297,10,N,N,-,-1,-1
REMKEL2.txt,151055,152322,1267,10,N,N,-,-1,-1
REMKEL2.txt,151315,152589,1274,10,N,N,-,-1,-1
REMKEL2.txt,151608,152740,1132,10,N,N,-,-1,-1
REMKEL2.txt,151756,152915,1159,10,N,N,-,-1,-1
REMKEL2.txt,151854,153012,1158,10,N,N,-,-1,-1
REMKEL2.txt,151960,153198,1238,10,N,N,-,-1,-1
REMKEL2.txt,152054,153293,1239,10,N,N,-,-1,-1
REMKEL2.txt,152075,153542,1467,10,N,N,-,-1,-1
REMKEL2.txt,152197,153731,1534,10,N,N,-,-1,-1
REMKEL2.txt,152238,153857,1619,10,N,N,-,-1,-1
REMKEL2.txt,152323,154059,1736,10,N,N,-,-1,-1
REMKEL2.txt,152590,154184,1594,10,N,N,-,-1,-1
REMKEL2.txt,152741,154754,2013,10,N,N,-,-1,-1
REMKEL2.txt,152918,154773,1855,10,N,N,-,-1,-1
REMKEL2.txt,153014,154863,1849,10,N,N,-,-1,-1
REMKEL2.txt,153199,154864,1665,10,N,N,-,-1,-1
REMKEL2.txt,153294,155119,1825,10,N,N,-,-1,-1
REMKEL2.txt,153543,155200,1657,10,N,N,-,-1,-1
REMKEL2.txt,153732,155269,1537,10,N,N,-,-1,-1
REMKEL2.txt,153858,155481,1623,10,N,N,-,-1,-1
REMKEL2.txt,154062,155610,1548,10,N,N,-,-1,-1
REMKEL2.txt,154185,155658,1473,10,N,N,-,-1,-1
REMKEL2.txt,154759,155867,1108,10,N,N,-,-1,-1
REMKEL2.txt,154774,155944,1170,10,N,N,-,-1,-1
REMKEL2.txt,154863,156088,1225,10,N,N,-,-1,-1
REMKEL2.txt,154865,156123,1258,10,N,N,-,-1,-1
REMKEL2.txt,155122,156228,1106,10,N,N,-,-1,-1
REMKEL2.txt,155201,156411,1210,10,N,N,-,-1,-1
REMKEL2.txt,155271,156649,1378,10,N,N,-,-1,-1
REMKEL2.txt,155482,156865,1383,10,N,N,-,-1,-1
REMKEL2.txt,155611,157024,1413,10,N,N,-,-1,-1
REMKEL2.txt,155659,157471,1812,10,Y,N,-,-1,-1
REMKEL2.txt,155868,157654,1786,10,Y,N,-,-1,-1
REMKEL2.txt,155945,157809,1864,10,Y,N,-,-1,-1
REMKEL2.txt,156089,157991,1902,10,Y,N,-,-1,-1
REMKEL2.txt,156128,158276,2148,10,Y,N,-,-1,-1
REMKEL2.txt,156231,158400,2169,10,Y,N,-,-1,-1
REMKEL2.txt,156412,158718,2306,10,Y,N,-,-1,-1
REMKEL2.txt,156652,159019,2367,10,Y,N,-,-1,-1
REMKEL2.txt,156866,159219,2353,10,Y,N,-,-1,-1
REMKEL2.txt,157025,159305,2280,10,N,N,-,-1,-1
REMKEL2.txt,157472,159450,1978,10,N,N,-,-1,-1
REMKEL2.txt,157655,159562,1907,10,N,N,-,-1,-1
REMKEL2.txt,157810,159698,1888,10,N,N,-,-1,-1
REMKEL2.txt,157992,159769,1777,10,N,N,-,-1,-1
REMKEL2.txt,158277,159906,1629,10,N,N,-,-1,-1
REMKEL2.txt,158403,159999,1596,10,N,N,-,-1,-1
REMKEL2.txt,158719,160057,1338,10,N,N,-,-1,-1
REMKEL2.txt,159020,160251,1231,10,N,N,-,-1,-1
REMKEL2.txt,159222,160305,1083,10,N,N,-,-1,-1
REMKEL2.txt,159306,160324,1018,10,N,N,-,-1,-1
REMKEL2.txt,159451,160410,959,10,N,N,-,-1,-1
REMKEL2.txt,159563,160530,967,10,N,N,-,-1,-1
REMKEL2.txt,159699,160660,961,10,N,N,-,-1,-1
REMKEL2.txt,159770,161048,1278,10,N,N,-,-1,-1
REMKEL2.txt,159907,161307,1400,10,N,N,-,-1,-1
REMKEL2.txt,160002,161429,1427,10,N,N,-,-1,-1
REMKEL2.txt,160058,161706,1648,10,N,N,-,-1,-1
REMKEL2.txt,160253,161937,1684,10,N,N,-,-1,-1
REMKEL2.txt,160310,161939,1629,10,N,N,-,-1,-1
REMKEL2.txt,160325,162112,1787,10,N,N,-,-1,-1
REMKEL2.txt,160411,162514,2103,10,N,N,-,-1,-1
REMKEL2.txt,160533,162694,2161,10,N,N,-,-1,-1
REMKEL2.txt,160661,162872,2211,10,N,N,-,-1,-1
REMKEL2.txt,161051,163041,1990,10,N,N,-,-1,-1
REMKEL2.txt,161308,163165,1857,10,N,N,-,-1,-1
REMKEL2.txt,161430,163258,1828,10,N,N,-,-1,-1
REMKEL2.txt,161707,163515,1808,10,N,N,-,-1,-1
REMKEL2.txt,161938,163603,1665,10,N,N,-,-1,-1
REMKEL2.txt,161939,163674,1735,10,N,N,-,-1,-1
REMKEL2.txt,162113,163888,1775,10,N,N,-,-1,-1
REMKEL2.txt,162516,164049,1533,10,N,N,-,-1,-1
REMKEL2.txt,162697,164307,1610,10,N,N,-,-1,-1
REMKEL2.txt,162873,164426,1553,10,N,N,-,-1,-1
REMKEL2.txt,163042,164571,1529,10,N,N,-,-1,-1
REMKEL2.txt,163166,164769,1603,10,N,N,-,-1,-1
REMKEL2.txt,163261,164895,1634,10,N,N,-,-1,-1
REMKEL2.txt,163516,165303,1787,10,N,N,-,-1,-1
REMKEL2.txt,163604,165588,1984,10,N,N,-,-1,-1
REMKEL2.txt,163677,165789,2112,10,N,N,-,-1,-1
REMKEL2.txt,163889,165862,1973,10,N,N,-,-1,-1
REMKEL2.txt,164050,166041,1991,10,N,N,-,-1,-1
REMKEL2.txt,164310,166149,1839,10,N,N,-,-1,-1
REMKEL2.txt,164427,166351,1924,10,N,N,-,-1,-1
REMKEL2.txt,164572,166717,2145,10,N,N,-,-1,-1
REMKEL2.txt,164770,167165,2395,10,N,N,-,-1,-1
REMKEL2.txt,164898,167460,2562,10,N,N,-,-1,-1
REMKEL2.txt,165306,167808,2502,10,N,N,-,-1,-1
REMKEL2.txt,165591,168131,2540,10,N,N,-,-1,-1
REMKEL2.txt,165791,168230,2439,10,N,N,-,-1,-1
REMKEL2.txt,165863,168450,2587,10,N,N,-,-1,-1
REMKEL2.txt,166044,168621,2577,10,N,N,-,-1,-1
REMKEL2.txt,166150,168706,2556,10,N,N,-,-1,-1
REMKEL2.txt,166354,168725,2371,10,Y,N,-,-1,-1
REMKEL2.txt,166718,168990,2272,10,Y,N,-,-1,-1
REMKEL2.txt,167170,169088,1918,10,Y,N,-,-1,-1
REMKEL2.txt,167461,169202,1741,10,N,N,-,-1,-1
REMKEL2.txt,167809,169417,1608,10,N,N,-,-1,-1
REMKEL2.txt,168132,169563,1431,10,N,N,-,-1,-1
REMKEL2.txt,168231,169945,1714,10,Y,N,-,-1,-1
REMKEL2.txt,168453,170229,1776,10,N,Y,1437476486340,221621,222520
REMKEL2.txt,168622,170490,1868,10,N,Y,1437476486340,221621,222520
REMKEL2.txt,168707,170619,1912,10,N,Y,1437476486340,221621,222520
REMKEL2.txt,168725,170741,2016,10,N,Y,1437476486340,221621,222520
REMKEL2.txt,168993,170914,1921,10,N,Y,1437476486340,221621,222520
REMKEL2.txt,169090,170998,1908,10,N,Y,1437476486340,221621,222520
REMKEL2.txt,169203,171217,2014,10,N,Y,1437476486340,221621,222520
REMKEL2.txt,169418,171356,1938,10,N,Y,1437476486340,221621,222520
REMKEL2.txt,169566,171917,2351,10,Y,Y,1437476486340,221621,222520
REMKEL2.txt,169948,172005,2057,10,N,Y,1437476486340,221621,222520
REMKEL2.txt,170232,172245,2013,10,N,N,-,-1,-1
REMKEL2.txt,170492,172362,1870,10,N,N,-,-1,-1
REMKEL2.txt,170620,172425,1805,10,N,N,-,-1,-1
REMKEL2.txt,170743,172560,1817,10,N,N,-,-1,-1
REMKEL2.txt,170915,172671,1756,10,N,N,-,-1,-1
REMKEL2.txt,171001,172774,1773,10,N,N,-,-1,-1
REMKEL2.txt,171218,172979,1761,10,N,N,-,-1,-1
REMKEL2.txt,171357,173301,1944,10,N,N,-,-1,-1
REMKEL2.txt,171920,173375,1455,10,N,N,-,-1,-1
REMKEL2.txt,172006,173510,1504,10,N,N,-,-1,-1
REMKEL2.txt,172246,173839,1593,10,N,N,-,-1,-1
REMKEL2.txt,172363,173972,1609,10,N,N,-,-1,-1
REMKEL2.txt,172426,174141,1715,10,N,N,-,-1,-1
REMKEL2.txt,172561,174212,1651,10,N,N,-,-1,-1
REMKEL2.txt,172672,174400,1728,10,N,N,-,-1,-1
REMKEL2.txt,172779,174745,1966,10,N,N,-,-1,-1
REMKEL2.txt,172980,175097,2117,10,N,N,-,-1,-1
REMKEL2.txt,173302,175501,2199,10,N,N,-,-1,-1
REMKEL2.txt,173376,175780,2404,10,N,N,-,-1,-1
REMKEL2.txt,173513,175856,2343,10,N,N,-,-1,-1
REMKEL2.txt,173842,175934,2092,10,N,N,-,-1,-1
REMKEL2.txt,173973,175939,1966,10,N,N,-,-1,-1
REMKEL2.txt,174142,176082,1940,10,N,N,-,-1,-1
REMKEL2.txt,174213,176245,2032,10,N,N,-,-1,-1
REMKEL2.txt,174403,176277,1874,10,N,N,-,-1,-1
REMKEL2.txt,174746,176492,1746,10,N,N,-,-1,-1
REMKEL2.txt,175100,176621,1521,10,N,N,-,-1,-1
REMKEL2.txt,175504,176782,1278,10,N,N,-,-1,-1
REMKEL2.txt,175781,176955,1174,10,N,N,-,-1,-1
REMKEL2.txt,175857,177022,1165,10,N,N,-,-1,-1
REMKEL2.txt,175935,177159,1224,10,N,N,-,-1,-1
REMKEL2.txt,175940,177196,1256,10,N,N,-,-1,-1
REMKEL2.txt,176084,177612,1528,10,N,N,-,-1,-1
REMKEL2.txt,176246,177678,1432,10,N,N,-,-1,-1
REMKEL2.txt,176279,177741,1462,10,N,N,-,-1,-1
REMKEL2.txt,176495,177996,1501,10,N,N,-,-1,-1
REMKEL2.txt,176622,178161,1539,10,N,N,-,-1,-1
REMKEL2.txt,176785,178360,1575,10,N,N,-,-1,-1
REMKEL2.txt,176956,178571,1615,10,N,N,-,-1,-1
REMKEL2.txt,177023,178813,1790,10,N,N,-,-1,-1
REMKEL2.txt,177162,178999,1837,10,N,N,-,-1,-1
REMKEL2.txt,177197,179040,1843,10,N,N,-,-1,-1
REMKEL2.txt,177613,179073,1460,10,N,N,-,-1,-1
REMKEL2.txt,177679,179095,1416,10,N,N,-,-1,-1
REMKEL2.txt,177744,179322,1578,10,N,N,-,-1,-1
REMKEL2.txt,177999,179454,1455,10,N,N,-,-1,-1
REMKEL2.txt,178162,179523,1361,10,N,N,-,-1,-1
REMKEL2.txt,178361,179713,1352,10,N,N,-,-1,-1
REMKEL2.txt,178574,179744,1170,10,N,N,-,-1,-1
REMKEL2.txt,178814,179996,1182,10,N,N,-,-1,-1
REMKEL2.txt,179002,180181,1179,10,N,N,-,-1,-1
REMKEL2.txt,179040,180461,1421,10,N,N,-,-1,-1
REMKEL2.txt,179074,180522,1448,10,N,N,-,-1,-1
REMKEL2.txt,179096,180608,1512,10,N,N,-,-1,-1
REMKEL2.txt,179323,180793,1470,10,N,N,-,-1,-1
REMKEL2.txt,179455,180935,1480,10,N,N,-,-1,-1
REMKEL2.txt,179524,181024,1500,10,N,N,-,-1,-1
REMKEL2.txt,179716,181028,1312,10,N,N,-,-1,-1
REMKEL2.txt,179745,181076,1331,10,N,N,-,-1,-1
REMKEL2.txt,179999,181088,1089,10,N,N,-,-1,-1
REMKEL2.txt,180182,181314,1132,10,N,N,-,-1,-1
REMKEL2.txt,180464,181520,1056,10,N,N,-,-1,-1
REMKEL2.txt,180523,181618,1095,10,N,N,-,-1,-1
REMKEL2.txt,180609,181994,1385,10,N,N,-,-1,-1
REMKEL2.txt,180794,182282,1488,10,N,N,-,-1,-1
REMKEL2.txt,180936,182392,1456,10,N,N,-,-1,-1
REMKEL2.txt,181025,182509,1484,10,N,N,-,-1,-1
REMKEL2.txt,181029,182676,1647,10,N,N,-,-1,-1
REMKEL2.txt,181078,182793,1715,10,N,N,-,-1,-1
REMKEL2.txt,181089,182933,1844,10,N,N,-,-1,-1
REMKEL2.txt,181315,183097,1782,10,N,N,-,-1,-1
REMKEL2.txt,181521,183356,1835,10,N,N,-,-1,-1
REMKEL2.txt,181621,183556,1935,10,N,N,-,-1,-1
REMKEL2.txt,181995,183653,1658,10,N,N,-,-1,-1
REMKEL2.txt,182283,183765,1482,10,N,N,-,-1,-1
REMKEL2.txt,182395,183888,1493,10,N,N,-,-1,-1
REMKEL2.txt,182514,184037,1523,10,N,N,-,-1,-1
REMKEL2.txt,182677,184309,1632,10,N,Y,1437477878183,427206,428439
REMKEL2.txt,182794,184426,1632,10,N,Y,1437477878183,427206,428439
REMKEL2.txt,182936,184574,1638,10,N,Y,1437477878183,427206,428439
REMKEL2.txt,183098,184698,1600,10,N,Y,1437477878183,427206,428439
REMKEL2.txt,183359,184847,1488,10,N,Y,1437477878183,427206,428439
REMKEL2.txt,183558,185151,1593,10,N,Y,1437477878183,427206,428439
REMKEL2.txt,183654,185245,1591,10,Y,Y,1437477878183,427206,428439
REMKEL2.txt,183766,185354,1588,10,Y,Y,1437477878183,427206,428439
REMKEL2.txt,183889,185514,1625,10,N,Y,1437477878183,427206,428439
REMKEL2.txt,184040,185712,1672,10,Y,Y,1437477878183,427206,428439
REMKEL2.txt,184310,185778,1468,10,Y,Y,1437477878183,427206,428439
REMKEL2.txt,184429,185972,1543,10,Y,N,-,-1,-1
REMKEL2.txt,184576,186050,1474,10,Y,N,-,-1,-1
REMKEL2.txt,184699,186302,1603,10,N,N,-,-1,-1
REMKEL2.txt,184848,186471,1623,10,N,N,-,-1,-1
REMKEL2.txt,185152,186591,1439,10,N,N,-,-1,-1
REMKEL2.txt,185246,186764,1518,10,N,N,-,-1,-1
REMKEL2.txt,185357,186772,1415,10,N,N,-,-1,-1
REMKEL2.txt,185515,187196,1681,10,N,N,-,-1,-1
REMKEL2.txt,185713,187380,1667,10,N,N,-,-1,-1
REMKEL2.txt,185779,187596,1817,10,N,N,-,-1,-1
REMKEL2.txt,185975,187867,1892,10,N,N,-,-1,-1
REMKEL2.txt,186051,188032,1981,10,N,N,-,-1,-1
REMKEL2.txt,186303,188125,1822,10,N,N,-,-1,-1
REMKEL2.txt,186472,188186,1714,10,N,N,-,-1,-1
REMKEL2.txt,186592,188263,1671,10,N,N,-,-1,-1
REMKEL2.txt,186766,188364,1598,10,N,N,-,-1,-1
REMKEL2.txt,186773,188507,1734,10,N,N,-,-1,-1
REMKEL2.txt,187199,188512,1313,10,N,N,-,-1,-1
REMKEL2.txt,187383,188690,1307,10,N,N,-,-1,-1
REMKEL2.txt,187597,188860,1263,10,N,N,-,-1,-1
REMKEL2.txt,187870,188866,996,10,N,N,-,-1,-1
REMKEL2.txt,188033,189055,1022,10,N,N,-,-1,-1
REMKEL2.txt,188126,189073,947,10,N,N,-,-1,-1
REMKEL2.txt,188187,189232,1045,10,N,N,-,-1,-1
REMKEL2.txt,188264,189264,1000,10,N,N,-,-1,-1
REMKEL2.txt,188367,189275,908,10,N,N,-,-1,-1
REMKEL2.txt,188510,189452,942,10,N,N,-,-1,-1
REMKEL2.txt,188515,189627,1112,10,N,N,-,-1,-1
REMKEL2.txt,188692,189764,1072,10,N,N,-,-1,-1
REMKEL2.txt,188863,189931,1068,10,N,N,-,-1,-1
REMKEL2.txt,188869,190147,1278,10,N,N,-,-1,-1
REMKEL2.txt,189057,190422,1365,10,N,N,-,-1,-1
REMKEL2.txt,189074,190588,1514,10,N,N,-,-1,-1
REMKEL2.txt,189237,190769,1532,10,N,N,-,-1,-1
REMKEL2.txt,189266,190847,1581,10,N,N,-,-1,-1
REMKEL2.txt,189276,191294,2018,10,N,N,-,-1,-1
REMKEL2.txt,189454,191498,2044,10,N,N,-,-1,-1
REMKEL2.txt,189630,191564,1934,10,N,N,-,-1,-1
REMKEL2.txt,189767,191811,2044,10,N,N,-,-1,-1
REMKEL2.txt,189932,191836,1904,10,N,N,-,-1,-1
REMKEL2.txt,190148,191963,1815,10,N,N,-,-1,-1
REMKEL2.txt,190425,192086,1661,10,N,N,-,-1,-1
REMKEL2.txt,190589,192254,1665,10,N,N,-,-1,-1
REMKEL2.txt,190770,192512,1742,10,N,N,-,-1,-1
REMKEL2.txt,190850,192522,1672,10,N,N,-,-1,-1
REMKEL2.txt,191295,192548,1253,10,N,N,-,-1,-1
REMKEL2.txt,191501,192700,1199,10,Y,N,-,-1,-1
REMKEL2.txt,191565,192962,1397,10,Y,N,-,-1,-1
REMKEL2.txt,191812,193054,1242,10,N,N,-,-1,-1
REMKEL2.txt,191837,193234,1397,10,N,N,-,-1,-1
REMKEL2.txt,191968,193398,1430,10,N,N,-,-1,-1
REMKEL2.txt,192087,193753,1666,10,N,N,-,-1,-1
REMKEL2.txt,192255,193860,1605,10,N,N,-,-1,-1
REMKEL2.txt,192513,193932,1419,10,N,N,-,-1,-1
REMKEL2.txt,192523,194030,1507,10,N,N,-,-1,-1
REMKEL2.txt,192549,194227,1678,10,N,N,-,-1,-1
REMKEL2.txt,192703,194492,1789,10,N,N,-,-1,-1
REMKEL2.txt,192963,194653,1690,10,N,N,-,-1,-1
REMKEL2.txt,193055,194795,1740,10,N,N,-,-1,-1
REMKEL2.txt,193235,194804,1569,10,N,N,-,-1,-1
REMKEL2.txt,193399,194969,1570,10,N,N,-,-1,-1
REMKEL2.txt,193754,195042,1288,10,N,N,-,-1,-1
REMKEL2.txt,193863,195308,1445,10,N,N,-,-1,-1
REMKEL2.txt,193935,195334,1399,10,N,N,-,-1,-1
REMKEL2.txt,194033,195575,1542,10,N,N,-,-1,-1
REMKEL2.txt,194228,195603,1375,10,N,N,-,-1,-1
REMKEL2.txt,194493,195817,1324,10,N,N,-,-1,-1
REMKEL2.txt,194654,195875,1221,10,N,N,-,-1,-1
REMKEL2.txt,194800,196140,1340,10,N,N,-,-1,-1
REMKEL2.txt,194805,196174,1369,10,N,N,-,-1,-1
REMKEL2.txt,194970,196522,1552,10,N,N,-,-1,-1
REMKEL2.txt,195043,196743,1700,10,N,N,-,-1,-1
REMKEL2.txt,195311,196874,1563,10,N,N,-,-1,-1
REMKEL2.txt,195336,197176,1840,10,N,N,-,-1,-1
REMKEL2.txt,195576,197353,1777,10,N,N,-,-1,-1
REMKEL2.txt,195604,197515,1911,10,N,N,-,-1,-1
REMKEL2.txt,195820,197606,1786,10,N,N,-,-1,-1
REMKEL2.txt,195878,197817,1939,10,N,N,-,-1,-1
REMKEL2.txt,196141,198072,1931,10,N,N,-,-1,-1
REMKEL2.txt,196175,198350,2175,10,N,N,-,-1,-1
REMKEL2.txt,196525,198597,2072,10,N,N,-,-1,-1
REMKEL2.txt,196744,198703,1959,10,N,N,-,-1,-1
REMKEL2.txt,196875,198834,1959,10,N,N,-,-1,-1
REMKEL2.txt,197178,198937,1759,10,N,N,-,-1,-1
REMKEL2.txt,197354,198957,1603,10,N,N,-,-1,-1
REMKEL2.txt,197516,199032,1516,10,N,N,-,-1,-1
REMKEL2.txt,197607,199165,1558,10,N,N,-,-1,-1
REMKEL2.txt,197820,199501,1681,10,N,N,-,-1,-1
REMKEL2.txt,198075,199738,1663,10,N,N,-,-1,-1
REMKEL2.txt,198353,200103,1750,10,N,N,-,-1,-1
REMKEL2.txt,198598,200226,1628,10,N,N,-,-1,-1
REMKEL2.txt,198704,200519,1815,10,N,N,-,-1,-1
REMKEL2.txt,198835,200713,1878,10,N,N,-,-1,-1
REMKEL2.txt,198938,200891,1953,10,N,N,-,-1,-1
REMKEL2.txt,198958,201170,2212,10,N,N,-,-1,-1
REMKEL2.txt,199033,201433,2400,10,N,N,-,-1,-1
REMKEL2.txt,199168,201583,2415,10,N,N,-,-1,-1
REMKEL2.txt,199504,201675,2171,10,N,N,-,-1,-1
REMKEL2.txt,199739,201789,2050,10,N,N,-,-1,-1
REMKEL2.txt,200104,202184,2080,10,N,N,-,-1,-1
REMKEL2.txt,200229,202252,2023,10,N,N,-,-1,-1
REMKEL2.txt,200520,202489,1969,10,N,N,-,-1,-1
REMKEL2.txt,200714,202780,2066,10,N,N,-,-1,-1
REMKEL2.txt,200894,202789,1895,10,N,N,-,-1,-1
REMKEL2.txt,201173,203346,2173,10,N,N,-,-1,-1
REMKEL2.txt,201434,203472,2038,10,N,N,-,-1,-1
REMKEL2.txt,201584,203861,2277,10,N,N,-,-1,-1
REMKEL2.txt,201676,203918,2242,10,N,N,-,-1,-1
REMKEL2.txt,201790,204062,2272,10,N,N,-,-1,-1
REMKEL2.txt,202185,204129,1944,10,N,N,-,-1,-1
REMKEL2.txt,202255,204180,1925,10,N,N,-,-1,-1
REMKEL2.txt,202492,204244,1752,10,N,N,-,-1,-1
REMKEL2.txt,202783,204350,1567,10,N,N,-,-1,-1
REMKEL2.txt,202790,204562,1772,10,N,N,-,-1,-1
REMKEL2.txt,203347,204802,1455,10,N,N,-,-1,-1
REMKEL2.txt,203475,205041,1566,10,N,N,-,-1,-1
REMKEL2.txt,203864,205090,1226,10,N,N,-,-1,-1
REMKEL2.txt,203919,205152,1233,10,N,N,-,-1,-1
REMKEL2.txt,204064,205331,1267,10,N,N,-,-1,-1
REMKEL2.txt,204130,205560,1430,10,N,N,-,-1,-1
REMKEL2.txt,204181,205761,1580,10,N,Y,1448359440819,262798,263079
REMKEL2.txt,204247,205803,1556,10,N,Y,1448359440819,262798,263079
REMKEL2.txt,204351,205996,1645,10,N,Y,1448359440819,262798,263079
REMKEL2.txt,204563,206164,1601,10,N,Y,1448281491382,97818,98860
REMKEL2.txt,204802,206396,1594,10,N,Y,1448281491382,97818,98860
REMKEL2.txt,205042,206479,1437,10,N,Y,1448281491382,97818,98860
REMKEL2.txt,205091,206571,1480,10,N,Y,1448281491382,97818,98860
REMKEL2.txt,205155,206624,1469,10,N,Y,1448281491382,97818,98860
REMKEL2.txt,205332,206769,1437,10,N,Y,1448281491382,97818,98860
REMKEL2.txt,205565,206961,1396,10,N,Y,1448038803075,18895,19670
REMKEL2.txt,205762,207038,1276,10,N,Y,1448038803075,18895,19670
REMKEL2.txt,205804,207053,1249,10,N,Y,1448038803075,18895,19670
REMKEL2.txt,205997,207098,1101,10,N,Y,1448038803075,18895,19670
REMKEL2.txt,206165,207266,1101,10,N,Y,1448038803075,18895,19670
REMKEL2.txt,206397,207302,905,10,N,Y,1448038803075,18895,19670
REMKEL2.txt,206480,207504,1024,10,N,Y,1448038803075,18895,19670
REMKEL2.txt,206573,207815,1242,10,N,Y,1448038803075,18895,19670
REMKEL2.txt,206625,208064,1439,10,N,Y,1448038803075,18895,19670
REMKEL2.txt,206771,208185,1414,10,N,Y,1448038803075,18895,19670
REMKEL2.txt,206962,208431,1469,10,N,Y,1448038803075,18895,19670
REMKEL2.txt,207039,208975,1936,10,N,Y,1448038803075,18895,19670
REMKEL2.txt,207053,209338,2285,10,N,Y,1448038803075,18895,19670
REMKEL2.txt,207099,209499,2400,10,N,Y,1448038803075,18895,19670
REMKEL2.txt,207267,209927,2660,10,Y,N,-,-1,-1
REMKEL2.txt,207305,209945,2640,10,Y,N,-,-1,-1
REMKEL2.txt,207507,210053,2546,10,N,N,-,-1,-1
REMKEL2.txt,207818,210334,2516,10,N,N,-,-1,-1
REMKEL2.txt,208065,210497,2432,10,N,N,-,-1,-1
REMKEL2.txt,208186,210720,2534,10,N,N,-,-1,-1
REMKEL2.txt,208439,211038,2599,10,N,N,-,-1,-1
REMKEL2.txt,208976,211158,2182,10,N,N,-,-1,-1
REMKEL2.txt,209341,211310,1969,10,N,N,-,-1,-1
REMKEL2.txt,209501,211314,1813,10,N,N,-,-1,-1
REMKEL2.txt,209930,211573,1643,10,N,N,-,-1,-1
REMKEL2.txt,209946,211920,1974,10,N,N,-,-1,-1
REMKEL2.txt,210054,212035,1981,10,N,N,-,-1,-1
REMKEL2.txt,210337,212453,2116,10,N,N,-,-1,-1
REMKEL2.txt,210498,212792,2294,10,N,N,-,-1,-1
REMKEL2.txt,210721,212937,2216,10,N,N,-,-1,-1
REMKEL2.txt,211039,213348,2309,10,Y,N,-,-1,-1
REMKEL2.txt,211159,213792,2633,10,Y,N,-,-1,-1
REMKEL2.txt,211311,214093,2782,10,N,N,-,-1,-1
REMKEL2.txt,211315,214432,3117,10,N,N,-,-1,-1
REMKEL2.txt,211574,214571,2997,10,N,N,-,-1,-1
REMKEL2.txt,211921,214805,2884,10,N,N,-,-1,-1
REMKEL2.txt,212036,215157,3121,10,N,N,-,-1,-1
REMKEL2.txt,212456,215362,2906,10,N,N,-,-1,-1
REMKEL2.txt,212793,215435,2642,10,N,N,-,-1,-1
REMKEL2.txt,212938,215642,2704,10,N,N,-,-1,-1
REMKEL2.txt,213351,215807,2456,10,N,N,-,-1,-1
REMKEL2.txt,213793,215935,2142,10,N,N,-,-1,-1
REMKEL2.txt,214094,216329,2235,10,N,N,-,-1,-1
REMKEL2.txt,214435,216580,2145,10,N,N,-,-1,-1
REMKEL2.txt,214572,216774,2202,10,N,N,-,-1,-1
REMKEL2.txt,214808,216972,2164,10,N,N,-,-1,-1
REMKEL2.txt,215160,217204,2044,10,N,N,-,-1,-1
REMKEL2.txt,215364,217284,1920,10,N,N,-,-1,-1
REMKEL2.txt,215436,217455,2019,10,N,N,-,-1,-1
REMKEL2.txt,215643,217702,2059,10,N,N,-,-1,-1
REMKEL2.txt,215809,217788,1979,10,N,N,-,-1,-1
REMKEL2.txt,215938,217979,2041,10,N,N,-,-1,-1
REMKEL2.txt,216330,218344,2014,10,N,N,-,-1,-1
REMKEL2.txt,216583,218412,1829,10,N,N,-,-1,-1
REMKEL2.txt,216775,218635,1860,10,N,N,-,-1,-1
REMKEL2.txt,216973,218781,1808,10,N,N,-,-1,-1
REMKEL2.txt,217205,218815,1610,10,N,N,-,-1,-1
REMKEL2.txt,217287,218926,1639,10,N,N,-,-1,-1
REMKEL2.txt,217456,219174,1718,10,N,N,-,-1,-1
REMKEL2.txt,217705,219419,1714,10,N,N,-,-1,-1
REMKEL2.txt,217789,219527,1738,10,N,N,-,-1,-1
REMKEL2.txt,217980,219603,1623,10,N,N,-,-1,-1
REMKEL2.txt,218347,219745,1398,10,N,N,-,-1,-1
REMKEL2.txt,218413,220267,1854,10,N,N,-,-1,-1
REMKEL2.txt,218636,220395,1759,10,N,N,-,-1,-1
REMKEL2.txt,218782,220493,1711,10,N,N,-,-1,-1
REMKEL2.txt,218816,220697,1881,10,N,N,-,-1,-1
REMKEL2.txt,218927,220760,1833,10,N,N,-,-1,-1
REMKEL2.txt,219175,220832,1657,10,N,N,-,-1,-1
REMKEL2.txt,219420,220931,1511,10,N,N,-,-1,-1
REMKEL2.txt,219530,221205,1675,10,N,N,-,-1,-1
REMKEL2.txt,219604,221256,1652,10,N,N,-,-1,-1
REMKEL2.txt,219746,221457,1711,10,N,N,-,-1,-1
REMKEL2.txt,220268,221612,1344,10,N,N,-,-1,-1
REMKEL2.txt,220396,221965,1569,10,N,N,-,-1,-1
REMKEL2.txt,220496,222452,1956,10,Y,N,-,-1,-1
REMKEL2.txt,220698,222553,1855,10,Y,N,-,-1,-1
REMKEL2.txt,220761,222828,2067,10,Y,N,-,-1,-1
REMKEL2.txt,220834,222988,2154,10,Y,N,-,-1,-1
REMKEL2.txt,220933,223065,2132,10,Y,N,-,-1,-1
REMKEL2.txt,221206,223352,2146,10,Y,N,-,-1,-1
REMKEL2.txt,221257,223546,2289,10,Y,N,-,-1,-1
REMKEL2.txt,221458,223559,2101,10,Y,N,-,-1,-1
REMKEL2.txt,221615,223712,2097,10,Y,N,-,-1,-1
REMKEL2.txt,221967,223784,1817,10,Y,N,-,-1,-1
REMKEL2.txt,222453,223914,1461,10,N,N,-,-1,-1
REMKEL2.txt,222554,223939,1385,10,N,N,-,-1,-1
REMKEL2.txt,222831,224066,1235,10,N,N,-,-1,-1
REMKEL2.txt,222989,224113,1124,10,N,N,-,-1,-1
REMKEL2.txt,223066,224130,1064,10,N,N,-,-1,-1
REMKEL2.txt,223353,224146,793,10,N,N,-,-1,-1
REMKEL2.txt,223548,224405,857,10,N,N,-,-1,-1
REMKEL2.txt,223562,224480,918,10,N,N,-,-1,-1
REMKEL2.txt,223714,224689,975,10,N,N,-,-1,-1
REMKEL2.txt,223785,224926,1141,10,N,N,-,-1,-1
REMKEL2.txt,223915,225098,1183,10,N,N,-,-1,-1
REMKEL2.txt,223939,225234,1295,10,N,N,-,-1,-1
REMKEL2.txt,224069,225316,1247,10,N,N,-,-1,-1
REMKEL2.txt,224115,225494,1379,10,N,N,-,-1,-1
REMKEL2.txt,224131,225591,1460,10,N,N,-,-1,-1
REMKEL2.txt,224147,225670,1523,10,N,N,-,-1,-1
REMKEL2.txt,224406,225868,1462,10,Y,N,-,-1,-1
REMKEL2.txt,224481,225954,1473,10,Y,N,-,-1,-1
REMKEL2.txt,224690,226240,1550,10,Y,N,-,-1,-1
REMKEL2.txt,224929,226525,1596,10,Y,N,-,-1,-1
REMKEL2.txt,225099,226633,1534,10,Y,N,-,-1,-1
REMKEL2.txt,225235,226681,1446,10,Y,N,-,-1,-1
REMKEL2.txt,225317,226760,1443,10,Y,N,-,-1,-1
REMKEL2.txt,225495,226808,1313,10,Y,N,-,-1,-1
REMKEL2.txt,225592,226879,1287,10,Y,N,-,-1,-1
REMKEL2.txt,225671,227173,1502,10,Y,N,-,-1,-1
REMKEL2.txt,225869,227210,1341,10,Y,N,-,-1,-1
REMKEL2.txt,225955,227321,1366,10,Y,N,-,-1,-1
REMKEL2.txt,226243,227697,1454,10,N,N,-,-1,-1
REMKEL2.txt,226526,227737,1211,10,N,N,-,-1,-1
REMKEL2.txt,226634,227837,1203,10,N,N,-,-1,-1
REMKEL2.txt,226682,227974,1292,10,Y,N,-,-1,-1
REMKEL2.txt,226761,228221,1460,10,Y,N,-,-1,-1
REMKEL2.txt,226809,228307,1498,10,Y,N,-,-1,-1
REMKEL2.txt,226880,228400,1520,10,Y,N,-,-1,-1
REMKEL2.txt,227176,228509,1333,10,N,N,-,-1,-1
REMKEL2.txt,227211,228587,1376,10,N,N,-,-1,-1
REMKEL2.txt,227323,228777,1454,10,N,N,-,-1,-1
REMKEL2.txt,227698,228840,1142,10,N,N,-,-1,-1
REMKEL2.txt,227738,228946,1208,10,N,N,-,-1,-1
REMKEL2.txt,227838,229269,1431,10,Y,N,-,-1,-1
REMKEL2.txt,227976,229305,1329,10,Y,N,-,-1,-1
REMKEL2.txt,228222,229443,1221,10,Y,N,-,-1,-1
REMKEL2.txt,228308,229601,1293,10,N,N,-,-1,-1
REMKEL2.txt,228403,229700,1297,10,N,N,-,-1,-1
REMKEL2.txt,228512,229789,1277,10,N,N,-,-1,-1
REMKEL2.txt,228588,229917,1329,10,N,N,-,-1,-1
REMKEL2.txt,228778,230128,1350,10,N,N,-,-1,-1
REMKEL2.txt,228841,230232,1391,10,N,Y,1448038356234,18463,18881
REMKEL2.txt,228947,230394,1447,10,N,Y,1448038356234,18463,18881
REMKEL2.txt,229270,230520,1250,10,N,Y,1448038356234,18463,18881
REMKEL2.txt,229306,230868,1562,10,N,Y,1448038356234,18463,18881
REMKEL2.txt,229444,231054,1610,10,N,Y,1448038356234,18463,18881
REMKEL2.txt,229601,231118,1517,10,N,Y,1448038356234,18463,18881
REMKEL2.txt,229701,231320,1619,10,N,Y,1448038356234,18463,18881
REMKEL2.txt,229790,231418,1628,10,N,Y,1448038356234,18463,18881
REMKEL2.txt,229919,231491,1572,10,N,Y,1448038356234,18463,18881
REMKEL2.txt,230131,231661,1530,10,N,Y,1448038356234,18463,18881
REMKEL2.txt,230233,231850,1617,10,N,Y,1448038356234,18463,18881
REMKEL2.txt,230395,231903,1508,10,N,Y,1448038356234,18463,18881
REMKEL2.txt,230523,231967,1444,10,N,Y,1448322095209,213778,214023
REMKEL2.txt,230871,232136,1265,10,N,N,-,-1,-1
REMKEL2.txt,231055,232227,1172,10,N,N,-,-1,-1
REMKEL2.txt,231119,232590,1471,10,N,N,-,-1,-1
REMKEL2.txt,231321,232723,1402,10,N,N,-,-1,-1
REMKEL2.txt,231419,232945,1526,10,N,N,-,-1,-1
REMKEL2.txt,231492,233001,1509,10,N,N,-,-1,-1
REMKEL2.txt,231664,233258,1594,10,N,N,-,-1,-1
REMKEL2.txt,231851,233348,1497,10,N,Y,1448322713112,221941,223038
REMKEL2.txt,231904,233455,1551,10,N,Y,1448322713112,221941,223038
REMKEL2.txt,231968,233619,1651,10,N,Y,1448322713112,221941,223038
REMKEL2.txt,232137,233739,1602,10,N,Y,1448322713112,221941,223038
REMKEL2.txt,232228,233892,1664,10,N,Y,1448322713112,221941,223038
REMKEL2.txt,232591,233924,1333,10,N,Y,1448322713112,221941,223038
REMKEL2.txt,232726,234080,1354,10,N,Y,1448322713112,221941,223038
REMKEL2.txt,232946,234283,1337,10,N,Y,1448322713112,221941,223038
REMKEL2.txt,233002,234354,1352,10,N,Y,1448322713112,221941,223038
REMKEL2.txt,233261,234546,1285,10,N,Y,1448322713112,221941,223038
REMKEL2.txt,233349,234791,1442,10,N,Y,1448322713112,221941,223038
REMKEL2.txt,233457,234810,1353,10,N,Y,1448322713112,221941,223038
REMKEL2.txt,233620,234954,1334,10,N,Y,1448322713112,221941,223038
REMKEL2.txt,233742,235092,1350,10,N,Y,1448357159811,231190,232925
REMKEL2.txt,233893,235377,1484,10,N,Y,1448357159811,231190,232925
REMKEL2.txt,233927,235452,1525,10,N,N,-,-1,-1
REMKEL2.txt,234081,235713,1632,10,N,N,-,-1,-1
REMKEL2.txt,234284,236039,1755,10,N,N,-,-1,-1
REMKEL2.txt,234355,236122,1767,10,N,N,-,-1,-1
REMKEL2.txt,234549,236313,1764,10,N,N,-,-1,-1
REMKEL2.txt,234796,236563,1767,10,Y,N,-,-1,-1
REMKEL2.txt,234811,236780,1969,10,Y,N,-,-1,-1
REMKEL2.txt,234955,236920,1965,10,N,N,-,-1,-1
REMKEL2.txt,235097,237058,1961,10,N,N,-,-1,-1
REMKEL2.txt,235378,237223,1845,10,N,N,-,-1,-1
REMKEL2.txt,235454,237275,1821,10,N,N,-,-1,-1
REMKEL2.txt,235714,237530,1816,10,N,N,-,-1,-1
REMKEL2.txt,236042,237732,1690,10,N,N,-,-1,-1
REMKEL2.txt,236123,237795,1672,10,N,N,-,-1,-1
REMKEL2.txt,236314,237963,1649,10,N,N,-,-1,-1
REMKEL2.txt,236564,238076,1512,10,N,N,-,-1,-1
REMKEL2.txt,236783,238175,1392,10,N,N,-,-1,-1
REMKEL2.txt,236923,238255,1332,10,N,N,-,-1,-1
REMKEL2.txt,237059,238461,1402,10,N,N,-,-1,-1
REMKEL2.txt,237224,238600,1376,10,N,N,-,-1,-1
REMKEL2.txt,237276,239005,1729,10,N,N,-,-1,-1
REMKEL2.txt,237533,239023,1490,10,N,N,-,-1,-1
REMKEL2.txt,237734,239096,1362,10,N,N,-,-1,-1
REMKEL2.txt,237796,239234,1438,10,N,N,-,-1,-1
REMKEL2.txt,237964,239337,1373,10,N,N,-,-1,-1
REMKEL2.txt,238077,239393,1316,10,N,N,-,-1,-1
REMKEL2.txt,238176,239496,1320,10,N,N,-,-1,-1
REMKEL2.txt,238256,239571,1315,10,N,N,-,-1,-1
REMKEL2.txt,238464,239845,1381,10,Y,N,-,-1,-1
REMKEL2.txt,238601,239926,1325,10,N,N,-,-1,-1
REMKEL2.txt,239007,240183,1176,10,N,N,-,-1,-1
REMKEL2.txt,239024,240292,1268,10,N,N,-,-1,-1
REMKEL2.txt,239099,240340,1241,10,N,N,-,-1,-1
REMKEL2.txt,239236,240510,1274,10,N,N,-,-1,-1
REMKEL2.txt,239338,240674,1336,10,N,N,-,-1,-1
REMKEL2.txt,239394,240832,1438,10,N,N,-,-1,-1
REMKEL2.txt,239497,240920,1423,10,N,N,-,-1,-1
REMKEL2.txt,239572,241032,1460,10,N,N,-,-1,-1
REMKEL2.txt,239848,241134,1286,10,N,N,-,-1,-1
REMKEL2.txt,239927,241331,1404,10,N,Y,1448316079788,183824,184995
REMKEL2.txt,240185,241407,1222,10,N,Y,1448316079788,183824,184995
REMKEL2.txt,240294,241508,1214,10,N,Y,1448316079788,183824,184995
REMKEL2.txt,240343,241591,1248,10,N,Y,1448316079788,183824,184995
REMKEL2.txt,240511,241612,1101,10,N,Y,1448316079788,183824,184995
REMKEL2.txt,240675,241664,989,10,N,Y,1448316079788,183824,184995
REMKEL2.txt,240835,241814,979,10,N,Y,1448316079788,183824,184995
REMKEL2.txt,240921,241983,1062,10,N,Y,1448316079788,183824,184995
REMKEL2.txt,241033,242112,1079,10,Y,Y,1448316079788,183824,184995
REMKEL2.txt,241137,242271,1134,10,N,Y,1448316079788,183824,184995
REMKEL2.txt,241333,242571,1238,10,N,Y,1448316079788,183824,184995
REMKEL2.txt,241410,242593,1183,10,N,Y,1448316079788,183824,184995
REMKEL2.txt,241509,242720,1211,10,N,Y,1448316079788,183824,184995
REMKEL2.txt,241594,242734,1140,10,N,N,-,-1,-1
REMKEL2.txt,241613,242765,1152,10,N,N,-,-1,-1
REMKEL2.txt,241665,242783,1118,10,N,N,-,-1,-1
REMKEL2.txt,241817,242817,1000,10,N,N,-,-1,-1
REMKEL2.txt,241984,242906,922,10,N,N,-,-1,-1
REMKEL2.txt,242113,243167,1054,10,N,Y,1437490253936,460795,462238
REMKEL2.txt,242272,243502,1230,10,N,Y,1437490253936,460795,462238
REMKEL2.txt,242571,243640,1069,10,N,Y,1437490253936,460795,462238
REMKEL2.txt,242596,243702,1106,10,N,Y,1437490253936,460795,462238
REMKEL2.txt,242721,243809,1088,10,N,Y,1437490253936,460795,462238
REMKEL2.txt,242735,244148,1413,10,N,Y,1437490253936,460795,462238
REMKEL2.txt,242766,244152,1386,10,N,Y,1437490253936,460795,462238
REMKEL2.txt,242784,244374,1590,10,N,Y,1437490253936,460795,462238
REMKEL2.txt,242818,244538,1720,10,N,Y,1437490253936,460795,462238
REMKEL2.txt,242909,244756,1847,10,N,Y,1437490253936,460795,462238
REMKEL2.txt,243168,244904,1736,10,N,Y,1437490253936,460795,462238
REMKEL2.txt,243505,244924,1419,10,N,Y,1448039533036,21326,21680
REMKEL2.txt,243643,244972,1329,10,N,Y,1448039533036,21326,21680
REMKEL2.txt,243703,245152,1449,10,N,Y,1448039533036,21326,21680
REMKEL2.txt,243810,245261,1451,10,N,Y,1448039533036,21326,21680
REMKEL2.txt,244149,245360,1211,10,N,Y,1448039533036,21326,21680
REMKEL2.txt,244153,245580,1427,10,N,Y,1448039533036,21326,21680
REMKEL2.txt,244377,245743,1366,10,N,N,-,-1,-1
REMKEL2.txt,244539,245785,1246,10,N,N,-,-1,-1
REMKEL2.txt,244757,245889,1132,10,N,N,-,-1,-1
REMKEL2.txt,244905,246176,1271,10,N,N,-,-1,-1
REMKEL2.txt,244925,246246,1321,10,N,N,-,-1,-1
REMKEL2.txt,244973,246377,1404,10,N,N,-,-1,-1
REMKEL2.txt,245153,246589,1436,10,N,N,-,-1,-1
REMKEL2.txt,245264,246704,1440,10,N,N,-,-1,-1
REMKEL2.txt,245362,246833,1471,10,N,N,-,-1,-1
REMKEL2.txt,245581,246996,1415,10,N,N,-,-1,-1
REMKEL2.txt,245745,247157,1412,10,N,N,-,-1,-1
REMKEL2.txt,245786,247291,1505,10,N,N,-,-1,-1
REMKEL2.txt,245890,247604,1714,10,N,N,-,-1,-1
REMKEL2.txt,246177,247751,1574,10,N,N,-,-1,-1
REMKEL2.txt,246247,248021,1774,10,N,N,-,-1,-1
REMKEL2.txt,246380,248227,1847,10,N,N,-,-1,-1
REMKEL2.txt,246590,248309,1719,10,N,N,-,-1,-1
REMKEL2.txt,246707,248370,1663,10,N,N,-,-1,-1
REMKEL2.txt,246834,248595,1761,10,N,N,-,-1,-1
REMKEL2.txt,246997,248708,1711,10,N,N,-,-1,-1
REMKEL2.txt,247158,249030,1872,10,N,N,-,-1,-1
REMKEL2.txt,247292,249208,1916,10,N,N,-,-1,-1
REMKEL2.txt,247605,249339,1734,10,N,N,-,-1,-1
REMKEL2.txt,247754,249370,1616,10,N,N,-,-1,-1
REMKEL2.txt,248022,249579,1557,10,N,N,-,-1,-1
REMKEL2.txt,248228,249652,1424,10,N,N,-,-1,-1
REMKEL2.txt,248310,249851,1541,10,N,N,-,-1,-1
REMKEL2.txt,248371,250047,1676,10,N,N,-,-1,-1
REMKEL2.txt,248596,250105,1509,10,N,N,-,-1,-1
REMKEL2.txt,248711,250259,1548,10,N,N,-,-1,-1
REMKEL2.txt,249031,250355,1324,10,N,N,-,-1,-1
REMKEL2.txt,249209,250576,1367,10,N,N,-,-1,-1
REMKEL2.txt,249340,250635,1295,10,N,N,-,-1,-1
REMKEL2.txt,249371,250650,1279,10,N,N,-,-1,-1
REMKEL2.txt,249580,250685,1105,10,N,N,-,-1,-1
REMKEL2.txt,249653,250923,1270,10,N,N,-,-1,-1
REMKEL2.txt,249854,250966,1112,10,N,N,-,-1,-1
REMKEL2.txt,250047,251102,1055,10,N,N,-,-1,-1
REMKEL2.txt,250106,251172,1066,10,N,N,-,-1,-1
REMKEL2.txt,250260,251273,1013,10,N,N,-,-1,-1
REMKEL2.txt,250357,251339,982,10,N,N,-,-1,-1
REMKEL2.txt,250577,251532,955,10,N,N,-,-1,-1
REMKEL2.txt,250636,251883,1247,10,N,N,-,-1,-1
REMKEL2.txt,250651,251978,1327,10,N,N,-,-1,-1
REMKEL2.txt,250686,252114,1428,10,N,N,-,-1,-1
REMKEL2.txt,250925,252326,1401,10,N,N,-,-1,-1
REMKEL2.txt,250967,252408,1441,10,N,N,-,-1,-1
REMKEL2.txt,251105,252564,1459,10,N,N,-,-1,-1
REMKEL2.txt,251173,252771,1598,10,N,N,-,-1,-1
REMKEL2.txt,251274,252959,1685,10,N,N,-,-1,-1
REMKEL2.txt,251340,253208,1868,10,N,N,-,-1,-1
REMKEL2.txt,251535,253284,1749,10,N,N,-,-1,-1
REMKEL2.txt,251884,253373,1489,10,N,N,-,-1,-1
REMKEL2.txt,251981,253535,1554,10,N,Y,1448316411409,206556,208475
REMKEL2.txt,252115,253785,1670,10,N,Y,1448316411409,206556,208475
REMKEL2.txt,252327,254042,1715,10,Y,Y,1448316411409,206556,208475
REMKEL2.txt,252411,254101,1690,10,Y,Y,1448316411409,206556,208475
REMKEL2.txt,252567,254196,1629,10,N,Y,1448316411409,206556,208475
REMKEL2.txt,252772,254350,1578,10,N,Y,1448316411409,206556,208475
REMKEL2.txt,252960,254476,1516,10,N,Y,1448316411409,206556,208475
REMKEL2.txt,253210,254532,1322,10,N,Y,1448316411409,206556,208475
REMKEL2.txt,253285,254638,1353,10,Y,Y,1448316411409,206556,208475
REMKEL2.txt,253376,254718,1342,10,Y,Y,1448316411409,206556,208475
REMKEL2.txt,253536,254779,1243,10,N,Y,1448316411409,206556,208475
REMKEL2.txt,253786,255137,1351,10,N,Y,1448316411409,206556,208475
REMKEL2.txt,254043,255320,1277,10,N,Y,1448316411409,206556,208475
REMKEL2.txt,254104,255484,1380,10,N,N,-,-1,-1
REMKEL2.txt,254198,255574,1376,10,Y,N,-,-1,-1
REMKEL2.txt,254352,255606,1254,10,Y,N,-,-1,-1
REMKEL2.txt,254477,255732,1255,10,Y,N,-,-1,-1
REMKEL2.txt,254533,256246,1713,10,Y,N,-,-1,-1
REMKEL2.txt,254639,256559,1920,10,Y,N,-,-1,-1
REMKEL2.txt,254719,256713,1994,10,Y,N,-,-1,-1
REMKEL2.txt,254780,256784,2004,10,Y,N,-,-1,-1
REMKEL2.txt,255138,256836,1698,10,N,N,-,-1,-1
REMKEL2.txt,255321,256963,1642,10,N,N,-,-1,-1
REMKEL2.txt,255487,257041,1554,10,N,N,-,-1,-1
REMKEL2.txt,255575,257479,1904,10,N,N,-,-1,-1
REMKEL2.txt,255607,257678,2071,10,N,N,-,-1,-1
REMKEL2.txt,255733,257855,2122,10,Y,N,-,-1,-1
REMKEL2.txt,256247,257956,1709,10,N,N,-,-1,-1
REMKEL2.txt,256560,258091,1531,10,N,N,-,-1,-1
REMKEL2.txt,256715,258208,1493,10,N,N,-,-1,-1
REMKEL2.txt,256787,258528,1741,10,N,N,-,-1,-1
REMKEL2.txt,256838,258766,1928,10,N,N,-,-1,-1
REMKEL2.txt,256964,258912,1948,10,N,N,-,-1,-1
REMKEL2.txt,257044,259055,2011,10,N,N,-,-1,-1
REMKEL2.txt,257480,259314,1834,10,N,N,-,-1,-1
REMKEL2.txt,257679,259386,1707,10,N,N,-,-1,-1
REMKEL2.txt,257856,259575,1719,10,N,N,-,-1,-1
REMKEL2.txt,257957,259697,1740,10,N,N,-,-1,-1
REMKEL2.txt,258093,259754,1661,10,N,N,-,-1,-1
REMKEL2.txt,258211,259863,1652,10,N,N,-,-1,-1
REMKEL2.txt,258531,260057,1526,10,N,N,-,-1,-1
REMKEL2.txt,258767,260263,1496,10,N,N,-,-1,-1
REMKEL2.txt,258913,260417,1504,10,N,N,-,-1,-1
REMKEL2.txt,259056,260539,1483,10,N,N,-,-1,-1
REMKEL2.txt,259317,260649,1332,10,N,N,-,-1,-1
REMKEL2.txt,259387,261175,1788,10,N,N,-,-1,-1
REMKEL2.txt,259578,261589,2011,10,Y,N,-,-1,-1
REMKEL2.txt,259698,261753,2055,10,Y,N,-,-1,-1
REMKEL2.txt,259755,261836,2081,10,Y,N,-,-1,-1
REMKEL2.txt,259864,262079,2215,10,Y,N,-,-1,-1
REMKEL2.txt,260058,262098,2040,10,Y,N,-,-1,-1
REMKEL2.txt,260264,262215,1951,10,Y,N,-,-1,-1
REMKEL2.txt,260420,262396,1976,10,Y,N,-,-1,-1
REMKEL2.txt,260541,262470,1929,10,Y,N,-,-1,-1
REMKEL2.txt,260650,262606,1956,10,Y,N,-,-1,-1
REMKEL2.txt,261176,263031,1855,10,Y,N,-,-1,-1
REMKEL2.txt,261590,263170,1580,10,N,Y,1448323072174,227638,227786
REMKEL2.txt,261754,263219,1465,10,N,Y,1448323072174,227638,227786
REMKEL2.txt,261839,263267,1428,10,N,Y,1448323072174,227638,227786
REMKEL2.txt,262084,263567,1483,10,N,Y,1437472380836,351899,352666
REMKEL2.txt,262099,263808,1709,10,N,Y,1437472380836,351899,352666
REMKEL2.txt,262216,264033,1817,10,Y,Y,1437472380836,351899,352666
REMKEL2.txt,262397,264144,1747,10,N,Y,1437472380836,351899,352666
REMKEL2.txt,262471,264309,1838,10,N,Y,1437472380836,351899,352666
REMKEL2.txt,262607,264629,2022,10,N,Y,1437472380836,351899,352666
REMKEL2.txt,263034,264780,1746,10,N,Y,1437472380836,351899,352666
REMKEL2.txt,263171,264898,1727,10,N,Y,1437472380836,351899,352666
REMKEL2.txt,263220,264945,1725,10,N,Y,1437472380836,351899,352666
REMKEL2.txt,263270,265013,1743,10,N,Y,1437472380836,351899,352666
REMKEL2.txt,263568,265069,1501,10,N,Y,1437472380836,351899,352666
REMKEL2.txt,263811,265301,1490,10,N,Y,1448311366799,143137,146264
REMKEL2.txt,264034,265401,1367,10,N,Y,1448311366799,143137,146264
REMKEL2.txt,264145,265505,1360,10,N,Y,1448311366799,143137,146264
REMKEL2.txt,264310,265570,1260,10,N,Y,1448311366799,143137,146264
REMKEL2.txt,264630,265679,1049,10,N,Y,1448311366799,143137,146264
REMKEL2.txt,264783,265839,1056,10,N,Y,1448311366799,143137,146264
REMKEL2.txt,264899,265954,1055,10,N,Y,1448311366799,143137,146264
REMKEL2.txt,264946,266081,1135,10,N,Y,1448311366799,143137,146264
REMKEL2.txt,265014,266247,1233,10,N,Y,1448311366799,143137,146264
REMKEL2.txt,265070,266345,1275,10,N,Y,1448311366799,143137,146264
REMKEL2.txt,265304,266416,1112,10,N,Y,1448314861876,180438,180657
REMKEL2.txt,265403,266709,1306,10,N,Y,1448314861876,180438,180657
REMKEL2.txt,265507,266984,1477,10,N,Y,1448314861876,180438,180657
REMKEL2.txt,265571,267099,1528,10,N,Y,1448314861876,180438,180657
REMKEL2.txt,265680,267293,1613,10,N,Y,1448314861876,180438,180657
REMKEL2.txt,265840,267340,1500,10,N,Y,1448314861876,180438,180657
REMKEL2.txt,265957,267372,1415,10,N,Y,1448394918930,293978,294297
REMKEL2.txt,266082,267514,1432,10,N,Y,1448394918930,293978,294297
REMKEL2.txt,266249,267645,1396,10,N,Y,1448394918930,293978,294297
REMKEL2.txt,266346,267710,1364,10,N,Y,1448394918930,293978,294297
REMKEL2.txt,266417,268027,1610,10,N,N,-,-1,-1
REMKEL2.txt,266710,268132,1422,10,N,N,-,-1,-1
REMKEL2.txt,266985,268273,1288,10,N,N,-,-1,-1
REMKEL2.txt,267100,268400,1300,10,N,N,-,-1,-1
REMKEL2.txt,267294,268559,1265,10,N,Y,1448313674408,176614,178600
REMKEL2.txt,267341,268655,1314,10,N,Y,1448313674408,176614,178600
REMKEL2.txt,267374,269211,1837,10,N,Y,1448313674408,176614,178600
REMKEL2.txt,267515,269431,1916,10,N,Y,1448313674408,176614,178600
REMKEL2.txt,267648,269551,1903,10,N,Y,1448313674408,176614,178600
REMKEL2.txt,267711,269627,1916,10,N,Y,1448313674408,176614,178600
REMKEL2.txt,268030,269703,1673,10,N,Y,1448286451685,111065,112127
REMKEL2.txt,268133,269988,1855,10,N,Y,1448286451685,111065,112127
REMKEL2.txt,268275,270076,1801,10,N,Y,1448286451685,111065,112127
REMKEL2.txt,268403,270196,1793,10,Y,Y,1448286451685,111065,112127
REMKEL2.txt,268560,270244,1684,10,Y,Y,1448286451685,111065,112127
REMKEL2.txt,268656,270386,1730,10,Y,Y,1448286451685,111065,112127
REMKEL2.txt,269214,270408,1194,10,N,Y,1448286451685,111065,112127
REMKEL2.txt,269432,270503,1071,10,N,Y,1448286451685,111065,112127
REMKEL2.txt,269552,270637,1085,10,N,Y,1448286451685,111065,112127
REMKEL2.txt,269630,270785,1155,10,N,Y,1448286451685,111065,112127
REMKEL2.txt,269704,271008,1304,10,N,Y,1448286451685,111065,112127
REMKEL2.txt,269991,271246,1255,10,N,Y,1448321627053,211159,212725
REMKEL2.txt,270077,271653,1576,10,N,Y,1448321627053,211159,212725
REMKEL2.txt,270197,271693,1496,10,N,Y,1448321627053,211159,212725
REMKEL2.txt,270245,271771,1526,10,N,Y,1448321627053,211159,212725
REMKEL2.txt,270387,271890,1503,10,N,Y,1448321627053,211159,212725
REMKEL2.txt,270409,272030,1621,10,N,Y,1448321627053,211159,212725
REMKEL2.txt,270506,272099,1593,10,N,N,-,-1,-1
REMKEL2.txt,270638,272105,1467,10,N,N,-,-1,-1
REMKEL2.txt,270786,272154,1368,10,N,N,-,-1,-1
REMKEL2.txt,271009,272274,1265,10,N,N,-,-1,-1
REMKEL2.txt,271247,272358,1111,10,N,N,-,-1,-1
REMKEL2.txt,271654,272469,815,10,N,N,-,-1,-1
REMKEL2.txt,271694,272543,849,10,N,N,-,-1,-1
REMKEL2.txt,271776,272660,884,10,N,N,-,-1,-1
REMKEL2.txt,271891,272856,965,10,N,N,-,-1,-1
REMKEL2.txt,272033,272975,942,10,N,N,-,-1,-1
REMKEL2.txt,272100,273069,969,10,N,N,-,-1,-1
REMKEL2.txt,272106,273177,1071,10,N,N,-,-1,-1
REMKEL2.txt,272155,273672,1517,10,N,N,-,-1,-1
REMKEL2.txt,272275,273709,1434,10,N,N,-,-1,-1
REMKEL2.txt,272361,273958,1597,10,N,N,-,-1,-1
REMKEL2.txt,272470,273991,1521,10,N,N,-,-1,-1
REMKEL2.txt,272544,274169,1625,10,N,N,-,-1,-1
REMKEL2.txt,272661,274295,1634,10,N,N,-,-1,-1
REMKEL2.txt,272858,274492,1634,10,N,N,-,-1,-1
REMKEL2.txt,272976,274600,1624,10,N,N,-,-1,-1
REMKEL2.txt,273072,274968,1896,10,N,N,-,-1,-1
REMKEL2.txt,273178,275091,1913,10,N,N,-,-1,-1
REMKEL2.txt,273673,275098,1425,10,N,N,-,-1,-1
REMKEL2.txt,273710,275218,1508,10,N,N,-,-1,-1
REMKEL2.txt,273960,275323,1363,10,N,N,-,-1,-1
REMKEL2.txt,273994,275625,1631,10,N,N,-,-1,-1
REMKEL2.txt,274170,275703,1533,10,N,N,-,-1,-1
REMKEL2.txt,274296,275799,1503,10,N,N,-,-1,-1
REMKEL2.txt,274493,275942,1449,10,N,N,-,-1,-1
REMKEL2.txt,274603,276194,1591,10,N,N,-,-1,-1
REMKEL2.txt,274969,276249,1280,10,N,N,-,-1,-1
REMKEL2.txt,275092,276294,1202,10,N,N,-,-1,-1
REMKEL2.txt,275099,276443,1344,10,Y,N,-,-1,-1
REMKEL2.txt,275221,276559,1338,10,Y,N,-,-1,-1
REMKEL2.txt,275326,276801,1475,10,Y,N,-,-1,-1
REMKEL2.txt,275626,277119,1493,10,Y,N,-,-1,-1
REMKEL2.txt,275704,277126,1422,10,Y,N,-,-1,-1
REMKEL2.txt,275800,277130,1330,10,Y,N,-,-1,-1
REMKEL2.txt,275945,277323,1378,10,Y,N,-,-1,-1
REMKEL2.txt,276195,277519,1324,10,N,N,-,-1,-1
REMKEL2.txt,276251,277881,1630,10,N,N,-,-1,-1
REMKEL2.txt,276295,277882,1587,10,N,N,-,-1,-1
REMKEL2.txt,276444,277976,1532,10,Y,N,-,-1,-1
REMKEL2.txt,276560,278116,1556,10,Y,N,-,-1,-1
REMKEL2.txt,276801,278346,1545,10,Y,N,-,-1,-1
REMKEL2.txt,277122,278542,1420,10,Y,N,-,-1,-1
REMKEL2.txt,277127,278557,1430,10,Y,N,-,-1,-1
REMKEL2.txt,277131,279005,1874,10,Y,N,-,-1,-1
REMKEL2.txt,277324,279120,1796,10,Y,N,-,-1,-1
REMKEL2.txt,277522,279249,1727,10,Y,N,-,-1,-1
REMKEL2.txt,277881,279864,1983,10,Y,N,-,-1,-1
REMKEL2.txt,277883,280073,2190,10,Y,N,-,-1,-1
REMKEL2.txt,277978,280148,2170,10,Y,N,-,-1,-1
REMKEL2.txt,278119,280299,2180,10,Y,N,-,-1,-1
REMKEL2.txt,278347,280472,2125,10,Y,N,-,-1,-1
REMKEL2.txt,278543,280592,2049,10,Y,N,-,-1,-1
REMKEL2.txt,278558,280699,2141,10,Y,N,-,-1,-1
REMKEL2.txt,279007,280940,1933,10,N,N,-,-1,-1
REMKEL2.txt,279123,281081,1958,10,N,N,-,-1,-1
REMKEL2.txt,279250,281087,1837,10,N,N,-,-1,-1
REMKEL2.txt,279865,281378,1513,10,N,N,-,-1,-1
REMKEL2.txt,280076,281485,1409,10,N,N,-,-1,-1
REMKEL2.txt,280149,281620,1471,10,N,N,-,-1,-1
REMKEL2.txt,280300,282237,1937,10,N,N,-,-1,-1
REMKEL2.txt,280473,282478,2005,10,N,N,-,-1,-1
REMKEL2.txt,280593,282524,1931,10,N,N,-,-1,-1
REMKEL2.txt,280702,282836,2134,10,N,N,-,-1,-1
REMKEL2.txt,280941,282952,2011,10,N,N,-,-1,-1
REMKEL2.txt,281082,283040,1958,10,N,N,-,-1,-1
REMKEL2.txt,281087,283224,2137,10,N,N,-,-1,-1
REMKEL2.txt,281379,283315,1936,10,N,N,-,-1,-1
REMKEL2.txt,281486,283496,2010,10,N,N,-,-1,-1
REMKEL2.txt,281623,283575,1952,10,N,N,-,-1,-1
REMKEL2.txt,282238,283614,1376,10,N,N,-,-1,-1
REMKEL2.txt,282481,283913,1432,10,N,N,-,-1,-1
REMKEL2.txt,282526,283988,1462,10,N,N,-,-1,-1
REMKEL2.txt,282837,284137,1300,10,N,N,-,-1,-1
REMKEL2.txt,282955,284208,1253,10,N,N,-,-1,-1
REMKEL2.txt,283041,284245,1204,10,N,N,-,-1,-1
REMKEL2.txt,283225,284252,1027,10,N,N,-,-1,-1
REMKEL2.txt,283317,284377,1060,10,N,N,-,-1,-1
REMKEL2.txt,283497,284464,967,10,N,N,-,-1,-1
REMKEL2.txt,283576,284611,1035,10,N,N,-,-1,-1
REMKEL2.txt,283616,284815,1199,10,N,N,-,-1,-1
REMKEL2.txt,283914,285080,1166,10,N,N,-,-1,-1
REMKEL2.txt,283991,285289,1298,10,N,N,-,-1,-1
REMKEL2.txt,284139,285651,1512,10,N,N,-,-1,-1
REMKEL2.txt,284209,285774,1565,10,N,N,-,-1,-1
REMKEL2.txt,284246,285965,1719,10,N,N,-,-1,-1
REMKEL2.txt,284253,285984,1731,10,N,N,-,-1,-1
REMKEL2.txt,284378,286001,1623,10,N,N,-,-1,-1
REMKEL2.txt,284466,286142,1676,10,N,N,-,-1,-1
REMKEL2.txt,284614,286166,1552,10,N,N,-,-1,-1
REMKEL2.txt,284818,286369,1551,10,N,N,-,-1,-1
REMKEL2.txt,285081,286587,1506,10,N,N,-,-1,-1
REMKEL2.txt,285292,286807,1515,10,N,N,-,-1,-1
REMKEL2.txt,285654,286875,1221,10,N,Y,1448278147591,54631,55869
REMKEL2.txt,285775,286956,1181,10,N,Y,1448278147591,54631,55869
REMKEL2.txt,285966,287026,1060,10,N,Y,1448278147591,54631,55869
REMKEL2.txt,285985,287145,1160,10,N,Y,1448278147591,54631,55869
REMKEL2.txt,286002,287281,1279,10,N,Y,1448278147591,54631,55869
REMKEL2.txt,286143,287530,1387,10,N,Y,1448278147591,54631,55869
REMKEL2.txt,286167,287657,1490,10,N,Y,1448278147591,54631,55869
REMKEL2.txt,286372,287828,1456,10,N,Y,1448278147591,54631,55869
REMKEL2.txt,286588,288090,1502,10,N,Y,1448278147591,54631,55869
REMKEL2.txt,286810,288404,1594,10,N,Y,1448278147591,54631,55869
REMKEL2.txt,286876,288612,1736,10,N,Y,1448278147591,54631,55869
REMKEL2.txt,286957,288732,1775,10,N,Y,1448278147591,54631,55869
REMKEL2.txt,287027,288857,1830,10,N,Y,1448278147591,54631,55869
REMKEL2.txt,287146,289154,2008,10,N,Y,1448278147591,54631,55869
REMKEL2.txt,287283,289352,2069,10,Y,Y,1448278147591,54631,55869
REMKEL2.txt,287533,289457,1924,10,Y,Y,1448366492754,275659,275884
REMKEL2.txt,287658,289677,2019,10,N,Y,1448366492754,275659,275884
REMKEL2.txt,287829,289754,1925,10,N,Y,1448366492754,275659,275884
REMKEL2.txt,288091,289911,1820,10,N,Y,1448366492754,275659,275884
REMKEL2.txt,288407,290016,1609,10,N,N,-,-1,-1
REMKEL2.txt,288613,290080,1467,10,N,N,-,-1,-1
REMKEL2.txt,288735,290293,1558,10,N,N,-,-1,-1
REMKEL2.txt,288858,290554,1696,10,N,N,-,-1,-1
REMKEL2.txt,289155,291031,1876,10,N,N,-,-1,-1
REMKEL2.txt,289353,291277,1924,10,N,N,-,-1,-1
REMKEL2.txt,289460,291621,2161,10,N,N,-,-1,-1
REMKEL2.txt,289678,291726,2048,10,N,N,-,-1,-1
REMKEL2.txt,289755,291980,2225,10,N,N,-,-1,-1
REMKEL2.txt,289912,292105,2193,10,N,N,-,-1,-1
REMKEL2.txt,290017,292251,2234,10,N,N,-,-1,-1
REMKEL2.txt,290081,292386,2305,10,N,N,-,-1,-1
REMKEL2.txt,290294,292506,2212,10,N,Y,1448311594480,155711,156312
REMKEL2.txt,290555,292592,2037,10,N,Y,1448311594480,155711,156312
REMKEL2.txt,291034,292654,1620,10,N,Y,1448311594480,155711,156312
REMKEL2.txt,291278,292705,1427,10,N,Y,1448311594480,155711,156312
REMKEL2.txt,291622,292973,1351,10,N,Y,1448311594480,155711,156312
REMKEL2.txt,291727,293101,1374,10,N,Y,1448311594480,155711,156312
REMKEL2.txt,291983,293137,1154,10,N,Y,1448311594480,155711,156312
REMKEL2.txt,292106,293294,1188,10,N,Y,1448311594480,155711,156312
REMKEL2.txt,292252,293629,1377,10,N,Y,1448311594480,155711,156312
REMKEL2.txt,292389,293688,1299,10,N,Y,1448311594480,155711,156312
REMKEL2.txt,292507,293760,1253,10,N,Y,1448311594480,155711,156312
REMKEL2.txt,292593,293879,1286,10,N,Y,1448311594480,155711,156312
REMKEL2.txt,292655,294044,1389,10,N,Y,1448311594480,155711,156312
REMKEL2.txt,292706,294080,1374,10,N,Y,1448311594480,155711,156312
REMKEL2.txt,292976,294194,1218,10,N,Y,1448311594480,155711,156312
REMKEL2.txt,293102,294354,1252,10,N,Y,1448311594480,155711,156312
REMKEL2.txt,293138,294523,1385,10,N,Y,1448311594480,155711,156312
REMKEL2.txt,293295,294600,1305,10,N,Y,1448311594480,155711,156312
REMKEL2.txt,293631,294669,1038,10,N,Y,1448311594480,155711,156312
REMKEL2.txt,293689,294738,1049,10,N,Y,1448311594480,155711,156312
REMKEL2.txt,293761,294764,1003,10,N,Y,1448311594480,155711,156312
REMKEL2.txt,293882,294904,1022,10,N,Y,1448314192885,179720,179950
REMKEL2.txt,294045,295160,1115,10,Y,Y,1448314192885,179720,179950
REMKEL2.txt,294081,295256,1175,10,N,Y,1448314192885,179720,179950
REMKEL2.txt,294196,295275,1079,10,N,Y,1448314192885,179720,179950
REMKEL2.txt,294355,295571,1216,10,N,Y,1448314192885,179720,179950
REMKEL2.txt,294524,295825,1301,10,Y,Y,1448314192885,179720,179950
REMKEL2.txt,294603,296019,1416,10,Y,Y,1437475017618,98942,100041
REMKEL2.txt,294670,296178,1508,10,Y,Y,1437475017618,98942,100041
REMKEL2.txt,294740,296346,1606,10,Y,Y,1437475017618,98942,100041
REMKEL2.txt,294765,296495,1730,10,Y,Y,1437475017618,98942,100041
REMKEL2.txt,294905,296510,1605,10,N,Y,1437475017618,98942,100041
REMKEL2.txt,295161,296612,1451,10,N,Y,1437475017618,98942,100041
REMKEL2.txt,295261,296745,1484,10,N,Y,1437475017618,98942,100041
REMKEL2.txt,295276,296839,1563,10,N,Y,1437475017618,98942,100041
REMKEL2.txt,295572,296988,1416,10,N,Y,1437475017618,98942,100041
REMKEL2.txt,295828,297125,1297,10,N,Y,1437475017618,98942,100041
REMKEL2.txt,296020,297180,1160,10,N,Y,1437475017618,98942,100041
REMKEL2.txt,296179,297475,1296,10,N,Y,1437475017618,98942,100041
REMKEL2.txt,296347,297622,1275,10,N,N,-,-1,-1
REMKEL2.txt,296496,297962,1466,10,N,N,-,-1,-1
REMKEL2.txt,296510,297978,1468,10,N,N,-,-1,-1
REMKEL2.txt,296613,298014,1401,10,N,N,-,-1,-1
REMKEL2.txt,296746,298087,1341,10,N,N,-,-1,-1
REMKEL2.txt,296840,298130,1290,10,N,N,-,-1,-1
REMKEL2.txt,296991,298573,1582,10,Y,N,-,-1,-1
REMKEL2.txt,297126,298812,1686,10,Y,N,-,-1,-1
REMKEL2.txt,297181,298952,1771,10,Y,N,-,-1,-1
REMKEL2.txt,297476,299159,1683,10,Y,N,-,-1,-1
REMKEL2.txt,297623,299294,1671,10,Y,N,-,-1,-1
REMKEL2.txt,297963,299557,1594,10,N,N,-,-1,-1
REMKEL2.txt,297979,299568,1589,10,N,N,-,-1,-1
REMKEL2.txt,298015,299596,1581,10,N,N,-,-1,-1
REMKEL2.txt,298088,299674,1586,10,N,N,-,-1,-1
REMKEL2.txt,298131,299882,1751,10,N,N,-,-1,-1
REMKEL2.txt,298574,300078,1504,10,N,N,-,-1,-1
REMKEL2.txt,298813,300234,1421,10,N,N,-,-1,-1
REMKEL2.txt,298953,300374,1421,10,N,N,-,-1,-1
REMKEL2.txt,299162,300773,1611,10,N,N,-,-1,-1
REMKEL2.txt,299295,300837,1542,10,N,N,-,-1,-1
REMKEL2.txt,299558,300999,1441,10,N,N,-,-1,-1
REMKEL2.txt,299569,301205,1636,10,N,N,-,-1,-1
REMKEL2.txt,299599,301282,1683,10,N,N,-,-1,-1
REMKEL2.txt,299675,301339,1664,10,N,N,-,-1,-1
REMKEL2.txt,299883,301401,1518,10,N,N,-,-1,-1
REMKEL2.txt,300079,301512,1433,10,N,N,-,-1,-1
REMKEL2.txt,300237,301664,1427,10,N,N,-,-1,-1
REMKEL2.txt,300377,301975,1598,10,N,N,-,-1,-1
REMKEL2.txt,300776,302010,1234,10,N,N,-,-1,-1
REMKEL2.txt,300840,302273,1433,10,N,N,-,-1,-1
REMKEL2.txt,301002,302318,1316,10,N,N,-,-1,-1
REMKEL2.txt,301208,302480,1272,10,N,N,-,-1,-1
REMKEL2.txt,301282,302568,1286,10,N,N,-,-1,-1
REMKEL2.txt,301342,302616,1274,10,N,N,-,-1,-1
REMKEL2.txt,301404,302774,1370,10,N,N,-,-1,-1
REMKEL2.txt,301515,302879,1364,10,N,Y,1448312968013,174511,175025
REMKEL2.txt,301666,303160,1494,10,N,Y,1448312968013,174511,175025
REMKEL2.txt,301980,303295,1315,10,N,Y,1448280884746,88496,89294
REMKEL2.txt,302011,303342,1331,10,N,Y,1448280884746,88496,89294
REMKEL2.txt,302274,303434,1160,10,N,Y,1448280884746,88496,89294
REMKEL2.txt,302321,303561,1240,10,N,Y,1448280884746,88496,89294
REMKEL2.txt,302481,303804,1323,10,N,Y,1448280884746,88496,89294
REMKEL2.txt,302570,303995,1425,10,N,Y,1448280884746,88496,89294
REMKEL2.txt,302618,304046,1428,10,N,Y,1448280884746,88496,89294
REMKEL2.txt,302777,304100,1323,10,N,Y,1448280884746,88496,89294
REMKEL2.txt,302880,304206,1326,10,N,Y,1448280884746,88496,89294
REMKEL2.txt,303161,304243,1082,10,N,Y,1448280884746,88496,89294
REMKEL2.txt,303300,304421,1121,10,N,Y,1448280884746,88496,89294
REMKEL2.txt,303343,304786,1443,10,N,Y,1448280884746,88496,89294
REMKEL2.txt,303437,304839,1402,10,N,Y,1448358276684,234999,235995
REMKEL2.txt,303562,304889,1327,10,N,Y,1448358276684,234999,235995
REMKEL2.txt,303805,305137,1332,10,N,Y,1448358276684,234999,235995
REMKEL2.txt,303998,305200,1202,10,N,N,-,-1,-1
REMKEL2.txt,304048,305277,1229,10,N,N,-,-1,-1
REMKEL2.txt,304100,305469,1369,10,N,N,-,-1,-1
REMKEL2.txt,304208,305714,1506,10,N,N,-,-1,-1
REMKEL2.txt,304244,305762,1518,10,N,N,-,-1,-1
REMKEL2.txt,304422,305953,1531,10,N,N,-,-1,-1
REMKEL2.txt,304787,306089,1302,10,N,N,-,-1,-1
REMKEL2.txt,304842,306227,1385,10,N,N,-,-1,-1
REMKEL2.txt,304891,306562,1671,10,N,N,-,-1,-1
REMKEL2.txt,305140,306567,1427,10,N,N,-,-1,-1
REMKEL2.txt,305201,306645,1444,10,N,N,-,-1,-1
REMKEL2.txt,305280,306843,1563,10,N,N,-,-1,-1
REMKEL2.txt,305471,307010,1539,10,N,N,-,-1,-1
REMKEL2.txt,305715,307142,1427,10,N,N,-,-1,-1
REMKEL2.txt,305765,307342,1577,10,N,N,-,-1,-1
REMKEL2.txt,305954,307385,1431,10,N,N,-,-1,-1
REMKEL2.txt,306090,307582,1492,10,N,N,-,-1,-1
REMKEL2.txt,306228,307719,1491,10,N,N,-,-1,-1
REMKEL2.txt,306563,307893,1330,10,N,N,-,-1,-1
REMKEL2.txt,306568,308045,1477,10,N,N,-,-1,-1
REMKEL2.txt,306648,308210,1562,10,N,N,-,-1,-1
REMKEL2.txt,306845,308487,1642,10,N,N,-,-1,-1
REMKEL2.txt,307011,308635,1624,10,N,N,-,-1,-1
REMKEL2.txt,307143,308711,1568,10,N,N,-,-1,-1
REMKEL2.txt,307343,308892,1549,10,N,N,-,-1,-1
REMKEL2.txt,307388,308931,1543,10,N,N,-,-1,-1
REMKEL2.txt,307583,309141,1558,10,N,N,-,-1,-1
REMKEL2.txt,307720,309318,1598,10,N,N,-,-1,-1
REMKEL2.txt,307894,309486,1592,10,N,N,-,-1,-1
REMKEL2.txt,308045,309595,1550,10,N,N,-,-1,-1
REMKEL2.txt,308213,309678,1465,10,N,N,-,-1,-1
REMKEL2.txt,308488,309744,1256,10,N,N,-,-1,-1
REMKEL2.txt,308636,310093,1457,10,N,N,-,-1,-1
REMKEL2.txt,308712,310281,1569,10,N,N,-,-1,-1
REMKEL2.txt,308893,310288,1395,10,N,N,-,-1,-1
REMKEL2.txt,308932,310292,1360,10,N,N,-,-1,-1
REMKEL2.txt,309144,310699,1555,10,N,N,-,-1,-1
REMKEL2.txt,309319,310896,1577,10,N,N,-,-1,-1
REMKEL2.txt,309487,310960,1473,10,N,N,-,-1,-1
REMKEL2.txt,309597,311087,1490,10,N,Y,1448287306770,114686,120152
REMKEL2.txt,309679,311344,1665,10,N,Y,1448287306770,114686,120152
REMKEL2.txt,309746,311373,1627,10,N,Y,1448287306770,114686,120152
REMKEL2.txt,310094,311527,1433,10,Y,Y,1448287306770,114686,120152
REMKEL2.txt,310284,311584,1300,10,Y,Y,1448287306770,114686,120152
REMKEL2.txt,310289,311744,1455,10,Y,Y,1448287306770,114686,120152
REMKEL2.txt,310293,311763,1470,10,Y,Y,1448287306770,114686,120152
REMKEL2.txt,310700,311934,1234,10,Y,Y,1448287306770,114686,120152
REMKEL2.txt,310897,312052,1155,10,Y,Y,1448280297446,84055,84972
REMKEL2.txt,310963,312124,1161,10,Y,Y,1448280297446,84055,84972
REMKEL2.txt,311088,312196,1108,10,N,Y,1448280297446,84055,84972
REMKEL2.txt,311344,312323,979,10,N,Y,1448278425221,65586,65914
REMKEL2.txt,311374,312400,1026,10,N,Y,1448278425221,65586,65914
REMKEL2.txt,311528,312554,1026,10,Y,Y,1448278425221,65586,65914
REMKEL2.txt,311585,312676,1091,10,Y,Y,1448278425221,65586,65914
REMKEL2.txt,311747,312800,1053,10,N,Y,1448278425221,65586,65914
REMKEL2.txt,311764,312857,1093,10,N,Y,1448278425221,65586,65914
REMKEL2.txt,311937,312931,994,10,N,Y,1448278425221,65586,65914
REMKEL2.txt,312053,313009,956,10,N,Y,1448278425221,65586,65914
REMKEL2.txt,312125,313118,993,10,N,Y,1448278425221,65586,65914
REMKEL2.txt,312199,313176,977,10,N,Y,1448278425221,65586,65914
REMKEL2.txt,312324,313312,988,10,N,Y,1448278425221,65586,65914
REMKEL2.txt,312403,313521,1118,10,N,N,-,-1,-1
REMKEL2.txt,312555,313666,1111,10,N,N,-,-1,-1
REMKEL2.txt,312677,313704,1027,10,N,N,-,-1,-1
REMKEL2.txt,312801,313923,1122,10,N,N,-,-1,-1
REMKEL2.txt,312858,314126,1268,10,N,N,-,-1,-1
REMKEL2.txt,312932,314205,1273,10,N,N,-,-1,-1
REMKEL2.txt,313014,314304,1290,10,N,N,-,-1,-1
REMKEL2.txt,313119,314427,1308,10,N,N,-,-1,-1
REMKEL2.txt,313177,314578,1401,10,N,N,-,-1,-1
REMKEL2.txt,313313,314764,1451,10,N,N,-,-1,-1
REMKEL2.txt,313524,314954,1430,10,N,N,-,-1,-1
REMKEL2.txt,313667,315055,1388,10,N,N,-,-1,-1
REMKEL2.txt,313707,315121,1414,10,N,N,-,-1,-1
REMKEL2.txt,313924,315283,1359,10,N,N,-,-1,-1
REMKEL2.txt,314127,315659,1532,10,N,N,-,-1,-1
REMKEL2.txt,314206,315743,1537,10,N,N,-,-1,-1
REMKEL2.txt,314305,315940,1635,10,N,N,-,-1,-1
REMKEL2.txt,314428,316051,1623,10,N,N,-,-1,-1
REMKEL2.txt,314579,316288,1709,10,N,N,-,-1,-1
REMKEL2.txt,314765,316552,1787,10,N,N,-,-1,-1
REMKEL2.txt,314957,317049,2092,10,N,N,-,-1,-1
REMKEL2.txt,315057,317136,2079,10,N,N,-,-1,-1
REMKEL2.txt,315122,317201,2079,10,N,N,-,-1,-1
REMKEL2.txt,315286,317260,1974,10,N,N,-,-1,-1
REMKEL2.txt,315660,317433,1773,10,N,N,-,-1,-1
REMKEL2.txt,315745,317720,1975,10,N,N,-,-1,-1
REMKEL2.txt,315941,318100,2159,10,N,N,-,-1,-1
REMKEL2.txt,316052,318267,2215,10,N,N,-,-1,-1
REMKEL2.txt,316291,318365,2074,10,N,N,-,-1,-1
REMKEL2.txt,316555,318540,1985,10,N,N,-,-1,-1
REMKEL2.txt,317052,318927,1875,10,N,N,-,-1,-1
REMKEL2.txt,317139,319170,2031,10,N,N,-,-1,-1
REMKEL2.txt,317204,319475,2271,10,N,N,-,-1,-1
REMKEL2.txt,317261,319601,2340,10,N,N,-,-1,-1
REMKEL2.txt,317434,319722,2288,10,N,N,-,-1,-1
REMKEL2.txt,317721,319848,2127,10,N,N,-,-1,-1
REMKEL2.txt,318101,319920,1819,10,N,N,-,-1,-1
REMKEL2.txt,318268,319944,1676,10,N,N,-,-1,-1
REMKEL2.txt,318366,320087,1721,10,N,N,-,-1,-1
REMKEL2.txt,318545,320208,1663,10,N,N,-,-1,-1
REMKEL2.txt,318930,320298,1368,10,N,N,-,-1,-1
REMKEL2.txt,319171,320465,1294,10,N,N,-,-1,-1
REMKEL2.txt,319476,320532,1056,10,N,N,-,-1,-1
REMKEL2.txt,319604,320646,1042,10,N,N,-,-1,-1
REMKEL2.txt,319723,320755,1032,10,N,N,-,-1,-1
REMKEL2.txt,319849,320964,1115,10,N,N,-,-1,-1
REMKEL2.txt,319921,321155,1234,10,N,N,-,-1,-1
REMKEL2.txt,319945,321194,1249,10,N,N,-,-1,-1
REMKEL2.txt,320088,321260,1172,10,N,N,-,-1,-1
REMKEL2.txt,320211,321355,1144,10,N,N,-,-1,-1
REMKEL2.txt,320299,321505,1206,10,N,N,-,-1,-1
REMKEL2.txt,320466,321795,1329,10,N,N,-,-1,-1
REMKEL2.txt,320535,321911,1376,10,N,N,-,-1,-1
REMKEL2.txt,320647,321998,1351,10,N,N,-,-1,-1
REMKEL2.txt,320758,322144,1386,10,N,N,-,-1,-1
REMKEL2.txt,320965,322201,1236,10,N,N,-,-1,-1
REMKEL2.txt,321157,322284,1127,10,N,N,-,-1,-1
REMKEL2.txt,321195,322362,1167,10,N,N,-,-1,-1
REMKEL2.txt,321261,322433,1172,10,N,N,-,-1,-1
REMKEL2.txt,321358,322518,1160,10,N,N,-,-1,-1
REMKEL2.txt,321507,322537,1030,10,N,N,-,-1,-1
REMKEL2.txt,321798,322735,937,10,N,N,-,-1,-1
REMKEL2.txt,321912,322826,914,10,N,N,-,-1,-1
REMKEL2.txt,321998,322873,875,10,N,N,-,-1,-1
REMKEL2.txt,322145,322890,745,10,N,N,-,-1,-1
REMKEL2.txt,322202,322997,795,10,N,N,-,-1,-1
REMKEL2.txt,322285,323286,1001,10,N,N,-,-1,-1
REMKEL2.txt,322365,323531,1166,10,N,N,-,-1,-1
REMKEL2.txt,322434,323627,1193,10,N,N,-,-1,-1
REMKEL2.txt,322523,323726,1203,10,N,N,-,-1,-1
REMKEL2.txt,322538,323927,1389,10,N,N,-,-1,-1
REMKEL2.txt,322736,324006,1270,10,N,N,-,-1,-1
REMKEL2.txt,322827,324434,1607,10,N,N,-,-1,-1
REMKEL2.txt,322874,324534,1660,10,N,N,-,-1,-1
REMKEL2.txt,322892,324653,1761,10,N,N,-,-1,-1
REMKEL2.txt,322998,324870,1872,10,N,N,-,-1,-1
REMKEL2.txt,323286,325213,1927,10,N,N,-,-1,-1
REMKEL2.txt,323532,325348,1816,10,N,N,-,-1,-1
REMKEL2.txt,323628,325385,1757,10,N,N,-,-1,-1
REMKEL2.txt,323729,325561,1832,10,N,N,-,-1,-1
REMKEL2.txt,323932,325843,1911,10,N,N,-,-1,-1
REMKEL2.txt,324008,325864,1856,10,N,N,-,-1,-1
REMKEL2.txt,324437,325893,1456,10,N,N,-,-1,-1
REMKEL2.txt,324534,325926,1392,10,N,N,-,-1,-1
REMKEL2.txt,324656,325955,1299,10,N,N,-,-1,-1
REMKEL2.txt,324871,326083,1212,10,N,N,-,-1,-1
REMKEL2.txt,325214,326196,982,10,N,N,-,-1,-1
REMKEL2.txt,325349,326273,924,10,N,N,-,-1,-1
REMKEL2.txt,325386,326554,1168,10,N,N,-,-1,-1
REMKEL2.txt,325564,326789,1225,10,N,N,-,-1,-1
REMKEL2.txt,325844,326907,1063,10,N,N,-,-1,-1
REMKEL2.txt,325865,327115,1250,10,N,N,-,-1,-1
REMKEL2.txt,325894,327296,1402,10,N,N,-,-1,-1
REMKEL2.txt,325927,327390,1463,10,N,N,-,-1,-1
REMKEL2.txt,325956,327481,1525,10,N,N,-,-1,-1
REMKEL2.txt,326084,327531,1447,10,N,N,-,-1,-1
REMKEL2.txt,326197,327699,1502,10,Y,N,-,-1,-1
REMKEL2.txt,326276,327766,1490,10,Y,N,-,-1,-1
REMKEL2.txt,326557,327905,1348,10,Y,N,-,-1,-1
REMKEL2.txt,326791,328080,1289,10,Y,N,-,-1,-1
REMKEL2.txt,326910,328102,1192,10,Y,N,-,-1,-1
REMKEL2.txt,327116,328260,1144,10,Y,N,-,-1,-1
REMKEL2.txt,327298,328385,1087,10,Y,N,-,-1,-1
REMKEL2.txt,327391,328601,1210,10,Y,N,-,-1,-1
REMKEL2.txt,327482,328714,1232,10,N,N,-,-1,-1
REMKEL2.txt,327532,328773,1241,10,Y,Y,1448038101349,15101,17486
REMKEL2.txt,327700,328923,1223,10,N,Y,1448038101349,15101,17486
REMKEL2.txt,327767,329047,1280,10,Y,Y,1448038101349,15101,17486
REMKEL2.txt,327908,329088,1180,10,N,Y,1448038101349,15101,17486
REMKEL2.txt,328083,329185,1102,10,N,Y,1448038101349,15101,17486
REMKEL2.txt,328103,329263,1160,10,N,Y,1448038101349,15101,17486
REMKEL2.txt,328261,329358,1097,10,N,Y,1448038101349,15101,17486
REMKEL2.txt,328388,329512,1124,10,Y,Y,1448038101349,15101,17486
REMKEL2.txt,328602,329756,1154,10,Y,Y,1448038101349,15101,17486
REMKEL2.txt,328717,329835,1118,10,Y,Y,1448038101349,15101,17486
REMKEL2.txt,328774,330204,1430,10,Y,Y,1448038101349,15101,17486
REMKEL2.txt,328924,330447,1523,10,Y,Y,1448038101349,15101,17486
REMKEL2.txt,329048,330562,1514,10,Y,Y,1448038101349,15101,17486
REMKEL2.txt,329089,330715,1626,10,Y,Y,1448275407308,26987,29181
REMKEL2.txt,329188,330794,1606,10,Y,Y,1448275407308,26987,29181
REMKEL2.txt,329264,330811,1547,10,Y,Y,1448275407308,26987,29181
REMKEL2.txt,329359,330827,1468,10,Y,Y,1448275407308,26987,29181
REMKEL2.txt,329515,330904,1389,10,Y,Y,1448275407308,26987,29181
REMKEL2.txt,329757,330962,1205,10,Y,Y,1448275407308,26987,29181
REMKEL2.txt,329836,331044,1208,10,Y,Y,1448275407308,26987,29181
REMKEL2.txt,330207,331468,1261,10,N,Y,1448275407308,26987,29181
REMKEL2.txt,330448,331578,1130,10,N,Y,1448275407308,26987,29181
REMKEL2.txt,330565,331772,1207,10,N,Y,1448275407308,26987,29181
REMKEL2.txt,330716,331997,1281,10,N,Y,1448275407308,26987,29181
REMKEL2.txt,330795,332225,1430,10,N,Y,1448275407308,26987,29181
REMKEL2.txt,330812,332437,1625,10,N,Y,1448275407308,26987,29181
REMKEL2.txt,330828,332558,1730,10,N,Y,1448275407308,26987,29181
REMKEL2.txt,330905,332680,1775,10,N,Y,1448275407308,26987,29181
REMKEL2.txt,330963,332766,1803,10,N,Y,1448275407308,26987,29181
REMKEL2.txt,331045,332802,1757,10,N,Y,1448322273366,219239,219544
REMKEL2.txt,331471,333017,1546,10,N,Y,1448322273366,219239,219544
REMKEL2.txt,331579,333390,1811,10,N,Y,1448322273366,219239,219544
REMKEL2.txt,331774,333446,1672,10,N,Y,1448322273366,219239,219544
REMKEL2.txt,331998,333649,1651,10,N,Y,1448322273366,219239,219544
REMKEL2.txt,332228,333705,1477,10,N,Y,1448322273366,219239,219544
REMKEL2.txt,332438,333734,1296,10,N,Y,1448322273366,219239,219544
REMKEL2.txt,332561,333745,1184,10,N,Y,1448322273366,219239,219544
REMKEL2.txt,332681,333890,1209,10,N,Y,1448322273366,219239,219544
REMKEL2.txt,332767,333904,1137,10,N,Y,1448322273366,219239,219544
REMKEL2.txt,332804,333945,1141,10,N,Y,1448322273366,219239,219544
REMKEL2.txt,333020,334154,1134,10,N,Y,1448322273366,219239,219544
REMKEL2.txt,333391,334271,880,10,N,Y,1448322273366,219239,219544
REMKEL2.txt,333447,334342,895,10,N,Y,1448322273366,219239,219544
REMKEL2.txt,333650,334714,1064,10,N,Y,1448322273366,219239,219544
REMKEL2.txt,333707,334824,1117,10,N,Y,1448322273366,219239,219544
REMKEL2.txt,333735,335043,1308,10,N,Y,1448322273366,219239,219544
REMKEL2.txt,333746,335122,1376,10,N,Y,1448322273366,219239,219544
REMKEL2.txt,333891,335222,1331,10,N,Y,1448322273366,219239,219544
REMKEL2.txt,333905,335608,1703,10,N,Y,1448322273366,219239,219544
REMKEL2.txt,333948,335786,1838,10,N,Y,1448322273366,219239,219544
REMKEL2.txt,334155,335898,1743,10,N,Y,1448322273366,219239,219544
REMKEL2.txt,334272,335980,1708,10,N,Y,1448322273366,219239,219544
REMKEL2.txt,334343,336153,1810,10,N,Y,1448322273366,219239,219544
REMKEL2.txt,334715,336204,1489,10,N,Y,1448322273366,219239,219544
REMKEL2.txt,334825,336293,1468,10,N,Y,1448322273366,219239,219544
REMKEL2.txt,335046,336320,1274,10,N,N,-,-1,-1
REMKEL2.txt,335125,336341,1216,10,N,N,-,-1,-1
REMKEL2.txt,335224,336481,1257,10,N,N,-,-1,-1
REMKEL2.txt,335609,336638,1029,10,N,Y,1437472966198,394609,395892
REMKEL2.txt,335787,337003,1216,10,N,Y,1437472966198,394609,395892
REMKEL2.txt,335899,337082,1183,10,N,Y,1437472966198,394609,395892
REMKEL2.txt,335981,337365,1384,10,N,Y,1437472966198,394609,395892
REMKEL2.txt,336154,337710,1556,10,N,Y,1437472966198,394609,395892
REMKEL2.txt,336205,337794,1589,10,N,Y,1437472966198,394609,395892
REMKEL2.txt,336294,337816,1522,10,N,Y,1437472966198,394609,395892
REMKEL2.txt,336321,337856,1535,10,N,Y,1437472966198,394609,395892
REMKEL2.txt,336342,337988,1646,10,N,Y,1437472966198,394609,395892
REMKEL2.txt,336483,338163,1680,10,N,Y,1437472966198,394609,395892
REMKEL2.txt,336639,338192,1553,10,N,Y,1437472966198,394609,395892
REMKEL2.txt,337004,338263,1259,10,N,Y,1437472966198,394609,395892
REMKEL2.txt,337083,338381,1298,10,N,Y,1437472966198,394609,395892
REMKEL2.txt,337366,338510,1144,10,N,Y,1437472966198,394609,395892
REMKEL2.txt,337711,338512,801,10,N,Y,1437472966198,394609,395892
REMKEL2.txt,337795,338592,797,10,N,Y,1437472966198,394609,395892
REMKEL2.txt,337817,338678,861,10,N,Y,1437472966198,394609,395892
REMKEL2.txt,337859,338844,985,10,N,Y,1437472966198,394609,395892
REMKEL2.txt,337991,339009,1018,10,N,Y,1448274783410,21836,25159
REMKEL2.txt,338164,339081,917,10,N,Y,1448274783410,21836,25159
REMKEL2.txt,338193,339135,942,10,N,Y,1448274783410,21836,25159
REMKEL2.txt,338264,339340,1076,10,N,Y,1448274783410,21836,25159
REMKEL2.txt,338382,339448,1066,10,N,Y,1448274783410,21836,25159
REMKEL2.txt,338511,339674,1163,10,N,Y,1448274783410,21836,25159
REMKEL2.txt,338513,339764,1251,10,N,Y,1448274783410,21836,25159
REMKEL2.txt,338593,339827,1234,10,N,Y,1448274783410,21836,25159
REMKEL2.txt,338681,339917,1236,10,N,Y,1448274783410,21836,25159
REMKEL2.txt,338845,340003,1158,10,N,Y,1448274783410,21836,25159
REMKEL2.txt,339010,340244,1234,10,N,Y,1448274783410,21836,25159
REMKEL2.txt,339084,340453,1369,10,N,N,-,-1,-1
REMKEL2.txt,339136,340512,1376,10,N,N,-,-1,-1
REMKEL2.txt,339341,340643,1302,10,N,N,-,-1,-1
REMKEL2.txt,339449,340890,1441,10,N,N,-,-1,-1
REMKEL2.txt,339675,341110,1435,10,N,N,-,-1,-1
REMKEL2.txt,339767,341459,1692,10,N,Y,1448279089520,67624,69991
REMKEL2.txt,339828,341566,1738,10,N,Y,1448279089520,67624,69991
REMKEL2.txt,339919,341712,1793,10,Y,Y,1448279089520,67624,69991
REMKEL2.txt,340004,341893,1889,10,Y,Y,1448279089520,67624,69991
REMKEL2.txt,340245,342073,1828,10,Y,Y,1448279089520,67624,69991
REMKEL2.txt,340454,342198,1744,10,N,Y,1448279089520,67624,69991
REMKEL2.txt,340513,342514,2001,10,Y,Y,1448279089520,67624,69991
REMKEL2.txt,340644,342673,2029,10,N,Y,1448279089520,67624,69991
REMKEL2.txt,340893,342779,1886,10,N,Y,1448279089520,67624,69991
REMKEL2.txt,341113,342878,1765,10,N,Y,1448279089520,67624,69991
REMKEL2.txt,341460,342882,1422,10,N,Y,1448360140810,268069,269800
REMKEL2.txt,341569,343042,1473,10,N,N,-,-1,-1
REMKEL2.txt,341714,343117,1403,10,N,N,-,-1,-1
REMKEL2.txt,341894,343238,1344,10,N,N,-,-1,-1
REMKEL2.txt,342074,343388,1314,10,N,Y,1448277167610,40886,47737
REMKEL2.txt,342199,343568,1369,10,N,Y,1448277167610,40886,47737
REMKEL2.txt,342515,343625,1110,10,N,Y,1448277167610,40886,47737
REMKEL2.txt,342674,343868,1194,10,N,Y,1448277167610,40886,47737
REMKEL2.txt,342782,343950,1168,10,N,Y,1448277167610,40886,47737
REMKEL2.txt,342879,344037,1158,10,N,Y,1448277167610,40886,47737
REMKEL2.txt,342883,344211,1328,10,N,Y,1448277167610,40886,47737
REMKEL2.txt,343043,344277,1234,10,N,Y,1448277167610,40886,47737
REMKEL2.txt,343118,344675,1557,10,N,Y,1448277167610,40886,47737
REMKEL2.txt,343241,344823,1582,10,N,Y,1448277167610,40886,47737
REMKEL2.txt,343390,344974,1584,10,N,Y,1448277167610,40886,47737
REMKEL2.txt,343569,345146,1577,10,N,Y,1448277167610,40886,47737
REMKEL2.txt,343626,345261,1635,10,N,Y,1448277167610,40886,47737
REMKEL2.txt,343869,345529,1660,10,N,Y,1448277167610,40886,47737
REMKEL2.txt,343951,345627,1676,10,N,Y,1448277167610,40886,47737
REMKEL2.txt,344038,345917,1879,10,N,Y,1448277167610,40886,47737
REMKEL2.txt,344214,345955,1741,10,N,N,-,-1,-1
REMKEL2.txt,344282,346122,1840,10,N,N,-,-1,-1
REMKEL2.txt,344676,346378,1702,10,N,N,-,-1,-1
REMKEL2.txt,344824,346465,1641,10,N,N,-,-1,-1
REMKEL2.txt,344975,346666,1691,10,N,N,-,-1,-1
REMKEL2.txt,345147,346702,1555,10,N,N,-,-1,-1
REMKEL2.txt,345262,346908,1646,10,N,N,-,-1,-1
REMKEL2.txt,345530,347081,1551,10,N,N,-,-1,-1
REMKEL2.txt,345628,347104,1476,10,N,N,-,-1,-1
REMKEL2.txt,345920,347114,1194,10,N,N,-,-1,-1
REMKEL2.txt,345956,347216,1260,10,N,N,-,-1,-1
REMKEL2.txt,346123,347271,1148,10,N,N,-,-1,-1
REMKEL2.txt,346379,347546,1167,10,N,N,-,-1,-1
REMKEL2.txt,346466,347680,1214,10,N,N,-,-1,-1
REMKEL2.txt,346667,347879,1212,10,N,N,-,-1,-1
REMKEL2.txt,346703,348064,1361,10,N,N,-,-1,-1
REMKEL2.txt,346909,348192,1283,10,N,N,-,-1,-1
REMKEL2.txt,347086,348390,1304,10,N,N,-,-1,-1
REMKEL2.txt,347105,348498,1393,10,N,N,-,-1,-1
REMKEL2.txt,347115,348742,1627,10,N,N,-,-1,-1
REMKEL2.txt,347219,348936,1717,10,N,N,-,-1,-1
REMKEL2.txt,347272,349009,1737,10,N,N,-,-1,-1
REMKEL2.txt,347547,349213,1666,10,N,N,-,-1,-1
REMKEL2.txt,347683,349449,1766,10,N,N,-,-1,-1
REMKEL2.txt,347880,349572,1692,10,N,N,-,-1,-1
REMKEL2.txt,348065,349615,1550,10,N,N,-,-1,-1
REMKEL2.txt,348193,349735,1542,10,N,N,-,-1,-1
REMKEL2.txt,348391,349811,1420,10,N,N,-,-1,-1
REMKEL2.txt,348503,349839,1336,10,N,N,-,-1,-1
REMKEL2.txt,348743,349981,1238,10,N,N,-,-1,-1
REMKEL2.txt,348937,350095,1158,10,N,N,-,-1,-1
REMKEL2.txt,349010,350219,1209,10,N,N,-,-1,-1
REMKEL2.txt,349216,350364,1148,10,N,Y,1448287094676,113323,113870
REMKEL2.txt,349450,350454,1004,10,N,Y,1448287094676,113323,113870
REMKEL2.txt,349574,350758,1184,10,Y,Y,1448287094676,113323,113870
REMKEL2.txt,349618,351091,1473,10,Y,Y,1448039370049,20775,21297
REMKEL2.txt,349736,351161,1425,10,Y,Y,1448039370049,20775,21297
REMKEL2.txt,349813,351280,1467,10,Y,Y,1448039370049,20775,21297
REMKEL2.txt,349840,351496,1656,10,Y,Y,1448039370049,20775,21297
REMKEL2.txt,349984,351638,1654,10,Y,Y,1448039370049,20775,21297
REMKEL2.txt,350096,351717,1621,10,Y,Y,1448039370049,20775,21297
REMKEL2.txt,350222,351981,1759,10,Y,Y,1448039370049,20775,21297
REMKEL2.txt,350365,352226,1861,10,Y,Y,1448039370049,20775,21297
REMKEL2.txt,350455,352395,1940,10,Y,Y,1448039370049,20775,21297
REMKEL2.txt,350761,352549,1788,10,N,Y,1448039370049,20775,21297
REMKEL2.txt,351091,352741,1650,10,N,Y,1448039370049,20775,21297
REMKEL2.txt,351162,352760,1598,10,N,Y,1448039370049,20775,21297
REMKEL2.txt,351281,352868,1587,10,N,Y,1448039370049,20775,21297
REMKEL2.txt,351499,352979,1480,10,N,Y,1448285913012,108803,110925
REMKEL2.txt,351639,353250,1611,10,N,Y,1448285913012,108803,110925
REMKEL2.txt,351720,353535,1815,10,N,Y,1448285913012,108803,110925
REMKEL2.txt,351982,353588,1606,10,N,Y,1448285913012,108803,110925
REMKEL2.txt,352229,353713,1484,10,N,Y,1448285913012,108803,110925
REMKEL2.txt,352396,354311,1915,10,N,Y,1448285913012,108803,110925
REMKEL2.txt,352550,354970,2420,10,N,Y,1448285913012,108803,110925
REMKEL2.txt,352746,355189,2443,10,N,Y,1448285913012,108803,110925
REMKEL2.txt,352761,355291,2530,10,N,Y,1448285913012,108803,110925
REMKEL2.txt,352869,355517,2648,10,N,Y,1448285913012,108803,110925
REMKEL2.txt,352980,355577,2597,10,N,Y,1448285913012,108803,110925
REMKEL2.txt,353251,355848,2597,10,N,Y,1448285913012,108803,110925
REMKEL2.txt,353537,355969,2432,10,N,Y,1448285913012,108803,110925
REMKEL2.txt,353589,356405,2816,10,N,Y,1448285913012,108803,110925
REMKEL2.txt,353716,356595,2879,10,N,N,-,-1,-1
REMKEL2.txt,354314,356975,2661,10,N,N,-,-1,-1
REMKEL2.txt,354973,357137,2164,10,N,N,-,-1,-1
REMKEL2.txt,355192,357301,2109,10,N,N,-,-1,-1
REMKEL2.txt,355293,357711,2418,10,N,N,-,-1,-1
REMKEL2.txt,355518,357878,2360,10,N,N,-,-1,-1
REMKEL2.txt,355578,358092,2514,10,N,N,-,-1,-1
REMKEL2.txt,355849,358208,2359,10,N,N,-,-1,-1
REMKEL2.txt,355972,358329,2357,10,N,N,-,-1,-1
REMKEL2.txt,356408,358554,2146,10,N,N,-,-1,-1
REMKEL2.txt,356596,358814,2218,10,N,N,-,-1,-1
REMKEL2.txt,356976,358912,1936,10,N,N,-,-1,-1
REMKEL2.txt,357140,359131,1991,10,N,N,-,-1,-1
REMKEL2.txt,357302,359140,1838,10,N,N,-,-1,-1
REMKEL2.txt,357712,359410,1698,10,N,N,-,-1,-1
REMKEL2.txt,357879,359681,1802,10,N,N,-,-1,-1
REMKEL2.txt,358093,359940,1847,10,N,N,-,-1,-1
REMKEL2.txt,358211,360455,2244,10,N,N,-,-1,-1
REMKEL2.txt,358330,360882,2552,10,N,N,-,-1,-1
REMKEL2.txt,358557,360928,2371,10,N,N,-,-1,-1
REMKEL2.txt,358815,361027,2212,10,N,N,-,-1,-1
REMKEL2.txt,358915,361073,2158,10,N,N,-,-1,-1
REMKEL2.txt,359132,361204,2072,10,N,N,-,-1,-1
REMKEL2.txt,359143,361391,2248,10,N,N,-,-1,-1
REMKEL2.txt,359413,362247,2834,10,N,N,-,-1,-1
REMKEL2.txt,359683,362633,2950,10,N,N,-,-1,-1
REMKEL2.txt,359943,362835,2892,10,N,Y,1448366973491,278203,278343
REMKEL2.txt,360456,362965,2509,10,N,Y,1448366973491,278203,278343
REMKEL2.txt,360883,363014,2131,10,N,Y,1448366973491,278203,278343
REMKEL2.txt,360929,363179,2250,10,N,Y,1448366973491,278203,278343
REMKEL2.txt,361028,363427,2399,10,N,Y,1448366973491,278203,278343
REMKEL2.txt,361074,363476,2402,10,N,Y,1448366973491,278203,278343
REMKEL2.txt,361205,363554,2349,10,N,Y,1448366973491,278203,278343
REMKEL2.txt,361394,363726,2332,10,N,Y,1448366973491,278203,278343
REMKEL2.txt,362250,363880,1630,10,N,Y,1448366973491,278203,278343
REMKEL2.txt,362636,364028,1392,10,N,Y,1448366973491,278203,278343
REMKEL2.txt,362838,364041,1203,10,N,N,-,-1,-1
REMKEL2.txt,362966,364172,1206,10,N,N,-,-1,-1
REMKEL2.txt,363017,364283,1266,10,N,N,-,-1,-1
REMKEL2.txt,363180,364411,1231,10,N,Y,1448279620157,70041,71486
REMKEL2.txt,363430,364465,1035,10,N,Y,1448279620157,70041,71486
REMKEL2.txt,363477,364716,1239,10,N,Y,1448279620157,70041,71486
REMKEL2.txt,363557,364813,1256,10,N,Y,1448279620157,70041,71486
REMKEL2.txt,363727,365032,1305,10,N,Y,1448279620157,70041,71486
REMKEL2.txt,363883,365182,1299,10,N,Y,1448279620157,70041,71486
REMKEL2.txt,364030,365411,1381,10,N,Y,1448279620157,70041,71486
REMKEL2.txt,364042,365605,1563,10,N,Y,1448279620157,70041,71486
REMKEL2.txt,364175,365733,1558,10,N,Y,1448279620157,70041,71486
REMKEL2.txt,364286,365853,1567,10,N,Y,1448279620157,70041,71486
REMKEL2.txt,364412,365997,1585,10,N,Y,1448279620157,70041,71486
REMKEL2.txt,364468,366070,1602,10,N,N,-,-1,-1
REMKEL2.txt,364718,366135,1417,10,N,N,-,-1,-1
REMKEL2.txt,364814,366204,1390,10,N,N,-,-1,-1
REMKEL2.txt,365037,366278,1241,10,N,N,-,-1,-1
REMKEL2.txt,365183,366313,1130,10,N,N,-,-1,-1
REMKEL2.txt,365414,366338,924,10,N,N,-,-1,-1
REMKEL2.txt,365608,366405,797,10,N,N,-,-1,-1
REMKEL2.txt,365734,366641,907,10,N,N,-,-1,-1
REMKEL2.txt,365854,366712,858,10,N,N,-,-1,-1
REMKEL2.txt,365998,366869,871,10,N,N,-,-1,-1
REMKEL2.txt,366073,367065,992,10,N,N,-,-1,-1
REMKEL2.txt,366138,367304,1166,10,N,N,-,-1,-1
REMKEL2.txt,366205,367384,1179,10,N,N,-,-1,-1
REMKEL2.txt,366279,367519,1240,10,N,N,-,-1,-1
REMKEL2.txt,366318,367830,1512,10,N,N,-,-1,-1
REMKEL2.txt,366339,368006,1667,10,N,N,-,-1,-1
REMKEL2.txt,366406,368012,1606,10,N,N,-,-1,-1
REMKEL2.txt,366642,368206,1564,10,N,N,-,-1,-1
REMKEL2.txt,366713,368393,1680,10,N,N,-,-1,-1
REMKEL2.txt,366872,368615,1743,10,N,N,-,-1,-1
REMKEL2.txt,367068,368789,1721,10,N,N,-,-1,-1
REMKEL2.txt,367305,368930,1625,10,N,N,-,-1,-1
REMKEL2.txt,367385,368999,1614,10,N,N,-,-1,-1
REMKEL2.txt,367520,369235,1715,10,N,N,-,-1,-1
REMKEL2.txt,367832,369336,1504,10,N,N,-,-1,-1
REMKEL2.txt,368009,369460,1451,10,N,N,-,-1,-1
REMKEL2.txt,368015,369782,1767,10,N,N,-,-1,-1
REMKEL2.txt,368208,369970,1762,10,N,Y,1448282044001,101941,102395
REMKEL2.txt,368396,370410,2014,10,N,Y,1448282044001,101941,102395
REMKEL2.txt,368616,370649,2033,10,N,Y,1448282044001,101941,102395
REMKEL2.txt,368791,370782,1991,10,N,Y,1448282044001,101941,102395
REMKEL2.txt,368933,371074,2141,10,N,Y,1448282044001,101941,102395
REMKEL2.txt,369000,371199,2199,10,N,Y,1448282044001,101941,102395
REMKEL2.txt,369238,371273,2035,10,N,Y,1448282044001,101941,102395
REMKEL2.txt,369339,371303,1964,10,N,Y,1448282044001,101941,102395
REMKEL2.txt,369461,371326,1865,10,N,Y,1448282044001,101941,102395
REMKEL2.txt,369783,371751,1968,10,N,Y,1448282044001,101941,102395
REMKEL2.txt,369971,371770,1799,10,N,Y,1448282044001,101941,102395
REMKEL2.txt,370415,371959,1544,10,N,N,-,-1,-1
REMKEL2.txt,370650,372133,1483,10,N,Y,1436867017136,105674,106651
REMKEL2.txt,370783,372309,1526,10,N,Y,1436867017136,105674,106651
REMKEL2.txt,371075,372520,1445,10,N,Y,1436867017136,105674,106651
REMKEL2.txt,371200,372556,1356,10,N,Y,1436867017136,105674,106651
REMKEL2.txt,371274,372670,1396,10,N,Y,1436867017136,105674,106651
REMKEL2.txt,371304,372788,1484,10,N,Y,1436867017136,105674,106651
REMKEL2.txt,371327,372849,1522,10,N,Y,1436867017136,105674,106651
REMKEL2.txt,371756,372940,1184,10,N,Y,1436867017136,105674,106651
REMKEL2.txt,371771,373239,1468,10,N,Y,1436867017136,105674,106651
REMKEL2.txt,371962,373316,1354,10,N,Y,1436867017136,105674,106651
REMKEL2.txt,372134,373399,1265,10,N,Y,1436867017136,105674,106651
REMKEL2.txt,372310,373576,1266,10,N,Y,1436867017136,105674,106651
REMKEL2.txt,372523,373647,1124,10,N,Y,1436867017136,105674,106651
REMKEL2.txt,372557,373913,1356,10,N,Y,1436867017136,105674,106651
REMKEL2.txt,372673,373950,1277,10,N,Y,1448274893770,25386,26202
REMKEL2.txt,372789,373990,1201,10,N,Y,1448274893770,25386,26202
REMKEL2.txt,372850,374030,1180,10,N,Y,1448274893770,25386,26202
REMKEL2.txt,372941,374073,1132,10,N,Y,1448274893770,25386,26202
REMKEL2.txt,373240,374100,860,10,N,Y,1448274893770,25386,26202
REMKEL2.txt,373319,374127,808,10,N,N,-,-1,-1
REMKEL2.txt,373400,374164,764,10,N,N,-,-1,-1
REMKEL2.txt,373577,374278,701,10,N,N,-,-1,-1
REMKEL2.txt,373648,374410,762,10,N,N,-,-1,-1
REMKEL2.txt,373916,374554,638,10,N,N,-,-1,-1
REMKEL2.txt,373953,374675,722,10,N,N,-,-1,-1
REMKEL2.txt,373993,374873,880,10,N,N,-,-1,-1
REMKEL2.txt,374033,375011,978,10,N,N,-,-1,-1
REMKEL2.txt,374076,375136,1060,10,N,N,-,-1,-1
REMKEL2.txt,374103,375293,1190,10,N,N,-,-1,-1
REMKEL2.txt,374130,375667,1537,10,N,N,-,-1,-1
REMKEL2.txt,374167,375671,1504,10,N,N,-,-1,-1
REMKEL2.txt,374279,375767,1488,10,N,N,-,-1,-1
REMKEL2.txt,374411,375940,1529,10,N,N,-,-1,-1
REMKEL2.txt,374555,376118,1563,10,N,N,-,-1,-1
REMKEL2.txt,374678,376192,1514,10,N,N,-,-1,-1
REMKEL2.txt,374874,376355,1481,10,N,N,-,-1,-1
REMKEL2.txt,375014,376476,1462,10,N,N,-,-1,-1
REMKEL2.txt,375139,376589,1450,10,N,N,-,-1,-1
REMKEL2.txt,375295,376691,1396,10,N,N,-,-1,-1
REMKEL2.txt,375668,376786,1118,10,N,N,-,-1,-1
REMKEL2.txt,375672,376877,1205,10,N,N,-,-1,-1
REMKEL2.txt,375770,376967,1197,10,N,N,-,-1,-1
REMKEL2.txt,375941,377080,1139,10,N,N,-,-1,-1
REMKEL2.txt,376121,377105,984,10,N,N,-,-1,-1
REMKEL2.txt,376193,377232,1039,10,N,N,-,-1,-1
REMKEL2.txt,376358,377299,941,10,N,N,-,-1,-1
REMKEL2.txt,376477,377424,947,10,N,N,-,-1,-1
REMKEL2.txt,376590,377526,936,10,N,N,-,-1,-1
REMKEL2.txt,376692,377534,842,10,N,N,-,-1,-1
REMKEL2.txt,376787,377568,781,10,N,N,-,-1,-1
REMKEL2.txt,376878,377606,728,10,N,N,-,-1,-1
REMKEL2.txt,376968,377702,734,10,N,N,-,-1,-1
REMKEL2.txt,377081,377842,761,10,N,N,-,-1,-1
REMKEL2.txt,377106,377869,763,10,N,N,-,-1,-1
REMKEL2.txt,377233,378001,768,10,N,N,-,-1,-1
REMKEL2.txt,377300,378144,844,10,N,N,-,-1,-1
REMKEL2.txt,377425,378172,747,10,N,N,-,-1,-1
REMKEL2.txt,377529,378292,763,10,N,N,-,-1,-1
REMKEL2.txt,377537,378426,889,10,N,N,-,-1,-1
REMKEL2.txt,377569,378622,1053,10,N,Y,1448278279697,58861,59444
REMKEL2.txt,377611,378655,1044,10,N,Y,1448278279697,58861,59444
REMKEL2.txt,377705,378763,1058,10,N,Y,1448278279697,58861,59444
REMKEL2.txt,377845,378808,963,10,N,Y,1448278279697,58861,59444
REMKEL2.txt,377872,378915,1043,10,N,Y,1448278279697,58861,59444
REMKEL2.txt,378006,378959,953,10,N,Y,1448278279697,58861,59444
REMKEL2.txt,378147,379055,908,10,N,Y,1448278279697,58861,59444
REMKEL2.txt,378175,379122,947,10,N,Y,1448278279697,58861,59444
REMKEL2.txt,378294,379365,1071,10,N,Y,1448278279697,58861,59444
REMKEL2.txt,378429,379599,1170,10,Y,Y,1448278279697,58861,59444
REMKEL2.txt,378623,379762,1139,10,N,Y,1448278279697,58861,59444
REMKEL2.txt,378658,379980,1322,10,N,Y,1448275023016,26258,26837
REMKEL2.txt,378764,380098,1334,10,N,Y,1448275023016,26258,26837
REMKEL2.txt,378811,380585,1774,10,N,Y,1448275023016,26258,26837
REMKEL2.txt,378916,380740,1824,10,N,Y,1448275023016,26258,26837
REMKEL2.txt,378960,381005,2045,10,N,Y,1448275023016,26258,26837
REMKEL2.txt,379058,381086,2028,10,N,Y,1448275023016,26258,26837
REMKEL2.txt,379123,381145,2022,10,N,Y,1448275023016,26258,26837
REMKEL2.txt,379368,381385,2017,10,N,Y,1448275023016,26258,26837
REMKEL2.txt,379600,381565,1965,10,N,Y,1448275023016,26258,26837
REMKEL2.txt,379763,381609,1846,10,N,Y,1448275023016,26258,26837
REMKEL2.txt,379982,381664,1682,10,N,Y,1448275023016,26258,26837
REMKEL2.txt,380101,381730,1629,10,N,Y,1448275023016,26258,26837
REMKEL2.txt,380586,381856,1270,10,N,Y,1448275023016,26258,26837
REMKEL2.txt,380743,382017,1274,10,Y,Y,1448275023016,26258,26837
REMKEL2.txt,381006,382092,1086,10,Y,Y,1448275023016,26258,26837
REMKEL2.txt,381087,382104,1017,10,Y,Y,1448275023016,26258,26837
REMKEL2.txt,381146,382519,1373,10,Y,Y,1448275023016,26258,26837
REMKEL2.txt,381388,382577,1189,10,Y,Y,1448325046337,230539,231128
REMKEL2.txt,381566,382873,1307,10,Y,Y,1448313800274,179025,179317
REMKEL2.txt,381610,383210,1600,10,N,Y,1448313800274,179025,179317
REMKEL2.txt,381665,383491,1826,10,N,Y,1448313800274,179025,179317
REMKEL2.txt,381733,383632,1899,10,N,Y,1448313800274,179025,179317
REMKEL2.txt,381857,383813,1956,10,N,Y,1448313800274,179025,179317
REMKEL2.txt,382019,383963,1944,10,N,Y,1448313800274,179025,179317
REMKEL2.txt,382093,384098,2005,10,N,Y,1448313800274,179025,179317
REMKEL2.txt,382105,384584,2479,10,N,Y,1448313800274,179025,179317
REMKEL2.txt,382520,384651,2131,10,N,Y,1448313800274,179025,179317
REMKEL2.txt,382579,384906,2327,10,N,Y,1448313800274,179025,179317
REMKEL2.txt,382876,385451,2575,10,N,N,-,-1,-1
REMKEL2.txt,383211,385733,2522,10,N,N,-,-1,-1
REMKEL2.txt,383493,385982,2489,10,N,N,-,-1,-1
REMKEL2.txt,383633,386033,2400,10,N,N,-,-1,-1
REMKEL2.txt,383816,386177,2361,10,N,N,-,-1,-1
REMKEL2.txt,383966,386311,2345,10,N,N,-,-1,-1
REMKEL2.txt,384099,386369,2270,10,N,N,-,-1,-1
REMKEL2.txt,384587,386500,1913,10,N,N,-,-1,-1
REMKEL2.txt,384652,386905,2253,10,N,N,-,-1,-1
REMKEL2.txt,384907,387229,2322,10,N,N,-,-1,-1
REMKEL2.txt,385454,387249,1795,10,N,N,-,-1,-1
REMKEL2.txt,385734,387276,1542,10,N,N,-,-1,-1
REMKEL2.txt,385985,387315,1330,10,N,N,-,-1,-1
REMKEL2.txt,386038,387344,1306,10,N,N,-,-1,-1
REMKEL2.txt,386178,387400,1222,10,N,N,-,-1,-1
REMKEL2.txt,386312,387426,1114,10,N,N,-,-1,-1
REMKEL2.txt,386371,387452,1081,10,N,N,-,-1,-1
REMKEL2.txt,386501,387472,971,10,N,N,-,-1,-1
REMKEL2.txt,386908,387490,582,10,N,N,-,-1,-1
REMKEL2.txt,387230,387506,276,10,N,N,-,-1,-1
REMKEL2.txt,387250,387555,305,10,N,N,-,-1,-1
REMKEL2.txt,387277,387635,358,10,N,N,-,-1,-1
REMKEL2.txt,387316,387737,421,10,N,N,-,-1,-1
REMKEL2.txt,387345,387856,511,10,N,Y,1448037533268,13930,15031
REMKEL2.txt,387401,388059,658,10,N,Y,1448037533268,13930,15031
REMKEL2.txt,387427,388292,865,10,N,Y,1448037533268,13930,15031
REMKEL2.txt,387453,388365,912,10,N,Y,1448037533268,13930,15031
REMKEL2.txt,387473,388553,1080,10,N,Y,1448037533268,13930,15031
REMKEL2.txt,387491,388702,1211,10,N,Y,1448037533268,13930,15031
REMKEL2.txt,387508,388897,1389,10,N,Y,1448037533268,13930,15031
REMKEL2.txt,387556,388973,1417,10,N,Y,1448037533268,13930,15031
REMKEL2.txt,387636,389168,1532,10,N,Y,1448037533268,13930,15031
REMKEL2.txt,387740,389172,1432,10,N,Y,1448037533268,13930,15031
REMKEL2.txt,387857,389231,1374,10,N,Y,1448037533268,13930,15031
REMKEL2.txt,388062,389425,1363,10,N,Y,1448368866047,278997,279078
REMKEL2.txt,388293,389444,1151,10,N,Y,1448368866047,278997,279078
REMKEL2.txt,388366,389515,1149,10,N,Y,1448368866047,278997,279078
REMKEL2.txt,388554,389525,971,10,N,Y,1448368866047,278997,279078
REMKEL2.txt,388703,389536,833,10,N,Y,1448368866047,278997,279078
REMKEL2.txt,388900,389642,742,10,N,Y,1448322979449,227304,227638
REMKEL2.txt,388974,389716,742,10,N,Y,1448322979449,227304,227638
REMKEL2.txt,389170,389964,794,10,N,Y,1448322979449,227304,227638
REMKEL2.txt,389174,390521,1347,10,N,Y,1448322979449,227304,227638
REMKEL2.txt,389233,390655,1422,10,N,Y,1448322979449,227304,227638
REMKEL2.txt,389428,390952,1524,10,Y,Y,1448322979449,227304,227638
REMKEL2.txt,389445,391227,1782,10,Y,Y,1448279941918,72406,72905
REMKEL2.txt,389520,391299,1779,10,Y,Y,1448279941918,72406,72905
REMKEL2.txt,389525,391501,1976,10,Y,Y,1448279941918,72406,72905
REMKEL2.txt,389537,391679,2142,10,N,Y,1448279941918,72406,72905
REMKEL2.txt,389643,391823,2180,10,N,Y,1448279941918,72406,72905
REMKEL2.txt,389717,392060,2343,10,N,Y,1448279941918,72406,72905
REMKEL2.txt,389965,392176,2211,10,Y,Y,1448279941918,72406,72905
REMKEL2.txt,390524,392267,1743,10,N,Y,1448279941918,72406,72905
REMKEL2.txt,390656,392343,1687,10,N,Y,1448279941918,72406,72905
REMKEL2.txt,390957,392367,1410,10,N,Y,1448279941918,72406,72905
REMKEL2.txt,391228,392727,1499,10,N,Y,1448279941918,72406,72905
REMKEL2.txt,391302,392851,1549,10,N,N,-,-1,-1
REMKEL2.txt,391502,392886,1384,10,N,N,-,-1,-1
REMKEL2.txt,391680,392966,1286,10,N,N,-,-1,-1
REMKEL2.txt,391826,393176,1350,10,N,N,-,-1,-1
REMKEL2.txt,392061,393340,1279,10,N,N,-,-1,-1
REMKEL2.txt,392179,393423,1244,10,N,N,-,-1,-1
REMKEL2.txt,392268,393639,1371,10,N,N,-,-1,-1
REMKEL2.txt,392346,393944,1598,10,N,N,-,-1,-1
REMKEL2.txt,392368,393997,1629,10,N,Y,1448314503640,180207,180355
REMKEL2.txt,392728,394282,1554,10,N,Y,1448314503640,180207,180355
REMKEL2.txt,392853,394767,1914,10,N,Y,1448314503640,180207,180355
REMKEL2.txt,392887,394998,2111,10,N,Y,1448314503640,180207,180355
REMKEL2.txt,392969,395337,2368,10,N,Y,1448314503640,180207,180355
REMKEL2.txt,393179,395578,2399,10,N,Y,1448314503640,180207,180355
REMKEL2.txt,393341,395738,2397,10,N,Y,1448314503640,180207,180355
REMKEL2.txt,393424,395870,2446,10,N,Y,1448314503640,180207,180355
REMKEL2.txt,393640,396096,2456,10,N,Y,1448314503640,180207,180355
REMKEL2.txt,393947,396278,2331,10,N,Y,1448314503640,180207,180355
REMKEL2.txt,393998,396328,2330,10,N,Y,1448314503640,180207,180355
REMKEL2.txt,394285,396595,2310,10,N,Y,1448314503640,180207,180355
REMKEL2.txt,394770,396836,2066,10,N,N,-,-1,-1
REMKEL2.txt,395003,397269,2266,10,N,N,-,-1,-1
REMKEL2.txt,395338,397364,2026,10,N,N,-,-1,-1
REMKEL2.txt,395581,397412,1831,10,N,N,-,-1,-1
REMKEL2.txt,395741,397628,1887,10,N,N,-,-1,-1
REMKEL2.txt,395873,397691,1818,10,N,N,-,-1,-1
REMKEL2.txt,396097,397761,1664,10,N,Y,1437028092146,121457,123204
REMKEL2.txt,396279,397932,1653,10,N,Y,1437028092146,121457,123204
REMKEL2.txt,396333,398206,1873,10,N,Y,1437028092146,121457,123204
REMKEL2.txt,396596,398553,1957,10,N,Y,1437028092146,121457,123204
REMKEL2.txt,396837,398728,1891,10,N,Y,1437028092146,121457,123204
REMKEL2.txt,397270,399120,1850,10,N,Y,1437028092146,121457,123204
REMKEL2.txt,397365,399305,1940,10,N,Y,1437028092146,121457,123204
REMKEL2.txt,397413,399508,2095,10,N,Y,1437028092146,121457,123204
REMKEL2.txt,397630,399643,2013,10,N,Y,1437028092146,121457,123204
REMKEL2.txt,397694,399810,2116,10,N,Y,1437028092146,121457,123204
REMKEL2.txt,397762,399938,2176,10,N,Y,1437028092146,121457,123204
REMKEL2.txt,397933,400075,2142,10,N,Y,1437028092146,121457,123204
REMKEL2.txt,398209,400221,2012,10,N,Y,1437028092146,121457,123204
REMKEL2.txt,398555,400320,1765,10,N,N,-,-1,-1
REMKEL2.txt,398729,400574,1845,10,N,N,-,-1,-1
REMKEL2.txt,399121,400786,1665,10,N,N,-,-1,-1
REMKEL2.txt,399308,401073,1765,10,N,N,-,-1,-1
REMKEL2.txt,399509,401389,1880,10,N,N,-,-1,-1
REMKEL2.txt,399644,401600,1956,10,N,N,-,-1,-1
REMKEL2.txt,399811,401775,1964,10,N,N,-,-1,-1
REMKEL2.txt,399939,401971,2032,10,N,N,-,-1,-1
REMKEL2.txt,400077,402125,2048,10,N,N,-,-1,-1
REMKEL2.txt,400224,402276,2052,10,N,N,-,-1,-1
REMKEL2.txt,400321,402363,2042,10,N,N,-,-1,-1
REMKEL2.txt,400575,402601,2026,10,N,N,-,-1,-1
REMKEL2.txt,400787,402724,1937,10,N,N,-,-1,-1
REMKEL2.txt,401076,402904,1828,10,N,N,-,-1,-1
REMKEL2.txt,401390,402973,1583,10,N,N,-,-1,-1
REMKEL2.txt,401601,403011,1410,10,N,N,-,-1,-1
REMKEL2.txt,401776,403120,1344,10,N,N,-,-1,-1
REMKEL2.txt,401972,403231,1259,10,N,N,-,-1,-1
REMKEL2.txt,402126,403327,1201,10,N,N,-,-1,-1
REMKEL2.txt,402277,403517,1240,10,N,N,-,-1,-1
REMKEL2.txt,402364,403568,1204,10,N,N,-,-1,-1
REMKEL2.txt,402604,403712,1108,10,N,Y,1448322397200,219547,220107
REMKEL2.txt,402725,403795,1070,10,N,Y,1448322397200,219547,220107
REMKEL2.txt,402905,403865,960,10,N,Y,1448322397200,219547,220107
REMKEL2.txt,402976,403906,930,10,N,Y,1448322397200,219547,220107
REMKEL2.txt,403014,404291,1277,10,N,Y,1448322397200,219547,220107
REMKEL2.txt,403121,404364,1243,10,N,Y,1448322397200,219547,220107
REMKEL2.txt,403232,404432,1200,10,N,Y,1448322397200,219547,220107
REMKEL2.txt,403330,404548,1218,10,N,Y,1448322397200,219547,220107
REMKEL2.txt,403518,404556,1038,10,N,Y,1448322397200,219547,220107
REMKEL2.txt,403571,404565,994,10,N,Y,1448322397200,219547,220107
REMKEL2.txt,403713,404687,974,10,N,Y,1448322397200,219547,220107
REMKEL2.txt,403796,404745,949,10,N,Y,1448322397200,219547,220107
REMKEL2.txt,403866,404772,906,10,N,Y,1448322397200,219547,220107
REMKEL2.txt,403907,404829,922,10,N,Y,1448322397200,219547,220107
REMKEL2.txt,404294,404851,557,10,N,Y,1448322397200,219547,220107
REMKEL2.txt,404365,404875,510,10,N,Y,1448322397200,219547,220107
REMKEL2.txt,404433,404972,539,10,N,Y,1448322397200,219547,220107
REMKEL2.txt,404549,405025,476,10,N,Y,1448322397200,219547,220107
REMKEL2.txt,404557,405039,482,10,N,Y,1448322397200,219547,220107
REMKEL2.txt,404566,405136,570,10,N,Y,1448322397200,219547,220107
REMKEL2.txt,404688,405310,622,10,N,Y,1448322397200,219547,220107
REMKEL2.txt,404746,405506,760,10,N,Y,1448322397200,219547,220107
REMKEL2.txt,404775,405654,879,10,N,Y,1448322397200,219547,220107
REMKEL2.txt,404830,405741,911,10,N,Y,1448322397200,219547,220107
REMKEL2.txt,404852,405869,1017,10,N,Y,1448322397200,219547,220107
REMKEL2.txt,404876,405964,1088,10,N,Y,1448322397200,219547,220107
REMKEL2.txt,404973,406304,1331,10,N,Y,1448322397200,219547,220107
REMKEL2.txt,405026,406843,1817,10,N,Y,1448322397200,219547,220107
REMKEL2.txt,405040,407043,2003,10,N,Y,1448322397200,219547,220107
REMKEL2.txt,405139,407169,2030,10,N,Y,1448312128598,172353,173027
REMKEL2.txt,405311,407282,1971,10,N,Y,1448312128598,172353,173027
REMKEL2.txt,405507,407286,1779,10,N,Y,1448312128598,172353,173027
REMKEL2.txt,405655,407395,1740,10,N,Y,1448312128598,172353,173027
REMKEL2.txt,405743,407466,1723,10,N,Y,1448312128598,172353,173027
REMKEL2.txt,405870,407715,1845,10,N,Y,1448312128598,172353,173027
REMKEL2.txt,405965,407864,1899,10,N,Y,1448312128598,172353,173027
REMKEL2.txt,406305,408121,1816,10,N,Y,1448312128598,172353,173027
REMKEL2.txt,406846,408338,1492,10,N,Y,1448312128598,172353,173027
REMKEL2.txt,407045,408395,1350,10,N,Y,1448312128598,172353,173027
REMKEL2.txt,407172,408503,1331,10,N,Y,1448312128598,172353,173027
REMKEL2.txt,407283,408581,1298,10,N,Y,1448312128598,172353,173027
REMKEL2.txt,407287,408620,1333,10,N,Y,1448312128598,172353,173027
REMKEL2.txt,407398,408664,1266,10,N,Y,1448312128598,172353,173027
REMKEL2.txt,407467,408698,1231,10,N,Y,1448312128598,172353,173027
REMKEL2.txt,407716,408814,1098,10,N,Y,1448312128598,172353,173027
REMKEL2.txt,407865,408979,1114,10,N,Y,1448312128598,172353,173027
REMKEL2.txt,408124,409105,981,10,N,N,-,-1,-1
REMKEL2.txt,408339,409206,867,10,N,N,-,-1,-1
REMKEL2.txt,408398,409310,912,10,N,N,-,-1,-1
REMKEL2.txt,408504,409397,893,10,N,N,-,-1,-1
REMKEL2.txt,408582,409579,997,10,N,N,-,-1,-1
REMKEL2.txt,408621,409858,1237,10,N,N,-,-1,-1
REMKEL2.txt,408665,409923,1258,10,N,N,-,-1,-1
REMKEL2.txt,408699,410120,1421,10,N,N,-,-1,-1
REMKEL2.txt,408815,410320,1505,10,N,N,-,-1,-1
REMKEL2.txt,408980,410420,1440,10,N,N,-,-1,-1
REMKEL2.txt,409108,410545,1437,10,N,N,-,-1,-1
REMKEL2.txt,409208,410630,1422,10,N,N,-,-1,-1
REMKEL2.txt,409311,410897,1586,10,N,N,-,-1,-1
REMKEL2.txt,409398,410963,1565,10,N,N,-,-1,-1
REMKEL2.txt,409582,411060,1478,10,N,N,-,-1,-1
REMKEL2.txt,409861,411352,1491,10,N,N,-,-1,-1
REMKEL2.txt,409923,411419,1496,10,N,N,-,-1,-1
REMKEL2.txt,410121,411657,1536,10,N,N,-,-1,-1
REMKEL2.txt,410321,411769,1448,10,N,N,-,-1,-1
REMKEL2.txt,410421,411946,1525,10,N,N,-,-1,-1
REMKEL2.txt,410546,412087,1541,10,N,N,-,-1,-1
REMKEL2.txt,410631,412397,1766,10,N,N,-,-1,-1
REMKEL2.txt,410900,412484,1584,10,Y,N,-,-1,-1
REMKEL2.txt,410964,412652,1688,10,Y,N,-,-1,-1
REMKEL2.txt,411061,412830,1769,10,Y,N,-,-1,-1
REMKEL2.txt,411355,412874,1519,10,Y,N,-,-1,-1
REMKEL2.txt,411420,413227,1807,10,N,N,-,-1,-1
REMKEL2.txt,411658,413354,1696,10,N,N,-,-1,-1
REMKEL2.txt,411772,413491,1719,10,N,N,-,-1,-1
REMKEL2.txt,411947,413646,1699,10,N,N,-,-1,-1
REMKEL2.txt,412088,413686,1598,10,N,N,-,-1,-1
REMKEL2.txt,412398,413896,1498,10,N,N,-,-1,-1
REMKEL2.txt,412486,414071,1585,10,N,N,-,-1,-1
REMKEL2.txt,412653,414114,1461,10,N,N,-,-1,-1
REMKEL2.txt,412831,414224,1393,10,N,N,-,-1,-1
REMKEL2.txt,412877,414294,1417,10,N,N,-,-1,-1
REMKEL2.txt,413230,414486,1256,10,N,N,-,-1,-1
REMKEL2.txt,413355,414583,1228,10,N,N,-,-1,-1
REMKEL2.txt,413494,414703,1209,10,N,N,-,-1,-1
REMKEL2.txt,413647,414790,1143,10,N,N,-,-1,-1
REMKEL2.txt,413687,414904,1217,10,N,N,-,-1,-1
REMKEL2.txt,413898,414948,1050,10,N,N,-,-1,-1
REMKEL2.txt,414072,415033,961,10,N,N,-,-1,-1
REMKEL2.txt,414115,415281,1166,10,N,N,-,-1,-1
REMKEL2.txt,414227,415535,1308,10,N,N,-,-1,-1
REMKEL2.txt,414295,415627,1332,10,N,N,-,-1,-1
REMKEL2.txt,414487,415783,1296,10,N,N,-,-1,-1
REMKEL2.txt,414584,415988,1404,10,N,N,-,-1,-1
REMKEL2.txt,414704,416190,1486,10,N,N,-,-1,-1
REMKEL2.txt,414791,416363,1572,10,N,N,-,-1,-1
REMKEL2.txt,414904,416532,1628,10,N,N,-,-1,-1
REMKEL2.txt,414949,416788,1839,10,N,N,-,-1,-1
REMKEL2.txt,415034,416891,1857,10,N,N,-,-1,-1
REMKEL2.txt,415284,416922,1638,10,N,N,-,-1,-1
REMKEL2.txt,415536,417345,1809,10,N,N,-,-1,-1
REMKEL2.txt,415628,417925,2297,10,N,N,-,-1,-1
REMKEL2.txt,415784,418080,2296,10,N,N,-,-1,-1
REMKEL2.txt,415989,418161,2172,10,N,N,-,-1,-1
REMKEL2.txt,416191,418368,2177,10,N,N,-,-1,-1
REMKEL2.txt,416365,418451,2086,10,N,N,-,-1,-1
REMKEL2.txt,416535,418574,2039,10,N,N,-,-1,-1
REMKEL2.txt,416789,418827,2038,10,N,N,-,-1,-1
REMKEL2.txt,416896,418937,2041,10,N,Y,1437471855423,351318,351853
REMKEL2.txt,416923,419112,2189,10,N,Y,1437471855423,351318,351853
REMKEL2.txt,417348,419371,2023,10,N,Y,1437471855423,351318,351853
REMKEL2.txt,417926,419496,1570,10,N,Y,1437471855423,351318,351853
REMKEL2.txt,418081,419764,1683,10,N,Y,1437471855423,351318,351853
REMKEL2.txt,418162,419843,1681,10,N,Y,1437471855423,351318,351853
REMKEL2.txt,418369,420005,1636,10,N,Y,1437471855423,351318,351853
REMKEL2.txt,418452,420189,1737,10,N,Y,1437471855423,351318,351853
REMKEL2.txt,418575,420525,1950,10,Y,Y,1437471855423,351318,351853
REMKEL2.txt,418830,420662,1832,10,Y,Y,1437471855423,351318,351853
REMKEL2.txt,418938,420785,1847,10,Y,Y,1437471855423,351318,351853
REMKEL2.txt,419113,421135,2022,10,Y,Y,1437471855423,351318,351853
REMKEL2.txt,419372,421285,1913,10,Y,Y,1437471855423,351318,351853
REMKEL2.txt,419497,421426,1929,10,Y,Y,1437471855423,351318,351853
REMKEL2.txt,419765,421573,1808,10,Y,Y,1437471855423,351318,351853
REMKEL2.txt,419844,421728,1884,10,Y,Y,1437471855423,351318,351853
REMKEL2.txt,420008,422088,2080,10,N,Y,1448281888079,98877,102290
REMKEL2.txt,420190,422354,2164,10,N,Y,1448281888079,98877,102290
REMKEL2.txt,420526,422481,1955,10,Y,Y,1448281888079,98877,102290
REMKEL2.txt,420663,422632,1969,10,N,Y,1448281888079,98877,102290
REMKEL2.txt,420788,422702,1914,10,N,Y,1448312844411,173573,174472
REMKEL2.txt,421138,422805,1667,10,N,Y,1448312844411,173573,174472
REMKEL2.txt,421286,422986,1700,10,N,Y,1448312844411,173573,174472
REMKEL2.txt,421427,423089,1662,10,N,Y,1448312844411,173573,174472
REMKEL2.txt,421575,423375,1800,10,N,Y,1448312844411,173573,174472
REMKEL2.txt,421729,423450,1721,10,N,Y,1448312844411,173573,174472
REMKEL2.txt,422089,423723,1634,10,N,Y,1448312844411,173573,174472
REMKEL2.txt,422355,423882,1527,10,N,Y,1448312844411,173573,174472
REMKEL2.txt,422482,424090,1608,10,N,Y,1448280673594,87462,88501
REMKEL2.txt,422635,424233,1598,10,N,Y,1448280673594,87462,88501
REMKEL2.txt,422703,424332,1629,10,N,Y,1448280673594,87462,88501
REMKEL2.txt,422806,424547,1741,10,N,Y,1448280673594,87462,88501
REMKEL2.txt,422989,424727,1738,10,N,Y,1448280673594,87462,88501
REMKEL2.txt,423090,424923,1833,10,N,Y,1448280673594,87462,88501
REMKEL2.txt,423376,425003,1627,10,N,Y,1448280673594,87462,88501
REMKEL2.txt,423451,425059,1608,10,N,Y,1448280673594,87462,88501
REMKEL2.txt,423726,425236,1510,10,N,Y,1448280673594,87462,88501
REMKEL2.txt,423885,425373,1488,10,N,Y,1448280673594,87462,88501
REMKEL2.txt,424091,425435,1344,10,N,Y,1448280673594,87462,88501
REMKEL2.txt,424236,425520,1284,10,N,N,-,-1,-1
REMKEL2.txt,424335,425723,1388,10,N,N,-,-1,-1
REMKEL2.txt,424548,425967,1419,10,N,N,-,-1,-1
REMKEL2.txt,424728,426291,1563,10,N,N,-,-1,-1
REMKEL2.txt,424924,426342,1418,10,N,N,-,-1,-1
REMKEL2.txt,425004,426556,1552,10,N,N,-,-1,-1
REMKEL2.txt,425061,426598,1537,10,N,N,-,-1,-1
REMKEL2.txt,425237,426789,1552,10,N,N,-,-1,-1
REMKEL2.txt,425376,426866,1490,10,N,N,-,-1,-1
REMKEL2.txt,425436,427214,1778,10,N,N,-,-1,-1
REMKEL2.txt,425522,427293,1771,10,N,N,-,-1,-1
REMKEL2.txt,425724,427382,1658,10,N,N,-,-1,-1
REMKEL2.txt,425968,427432,1464,10,N,N,-,-1,-1
REMKEL2.txt,426292,427657,1365,10,N,N,-,-1,-1
REMKEL2.txt,426343,427784,1441,10,N,N,-,-1,-1
REMKEL2.txt,426558,427891,1333,10,N,N,-,-1,-1
REMKEL2.txt,426601,428023,1422,10,N,N,-,-1,-1
REMKEL2.txt,426790,428150,1360,10,N,N,-,-1,-1
REMKEL2.txt,426867,428463,1596,10,N,N,-,-1,-1
REMKEL2.txt,427217,428497,1280,10,N,N,-,-1,-1
REMKEL2.txt,427294,428843,1549,10,N,N,-,-1,-1
REMKEL2.txt,427383,429051,1668,10,N,N,-,-1,-1
REMKEL2.txt,427433,429281,1848,10,N,N,-,-1,-1
REMKEL2.txt,427658,429452,1794,10,N,N,-,-1,-1
REMKEL2.txt,427785,429622,1837,10,N,N,-,-1,-1
REMKEL2.txt,427892,429712,1820,10,N,N,-,-1,-1
REMKEL2.txt,428024,429853,1829,10,N,N,-,-1,-1
REMKEL2.txt,428153,429920,1767,10,N,N,-,-1,-1
REMKEL2.txt,428464,430325,1861,10,N,N,-,-1,-1
REMKEL2.txt,428500,430468,1968,10,N,N,-,-1,-1
REMKEL2.txt,428846,430682,1836,10,N,N,-,-1,-1
REMKEL2.txt,429052,430894,1842,10,N,N,-,-1,-1
REMKEL2.txt,429282,431066,1784,10,N,N,-,-1,-1
REMKEL2.txt,429453,431136,1683,10,N,N,-,-1,-1
REMKEL2.txt,429623,431337,1714,10,N,N,-,-1,-1
REMKEL2.txt,429714,431513,1799,10,N,N,-,-1,-1
REMKEL2.txt,429856,431966,2110,10,N,N,-,-1,-1
REMKEL2.txt,429923,432396,2473,10,N,N,-,-1,-1
REMKEL2.txt,430326,432624,2298,10,N,N,-,-1,-1
REMKEL2.txt,430469,432889,2420,10,N,N,-,-1,-1
REMKEL2.txt,430685,433106,2421,10,N,N,-,-1,-1
REMKEL2.txt,430895,433221,2326,10,N,N,-,-1,-1
REMKEL2.txt,431067,433279,2212,10,N,N,-,-1,-1
REMKEL2.txt,431138,433523,2385,10,N,N,-,-1,-1
REMKEL2.txt,431340,433716,2376,10,N,N,-,-1,-1
REMKEL2.txt,431514,433930,2416,10,N,N,-,-1,-1
REMKEL2.txt,431969,434103,2134,10,N,N,-,-1,-1
REMKEL2.txt,432399,434144,1745,10,N,N,-,-1,-1
REMKEL2.txt,432625,434315,1690,10,N,N,-,-1,-1
REMKEL2.txt,432890,434942,2052,10,N,N,-,-1,-1
REMKEL2.txt,433109,435233,2124,10,N,N,-,-1,-1
REMKEL2.txt,433222,435418,2196,10,N,N,-,-1,-1
REMKEL2.txt,433280,435916,2636,10,N,N,-,-1,-1
REMKEL2.txt,433524,436088,2564,10,N,N,-,-1,-1
REMKEL2.txt,433717,436239,2522,10,N,N,-,-1,-1
REMKEL2.txt,433933,437220,3287,10,N,N,-,-1,-1
REMKEL2.txt,434106,437428,3322,10,N,N,-,-1,-1
REMKEL2.txt,434145,437883,3738,10,N,N,-,-1,-1
REMKEL2.txt,434316,438215,3899,10,N,N,-,-1,-1
REMKEL2.txt,434945,438374,3429,10,N,N,-,-1,-1
REMKEL2.txt,435234,438556,3322,10,N,N,-,-1,-1
REMKEL2.txt,435421,438681,3260,10,N,N,-,-1,-1
REMKEL2.txt,435919,438925,3006,10,N,N,-,-1,-1
REMKEL2.txt,436089,438998,2909,10,N,N,-,-1,-1
REMKEL2.txt,436242,439199,2957,10,N,N,-,-1,-1
REMKEL2.txt,437223,439392,2169,10,N,N,-,-1,-1
REMKEL2.txt,437430,439580,2150,10,N,N,-,-1,-1
REMKEL2.txt,437886,439914,2028,10,N,N,-,-1,-1
REMKEL2.txt,438218,440107,1889,10,N,N,-,-1,-1
REMKEL2.txt,438375,440223,1848,10,N,N,-,-1,-1
REMKEL2.txt,438559,440341,1782,10,N,N,-,-1,-1
REMKEL2.txt,438682,440345,1663,10,N,N,-,-1,-1
REMKEL2.txt,438926,440770,1844,10,N,N,-,-1,-1
REMKEL2.txt,438999,440939,1940,10,N,N,-,-1,-1
REMKEL2.txt,439200,441170,1970,10,N,N,-,-1,-1
REMKEL2.txt,439393,441249,1856,10,N,N,-,-1,-1
REMKEL2.txt,439583,441479,1896,10,N,N,-,-1,-1
REMKEL2.txt,439915,441553,1638,10,N,N,-,-1,-1
REMKEL2.txt,440108,441602,1494,10,N,N,-,-1,-1
REMKEL2.txt,440224,441654,1430,10,N,N,-,-1,-1
REMKEL2.txt,440342,441839,1497,10,N,N,-,-1,-1
REMKEL2.txt,440346,442007,1661,10,N,N,-,-1,-1
REMKEL2.txt,440773,442129,1356,10,N,N,-,-1,-1
REMKEL2.txt,440942,442316,1374,10,N,N,-,-1,-1
REMKEL2.txt,441171,442461,1290,10,N,N,-,-1,-1
REMKEL2.txt,441250,442806,1556,10,N,N,-,-1,-1
REMKEL2.txt,441479,442955,1476,10,N,N,-,-1,-1
REMKEL2.txt,441554,443058,1504,10,N,N,-,-1,-1
REMKEL2.txt,441603,443237,1634,10,N,N,-,-1,-1
REMKEL2.txt,441655,443495,1840,10,N,N,-,-1,-1
REMKEL2.txt,441840,443603,1763,10,N,N,-,-1,-1
REMKEL2.txt,442010,443701,1691,10,N,N,-,-1,-1
REMKEL2.txt,442130,443834,1704,10,N,N,-,-1,-1
REMKEL2.txt,442318,443932,1614,10,N,N,-,-1,-1
REMKEL2.txt,442462,444028,1566,10,N,N,-,-1,-1
REMKEL2.txt,442807,444412,1605,10,N,N,-,-1,-1
REMKEL2.txt,442956,444466,1510,10,N,N,-,-1,-1
REMKEL2.txt,443063,444595,1532,10,N,N,-,-1,-1
REMKEL2.txt,443238,444699,1461,10,N,N,-,-1,-1
REMKEL2.txt,443497,444781,1284,10,N,N,-,-1,-1
REMKEL2.txt,443604,444793,1189,10,N,N,-,-1,-1
REMKEL2.txt,443702,444926,1224,10,N,N,-,-1,-1
REMKEL2.txt,443835,445051,1216,10,N,N,-,-1,-1
REMKEL2.txt,443933,445330,1397,10,N,N,-,-1,-1
REMKEL2.txt,444031,445952,1921,10,N,N,-,-1,-1
REMKEL2.txt,444413,445988,1575,10,N,N,-,-1,-1
REMKEL2.txt,444467,446221,1754,10,N,N,-,-1,-1
REMKEL2.txt,444596,446311,1715,10,N,N,-,-1,-1
REMKEL2.txt,444700,446442,1742,10,N,N,-,-1,-1
REMKEL2.txt,444782,446465,1683,10,N,N,-,-1,-1
REMKEL2.txt,444794,446484,1690,10,N,N,-,-1,-1
REMKEL2.txt,444929,446520,1591,10,N,N,-,-1,-1
REMKEL2.txt,445052,446623,1571,10,N,N,-,-1,-1
REMKEL2.txt,445333,446682,1349,10,N,N,-,-1,-1
REMKEL2.txt,445955,446809,854,10,N,N,-,-1,-1
REMKEL2.txt,445989,447027,1038,10,N,N,-,-1,-1
REMKEL2.txt,446222,447066,844,10,N,N,-,-1,-1
REMKEL2.txt,446312,447135,823,10,N,N,-,-1,-1
REMKEL2.txt,446443,447223,780,10,N,N,-,-1,-1
REMKEL2.txt,446466,447470,1004,10,N,N,-,-1,-1
REMKEL2.txt,446485,447698,1213,10,N,N,-,-1,-1
REMKEL2.txt,446521,447847,1326,10,N,N,-,-1,-1
REMKEL2.txt,446624,448049,1425,10,N,N,-,-1,-1
REMKEL2.txt,446683,448119,1436,10,N,N,-,-1,-1
REMKEL2.txt,446812,448235,1423,10,N,N,-,-1,-1
REMKEL2.txt,447028,448279,1251,10,N,N,-,-1,-1
REMKEL2.txt,447067,448299,1232,10,N,N,-,-1,-1
REMKEL2.txt,447138,448506,1368,10,N,N,-,-1,-1
REMKEL2.txt,447224,448530,1306,10,N,N,-,-1,-1
REMKEL2.txt,447471,448577,1106,10,N,N,-,-1,-1
REMKEL2.txt,447701,448762,1061,10,N,N,-,-1,-1
REMKEL2.txt,447848,449261,1413,10,N,N,-,-1,-1
REMKEL2.txt,448052,449492,1440,10,N,N,-,-1,-1
REMKEL2.txt,448120,449667,1547,10,N,N,-,-1,-1
REMKEL2.txt,448236,449910,1674,10,N,N,-,-1,-1
REMKEL2.txt,448280,450070,1790,10,N,N,-,-1,-1
REMKEL2.txt,448300,450302,2002,10,N,N,-,-1,-1
REMKEL2.txt,448507,450509,2002,10,N,N,-,-1,-1
REMKEL2.txt,448533,450761,2228,10,N,N,-,-1,-1
REMKEL2.txt,448580,450831,2251,10,N,N,-,-1,-1
REMKEL2.txt,448763,451564,2801,10,N,N,-,-1,-1
REMKEL2.txt,449262,451691,2429,10,N,N,-,-1,-1
REMKEL2.txt,449495,451802,2307,10,N,N,-,-1,-1
REMKEL2.txt,449670,452015,2345,10,N,N,-,-1,-1
REMKEL2.txt,449913,452094,2181,10,N,N,-,-1,-1
REMKEL2.txt,450071,452176,2105,10,N,N,-,-1,-1
REMKEL2.txt,450305,452228,1923,10,N,N,-,-1,-1
REMKEL2.txt,450510,452298,1788,10,N,N,-,-1,-1
REMKEL2.txt,450762,452397,1635,10,N,N,-,-1,-1
REMKEL2.txt,450832,452485,1653,10,N,N,-,-1,-1
REMKEL2.txt,451565,452513,948,10,N,N,-,-1,-1
REMKEL2.txt,451694,452623,929,10,N,N,-,-1,-1
REMKEL2.txt,451803,452781,978,10,N,N,-,-1,-1
REMKEL2.txt,452016,452843,827,10,N,N,-,-1,-1
REMKEL2.txt,452097,453044,947,10,N,N,-,-1,-1
REMKEL2.txt,452179,453239,1060,10,N,N,-,-1,-1
REMKEL2.txt,452229,453472,1243,10,N,Y,1448359878707,265791,267089
REMKEL2.txt,452299,453646,1347,10,N,Y,1448359878707,265791,267089
REMKEL2.txt,452400,453957,1557,10,N,Y,1448359878707,265791,267089
REMKEL2.txt,452486,454008,1522,10,N,Y,1448359878707,265791,267089
REMKEL2.txt,452514,454039,1525,10,N,Y,1448359878707,265791,267089
REMKEL2.txt,452626,454068,1442,10,N,Y,1448359878707,265791,267089
REMKEL2.txt,452783,454110,1327,10,N,Y,1448359878707,265791,267089
REMKEL2.txt,452844,454153,1309,10,N,Y,1448359878707,265791,267089
REMKEL2.txt,453045,454176,1131,10,N,Y,1448359878707,265791,267089
REMKEL2.txt,453242,454195,953,10,N,Y,1448359878707,265791,267089
REMKEL2.txt,453473,454245,772,10,N,Y,1448359878707,265791,267089
REMKEL2.txt,453647,454247,600,10,N,Y,1448359878707,265791,267089
REMKEL2.txt,453962,454297,335,10,N,N,-,-1,-1
REMKEL2.txt,454013,454334,321,10,N,N,-,-1,-1
REMKEL2.txt,454041,454346,305,10,N,N,-,-1,-1
REMKEL2.txt,454073,454373,300,10,N,N,-,-1,-1
REMKEL2.txt,454113,454375,262,10,N,N,-,-1,-1
REMKEL2.txt,454156,454420,264,10,N,N,-,-1,-1
REMKEL2.txt,454179,454422,243,10,N,N,-,-1,-1
REMKEL2.txt,454196,454434,238,10,N,N,-,-1,-1
REMKEL2.txt,454246,454463,217,10,N,N,-,-1,-1
REMKEL2.txt,454250,454591,341,10,N,N,-,-1,-1
REMKEL2.txt,454298,454644,346,10,N,N,-,-1,-1
REMKEL2.txt,454335,454746,411,10,N,N,-,-1,-1
REMKEL2.txt,454349,454766,417,10,N,N,-,-1,-1
REMKEL2.txt,454374,454844,470,10,N,N,-,-1,-1
REMKEL2.txt,454378,454866,488,10,N,N,-,-1,-1
REMKEL2.txt,454421,454868,447,10,N,N,-,-1,-1
REMKEL2.txt,454423,454878,455,10,N,N,-,-1,-1
REMKEL2.txt,454437,454901,464,10,N,N,-,-1,-1
REMKEL2.txt,454466,454931,465,10,N,N,-,-1,-1
REMKEL2.txt,454594,454942,348,10,N,N,-,-1,-1
REMKEL2.txt,454645,454965,320,10,N,N,-,-1,-1
REMKEL2.txt,454748,455024,276,10,N,N,-,-1,-1
REMKEL2.txt,454768,455033,265,10,N,N,-,-1,-1
REMKEL2.txt,454847,455042,195,10,N,N,-,-1,-1
REMKEL2.txt,454867,455053,186,10,N,N,-,-1,-1
REMKEL2.txt,454869,455062,193,10,N,N,-,-1,-1
REMKEL2.txt,454880,455071,191,10,N,N,-,-1,-1
REMKEL2.txt,454902,455080,178,10,N,N,-,-1,-1
REMKEL2.txt,454932,455089,157,10,N,N,-,-1,-1
REMKEL2.txt,454944,455100,156,10,N,N,-,-1,-1
REMKEL2.txt,454966,455109,143,10,N,N,-,-1,-1
REMKEL2.txt,455027,455120,93,10,N,N,-,-1,-1
REMKEL2.txt,455036,455137,101,10,N,N,-,-1,-1
REMKEL2.txt,455043,455155,112,10,N,N,-,-1,-1
REMKEL2.txt,455056,455386,330,10,N,N,-,-1,-1
REMKEL2.txt,455065,455388,323,10,N,N,-,-1,-1
REMKEL2.txt,455074,455416,342,10,N,N,-,-1,-1
REMKEL2.txt,455083,455431,348,10,N,N,-,-1,-1
REMKEL2.txt,455090,455458,368,10,N,N,-,-1,-1
REMKEL2.txt,455103,455471,368,10,N,N,-,-1,-1
REMKEL2.txt,455110,455485,375,10,N,N,-,-1,-1
REMKEL2.txt,455121,455494,373,10,N,N,-,-1,-1
REMKEL2.txt,455140,455496,356,10,N,N,-,-1,-1
REMKEL2.txt,455157,455505,348,10,N,N,-,-1,-1
REMKEL2.txt,455387,455507,120,10,N,N,-,-1,-1
REMKEL2.txt,455389,455516,127,10,N,N,-,-1,-1
REMKEL2.txt,455418,455518,100,10,N,N,-,-1,-1
REMKEL2.txt,455432,455667,235,10,N,N,-,-1,-1
REMKEL2.txt,455460,455700,240,10,N,N,-,-1,-1
REMKEL2.txt,455473,455709,236,10,N,N,-,-1,-1
REMKEL2.txt,455488,455711,223,10,N,N,-,-1,-1
REMKEL2.txt,455495,455724,229,10,N,N,-,-1,-1
REMKEL2.txt,455499,455733,234,10,N,N,-,-1,-1
REMKEL2.txt,455506,455734,228,10,N,N,-,-1,-1
REMKEL2.txt,455510,455736,226,10,N,N,-,-1,-1
REMKEL2.txt,455517,455742,225,10,N,N,-,-1,-1
REMKEL2.txt,455521,455764,243,10,N,N,-,-1,-1
REMKEL2.txt,455668,455910,242,10,N,N,-,-1,-1
REMKEL2.txt,455703,455985,282,10,N,N,-,-1,-1
REMKEL2.txt,455710,456005,295,10,N,N,-,-1,-1
REMKEL2.txt,455713,456023,310,10,N,N,-,-1,-1
REMKEL2.txt,455727,456025,298,10,N,N,-,-1,-1
REMKEL2.txt,455733,456063,330,10,N,N,-,-1,-1
REMKEL2.txt,455735,456065,330,10,N,N,-,-1,-1
REMKEL2.txt,455738,456100,362,10,N,N,-,-1,-1
REMKEL2.txt,455743,456102,359,10,N,N,-,-1,-1
REMKEL2.txt,455767,456169,402,10,N,N,-,-1,-1
REMKEL2.txt,455915,456171,256,10,N,N,-,-1,-1
REMKEL2.txt,455988,456184,196,10,N,N,-,-1,-1
REMKEL2.txt,456008,456203,195,10,N,N,-,-1,-1
REMKEL2.txt,456024,456205,181,10,N,N,-,-1,-1
REMKEL2.txt,456028,456239,211,10,N,N,-,-1,-1
REMKEL2.txt,456064,456277,213,10,N,N,-,-1,-1
REMKEL2.txt,456068,456285,217,10,N,N,-,-1,-1
REMKEL2.txt,456101,456287,186,10,N,N,-,-1,-1
REMKEL2.txt,456105,456303,198,10,N,N,-,-1,-1
REMKEL2.txt,456170,456308,138,10,N,N,-,-1,-1
REMKEL2.txt,456172,456336,164,10,N,N,-,-1,-1
REMKEL2.txt,456186,456350,164,10,N,N,-,-1,-1
REMKEL2.txt,456204,456380,176,10,N,N,-,-1,-1
REMKEL2.txt,456206,456394,188,10,N,N,-,-1,-1
REMKEL2.txt,456242,456435,193,10,N,N,-,-1,-1
REMKEL2.txt,456279,456449,170,10,N,N,-,-1,-1
REMKEL2.txt,456286,456451,165,10,N,N,-,-1,-1
REMKEL2.txt,456289,456460,171,10,N,N,-,-1,-1
REMKEL2.txt,456304,456462,158,10,N,N,-,-1,-1
REMKEL2.txt,456309,456470,161,10,N,N,-,-1,-1
REMKEL2.txt,456339,456472,133,10,N,N,-,-1,-1
REMKEL2.txt,456351,456480,129,10,N,N,-,-1,-1
REMKEL2.txt,456383,456482,99,10,N,N,-,-1,-1
REMKEL2.txt,456395,456495,100,10,N,N,-,-1,-1
REMKEL2.txt,456438,456509,71,10,N,N,-,-1,-1
REMKEL2.txt,456450,456781,331,10,N,N,-,-1,-1
REMKEL2.txt,456454,456800,346,10,N,N,-,-1,-1
REMKEL2.txt,456461,456843,382,10,N,N,-,-1,-1
REMKEL2.txt,456464,456898,434,10,N,N,-,-1,-1
REMKEL2.txt,456471,456910,439,10,N,N,-,-1,-1
REMKEL2.txt,456474,457049,575,10,N,N,-,-1,-1
REMKEL2.txt,456481,457131,650,10,N,N,-,-1,-1
REMKEL2.txt,456484,457140,656,10,N,N,-,-1,-1
REMKEL2.txt,456497,457147,650,10,N,N,-,-1,-1
REMKEL2.txt,456514,457148,634,10,N,N,-,-1,-1
REMKEL2.txt,456782,457161,379,10,N,N,-,-1,-1
REMKEL2.txt,456801,457204,403,10,N,N,-,-1,-1
REMKEL2.txt,456844,457211,367,10,N,N,-,-1,-1
REMKEL2.txt,456899,457213,314,10,N,N,-,-1,-1
REMKEL2.txt,456911,457255,344,10,N,N,-,-1,-1
REMKEL2.txt,457050,457323,273,10,N,N,-,-1,-1
REMKEL2.txt,457132,457325,193,10,N,N,-,-1,-1
REMKEL2.txt,457140,457366,226,10,N,N,-,-1,-1
REMKEL2.txt,457147,457368,221,10,N,N,-,-1,-1
REMKEL2.txt,457149,457408,259,10,N,N,-,-1,-1
REMKEL2.txt,457162,457415,253,10,N,N,-,-1,-1
REMKEL2.txt,457205,457417,212,10,N,N,-,-1,-1
REMKEL2.txt,457212,457464,252,10,N,N,-,-1,-1
REMKEL2.txt,457214,457471,257,10,N,N,-,-1,-1
REMKEL2.txt,457256,457473,217,10,N,N,-,-1,-1
REMKEL2.txt,457324,457511,187,10,N,N,-,-1,-1
REMKEL2.txt,457326,457523,197,10,N,N,-,-1,-1
REMKEL2.txt,457367,457580,213,10,N,N,-,-1,-1
REMKEL2.txt,457369,457618,249,10,N,N,-,-1,-1
REMKEL2.txt,457409,457620,211,10,N,N,-,-1,-1
REMKEL2.txt,457416,457660,244,10,N,N,-,-1,-1
REMKEL2.txt,457418,457674,256,10,N,N,-,-1,-1
REMKEL2.txt,457465,457676,211,10,N,N,-,-1,-1
REMKEL2.txt,457472,457778,306,10,N,N,-,-1,-1
REMKEL2.txt,457474,458038,564,10,N,N,-,-1,-1
REMKEL2.txt,457512,458349,837,10,Y,N,-,-1,-1
REMKEL2.txt,457524,458495,971,10,Y,N,-,-1,-1
REMKEL2.txt,457581,458626,1045,10,Y,N,-,-1,-1
REMKEL2.txt,457619,459043,1424,10,Y,N,-,-1,-1
REMKEL2.txt,457621,459160,1539,10,Y,N,-,-1,-1
REMKEL2.txt,457661,459347,1686,10,Y,N,-,-1,-1
REMKEL2.txt,457675,459518,1843,10,Y,N,-,-1,-1
REMKEL2.txt,457677,459809,2132,10,Y,N,-,-1,-1
REMKEL2.txt,457783,459876,2093,10,N,N,-,-1,-1
REMKEL2.txt,458039,460156,2117,10,N,N,-,-1,-1
REMKEL2.txt,458350,460298,1948,10,N,N,-,-1,-1
REMKEL2.txt,458498,460466,1968,10,N,N,-,-1,-1
REMKEL2.txt,458627,460513,1886,10,N,N,-,-1,-1
REMKEL2.txt,459046,460717,1671,10,N,N,-,-1,-1
REMKEL2.txt,459161,460820,1659,10,N,N,-,-1,-1
REMKEL2.txt,459348,461062,1714,10,N,N,-,-1,-1
REMKEL2.txt,459520,461280,1760,10,N,N,-,-1,-1
REMKEL2.txt,459812,461578,1766,10,N,N,-,-1,-1
REMKEL2.txt,459877,461764,1887,10,N,Y,1448396118064,295199,297352
REMKEL2.txt,460157,461783,1626,10,N,Y,1448396118064,295199,297352
REMKEL2.txt,460299,461972,1673,10,N,Y,1448396118064,295199,297352
REMKEL2.txt,460467,462157,1690,10,N,Y,1448396118064,295199,297352
REMKEL2.txt,460514,462565,2051,10,N,Y,1448396118064,295199,297352
REMKEL2.txt,460720,462697,1977,10,N,Y,1448396118064,295199,297352
REMKEL2.txt,460822,462914,2092,10,N,Y,1448396118064,295199,297352
REMKEL2.txt,461063,463050,1987,10,N,Y,1448396118064,295199,297352
REMKEL2.txt,461282,463252,1970,10,N,Y,1448396118064,295199,297352
REMKEL2.txt,461581,463592,2011,10,N,Y,1448396118064,295199,297352
REMKEL2.txt,461769,464097,2328,10,N,Y,1448396118064,295199,297352
REMKEL2.txt,461784,464317,2533,10,Y,Y,1448396118064,295199,297352
REMKEL2.txt,461975,464355,2380,10,Y,Y,1448396118064,295199,297352
REMKEL2.txt,462159,464398,2239,10,Y,Y,1448396118064,295199,297352
REMKEL2.txt,462566,464429,1863,10,Y,Y,1448396118064,295199,297352
REMKEL2.txt,462700,464495,1795,10,Y,Y,1448396118064,295199,297352
REMKEL2.txt,462915,464522,1607,10,Y,Y,1448396118064,295199,297352
REMKEL2.txt,463051,464553,1502,10,Y,Y,1448396118064,295199,297352
REMKEL2.txt,463253,464571,1318,10,N,Y,1448396118064,295199,297352
REMKEL2.txt,463595,464828,1233,10,N,Y,1448396118064,295199,297352
REMKEL2.txt,464098,465097,999,10,N,Y,1448396118064,295199,297352
REMKEL2.txt,464318,465131,813,10,N,Y,1448396118064,295199,297352
REMKEL2.txt,464356,465368,1012,10,N,Y,1448396118064,295199,297352
REMKEL2.txt,464399,465519,1120,10,N,Y,1448396118064,295199,297352
REMKEL2.txt,464430,466078,1648,10,N,Y,1448396118064,295199,297352
REMKEL2.txt,464496,466214,1718,10,N,Y,1448396118064,295199,297352
REMKEL2.txt,464525,466360,1835,10,N,Y,1448396118064,295199,297352
REMKEL2.txt,464554,466657,2103,10,N,Y,1448396118064,295199,297352
REMKEL2.txt,464574,466733,2159,10,N,Y,1448396118064,295199,297352
REMKEL2.txt,464831,466797,1966,10,N,Y,1448396118064,295199,297352
REMKEL2.txt,465098,466930,1832,10,N,Y,1448396118064,295199,297352
REMKEL2.txt,465132,467380,2248,10,N,Y,1448396118064,295199,297352
REMKEL2.txt,465369,467388,2019,10,N,N,-,-1,-1
REMKEL2.txt,465522,467391,1869,10,N,N,-,-1,-1
REMKEL2.txt,466081,467437,1356,10,N,N,-,-1,-1
REMKEL2.txt,466217,467733,1516,10,N,N,-,-1,-1
REMKEL2.txt,466363,468489,2126,10,Y,N,-,-1,-1
REMKEL2.txt,466660,468530,1870,10,Y,N,-,-1,-1
REMKEL2.txt,466736,468883,2147,10,Y,N,-,-1,-1
REMKEL2.txt,466798,469064,2266,10,Y,N,-,-1,-1
REMKEL2.txt,466933,469288,2355,10,Y,N,-,-1,-1
REMKEL2.txt,467385,469473,2088,10,N,N,-,-1,-1
REMKEL2.txt,467388,469706,2318,10,Y,N,-,-1,-1
REMKEL2.txt,467392,469824,2432,10,N,N,-,-1,-1
REMKEL2.txt,467442,469979,2537,10,N,N,-,-1,-1
REMKEL2.txt,467738,470086,2348,10,N,N,-,-1,-1
REMKEL2.txt,468490,470195,1705,10,N,N,-,-1,-1
REMKEL2.txt,468533,470336,1803,10,N,N,-,-1,-1
REMKEL2.txt,468884,470457,1573,10,N,N,-,-1,-1
REMKEL2.txt,469065,471205,2140,10,N,N,-,-1,-1
REMKEL2.txt,469289,471614,2325,10,N,N,-,-1,-1
REMKEL2.txt,469475,471629,2154,10,N,N,-,-1,-1
REMKEL2.txt,469708,471635,1927,10,N,N,-,-1,-1
REMKEL2.txt,469827,471639,1812,10,N,N,-,-1,-1
REMKEL2.txt,469980,471660,1680,10,N,N,-,-1,-1
REMKEL2.txt,470087,471918,1831,10,N,N,-,-1,-1
REMKEL2.txt,470196,472133,1937,10,N,N,-,-1,-1
REMKEL2.txt,470337,472334,1997,10,N,N,-,-1,-1
REMKEL2.txt,470458,472486,2028,10,N,N,-,-1,-1
REMKEL2.txt,471206,472597,1391,10,Y,N,-,-1,-1
REMKEL2.txt,471615,472753,1138,10,N,N,-,-1,-1
REMKEL2.txt,471631,472822,1191,10,N,N,-,-1,-1
REMKEL2.txt,471636,472895,1259,10,N,N,-,-1,-1
REMKEL2.txt,471640,473108,1468,10,N,N,-,-1,-1
REMKEL2.txt,471663,473286,1623,10,N,N,-,-1,-1
REMKEL2.txt,471919,473540,1621,10,N,N,-,-1,-1
REMKEL2.txt,472134,473789,1655,10,Y,N,-,-1,-1
REMKEL2.txt,472335,474246,1911,10,Y,N,-,-1,-1
REMKEL2.txt,472488,474342,1854,10,Y,N,-,-1,-1
REMKEL2.txt,472599,474418,1819,10,Y,N,-,-1,-1
REMKEL2.txt,472754,474545,1791,10,Y,N,-,-1,-1
REMKEL2.txt,472822,474675,1853,10,Y,N,-,-1,-1
REMKEL2.txt,472896,474711,1815,10,Y,N,-,-1,-1
REMKEL2.txt,473109,474876,1767,10,Y,N,-,-1,-1
REMKEL2.txt,473287,474942,1655,10,N,N,-,-1,-1
REMKEL2.txt,473541,474989,1448,10,N,N,-,-1,-1
REMKEL2.txt,473790,475017,1227,10,N,N,-,-1,-1
REMKEL2.txt,474247,475025,778,10,N,N,-,-1,-1
REMKEL2.txt,474343,475088,745,10,N,N,-,-1,-1
REMKEL2.txt,474419,475657,1238,10,N,N,-,-1,-1
REMKEL2.txt,474546,475676,1130,10,N,N,-,-1,-1
REMKEL2.txt,474676,475695,1019,10,N,N,-,-1,-1
REMKEL2.txt,474712,475704,992,10,N,N,-,-1,-1
REMKEL2.txt,474879,475710,831,10,N,N,-,-1,-1
REMKEL2.txt,474943,475712,769,10,N,N,-,-1,-1
REMKEL2.txt,474990,475724,734,10,N,N,-,-1,-1
REMKEL2.txt,475020,475726,706,10,N,N,-,-1,-1
REMKEL2.txt,475026,475728,702,10,N,N,-,-1,-1
REMKEL2.txt,475089,475754,665,10,N,N,-,-1,-1
REMKEL2.txt,475658,475983,325,10,N,N,-,-1,-1
REMKEL2.txt,475677,476141,464,10,N,N,-,-1,-1
REMKEL2.txt,475697,476361,664,10,N,N,-,-1,-1
REMKEL2.txt,475705,476406,701,10,N,N,-,-1,-1
REMKEL2.txt,475711,476478,767,10,N,N,-,-1,-1
REMKEL2.txt,475713,476559,846,10,N,N,-,-1,-1
REMKEL2.txt,475725,476822,1097,10,N,N,-,-1,-1
REMKEL2.txt,475727,476870,1143,10,N,N,-,-1,-1
REMKEL2.txt,475729,476888,1159,10,N,N,-,-1,-1
REMKEL2.txt,475756,476904,1148,10,N,N,-,-1,-1
REMKEL2.txt,475984,476978,994,10,N,N,-,-1,-1
REMKEL2.txt,476142,477054,912,10,N,N,-,-1,-1
REMKEL2.txt,476362,477088,726,10,N,N,-,-1,-1
REMKEL2.txt,476407,477262,855,10,N,N,-,-1,-1
REMKEL2.txt,476480,477353,873,10,N,N,-,-1,-1
REMKEL2.txt,476560,477357,797,10,N,N,-,-1,-1
REMKEL2.txt,476823,477392,569,10,N,N,-,-1,-1
REMKEL2.txt,476871,477410,539,10,N,N,-,-1,-1
REMKEL2.txt,476889,477507,618,10,N,N,-,-1,-1
REMKEL2.txt,476906,477533,627,10,N,N,-,-1,-1
REMKEL2.txt,476979,477554,575,10,N,N,-,-1,-1
REMKEL2.txt,477055,477655,600,10,N,N,-,-1,-1
REMKEL2.txt,477089,477699,610,10,N,N,-,-1,-1
REMKEL2.txt,477263,477729,466,10,N,N,-,-1,-1
REMKEL2.txt,477354,477734,380,10,N,N,-,-1,-1
REMKEL2.txt,477358,477738,380,10,N,N,-,-1,-1
REMKEL2.txt,477393,477880,487,10,N,N,-,-1,-1
REMKEL2.txt,477411,477898,487,10,N,N,-,-1,-1
REMKEL2.txt,477508,477908,400,10,N,N,-,-1,-1
REMKEL2.txt,477535,477931,396,10,N,N,-,-1,-1
REMKEL2.txt,477555,477935,380,10,N,N,-,-1,-1
REMKEL2.txt,477656,477955,299,10,N,N,-,-1,-1
REMKEL2.txt,477700,477959,259,10,N,N,-,-1,-1
REMKEL2.txt,477730,477983,253,10,N,N,-,-1,-1
REMKEL2.txt,477735,477989,254,10,N,N,-,-1,-1
REMKEL2.txt,477741,478169,428,10,N,N,-,-1,-1
REMKEL2.txt,477885,478233,348,10,N,N,-,-1,-1
REMKEL2.txt,477901,478343,442,10,N,N,-,-1,-1
REMKEL2.txt,477909,478351,442,10,N,N,-,-1,-1
REMKEL2.txt,477932,478549,617,10,N,N,-,-1,-1
REMKEL2.txt,477936,478912,976,10,N,N,-,-1,-1
REMKEL2.txt,477956,478985,1029,10,N,N,-,-1,-1
REMKEL2.txt,477961,479003,1042,10,N,N,-,-1,-1
REMKEL2.txt,477984,479136,1152,10,N,N,-,-1,-1
REMKEL2.txt,477990,479436,1446,10,N,N,-,-1,-1
REMKEL2.txt,478171,479613,1442,10,N,N,-,-1,-1
REMKEL2.txt,478234,479649,1415,10,N,N,-,-1,-1
REMKEL2.txt,478344,479663,1319,10,N,N,-,-1,-1
REMKEL2.txt,478352,479687,1335,10,N,N,-,-1,-1
REMKEL2.txt,478550,479873,1323,10,N,N,-,-1,-1
REMKEL2.txt,478913,479947,1034,10,N,N,-,-1,-1
REMKEL2.txt,478986,480060,1074,10,N,N,-,-1,-1
REMKEL2.txt,479006,480202,1196,10,Y,N,-,-1,-1
REMKEL2.txt,479137,480281,1144,10,Y,N,-,-1,-1
REMKEL2.txt,479438,480554,1116,10,N,N,-,-1,-1
REMKEL2.txt,479614,480702,1088,10,N,N,-,-1,-1
REMKEL2.txt,479654,480761,1107,10,N,N,-,-1,-1
REMKEL2.txt,479664,480864,1200,10,N,N,-,-1,-1
REMKEL2.txt,479688,480898,1210,10,N,N,-,-1,-1
REMKEL2.txt,479874,480939,1065,10,N,N,-,-1,-1
REMKEL2.txt,479948,480949,1001,10,N,N,-,-1,-1
REMKEL2.txt,480061,480957,896,10,N,N,-,-1,-1
REMKEL2.txt,480204,480971,767,10,N,N,-,-1,-1
REMKEL2.txt,480282,480975,693,10,N,N,-,-1,-1
REMKEL2.txt,480555,480984,429,10,N,N,-,-1,-1
REMKEL2.txt,480703,480988,285,10,N,N,-,-1,-1
REMKEL2.txt,480762,481063,301,10,N,N,-,-1,-1
REMKEL2.txt,480865,481074,209,10,N,N,-,-1,-1
REMKEL2.txt,480899,481107,208,10,N,N,-,-1,-1
REMKEL2.txt,480940,481136,196,10,N,N,-,-1,-1
REMKEL2.txt,480950,481162,212,10,N,N,-,-1,-1
REMKEL2.txt,480958,481279,321,10,N,N,-,-1,-1
REMKEL2.txt,480972,481360,388,10,N,N,-,-1,-1
REMKEL2.txt,480976,481403,427,10,N,N,-,-1,-1
REMKEL2.txt,480985,481593,608,10,N,N,-,-1,-1
REMKEL2.txt,480989,481663,674,10,N,N,-,-1,-1
REMKEL2.txt,481064,481756,692,10,N,N,-,-1,-1
REMKEL2.txt,481076,481896,820,10,N,N,-,-1,-1
REMKEL2.txt,481108,482060,952,10,N,N,-,-1,-1
REMKEL2.txt,481139,482422,1283,10,N,N,-,-1,-1
REMKEL2.txt,481163,482655,1492,10,N,N,-,-1,-1
REMKEL2.txt,481280,482726,1446,10,N,N,-,-1,-1
REMKEL2.txt,481361,482779,1418,10,N,N,-,-1,-1
REMKEL2.txt,481404,482975,1571,10,N,N,-,-1,-1
REMKEL2.txt,481594,483073,1479,10,N,N,-,-1,-1
REMKEL2.txt,481665,483255,1590,10,N,N,-,-1,-1
REMKEL2.txt,481757,483444,1687,10,N,N,-,-1,-1
REMKEL2.txt,481897,483543,1646,10,N,N,-,-1,-1
REMKEL2.txt,482061,484073,2012,10,N,N,-,-1,-1
REMKEL2.txt,482423,484298,1875,10,N,N,-,-1,-1
REMKEL2.txt,482657,484424,1767,10,N,N,-,-1,-1
REMKEL2.txt,482727,484447,1720,10,N,N,-,-1,-1
REMKEL2.txt,482780,484475,1695,10,N,N,-,-1,-1
REMKEL2.txt,482976,484521,1545,10,N,N,-,-1,-1
REMKEL2.txt,483074,484677,1603,10,N,N,-,-1,-1
REMKEL2.txt,483256,484802,1546,10,N,N,-,-1,-1
REMKEL2.txt,483445,484925,1480,10,N,N,-,-1,-1
REMKEL2.txt,483545,485188,1643,10,N,N,-,-1,-1
REMKEL2.txt,484074,485356,1282,10,N,N,-,-1,-1
REMKEL2.txt,484299,485448,1149,10,N,N,-,-1,-1
REMKEL2.txt,484427,485580,1153,10,N,N,-,-1,-1
REMKEL2.txt,484450,485881,1431,10,N,N,-,-1,-1
REMKEL2.txt,484476,485954,1478,10,N,N,-,-1,-1
REMKEL2.txt,484522,486045,1523,10,N,N,-,-1,-1
REMKEL2.txt,484678,486120,1442,10,N,N,-,-1,-1
REMKEL2.txt,484803,486328,1525,10,N,N,-,-1,-1
REMKEL2.txt,484926,486385,1459,10,N,N,-,-1,-1
REMKEL2.txt,485189,486588,1399,10,N,N,-,-1,-1
REMKEL2.txt,485357,486811,1454,10,N,N,-,-1,-1
REMKEL2.txt,485449,486927,1478,10,N,N,-,-1,-1
REMKEL2.txt,485581,486997,1416,10,N,N,-,-1,-1
REMKEL2.txt,485882,487040,1158,10,N,N,-,-1,-1
REMKEL2.txt,485955,487044,1089,10,N,N,-,-1,-1
REMKEL2.txt,486046,487048,1002,10,N,N,-,-1,-1
REMKEL2.txt,486121,487153,1032,10,N,N,-,-1,-1
REMKEL2.txt,486329,487201,872,10,N,N,-,-1,-1
REMKEL2.txt,486386,487304,918,10,N,N,-,-1,-1
REMKEL2.txt,486589,487484,895,10,N,N,-,-1,-1
REMKEL2.txt,486812,487873,1061,10,N,N,-,-1,-1
REMKEL2.txt,486929,487979,1050,10,N,N,-,-1,-1
REMKEL2.txt,486998,488013,1015,10,N,N,-,-1,-1
REMKEL2.txt,487041,488019,978,10,N,N,-,-1,-1
REMKEL2.txt,487045,488070,1025,10,N,N,-,-1,-1
REMKEL2.txt,487049,488076,1027,10,N,N,-,-1,-1
REMKEL2.txt,487154,488259,1105,10,N,N,-,-1,-1
REMKEL2.txt,487204,488263,1059,10,N,N,-,-1,-1
REMKEL2.txt,487305,488318,1013,10,N,N,-,-1,-1
REMKEL2.txt,487485,488527,1042,10,N,N,-,-1,-1
REMKEL2.txt,487874,488800,926,10,N,N,-,-1,-1
REMKEL2.txt,487980,489003,1023,10,N,N,-,-1,-1
REMKEL2.txt,488014,489163,1149,10,N,N,-,-1,-1
REMKEL2.txt,488020,489367,1347,10,N,N,-,-1,-1
REMKEL2.txt,488071,489428,1357,10,N,N,-,-1,-1
REMKEL2.txt,488077,489656,1579,10,N,N,-,-1,-1
REMKEL2.txt,488260,489689,1429,10,N,N,-,-1,-1
REMKEL2.txt,488264,489841,1577,10,N,N,-,-1,-1
REMKEL2.txt,488319,489895,1576,10,N,N,-,-1,-1
REMKEL2.txt,488529,489901,1372,10,N,N,-,-1,-1
REMKEL2.txt,488801,489909,1108,10,N,N,-,-1,-1
REMKEL2.txt,489004,489914,910,10,N,N,-,-1,-1
REMKEL2.txt,489165,489918,753,10,N,N,-,-1,-1
REMKEL2.txt,489368,490003,635,10,N,N,-,-1,-1
REMKEL2.txt,489429,490133,704,10,N,N,-,-1,-1
REMKEL2.txt,489656,490238,582,10,N,N,-,-1,-1
REMKEL2.txt,489690,490259,569,10,N,N,-,-1,-1
REMKEL2.txt,489842,490397,555,10,N,N,-,-1,-1
REMKEL2.txt,489898,490484,586,10,N,N,-,-1,-1
REMKEL2.txt,489902,490636,734,10,N,N,-,-1,-1
REMKEL2.txt,489910,490748,838,10,N,N,-,-1,-1
REMKEL2.txt,489915,490933,1018,10,N,N,-,-1,-1
REMKEL2.txt,489919,491102,1183,10,N,N,-,-1,-1
REMKEL2.txt,490005,491185,1180,10,N,N,-,-1,-1
REMKEL2.txt,490134,491405,1271,10,N,N,-,-1,-1
REMKEL2.txt,490239,491473,1234,10,N,N,-,-1,-1
REMKEL2.txt,490260,491556,1296,10,N,N,-,-1,-1
REMKEL2.txt,490398,491562,1164,10,N,N,-,-1,-1
REMKEL2.txt,490486,491742,1256,10,N,N,-,-1,-1
REMKEL2.txt,490637,491869,1232,10,N,N,-,-1,-1
REMKEL2.txt,490750,491940,1190,10,N,N,-,-1,-1
REMKEL2.txt,490934,491989,1055,10,N,N,-,-1,-1
REMKEL2.txt,491103,492109,1006,10,N,N,-,-1,-1
REMKEL2.txt,491186,492183,997,10,N,N,-,-1,-1
REMKEL2.txt,491406,492415,1009,10,N,N,-,-1,-1
REMKEL2.txt,491476,492464,988,10,N,N,-,-1,-1
REMKEL2.txt,491557,492471,914,10,N,N,-,-1,-1
REMKEL2.txt,491563,492709,1146,10,N,N,-,-1,-1
REMKEL2.txt,491744,492875,1131,10,N,N,-,-1,-1
REMKEL2.txt,491870,493024,1154,10,N,N,-,-1,-1
REMKEL2.txt,491941,493038,1097,10,N,N,-,-1,-1
REMKEL2.txt,491990,493238,1248,10,N,N,-,-1,-1
REMKEL2.txt,492110,493408,1298,10,N,N,-,-1,-1
REMKEL2.txt,492184,493511,1327,10,N,N,-,-1,-1
REMKEL2.txt,492416,493606,1190,10,N,N,-,-1,-1
REMKEL2.txt,492465,493795,1330,10,N,N,-,-1,-1
REMKEL2.txt,492472,493805,1333,10,N,N,-,-1,-1
REMKEL2.txt,492710,493813,1103,10,N,N,-,-1,-1
REMKEL2.txt,492876,493873,997,10,N,N,-,-1,-1
REMKEL2.txt,493029,493940,911,10,N,N,-,-1,-1
REMKEL2.txt,493039,494130,1091,10,N,N,-,-1,-1
REMKEL2.txt,493239,494168,929,10,N,N,-,-1,-1
REMKEL2.txt,493409,494398,989,10,N,N,-,-1,-1
REMKEL2.txt,493512,494562,1050,10,N,N,-,-1,-1
REMKEL2.txt,493607,494695,1088,10,N,N,-,-1,-1
REMKEL2.txt,493796,494808,1012,10,N,N,-,-1,-1
REMKEL2.txt,493806,495000,1194,10,N,N,-,-1,-1
REMKEL2.txt,493815,495186,1371,10,N,N,-,-1,-1
REMKEL2.txt,493874,495477,1603,10,N,N,-,-1,-1
REMKEL2.txt,493941,495652,1711,10,N,N,-,-1,-1
REMKEL2.txt,494132,495829,1697,10,N,N,-,-1,-1
REMKEL2.txt,494169,496149,1980,10,N,N,-,-1,-1
REMKEL2.txt,494399,496319,1920,10,N,N,-,-1,-1
REMKEL2.txt,494563,496406,1843,10,N,N,-,-1,-1
REMKEL2.txt,494700,496771,2071,10,N,N,-,-1,-1
REMKEL2.txt,494809,496785,1976,10,N,N,-,-1,-1
REMKEL2.txt,495001,496850,1849,10,N,N,-,-1,-1
REMKEL2.txt,495188,497013,1825,10,N,N,-,-1,-1
REMKEL2.txt,495478,497050,1572,10,N,N,-,-1,-1
REMKEL2.txt,495653,497151,1498,10,N,N,-,-1,-1
REMKEL2.txt,495831,497320,1489,10,N,N,-,-1,-1
REMKEL2.txt,496150,497327,1177,10,N,N,-,-1,-1
REMKEL2.txt,496320,497453,1133,10,N,N,-,-1,-1
REMKEL2.txt,496407,497477,1070,10,N,N,-,-1,-1
REMKEL2.txt,496776,497510,734,10,N,N,-,-1,-1
REMKEL2.txt,496786,497656,870,10,N,N,-,-1,-1
REMKEL2.txt,496851,497745,894,10,N,N,-,-1,-1
REMKEL2.txt,497014,497844,830,10,N,N,-,-1,-1
REMKEL2.txt,497051,498133,1082,10,N,N,-,-1,-1
REMKEL2.txt,497152,498445,1293,10,N,N,-,-1,-1
REMKEL2.txt,497321,498463,1142,10,N,N,-,-1,-1
REMKEL2.txt,497328,498614,1286,10,N,N,-,-1,-1
REMKEL2.txt,497454,498757,1303,10,N,N,-,-1,-1
REMKEL2.txt,497479,498761,1282,10,N,N,-,-1,-1
REMKEL2.txt,497511,498767,1256,10,N,N,-,-1,-1
REMKEL2.txt,497657,498780,1123,10,N,N,-,-1,-1
REMKEL2.txt,497746,498948,1202,10,N,N,-,-1,-1
REMKEL2.txt,497846,499124,1278,10,N,N,-,-1,-1
REMKEL2.txt,498134,499191,1057,10,N,N,-,-1,-1
REMKEL2.txt,498450,499274,824,10,N,N,-,-1,-1
REMKEL2.txt,498466,499299,833,10,N,N,-,-1,-1
REMKEL2.txt,498615,499460,845,10,N,N,-,-1,-1
REMKEL2.txt,498758,499578,820,10,N,N,-,-1,-1
REMKEL2.txt,498762,499835,1073,10,N,N,-,-1,-1
REMKEL2.txt,498768,499843,1075,10,N,N,-,-1,-1
REMKEL2.txt,498781,500003,1222,10,N,N,-,-1,-1
REMKEL2.txt,498949,500066,1117,10,N,N,-,-1,-1
REMKEL2.txt,499127,500167,1040,10,N,N,-,-1,-1
REMKEL2.txt,499192,500175,983,10,N,N,-,-1,-1
REMKEL2.txt,499275,500230,955,10,N,N,-,-1,-1
REMKEL2.txt,499300,500268,968,10,N,N,-,-1,-1
REMKEL2.txt,499461,500272,811,10,N,N,-,-1,-1
REMKEL2.txt,499579,500280,701,10,N,N,-,-1,-1
REMKEL2.txt,499836,500298,462,10,N,N,-,-1,-1
REMKEL2.txt,499844,500307,463,10,N,N,-,-1,-1
REMKEL2.txt,500004,500351,347,10,N,N,-,-1,-1
REMKEL2.txt,500068,500395,327,10,N,N,-,-1,-1
REMKEL2.txt,500168,500573,405,10,N,N,-,-1,-1
REMKEL2.txt,500176,500679,503,10,N,N,-,-1,-1
REMKEL2.txt,500232,500731,499,10,N,N,-,-1,-1
REMKEL2.txt,500269,500746,477,10,N,N,-,-1,-1
REMKEL2.txt,500273,500750,477,10,N,N,-,-1,-1
REMKEL2.txt,500281,500758,477,10,N,N,-,-1,-1
REMKEL2.txt,500299,500824,525,10,N,N,-,-1,-1
REMKEL2.txt,500308,500831,523,10,N,N,-,-1,-1
REMKEL2.txt,500352,500888,536,10,N,N,-,-1,-1
REMKEL2.txt,500397,500894,497,10,N,N,-,-1,-1
REMKEL2.txt,500574,500910,336,10,N,N,-,-1,-1
REMKEL2.txt,500680,500962,282,10,N,N,-,-1,-1
REMKEL2.txt,500732,501146,414,10,N,N,-,-1,-1
REMKEL2.txt,500747,501195,448,10,N,N,-,-1,-1
REMKEL2.txt,500751,501282,531,10,N,N,-,-1,-1
REMKEL2.txt,500759,501409,650,10,N,N,-,-1,-1
REMKEL2.txt,500826,501562,736,10,N,N,-,-1,-1
REMKEL2.txt,500832,501580,748,10,N,N,-,-1,-1
REMKEL2.txt,500889,501596,707,10,N,N,-,-1,-1
REMKEL2.txt,500895,501689,794,10,N,N,-,-1,-1
REMKEL2.txt,500911,501697,786,10,N,N,-,-1,-1
REMKEL2.txt,500963,501738,775,10,N,N,-,-1,-1
REMKEL2.txt,501148,501755,607,10,N,N,-,-1,-1
REMKEL2.txt,501196,501761,565,10,N,N,-,-1,-1
REMKEL2.txt,501283,501837,554,10,N,N,-,-1,-1
REMKEL2.txt,501410,501847,437,10,N,N,-,-1,-1
REMKEL2.txt,501567,501915,348,10,N,N,-,-1,-1
REMKEL2.txt,501583,501921,338,10,N,N,-,-1,-1
REMKEL2.txt,501597,502034,437,10,N,N,-,-1,-1
REMKEL2.txt,501692,502039,347,10,N,N,-,-1,-1
REMKEL2.txt,501698,502043,345,10,N,N,-,-1,-1
REMKEL2.txt,501740,502051,311,10,N,N,-,-1,-1
REMKEL2.txt,501756,502057,301,10,N,N,-,-1,-1
REMKEL2.txt,501762,502096,334,10,N,N,-,-1,-1
REMKEL2.txt,501838,502103,265,10,N,N,-,-1,-1
REMKEL2.txt,501849,502149,300,10,N,N,-,-1,-1
REMKEL2.txt,501916,502155,239,10,N,N,-,-1,-1
REMKEL2.txt,501922,502258,336,10,N,N,-,-1,-1
REMKEL2.txt,502035,502264,229,10,N,N,-,-1,-1
REMKEL2.txt,502040,502298,258,10,N,N,-,-1,-1
REMKEL2.txt,502044,502304,260,10,N,N,-,-1,-1
REMKEL2.txt,502052,502342,290,10,N,N,-,-1,-1
REMKEL2.txt,502059,502408,349,10,N,N,-,-1,-1
REMKEL2.txt,502097,502419,322,10,N,N,-,-1,-1
REMKEL2.txt,502104,502423,319,10,N,N,-,-1,-1
REMKEL2.txt,502150,502432,282,10,N,N,-,-1,-1
REMKEL2.txt,502156,502447,291,10,N,N,-,-1,-1
REMKEL2.txt,502259,502467,208,10,N,N,-,-1,-1
REMKEL2.txt,502265,502561,296,10,N,N,-,-1,-1
REMKEL2.txt,502299,502568,269,10,N,N,-,-1,-1
REMKEL2.txt,502305,502636,331,10,N,N,-,-1,-1
REMKEL2.txt,502343,502642,299,10,N,N,-,-1,-1
REMKEL2.txt,502409,502689,280,10,N,N,-,-1,-1
REMKEL2.txt,502420,502699,279,10,N,N,-,-1,-1
REMKEL2.txt,502424,502795,371,10,N,N,-,-1,-1
REMKEL2.txt,502433,502903,470,10,N,N,-,-1,-1
REMKEL2.txt,502448,502910,462,10,N,N,-,-1,-1
REMKEL2.txt,502468,502944,476,10,N,N,-,-1,-1
REMKEL2.txt,502562,502971,409,10,N,N,-,-1,-1
REMKEL2.txt,502569,503011,442,10,N,N,-,-1,-1
REMKEL2.txt,502637,503017,380,10,N,N,-,-1,-1
REMKEL2.txt,502644,503084,440,10,N,N,-,-1,-1
REMKEL2.txt,502691,503119,428,10,N,N,-,-1,-1
REMKEL2.txt,502700,503150,450,10,N,N,-,-1,-1
REMKEL2.txt,502796,503234,438,10,N,N,-,-1,-1
REMKEL2.txt,502905,503240,335,10,N,N,-,-1,-1
REMKEL2.txt,502911,503702,791,10,N,N,-,-1,-1
REMKEL2.txt,502945,503934,989,10,N,N,-,-1,-1
REMKEL2.txt,502972,504039,1067,10,N,N,-,-1,-1
REMKEL2.txt,503012,504254,1242,10,N,N,-,-1,-1
REMKEL2.txt,503018,504353,1335,10,N,N,-,-1,-1
REMKEL2.txt,503085,504473,1388,10,N,N,-,-1,-1
REMKEL2.txt,503120,504537,1417,10,N,N,-,-1,-1
REMKEL2.txt,503151,504695,1544,10,N,N,-,-1,-1
REMKEL2.txt,503235,504713,1478,10,N,N,-,-1,-1
REMKEL2.txt,503241,504721,1480,10,N,N,-,-1,-1
REMKEL2.txt,503703,504820,1117,10,N,N,-,-1,-1
REMKEL2.txt,503935,504960,1025,10,N,N,-,-1,-1
REMKEL2.txt,504040,505188,1148,10,N,N,-,-1,-1
REMKEL2.txt,504255,505319,1064,10,N,N,-,-1,-1
REMKEL2.txt,504354,505466,1112,10,N,N,-,-1,-1
REMKEL2.txt,504474,505547,1073,10,N,N,-,-1,-1
REMKEL2.txt,504539,505751,1212,10,N,N,-,-1,-1
REMKEL2.txt,504700,505840,1140,10,N,N,-,-1,-1
REMKEL2.txt,504716,506053,1337,10,N,N,-,-1,-1
REMKEL2.txt,504722,506266,1544,10,N,N,-,-1,-1
REMKEL2.txt,504821,506284,1463,10,N,N,-,-1,-1
REMKEL2.txt,504961,506313,1352,10,N,N,-,-1,-1
REMKEL2.txt,505190,506450,1260,10,N,N,-,-1,-1
REMKEL2.txt,505320,506630,1310,10,N,N,-,-1,-1
REMKEL2.txt,505467,506664,1197,10,N,N,-,-1,-1
REMKEL2.txt,505548,506674,1126,10,N,N,-,-1,-1
REMKEL2.txt,505752,506835,1083,10,N,N,-,-1,-1
REMKEL2.txt,505841,506868,1027,10,N,N,-,-1,-1
REMKEL2.txt,506054,506977,923,10,N,N,-,-1,-1
REMKEL2.txt,506269,507051,782,10,N,N,-,-1,-1
REMKEL2.txt,506285,507099,814,10,N,N,-,-1,-1
REMKEL2.txt,506314,507105,791,10,N,N,-,-1,-1
REMKEL2.txt,506451,507194,743,10,N,N,-,-1,-1
REMKEL2.txt,506631,507203,572,10,N,N,-,-1,-1
REMKEL2.txt,506666,507237,571,10,N,N,-,-1,-1
REMKEL2.txt,506675,507359,684,10,N,N,-,-1,-1
REMKEL2.txt,506836,507397,561,10,N,N,-,-1,-1
REMKEL2.txt,506870,507606,736,10,N,N,-,-1,-1
REMKEL2.txt,506978,507695,717,10,N,N,-,-1,-1
REMKEL2.txt,507052,507706,654,10,N,N,-,-1,-1
REMKEL2.txt,507100,507844,744,10,N,N,-,-1,-1
REMKEL2.txt,507106,508064,958,10,N,N,-,-1,-1
REMKEL2.txt,507196,508095,899,10,N,N,-,-1,-1
REMKEL2.txt,507204,508173,969,10,N,N,-,-1,-1
REMKEL2.txt,507238,508214,976,10,N,N,-,-1,-1
REMKEL2.txt,507360,508325,965,10,N,N,-,-1,-1
REMKEL2.txt,507398,508333,935,10,N,N,-,-1,-1
REMKEL2.txt,507607,508355,748,10,N,N,-,-1,-1
REMKEL2.txt,507696,508375,679,10,N,N,-,-1,-1
REMKEL2.txt,507707,508384,677,10,N,N,-,-1,-1
REMKEL2.txt,507847,508407,560,10,N,N,-,-1,-1
REMKEL2.txt,508066,508520,454,10,N,N,-,-1,-1
REMKEL2.txt,508096,508533,437,10,N,N,-,-1,-1
REMKEL2.txt,508175,508539,364,10,N,N,-,-1,-1
REMKEL2.txt,508215,508561,346,10,N,N,-,-1,-1
REMKEL2.txt,508328,508781,453,10,N,N,-,-1,-1
REMKEL2.txt,508334,508857,523,10,N,N,-,-1,-1
REMKEL2.txt,508356,508992,636,10,N,N,-,-1,-1
REMKEL2.txt,508377,509113,736,10,N,N,-,-1,-1
REMKEL2.txt,508385,509191,806,10,N,N,-,-1,-1
REMKEL2.txt,508408,509266,858,10,N,N,-,-1,-1
REMKEL2.txt,508521,509342,821,10,N,N,-,-1,-1
REMKEL2.txt,508534,509414,880,10,N,N,-,-1,-1
REMKEL2.txt,508541,509428,887,10,N,N,-,-1,-1
REMKEL2.txt,508562,509462,900,10,N,N,-,-1,-1
REMKEL2.txt,508782,509571,789,10,N,N,-,-1,-1
REMKEL2.txt,508858,509618,760,10,N,N,-,-1,-1
REMKEL2.txt,508993,509624,631,10,N,N,-,-1,-1
REMKEL2.txt,509114,509684,570,10,N,N,-,-1,-1
REMKEL2.txt,509192,509774,582,10,N,N,-,-1,-1
REMKEL2.txt,509267,509813,546,10,N,N,-,-1,-1
REMKEL2.txt,509343,510009,666,10,N,N,-,-1,-1
REMKEL2.txt,509419,510104,685,10,N,N,-,-1,-1
REMKEL2.txt,509429,510163,734,10,N,N,-,-1,-1
REMKEL2.txt,509463,510284,821,10,N,N,-,-1,-1
REMKEL2.txt,509572,510291,719,10,N,N,-,-1,-1
REMKEL2.txt,509619,510331,712,10,N,N,-,-1,-1
REMKEL2.txt,509625,510377,752,10,N,N,-,-1,-1
REMKEL2.txt,509685,510383,698,10,N,N,-,-1,-1
REMKEL2.txt,509775,510452,677,10,N,N,-,-1,-1
REMKEL2.txt,509814,510517,703,10,N,N,-,-1,-1
REMKEL2.txt,510010,510586,576,10,N,N,-,-1,-1
REMKEL2.txt,510105,510617,512,10,N,N,-,-1,-1
REMKEL2.txt,510164,510662,498,10,N,N,-,-1,-1
REMKEL2.txt,510285,510731,446,10,N,N,-,-1,-1
REMKEL2.txt,510293,510789,496,10,N,N,-,-1,-1
REMKEL2.txt,510332,510825,493,10,N,N,-,-1,-1
REMKEL2.txt,510378,510861,483,10,N,N,-,-1,-1
REMKEL2.txt,510384,510870,486,10,N,N,-,-1,-1
REMKEL2.txt,510453,510971,518,10,N,N,-,-1,-1
REMKEL2.txt,510518,510975,457,10,N,N,-,-1,-1
REMKEL2.txt,510587,510996,409,10,N,N,-,-1,-1
REMKEL2.txt,510618,511019,401,10,N,N,-,-1,-1
REMKEL2.txt,510663,511106,443,10,N,N,-,-1,-1
REMKEL2.txt,510732,511181,449,10,N,N,-,-1,-1
REMKEL2.txt,510790,511578,788,10,N,N,-,-1,-1
REMKEL2.txt,510826,511709,883,10,N,N,-,-1,-1
REMKEL2.txt,510863,511826,963,10,N,N,-,-1,-1
REMKEL2.txt,510871,511989,1118,10,N,N,-,-1,-1
REMKEL2.txt,510972,512139,1167,10,N,N,-,-1,-1
REMKEL2.txt,510976,512302,1326,10,N,N,-,-1,-1
REMKEL2.txt,510999,512375,1376,10,N,N,-,-1,-1
REMKEL2.txt,511020,512416,1396,10,N,N,-,-1,-1
REMKEL2.txt,511109,512573,1464,10,N,N,-,-1,-1
REMKEL2.txt,511182,512709,1527,10,N,N,-,-1,-1
REMKEL2.txt,511579,512792,1213,10,N,N,-,-1,-1
REMKEL2.txt,511710,512876,1166,10,N,N,-,-1,-1
REMKEL2.txt,511827,513131,1304,10,N,N,-,-1,-1
REMKEL2.txt,511990,513342,1352,10,N,N,-,-1,-1
REMKEL2.txt,512140,513363,1223,10,N,N,-,-1,-1
REMKEL2.txt,512303,513464,1161,10,N,N,-,-1,-1
REMKEL2.txt,512376,513599,1223,10,N,N,-,-1,-1
REMKEL2.txt,512417,513687,1270,10,N,N,-,-1,-1
REMKEL2.txt,512574,513727,1153,10,N,N,-,-1,-1
REMKEL2.txt,512710,514085,1375,10,N,N,-,-1,-1
REMKEL2.txt,512794,514210,1416,10,N,N,-,-1,-1
REMKEL2.txt,512877,514228,1351,10,N,N,-,-1,-1
REMKEL2.txt,513132,514348,1216,10,N,N,-,-1,-1
REMKEL2.txt,513343,514356,1013,10,N,N,-,-1,-1
REMKEL2.txt,513364,514539,1175,10,N,N,-,-1,-1
REMKEL2.txt,513465,514636,1171,10,N,N,-,-1,-1
REMKEL2.txt,513600,514642,1042,10,N,N,-,-1,-1
REMKEL2.txt,513688,514695,1007,10,N,N,-,-1,-1
REMKEL2.txt,513728,514723,995,10,N,N,-,-1,-1
REMKEL2.txt,514086,514847,761,10,N,N,-,-1,-1
REMKEL2.txt,514215,514958,743,10,N,N,-,-1,-1
REMKEL2.txt,514231,515012,781,10,N,N,-,-1,-1
REMKEL2.txt,514351,515058,707,10,N,N,-,-1,-1
REMKEL2.txt,514357,515145,788,10,N,N,-,-1,-1
REMKEL2.txt,514540,515419,879,10,N,N,-,-1,-1
REMKEL2.txt,514637,515445,808,10,N,N,-,-1,-1
REMKEL2.txt,514643,515522,879,10,N,N,-,-1,-1
REMKEL2.txt,514696,515622,926,10,N,N,-,-1,-1
REMKEL2.txt,514724,515731,1007,10,N,N,-,-1,-1
REMKEL2.txt,514848,515781,933,10,N,N,-,-1,-1
REMKEL2.txt,514959,515788,829,10,N,N,-,-1,-1
REMKEL2.txt,515013,515927,914,10,N,N,-,-1,-1
REMKEL2.txt,515059,515981,922,10,N,N,-,-1,-1
REMKEL2.txt,515146,516030,884,10,N,N,-,-1,-1
REMKEL2.txt,515420,516121,701,10,N,N,-,-1,-1
REMKEL2.txt,515447,516212,765,10,N,N,-,-1,-1
REMKEL2.txt,515523,516233,710,10,N,N,-,-1,-1
REMKEL2.txt,515623,516312,689,10,N,N,-,-1,-1
REMKEL2.txt,515736,516355,619,10,N,N,-,-1,-1
REMKEL2.txt,515782,516440,658,10,N,N,-,-1,-1
REMKEL2.txt,515789,516483,694,10,N,N,-,-1,-1
REMKEL2.txt,515928,516501,573,10,N,N,-,-1,-1
REMKEL2.txt,515982,516507,525,10,N,N,-,-1,-1
REMKEL2.txt,516031,516539,508,10,N,N,-,-1,-1
REMKEL2.txt,516122,516603,481,10,N,N,-,-1,-1
REMKEL2.txt,516213,516696,483,10,N,N,-,-1,-1
REMKEL2.txt,516234,516894,660,10,N,N,-,-1,-1
REMKEL2.txt,516313,516935,622,10,N,N,-,-1,-1
REMKEL2.txt,516356,516985,629,10,N,N,-,-1,-1
REMKEL2.txt,516442,517111,669,10,N,N,-,-1,-1
REMKEL2.txt,516484,517214,730,10,N,N,-,-1,-1
REMKEL2.txt,516502,517243,741,10,N,N,-,-1,-1
REMKEL2.txt,516508,517358,850,10,N,N,-,-1,-1
REMKEL2.txt,516541,517359,818,10,N,N,-,-1,-1
REMKEL2.txt,516604,517365,761,10,N,N,-,-1,-1
REMKEL2.txt,516697,517369,672,10,N,N,-,-1,-1
REMKEL2.txt,516895,517393,498,10,N,N,-,-1,-1
REMKEL2.txt,516936,517418,482,10,N,N,-,-1,-1
REMKEL2.txt,516986,517461,475,10,N,N,-,-1,-1
REMKEL2.txt,517112,517536,424,10,N,N,-,-1,-1
REMKEL2.txt,517215,517542,327,10,N,N,-,-1,-1
REMKEL2.txt,517244,517565,321,10,N,N,-,-1,-1
REMKEL2.txt,517358,517714,356,10,N,N,-,-1,-1
REMKEL2.txt,517361,517721,360,10,N,N,-,-1,-1
REMKEL2.txt,517366,517801,435,10,N,N,-,-1,-1
REMKEL2.txt,517370,517853,483,10,N,N,-,-1,-1
REMKEL2.txt,517398,517893,495,10,N,N,-,-1,-1
REMKEL2.txt,517419,517955,536,10,N,N,-,-1,-1
REMKEL2.txt,517462,517961,499,10,N,N,-,-1,-1
REMKEL2.txt,517537,518015,478,10,N,N,-,-1,-1
REMKEL2.txt,517543,518045,502,10,N,N,-,-1,-1
REMKEL2.txt,517566,518170,604,10,N,N,-,-1,-1
REMKEL2.txt,517716,518179,463,10,N,N,-,-1,-1
REMKEL2.txt,517722,518275,553,10,N,N,-,-1,-1
REMKEL2.txt,517802,518281,479,10,N,N,-,-1,-1
REMKEL2.txt,517854,518358,504,10,N,N,-,-1,-1
REMKEL2.txt,517894,518364,470,10,N,N,-,-1,-1
REMKEL2.txt,517956,518507,551,10,N,N,-,-1,-1
REMKEL2.txt,517962,518514,552,10,N,N,-,-1,-1
REMKEL2.txt,518016,518648,632,10,N,N,-,-1,-1
REMKEL2.txt,518046,518768,722,10,N,N,-,-1,-1
REMKEL2.txt,518171,518788,617,10,N,N,-,-1,-1
REMKEL2.txt,518180,518923,743,10,N,N,-,-1,-1
REMKEL2.txt,518276,518974,698,10,N,N,-,-1,-1
REMKEL2.txt,518282,518980,698,10,N,N,-,-1,-1
REMKEL2.txt,518359,519002,643,10,N,N,-,-1,-1
REMKEL2.txt,518365,519100,735,10,N,N,-,-1,-1
REMKEL2.txt,518509,519106,597,10,N,N,-,-1,-1
REMKEL2.txt,518515,519124,609,10,N,N,-,-1,-1
REMKEL2.txt,518649,519287,638,10,N,N,-,-1,-1
REMKEL2.txt,518769,519353,584,10,N,N,-,-1,-1
REMKEL2.txt,518789,519359,570,10,N,N,-,-1,-1
REMKEL2.txt,518924,519621,697,10,N,N,-,-1,-1
REMKEL2.txt,518975,519745,770,10,N,N,-,-1,-1
REMKEL2.txt,518981,519945,964,10,N,N,-,-1,-1
REMKEL2.txt,519003,520055,1052,10,N,N,-,-1,-1
REMKEL2.txt,519101,520307,1206,10,N,N,-,-1,-1
REMKEL2.txt,519108,520318,1210,10,N,N,-,-1,-1
REMKEL2.txt,519125,520382,1257,10,N,N,-,-1,-1
REMKEL2.txt,519288,520447,1159,10,N,N,-,-1,-1
REMKEL2.txt,519354,520463,1109,10,N,N,-,-1,-1
REMKEL2.txt,519360,520479,1119,10,N,N,-,-1,-1
REMKEL2.txt,519622,520563,941,10,N,N,-,-1,-1
REOPER.txt,0,945,945,10,N,N,-,-1,-1
REOPER.txt,250,952,702,10,N,N,-,-1,-1
REOPER.txt,433,993,560,10,N,N,-,-1,-1
REOPER.txt,525,1092,567,10,N,N,-,-1,-1
REOPER.txt,611,1424,813,10,N,N,-,-1,-1
REOPER.txt,641,1442,801,10,N,N,-,-1,-1
REOPER.txt,703,1676,973,10,N,N,-,-1,-1
REOPER.txt,762,2040,1278,10,N,N,-,-1,-1
REOPER.txt,840,2478,1638,10,N,N,-,-1,-1
REOPER.txt,916,2665,1749,10,N,N,-,-1,-1
REOPER.txt,947,2690,1743,10,N,N,-,-1,-1
REOPER.txt,955,3133,2178,10,N,N,-,-1,-1
REOPER.txt,998,3740,2742,10,N,N,-,-1,-1
REOPER.txt,1097,3746,2649,10,N,N,-,-1,-1
REOPER.txt,1429,3925,2496,10,N,N,-,-1,-1
REOPER.txt,1447,4106,2659,10,N,N,-,-1,-1
REOPER.txt,1678,4357,2679,10,N,N,-,-1,-1
REOPER.txt,2043,4738,2695,10,N,N,-,-1,-1
REOPER.txt,2481,4983,2502,10,N,N,-,-1,-1
REOPER.txt,2668,5226,2558,10,Y,N,-,-1,-1
REOPER.txt,2691,5346,2655,10,Y,N,-,-1,-1
REOPER.txt,3134,5509,2375,10,Y,N,-,-1,-1
REOPER.txt,3742,5554,1812,10,N,N,-,-1,-1
REOPER.txt,3749,5824,2075,10,Y,N,-,-1,-1
REOPER.txt,3926,6221,2295,10,Y,N,-,-1,-1
REOPER.txt,4107,6885,2778,10,Y,N,-,-1,-1
REOPER.txt,4362,6929,2567,10,Y,N,-,-1,-1
REOPER.txt,4739,7831,3092,10,Y,N,-,-1,-1
REOPER.txt,4986,8124,3138,10,Y,N,-,-1,-1
REOPER.txt,5227,8391,3164,10,N,N,-,-1,-1
REOPER.txt,5347,9358,4011,10,Y,N,-,-1,-1
REOPER.txt,5510,10082,4572,10,Y,N,-,-1,-1
REOPER.txt,5555,10176,4621,10,Y,N,-,-1,-1
REOPER.txt,5827,10198,4371,10,N,N,-,-1,-1
REOPER.txt,6222,10925,4703,10,N,N,-,-1,-1
REOPER.txt,6888,10947,4059,10,N,N,-,-1,-1
REOPER.txt,6934,11682,4748,10,Y,N,-,-1,-1
REOPER.txt,7834,12165,4331,10,Y,N,-,-1,-1
REOPER.txt,8127,12927,4800,10,Y,N,-,-1,-1
REOPER.txt,8394,12929,4535,10,Y,N,-,-1,-1
REOPER.txt,9361,12949,3588,10,Y,N,-,-1,-1
REOPER.txt,10083,13327,3244,10,N,N,-,-1,-1
REOPER.txt,10177,14138,3961,10,Y,N,-,-1,-1
REOPER.txt,10203,14451,4248,10,Y,N,-,-1,-1
REOPER.txt,10926,14472,3546,10,Y,N,-,-1,-1
REOPER.txt,10950,15111,4161,10,Y,N,-,-1,-1
REOPER.txt,11685,15134,3449,10,N,N,-,-1,-1
REOPER.txt,12170,15750,3580,10,Y,N,-,-1,-1
REOPER.txt,12928,16617,3689,10,N,N,-,-1,-1
REOPER.txt,12930,16991,4061,10,N,N,-,-1,-1
REOPER.txt,12952,17298,4346,10,N,N,-,-1,-1
REOPER.txt,13330,17912,4582,10,Y,N,-,-1,-1
REOPER.txt,14140,17933,3793,10,Y,N,-,-1,-1
REOPER.txt,14452,18544,4092,10,Y,N,-,-1,-1
REOPER.txt,14475,18564,4089,10,Y,N,-,-1,-1
REOPER.txt,15112,18778,3666,10,N,N,-,-1,-1
REOPER.txt,15137,18814,3677,10,N,N,-,-1,-1
REOPER.txt,15753,19530,3777,10,N,N,-,-1,-1
REOPER.txt,16620,19551,2931,10,N,N,-,-1,-1
REOPER.txt,16994,19603,2609,10,N,N,-,-1,-1
REOPER.txt,17301,19617,2316,10,N,N,-,-1,-1
REOPER.txt,17913,19862,1949,10,N,N,-,-1,-1
REOPER.txt,17936,20487,2551,10,N,N,-,-1,-1
REOPER.txt,18545,20489,1944,10,N,N,-,-1,-1
REOPER.txt,18567,20512,1945,10,N,N,-,-1,-1
REOPER.txt,18778,20729,1951,10,N,N,-,-1,-1
REOPER.txt,18815,22117,3302,10,N,N,-,-1,-1
REOPER.txt,19531,22119,2588,10,N,N,-,-1,-1
REOPER.txt,19554,22138,2584,10,N,N,-,-1,-1
REOPER.txt,19604,22203,2599,10,N,N,-,-1,-1
REOPER.txt,19619,22625,3006,10,N,N,-,-1,-1
REOPER.txt,19863,22721,2858,10,N,N,-,-1,-1
REOPER.txt,20488,22768,2280,10,N,N,-,-1,-1
REOPER.txt,20490,22807,2317,10,N,N,-,-1,-1
REOPER.txt,20515,22907,2392,10,N,N,-,-1,-1
REOPER.txt,20732,22933,2201,10,N,N,-,-1,-1
REOPER.txt,22118,23082,964,10,N,N,-,-1,-1
REOPER.txt,22120,23120,1000,10,N,N,-,-1,-1
REOPER.txt,22141,23288,1147,10,N,N,-,-1,-1
REOPER.txt,22205,23935,1730,10,N,N,-,-1,-1
REOPER.txt,22626,23956,1330,10,N,N,-,-1,-1
REOPER.txt,22722,24156,1434,10,N,N,-,-1,-1
REOPER.txt,22770,24371,1601,10,N,N,-,-1,-1
REOPER.txt,22808,24773,1965,10,N,N,-,-1,-1
REOPER.txt,22908,24996,2088,10,N,N,-,-1,-1
REOPER.txt,22936,25016,2080,10,N,N,-,-1,-1
REOPER.txt,23083,25098,2015,10,N,N,-,-1,-1
REOPER.txt,23121,25565,2444,10,N,N,-,-1,-1
REOPER.txt,23289,26006,2717,10,N,N,-,-1,-1
REOPER.txt,23936,26439,2503,10,N,N,-,-1,-1
REOPER.txt,23959,26961,3002,10,N,N,-,-1,-1
REOPER.txt,24158,27271,3113,10,N,N,-,-1,-1
REOPER.txt,24372,27288,2916,10,N,N,-,-1,-1
REOPER.txt,24774,27486,2712,10,N,N,-,-1,-1
REOPER.txt,24997,27571,2574,10,N,N,-,-1,-1
REOPER.txt,25019,27756,2737,10,N,N,-,-1,-1
REOPER.txt,25099,27883,2784,10,N,N,-,-1,-1
REOPER.txt,25568,28138,2570,10,N,N,-,-1,-1
REOPER.txt,26011,28414,2403,10,N,N,-,-1,-1
REOPER.txt,26442,28684,2242,10,N,N,-,-1,-1
REOPER.txt,26964,28908,1944,10,N,N,-,-1,-1
REOPER.txt,27274,29102,1828,10,N,N,-,-1,-1
REOPER.txt,27289,29132,1843,10,N,N,-,-1,-1
REOPER.txt,27487,29152,1665,10,N,N,-,-1,-1
REOPER.txt,27574,29270,1696,10,N,N,-,-1,-1
REOPER.txt,27757,29510,1753,10,N,N,-,-1,-1
REOPER.txt,27884,29817,1933,10,N,N,-,-1,-1
REOPER.txt,28140,30398,2258,10,N,N,-,-1,-1
REOPER.txt,28416,30823,2407,10,N,N,-,-1,-1
REOPER.txt,28687,30862,2175,10,N,N,-,-1,-1
REOPER.txt,28910,30945,2035,10,N,N,-,-1,-1
REOPER.txt,29103,31324,2221,10,N,N,-,-1,-1
REOPER.txt,29133,31508,2375,10,N,N,-,-1,-1
REOPER.txt,29153,31705,2552,10,N,N,-,-1,-1
REOPER.txt,29271,31946,2675,10,N,N,-,-1,-1
REOPER.txt,29513,32318,2805,10,N,N,-,-1,-1
REOPER.txt,29820,32510,2690,10,N,N,-,-1,-1
REOPER.txt,30399,32658,2259,10,N,N,-,-1,-1
REOPER.txt,30826,32843,2017,10,N,N,-,-1,-1
REOPER.txt,30865,33024,2159,10,N,N,-,-1,-1
REOPER.txt,30946,33278,2332,10,N,N,-,-1,-1
REOPER.txt,31325,33645,2320,10,N,N,-,-1,-1
REOPER.txt,31509,33748,2239,10,N,N,-,-1,-1
REOPER.txt,31706,34146,2440,10,N,N,-,-1,-1
REOPER.txt,31949,34277,2328,10,N,N,-,-1,-1
REOPER.txt,32319,34376,2057,10,N,N,-,-1,-1
REOPER.txt,32513,34463,1950,10,N,N,-,-1,-1
REOPER.txt,32659,34548,1889,10,N,N,-,-1,-1
REOPER.txt,32846,34657,1811,10,N,N,-,-1,-1
REOPER.txt,33025,34811,1786,10,N,N,-,-1,-1
REOPER.txt,33279,34991,1712,10,N,N,-,-1,-1
REOPER.txt,33646,35420,1774,10,N,N,-,-1,-1
REOPER.txt,33749,35858,2109,10,N,N,-,-1,-1
REOPER.txt,34147,35956,1809,10,N,N,-,-1,-1
REOPER.txt,34278,36264,1986,10,N,N,-,-1,-1
REOPER.txt,34379,36290,1911,10,N,N,-,-1,-1
REOPER.txt,34466,36467,2001,10,N,N,-,-1,-1
REOPER.txt,34549,36847,2298,10,N,N,-,-1,-1
REOPER.txt,34658,37062,2404,10,N,N,-,-1,-1
REOPER.txt,34812,37466,2654,10,N,N,-,-1,-1
REOPER.txt,34992,37588,2596,10,N,N,-,-1,-1
REOPER.txt,35421,37741,2320,10,N,N,-,-1,-1
REOPER.txt,35858,37862,2004,10,N,N,-,-1,-1
REOPER.txt,35957,38003,2046,10,N,N,-,-1,-1
REOPER.txt,36269,38021,1752,10,N,N,-,-1,-1
REOPER.txt,36291,38083,1792,10,N,N,-,-1,-1
REOPER.txt,36468,38164,1696,10,N,N,-,-1,-1
REOPER.txt,36849,38285,1436,10,N,N,-,-1,-1
REOPER.txt,37065,38696,1631,10,N,N,-,-1,-1
REOPER.txt,37467,39080,1613,10,N,N,-,-1,-1
REOPER.txt,37589,39329,1740,10,N,N,-,-1,-1
REOPER.txt,37744,39506,1762,10,N,N,-,-1,-1
REOPER.txt,37865,39640,1775,10,N,N,-,-1,-1
REOPER.txt,38004,39805,1801,10,N,N,-,-1,-1
REOPER.txt,38022,39823,1801,10,N,N,-,-1,-1
REOPER.txt,38086,39915,1829,10,N,N,-,-1,-1
REOPER.txt,38165,40121,1956,10,N,N,-,-1,-1
REOPER.txt,38286,40458,2172,10,N,N,-,-1,-1
REOPER.txt,38699,40885,2186,10,N,N,-,-1,-1
REOPER.txt,39082,41155,2073,10,N,N,-,-1,-1
REOPER.txt,39330,41503,2173,10,N,N,-,-1,-1
REOPER.txt,39509,41651,2142,10,N,N,-,-1,-1
REOPER.txt,39641,41703,2062,10,N,N,-,-1,-1
REOPER.txt,39810,41983,2173,10,Y,N,-,-1,-1
REOPER.txt,39824,42301,2477,10,Y,N,-,-1,-1
REOPER.txt,39916,42310,2394,10,Y,N,-,-1,-1
REOPER.txt,40124,42329,2205,10,Y,N,-,-1,-1
REOPER.txt,40459,42608,2149,10,Y,N,-,-1,-1
REOPER.txt,40888,42797,1909,10,Y,N,-,-1,-1
REOPER.txt,41156,42917,1761,10,Y,N,-,-1,-1
REOPER.txt,41505,43121,1616,10,Y,N,-,-1,-1
REOPER.txt,41654,43157,1503,10,N,N,-,-1,-1
REOPER.txt,41704,43432,1728,10,N,N,-,-1,-1
REOPER.txt,41986,43586,1600,10,N,N,-,-1,-1
REOPER.txt,42302,43661,1359,10,N,N,-,-1,-1
REOPER.txt,42311,43679,1368,10,N,N,-,-1,-1
REOPER.txt,42330,43820,1490,10,N,N,-,-1,-1
REOPER.txt,42613,44019,1406,10,N,N,-,-1,-1
REOPER.txt,42798,44185,1387,10,N,N,-,-1,-1
REOPER.txt,42918,44281,1363,10,N,N,-,-1,-1
REOPER.txt,43122,44566,1444,10,N,N,-,-1,-1
REOPER.txt,43158,44888,1730,10,N,N,-,-1,-1
REOPER.txt,43435,45314,1879,10,N,N,-,-1,-1
REOPER.txt,43587,45546,1959,10,N,N,-,-1,-1
REOPER.txt,43666,45801,2135,10,N,N,-,-1,-1
REOPER.txt,43680,45991,2311,10,N,N,-,-1,-1
REOPER.txt,43821,46074,2253,10,N,N,-,-1,-1
REOPER.txt,44020,46318,2298,10,N,N,-,-1,-1
REOPER.txt,44186,46341,2155,10,N,N,-,-1,-1
REOPER.txt,44284,46453,2169,10,N,N,-,-1,-1
REOPER.txt,44567,46756,2189,10,N,N,-,-1,-1
REOPER.txt,44891,47043,2152,10,N,N,-,-1,-1
REOPER.txt,45317,47274,1957,10,N,N,-,-1,-1
REOPER.txt,45547,47526,1979,10,N,N,-,-1,-1
REOPER.txt,45804,47780,1976,10,N,N,-,-1,-1
REOPER.txt,45992,47873,1881,10,N,N,-,-1,-1
REOPER.txt,46075,48046,1971,10,N,N,-,-1,-1
REOPER.txt,46319,48147,1828,10,N,N,-,-1,-1
REOPER.txt,46342,48218,1876,10,N,N,-,-1,-1
REOPER.txt,46456,48478,2022,10,N,N,-,-1,-1
REOPER.txt,46757,48717,1960,10,N,N,-,-1,-1
REOPER.txt,47044,48943,1899,10,N,N,-,-1,-1
REOPER.txt,47275,49104,1829,10,N,N,-,-1,-1
REOPER.txt,47527,49332,1805,10,N,N,-,-1,-1
REOPER.txt,47781,49508,1727,10,N,N,-,-1,-1
REOPER.txt,47874,49679,1805,10,N,N,-,-1,-1
REOPER.txt,48047,49781,1734,10,N,N,-,-1,-1
REOPER.txt,48150,49919,1769,10,N,N,-,-1,-1
REOPER.txt,48219,50045,1826,10,N,N,-,-1,-1
REOPER.txt,48481,50083,1602,10,N,N,-,-1,-1
REOPER.txt,48718,50179,1461,10,N,N,-,-1,-1
REOPER.txt,48944,50396,1452,10,N,N,-,-1,-1
REOPER.txt,49105,50422,1317,10,N,N,-,-1,-1
REOPER.txt,49334,50434,1100,10,N,N,-,-1,-1
REOPER.txt,49511,50447,936,10,N,N,-,-1,-1
REOPER.txt,49680,50626,946,10,N,N,-,-1,-1
REOPER.txt,49783,50648,865,10,N,N,-,-1,-1
REOPER.txt,49920,50669,749,10,N,N,-,-1,-1
REOPER.txt,50046,50778,732,10,N,N,-,-1,-1
REOPER.txt,50084,50847,763,10,N,N,-,-1,-1
REOPER.txt,50180,50976,796,10,N,N,-,-1,-1
REOPER.txt,50397,51227,830,10,N,N,-,-1,-1
REOPER.txt,50424,51270,846,10,N,N,-,-1,-1
REOPER.txt,50435,51330,895,10,N,N,-,-1,-1
REOPER.txt,50448,51397,949,10,N,N,-,-1,-1
REOPER.txt,50627,51407,780,10,N,N,-,-1,-1
REOPER.txt,50649,51449,800,10,N,N,-,-1,-1
REOPER.txt,50670,51574,904,10,N,N,-,-1,-1
REOPER.txt,50779,51646,867,10,N,N,-,-1,-1
REOPER.txt,50848,51744,896,10,N,N,-,-1,-1
REOPER.txt,50977,51855,878,10,N,N,-,-1,-1
REOPER.txt,51229,52085,856,10,N,N,-,-1,-1
REOPER.txt,51271,52144,873,10,N,N,-,-1,-1
REOPER.txt,51331,52371,1040,10,N,N,-,-1,-1
REOPER.txt,51398,52523,1125,10,N,N,-,-1,-1
REOPER.txt,51408,52787,1379,10,N,N,-,-1,-1
REOPER.txt,51450,52828,1378,10,N,N,-,-1,-1
REOPER.txt,51575,53019,1444,10,N,N,-,-1,-1
REOPER.txt,51647,53146,1499,10,N,N,-,-1,-1
REOPER.txt,51747,53256,1509,10,N,N,-,-1,-1
REOPER.txt,51857,53305,1448,10,N,N,-,-1,-1
REOPER.txt,52088,53379,1291,10,N,N,-,-1,-1
REOPER.txt,52145,53517,1372,10,N,N,-,-1,-1
REOPER.txt,52372,53598,1226,10,N,N,-,-1,-1
REOPER.txt,52525,53622,1097,10,N,N,-,-1,-1
REOPER.txt,52788,53719,931,10,N,N,-,-1,-1
REOPER.txt,52829,53869,1040,10,N,N,-,-1,-1
REOPER.txt,53020,54018,998,10,N,N,-,-1,-1
REOPER.txt,53147,54051,904,10,N,N,-,-1,-1
REOPER.txt,53257,54194,937,10,N,N,-,-1,-1
REOPER.txt,53306,54267,961,10,N,N,-,-1,-1
REOPER.txt,53380,54471,1091,10,N,N,-,-1,-1
REOPER.txt,53518,54837,1319,10,N,N,-,-1,-1
REOPER.txt,53603,55182,1579,10,N,N,-,-1,-1
REOPER.txt,53623,55521,1898,10,N,N,-,-1,-1
REOPER.txt,53720,55859,2139,10,N,N,-,-1,-1
REOPER.txt,53870,56108,2238,10,N,N,-,-1,-1
REOPER.txt,54020,56351,2331,10,N,N,-,-1,-1
REOPER.txt,54052,56670,2618,10,N,N,-,-1,-1
REOPER.txt,54195,56934,2739,10,N,N,-,-1,-1
REOPER.txt,54268,57145,2877,10,N,N,-,-1,-1
REOPER.txt,54473,57383,2910,10,N,N,-,-1,-1
REOPER.txt,54838,57480,2642,10,N,N,-,-1,-1
REOPER.txt,55183,57666,2483,10,N,N,-,-1,-1
REOPER.txt,55524,58177,2653,10,N,N,-,-1,-1
REOPER.txt,55860,58404,2544,10,N,N,-,-1,-1
REOPER.txt,56109,58596,2487,10,N,N,-,-1,-1
REOPER.txt,56353,58927,2574,10,N,N,-,-1,-1
REOPER.txt,56673,59147,2474,10,N,N,-,-1,-1
REOPER.txt,56935,59338,2403,10,N,N,-,-1,-1
REOPER.txt,57148,59379,2231,10,N,N,-,-1,-1
REOPER.txt,57384,59531,2147,10,N,N,-,-1,-1
REOPER.txt,57483,59830,2347,10,N,N,-,-1,-1
REOPER.txt,57667,59947,2280,10,N,N,-,-1,-1
REOPER.txt,58178,60347,2169,10,N,N,-,-1,-1
REOPER.txt,58405,60488,2083,10,N,N,-,-1,-1
REOPER.txt,58598,60817,2219,10,N,N,-,-1,-1
REOPER.txt,58928,60964,2036,10,N,N,-,-1,-1
REOPER.txt,59148,61103,1955,10,N,N,-,-1,-1
REOPER.txt,59341,61129,1788,10,N,N,-,-1,-1
REOPER.txt,59382,61201,1819,10,N,N,-,-1,-1
REOPER.txt,59532,61233,1701,10,N,N,-,-1,-1
REOPER.txt,59831,61422,1591,10,N,N,-,-1,-1
REOPER.txt,59950,61769,1819,10,N,N,-,-1,-1
REOPER.txt,60348,62012,1664,10,N,N,-,-1,-1
REOPER.txt,60489,62324,1835,10,N,N,-,-1,-1
REOPER.txt,60818,62369,1551,10,N,N,-,-1,-1
REOPER.txt,60965,62434,1469,10,N,N,-,-1,-1
REOPER.txt,61106,62449,1343,10,N,N,-,-1,-1
REOPER.txt,61130,62526,1396,10,N,N,-,-1,-1
REOPER.txt,61202,62570,1368,10,N,N,-,-1,-1
REOPER.txt,61234,62969,1735,10,N,N,-,-1,-1
REOPER.txt,61423,63096,1673,10,N,N,-,-1,-1
REOPER.txt,61770,63139,1369,10,N,N,-,-1,-1
REOPER.txt,62013,63542,1529,10,N,N,-,-1,-1
REOPER.txt,62325,63649,1324,10,N,N,-,-1,-1
REOPER.txt,62371,63906,1535,10,N,N,-,-1,-1
REOPER.txt,62435,63957,1522,10,N,N,-,-1,-1
REOPER.txt,62450,64163,1713,10,N,N,-,-1,-1
REOPER.txt,62527,64393,1866,10,N,N,-,-1,-1
REOPER.txt,62573,64515,1942,10,N,N,-,-1,-1
REOPER.txt,62970,64580,1610,10,N,N,-,-1,-1
REOPER.txt,63099,64671,1572,10,N,N,-,-1,-1
REOPER.txt,63140,64794,1654,10,N,N,-,-1,-1
REOPER.txt,63543,64833,1290,10,N,N,-,-1,-1
REOPER.txt,63650,64857,1207,10,N,N,-,-1,-1
REOPER.txt,63908,65377,1469,10,N,N,-,-1,-1
REOPER.txt,63958,65423,1465,10,N,N,-,-1,-1
REOPER.txt,64164,65510,1346,10,N,N,-,-1,-1
REOPER.txt,64396,65624,1228,10,N,N,-,-1,-1
REOPER.txt,64516,65913,1397,10,N,N,-,-1,-1
REOPER.txt,64581,66254,1673,10,N,N,-,-1,-1
REOPER.txt,64672,66358,1686,10,N,N,-,-1,-1
REOPER.txt,64797,66440,1643,10,N,N,-,-1,-1
REOPER.txt,64838,66574,1736,10,N,N,-,-1,-1
REOPER.txt,64860,66968,2108,10,N,N,-,-1,-1
REOPER.txt,65380,67203,1823,10,N,N,-,-1,-1
REOPER.txt,65424,67454,2030,10,N,N,-,-1,-1
REOPER.txt,65511,67700,2189,10,N,N,-,-1,-1
REOPER.txt,65625,67794,2169,10,N,N,-,-1,-1
REOPER.txt,65914,67926,2012,10,N,N,-,-1,-1
REOPER.txt,66255,68295,2040,10,N,N,-,-1,-1
REOPER.txt,66361,68321,1960,10,N,N,-,-1,-1
REOPER.txt,66441,68444,2003,10,N,N,-,-1,-1
REOPER.txt,66575,68542,1967,10,N,N,-,-1,-1
REOPER.txt,66969,68725,1756,10,N,N,-,-1,-1
REOPER.txt,67204,68820,1616,10,N,N,-,-1,-1
REOPER.txt,67455,69078,1623,10,N,N,-,-1,-1
REOPER.txt,67703,69252,1549,10,N,N,-,-1,-1
REOPER.txt,67795,69334,1539,10,N,N,-,-1,-1
REOPER.txt,67928,69561,1633,10,N,N,-,-1,-1
REOPER.txt,68298,69668,1370,10,N,N,-,-1,-1
REOPER.txt,68322,69914,1592,10,N,N,-,-1,-1
REOPER.txt,68445,69955,1510,10,N,N,-,-1,-1
REOPER.txt,68545,70028,1483,10,N,N,-,-1,-1
REOPER.txt,68728,70057,1329,10,N,N,-,-1,-1
REOPER.txt,68821,70169,1348,10,N,N,-,-1,-1
REOPER.txt,69079,70299,1220,10,N,N,-,-1,-1
REOPER.txt,69252,70400,1148,10,N,N,-,-1,-1
REOPER.txt,69337,70466,1129,10,N,N,-,-1,-1
REOPER.txt,69563,70549,986,10,N,N,-,-1,-1
REOPER.txt,69670,70636,966,10,N,N,-,-1,-1
REOPER.txt,69915,70883,968,10,N,N,-,-1,-1
REOPER.txt,69956,70977,1021,10,N,N,-,-1,-1
REOPER.txt,70031,71406,1375,10,N,N,-,-1,-1
REOPER.txt,70058,71882,1824,10,N,N,-,-1,-1
REOPER.txt,70170,71898,1728,10,N,N,-,-1,-1
REOPER.txt,70300,72058,1758,10,N,N,-,-1,-1
REOPER.txt,70401,72360,1959,10,N,N,-,-1,-1
REOPER.txt,70467,72512,2045,10,N,N,-,-1,-1
REOPER.txt,70550,72906,2356,10,N,N,-,-1,-1
REOPER.txt,70638,73142,2504,10,N,N,-,-1,-1
REOPER.txt,70884,73379,2495,10,N,N,-,-1,-1
REOPER.txt,70978,73638,2660,10,N,N,-,-1,-1
REOPER.txt,71409,73822,2413,10,N,N,-,-1,-1
REOPER.txt,71883,73959,2076,10,N,N,-,-1,-1
REOPER.txt,71899,74205,2306,10,N,N,-,-1,-1
REOPER.txt,72061,74409,2348,10,N,N,-,-1,-1
REOPER.txt,72361,74575,2214,10,N,N,-,-1,-1
REOPER.txt,72515,74790,2275,10,N,N,-,-1,-1
REOPER.txt,72907,75107,2200,10,N,N,-,-1,-1
REOPER.txt,73143,75370,2227,10,N,N,-,-1,-1
REOPER.txt,73382,75463,2081,10,N,N,-,-1,-1
REOPER.txt,73641,75657,2016,10,N,N,-,-1,-1
REOPER.txt,73823,76057,2234,10,N,N,-,-1,-1
REOPER.txt,73962,76304,2342,10,N,N,-,-1,-1
REOPER.txt,74206,76510,2304,10,N,N,-,-1,-1
REOPER.txt,74410,76600,2190,10,N,N,-,-1,-1
REOPER.txt,74576,76833,2257,10,N,N,-,-1,-1
REOPER.txt,74793,76976,2183,10,N,N,-,-1,-1
REOPER.txt,75110,77124,2014,10,N,N,-,-1,-1
REOPER.txt,75371,77226,1855,10,N,N,-,-1,-1
REOPER.txt,75464,77416,1952,10,N,N,-,-1,-1
REOPER.txt,75660,77804,2144,10,N,N,-,-1,-1
REOPER.txt,76058,77972,1914,10,N,N,-,-1,-1
REOPER.txt,76305,78261,1956,10,N,N,-,-1,-1
REOPER.txt,76513,78496,1983,10,N,N,-,-1,-1
REOPER.txt,76601,78648,2047,10,N,N,-,-1,-1
REOPER.txt,76834,78797,1963,10,N,N,-,-1,-1
REOPER.txt,76979,79006,2027,10,N,N,-,-1,-1
REOPER.txt,77125,79095,1970,10,N,N,-,-1,-1
REOPER.txt,77229,79448,2219,10,N,N,-,-1,-1
REOPER.txt,77417,79617,2200,10,N,N,-,-1,-1
REOPER.txt,77805,80053,2248,10,N,N,-,-1,-1
REOPER.txt,77975,80076,2101,10,N,N,-,-1,-1
REOPER.txt,78262,80641,2379,10,N,N,-,-1,-1
REOPER.txt,78497,80823,2326,10,N,N,-,-1,-1
REOPER.txt,78651,81006,2355,10,N,N,-,-1,-1
REOPER.txt,78798,81070,2272,10,N,N,-,-1,-1
REOPER.txt,79007,81250,2243,10,N,N,-,-1,-1
REOPER.txt,79096,81314,2218,10,N,N,-,-1,-1
REOPER.txt,79449,81388,1939,10,N,N,-,-1,-1
REOPER.txt,79620,81537,1917,10,N,N,-,-1,-1
REOPER.txt,80058,81567,1509,10,N,N,-,-1,-1
REOPER.txt,80079,81645,1566,10,N,N,-,-1,-1
REOPER.txt,80644,81882,1238,10,N,N,-,-1,-1
REOPER.txt,80824,82156,1332,10,N,N,-,-1,-1
REOPER.txt,81007,82247,1240,10,N,N,-,-1,-1
REOPER.txt,81071,82512,1441,10,N,N,-,-1,-1
REOPER.txt,81251,82832,1581,10,N,N,-,-1,-1
REOPER.txt,81317,83034,1717,10,N,N,-,-1,-1
REOPER.txt,81389,83171,1782,10,N,N,-,-1,-1
REOPER.txt,81542,83407,1865,10,N,N,-,-1,-1
REOPER.txt,81568,83588,2020,10,N,N,-,-1,-1
REOPER.txt,81646,83708,2062,10,N,N,-,-1,-1
REOPER.txt,81883,83833,1950,10,N,N,-,-1,-1
REOPER.txt,82157,83959,1802,10,N,N,-,-1,-1
REOPER.txt,82249,84142,1893,10,N,N,-,-1,-1
REOPER.txt,82515,84408,1893,10,N,N,-,-1,-1
REOPER.txt,82833,84521,1688,10,N,N,-,-1,-1
REOPER.txt,83035,84710,1675,10,N,N,-,-1,-1
REOPER.txt,83172,84809,1637,10,N,N,-,-1,-1
REOPER.txt,83410,85196,1786,10,N,N,-,-1,-1
REOPER.txt,83589,85229,1640,10,N,N,-,-1,-1
REOPER.txt,83709,85297,1588,10,N,N,-,-1,-1
REOPER.txt,83834,85411,1577,10,Y,N,-,-1,-1
REOPER.txt,83960,85465,1505,10,N,N,-,-1,-1
REOPER.txt,84143,85501,1358,10,N,N,-,-1,-1
REOPER.txt,84409,85534,1125,10,N,N,-,-1,-1
REOPER.txt,84522,85736,1214,10,N,N,-,-1,-1
REOPER.txt,84713,85801,1088,10,N,N,-,-1,-1
REOPER.txt,84810,85943,1133,10,N,N,-,-1,-1
REOPER.txt,85197,86103,906,10,N,N,-,-1,-1
REOPER.txt,85230,86156,926,10,N,N,-,-1,-1
REOPER.txt,85298,86310,1012,10,N,N,-,-1,-1
REOPER.txt,85412,86349,937,10,N,N,-,-1,-1
REOPER.txt,85466,86434,968,10,N,N,-,-1,-1
REOPER.txt,85502,86695,1193,10,N,Y,1448281320115,89144,91129
REOPER.txt,85535,86877,1342,10,N,Y,1448281320115,89144,91129
REOPER.txt,85737,87079,1342,10,N,Y,1448281320115,89144,91129
REOPER.txt,85802,87142,1340,10,N,Y,1448281320115,89144,91129
REOPER.txt,85944,87272,1328,10,Y,Y,1448281320115,89144,91129
REOPER.txt,86105,87467,1362,10,Y,Y,1448281320115,89144,91129
REOPER.txt,86157,87605,1448,10,Y,Y,1448281320115,89144,91129
REOPER.txt,86311,87950,1639,10,Y,Y,1448281320115,89144,91129
REOPER.txt,86350,88089,1739,10,Y,Y,1448281320115,89144,91129
REOPER.txt,86437,88255,1818,10,N,Y,1448281320115,89144,91129
REOPER.txt,86696,88384,1688,10,N,Y,1448281320115,89144,91129
REOPER.txt,86879,88560,1681,10,Y,Y,1448281320115,89144,91129
REOPER.txt,87082,88812,1730,10,Y,Y,1448281320115,89144,91129
REOPER.txt,87143,88877,1734,10,N,Y,1448281320115,89144,91129
REOPER.txt,87273,88901,1628,10,N,Y,1448281320115,89144,91129
REOPER.txt,87468,88950,1482,10,N,Y,1448281320115,89144,91129
REOPER.txt,87606,89100,1494,10,N,Y,1448281320115,89144,91129
REOPER.txt,87951,89168,1217,10,N,Y,1448281320115,89144,91129
REOPER.txt,88090,89375,1285,10,N,N,-,-1,-1
REOPER.txt,88256,89532,1276,10,N,N,-,-1,-1
REOPER.txt,88387,89753,1366,10,N,N,-,-1,-1
REOPER.txt,88561,89906,1345,10,N,N,-,-1,-1
REOPER.txt,88813,90045,1232,10,N,N,-,-1,-1
REOPER.txt,88882,90288,1406,10,N,N,-,-1,-1
REOPER.txt,88902,90389,1487,10,N,N,-,-1,-1
REOPER.txt,88951,90767,1816,10,N,N,-,-1,-1
REOPER.txt,89101,90969,1868,10,N,N,-,-1,-1
REOPER.txt,89169,91276,2107,10,N,N,-,-1,-1
REOPER.txt,89378,91434,2056,10,N,N,-,-1,-1
REOPER.txt,89533,91666,2133,10,N,N,-,-1,-1
REOPER.txt,89754,91881,2127,10,N,N,-,-1,-1
REOPER.txt,89907,92067,2160,10,N,N,-,-1,-1
REOPER.txt,90046,92248,2202,10,N,N,-,-1,-1
REOPER.txt,90291,92570,2279,10,N,N,-,-1,-1
REOPER.txt,90394,92699,2305,10,N,Y,1448275407308,26987,29181
REOPER.txt,90772,92909,2137,10,N,Y,1448275407308,26987,29181
REOPER.txt,90970,93023,2053,10,N,Y,1448275407308,26987,29181
REOPER.txt,91277,93171,1894,10,N,Y,1448275407308,26987,29181
REOPER.txt,91437,93330,1893,10,N,Y,1448275407308,26987,29181
REOPER.txt,91668,93529,1861,10,N,Y,1448275407308,26987,29181
REOPER.txt,91882,93636,1754,10,N,Y,1448275407308,26987,29181
REOPER.txt,92068,93718,1650,10,N,Y,1448275407308,26987,29181
REOPER.txt,92249,93888,1639,10,N,Y,1448275407308,26987,29181
REOPER.txt,92572,93986,1414,10,N,Y,1448275407308,26987,29181
REOPER.txt,92700,94238,1538,10,N,Y,1448275407308,26987,29181
REOPER.txt,92910,94429,1519,10,N,Y,1448275407308,26987,29181
REOPER.txt,93024,94559,1535,10,N,Y,1448275407308,26987,29181
REOPER.txt,93172,94798,1626,10,N,Y,1448275407308,26987,29181
REOPER.txt,93331,95076,1745,10,N,Y,1448275407308,26987,29181
REOPER.txt,93530,95478,1948,10,N,Y,1448037533268,13930,15031
REOPER.txt,93639,95616,1977,10,N,Y,1448037533268,13930,15031
REOPER.txt,93721,95718,1997,10,N,Y,1448037533268,13930,15031
REOPER.txt,93890,95854,1964,10,N,Y,1448037533268,13930,15031
REOPER.txt,93987,95890,1903,10,N,Y,1448037533268,13930,15031
REOPER.txt,94240,96013,1773,10,N,Y,1448037533268,13930,15031
REOPER.txt,94430,96032,1602,10,N,Y,1448037533268,13930,15031
REOPER.txt,94560,96212,1652,10,N,Y,1448037533268,13930,15031
REOPER.txt,94799,96423,1624,10,N,N,-,-1,-1
REOPER.txt,95077,96496,1419,10,N,N,-,-1,-1
REOPER.txt,95479,96831,1352,10,N,N,-,-1,-1
REOPER.txt,95617,96853,1236,10,N,N,-,-1,-1
REOPER.txt,95721,97064,1343,10,N,N,-,-1,-1
REOPER.txt,95855,97109,1254,10,N,N,-,-1,-1
REOPER.txt,95891,97225,1334,10,N,N,-,-1,-1
REOPER.txt,96014,97274,1260,10,N,N,-,-1,-1
REOPER.txt,96033,97333,1300,10,N,N,-,-1,-1
REOPER.txt,96215,97717,1502,10,N,N,-,-1,-1
REOPER.txt,96424,97985,1561,10,N,N,-,-1,-1
REOPER.txt,96497,98193,1696,10,Y,N,-,-1,-1
REOPER.txt,96832,98330,1498,10,N,N,-,-1,-1
REOPER.txt,96856,98457,1601,10,N,Y,1437472966198,394609,395892
REOPER.txt,97065,98570,1505,10,N,Y,1437472966198,394609,395892
REOPER.txt,97110,98712,1602,10,N,Y,1437472966198,394609,395892
REOPER.txt,97226,98768,1542,10,N,Y,1437472966198,394609,395892
REOPER.txt,97277,98878,1601,10,N,Y,1437472966198,394609,395892
REOPER.txt,97336,98966,1630,10,N,Y,1437472966198,394609,395892
REOPER.txt,97718,99053,1335,10,N,Y,1437472966198,394609,395892
REOPER.txt,97987,99072,1085,10,N,Y,1437472966198,394609,395892
REOPER.txt,98194,99171,977,10,N,Y,1437472966198,394609,395892
REOPER.txt,98333,99239,906,10,N,Y,1437472966198,394609,395892
REOPER.txt,98458,99518,1060,10,N,Y,1437472966198,394609,395892
REOPER.txt,98571,99799,1228,10,N,Y,1437472966198,394609,395892
REOPER.txt,98713,99904,1191,10,N,Y,1437472966198,394609,395892
REOPER.txt,98769,99999,1230,10,N,Y,1437472966198,394609,395892
REOPER.txt,98879,100312,1433,10,N,Y,1437472966198,394609,395892
REOPER.txt,98967,100432,1465,10,N,Y,1437472966198,394609,395892
REOPER.txt,99054,100674,1620,10,Y,Y,1437472966198,394609,395892
REOPER.txt,99073,100827,1754,10,Y,Y,1437472966198,394609,395892
REOPER.txt,99173,100852,1679,10,Y,Y,1437472966198,394609,395892
REOPER.txt,99240,100949,1709,10,Y,Y,1437472966198,394609,395892
REOPER.txt,99519,101220,1701,10,Y,Y,1437472966198,394609,395892
REOPER.txt,99800,101416,1616,10,Y,Y,1437472966198,394609,395892
REOPER.txt,99905,101603,1698,10,Y,Y,1437472966198,394609,395892
REOPER.txt,100000,101773,1773,10,Y,Y,1437472966198,394609,395892
REOPER.txt,100315,101999,1684,10,Y,Y,1437472966198,394609,395892
REOPER.txt,100435,102210,1775,10,Y,Y,1437472966198,394609,395892
REOPER.txt,100677,102303,1626,10,Y,Y,1437472966198,394609,395892
REOPER.txt,100830,102413,1583,10,Y,Y,1437472966198,394609,395892
REOPER.txt,100853,102516,1663,10,Y,Y,1437472966198,394609,395892
REOPER.txt,100950,102541,1591,10,Y,Y,1437472966198,394609,395892
REOPER.txt,101223,102780,1557,10,N,Y,1448322713112,221941,223038
REOPER.txt,101419,102943,1524,10,N,Y,1448322713112,221941,223038
REOPER.txt,101606,103150,1544,10,N,Y,1448322713112,221941,223038
REOPER.txt,101774,103230,1456,10,N,Y,1448322713112,221941,223038
REOPER.txt,102002,103280,1278,10,N,Y,1448322713112,221941,223038
REOPER.txt,102211,103392,1181,10,N,Y,1448322713112,221941,223038
REOPER.txt,102304,103600,1296,10,N,Y,1448322713112,221941,223038
REOPER.txt,102414,103707,1293,10,N,Y,1448322713112,221941,223038
REOPER.txt,102517,103769,1252,10,N,Y,1448322713112,221941,223038
REOPER.txt,102542,103952,1410,10,N,Y,1448322713112,221941,223038
REOPER.txt,102783,104089,1306,10,N,Y,1448322713112,221941,223038
REOPER.txt,102945,104142,1197,10,N,Y,1448322713112,221941,223038
REOPER.txt,103151,104299,1148,10,N,N,-,-1,-1
REOPER.txt,103231,104413,1182,10,N,N,-,-1,-1
REOPER.txt,103281,104568,1287,10,N,N,-,-1,-1
REOPER.txt,103395,104614,1219,10,N,N,-,-1,-1
REOPER.txt,103601,104690,1089,10,N,N,-,-1,-1
REOPER.txt,103708,104752,1044,10,N,N,-,-1,-1
REOPER.txt,103770,104858,1088,10,N,N,-,-1,-1
REOPER.txt,103953,105171,1218,10,N,N,-,-1,-1
REOPER.txt,104090,105395,1305,10,N,N,-,-1,-1
REOPER.txt,104143,105556,1413,10,N,N,-,-1,-1
REOPER.txt,104302,105691,1389,10,N,N,-,-1,-1
REOPER.txt,104414,105782,1368,10,N,N,-,-1,-1
REOPER.txt,104569,105864,1295,10,N,N,-,-1,-1
REOPER.txt,104615,105892,1277,10,N,N,-,-1,-1
REOPER.txt,104691,105921,1230,10,N,N,-,-1,-1
REOPER.txt,104753,105992,1239,10,N,N,-,-1,-1
REOPER.txt,104859,106056,1197,10,N,N,-,-1,-1
REOPER.txt,105172,106108,936,10,N,N,-,-1,-1
REOPER.txt,105396,106134,738,10,N,N,-,-1,-1
REOPER.txt,105557,106212,655,10,N,N,-,-1,-1
REOPER.txt,105693,106495,802,10,N,N,-,-1,-1
REOPER.txt,105783,106521,738,10,N,N,-,-1,-1
REOPER.txt,105865,106698,833,10,N,N,-,-1,-1
REOPER.txt,105893,106862,969,10,N,N,-,-1,-1
REOPER.txt,105922,107003,1081,10,N,N,-,-1,-1
REOPER.txt,105993,107026,1033,10,N,N,-,-1,-1
REOPER.txt,106059,107836,1777,10,N,N,-,-1,-1
REOPER.txt,106113,108233,2120,10,N,N,-,-1,-1
REOPER.txt,106135,108447,2312,10,N,Y,1448314402792,179959,180202
REOPER.txt,106213,108492,2279,10,N,Y,1448314402792,179959,180202
REOPER.txt,106496,108586,2090,10,N,Y,1448314402792,179959,180202
REOPER.txt,106523,108663,2140,10,N,Y,1448314402792,179959,180202
REOPER.txt,106699,108806,2107,10,Y,Y,1448314402792,179959,180202
REOPER.txt,106863,108842,1979,10,Y,Y,1448314402792,179959,180202
REOPER.txt,107008,108869,1861,10,Y,Y,1448314402792,179959,180202
REOPER.txt,107029,109034,2005,10,Y,Y,1448314402792,179959,180202
REOPER.txt,107841,109221,1380,10,N,Y,1448314402792,179959,180202
REOPER.txt,108235,109407,1172,10,N,Y,1448314402792,179959,180202
REOPER.txt,108448,109681,1233,10,Y,Y,1448314402792,179959,180202
REOPER.txt,108493,109772,1279,10,Y,Y,1448314402792,179959,180202
REOPER.txt,108587,110000,1413,10,Y,Y,1448314402792,179959,180202
REOPER.txt,108664,110267,1603,10,Y,Y,1448314402792,179959,180202
REOPER.txt,108807,110358,1551,10,N,Y,1448314402792,179959,180202
REOPER.txt,108843,110411,1568,10,N,Y,1448314402792,179959,180202
REOPER.txt,108870,110482,1612,10,N,Y,1448314402792,179959,180202
REOPER.txt,109035,110586,1551,10,N,Y,1448314402792,179959,180202
REOPER.txt,109222,110713,1491,10,N,Y,1448314402792,179959,180202
REOPER.txt,109410,110947,1537,10,N,Y,1448314402792,179959,180202
REOPER.txt,109682,111046,1364,10,N,Y,1448314402792,179959,180202
REOPER.txt,109773,111216,1443,10,N,N,-,-1,-1
REOPER.txt,110001,111361,1360,10,N,N,-,-1,-1
REOPER.txt,110270,111575,1305,10,N,N,-,-1,-1
REOPER.txt,110361,111714,1353,10,N,N,-,-1,-1
REOPER.txt,110412,111988,1576,10,N,N,-,-1,-1
REOPER.txt,110483,112119,1636,10,N,N,-,-1,-1
REOPER.txt,110587,112372,1785,10,N,N,-,-1,-1
REOPER.txt,110714,112507,1793,10,N,N,-,-1,-1
REOPER.txt,110950,112793,1843,10,N,N,-,-1,-1
REOPER.txt,111047,113031,1984,10,N,N,-,-1,-1
REOPER.txt,111218,113124,1906,10,N,N,-,-1,-1
REOPER.txt,111362,113211,1849,10,N,N,-,-1,-1
REOPER.txt,111576,113289,1713,10,N,N,-,-1,-1
REOPER.txt,111715,113306,1591,10,N,N,-,-1,-1
REOPER.txt,111991,113347,1356,10,N,N,-,-1,-1
REOPER.txt,112120,113388,1268,10,N,N,-,-1,-1
REOPER.txt,112373,113413,1040,10,N,N,-,-1,-1
REOPER.txt,112509,113660,1151,10,N,N,-,-1,-1
REOPER.txt,112794,113886,1092,10,N,N,-,-1,-1
REOPER.txt,113034,113984,950,10,N,N,-,-1,-1
REOPER.txt,113125,114260,1135,10,N,N,-,-1,-1
REOPER.txt,113212,114409,1197,10,N,N,-,-1,-1
REOPER.txt,113290,114694,1404,10,N,N,-,-1,-1
REOPER.txt,113308,114778,1470,10,N,N,-,-1,-1
REOPER.txt,113348,115067,1719,10,N,Y,1448311366799,143137,146264
REOPER.txt,113389,115308,1919,10,N,Y,1448311366799,143137,146264
REOPER.txt,113416,115679,2263,10,Y,Y,1448311366799,143137,146264
REOPER.txt,113661,115727,2066,10,Y,Y,1448311366799,143137,146264
REOPER.txt,113889,115871,1982,10,Y,Y,1448311366799,143137,146264
REOPER.txt,113987,116056,2069,10,Y,Y,1448311366799,143137,146264
REOPER.txt,114261,116127,1866,10,Y,Y,1448311366799,143137,146264
REOPER.txt,114412,116331,1919,10,Y,Y,1448311366799,143137,146264
REOPER.txt,114695,116634,1939,10,Y,Y,1448311366799,143137,146264
REOPER.txt,114781,116735,1954,10,Y,Y,1448311366799,143137,146264
REOPER.txt,115068,117068,2000,10,Y,Y,1448311366799,143137,146264
REOPER.txt,115309,117252,1943,10,Y,Y,1448311366799,143137,146264
REOPER.txt,115680,117425,1745,10,N,Y,1448311366799,143137,146264
REOPER.txt,115728,117504,1776,10,N,Y,1448311366799,143137,146264
REOPER.txt,115874,117652,1778,10,N,N,-,-1,-1
REOPER.txt,116057,117813,1756,10,N,N,-,-1,-1
REOPER.txt,116130,118138,2008,10,N,N,-,-1,-1
REOPER.txt,116334,118240,1906,10,N,N,-,-1,-1
REOPER.txt,116635,118242,1607,10,N,N,-,-1,-1
REOPER.txt,116738,118355,1617,10,N,N,-,-1,-1
REOPER.txt,117071,118463,1392,10,N,N,-,-1,-1
REOPER.txt,117253,118846,1593,10,N,N,-,-1,-1
REOPER.txt,117428,119004,1576,10,N,N,-,-1,-1
REOPER.txt,117505,119268,1763,10,N,N,-,-1,-1
REOPER.txt,117654,119382,1728,10,N,N,-,-1,-1
REOPER.txt,117816,119572,1756,10,N,N,-,-1,-1
REOPER.txt,118141,119638,1497,10,N,N,-,-1,-1
REOPER.txt,118240,119775,1535,10,N,N,-,-1,-1
REOPER.txt,118244,120032,1788,10,N,N,-,-1,-1
REOPER.txt,118357,120277,1920,10,N,N,-,-1,-1
REOPER.txt,118464,120355,1891,10,N,N,-,-1,-1
REOPER.txt,118847,120393,1546,10,N,N,-,-1,-1
REOPER.txt,119005,120531,1526,10,N,N,-,-1,-1
REOPER.txt,119269,120703,1434,10,N,N,-,-1,-1
REOPER.txt,119383,120819,1436,10,N,N,-,-1,-1
REOPER.txt,119575,120854,1279,10,N,N,-,-1,-1
REOPER.txt,119639,120997,1358,10,N,N,-,-1,-1
REOPER.txt,119776,121092,1316,10,N,N,-,-1,-1
REOPER.txt,120033,121250,1217,10,N,N,-,-1,-1
REOPER.txt,120278,121448,1170,10,N,N,-,-1,-1
REOPER.txt,120356,121518,1162,10,N,N,-,-1,-1
REOPER.txt,120394,121695,1301,10,N,N,-,-1,-1
REOPER.txt,120532,121870,1338,10,N,N,-,-1,-1
REOPER.txt,120704,121925,1221,10,N,N,-,-1,-1
REOPER.txt,120820,122064,1244,10,N,N,-,-1,-1
REOPER.txt,120855,122192,1337,10,N,N,-,-1,-1
REOPER.txt,121000,122333,1333,10,N,N,-,-1,-1
REOPER.txt,121095,122435,1340,10,N,N,-,-1,-1
REOPER.txt,121251,122489,1238,10,N,N,-,-1,-1
REOPER.txt,121449,122612,1163,10,N,N,-,-1,-1
REOPER.txt,121519,122895,1376,10,N,N,-,-1,-1
REOPER.txt,121696,123383,1687,10,N,N,-,-1,-1
REOPER.txt,121872,123464,1592,10,N,N,-,-1,-1
REOPER.txt,121927,123696,1769,10,N,N,-,-1,-1
REOPER.txt,122065,123799,1734,10,N,N,-,-1,-1
REOPER.txt,122193,123867,1674,10,N,N,-,-1,-1
REOPER.txt,122334,123891,1557,10,N,N,-,-1,-1
REOPER.txt,122436,124621,2185,10,N,N,-,-1,-1
REOPER.txt,122490,124841,2351,10,N,N,-,-1,-1
REOPER.txt,122615,124995,2380,10,N,N,-,-1,-1
REOPER.txt,122896,125090,2194,10,N,N,-,-1,-1
REOPER.txt,123386,125184,1798,10,N,N,-,-1,-1
REOPER.txt,123465,125291,1826,10,N,N,-,-1,-1
REOPER.txt,123697,125421,1724,10,N,N,-,-1,-1
REOPER.txt,123800,125443,1643,10,N,N,-,-1,-1
REOPER.txt,123872,125553,1681,10,N,N,-,-1,-1
REOPER.txt,123894,125685,1791,10,N,N,-,-1,-1
REOPER.txt,124624,125796,1172,10,N,N,-,-1,-1
REOPER.txt,124843,125848,1005,10,N,N,-,-1,-1
REOPER.txt,124996,126200,1204,10,N,N,-,-1,-1
REOPER.txt,125093,126288,1195,10,N,N,-,-1,-1
REOPER.txt,125185,126507,1322,10,Y,N,-,-1,-1
REOPER.txt,125292,126638,1346,10,N,N,-,-1,-1
REOPER.txt,125426,126700,1274,10,N,N,-,-1,-1
REOPER.txt,125444,126946,1502,10,N,N,-,-1,-1
REOPER.txt,125556,127032,1476,10,N,N,-,-1,-1
REOPER.txt,125686,127195,1509,10,N,N,-,-1,-1
REOPER.txt,125797,127242,1445,10,Y,N,-,-1,-1
REOPER.txt,125849,127270,1421,10,Y,N,-,-1,-1
REOPER.txt,126202,127404,1202,10,Y,N,-,-1,-1
REOPER.txt,126289,127708,1419,10,Y,N,-,-1,-1
REOPER.txt,126510,127961,1451,10,N,N,-,-1,-1
REOPER.txt,126639,128128,1489,10,N,N,-,-1,-1
REOPER.txt,126701,128301,1600,10,N,N,-,-1,-1
REOPER.txt,126947,128506,1559,10,N,N,-,-1,-1
REOPER.txt,127033,128682,1649,10,N,N,-,-1,-1
REOPER.txt,127196,128867,1671,10,N,N,-,-1,-1
REOPER.txt,127245,129065,1820,10,N,N,-,-1,-1
REOPER.txt,127271,129281,2010,10,N,N,-,-1,-1
REOPER.txt,127406,129450,2044,10,N,N,-,-1,-1
REOPER.txt,127709,129531,1822,10,N,N,-,-1,-1
REOPER.txt,127962,129595,1633,10,N,N,-,-1,-1
REOPER.txt,128131,129918,1787,10,N,N,-,-1,-1
REOPER.txt,128302,130126,1824,10,N,N,-,-1,-1
REOPER.txt,128508,130270,1762,10,N,N,-,-1,-1
REOPER.txt,128683,130454,1771,10,N,N,-,-1,-1
REOPER.txt,128870,130607,1737,10,N,N,-,-1,-1
REOPER.txt,129066,130708,1642,10,N,N,-,-1,-1
REOPER.txt,129283,130859,1576,10,N,N,-,-1,-1
REOPER.txt,129452,130905,1453,10,N,N,-,-1,-1
REOPER.txt,129532,131093,1561,10,Y,N,-,-1,-1
REOPER.txt,129596,131452,1856,10,Y,N,-,-1,-1
REOPER.txt,129919,131621,1702,10,N,N,-,-1,-1
REOPER.txt,130127,131800,1673,10,Y,N,-,-1,-1
REOPER.txt,130271,132093,1822,10,Y,N,-,-1,-1
REOPER.txt,130457,132221,1764,10,Y,N,-,-1,-1
REOPER.txt,130608,132439,1831,10,Y,N,-,-1,-1
REOPER.txt,130709,132641,1932,10,Y,N,-,-1,-1
REOPER.txt,130862,132811,1949,10,N,N,-,-1,-1
REOPER.txt,130906,132878,1972,10,N,N,-,-1,-1
REOPER.txt,131094,132967,1873,10,N,N,-,-1,-1
REOPER.txt,131453,133070,1617,10,N,N,-,-1,-1
REOPER.txt,131624,133203,1579,10,N,N,-,-1,-1
REOPER.txt,131801,133606,1805,10,N,N,-,-1,-1
REOPER.txt,132096,133752,1656,10,N,N,-,-1,-1
REOPER.txt,132222,133920,1698,10,N,N,-,-1,-1
REOPER.txt,132440,134215,1775,10,N,N,-,-1,-1
REOPER.txt,132646,134391,1745,10,N,N,-,-1,-1
REOPER.txt,132814,134415,1601,10,N,N,-,-1,-1
REOPER.txt,132879,134507,1628,10,N,Y,1437472380836,351899,352666
REOPER.txt,132968,134608,1640,10,N,Y,1437472380836,351899,352666
REOPER.txt,133071,134713,1642,10,N,Y,1437472380836,351899,352666
REOPER.txt,133204,134822,1618,10,N,Y,1437472380836,351899,352666
REOPER.txt,133607,135048,1441,10,N,Y,1437472380836,351899,352666
REOPER.txt,133754,135455,1701,10,N,Y,1437472380836,351899,352666
REOPER.txt,133921,135629,1708,10,N,Y,1437472380836,351899,352666
REOPER.txt,134216,135866,1650,10,N,Y,1437472380836,351899,352666
REOPER.txt,134392,136041,1649,10,N,Y,1437472380836,351899,352666
REOPER.txt,134418,136083,1665,10,N,Y,1437472380836,351899,352666
REOPER.txt,134510,136192,1682,10,N,Y,1437472380836,351899,352666
REOPER.txt,134609,136327,1718,10,N,Y,1437472380836,351899,352666
REOPER.txt,134714,136425,1711,10,Y,Y,1437472380836,351899,352666
REOPER.txt,134823,136582,1759,10,N,Y,1437472380836,351899,352666
REOPER.txt,135049,136711,1662,10,N,Y,1437472380836,351899,352666
REOPER.txt,135456,137012,1556,10,N,N,-,-1,-1
REOPER.txt,135631,137151,1520,10,N,N,-,-1,-1
REOPER.txt,135869,137272,1403,10,N,N,-,-1,-1
REOPER.txt,136042,137368,1326,10,N,N,-,-1,-1
REOPER.txt,136086,137602,1516,10,N,Y,1448313994373,179347,179715
REOPER.txt,136194,137687,1493,10,N,Y,1448313994373,179347,179715
REOPER.txt,136328,137772,1444,10,N,Y,1448313994373,179347,179715
REOPER.txt,136426,137867,1441,10,N,Y,1448313994373,179347,179715
REOPER.txt,136583,137912,1329,10,N,Y,1448313994373,179347,179715
REOPER.txt,136712,138104,1392,10,N,Y,1448313994373,179347,179715
REOPER.txt,137013,138147,1134,10,N,Y,1448313994373,179347,179715
REOPER.txt,137152,138235,1083,10,N,Y,1448313994373,179347,179715
REOPER.txt,137274,138424,1150,10,N,Y,1448313994373,179347,179715
REOPER.txt,137371,138515,1144,10,N,Y,1448313994373,179347,179715
REOPER.txt,137605,138568,963,10,N,Y,1448313994373,179347,179715
REOPER.txt,137688,138743,1055,10,N,Y,1448313994373,179347,179715
REOPER.txt,137773,138868,1095,10,N,Y,1448313994373,179347,179715
REOPER.txt,137868,139018,1150,10,N,Y,1448313994373,179347,179715
REOPER.txt,137913,139199,1286,10,N,Y,1448313994373,179347,179715
REOPER.txt,138107,139538,1431,10,Y,Y,1448313994373,179347,179715
REOPER.txt,138148,139829,1681,10,Y,Y,1448313994373,179347,179715
REOPER.txt,138236,139956,1720,10,N,Y,1448313994373,179347,179715
REOPER.txt,138426,139969,1543,10,N,Y,1448313994373,179347,179715
REOPER.txt,138516,140131,1615,10,Y,Y,1448313994373,179347,179715
REOPER.txt,138571,140235,1664,10,Y,Y,1448313994373,179347,179715
REOPER.txt,138744,140490,1746,10,N,Y,1448313994373,179347,179715
REOPER.txt,138869,140528,1659,10,N,Y,1448313994373,179347,179715
REOPER.txt,139019,140739,1720,10,N,Y,1448313994373,179347,179715
REOPER.txt,139200,140873,1673,10,N,N,-,-1,-1
REOPER.txt,139541,141048,1507,10,N,N,-,-1,-1
REOPER.txt,139830,141249,1419,10,N,N,-,-1,-1
REOPER.txt,139957,141465,1508,10,N,N,-,-1,-1
REOPER.txt,139970,141655,1685,10,N,N,-,-1,-1
REOPER.txt,140133,141782,1649,10,N,N,-,-1,-1
REOPER.txt,140238,141981,1743,10,N,N,-,-1,-1
REOPER.txt,140491,142182,1691,10,N,N,-,-1,-1
REOPER.txt,140529,142450,1921,10,N,N,-,-1,-1
REOPER.txt,140740,142576,1836,10,N,N,-,-1,-1
REOPER.txt,140874,142622,1748,10,N,N,-,-1,-1
REOPER.txt,141051,142691,1640,10,N,N,-,-1,-1
REOPER.txt,141250,142843,1593,10,N,N,-,-1,-1
REOPER.txt,141467,142933,1466,10,N,N,-,-1,-1
REOPER.txt,141656,143027,1371,10,N,Y,1437471855423,351318,351853
REOPER.txt,141785,143169,1384,10,N,Y,1437471855423,351318,351853
REOPER.txt,141982,143270,1288,10,N,Y,1437471855423,351318,351853
REOPER.txt,142183,143554,1371,10,N,Y,1437471855423,351318,351853
REOPER.txt,142453,143579,1126,10,N,Y,1437471855423,351318,351853
REOPER.txt,142577,143687,1110,10,N,Y,1437471855423,351318,351853
REOPER.txt,142623,143801,1178,10,N,Y,1437471855423,351318,351853
REOPER.txt,142692,143882,1190,10,N,Y,1437471855423,351318,351853
REOPER.txt,142844,143939,1095,10,N,Y,1437471855423,351318,351853
REOPER.txt,142936,144154,1218,10,N,Y,1437471855423,351318,351853
REOPER.txt,143028,144327,1299,10,N,Y,1437471855423,351318,351853
REOPER.txt,143170,144408,1238,10,N,Y,1437471855423,351318,351853
REOPER.txt,143271,144595,1324,10,N,Y,1437471855423,351318,351853
REOPER.txt,143555,144727,1172,10,N,Y,1437471855423,351318,351853
REOPER.txt,143580,144815,1235,10,N,Y,1437471855423,351318,351853
REOPER.txt,143688,144894,1206,10,N,Y,1437471855423,351318,351853
REOPER.txt,143802,145013,1211,10,N,Y,1437471855423,351318,351853
REOPER.txt,143883,145116,1233,10,N,Y,1437471855423,351318,351853
REOPER.txt,143940,145369,1429,10,N,Y,1437471855423,351318,351853
REOPER.txt,144155,145404,1249,10,N,Y,1437471855423,351318,351853
REOPER.txt,144330,145552,1222,10,N,Y,1448279089520,67624,69991
REOPER.txt,144409,145912,1503,10,N,Y,1448279089520,67624,69991
REOPER.txt,144597,146038,1441,10,N,Y,1448279089520,67624,69991
REOPER.txt,144728,146220,1492,10,N,Y,1448279089520,67624,69991
REOPER.txt,144817,146360,1543,10,N,Y,1448279089520,67624,69991
REOPER.txt,144895,146762,1867,10,N,Y,1448279089520,67624,69991
REOPER.txt,145014,146931,1917,10,N,Y,1448279089520,67624,69991
REOPER.txt,145117,146950,1833,10,N,Y,1448279089520,67624,69991
REOPER.txt,145374,147020,1646,10,N,Y,1448279089520,67624,69991
REOPER.txt,145407,147058,1651,10,N,Y,1448279089520,67624,69991
REOPER.txt,145555,147215,1660,10,N,N,-,-1,-1
REOPER.txt,145913,147645,1732,10,N,N,-,-1,-1
REOPER.txt,146039,147910,1871,10,N,N,-,-1,-1
REOPER.txt,146221,148018,1797,10,N,N,-,-1,-1
REOPER.txt,146361,148433,2072,10,N,N,-,-1,-1
REOPER.txt,146764,148643,1879,10,N,N,-,-1,-1
REOPER.txt,146932,148796,1864,10,N,N,-,-1,-1
REOPER.txt,146951,149024,2073,10,N,N,-,-1,-1
REOPER.txt,147021,149108,2087,10,N,N,-,-1,-1
REOPER.txt,147059,149259,2200,10,N,N,-,-1,-1
REOPER.txt,147216,149563,2347,10,N,N,-,-1,-1
REOPER.txt,147648,149695,2047,10,N,N,-,-1,-1
REOPER.txt,147911,150132,2221,10,N,N,-,-1,-1
REOPER.txt,148019,150297,2278,10,N,N,-,-1,-1
REOPER.txt,148436,150546,2110,10,N,N,-,-1,-1
REOPER.txt,148644,150587,1943,10,N,N,-,-1,-1
REOPER.txt,148797,150628,1831,10,N,N,-,-1,-1
REOPER.txt,149027,150740,1713,10,N,N,-,-1,-1
REOPER.txt,149111,150824,1713,10,N,N,-,-1,-1
REOPER.txt,149260,150957,1697,10,N,N,-,-1,-1
REOPER.txt,149565,151011,1446,10,N,N,-,-1,-1
REOPER.txt,149698,151036,1338,10,N,N,-,-1,-1
REOPER.txt,150135,151763,1628,10,N,N,-,-1,-1
REOPER.txt,150299,151963,1664,10,N,N,-,-1,-1
REOPER.txt,150547,152188,1641,10,N,N,-,-1,-1
REOPER.txt,150588,152306,1718,10,N,N,-,-1,-1
REOPER.txt,150630,152428,1798,10,N,N,-,-1,-1
REOPER.txt,150741,152548,1807,10,N,N,-,-1,-1
REOPER.txt,150825,152633,1808,10,N,N,-,-1,-1
REOPER.txt,150958,152968,2010,10,N,N,-,-1,-1
REOPER.txt,151016,153107,2091,10,N,N,-,-1,-1
REOPER.txt,151039,153157,2118,10,N,N,-,-1,-1
REOPER.txt,151766,153255,1489,10,N,N,-,-1,-1
REOPER.txt,151964,153396,1432,10,N,N,-,-1,-1
REOPER.txt,152189,153564,1375,10,N,N,-,-1,-1
REOPER.txt,152307,153684,1377,10,N,N,-,-1,-1
REOPER.txt,152429,153965,1536,10,N,N,-,-1,-1
REOPER.txt,152550,154250,1700,10,N,N,-,-1,-1
REOPER.txt,152634,154419,1785,10,N,N,-,-1,-1
REOPER.txt,152969,154437,1468,10,N,N,-,-1,-1
REOPER.txt,153110,154696,1586,10,N,N,-,-1,-1
REOPER.txt,153158,154806,1648,10,N,N,-,-1,-1
REOPER.txt,153258,154986,1728,10,N,N,-,-1,-1
REOPER.txt,153397,155288,1891,10,N,N,-,-1,-1
REOPER.txt,153565,155447,1882,10,N,Y,1448274783410,21836,25159
REOPER.txt,153686,155593,1907,10,N,Y,1448274783410,21836,25159
REOPER.txt,153966,155674,1708,10,N,Y,1448274783410,21836,25159
REOPER.txt,154251,155974,1723,10,Y,Y,1448274783410,21836,25159
REOPER.txt,154422,156124,1702,10,Y,Y,1448274783410,21836,25159
REOPER.txt,154438,156260,1822,10,Y,Y,1448274783410,21836,25159
REOPER.txt,154697,156332,1635,10,Y,Y,1448274783410,21836,25159
REOPER.txt,154807,156418,1611,10,Y,Y,1448274783410,21836,25159
REOPER.txt,154987,156557,1570,10,Y,Y,1448274783410,21836,25159
REOPER.txt,155291,156652,1361,10,Y,Y,1448274783410,21836,25159
REOPER.txt,155448,156918,1470,10,N,Y,1448274783410,21836,25159
REOPER.txt,155594,156972,1378,10,N,Y,1448274783410,21836,25159
REOPER.txt,155675,157155,1480,10,N,Y,1448274783410,21836,25159
REOPER.txt,155975,157313,1338,10,N,Y,1448274783410,21836,25159
REOPER.txt,156127,157503,1376,10,N,N,-,-1,-1
REOPER.txt,156261,157742,1481,10,N,N,-,-1,-1
REOPER.txt,156333,157826,1493,10,N,N,-,-1,-1
REOPER.txt,156419,157933,1514,10,N,N,-,-1,-1
REOPER.txt,156558,158088,1530,10,N,N,-,-1,-1
REOPER.txt,156653,158160,1507,10,N,N,-,-1,-1
REOPER.txt,156919,158255,1336,10,N,N,-,-1,-1
REOPER.txt,156973,158535,1562,10,N,N,-,-1,-1
REOPER.txt,157156,158577,1421,10,N,N,-,-1,-1
REOPER.txt,157314,159006,1692,10,N,N,-,-1,-1
REOPER.txt,157504,159181,1677,10,N,N,-,-1,-1
REOPER.txt,157744,159422,1678,10,N,N,-,-1,-1
REOPER.txt,157827,159577,1750,10,N,N,-,-1,-1
REOPER.txt,157934,159946,2012,10,N,N,-,-1,-1
REOPER.txt,158089,160289,2200,10,N,N,-,-1,-1
REOPER.txt,158163,160474,2311,10,N,N,-,-1,-1
REOPER.txt,158256,160563,2307,10,N,N,-,-1,-1
REOPER.txt,158536,160619,2083,10,N,N,-,-1,-1
REOPER.txt,158578,160705,2127,10,N,N,-,-1,-1
REOPER.txt,159009,160851,1842,10,N,N,-,-1,-1
REOPER.txt,159182,161023,1841,10,N,N,-,-1,-1
REOPER.txt,159423,161046,1623,10,N,N,-,-1,-1
REOPER.txt,159578,161502,1924,10,N,N,-,-1,-1
REOPER.txt,159947,161589,1642,10,N,N,-,-1,-1
REOPER.txt,160292,161701,1409,10,N,N,-,-1,-1
REOPER.txt,160475,161776,1301,10,N,N,-,-1,-1
REOPER.txt,160564,161996,1432,10,N,N,-,-1,-1
REOPER.txt,160621,162110,1489,10,N,N,-,-1,-1
REOPER.txt,160706,162254,1548,10,N,N,-,-1,-1
REOPER.txt,160854,162275,1421,10,N,N,-,-1,-1
REOPER.txt,161028,162348,1320,10,N,N,-,-1,-1
REOPER.txt,161049,162387,1338,10,N,N,-,-1,-1
REOPER.txt,161505,162480,975,10,N,N,-,-1,-1
REOPER.txt,161590,162563,973,10,N,N,-,-1,-1
REOPER.txt,161702,162852,1150,10,N,N,-,-1,-1
REOPER.txt,161777,163178,1401,10,N,N,-,-1,-1
REOPER.txt,161997,163325,1328,10,N,N,-,-1,-1
REOPER.txt,162111,163426,1315,10,N,N,-,-1,-1
REOPER.txt,162257,163526,1269,10,N,N,-,-1,-1
REOPER.txt,162275,163773,1498,10,N,N,-,-1,-1
REOPER.txt,162349,163843,1494,10,N,N,-,-1,-1
REOPER.txt,162388,163912,1524,10,N,N,-,-1,-1
REOPER.txt,162481,164062,1581,10,N,N,-,-1,-1
REOPER.txt,162564,164321,1757,10,N,N,-,-1,-1
REOPER.txt,162853,164341,1488,10,N,N,-,-1,-1
REOPER.txt,163179,164500,1321,10,N,N,-,-1,-1
REOPER.txt,163326,164684,1358,10,N,N,-,-1,-1
REOPER.txt,163428,164865,1437,10,N,N,-,-1,-1
REOPER.txt,163527,164907,1380,10,N,N,-,-1,-1
REOPER.txt,163774,165107,1333,10,N,N,-,-1,-1
REOPER.txt,163844,165176,1332,10,N,N,-,-1,-1
REOPER.txt,163913,165324,1411,10,N,N,-,-1,-1
REOPER.txt,164065,165420,1355,10,N,N,-,-1,-1
REOPER.txt,164324,165644,1320,10,N,N,-,-1,-1
REOPER.txt,164342,165828,1486,10,N,N,-,-1,-1
REOPER.txt,164501,166066,1565,10,N,N,-,-1,-1
REOPER.txt,164685,166106,1421,10,N,N,-,-1,-1
REOPER.txt,164867,166230,1363,10,N,N,-,-1,-1
REOPER.txt,164908,166507,1599,10,N,N,-,-1,-1
REOPER.txt,165108,166702,1594,10,N,N,-,-1,-1
REOPER.txt,165177,166847,1670,10,N,N,-,-1,-1
REOPER.txt,165327,166932,1605,10,N,N,-,-1,-1
REOPER.txt,165421,167043,1622,10,N,N,-,-1,-1
REOPER.txt,165645,167238,1593,10,N,N,-,-1,-1
REOPER.txt,165829,167618,1789,10,N,N,-,-1,-1
REOPER.txt,166067,167694,1627,10,N,N,-,-1,-1
REOPER.txt,166107,167752,1645,10,N,N,-,-1,-1
REOPER.txt,166231,167816,1585,10,N,N,-,-1,-1
REOPER.txt,166508,167930,1422,10,N,N,-,-1,-1
REOPER.txt,166705,167967,1262,10,Y,N,-,-1,-1
REOPER.txt,166848,168088,1240,10,Y,N,-,-1,-1
REOPER.txt,166933,168218,1285,10,Y,N,-,-1,-1
REOPER.txt,167044,168413,1369,10,N,Y,1448275023016,26258,26837
REOPER.txt,167239,168608,1369,10,Y,Y,1448275023016,26258,26837
REOPER.txt,167621,168690,1069,10,Y,Y,1448275023016,26258,26837
REOPER.txt,167695,168809,1114,10,Y,Y,1448275023016,26258,26837
REOPER.txt,167753,168985,1232,10,Y,Y,1448275023016,26258,26837
REOPER.txt,167817,169117,1300,10,Y,Y,1448275023016,26258,26837
REOPER.txt,167933,169268,1335,10,Y,Y,1436867017136,105674,106651
REOPER.txt,167968,169414,1446,10,N,Y,1436867017136,105674,106651
REOPER.txt,168089,169447,1358,10,N,Y,1436867017136,105674,106651
REOPER.txt,168221,169621,1400,10,N,Y,1436867017136,105674,106651
REOPER.txt,168414,169720,1306,10,N,Y,1436867017136,105674,106651
REOPER.txt,168609,169745,1136,10,N,Y,1436867017136,105674,106651
REOPER.txt,168691,169825,1134,10,N,Y,1436867017136,105674,106651
REOPER.txt,168810,169974,1164,10,N,Y,1436867017136,105674,106651
REOPER.txt,168986,170047,1061,10,N,Y,1436867017136,105674,106651
REOPER.txt,169118,170196,1078,10,N,Y,1436867017136,105674,106651
REOPER.txt,169269,170283,1014,10,N,Y,1436867017136,105674,106651
REOPER.txt,169415,170348,933,10,N,Y,1436867017136,105674,106651
REOPER.txt,169448,170548,1100,10,N,Y,1436867017136,105674,106651
REOPER.txt,169624,170704,1080,10,N,N,-,-1,-1
REOPER.txt,169721,170873,1152,10,N,N,-,-1,-1
REOPER.txt,169746,171051,1305,10,N,N,-,-1,-1
REOPER.txt,169826,171187,1361,10,N,N,-,-1,-1
REOPER.txt,169975,171267,1292,10,N,N,-,-1,-1
REOPER.txt,170048,171523,1475,10,N,N,-,-1,-1
REOPER.txt,170199,171558,1359,10,N,N,-,-1,-1
REOPER.txt,170284,171737,1453,10,N,N,-,-1,-1
REOPER.txt,170349,171917,1568,10,N,N,-,-1,-1
REOPER.txt,170551,172054,1503,10,N,N,-,-1,-1
REOPER.txt,170705,172206,1501,10,N,N,-,-1,-1
REOPER.txt,170874,172250,1376,10,N,N,-,-1,-1
REOPER.txt,171052,172316,1264,10,N,N,-,-1,-1
REOPER.txt,171188,172544,1356,10,N,N,-,-1,-1
REOPER.txt,171268,172678,1410,10,N,N,-,-1,-1
REOPER.txt,171528,172822,1294,10,N,N,-,-1,-1
REOPER.txt,171561,172920,1359,10,N,N,-,-1,-1
REOPER.txt,171740,173026,1286,10,N,N,-,-1,-1
REOPER.txt,171918,173197,1279,10,N,N,-,-1,-1
REOPER.txt,172055,173338,1283,10,N,N,-,-1,-1
REOPER.txt,172207,173453,1246,10,N,N,-,-1,-1
REOPER.txt,172251,173638,1387,10,N,N,-,-1,-1
REOPER.txt,172317,173769,1452,10,N,N,-,-1,-1
REOPER.txt,172545,173786,1241,10,N,N,-,-1,-1
REOPER.txt,172679,173944,1265,10,N,N,-,-1,-1
REOPER.txt,172823,174164,1341,10,N,N,-,-1,-1
REOPER.txt,172921,174598,1677,10,N,N,-,-1,-1
REOPER.txt,173027,174926,1899,10,N,N,-,-1,-1
REOPER.txt,173200,175127,1927,10,N,Y,1448276340407,30017,39003
REOPER.txt,173339,175335,1996,10,N,Y,1448276340407,30017,39003
REOPER.txt,173455,175388,1933,10,N,Y,1448276340407,30017,39003
REOPER.txt,173639,175655,2016,10,N,Y,1448276340407,30017,39003
REOPER.txt,173770,175860,2090,10,N,Y,1448276340407,30017,39003
REOPER.txt,173789,176146,2357,10,N,Y,1448276340407,30017,39003
REOPER.txt,173946,176246,2300,10,Y,Y,1448276340407,30017,39003
REOPER.txt,174165,176633,2468,10,N,Y,1448276340407,30017,39003
REOPER.txt,174599,176728,2129,10,N,Y,1448276340407,30017,39003
REOPER.txt,174929,176908,1979,10,N,Y,1448276340407,30017,39003
REOPER.txt,175130,176926,1796,10,N,Y,1448276340407,30017,39003
REOPER.txt,175336,177418,2082,10,N,Y,1448276340407,30017,39003
REOPER.txt,175391,177588,2197,10,N,Y,1448276340407,30017,39003
REOPER.txt,175655,177692,2037,10,N,Y,1448280884746,88496,89294
REOPER.txt,175861,177848,1987,10,N,Y,1448280884746,88496,89294
REOPER.txt,176147,178122,1975,10,N,Y,1448280884746,88496,89294
REOPER.txt,176247,178185,1938,10,N,Y,1448280884746,88496,89294
REOPER.txt,176634,178276,1642,10,N,Y,1448280884746,88496,89294
REOPER.txt,176731,178345,1614,10,N,Y,1448280884746,88496,89294
REOPER.txt,176909,178461,1552,10,N,Y,1448280884746,88496,89294
REOPER.txt,176926,178588,1662,10,N,Y,1448280884746,88496,89294
REOPER.txt,177421,178660,1239,10,N,Y,1448280884746,88496,89294
REOPER.txt,177590,178708,1118,10,N,Y,1448280884746,88496,89294
REOPER.txt,177693,178860,1167,10,N,Y,1448280884746,88496,89294
REOPER.txt,177849,179031,1182,10,N,Y,1448280884746,88496,89294
REOPER.txt,178123,179199,1076,10,N,Y,1448280884746,88496,89294
REOPER.txt,178186,179404,1218,10,N,Y,1448280884746,88496,89294
REOPER.txt,178277,179636,1359,10,N,Y,1448280884746,88496,89294
REOPER.txt,178347,179882,1535,10,Y,Y,1448280884746,88496,89294
REOPER.txt,178464,180028,1564,10,Y,Y,1448280884746,88496,89294
REOPER.txt,178589,180186,1597,10,Y,Y,1448280884746,88496,89294
REOPER.txt,178663,180374,1711,10,Y,Y,1448280884746,88496,89294
REOPER.txt,178709,180503,1794,10,Y,Y,1448280884746,88496,89294
REOPER.txt,178861,180706,1845,10,Y,Y,1448280884746,88496,89294
REOPER.txt,179032,180942,1910,10,Y,Y,1448280884746,88496,89294
REOPER.txt,179202,181050,1848,10,Y,Y,1448281491382,97818,98860
REOPER.txt,179405,181301,1896,10,Y,Y,1448281491382,97818,98860
REOPER.txt,179638,181496,1858,10,Y,Y,1448281491382,97818,98860
REOPER.txt,179883,181687,1804,10,Y,Y,1448281491382,97818,98860
REOPER.txt,180029,181833,1804,10,N,Y,1448281491382,97818,98860
REOPER.txt,180188,182017,1829,10,N,Y,1448281491382,97818,98860
REOPER.txt,180375,182085,1710,10,N,Y,1448281491382,97818,98860
REOPER.txt,180504,182330,1826,10,N,Y,1448281491382,97818,98860
REOPER.txt,180707,182457,1750,10,N,Y,1448281491382,97818,98860
REOPER.txt,180945,182553,1608,10,N,Y,1448281491382,97818,98860
REOPER.txt,181052,182680,1628,10,N,Y,1448281491382,97818,98860
REOPER.txt,181302,183055,1753,10,N,Y,1448281491382,97818,98860
REOPER.txt,181497,183296,1799,10,N,Y,1448281491382,97818,98860
REOPER.txt,181690,183636,1946,10,N,N,-,-1,-1
REOPER.txt,181834,183860,2026,10,N,N,-,-1,-1
REOPER.txt,182018,183915,1897,10,N,N,-,-1,-1
REOPER.txt,182088,184044,1956,10,N,N,-,-1,-1
REOPER.txt,182333,184081,1748,10,N,N,-,-1,-1
REOPER.txt,182458,184108,1650,10,N,N,-,-1,-1
REOPER.txt,182554,184249,1695,10,N,N,-,-1,-1
REOPER.txt,182681,184358,1677,10,N,N,-,-1,-1
REOPER.txt,183056,184490,1434,10,N,N,-,-1,-1
REOPER.txt,183299,184559,1260,10,N,N,-,-1,-1
REOPER.txt,183639,184838,1199,10,N,N,-,-1,-1
REOPER.txt,183862,185054,1192,10,N,N,-,-1,-1
REOPER.txt,183917,185161,1244,10,N,N,-,-1,-1
REOPER.txt,184045,185332,1287,10,N,N,-,-1,-1
REOPER.txt,184086,185480,1394,10,N,N,-,-1,-1
REOPER.txt,184109,185730,1621,10,N,N,-,-1,-1
REOPER.txt,184250,185882,1632,10,N,N,-,-1,-1
REOPER.txt,184359,185917,1558,10,N,N,-,-1,-1
REOPER.txt,184491,185999,1508,10,N,N,-,-1,-1
REOPER.txt,184560,186143,1583,10,N,N,-,-1,-1
REOPER.txt,184841,186169,1328,10,N,N,-,-1,-1
REOPER.txt,185055,186394,1339,10,N,N,-,-1,-1
REOPER.txt,185164,186426,1262,10,N,N,-,-1,-1
REOPER.txt,185333,186715,1382,10,N,N,-,-1,-1
REOPER.txt,185481,186851,1370,10,N,N,-,-1,-1
REOPER.txt,185731,186947,1216,10,N,N,-,-1,-1
REOPER.txt,185887,187179,1292,10,N,N,-,-1,-1
REOPER.txt,185920,187432,1512,10,Y,N,-,-1,-1
REOPER.txt,186002,187655,1653,10,Y,N,-,-1,-1
REOPER.txt,186144,187685,1541,10,Y,N,-,-1,-1
REOPER.txt,186170,187819,1649,10,Y,N,-,-1,-1
REOPER.txt,186395,188137,1742,10,Y,N,-,-1,-1
REOPER.txt,186427,188208,1781,10,Y,N,-,-1,-1
REOPER.txt,186716,188434,1718,10,Y,N,-,-1,-1
REOPER.txt,186852,188585,1733,10,Y,N,-,-1,-1
REOPER.txt,186948,188687,1739,10,Y,N,-,-1,-1
REOPER.txt,187182,188807,1625,10,N,N,-,-1,-1
REOPER.txt,187433,188899,1466,10,N,N,-,-1,-1
REOPER.txt,187660,189224,1564,10,N,N,-,-1,-1
REOPER.txt,187686,189298,1612,10,N,N,-,-1,-1
REOPER.txt,187820,189400,1580,10,N,N,-,-1,-1
REOPER.txt,188138,189496,1358,10,N,N,-,-1,-1
REOPER.txt,188209,189531,1322,10,N,N,-,-1,-1
REOPER.txt,188435,189679,1244,10,N,N,-,-1,-1
REOPER.txt,188586,189997,1411,10,N,N,-,-1,-1
REOPER.txt,188690,190049,1359,10,N,N,-,-1,-1
REOPER.txt,188808,190265,1457,10,N,N,-,-1,-1
REOPER.txt,188900,190419,1519,10,N,N,-,-1,-1
REOPER.txt,189225,190597,1372,10,N,N,-,-1,-1
REOPER.txt,189299,190722,1423,10,N,N,-,-1,-1
REOPER.txt,189401,190927,1526,10,N,N,-,-1,-1
REOPER.txt,189501,191085,1584,10,N,N,-,-1,-1
REOPER.txt,189534,191372,1838,10,N,N,-,-1,-1
REOPER.txt,189682,191395,1713,10,N,N,-,-1,-1
REOPER.txt,189998,191513,1515,10,N,N,-,-1,-1
REOPER.txt,190050,191651,1601,10,N,N,-,-1,-1
REOPER.txt,190268,192021,1753,10,N,N,-,-1,-1
REOPER.txt,190420,192171,1751,10,N,N,-,-1,-1
REOPER.txt,190599,192260,1661,10,N,N,-,-1,-1
REOPER.txt,190723,192338,1615,10,N,N,-,-1,-1
REOPER.txt,190928,192453,1525,10,N,N,-,-1,-1
REOPER.txt,191086,192634,1548,10,N,N,-,-1,-1
REOPER.txt,191377,192823,1446,10,N,N,-,-1,-1
REOPER.txt,191396,192884,1488,10,N,N,-,-1,-1
REOPER.txt,191514,192970,1456,10,N,N,-,-1,-1
REOPER.txt,191652,193067,1415,10,N,N,-,-1,-1
REOPER.txt,192022,193088,1066,10,N,N,-,-1,-1
REOPER.txt,192174,193126,952,10,N,N,-,-1,-1
REOPER.txt,192261,193212,951,10,N,N,-,-1,-1
REOPER.txt,192339,193419,1080,10,N,N,-,-1,-1
REOPER.txt,192454,193733,1279,10,N,N,-,-1,-1
REOPER.txt,192635,193936,1301,10,N,N,-,-1,-1
REOPER.txt,192824,193947,1123,10,N,N,-,-1,-1
REOPER.txt,192886,194004,1118,10,N,N,-,-1,-1
REOPER.txt,192971,194035,1064,10,N,N,-,-1,-1
REOPER.txt,193070,194044,974,10,N,N,-,-1,-1
REOPER.txt,193089,194096,1007,10,N,N,-,-1,-1
REOPER.txt,193127,194109,982,10,N,N,-,-1,-1
REOPER.txt,193215,194216,1001,10,N,N,-,-1,-1
REOPER.txt,193420,194332,912,10,N,N,-,-1,-1
REOPER.txt,193736,194347,611,10,N,N,-,-1,-1
REOPER.txt,193937,194394,457,10,N,N,-,-1,-1
REOPER.txt,193948,194405,457,10,N,N,-,-1,-1
REOPER.txt,194005,194452,447,10,N,N,-,-1,-1
REOPER.txt,194038,194494,456,10,N,N,-,-1,-1
REOPER.txt,194045,194506,461,10,N,N,-,-1,-1
REOPER.txt,194099,194551,452,10,N,N,-,-1,-1
REOPER.txt,194110,194563,453,10,N,N,-,-1,-1
REOPER.txt,194217,194643,426,10,N,N,-,-1,-1
REOPER.txt,194335,194674,339,10,N,N,-,-1,-1
REOPER.txt,194348,194684,336,10,N,N,-,-1,-1
REOPER.txt,194397,194703,306,10,N,N,-,-1,-1
REOPER.txt,194406,194785,379,10,N,N,-,-1,-1
REOPER.txt,194453,194839,386,10,N,N,-,-1,-1
REOPER.txt,194497,194848,351,10,N,N,-,-1,-1
REOPER.txt,194507,194929,422,10,N,N,-,-1,-1
REOPER.txt,194554,194934,380,10,N,N,-,-1,-1
REOPER.txt,194564,194985,421,10,N,N,-,-1,-1
REOPER.txt,194644,195000,356,10,N,N,-,-1,-1
REOPER.txt,194677,195012,335,10,N,N,-,-1,-1
REOPER.txt,194685,195176,491,10,N,N,-,-1,-1
REOPER.txt,194704,195198,494,10,N,N,-,-1,-1
REOPER.txt,194786,195210,424,10,N,N,-,-1,-1
REOPER.txt,194842,195268,426,10,N,N,-,-1,-1
REOPER.txt,194849,195277,428,10,N,N,-,-1,-1
REOPER.txt,194930,195349,419,10,N,N,-,-1,-1
REOPER.txt,194935,195361,426,10,N,N,-,-1,-1
REOPER.txt,194988,195413,425,10,N,N,-,-1,-1
REOPER.txt,195001,195428,427,10,N,N,-,-1,-1
REOPER.txt,195013,195449,436,10,N,N,-,-1,-1
REOPER.txt,195181,195632,451,10,N,N,-,-1,-1
REOPER.txt,195199,195706,507,10,N,N,-,-1,-1
REOPER.txt,195211,195763,552,10,N,N,-,-1,-1
REOPER.txt,195271,195782,511,10,N,N,-,-1,-1
REOPER.txt,195278,195913,635,10,N,N,-,-1,-1
REOPER.txt,195352,195930,578,10,N,N,-,-1,-1
REOPER.txt,195362,195986,624,10,N,N,-,-1,-1
REOPER.txt,195416,195997,581,10,N,N,-,-1,-1
REOPER.txt,195429,196052,623,10,N,N,-,-1,-1
REOPER.txt,195450,196102,652,10,N,N,-,-1,-1
REOPER.txt,195633,196117,484,10,N,N,-,-1,-1
REOPER.txt,195707,196183,476,10,N,N,-,-1,-1
REOPER.txt,195766,196202,436,10,N,N,-,-1,-1
REOPER.txt,195783,196234,451,10,N,N,-,-1,-1
REOPER.txt,195916,196243,327,10,N,N,-,-1,-1
REOPER.txt,195931,196286,355,10,N,N,-,-1,-1
REOPER.txt,195989,196513,524,10,N,N,-,-1,-1
REOPER.txt,195998,196522,524,10,N,N,-,-1,-1
REOPER.txt,196054,196633,579,10,N,N,-,-1,-1
REOPER.txt,196105,196656,551,10,N,N,-,-1,-1
REOPER.txt,196118,196670,552,10,N,N,-,-1,-1
REOPER.txt,196186,196702,516,10,N,N,-,-1,-1
REOPER.txt,196203,196724,521,10,N,N,-,-1,-1
REOPER.txt,196237,196744,507,10,N,N,-,-1,-1
REOPER.txt,196244,196765,521,10,N,N,-,-1,-1
REOPER.txt,196287,196778,491,10,N,N,-,-1,-1
REOPER.txt,196516,196933,417,10,N,N,-,-1,-1
REOPER.txt,196523,197164,641,10,N,N,-,-1,-1
REOPER.txt,196634,197232,598,10,N,N,-,-1,-1
REOPER.txt,196659,197501,842,10,N,N,-,-1,-1
REOPER.txt,196671,197553,882,10,N,N,-,-1,-1
REOPER.txt,196705,198256,1551,10,N,N,-,-1,-1
REOPER.txt,196725,198366,1641,10,N,N,-,-1,-1
REOPER.txt,196747,198454,1707,10,Y,N,-,-1,-1
REOPER.txt,196766,198566,1800,10,Y,N,-,-1,-1
REOPER.txt,196781,198876,2095,10,Y,N,-,-1,-1
REOPER.txt,196934,198983,2049,10,Y,N,-,-1,-1
REOPER.txt,197167,199073,1906,10,N,N,-,-1,-1
REOPER.txt,197235,199135,1900,10,N,N,-,-1,-1
REOPER.txt,197506,199354,1848,10,N,N,-,-1,-1
REOPER.txt,197553,199474,1921,10,N,N,-,-1,-1
REOPER.txt,198259,199603,1344,10,N,N,-,-1,-1
REOPER.txt,198368,199648,1280,10,N,N,-,-1,-1
REOPER.txt,198455,199875,1420,10,N,N,-,-1,-1
REOPER.txt,198567,199952,1385,10,N,N,-,-1,-1
REOPER.txt,198879,200226,1347,10,N,N,-,-1,-1
REOPER.txt,198985,200345,1360,10,N,N,-,-1,-1
REOPER.txt,199076,200480,1404,10,N,N,-,-1,-1
REOPER.txt,199136,200575,1439,10,N,N,-,-1,-1
REOPER.txt,199356,200692,1336,10,N,N,-,-1,-1
REOPER.txt,199475,200859,1384,10,N,N,-,-1,-1
REOPER.txt,199606,200916,1310,10,N,N,-,-1,-1
REOPER.txt,199649,201543,1894,10,N,N,-,-1,-1
REOPER.txt,199876,201659,1783,10,N,Y,1448314861876,180438,180657
REOPER.txt,199953,201807,1854,10,N,Y,1448314861876,180438,180657
REOPER.txt,200228,201976,1748,10,N,Y,1448314861876,180438,180657
REOPER.txt,200348,202002,1654,10,N,Y,1448314861876,180438,180657
REOPER.txt,200481,202153,1672,10,N,Y,1448314861876,180438,180657
REOPER.txt,200576,202348,1772,10,N,Y,1448314861876,180438,180657
REOPER.txt,200693,202658,1965,10,N,Y,1448314861876,180438,180657
REOPER.txt,200860,202694,1834,10,N,Y,1448314861876,180438,180657
REOPER.txt,200917,202996,2079,10,N,Y,1448314861876,180438,180657
REOPER.txt,201546,203214,1668,10,N,Y,1448314861876,180438,180657
REOPER.txt,201660,203408,1748,10,N,Y,1448314861876,180438,180657
REOPER.txt,201808,203552,1744,10,N,Y,1448314861876,180438,180657
REOPER.txt,201977,203710,1733,10,N,Y,1448314861876,180438,180657
REOPER.txt,202003,203739,1736,10,N,Y,1448314861876,180438,180657
REOPER.txt,202154,203841,1687,10,N,Y,1448314861876,180438,180657
REOPER.txt,202349,203928,1579,10,N,Y,1448314861876,180438,180657
REOPER.txt,202663,204051,1388,10,N,N,-,-1,-1
REOPER.txt,202697,204157,1460,10,N,N,-,-1,-1
REOPER.txt,202997,204423,1426,10,N,N,-,-1,-1
REOPER.txt,203217,204530,1313,10,N,N,-,-1,-1
REOPER.txt,203411,204641,1230,10,N,Y,1448281888079,98877,102290
REOPER.txt,203553,204769,1216,10,N,Y,1448281888079,98877,102290
REOPER.txt,203711,204845,1134,10,N,Y,1448281888079,98877,102290
REOPER.txt,203740,205008,1268,10,N,Y,1448281888079,98877,102290
REOPER.txt,203842,205256,1414,10,N,Y,1448281888079,98877,102290
REOPER.txt,203929,205550,1621,10,N,Y,1448281888079,98877,102290
REOPER.txt,204052,205623,1571,10,N,Y,1448281888079,98877,102290
REOPER.txt,204158,205738,1580,10,N,Y,1448281888079,98877,102290
REOPER.txt,204424,206045,1621,10,N,Y,1448281888079,98877,102290
REOPER.txt,204533,206271,1738,10,N,Y,1448281888079,98877,102290
REOPER.txt,204643,206361,1718,10,Y,Y,1448281888079,98877,102290
REOPER.txt,204770,206511,1741,10,Y,Y,1448281888079,98877,102290
REOPER.txt,204846,206545,1699,10,Y,Y,1448281888079,98877,102290
REOPER.txt,205009,206659,1650,10,Y,Y,1448313482895,176553,176862
REOPER.txt,205257,206831,1574,10,N,Y,1448313482895,176553,176862
REOPER.txt,205551,206935,1384,10,N,Y,1448313482895,176553,176862
REOPER.txt,205626,207009,1383,10,N,Y,1448313482895,176553,176862
REOPER.txt,205739,207420,1681,10,N,Y,1448313482895,176553,176862
REOPER.txt,206046,207649,1603,10,N,Y,1448313482895,176553,176862
REOPER.txt,206274,207886,1612,10,N,Y,1448313482895,176553,176862
REOPER.txt,206364,207974,1610,10,N,N,-,-1,-1
REOPER.txt,206511,208075,1564,10,N,N,-,-1,-1
REOPER.txt,206546,208240,1694,10,N,N,-,-1,-1
REOPER.txt,206660,208355,1695,10,N,N,-,-1,-1
REOPER.txt,206834,208470,1636,10,N,N,-,-1,-1
REOPER.txt,206936,208707,1771,10,N,N,-,-1,-1
REOPER.txt,207011,208998,1987,10,N,N,-,-1,-1
REOPER.txt,207421,209169,1748,10,N,N,-,-1,-1
REOPER.txt,207650,209442,1792,10,N,N,-,-1,-1
REOPER.txt,207889,209588,1699,10,N,N,-,-1,-1
REOPER.txt,207975,209693,1718,10,N,N,-,-1,-1
REOPER.txt,208076,209780,1704,10,N,N,-,-1,-1
REOPER.txt,208241,209895,1654,10,N,N,-,-1,-1
REOPER.txt,208358,210106,1748,10,N,N,-,-1,-1
REOPER.txt,208471,210361,1890,10,N,N,-,-1,-1
REOPER.txt,208708,210412,1704,10,N,N,-,-1,-1
REOPER.txt,209001,210780,1779,10,N,N,-,-1,-1
REOPER.txt,209170,210885,1715,10,N,N,-,-1,-1
REOPER.txt,209443,211089,1646,10,N,N,-,-1,-1
REOPER.txt,209589,211351,1762,10,N,N,-,-1,-1
REOPER.txt,209696,211442,1746,10,N,N,-,-1,-1
REOPER.txt,209781,211576,1795,10,N,N,-,-1,-1
REOPER.txt,209898,211693,1795,10,N,N,-,-1,-1
REOPER.txt,210107,211716,1609,10,N,N,-,-1,-1
REOPER.txt,210364,211778,1414,10,N,N,-,-1,-1
REOPER.txt,210414,211882,1468,10,N,N,-,-1,-1
REOPER.txt,210781,212080,1299,10,N,N,-,-1,-1
REOPER.txt,210886,212216,1330,10,N,N,-,-1,-1
REOPER.txt,211090,212295,1205,10,N,N,-,-1,-1
REOPER.txt,211353,212532,1179,10,N,N,-,-1,-1
REOPER.txt,211443,212774,1331,10,N,N,-,-1,-1
REOPER.txt,211577,212932,1355,10,N,N,-,-1,-1
REOPER.txt,211694,213129,1435,10,N,N,-,-1,-1
REOPER.txt,211717,213571,1854,10,N,N,-,-1,-1
REOPER.txt,211780,213697,1917,10,N,N,-,-1,-1
REOPER.txt,211883,213735,1852,10,N,N,-,-1,-1
REOPER.txt,212081,213842,1761,10,N,N,-,-1,-1
REOPER.txt,212219,213864,1645,10,N,N,-,-1,-1
REOPER.txt,212296,213921,1625,10,N,N,-,-1,-1
REOPER.txt,212533,214070,1537,10,N,N,-,-1,-1
REOPER.txt,212775,214163,1388,10,N,N,-,-1,-1
REOPER.txt,212934,214265,1331,10,N,N,-,-1,-1
REOPER.txt,213130,214440,1310,10,N,N,-,-1,-1
REOPER.txt,213574,214468,894,10,N,N,-,-1,-1
REOPER.txt,213698,214572,874,10,N,N,-,-1,-1
REOPER.txt,213737,214667,930,10,N,N,-,-1,-1
REOPER.txt,213844,214797,953,10,N,N,-,-1,-1
REOPER.txt,213865,214871,1006,10,N,N,-,-1,-1
REOPER.txt,213924,215152,1228,10,N,N,-,-1,-1
REOPER.txt,214071,215364,1293,10,N,N,-,-1,-1
REOPER.txt,214164,215434,1270,10,N,N,-,-1,-1
REOPER.txt,214266,215619,1353,10,N,N,-,-1,-1
REOPER.txt,214441,215876,1435,10,N,N,-,-1,-1
REOPER.txt,214470,216010,1540,10,N,N,-,-1,-1
REOPER.txt,214573,216192,1619,10,N,N,-,-1,-1
REOPER.txt,214667,216327,1660,10,N,N,-,-1,-1
REOPER.txt,214799,216503,1704,10,N,N,-,-1,-1
REOPER.txt,214872,216574,1702,10,N,N,-,-1,-1
REOPER.txt,215153,216610,1457,10,N,N,-,-1,-1
REOPER.txt,215365,216783,1418,10,N,N,-,-1,-1
REOPER.txt,215435,216877,1442,10,N,N,-,-1,-1
REOPER.txt,215620,217052,1432,10,N,N,-,-1,-1
REOPER.txt,215879,217165,1286,10,N,N,-,-1,-1
REOPER.txt,216011,217373,1362,10,N,N,-,-1,-1
REOPER.txt,216193,217485,1292,10,N,N,-,-1,-1
REOPER.txt,216328,217681,1353,10,N,N,-,-1,-1
REOPER.txt,216504,217830,1326,10,N,N,-,-1,-1
REOPER.txt,216575,217889,1314,10,N,N,-,-1,-1
REOPER.txt,216611,218004,1393,10,N,N,-,-1,-1
REOPER.txt,216784,218209,1425,10,N,N,-,-1,-1
REOPER.txt,216878,218370,1492,10,N,N,-,-1,-1
REOPER.txt,217053,218610,1557,10,Y,N,-,-1,-1
REOPER.txt,217168,218969,1801,10,Y,N,-,-1,-1
REOPER.txt,217374,219031,1657,10,N,N,-,-1,-1
REOPER.txt,217486,219326,1840,10,N,N,-,-1,-1
REOPER.txt,217684,219351,1667,10,N,N,-,-1,-1
REOPER.txt,217831,219435,1604,10,N,N,-,-1,-1
REOPER.txt,217890,219518,1628,10,Y,N,-,-1,-1
REOPER.txt,218006,219728,1722,10,Y,N,-,-1,-1
REOPER.txt,218210,219951,1741,10,N,N,-,-1,-1
REOPER.txt,218371,220145,1774,10,N,N,-,-1,-1
REOPER.txt,218611,220389,1778,10,N,N,-,-1,-1
REOPER.txt,218970,220626,1656,10,N,N,-,-1,-1
REOPER.txt,219034,220745,1711,10,N,N,-,-1,-1
REOPER.txt,219327,220775,1448,10,N,N,-,-1,-1
REOPER.txt,219352,220905,1553,10,N,N,-,-1,-1
REOPER.txt,219438,221096,1658,10,N,N,-,-1,-1
REOPER.txt,219519,221286,1767,10,N,N,-,-1,-1
REOPER.txt,219729,221561,1832,10,N,N,-,-1,-1
REOPER.txt,219954,221668,1714,10,N,N,-,-1,-1
REOPER.txt,220146,221914,1768,10,N,N,-,-1,-1
REOPER.txt,220390,222107,1717,10,N,N,-,-1,-1
REOPER.txt,220627,222221,1594,10,N,N,-,-1,-1
REOPER.txt,220748,222312,1564,10,N,N,-,-1,-1
REOPER.txt,220776,222547,1771,10,N,N,-,-1,-1
REOPER.txt,220906,222660,1754,10,N,N,-,-1,-1
REOPER.txt,221099,222772,1673,10,N,N,-,-1,-1
REOPER.txt,221287,222992,1705,10,N,N,-,-1,-1
REOPER.txt,221562,223093,1531,10,N,N,-,-1,-1
REOPER.txt,221669,223137,1468,10,N,N,-,-1,-1
REOPER.txt,221917,223208,1291,10,N,N,-,-1,-1
REOPER.txt,222108,223259,1151,10,N,N,-,-1,-1
REOPER.txt,222222,223331,1109,10,N,N,-,-1,-1
REOPER.txt,222313,223372,1059,10,N,N,-,-1,-1
REOPER.txt,222548,223770,1222,10,N,N,-,-1,-1
REOPER.txt,222662,224046,1384,10,N,N,-,-1,-1
REOPER.txt,222774,224119,1345,10,N,N,-,-1,-1
REOPER.txt,222993,224234,1241,10,N,N,-,-1,-1
REOPER.txt,223094,224444,1350,10,N,N,-,-1,-1
REOPER.txt,223138,224454,1316,10,N,N,-,-1,-1
REOPER.txt,223209,224584,1375,10,N,N,-,-1,-1
REOPER.txt,223262,224650,1388,10,N,N,-,-1,-1
REOPER.txt,223332,225113,1781,10,N,N,-,-1,-1
REOPER.txt,223374,225143,1769,10,N,N,-,-1,-1
REOPER.txt,223771,225309,1538,10,N,N,-,-1,-1
REOPER.txt,224047,225562,1515,10,N,N,-,-1,-1
REOPER.txt,224121,225795,1674,10,N,N,-,-1,-1
REOPER.txt,224236,225940,1704,10,N,N,-,-1,-1
REOPER.txt,224447,226189,1742,10,N,N,-,-1,-1
REOPER.txt,224455,226262,1807,10,N,N,-,-1,-1
REOPER.txt,224587,226362,1775,10,N,N,-,-1,-1
REOPER.txt,224651,226492,1841,10,N,N,-,-1,-1
REOPER.txt,225116,226503,1387,10,N,N,-,-1,-1
REOPER.txt,225144,226730,1586,10,N,N,-,-1,-1
REOPER.txt,225310,226785,1475,10,N,N,-,-1,-1
REOPER.txt,225563,226871,1308,10,N,N,-,-1,-1
REOPER.txt,225796,226944,1148,10,N,N,-,-1,-1
REOPER.txt,225941,227043,1102,10,N,N,-,-1,-1
REOPER.txt,226190,227089,899,10,N,N,-,-1,-1
REOPER.txt,226263,227241,978,10,N,N,-,-1,-1
REOPER.txt,226363,227261,898,10,N,N,-,-1,-1
REOPER.txt,226493,227329,836,10,N,N,-,-1,-1
REOPER.txt,226504,227540,1036,10,N,N,-,-1,-1
REOPER.txt,226731,227795,1064,10,N,N,-,-1,-1
REOPER.txt,226786,227843,1057,10,N,N,-,-1,-1
REOPER.txt,226872,227874,1002,10,N,N,-,-1,-1
REOPER.txt,226944,227982,1038,10,N,N,-,-1,-1
REOPER.txt,227044,228018,974,10,N,N,-,-1,-1
REOPER.txt,227090,228126,1036,10,N,N,-,-1,-1
REOPER.txt,227242,228256,1014,10,N,N,-,-1,-1
REOPER.txt,227263,228397,1134,10,N,N,-,-1,-1
REOPER.txt,227330,228436,1106,10,N,N,-,-1,-1
REOPER.txt,227543,228506,963,10,N,N,-,-1,-1
REOPER.txt,227796,228618,822,10,N,N,-,-1,-1
REOPER.txt,227844,228655,811,10,N,N,-,-1,-1
REOPER.txt,227874,228739,865,10,N,N,-,-1,-1
REOPER.txt,227987,228776,789,10,N,N,-,-1,-1
REOPER.txt,228021,228808,787,10,N,N,-,-1,-1
REOPER.txt,228127,228946,819,10,N,N,-,-1,-1
REOPER.txt,228257,229007,750,10,N,N,-,-1,-1
REOPER.txt,228398,229158,760,10,N,N,-,-1,-1
REOPER.txt,228437,229343,906,10,N,N,-,-1,-1
REOPER.txt,228507,229427,920,10,N,N,-,-1,-1
REOPER.txt,228619,229480,861,10,N,N,-,-1,-1
REOPER.txt,228656,229512,856,10,N,N,-,-1,-1
REOPER.txt,228742,229809,1067,10,N,N,-,-1,-1
REOPER.txt,228777,230421,1644,10,N,Y,1437470299748,152207,152889
REOPER.txt,228809,230507,1698,10,N,Y,1437470299748,152207,152889
REOPER.txt,228947,230590,1643,10,N,Y,1437470299748,152207,152889
REOPER.txt,229008,230661,1653,10,N,Y,1437470299748,152207,152889
REOPER.txt,229159,230792,1633,10,N,Y,1437470299748,152207,152889
REOPER.txt,229344,230828,1484,10,N,Y,1437470299748,152207,152889
REOPER.txt,229432,230948,1516,10,N,Y,1437470299748,152207,152889
REOPER.txt,229481,231111,1630,10,N,Y,1437470299748,152207,152889
REOPER.txt,229513,231203,1690,10,N,Y,1437470299748,152207,152889
REOPER.txt,229812,231647,1835,10,N,Y,1437470299748,152207,152889
REOPER.txt,230422,231726,1304,10,N,Y,1437470299748,152207,152889
REOPER.txt,230508,231878,1370,10,N,Y,1437470299748,152207,152889
REOPER.txt,230591,232178,1587,10,N,Y,1437470299748,152207,152889
REOPER.txt,230662,232539,1877,10,N,Y,1437470299748,152207,152889
REOPER.txt,230797,232623,1826,10,N,Y,1437470299748,152207,152889
REOPER.txt,230831,232668,1837,10,N,Y,1437470299748,152207,152889
REOPER.txt,230949,232709,1760,10,Y,Y,1437470299748,152207,152889
REOPER.txt,231112,232758,1646,10,Y,Y,1437470299748,152207,152889
REOPER.txt,231206,232849,1643,10,Y,Y,1437470299748,152207,152889
REOPER.txt,231649,232998,1349,10,Y,Y,1448281071558,89330,89524
REOPER.txt,231727,233150,1423,10,Y,Y,1448281071558,89330,89524
REOPER.txt,231879,233578,1699,10,Y,Y,1448281071558,89330,89524
REOPER.txt,232179,233946,1767,10,N,Y,1448281071558,89330,89524
REOPER.txt,232542,234522,1980,10,N,N,-,-1,-1
REOPER.txt,232624,234660,2036,10,N,N,-,-1,-1
REOPER.txt,232669,234790,2121,10,N,N,-,-1,-1
REOPER.txt,232710,235067,2357,10,N,N,-,-1,-1
REOPER.txt,232759,235325,2566,10,N,N,-,-1,-1
REOPER.txt,232851,235477,2626,10,N,Y,1448322397200,219547,220107
REOPER.txt,232999,235561,2562,10,N,Y,1448322397200,219547,220107
REOPER.txt,233151,235595,2444,10,N,Y,1448322397200,219547,220107
REOPER.txt,233580,235742,2162,10,N,Y,1448322397200,219547,220107
REOPER.txt,233947,235847,1900,10,N,Y,1448322397200,219547,220107
REOPER.txt,234525,236111,1586,10,N,Y,1448322397200,219547,220107
REOPER.txt,234661,236250,1589,10,N,Y,1448322397200,219547,220107
REOPER.txt,234792,236340,1548,10,N,Y,1448322397200,219547,220107
REOPER.txt,235068,236444,1376,10,N,Y,1448322397200,219547,220107
REOPER.txt,235328,236874,1546,10,N,Y,1448322397200,219547,220107
REOPER.txt,235478,237292,1814,10,N,Y,1448322397200,219547,220107
REOPER.txt,235562,237582,2020,10,N,Y,1448322397200,219547,220107
REOPER.txt,235596,237874,2278,10,N,Y,1448322397200,219547,220107
REOPER.txt,235743,238246,2503,10,Y,Y,1448322397200,219547,220107
REOPER.txt,235848,238247,2399,10,Y,Y,1448322397200,219547,220107
REOPER.txt,236112,238643,2531,10,Y,Y,1448322397200,219547,220107
REOPER.txt,236252,239221,2969,10,Y,Y,1448322397200,219547,220107
REOPER.txt,236341,239617,3276,10,Y,Y,1448322397200,219547,220107
REOPER.txt,236445,239826,3381,10,Y,Y,1448322397200,219547,220107
REOPER.txt,236875,240137,3262,10,N,Y,1448322397200,219547,220107
REOPER.txt,237295,240372,3077,10,N,N,-,-1,-1
REOPER.txt,237583,240692,3109,10,N,N,-,-1,-1
REOPER.txt,237876,240974,3098,10,N,N,-,-1,-1
REOPER.txt,238246,241702,3456,10,N,N,-,-1,-1
REOPER.txt,238250,241902,3652,10,N,N,-,-1,-1
REOPER.txt,238644,241938,3294,10,N,N,-,-1,-1
REOPER.txt,239222,242066,2844,10,N,N,-,-1,-1
REOPER.txt,239618,242359,2741,10,N,N,-,-1,-1
REOPER.txt,239827,242526,2699,10,N,N,-,-1,-1
REOPER.txt,240138,242856,2718,10,N,N,-,-1,-1
REOPER.txt,240373,242950,2577,10,N,N,-,-1,-1
REOPER.txt,240694,243103,2409,10,N,N,-,-1,-1
REOPER.txt,240975,243232,2257,10,N,N,-,-1,-1
REOPER.txt,241705,243296,1591,10,N,N,-,-1,-1
REOPER.txt,241907,243522,1615,10,N,N,-,-1,-1
REOPER.txt,241941,243694,1753,10,N,N,-,-1,-1
REOPER.txt,242067,243749,1682,10,N,N,-,-1,-1
REOPER.txt,242360,243783,1423,10,N,N,-,-1,-1
REOPER.txt,242527,243866,1339,10,N,N,-,-1,-1
REOPER.txt,242857,244087,1230,10,N,N,-,-1,-1
REOPER.txt,242951,244453,1502,10,N,N,-,-1,-1
REOPER.txt,243104,244592,1488,10,N,N,-,-1,-1
REOPER.txt,243233,244705,1472,10,N,N,-,-1,-1
REOPER.txt,243298,245006,1708,10,N,N,-,-1,-1
REOPER.txt,243525,245203,1678,10,N,N,-,-1,-1
REOPER.txt,243696,245607,1911,10,N,N,-,-1,-1
REOPER.txt,243754,245794,2040,10,N,N,-,-1,-1
REOPER.txt,243784,246195,2411,10,N,N,-,-1,-1
REOPER.txt,243869,246365,2496,10,N,N,-,-1,-1
REOPER.txt,244088,246507,2419,10,N,N,-,-1,-1
REOPER.txt,244454,246666,2212,10,N,N,-,-1,-1
REOPER.txt,244593,246806,2213,10,N,N,-,-1,-1
REOPER.txt,244708,247138,2430,10,N,N,-,-1,-1
REOPER.txt,245009,247412,2403,10,N,N,-,-1,-1
REOPER.txt,245204,247453,2249,10,N,N,-,-1,-1
REOPER.txt,245610,247661,2051,10,N,N,-,-1,-1
REOPER.txt,245795,247758,1963,10,N,N,-,-1,-1
REOPER.txt,246196,248292,2096,10,N,N,-,-1,-1
REOPER.txt,246368,248487,2119,10,N,N,-,-1,-1
REOPER.txt,246508,248605,2097,10,N,N,-,-1,-1
REOPER.txt,246667,248809,2142,10,N,N,-,-1,-1
REOPER.txt,246807,249021,2214,10,N,N,-,-1,-1
REOPER.txt,247138,249227,2089,10,N,N,-,-1,-1
REOPER.txt,247413,249301,1888,10,N,N,-,-1,-1
REOPER.txt,247454,249370,1916,10,N,N,-,-1,-1
REOPER.txt,247662,249511,1849,10,N,N,-,-1,-1
REOPER.txt,247759,249748,1989,10,N,N,-,-1,-1
REOPER.txt,248295,249915,1620,10,N,N,-,-1,-1
REOPER.txt,248488,250103,1615,10,N,N,-,-1,-1
REOPER.txt,248608,250475,1867,10,N,N,-,-1,-1
REOPER.txt,248810,250840,2030,10,N,N,-,-1,-1
REOPER.txt,249022,251107,2085,10,N,N,-,-1,-1
REOPER.txt,249228,251201,1973,10,N,N,-,-1,-1
REOPER.txt,249304,251600,2296,10,N,N,-,-1,-1
REOPER.txt,249371,251744,2373,10,N,N,-,-1,-1
REOPER.txt,249512,251776,2264,10,N,N,-,-1,-1
REOPER.txt,249750,252885,3135,10,N,N,-,-1,-1
REOPER.txt,249916,253025,3109,10,N,N,-,-1,-1
REOPER.txt,250104,253215,3111,10,N,N,-,-1,-1
REOPER.txt,250478,253491,3013,10,N,N,-,-1,-1
REOPER.txt,250841,253521,2680,10,N,N,-,-1,-1
REOPER.txt,251108,253583,2475,10,N,N,-,-1,-1
REOPER.txt,251204,253853,2649,10,N,N,-,-1,-1
REOPER.txt,251603,254026,2423,10,N,N,-,-1,-1
REOPER.txt,251749,254172,2423,10,N,N,-,-1,-1
REOPER.txt,251779,255013,3234,10,N,N,-,-1,-1
REOPER.txt,252888,255203,2315,10,N,N,-,-1,-1
REOPER.txt,253026,255410,2384,10,N,N,-,-1,-1
REOPER.txt,253216,255830,2614,10,N,N,-,-1,-1
REOPER.txt,253496,256052,2556,10,N,N,-,-1,-1
REOPER.txt,253522,256178,2656,10,N,N,-,-1,-1
REOPER.txt,253584,256282,2698,10,N,N,-,-1,-1
REOPER.txt,253855,256477,2622,10,N,N,-,-1,-1
REOPER.txt,254027,256878,2851,10,N,N,-,-1,-1
REOPER.txt,254173,257147,2974,10,N,N,-,-1,-1
REOPER.txt,255014,257253,2239,10,N,N,-,-1,-1
REOPER.txt,255206,257407,2201,10,N,N,-,-1,-1
REOPER.txt,255413,257678,2265,10,N,N,-,-1,-1
REOPER.txt,255831,257882,2051,10,N,N,-,-1,-1
REOPER.txt,256053,258096,2043,10,N,N,-,-1,-1
REOPER.txt,256179,258318,2139,10,N,N,-,-1,-1
REOPER.txt,256283,258341,2058,10,N,N,-,-1,-1
REOPER.txt,256478,258379,1901,10,N,N,-,-1,-1
REOPER.txt,256879,258603,1724,10,N,N,-,-1,-1
REOPER.txt,257148,258798,1650,10,N,N,-,-1,-1
REOPER.txt,257254,258912,1658,10,N,N,-,-1,-1
REOPER.txt,257408,259113,1705,10,N,N,-,-1,-1
REOPER.txt,257679,259172,1493,10,N,N,-,-1,-1
REOPER.txt,257883,259440,1557,10,N,N,-,-1,-1
REOPER.txt,258098,259473,1375,10,N,N,-,-1,-1
REOPER.txt,258321,259866,1545,10,N,N,-,-1,-1
REOPER.txt,258342,259954,1612,10,N,N,-,-1,-1
REOPER.txt,258380,260129,1749,10,Y,N,-,-1,-1
REOPER.txt,258604,260241,1637,10,Y,N,-,-1,-1
REOPER.txt,258799,260335,1536,10,N,N,-,-1,-1
REOPER.txt,258913,260467,1554,10,N,N,-,-1,-1
REOPER.txt,259116,260664,1548,10,N,N,-,-1,-1
REOPER.txt,259174,260858,1684,10,N,N,-,-1,-1
REOPER.txt,259441,260992,1551,10,N,N,-,-1,-1
REOPER.txt,259474,261004,1530,10,N,N,-,-1,-1
REOPER.txt,259867,261066,1199,10,N,N,-,-1,-1
REOPER.txt,259955,261157,1202,10,N,N,-,-1,-1
REOPER.txt,260130,261236,1106,10,N,N,-,-1,-1
REOPER.txt,260242,261520,1278,10,N,N,-,-1,-1
REOPER.txt,260338,261632,1294,10,N,N,-,-1,-1
REOPER.txt,260468,261742,1274,10,N,N,-,-1,-1
REOPER.txt,260665,261834,1169,10,N,N,-,-1,-1
REOPER.txt,260860,261942,1082,10,N,N,-,-1,-1
REOPER.txt,260993,262040,1047,10,N,N,-,-1,-1
REOPER.txt,261005,262093,1088,10,N,N,-,-1,-1
REOPER.txt,261067,262215,1148,10,N,N,-,-1,-1
REOPER.txt,261159,262304,1145,10,N,N,-,-1,-1
REOPER.txt,261237,262363,1126,10,N,N,-,-1,-1
REOPER.txt,261521,262451,930,10,N,N,-,-1,-1
REOPER.txt,261633,262624,991,10,N,N,-,-1,-1
REOPER.txt,261743,262793,1050,10,N,N,-,-1,-1
REOPER.txt,261835,262885,1050,10,N,N,-,-1,-1
REOPER.txt,261943,262929,986,10,N,N,-,-1,-1
REOPER.txt,262041,263077,1036,10,N,N,-,-1,-1
REOPER.txt,262094,263153,1059,10,N,N,-,-1,-1
REOPER.txt,262216,263189,973,10,N,N,-,-1,-1
REOPER.txt,262305,263399,1094,10,Y,N,-,-1,-1
REOPER.txt,262364,263436,1072,10,Y,N,-,-1,-1
REOPER.txt,262452,263562,1110,10,Y,N,-,-1,-1
REOPER.txt,262626,263671,1045,10,Y,N,-,-1,-1
REOPER.txt,262795,263765,970,10,Y,N,-,-1,-1
REOPER.txt,262888,263885,997,10,Y,N,-,-1,-1
REOPER.txt,262930,264087,1157,10,Y,N,-,-1,-1
REOPER.txt,263078,264139,1061,10,Y,N,-,-1,-1
REOPER.txt,263154,264182,1028,10,Y,N,-,-1,-1
REOPER.txt,263190,264313,1123,10,Y,N,-,-1,-1
REOPER.txt,263400,264478,1078,10,N,N,-,-1,-1
REOPER.txt,263437,264496,1059,10,N,N,-,-1,-1
REOPER.txt,263564,264507,943,10,N,N,-,-1,-1
REOPER.txt,263672,264569,897,10,N,N,-,-1,-1
REOPER.txt,263768,264962,1194,10,N,N,-,-1,-1
REOPER.txt,263886,265168,1282,10,N,N,-,-1,-1
REOPER.txt,264087,265472,1385,10,N,N,-,-1,-1
REOPER.txt,264140,265635,1495,10,N,N,-,-1,-1
REOPER.txt,264183,265756,1573,10,N,N,-,-1,-1
REOPER.txt,264314,265816,1502,10,N,N,-,-1,-1
REOPER.txt,264483,265905,1422,10,N,N,-,-1,-1
REOPER.txt,264497,266030,1533,10,N,N,-,-1,-1
REOPER.txt,264508,266223,1715,10,N,N,-,-1,-1
REOPER.txt,264570,266331,1761,10,N,N,-,-1,-1
REOPER.txt,264963,266385,1422,10,N,N,-,-1,-1
REOPER.txt,265171,266676,1505,10,N,N,-,-1,-1
REOPER.txt,265473,266776,1303,10,N,N,-,-1,-1
REOPER.txt,265636,266947,1311,10,N,N,-,-1,-1
REOPER.txt,265759,267043,1284,10,N,N,-,-1,-1
REOPER.txt,265817,267112,1295,10,N,N,-,-1,-1
REOPER.txt,265906,267215,1309,10,N,N,-,-1,-1
REOPER.txt,266031,267403,1372,10,N,N,-,-1,-1
REOPER.txt,266224,267742,1518,10,N,N,-,-1,-1
REOPER.txt,266332,267843,1511,10,N,N,-,-1,-1
REOPER.txt,266388,268058,1670,10,N,N,-,-1,-1
REOPER.txt,266678,268191,1513,10,N,N,-,-1,-1
REOPER.txt,266779,268229,1450,10,N,N,-,-1,-1
REOPER.txt,266949,268445,1496,10,N,N,-,-1,-1
REOPER.txt,267043,268664,1621,10,N,N,-,-1,-1
REOPER.txt,267113,268923,1810,10,N,N,-,-1,-1
REOPER.txt,267217,269135,1918,10,N,N,-,-1,-1
REOPER.txt,267404,269490,2086,10,N,N,-,-1,-1
REOPER.txt,267743,269685,1942,10,N,N,-,-1,-1
REOPER.txt,267844,269875,2031,10,N,N,-,-1,-1
REOPER.txt,268059,270108,2049,10,N,N,-,-1,-1
REOPER.txt,268196,270118,1922,10,N,N,-,-1,-1
REOPER.txt,268230,270287,2057,10,N,N,-,-1,-1
REOPER.txt,268446,270483,2037,10,N,N,-,-1,-1
REOPER.txt,268665,270656,1991,10,N,N,-,-1,-1
REOPER.txt,268924,270717,1793,10,N,N,-,-1,-1
REOPER.txt,269137,270939,1802,10,N,N,-,-1,-1
REOPER.txt,269491,270991,1500,10,N,N,-,-1,-1
REOPER.txt,269688,271202,1514,10,N,N,-,-1,-1
REOPER.txt,269876,271298,1422,10,N,N,-,-1,-1
REOPER.txt,270111,271577,1466,10,N,N,-,-1,-1
REOPER.txt,270119,271685,1566,10,N,N,-,-1,-1
REOPER.txt,270288,271837,1549,10,Y,N,-,-1,-1
REOPER.txt,270484,271979,1495,10,Y,N,-,-1,-1
REOPER.txt,270657,272033,1376,10,Y,N,-,-1,-1
REOPER.txt,270718,272396,1678,10,N,N,-,-1,-1
REOPER.txt,270942,272743,1801,10,N,N,-,-1,-1
REOPER.txt,270993,273080,2087,10,N,N,-,-1,-1
REOPER.txt,271203,273208,2005,10,N,N,-,-1,-1
REOPER.txt,271299,273369,2070,10,N,N,-,-1,-1
REOPER.txt,271578,273515,1937,10,N,N,-,-1,-1
REOPER.txt,271686,273684,1998,10,N,N,-,-1,-1
REOPER.txt,271839,273780,1941,10,N,N,-,-1,-1
REOPER.txt,271980,274140,2160,10,N,N,-,-1,-1
REOPER.txt,272034,274228,2194,10,N,N,-,-1,-1
REOPER.txt,272397,274580,2183,10,N,N,-,-1,-1
REOPER.txt,272744,274754,2010,10,N,N,-,-1,-1
REOPER.txt,273081,275161,2080,10,N,N,-,-1,-1
REOPER.txt,273209,275365,2156,10,N,Y,1448311594480,155711,156312
REOPER.txt,273370,275572,2202,10,N,Y,1448311594480,155711,156312
REOPER.txt,273518,275624,2106,10,N,Y,1448311594480,155711,156312
REOPER.txt,273686,275759,2073,10,N,Y,1448311594480,155711,156312
REOPER.txt,273783,275919,2136,10,N,Y,1448311594480,155711,156312
REOPER.txt,274141,276093,1952,10,N,Y,1448311594480,155711,156312
REOPER.txt,274230,276206,1976,10,N,Y,1448311594480,155711,156312
REOPER.txt,274582,276327,1745,10,N,Y,1448311594480,155711,156312
REOPER.txt,274755,276551,1796,10,N,Y,1448311594480,155711,156312
REOPER.txt,275164,276718,1554,10,N,Y,1448311594480,155711,156312
REOPER.txt,275366,276853,1487,10,N,Y,1448311594480,155711,156312
REOPER.txt,275573,277057,1484,10,N,Y,1448311594480,155711,156312
REOPER.txt,275625,277149,1524,10,N,Y,1448311594480,155711,156312
REOPER.txt,275760,277272,1512,10,N,Y,1448311594480,155711,156312
REOPER.txt,275920,277384,1464,10,N,Y,1448311594480,155711,156312
REOPER.txt,276094,277462,1368,10,N,Y,1448311594480,155711,156312
REOPER.txt,276207,277483,1276,10,N,Y,1448311594480,155711,156312
REOPER.txt,276328,277718,1390,10,N,Y,1448311594480,155711,156312
REOPER.txt,276552,277958,1406,10,N,Y,1448311594480,155711,156312
REOPER.txt,276720,278153,1433,10,N,Y,1448311594480,155711,156312
REOPER.txt,276854,278544,1690,10,N,Y,1448311594480,155711,156312
REOPER.txt,277058,278795,1737,10,N,Y,1448311594480,155711,156312
REOPER.txt,277151,279101,1950,10,N,Y,1448311594480,155711,156312
REOPER.txt,277273,279186,1913,10,N,Y,1448311594480,155711,156312
REOPER.txt,277385,279313,1928,10,N,Y,1448311594480,155711,156312
REOPER.txt,277465,279470,2005,10,N,Y,1448311594480,155711,156312
REOPER.txt,277484,279626,2142,10,N,Y,1448311594480,155711,156312
REOPER.txt,277719,279839,2120,10,Y,Y,1448311594480,155711,156312
REOPER.txt,277959,279902,1943,10,N,Y,1448311594480,155711,156312
REOPER.txt,278154,280029,1875,10,N,Y,1448311594480,155711,156312
REOPER.txt,278545,280067,1522,10,N,Y,1448311594480,155711,156312
REOPER.txt,278798,280162,1364,10,N,Y,1448286880729,112151,113274
REOPER.txt,279102,280229,1127,10,N,Y,1448286880729,112151,113274
REOPER.txt,279187,280327,1140,10,Y,Y,1448286880729,112151,113274
REOPER.txt,279314,280528,1214,10,Y,Y,1448282044001,101941,102395
REOPER.txt,279473,280625,1152,10,Y,Y,1448282044001,101941,102395
REOPER.txt,279627,280775,1148,10,Y,Y,1448282044001,101941,102395
REOPER.txt,279840,280985,1145,10,N,Y,1448282044001,101941,102395
REOPER.txt,279905,281102,1197,10,N,Y,1448282044001,101941,102395
REOPER.txt,280030,281113,1083,10,N,Y,1448282044001,101941,102395
REOPER.txt,280068,281265,1197,10,N,Y,1448282044001,101941,102395
REOPER.txt,280164,281355,1191,10,N,Y,1448282044001,101941,102395
REOPER.txt,280230,281590,1360,10,N,Y,1448282044001,101941,102395
REOPER.txt,280328,281724,1396,10,N,Y,1448282044001,101941,102395
REOPER.txt,280530,281872,1342,10,N,Y,1448282044001,101941,102395
REOPER.txt,280626,282032,1406,10,N,Y,1448282044001,101941,102395
REOPER.txt,280776,282305,1529,10,N,Y,1448282044001,101941,102395
REOPER.txt,280986,282398,1412,10,N,Y,1448282044001,101941,102395
REOPER.txt,281105,282653,1548,10,N,Y,1448278425221,65586,65914
REOPER.txt,281114,282737,1623,10,N,Y,1448278425221,65586,65914
REOPER.txt,281267,282869,1602,10,N,Y,1448278425221,65586,65914
REOPER.txt,281356,282985,1629,10,N,Y,1448278425221,65586,65914
REOPER.txt,281591,283030,1439,10,N,Y,1448278425221,65586,65914
REOPER.txt,281727,283075,1348,10,N,Y,1448278425221,65586,65914
REOPER.txt,281873,283252,1379,10,N,Y,1448278425221,65586,65914
REOPER.txt,282033,283519,1486,10,N,Y,1448278425221,65586,65914
REOPER.txt,282306,283730,1424,10,N,Y,1448278425221,65586,65914
REOPER.txt,282400,283746,1346,10,N,Y,1448278425221,65586,65914
REOPER.txt,282654,283972,1318,10,N,Y,1448278425221,65586,65914
REOPER.txt,282739,284047,1308,10,N,Y,1448278425221,65586,65914
REOPER.txt,282870,284190,1320,10,N,Y,1437476486340,221621,222520
REOPER.txt,282987,284404,1417,10,N,Y,1437476486340,221621,222520
REOPER.txt,283031,284465,1434,10,N,Y,1437476486340,221621,222520
REOPER.txt,283076,284604,1528,10,N,Y,1437476486340,221621,222520
REOPER.txt,283253,284683,1430,10,N,Y,1437476486340,221621,222520
REOPER.txt,283520,284800,1280,10,N,Y,1437476486340,221621,222520
REOPER.txt,283731,284887,1156,10,N,Y,1437476486340,221621,222520
REOPER.txt,283747,285008,1261,10,N,Y,1437476486340,221621,222520
REOPER.txt,283973,285151,1178,10,N,Y,1437476486340,221621,222520
REOPER.txt,284050,285265,1215,10,N,Y,1437476486340,221621,222520
REOPER.txt,284191,285365,1174,10,N,Y,1437476486340,221621,222520
REOPER.txt,284405,285670,1265,10,N,Y,1437476486340,221621,222520
REOPER.txt,284466,285757,1291,10,N,Y,1437476486340,221621,222520
REOPER.txt,284605,285993,1388,10,N,Y,1437476486340,221621,222520
REOPER.txt,284686,286062,1376,10,N,Y,1437476486340,221621,222520
REOPER.txt,284802,286217,1415,10,N,Y,1437476486340,221621,222520
REOPER.txt,284890,286285,1395,10,N,N,-,-1,-1
REOPER.txt,285009,286458,1449,10,N,N,-,-1,-1
REOPER.txt,285152,286483,1331,10,N,N,-,-1,-1
REOPER.txt,285266,286555,1289,10,N,N,-,-1,-1
REOPER.txt,285366,286600,1234,10,N,N,-,-1,-1
REOPER.txt,285671,286740,1069,10,N,N,-,-1,-1
REOPER.txt,285758,286801,1043,10,N,N,-,-1,-1
REOPER.txt,285994,286946,952,10,N,N,-,-1,-1
REOPER.txt,286063,287078,1015,10,N,N,-,-1,-1
REOPER.txt,286218,287168,950,10,N,N,-,-1,-1
REOPER.txt,286286,287563,1277,10,N,N,-,-1,-1
REOPER.txt,286459,287709,1250,10,N,N,-,-1,-1
REOPER.txt,286484,287803,1319,10,N,N,-,-1,-1
REOPER.txt,286556,288025,1469,10,N,N,-,-1,-1
REOPER.txt,286601,288249,1648,10,N,N,-,-1,-1
REOPER.txt,286741,288331,1590,10,N,N,-,-1,-1
REOPER.txt,286802,288459,1657,10,N,N,-,-1,-1
REOPER.txt,286948,288706,1758,10,N,N,-,-1,-1
REOPER.txt,287079,288817,1738,10,Y,N,-,-1,-1
REOPER.txt,287169,289138,1969,10,N,N,-,-1,-1
REOPER.txt,287566,289283,1717,10,N,N,-,-1,-1
REOPER.txt,287712,289677,1965,10,N,N,-,-1,-1
REOPER.txt,287804,289795,1991,10,N,N,-,-1,-1
REOPER.txt,288026,289989,1963,10,N,N,-,-1,-1
REOPER.txt,288250,290014,1764,10,N,N,-,-1,-1
REOPER.txt,288334,290053,1719,10,N,N,-,-1,-1
REOPER.txt,288460,290133,1673,10,N,N,-,-1,-1
REOPER.txt,288707,290235,1528,10,N,N,-,-1,-1
REOPER.txt,288818,290288,1470,10,N,N,-,-1,-1
REOPER.txt,289141,290390,1249,10,N,N,-,-1,-1
REOPER.txt,289284,290639,1355,10,N,N,-,-1,-1
REOPER.txt,289678,290760,1082,10,N,N,-,-1,-1
REOPER.txt,289796,290930,1134,10,N,N,-,-1,-1
REOPER.txt,289990,291028,1038,10,N,N,-,-1,-1
REOPER.txt,290015,291302,1287,10,N,N,-,-1,-1
REOPER.txt,290054,291704,1650,10,N,N,-,-1,-1
REOPER.txt,290136,291851,1715,10,N,N,-,-1,-1
REOPER.txt,290237,292039,1802,10,N,N,-,-1,-1
REOPER.txt,290289,292223,1934,10,N,N,-,-1,-1
REOPER.txt,290391,292350,1959,10,Y,N,-,-1,-1
REOPER.txt,290640,292766,2126,10,Y,N,-,-1,-1
REOPER.txt,290763,292876,2113,10,Y,N,-,-1,-1
REOPER.txt,290931,292971,2040,10,Y,N,-,-1,-1
REOPER.txt,291030,293458,2428,10,Y,N,-,-1,-1
REOPER.txt,291304,293536,2232,10,Y,N,-,-1,-1
REOPER.txt,291707,293599,1892,10,Y,N,-,-1,-1
REOPER.txt,291854,293655,1801,10,N,N,-,-1,-1
REOPER.txt,292040,293753,1713,10,Y,N,-,-1,-1
REOPER.txt,292224,293832,1608,10,N,N,-,-1,-1
REOPER.txt,292352,294033,1681,10,N,N,-,-1,-1
REOPER.txt,292767,294403,1636,10,N,N,-,-1,-1
REOPER.txt,292879,294481,1602,10,N,N,-,-1,-1
REOPER.txt,292972,294774,1802,10,N,N,-,-1,-1
REOPER.txt,293459,294894,1435,10,N,N,-,-1,-1
REOPER.txt,293537,294951,1414,10,N,N,-,-1,-1
REOPER.txt,293600,295050,1450,10,N,N,-,-1,-1
REOPER.txt,293656,295076,1420,10,N,N,-,-1,-1
REOPER.txt,293754,295717,1963,10,N,N,-,-1,-1
REOPER.txt,293835,295845,2010,10,N,N,-,-1,-1
REOPER.txt,294034,296249,2215,10,N,N,-,-1,-1
REOPER.txt,294404,296422,2018,10,N,N,-,-1,-1
REOPER.txt,294482,296626,2144,10,Y,N,-,-1,-1
REOPER.txt,294775,296662,1887,10,N,N,-,-1,-1
REOPER.txt,294895,296724,1829,10,N,N,-,-1,-1
REOPER.txt,294952,297073,2121,10,Y,N,-,-1,-1
REOPER.txt,295055,297283,2228,10,Y,N,-,-1,-1
REOPER.txt,295079,297564,2485,10,Y,N,-,-1,-1
REOPER.txt,295720,297844,2124,10,N,N,-,-1,-1
REOPER.txt,295846,298065,2219,10,N,N,-,-1,-1
REOPER.txt,296250,298318,2068,10,N,N,-,-1,-1
REOPER.txt,296423,298427,2004,10,N,N,-,-1,-1
REOPER.txt,296627,298462,1835,10,N,N,-,-1,-1
REOPER.txt,296663,298643,1980,10,N,N,-,-1,-1
REOPER.txt,296725,298824,2099,10,N,N,-,-1,-1
REOPER.txt,297074,298989,1915,10,N,N,-,-1,-1
REOPER.txt,297286,299061,1775,10,N,N,-,-1,-1
REOPER.txt,297565,299187,1622,10,N,N,-,-1,-1
REOPER.txt,297845,299260,1415,10,N,N,-,-1,-1
REOPER.txt,298066,299387,1321,10,N,N,-,-1,-1
REOPER.txt,298321,299729,1408,10,N,N,-,-1,-1
REOPER.txt,298432,300071,1639,10,N,N,-,-1,-1
REOPER.txt,298465,300147,1682,10,N,N,-,-1,-1
REOPER.txt,298644,300310,1666,10,N,N,-,-1,-1
REOPER.txt,298825,300508,1683,10,N,N,-,-1,-1
REOPER.txt,298990,300778,1788,10,N,N,-,-1,-1
REOPER.txt,299062,301147,2085,10,N,N,-,-1,-1
REOPER.txt,299190,301405,2215,10,Y,N,-,-1,-1
REOPER.txt,299261,301582,2321,10,Y,N,-,-1,-1
REOPER.txt,299388,301728,2340,10,Y,N,-,-1,-1
REOPER.txt,299732,301848,2116,10,Y,N,-,-1,-1
REOPER.txt,300072,301878,1806,10,N,N,-,-1,-1
REOPER.txt,300148,302091,1943,10,N,N,-,-1,-1
REOPER.txt,300311,302106,1795,10,N,N,-,-1,-1
REOPER.txt,300509,302287,1778,10,N,N,-,-1,-1
REOPER.txt,300779,302472,1693,10,N,N,-,-1,-1
REOPER.txt,301150,302659,1509,10,N,N,-,-1,-1
REOPER.txt,301406,302871,1465,10,N,N,-,-1,-1
REOPER.txt,301583,302894,1311,10,N,N,-,-1,-1
REOPER.txt,301731,302999,1268,10,N,N,-,-1,-1
REOPER.txt,301849,303183,1334,10,N,N,-,-1,-1
REOPER.txt,301879,303502,1623,10,N,N,-,-1,-1
REOPER.txt,302094,303670,1576,10,N,N,-,-1,-1
REOPER.txt,302107,303843,1736,10,N,N,-,-1,-1
REOPER.txt,302290,303919,1629,10,N,N,-,-1,-1
REOPER.txt,302473,303925,1452,10,N,N,-,-1,-1
REOPER.txt,302660,304117,1457,10,N,N,-,-1,-1
REOPER.txt,302872,304671,1799,10,N,N,-,-1,-1
REOPER.txt,302895,304799,1904,10,N,N,-,-1,-1
REOPER.txt,303000,304984,1984,10,N,N,-,-1,-1
REOPER.txt,303186,305093,1907,10,N,N,-,-1,-1
REOPER.txt,303503,305153,1650,10,N,N,-,-1,-1
REOPER.txt,303671,305350,1679,10,N,N,-,-1,-1
REOPER.txt,303845,305621,1776,10,N,N,-,-1,-1
REOPER.txt,303920,305770,1850,10,N,N,-,-1,-1
REOPER.txt,303926,305935,2009,10,N,N,-,-1,-1
REOPER.txt,304118,306097,1979,10,N,N,-,-1,-1
REOPER.txt,304672,306428,1756,10,N,N,-,-1,-1
REOPER.txt,304800,306771,1971,10,N,N,-,-1,-1
REOPER.txt,304984,306924,1940,10,N,N,-,-1,-1
REOPER.txt,305094,307414,2320,10,N,N,-,-1,-1
REOPER.txt,305154,307610,2456,10,N,N,-,-1,-1
REOPER.txt,305351,307702,2351,10,N,N,-,-1,-1
REOPER.txt,305624,307842,2218,10,N,N,-,-1,-1
REOPER.txt,305773,307993,2220,10,N,N,-,-1,-1
REOPER.txt,305937,308283,2346,10,N,N,-,-1,-1
REOPER.txt,306099,308496,2397,10,N,N,-,-1,-1
REOPER.txt,306429,308539,2110,10,N,N,-,-1,-1
REOPER.txt,306772,308738,1966,10,N,N,-,-1,-1
REOPER.txt,306926,308838,1912,10,N,N,-,-1,-1
REOPER.txt,307415,309379,1964,10,N,N,-,-1,-1
REOPER.txt,307611,309421,1810,10,N,N,-,-1,-1
REOPER.txt,307705,309657,1952,10,N,N,-,-1,-1
REOPER.txt,307843,310019,2176,10,N,N,-,-1,-1
REOPER.txt,307994,310285,2291,10,N,N,-,-1,-1
REOPER.txt,308284,310895,2611,10,N,N,-,-1,-1
REOPER.txt,308497,311222,2725,10,N,N,-,-1,-1
REOPER.txt,308540,311248,2708,10,N,N,-,-1,-1
REOPER.txt,308741,311432,2691,10,N,N,-,-1,-1
REOPER.txt,308839,311823,2984,10,N,N,-,-1,-1
REOPER.txt,309382,312026,2644,10,N,N,-,-1,-1
REOPER.txt,309424,312054,2630,10,N,N,-,-1,-1
REOPER.txt,309658,312195,2537,10,N,N,-,-1,-1
REOPER.txt,310022,312366,2344,10,N,N,-,-1,-1
REOPER.txt,310286,312444,2158,10,N,N,-,-1,-1
REOPER.txt,310895,312770,1875,10,N,N,-,-1,-1
REOPER.txt,311227,312818,1591,10,N,N,-,-1,-1
REOPER.txt,311249,312885,1636,10,N,N,-,-1,-1
REOPER.txt,311433,312960,1527,10,N,N,-,-1,-1
REOPER.txt,311826,313043,1217,10,N,N,-,-1,-1
REOPER.txt,312027,313372,1345,10,N,N,-,-1,-1
REOPER.txt,312055,313590,1535,10,N,N,-,-1,-1
REOPER.txt,312196,313683,1487,10,N,N,-,-1,-1
REOPER.txt,312368,313913,1545,10,N,N,-,-1,-1
REOPER.txt,312445,314102,1657,10,N,N,-,-1,-1
REOPER.txt,312771,314235,1464,10,N,N,-,-1,-1
REOPER.txt,312819,314677,1858,10,N,N,-,-1,-1
REOPER.txt,312886,314823,1937,10,N,N,-,-1,-1
REOPER.txt,312963,314866,1903,10,N,N,-,-1,-1
REOPER.txt,313046,315244,2198,10,N,N,-,-1,-1
REOPER.txt,313373,315413,2040,10,N,N,-,-1,-1
REOPER.txt,313593,315503,1910,10,N,N,-,-1,-1
REOPER.txt,313684,315985,2301,10,N,N,-,-1,-1
REOPER.txt,313915,316173,2258,10,N,N,-,-1,-1
REOPER.txt,314103,316440,2337,10,N,N,-,-1,-1
REOPER.txt,314236,316722,2486,10,N,N,-,-1,-1
REOPER.txt,314679,316924,2245,10,N,N,-,-1,-1
REOPER.txt,314824,317233,2409,10,N,N,-,-1,-1
REOPER.txt,314867,317530,2663,10,N,N,-,-1,-1
REOPER.txt,315245,317882,2637,10,N,N,-,-1,-1
REOPER.txt,315414,317994,2580,10,N,N,-,-1,-1
REOPER.txt,315504,318185,2681,10,N,N,-,-1,-1
REOPER.txt,315986,318409,2423,10,N,N,-,-1,-1
REOPER.txt,316174,318439,2265,10,N,N,-,-1,-1
REOPER.txt,316441,318524,2083,10,N,N,-,-1,-1
REOPER.txt,316725,318746,2021,10,N,N,-,-1,-1
REOPER.txt,316927,318770,1843,10,N,N,-,-1,-1
REOPER.txt,317234,318976,1742,10,N,N,-,-1,-1
REOPER.txt,317531,319266,1735,10,N,N,-,-1,-1
REOPER.txt,317883,319570,1687,10,N,N,-,-1,-1
REOPER.txt,317995,319773,1778,10,N,N,-,-1,-1
REOPER.txt,318186,320095,1909,10,N,N,-,-1,-1
REOPER.txt,318410,320493,2083,10,N,N,-,-1,-1
REOPER.txt,318442,320716,2274,10,N,N,-,-1,-1
REOPER.txt,318525,320738,2213,10,N,N,-,-1,-1
REOPER.txt,318748,321174,2426,10,N,N,-,-1,-1
REOPER.txt,318771,321435,2664,10,N,N,-,-1,-1
REOPER.txt,318977,321689,2712,10,N,N,-,-1,-1
REOPER.txt,319267,322080,2813,10,N,N,-,-1,-1
REOPER.txt,319571,322356,2785,10,Y,N,-,-1,-1
REOPER.txt,319774,322486,2712,10,N,N,-,-1,-1
REOPER.txt,320096,322573,2477,10,N,N,-,-1,-1
REOPER.txt,320494,322748,2254,10,N,N,-,-1,-1
REOPER.txt,320719,322838,2119,10,N,N,-,-1,-1
REOPER.txt,320739,323077,2338,10,N,N,-,-1,-1
REOPER.txt,321175,323630,2455,10,N,N,-,-1,-1
REOPER.txt,321436,323708,2272,10,N,N,-,-1,-1
REOPER.txt,321690,323876,2186,10,Y,N,-,-1,-1
REOPER.txt,322081,324055,1974,10,Y,N,-,-1,-1
REOPER.txt,322358,324232,1874,10,Y,N,-,-1,-1
REOPER.txt,322489,324283,1794,10,Y,N,-,-1,-1
REOPER.txt,322574,324379,1805,10,Y,N,-,-1,-1
REOPER.txt,322750,324454,1704,10,Y,N,-,-1,-1
REOPER.txt,322839,324530,1691,10,Y,N,-,-1,-1
REOPER.txt,323078,324898,1820,10,Y,N,-,-1,-1
REOPER.txt,323631,324978,1347,10,Y,N,-,-1,-1
REOPER.txt,323709,325147,1438,10,Y,N,-,-1,-1
REOPER.txt,323878,325222,1344,10,N,N,-,-1,-1
REOPER.txt,324056,325362,1306,10,N,N,-,-1,-1
REOPER.txt,324233,325459,1226,10,N,N,-,-1,-1
REOPER.txt,324286,325620,1334,10,N,Y,1448285913012,108803,110925
REOPER.txt,324380,325723,1343,10,N,Y,1448285913012,108803,110925
REOPER.txt,324455,325941,1486,10,N,Y,1448285913012,108803,110925
REOPER.txt,324531,326200,1669,10,N,Y,1448285913012,108803,110925
REOPER.txt,324899,326215,1316,10,N,Y,1448285913012,108803,110925
REOPER.txt,324979,326513,1534,10,N,Y,1448285913012,108803,110925
REOPER.txt,325149,326654,1505,10,Y,Y,1448285913012,108803,110925
REOPER.txt,325223,326804,1581,10,Y,Y,1448285913012,108803,110925
REOPER.txt,325363,326860,1497,10,N,Y,1448285913012,108803,110925
REOPER.txt,325462,326969,1507,10,Y,Y,1448285913012,108803,110925
REOPER.txt,325621,327021,1400,10,Y,Y,1448285913012,108803,110925
REOPER.txt,325724,327062,1338,10,Y,Y,1448285913012,108803,110925
REOPER.txt,325942,327272,1330,10,Y,Y,1448285913012,108803,110925
REOPER.txt,326205,327351,1146,10,Y,Y,1448285913012,108803,110925
REOPER.txt,326216,327393,1177,10,Y,Y,1448285913012,108803,110925
REOPER.txt,326514,327475,961,10,Y,Y,1448285913012,108803,110925
REOPER.txt,326655,327554,899,10,N,Y,1448285913012,108803,110925
REOPER.txt,326805,327642,837,10,N,Y,1448285913012,108803,110925
REOPER.txt,326861,327868,1007,10,N,Y,1448285913012,108803,110925
REOPER.txt,326970,327936,966,10,N,Y,1448285913012,108803,110925
REOPER.txt,327022,327983,961,10,N,Y,1448285913012,108803,110925
REOPER.txt,327063,328074,1011,10,N,Y,1448285913012,108803,110925
REOPER.txt,327273,328207,934,10,N,Y,1448285913012,108803,110925
REOPER.txt,327353,328320,967,10,N,Y,1448285913012,108803,110925
REOPER.txt,327394,328508,1114,10,N,Y,1448285913012,108803,110925
REOPER.txt,327476,328964,1488,10,N,Y,1448285913012,108803,110925
REOPER.txt,327557,329100,1543,10,N,N,-,-1,-1
REOPER.txt,327643,329198,1555,10,N,N,-,-1,-1
REOPER.txt,327869,329223,1354,10,N,N,-,-1,-1
REOPER.txt,327937,329827,1890,10,N,N,-,-1,-1
REOPER.txt,327986,330262,2276,10,N,N,-,-1,-1
REOPER.txt,328077,330393,2316,10,N,Y,1448315575026,182236,182361
REOPER.txt,328208,330533,2325,10,N,Y,1448315575026,182236,182361
REOPER.txt,328321,330757,2436,10,N,Y,1448315575026,182236,182361
REOPER.txt,328509,330955,2446,10,N,Y,1448315575026,182236,182361
REOPER.txt,328965,331105,2140,10,N,Y,1448315575026,182236,182361
REOPER.txt,329101,331151,2050,10,N,Y,1448315575026,182236,182361
REOPER.txt,329203,331351,2148,10,N,Y,1448315575026,182236,182361
REOPER.txt,329228,331559,2331,10,N,Y,1448315575026,182236,182361
REOPER.txt,329832,331757,1925,10,N,Y,1448315575026,182236,182361
REOPER.txt,330263,331984,1721,10,N,Y,1448315575026,182236,182361
REOPER.txt,330395,332163,1768,10,Y,Y,1448315575026,182236,182361
REOPER.txt,330534,332338,1804,10,Y,Y,1448315575026,182236,182361
REOPER.txt,330760,332563,1803,10,Y,Y,1448315575026,182236,182361
REOPER.txt,330956,332596,1640,10,Y,Y,1448315575026,182236,182361
REOPER.txt,331105,332671,1566,10,Y,Y,1448315575026,182236,182361
REOPER.txt,331152,332853,1701,10,Y,Y,1448315575026,182236,182361
REOPER.txt,331352,333203,1851,10,Y,N,-,-1,-1
REOPER.txt,331560,333292,1732,10,Y,N,-,-1,-1
REOPER.txt,331758,333352,1594,10,Y,N,-,-1,-1
REOPER.txt,331985,333382,1397,10,N,N,-,-1,-1
REOPER.txt,332164,333547,1383,10,N,N,-,-1,-1
REOPER.txt,332339,333921,1582,10,N,N,-,-1,-1
REOPER.txt,332564,334152,1588,10,N,N,-,-1,-1
REOPER.txt,332597,334308,1711,10,N,N,-,-1,-1
REOPER.txt,332672,334460,1788,10,N,N,-,-1,-1
REOPER.txt,332854,334481,1627,10,N,N,-,-1,-1
REOPER.txt,333204,334824,1620,10,N,N,-,-1,-1
REOPER.txt,333293,335129,1836,10,N,N,-,-1,-1
REOPER.txt,333353,335349,1996,10,N,N,-,-1,-1
REOPER.txt,333384,335694,2310,10,N,N,-,-1,-1
REOPER.txt,333549,335876,2327,10,N,N,-,-1,-1
REOPER.txt,333922,336044,2122,10,N,N,-,-1,-1
REOPER.txt,334154,336217,2063,10,N,N,-,-1,-1
REOPER.txt,334310,336254,1944,10,N,N,-,-1,-1
REOPER.txt,334463,336337,1874,10,N,N,-,-1,-1
REOPER.txt,334482,336401,1919,10,N,N,-,-1,-1
REOPER.txt,334825,336529,1704,10,N,N,-,-1,-1
REOPER.txt,335130,336727,1597,10,N,N,-,-1,-1
REOPER.txt,335350,336882,1532,10,N,N,-,-1,-1
REOPER.txt,335695,337095,1400,10,N,N,-,-1,-1
REOPER.txt,335877,337199,1322,10,N,N,-,-1,-1
REOPER.txt,336045,337227,1182,10,N,N,-,-1,-1
REOPER.txt,336222,337268,1046,10,N,N,-,-1,-1
REOPER.txt,336255,337316,1061,10,N,N,-,-1,-1
REOPER.txt,336338,337348,1010,10,N,N,-,-1,-1
REOPER.txt,336402,337389,987,10,N,N,-,-1,-1
REOPER.txt,336530,337548,1018,10,N,N,-,-1,-1
REOPER.txt,336728,337622,894,10,N,N,-,-1,-1
REOPER.txt,336883,337707,824,10,N,N,-,-1,-1
REOPER.txt,337096,337912,816,10,N,N,-,-1,-1
REOPER.txt,337200,338089,889,10,N,N,-,-1,-1
REOPER.txt,337228,338631,1403,10,N,N,-,-1,-1
REOPER.txt,337269,338948,1679,10,N,N,-,-1,-1
REOPER.txt,337317,338988,1671,10,N,N,-,-1,-1
REOPER.txt,337350,339015,1665,10,N,N,-,-1,-1
REOPER.txt,337392,339085,1693,10,N,N,-,-1,-1
REOPER.txt,337549,339161,1612,10,N,Y,1448285563397,102964,108476
REOPER.txt,337623,339241,1618,10,N,Y,1448285563397,102964,108476
REOPER.txt,337708,339515,1807,10,Y,Y,1448285563397,102964,108476
REOPER.txt,337913,339760,1847,10,Y,Y,1448285563397,102964,108476
REOPER.txt,338092,339868,1776,10,Y,Y,1448285563397,102964,108476
REOPER.txt,338632,339927,1295,10,Y,Y,1448285563397,102964,108476
REOPER.txt,338949,340001,1052,10,Y,Y,1448285563397,102964,108476
REOPER.txt,338989,340191,1202,10,Y,Y,1448285563397,102964,108476
REOPER.txt,339018,340357,1339,10,Y,Y,1448285563397,102964,108476
REOPER.txt,339086,340408,1322,10,Y,Y,1448285563397,102964,108476
REOPER.txt,339162,340675,1513,10,N,Y,1448285563397,102964,108476
REOPER.txt,339242,340775,1533,10,N,Y,1448285563397,102964,108476
REOPER.txt,339516,340880,1364,10,N,Y,1448285563397,102964,108476
REOPER.txt,339761,341083,1322,10,N,Y,1448285563397,102964,108476
REOPER.txt,339869,341107,1238,10,N,Y,1448313800274,179025,179317
REOPER.txt,339928,341145,1217,10,N,Y,1448313800274,179025,179317
REOPER.txt,340004,341286,1282,10,N,Y,1448313800274,179025,179317
REOPER.txt,340192,341327,1135,10,N,Y,1448313800274,179025,179317
REOPER.txt,340358,341434,1076,10,N,Y,1448313800274,179025,179317
REOPER.txt,340410,341600,1190,10,N,Y,1448313800274,179025,179317
REOPER.txt,340676,341693,1017,10,N,Y,1448313800274,179025,179317
REOPER.txt,340776,341786,1010,10,N,Y,1448313800274,179025,179317
REOPER.txt,340881,341865,984,10,N,N,-,-1,-1
REOPER.txt,341084,341951,867,10,N,N,-,-1,-1
REOPER.txt,341108,341984,876,10,N,N,-,-1,-1
REOPER.txt,341146,342041,895,10,N,N,-,-1,-1
REOPER.txt,341287,342198,911,10,N,N,-,-1,-1
REOPER.txt,341328,342212,884,10,N,N,-,-1,-1
REOPER.txt,341437,342239,802,10,N,N,-,-1,-1
REOPER.txt,341602,342385,783,10,N,N,-,-1,-1
REOPER.txt,341696,342435,739,10,N,N,-,-1,-1
REOPER.txt,341787,342517,730,10,N,N,-,-1,-1
REOPER.txt,341866,342696,830,10,N,N,-,-1,-1
REOPER.txt,341952,342926,974,10,N,N,-,-1,-1
REOPER.txt,341987,342965,978,10,N,N,-,-1,-1
REOPER.txt,342043,342973,930,10,N,N,-,-1,-1
REOPER.txt,342199,343095,896,10,N,N,-,-1,-1
REOPER.txt,342213,343112,899,10,N,N,-,-1,-1
REOPER.txt,342240,343257,1017,10,N,N,-,-1,-1
REOPER.txt,342386,343439,1053,10,N,N,-,-1,-1
REOPER.txt,342436,343453,1017,10,N,N,-,-1,-1
REOPER.txt,342520,343564,1044,10,N,N,-,-1,-1
REOPER.txt,342697,343756,1059,10,N,N,-,-1,-1
REOPER.txt,342927,343920,993,10,N,N,-,-1,-1
REOPER.txt,342966,343989,1023,10,N,N,-,-1,-1
REOPER.txt,342974,344045,1071,10,N,N,-,-1,-1
REOPER.txt,343097,344092,995,10,N,N,-,-1,-1
REOPER.txt,343113,344322,1209,10,N,N,-,-1,-1
REOPER.txt,343258,344396,1138,10,N,N,-,-1,-1
REOPER.txt,343440,344455,1015,10,N,N,-,-1,-1
REOPER.txt,343454,344644,1190,10,N,N,-,-1,-1
REOPER.txt,343565,344699,1134,10,N,N,-,-1,-1
REOPER.txt,343757,344806,1049,10,N,N,-,-1,-1
REOPER.txt,343921,345262,1341,10,N,N,-,-1,-1
REOPER.txt,343990,345298,1308,10,N,N,-,-1,-1
REOPER.txt,344046,345319,1273,10,N,N,-,-1,-1
REOPER.txt,344093,345537,1444,10,N,N,-,-1,-1
REOPER.txt,344323,345777,1454,10,Y,N,-,-1,-1
REOPER.txt,344397,346222,1825,10,Y,N,-,-1,-1
REOPER.txt,344456,346474,2018,10,Y,N,-,-1,-1
REOPER.txt,344645,346626,1981,10,N,Y,1448039123601,19678,19935
REOPER.txt,344702,346701,1999,10,N,Y,1448039123601,19678,19935
REOPER.txt,344807,346802,1995,10,Y,Y,1448039123601,19678,19935
REOPER.txt,345267,346874,1607,10,N,Y,1448039123601,19678,19935
REOPER.txt,345301,347071,1770,10,N,Y,1448039123601,19678,19935
REOPER.txt,345320,347125,1805,10,N,Y,1448039123601,19678,19935
REOPER.txt,345538,347153,1615,10,N,Y,1448039123601,19678,19935
REOPER.txt,345780,347265,1485,10,N,Y,1448039123601,19678,19935
REOPER.txt,346223,347339,1116,10,N,Y,1448039123601,19678,19935
REOPER.txt,346475,347697,1222,10,N,Y,1448039123601,19678,19935
REOPER.txt,346627,347790,1163,10,N,Y,1448039123601,19678,19935
REOPER.txt,346704,347844,1140,10,N,Y,1448039123601,19678,19935
REOPER.txt,346803,347997,1194,10,N,Y,1448039123601,19678,19935
REOPER.txt,346876,348042,1166,10,N,Y,1448039123601,19678,19935
REOPER.txt,347072,348158,1086,10,N,Y,1448039123601,19678,19935
REOPER.txt,347126,348216,1090,10,Y,Y,1448039123601,19678,19935
REOPER.txt,347154,348242,1088,10,Y,Y,1448039123601,19678,19935
REOPER.txt,347266,348487,1221,10,Y,Y,1448039123601,19678,19935
REOPER.txt,347342,348519,1177,10,Y,Y,1448039123601,19678,19935
REOPER.txt,347698,348540,842,10,Y,Y,1448039123601,19678,19935
REOPER.txt,347791,348559,768,10,Y,Y,1448039123601,19678,19935
REOPER.txt,347845,348577,732,10,Y,Y,1448039123601,19678,19935
REOPER.txt,347998,348704,706,10,N,Y,1448039123601,19678,19935
REOPER.txt,348043,348900,857,10,N,Y,1448039123601,19678,19935
REOPER.txt,348159,348987,828,10,N,Y,1448039123601,19678,19935
REOPER.txt,348217,349171,954,10,N,Y,1448039123601,19678,19935
REOPER.txt,348245,349443,1198,10,N,Y,1448039123601,19678,19935
REOPER.txt,348488,349680,1192,10,N,Y,1448039123601,19678,19935
REOPER.txt,348520,349757,1237,10,N,Y,1448039123601,19678,19935
REOPER.txt,348541,349928,1387,10,N,Y,1448039123601,19678,19935
REOPER.txt,348560,350149,1589,10,N,Y,1448039123601,19678,19935
REOPER.txt,348578,350173,1595,10,N,Y,1448039123601,19678,19935
REOPER.txt,348707,350512,1805,10,N,Y,1448314192885,179720,179950
REOPER.txt,348903,351009,2106,10,N,Y,1448314192885,179720,179950
REOPER.txt,348988,351255,2267,10,N,Y,1448314192885,179720,179950
REOPER.txt,349173,351441,2268,10,N,Y,1448314192885,179720,179950
REOPER.txt,349445,351606,2161,10,N,N,-,-1,-1
REOPER.txt,349683,351751,2068,10,N,N,-,-1,-1
REOPER.txt,349758,351957,2199,10,N,N,-,-1,-1
REOPER.txt,349929,352075,2146,10,N,N,-,-1,-1
REOPER.txt,350154,352164,2010,10,N,N,-,-1,-1
REOPER.txt,350176,352212,2036,10,N,N,-,-1,-1
REOPER.txt,350512,352277,1765,10,N,N,-,-1,-1
REOPER.txt,351012,352388,1376,10,N,N,-,-1,-1
REOPER.txt,351256,352610,1354,10,N,N,-,-1,-1
REOPER.txt,351442,352917,1475,10,N,N,-,-1,-1
REOPER.txt,351608,353112,1504,10,N,N,-,-1,-1
REOPER.txt,351754,353334,1580,10,N,N,-,-1,-1
REOPER.txt,351958,353452,1494,10,N,Y,1448280673594,87462,88501
REOPER.txt,352076,353515,1439,10,N,Y,1448280673594,87462,88501
REOPER.txt,352167,353569,1402,10,N,Y,1448280673594,87462,88501
REOPER.txt,352213,353790,1577,10,N,Y,1448280673594,87462,88501
REOPER.txt,352278,353927,1649,10,N,Y,1448280673594,87462,88501
REOPER.txt,352389,354100,1711,10,N,Y,1448280673594,87462,88501
REOPER.txt,352611,354160,1549,10,N,Y,1448278147591,54631,55869
REOPER.txt,352918,354524,1606,10,N,Y,1448278147591,54631,55869
REOPER.txt,353113,354719,1606,10,N,Y,1448278147591,54631,55869
REOPER.txt,353337,354963,1626,10,Y,Y,1448278147591,54631,55869
REOPER.txt,353453,355120,1667,10,Y,Y,1448278147591,54631,55869
REOPER.txt,353516,355344,1828,10,Y,Y,1448278147591,54631,55869
REOPER.txt,353570,355506,1936,10,Y,Y,1448278147591,54631,55869
REOPER.txt,353791,355735,1944,10,Y,Y,1437477878183,427206,428439
REOPER.txt,353930,356218,2288,10,Y,Y,1437477878183,427206,428439
REOPER.txt,354101,356350,2249,10,Y,Y,1437477878183,427206,428439
REOPER.txt,354161,356527,2366,10,Y,Y,1437477878183,427206,428439
REOPER.txt,354526,356735,2209,10,Y,Y,1437477878183,427206,428439
REOPER.txt,354720,356941,2221,10,Y,Y,1437477878183,427206,428439
REOPER.txt,354964,357035,2071,10,N,Y,1437477878183,427206,428439
REOPER.txt,355121,357130,2009,10,N,Y,1437477878183,427206,428439
REOPER.txt,355347,357154,1807,10,N,Y,1437477878183,427206,428439
REOPER.txt,355508,357281,1773,10,N,Y,1437477878183,427206,428439
REOPER.txt,355736,357525,1789,10,N,Y,1437477878183,427206,428439
REOPER.txt,356219,357677,1458,10,N,Y,1437477878183,427206,428439
REOPER.txt,356351,357724,1373,10,N,Y,1437477878183,427206,428439
REOPER.txt,356528,357971,1443,10,N,Y,1437477878183,427206,428439
REOPER.txt,356736,358117,1381,10,N,Y,1437477878183,427206,428439
REOPER.txt,356942,358355,1413,10,N,Y,1437477878183,427206,428439
REOPER.txt,357036,358613,1577,10,N,Y,1437477878183,427206,428439
REOPER.txt,357135,358872,1737,10,N,N,-,-1,-1
REOPER.txt,357155,358991,1836,10,N,N,-,-1,-1
REOPER.txt,357282,359228,1946,10,N,N,-,-1,-1
REOPER.txt,357526,359353,1827,10,N,N,-,-1,-1
REOPER.txt,357678,359510,1832,10,N,N,-,-1,-1
REOPER.txt,357725,359646,1921,10,N,N,-,-1,-1
REOPER.txt,357974,359752,1778,10,N,N,-,-1,-1
REOPER.txt,358118,359911,1793,10,N,Y,1448323072174,227638,227786
REOPER.txt,358357,360246,1889,10,N,Y,1448323072174,227638,227786
REOPER.txt,358614,360327,1713,10,Y,Y,1448323072174,227638,227786
REOPER.txt,358873,360463,1590,10,Y,Y,1448323072174,227638,227786
REOPER.txt,358994,360538,1544,10,Y,Y,1448323072174,227638,227786
REOPER.txt,359231,360614,1383,10,Y,Y,1448323072174,227638,227786
REOPER.txt,359354,360677,1323,10,Y,Y,1448323072174,227638,227786
REOPER.txt,359511,360739,1228,10,N,Y,1448323072174,227638,227786
REOPER.txt,359647,360755,1108,10,N,Y,1448323072174,227638,227786
REOPER.txt,359753,360781,1028,10,N,Y,1448323072174,227638,227786
REOPER.txt,359912,360977,1065,10,Y,Y,1448323072174,227638,227786
REOPER.txt,360249,361078,829,10,N,Y,1448323072174,227638,227786
REOPER.txt,360328,361221,893,10,Y,Y,1448323072174,227638,227786
REOPER.txt,360465,361359,894,10,N,Y,1448323072174,227638,227786
REOPER.txt,360539,361423,884,10,N,Y,1448323072174,227638,227786
REOPER.txt,360615,361677,1062,10,N,Y,1448323072174,227638,227786
REOPER.txt,360679,361780,1101,10,N,Y,1448315012079,181380,182053
REOPER.txt,360740,361986,1246,10,N,Y,1448315012079,181380,182053
REOPER.txt,360756,362189,1433,10,N,Y,1448315012079,181380,182053
REOPER.txt,360782,362295,1513,10,N,Y,1448315012079,181380,182053
REOPER.txt,360978,362424,1446,10,N,Y,1448315012079,181380,182053
REOPER.txt,361081,362492,1411,10,N,Y,1448315012079,181380,182053
REOPER.txt,361222,362672,1450,10,N,Y,1448315012079,181380,182053
REOPER.txt,361360,362704,1344,10,N,Y,1448315012079,181380,182053
REOPER.txt,361424,362896,1472,10,N,Y,1448315012079,181380,182053
REOPER.txt,361680,363014,1334,10,N,Y,1448315012079,181380,182053
REOPER.txt,361782,363064,1282,10,N,Y,1448315012079,181380,182053
REOPER.txt,361987,363238,1251,10,N,Y,1448315012079,181380,182053
REOPER.txt,362190,363374,1184,10,N,Y,1448315012079,181380,182053
REOPER.txt,362298,363500,1202,10,Y,Y,1448315012079,181380,182053
REOPER.txt,362425,363605,1180,10,Y,Y,1448315012079,181380,182053
REOPER.txt,362495,363727,1232,10,N,Y,1448315012079,181380,182053
REOPER.txt,362673,363882,1209,10,N,N,-,-1,-1
REOPER.txt,362705,364141,1436,10,N,N,-,-1,-1
REOPER.txt,362899,364234,1335,10,N,N,-,-1,-1
REOPER.txt,363015,364344,1329,10,N,N,-,-1,-1
REOPER.txt,363065,364522,1457,10,N,N,-,-1,-1
REOPER.txt,363239,364654,1415,10,Y,N,-,-1,-1
REOPER.txt,363375,364721,1346,10,Y,N,-,-1,-1
REOPER.txt,363501,365106,1605,10,Y,N,-,-1,-1
REOPER.txt,363608,365278,1670,10,Y,N,-,-1,-1
REOPER.txt,363728,365473,1745,10,Y,N,-,-1,-1
REOPER.txt,363883,365589,1706,10,N,N,-,-1,-1
REOPER.txt,364142,365817,1675,10,N,N,-,-1,-1
REOPER.txt,364235,366018,1783,10,N,N,-,-1,-1
REOPER.txt,364346,366083,1737,10,N,N,-,-1,-1
REOPER.txt,364525,366458,1933,10,N,N,-,-1,-1
REOPER.txt,364655,366690,2035,10,N,N,-,-1,-1
REOPER.txt,364722,366994,2272,10,N,N,-,-1,-1
REOPER.txt,365107,367093,1986,10,N,N,-,-1,-1
REOPER.txt,365279,367173,1894,10,N,N,-,-1,-1
REOPER.txt,365474,367307,1833,10,N,N,-,-1,-1
REOPER.txt,365590,367460,1870,10,N,N,-,-1,-1
REOPER.txt,365820,367599,1779,10,N,N,-,-1,-1
REOPER.txt,366021,367741,1720,10,N,N,-,-1,-1
REOPER.txt,366084,367760,1676,10,N,N,-,-1,-1
REOPER.txt,366460,367889,1429,10,N,N,-,-1,-1
REOPER.txt,366691,368026,1335,10,N,N,-,-1,-1
REOPER.txt,366997,368210,1213,10,N,N,-,-1,-1
REOPER.txt,367094,368495,1401,10,N,N,-,-1,-1
REOPER.txt,367174,368718,1544,10,N,N,-,-1,-1
REOPER.txt,367308,368884,1576,10,N,N,-,-1,-1
REOPER.txt,367465,369269,1804,10,N,N,-,-1,-1
REOPER.txt,367600,369490,1890,10,N,N,-,-1,-1
REOPER.txt,367746,369592,1846,10,N,N,-,-1,-1
REOPER.txt,367761,369643,1882,10,N,N,-,-1,-1
REOPER.txt,367890,369718,1828,10,N,N,-,-1,-1
REOPER.txt,368027,369874,1847,10,N,N,-,-1,-1
REOPER.txt,368211,370080,1869,10,N,N,-,-1,-1
REOPER.txt,368497,370290,1793,10,N,N,-,-1,-1
REOPER.txt,368720,370476,1756,10,N,N,-,-1,-1
REOPER.txt,368885,370696,1811,10,N,N,-,-1,-1
REOPER.txt,369270,370885,1615,10,N,N,-,-1,-1
REOPER.txt,369491,371022,1531,10,N,N,-,-1,-1
REOPER.txt,369593,371166,1573,10,N,N,-,-1,-1
REOPER.txt,369646,371356,1710,10,N,N,-,-1,-1
REOPER.txt,369721,371504,1783,10,N,N,-,-1,-1
REOPER.txt,369875,371700,1825,10,N,N,-,-1,-1
REOPER.txt,370081,371772,1691,10,N,N,-,-1,-1
REOPER.txt,370293,371906,1613,10,N,N,-,-1,-1
REOPER.txt,370477,372174,1697,10,N,N,-,-1,-1
REOPER.txt,370697,372235,1538,10,N,N,-,-1,-1
REOPER.txt,370890,372369,1479,10,N,N,-,-1,-1
REOPER.txt,371023,372536,1513,10,N,N,-,-1,-1
REOPER.txt,371168,372655,1487,10,N,N,-,-1,-1
REOPER.txt,371357,372766,1409,10,N,N,-,-1,-1
REOPER.txt,371505,372832,1327,10,N,N,-,-1,-1
REOPER.txt,371701,372954,1253,10,N,N,-,-1,-1
REOPER.txt,371773,373044,1271,10,N,N,-,-1,-1
REOPER.txt,371907,373254,1347,10,N,N,-,-1,-1
REOPER.txt,372175,373298,1123,10,N,N,-,-1,-1
REOPER.txt,372236,373394,1158,10,N,N,-,-1,-1
REOPER.txt,372372,373574,1202,10,N,N,-,-1,-1
REOPER.txt,372538,373772,1234,10,N,N,-,-1,-1
REOPER.txt,372658,373915,1257,10,N,N,-,-1,-1
REOPER.txt,372767,374035,1268,10,N,N,-,-1,-1
REOPER.txt,372833,374165,1332,10,N,N,-,-1,-1
REOPER.txt,372955,374253,1298,10,N,N,-,-1,-1
REOPER.txt,373045,374456,1411,10,N,N,-,-1,-1
REOPER.txt,373257,374558,1301,10,N,N,-,-1,-1
REOPER.txt,373299,374755,1456,10,N,N,-,-1,-1
REOPER.txt,373395,374877,1482,10,N,N,-,-1,-1
REOPER.txt,373577,374909,1332,10,N,N,-,-1,-1
REOPER.txt,373773,374935,1162,10,N,N,-,-1,-1
REOPER.txt,373918,375078,1160,10,N,N,-,-1,-1
REOPER.txt,374036,375279,1243,10,N,N,-,-1,-1
REOPER.txt,374166,375314,1148,10,N,N,-,-1,-1
REOPER.txt,374255,375561,1306,10,N,N,-,-1,-1
REOPER.txt,374457,375598,1141,10,N,N,-,-1,-1
REOPER.txt,374559,375639,1080,10,N,N,-,-1,-1
REOPER.txt,374756,375774,1018,10,N,N,-,-1,-1
REOPER.txt,374878,375931,1053,10,N,N,-,-1,-1
REOPER.txt,374912,376197,1285,10,N,N,-,-1,-1
REOPER.txt,374937,376221,1284,10,N,N,-,-1,-1
REOPER.txt,375079,376280,1201,10,N,N,-,-1,-1
REOPER.txt,375280,376318,1038,10,N,N,-,-1,-1
REOPER.txt,375315,376425,1110,10,N,N,-,-1,-1
REOPER.txt,375562,376505,943,10,N,N,-,-1,-1
REOPER.txt,375599,376610,1011,10,N,N,-,-1,-1
REOPER.txt,375640,376791,1151,10,N,N,-,-1,-1
REOPER.txt,375777,376911,1134,10,N,N,-,-1,-1
REOPER.txt,375932,377022,1090,10,N,N,-,-1,-1
REOPER.txt,376200,377222,1022,10,N,N,-,-1,-1
REOPER.txt,376224,377418,1194,10,N,N,-,-1,-1
REOPER.txt,376281,377673,1392,10,N,N,-,-1,-1
REOPER.txt,376319,377736,1417,10,N,N,-,-1,-1
REOPER.txt,376426,377830,1404,10,N,N,-,-1,-1
REOPER.txt,376506,377954,1448,10,N,N,-,-1,-1
REOPER.txt,376611,377983,1372,10,N,N,-,-1,-1
REOPER.txt,376792,378042,1250,10,N,N,-,-1,-1
REOPER.txt,376912,378531,1619,10,N,N,-,-1,-1
REOPER.txt,377023,378614,1591,10,N,N,-,-1,-1
REOPER.txt,377223,378828,1605,10,N,N,-,-1,-1
REOPER.txt,377419,378950,1531,10,N,N,-,-1,-1
REOPER.txt,377674,379131,1457,10,N,N,-,-1,-1
REOPER.txt,377737,379252,1515,10,N,N,-,-1,-1
REOPER.txt,377831,379365,1534,10,N,N,-,-1,-1
REOPER.txt,377957,379530,1573,10,N,N,-,-1,-1
REOPER.txt,377984,379647,1663,10,N,N,-,-1,-1
REOPER.txt,378043,380014,1971,10,N,N,-,-1,-1
REOPER.txt,378532,380053,1521,10,N,N,-,-1,-1
REOPER.txt,378615,380363,1748,10,N,N,-,-1,-1
REOPER.txt,378830,380542,1712,10,N,N,-,-1,-1
REOPER.txt,378951,380577,1626,10,N,N,-,-1,-1
REOPER.txt,379132,380598,1466,10,N,N,-,-1,-1
REOPER.txt,379253,380799,1546,10,N,N,-,-1,-1
REOPER.txt,379366,380976,1610,10,N,N,-,-1,-1
REOPER.txt,379531,381199,1668,10,N,N,-,-1,-1
REOPER.txt,379648,381583,1935,10,N,N,-,-1,-1
REOPER.txt,380015,381721,1706,10,N,N,-,-1,-1
REOPER.txt,380054,381844,1790,10,N,N,-,-1,-1
REOPER.txt,380365,382150,1785,10,N,N,-,-1,-1
REOPER.txt,380545,382224,1679,10,N,N,-,-1,-1
REOPER.txt,380582,382390,1808,10,N,N,-,-1,-1
REOPER.txt,380599,382515,1916,10,N,N,-,-1,-1
REOPER.txt,380802,382666,1864,10,N,N,-,-1,-1
REOPER.txt,380977,382834,1857,10,N,N,-,-1,-1
REOPER.txt,381201,383040,1839,10,N,N,-,-1,-1
REOPER.txt,381584,383130,1546,10,N,N,-,-1,-1
REOPER.txt,381722,383250,1528,10,N,N,-,-1,-1
REOPER.txt,381845,383364,1519,10,N,N,-,-1,-1
REOPER.txt,382151,383512,1361,10,N,N,-,-1,-1
REOPER.txt,382225,383626,1401,10,N,N,-,-1,-1
REOPER.txt,382391,383765,1374,10,N,N,-,-1,-1
REOPER.txt,382516,383904,1388,10,N,N,-,-1,-1
REOPER.txt,382669,384166,1497,10,N,Y,1448316586529,210063,210674
REOPER.txt,382835,384308,1473,10,N,Y,1448316586529,210063,210674
REOPER.txt,383043,384508,1465,10,N,Y,1448316586529,210063,210674
REOPER.txt,383131,384624,1493,10,N,Y,1448316586529,210063,210674
REOPER.txt,383253,384710,1457,10,N,Y,1448316586529,210063,210674
REOPER.txt,383365,384764,1399,10,N,Y,1448316586529,210063,210674
REOPER.txt,383513,384848,1335,10,N,Y,1448316586529,210063,210674
REOPER.txt,383631,384913,1282,10,N,Y,1448316586529,210063,210674
REOPER.txt,383766,384969,1203,10,N,Y,1448316586529,210063,210674
REOPER.txt,383907,385080,1173,10,N,Y,1448316586529,210063,210674
REOPER.txt,384167,385304,1137,10,N,Y,1448316586529,210063,210674
REOPER.txt,384309,385489,1180,10,N,Y,1448316586529,210063,210674
REOPER.txt,384510,385514,1004,10,N,Y,1448316586529,210063,210674
REOPER.txt,384625,385865,1240,10,N,N,-,-1,-1
REOPER.txt,384711,386131,1420,10,N,N,-,-1,-1
REOPER.txt,384765,386206,1441,10,N,N,-,-1,-1
REOPER.txt,384849,386353,1504,10,N,N,-,-1,-1
REOPER.txt,384916,386535,1619,10,N,N,-,-1,-1
REOPER.txt,384971,386647,1676,10,N,N,-,-1,-1
REOPER.txt,385082,386793,1711,10,N,N,-,-1,-1
REOPER.txt,385306,386938,1632,10,N,N,-,-1,-1
REOPER.txt,385494,387014,1520,10,N,N,-,-1,-1
REOPER.txt,385517,387169,1652,10,N,N,-,-1,-1
REOPER.txt,385868,387338,1470,10,N,N,-,-1,-1
REOPER.txt,386134,387415,1281,10,N,N,-,-1,-1
REOPER.txt,386207,387634,1427,10,N,N,-,-1,-1
REOPER.txt,386354,387680,1326,10,N,N,-,-1,-1
REOPER.txt,386536,387723,1187,10,N,N,-,-1,-1
REOPER.txt,386648,387942,1294,10,N,N,-,-1,-1
REOPER.txt,386794,388254,1460,10,N,N,-,-1,-1
REOPER.txt,386941,388414,1473,10,N,N,-,-1,-1
REOPER.txt,387015,388518,1503,10,N,N,-,-1,-1
REOPER.txt,387170,388574,1404,10,N,N,-,-1,-1
REOPER.txt,387339,388691,1352,10,N,N,-,-1,-1
REOPER.txt,387416,388866,1450,10,N,N,-,-1,-1
REOPER.txt,387635,388960,1325,10,N,N,-,-1,-1
REOPER.txt,387681,389141,1460,10,N,N,-,-1,-1
REOPER.txt,387724,389165,1441,10,N,N,-,-1,-1
REOPER.txt,387945,389211,1266,10,N,N,-,-1,-1
REOPER.txt,388255,389320,1065,10,N,N,-,-1,-1
REOPER.txt,388415,389510,1095,10,N,N,-,-1,-1
REOPER.txt,388519,389563,1044,10,N,N,-,-1,-1
REOPER.txt,388575,389748,1173,10,N,N,-,-1,-1
REOPER.txt,388692,389950,1258,10,N,N,-,-1,-1
REOPER.txt,388869,390174,1305,10,N,N,-,-1,-1
REOPER.txt,388963,390329,1366,10,N,N,-,-1,-1
REOPER.txt,389142,390526,1384,10,N,N,-,-1,-1
REOPER.txt,389166,390605,1439,10,N,N,-,-1,-1
REOPER.txt,389214,390867,1653,10,N,N,-,-1,-1
REOPER.txt,389322,390982,1660,10,N,N,-,-1,-1
REOPER.txt,389511,391105,1594,10,N,N,-,-1,-1
REOPER.txt,389564,391280,1716,10,N,N,-,-1,-1
REOPER.txt,389751,391412,1661,10,N,N,-,-1,-1
REOPER.txt,389953,391643,1690,10,N,N,-,-1,-1
REOPER.txt,390176,392041,1865,10,N,N,-,-1,-1
REOPER.txt,390330,392240,1910,10,N,N,-,-1,-1
REOPER.txt,390529,392320,1791,10,N,N,-,-1,-1
REOPER.txt,390606,392383,1777,10,N,N,-,-1,-1
REOPER.txt,390872,392487,1615,10,Y,N,-,-1,-1
REOPER.txt,390984,392981,1997,10,Y,N,-,-1,-1
REOPER.txt,391106,393144,2038,10,Y,N,-,-1,-1
REOPER.txt,391281,393300,2019,10,Y,N,-,-1,-1
REOPER.txt,391414,393492,2078,10,Y,N,-,-1,-1
REOPER.txt,391645,393703,2058,10,Y,N,-,-1,-1
REOPER.txt,392042,393764,1722,10,N,N,-,-1,-1
REOPER.txt,392241,393972,1731,10,N,N,-,-1,-1
REOPER.txt,392321,394053,1732,10,N,N,-,-1,-1
REOPER.txt,392386,394230,1844,10,N,N,-,-1,-1
REOPER.txt,392488,394492,2004,10,N,N,-,-1,-1
REOPER.txt,392982,394562,1580,10,N,N,-,-1,-1
REOPER.txt,393145,394741,1596,10,N,N,-,-1,-1
REOPER.txt,393301,394947,1646,10,N,N,-,-1,-1
REOPER.txt,393493,395107,1614,10,N,N,-,-1,-1
REOPER.txt,393704,395387,1683,10,N,Y,1437471397525,350644,351290
REOPER.txt,393767,395784,2017,10,Y,Y,1437471397525,350644,351290
REOPER.txt,393975,396047,2072,10,N,Y,1437471397525,350644,351290
REOPER.txt,394054,396104,2050,10,N,Y,1437471397525,350644,351290
REOPER.txt,394231,396221,1990,10,N,Y,1437471397525,350644,351290
REOPER.txt,394493,396351,1858,10,N,Y,1437471397525,350644,351290
REOPER.txt,394563,396614,2051,10,N,Y,1437471397525,350644,351290
REOPER.txt,394742,396659,1917,10,N,Y,1437471397525,350644,351290
REOPER.txt,394948,396702,1754,10,N,Y,1437471397525,350644,351290
REOPER.txt,395108,397046,1938,10,N,Y,1437471397525,350644,351290
REOPER.txt,395390,397141,1751,10,N,Y,1437471397525,350644,351290
REOPER.txt,395785,397257,1472,10,N,Y,1437471397525,350644,351290
REOPER.txt,396048,397412,1364,10,N,Y,1437471397525,350644,351290
REOPER.txt,396107,397561,1454,10,N,Y,1437471397525,350644,351290
REOPER.txt,396222,397708,1486,10,N,Y,1437471397525,350644,351290
REOPER.txt,396352,397829,1477,10,N,Y,1437471397525,350644,351290
REOPER.txt,396615,397948,1333,10,N,Y,1437471397525,350644,351290
REOPER.txt,396660,398008,1348,10,N,Y,1437471397525,350644,351290
REOPER.txt,396703,398081,1378,10,N,Y,1437471397525,350644,351290
REOPER.txt,397047,398200,1153,10,N,Y,1437471397525,350644,351290
REOPER.txt,397142,398366,1224,10,Y,Y,1437471397525,350644,351290
REOPER.txt,397260,398569,1309,10,Y,Y,1437471397525,350644,351290
REOPER.txt,397413,398723,1310,10,Y,Y,1437471397525,350644,351290
REOPER.txt,397562,398786,1224,10,Y,Y,1437471397525,350644,351290
REOPER.txt,397709,399001,1292,10,Y,Y,1437471397525,350644,351290
REOPER.txt,397830,399207,1377,10,Y,Y,1437471397525,350644,351290
REOPER.txt,397949,399430,1481,10,Y,Y,1437471397525,350644,351290
REOPER.txt,398011,399698,1687,10,Y,Y,1437471397525,350644,351290
REOPER.txt,398082,399749,1667,10,Y,Y,1437471397525,350644,351290
REOPER.txt,398201,399785,1584,10,Y,Y,1437471397525,350644,351290
REOPER.txt,398369,399889,1520,10,Y,Y,1437471397525,350644,351290
REOPER.txt,398570,399983,1413,10,Y,Y,1437471397525,350644,351290
REOPER.txt,398723,400234,1511,10,Y,Y,1437471397525,350644,351290
REOPER.txt,398787,400458,1671,10,Y,Y,1437471397525,350644,351290
REOPER.txt,399002,400533,1531,10,N,Y,1437471397525,350644,351290
REOPER.txt,399210,400687,1477,10,N,Y,1437477480340,424837,425856
REOPER.txt,399431,400743,1312,10,N,Y,1437477480340,424837,425856
REOPER.txt,399699,400988,1289,10,Y,Y,1437477480340,424837,425856
REOPER.txt,399754,401150,1396,10,Y,Y,1437477480340,424837,425856
REOPER.txt,399788,401204,1416,10,Y,Y,1437477480340,424837,425856
REOPER.txt,399892,401232,1340,10,Y,Y,1437477480340,424837,425856
REOPER.txt,399984,401270,1286,10,Y,Y,1437477480340,424837,425856
REOPER.txt,400236,401434,1198,10,N,Y,1437477480340,424837,425856
REOPER.txt,400460,401509,1049,10,Y,Y,1437477480340,424837,425856
REOPER.txt,400536,401624,1088,10,Y,Y,1437477480340,424837,425856
REOPER.txt,400688,401705,1017,10,Y,Y,1437477480340,424837,425856
REOPER.txt,400744,401968,1224,10,Y,Y,1437477480340,424837,425856
REOPER.txt,400989,401998,1009,10,N,Y,1437477480340,424837,425856
REOPER.txt,401151,402039,888,10,N,Y,1437477480340,424837,425856
REOPER.txt,401205,402077,872,10,N,Y,1437477480340,424837,425856
REOPER.txt,401233,402259,1026,10,N,Y,1437477480340,424837,425856
REOPER.txt,401271,402414,1143,10,N,Y,1437477480340,424837,425856
REOPER.txt,401435,402502,1067,10,N,Y,1437477480340,424837,425856
REOPER.txt,401510,402547,1037,10,N,Y,1437477480340,424837,425856
REOPER.txt,401625,402671,1046,10,N,Y,1437477480340,424837,425856
REOPER.txt,401706,402976,1270,10,N,Y,1437477480340,424837,425856
REOPER.txt,401969,403136,1167,10,N,Y,1437477480340,424837,425856
REOPER.txt,402000,403331,1331,10,N,Y,1437477480340,424837,425856
REOPER.txt,402040,403422,1382,10,N,Y,1437477480340,424837,425856
REOPER.txt,402080,403435,1355,10,N,N,-,-1,-1
REOPER.txt,402260,403757,1497,10,N,N,-,-1,-1
REOPER.txt,402415,404059,1644,10,N,N,-,-1,-1
REOPER.txt,402503,404188,1685,10,N,N,-,-1,-1
REOPER.txt,402548,404282,1734,10,N,N,-,-1,-1
REOPER.txt,402674,404304,1630,10,N,N,-,-1,-1
REOPER.txt,402977,404632,1655,10,N,N,-,-1,-1
REOPER.txt,403137,404822,1685,10,N,N,-,-1,-1
REOPER.txt,403333,404830,1497,10,N,N,-,-1,-1
REOPER.txt,403425,404930,1505,10,N,N,-,-1,-1
REOPER.txt,403436,404937,1501,10,N,N,-,-1,-1
REOPER.txt,403760,404944,1184,10,N,N,-,-1,-1
REOPER.txt,404060,404967,907,10,N,N,-,-1,-1
REOPER.txt,404191,405010,819,10,N,N,-,-1,-1
REOPER.txt,404283,405122,839,10,N,N,-,-1,-1
REOPER.txt,404305,405179,874,10,N,N,-,-1,-1
REOPER.txt,404635,405230,595,10,N,N,-,-1,-1
REOPER.txt,404825,405638,813,10,N,N,-,-1,-1
REOPER.txt,404831,405812,981,10,N,N,-,-1,-1
REOPER.txt,404932,406029,1097,10,N,N,-,-1,-1
REOPER.txt,404938,406239,1301,10,N,Y,1448038803075,18895,19670
REOPER.txt,404945,406482,1537,10,N,Y,1448038803075,18895,19670
REOPER.txt,404968,406529,1561,10,N,Y,1448038803075,18895,19670
REOPER.txt,405011,406841,1830,10,N,Y,1448038803075,18895,19670
REOPER.txt,405123,406872,1749,10,N,Y,1448038803075,18895,19670
REOPER.txt,405180,406965,1785,10,N,Y,1448038803075,18895,19670
REOPER.txt,405231,407238,2007,10,N,Y,1448038803075,18895,19670
REOPER.txt,405641,407307,1666,10,N,Y,1448038803075,18895,19670
REOPER.txt,405813,407505,1692,10,N,Y,1448038803075,18895,19670
REOPER.txt,406030,407775,1745,10,N,Y,1448038803075,18895,19670
REOPER.txt,406240,407907,1667,10,N,Y,1448038803075,18895,19670
REOPER.txt,406485,408020,1535,10,N,Y,1448325046337,230539,231128
REOPER.txt,406530,408323,1793,10,N,Y,1448325046337,230539,231128
REOPER.txt,406842,408794,1952,10,N,Y,1448325046337,230539,231128
REOPER.txt,406874,408869,1995,10,N,Y,1448325046337,230539,231128
REOPER.txt,406968,409035,2067,10,N,Y,1448325046337,230539,231128
REOPER.txt,407239,409425,2186,10,N,Y,1448325046337,230539,231128
REOPER.txt,407309,409881,2572,10,N,Y,1448325046337,230539,231128
REOPER.txt,407508,410009,2501,10,N,Y,1448325046337,230539,231128
REOPER.txt,407776,410133,2357,10,N,Y,1448325046337,230539,231128
REOPER.txt,407908,410190,2282,10,N,Y,1448325046337,230539,231128
REOPER.txt,408021,410431,2410,10,N,Y,1448325046337,230539,231128
REOPER.txt,408324,410542,2218,10,N,Y,1448325046337,230539,231128
REOPER.txt,408795,410740,1945,10,N,Y,1448325046337,230539,231128
REOPER.txt,408869,410837,1968,10,N,Y,1448325046337,230539,231128
REOPER.txt,409038,410873,1835,10,N,N,-,-1,-1
REOPER.txt,409426,410901,1475,10,N,N,-,-1,-1
REOPER.txt,409882,411053,1171,10,N,N,-,-1,-1
REOPER.txt,410010,411322,1312,10,N,Y,1448314503640,180207,180355
REOPER.txt,410134,411542,1408,10,N,Y,1448314503640,180207,180355
REOPER.txt,410191,411638,1447,10,N,Y,1448038101349,15101,17486
REOPER.txt,410433,411686,1253,10,N,Y,1448038101349,15101,17486
REOPER.txt,410543,411848,1305,10,N,Y,1448038101349,15101,17486
REOPER.txt,410741,411917,1176,10,N,Y,1448038101349,15101,17486
REOPER.txt,410842,412156,1314,10,N,Y,1448038101349,15101,17486
REOPER.txt,410876,412313,1437,10,N,Y,1448038101349,15101,17486
REOPER.txt,410902,412398,1496,10,N,Y,1448038101349,15101,17486
REOPER.txt,411056,412468,1412,10,N,Y,1448038101349,15101,17486
REOPER.txt,411324,412555,1231,10,N,Y,1448038101349,15101,17486
REOPER.txt,411545,412665,1120,10,N,Y,1448038101349,15101,17486
REOPER.txt,411639,412873,1234,10,N,Y,1448038101349,15101,17486
REOPER.txt,411687,412951,1264,10,N,Y,1448038101349,15101,17486
REOPER.txt,411849,413079,1230,10,N,Y,1448038101349,15101,17486
REOPER.txt,411918,413444,1526,10,N,Y,1448038101349,15101,17486
REOPER.txt,412157,413644,1487,10,N,Y,1448280423373,85694,86154
REOPER.txt,412315,413905,1590,10,N,Y,1448280423373,85694,86154
REOPER.txt,412399,413996,1597,10,N,Y,1448280423373,85694,86154
REOPER.txt,412471,414050,1579,10,N,Y,1448280423373,85694,86154
REOPER.txt,412556,414174,1618,10,N,Y,1448280423373,85694,86154
REOPER.txt,412666,414438,1772,10,N,Y,1448280423373,85694,86154
REOPER.txt,412876,414478,1602,10,N,Y,1448280423373,85694,86154
REOPER.txt,412952,414793,1841,10,N,Y,1448280423373,85694,86154
REOPER.txt,413080,414986,1906,10,N,Y,1448280423373,85694,86154
REOPER.txt,413445,415370,1925,10,N,Y,1448280423373,85694,86154
REOPER.txt,413645,415470,1825,10,N,Y,1448280423373,85694,86154
REOPER.txt,413906,415590,1684,10,N,Y,1448280423373,85694,86154
REOPER.txt,413998,415739,1741,10,N,Y,1448280423373,85694,86154
REOPER.txt,414052,415812,1760,10,N,Y,1448280423373,85694,86154
REOPER.txt,414177,416093,1916,10,Y,Y,1448279941918,72406,72905
REOPER.txt,414439,416152,1713,10,N,Y,1448279941918,72406,72905
REOPER.txt,414481,416171,1690,10,N,Y,1448279941918,72406,72905
REOPER.txt,414796,416483,1687,10,N,Y,1448279941918,72406,72905
REOPER.txt,414987,416709,1722,10,N,Y,1448279941918,72406,72905
REOPER.txt,415371,416857,1486,10,Y,Y,1448279941918,72406,72905
REOPER.txt,415475,417056,1581,10,Y,Y,1448279941918,72406,72905
REOPER.txt,415591,417188,1597,10,Y,Y,1448279941918,72406,72905
REOPER.txt,415740,417637,1897,10,Y,Y,1448279941918,72406,72905
REOPER.txt,415815,417949,2134,10,Y,Y,1437028092146,121457,123204
REOPER.txt,416094,418004,1910,10,Y,Y,1437028092146,121457,123204
REOPER.txt,416153,418095,1942,10,Y,Y,1437028092146,121457,123204
REOPER.txt,416172,418638,2466,10,Y,Y,1437028092146,121457,123204
REOPER.txt,416485,419113,2628,10,Y,Y,1437028092146,121457,123204
REOPER.txt,416712,419439,2727,10,Y,Y,1437028092146,121457,123204
REOPER.txt,416858,419583,2725,10,Y,Y,1437028092146,121457,123204
REOPER.txt,417057,419660,2603,10,Y,Y,1437028092146,121457,123204
REOPER.txt,417189,419913,2724,10,Y,Y,1437028092146,121457,123204
REOPER.txt,417638,419994,2356,10,Y,Y,1437028092146,121457,123204
REOPER.txt,417950,420055,2105,10,Y,Y,1437028092146,121457,123204
REOPER.txt,418007,420207,2200,10,Y,Y,1437028092146,121457,123204
REOPER.txt,418096,420376,2280,10,Y,Y,1437028092146,121457,123204
REOPER.txt,418639,420564,1925,10,Y,Y,1437028092146,121457,123204
REOPER.txt,419114,420733,1619,10,N,Y,1448038356234,18463,18881
REOPER.txt,419440,420839,1399,10,N,Y,1448038356234,18463,18881
REOPER.txt,419586,421059,1473,10,N,Y,1448038356234,18463,18881
REOPER.txt,419661,421207,1546,10,N,Y,1448038356234,18463,18881
REOPER.txt,419914,421397,1483,10,N,Y,1448038356234,18463,18881
REOPER.txt,419995,421663,1668,10,N,Y,1448038356234,18463,18881
REOPER.txt,420056,421732,1676,10,N,Y,1448038356234,18463,18881
REOPER.txt,420208,421892,1684,10,N,Y,1448038356234,18463,18881
REOPER.txt,420377,422080,1703,10,N,Y,1448038356234,18463,18881
REOPER.txt,420565,422189,1624,10,N,Y,1448038356234,18463,18881
REOPER.txt,420736,422237,1501,10,N,N,-,-1,-1
REOPER.txt,420840,422752,1912,10,N,N,-,-1,-1
REOPER.txt,421060,423007,1947,10,N,N,-,-1,-1
REOPER.txt,421208,423079,1871,10,N,N,-,-1,-1
REOPER.txt,421398,423186,1788,10,N,N,-,-1,-1
REOPER.txt,421666,423271,1605,10,N,N,-,-1,-1
REOPER.txt,421733,423435,1702,10,N,N,-,-1,-1
REOPER.txt,421894,423649,1755,10,N,N,-,-1,-1
REOPER.txt,422081,423695,1614,10,N,N,-,-1,-1
REOPER.txt,422190,424034,1844,10,N,N,-,-1,-1
REOPER.txt,422238,424320,2082,10,N,N,-,-1,-1
REOPER.txt,422755,424464,1709,10,N,N,-,-1,-1
REOPER.txt,423008,424683,1675,10,N,N,-,-1,-1
REOPER.txt,423080,424792,1712,10,N,N,-,-1,-1
REOPER.txt,423187,424968,1781,10,N,N,-,-1,-1
REOPER.txt,423272,425348,2076,10,N,N,-,-1,-1
REOPER.txt,423436,425383,1947,10,N,N,-,-1,-1
REOPER.txt,423652,425697,2045,10,N,N,-,-1,-1
REOPER.txt,423696,425985,2289,10,Y,N,-,-1,-1
REOPER.txt,424035,426131,2096,10,N,N,-,-1,-1
REOPER.txt,424321,426298,1977,10,N,N,-,-1,-1
REOPER.txt,424466,426510,2044,10,N,N,-,-1,-1
REOPER.txt,424684,426554,1870,10,N,N,-,-1,-1
REOPER.txt,424793,426735,1942,10,N,N,-,-1,-1
REOPER.txt,424971,427044,2073,10,N,N,-,-1,-1
REOPER.txt,425351,427286,1935,10,N,N,-,-1,-1
REOPER.txt,425384,427310,1926,10,N,N,-,-1,-1
REOPER.txt,425698,427534,1836,10,N,N,-,-1,-1
REOPER.txt,425988,427726,1738,10,N,N,-,-1,-1
REOPER.txt,426132,427848,1716,10,N,N,-,-1,-1
REOPER.txt,426298,427962,1664,10,N,N,-,-1,-1
REOPER.txt,426511,428026,1515,10,N,N,-,-1,-1
REOPER.txt,426555,428052,1497,10,N,N,-,-1,-1
REOPER.txt,426736,428339,1603,10,N,N,-,-1,-1
REOPER.txt,427045,428573,1528,10,N,N,-,-1,-1
REOPER.txt,427291,428801,1510,10,N,N,-,-1,-1
REOPER.txt,427311,428813,1502,10,N,N,-,-1,-1
REOPER.txt,427537,429133,1596,10,N,N,-,-1,-1
REOPER.txt,427727,429384,1657,10,N,N,-,-1,-1
REOPER.txt,427849,429595,1746,10,N,N,-,-1,-1
REOPER.txt,427963,429784,1821,10,N,N,-,-1,-1
REOPER.txt,428031,429964,1933,10,N,N,-,-1,-1
REOPER.txt,428055,430342,2287,10,N,N,-,-1,-1
REOPER.txt,428342,430419,2077,10,N,N,-,-1,-1
REOPER.txt,428574,430596,2022,10,N,N,-,-1,-1
REOPER.txt,428802,430610,1808,10,N,N,-,-1,-1
REOPER.txt,428813,430653,1840,10,N,N,-,-1,-1
REOPER.txt,429136,430799,1663,10,N,N,-,-1,-1
REOPER.txt,429385,430835,1450,10,N,N,-,-1,-1
REOPER.txt,429596,431078,1482,10,N,N,-,-1,-1
REOPER.txt,429785,431181,1396,10,N,N,-,-1,-1
REOPER.txt,429965,431326,1361,10,N,N,-,-1,-1
REOPER.txt,430343,431501,1158,10,N,N,-,-1,-1
REOPER.txt,430421,431602,1181,10,N,N,-,-1,-1
REOPER.txt,430597,431673,1076,10,N,N,-,-1,-1
REOPER.txt,430611,431771,1160,10,N,N,-,-1,-1
REOPER.txt,430656,432037,1381,10,N,N,-,-1,-1
REOPER.txt,430800,432242,1442,10,N,N,-,-1,-1
REOPER.txt,430836,432465,1629,10,N,N,-,-1,-1
REOPER.txt,431079,432720,1641,10,N,N,-,-1,-1
REOPER.txt,431184,432977,1793,10,N,N,-,-1,-1
REOPER.txt,431327,433206,1879,10,N,N,-,-1,-1
REOPER.txt,431502,433395,1893,10,N,N,-,-1,-1
REOPER.txt,431603,433511,1908,10,N,N,-,-1,-1
REOPER.txt,431676,433644,1968,10,N,N,-,-1,-1
REOPER.txt,431772,434038,2266,10,N,N,-,-1,-1
REOPER.txt,432038,434106,2068,10,N,N,-,-1,-1
REOPER.txt,432243,434263,2020,10,N,N,-,-1,-1
REOPER.txt,432468,434310,1842,10,N,N,-,-1,-1
REOPER.txt,432721,434465,1744,10,N,N,-,-1,-1
REOPER.txt,432980,434661,1681,10,N,N,-,-1,-1
REOPER.txt,433207,434883,1676,10,N,N,-,-1,-1
REOPER.txt,433396,435029,1633,10,N,N,-,-1,-1
REOPER.txt,433512,435312,1800,10,N,N,-,-1,-1
REOPER.txt,433645,435490,1845,10,N,N,-,-1,-1
REOPER.txt,434039,435737,1698,10,N,N,-,-1,-1
REOPER.txt,434109,435888,1779,10,N,N,-,-1,-1
REOPER.txt,434264,436102,1838,10,N,N,-,-1,-1
REOPER.txt,434311,436322,2011,10,N,N,-,-1,-1
REOPER.txt,434468,436418,1950,10,N,N,-,-1,-1
REOPER.txt,434662,436530,1868,10,N,N,-,-1,-1
REOPER.txt,434884,436783,1899,10,N,N,-,-1,-1
REOPER.txt,435030,436926,1896,10,N,N,-,-1,-1
REOPER.txt,435314,437018,1704,10,N,N,-,-1,-1
REOPER.txt,435491,437399,1908,10,N,N,-,-1,-1
REOPER.txt,435740,437467,1727,10,N,N,-,-1,-1
REOPER.txt,435889,437822,1933,10,N,N,-,-1,-1
REOPER.txt,436105,437987,1882,10,N,N,-,-1,-1
REOPER.txt,436323,438119,1796,10,N,N,-,-1,-1
REOPER.txt,436419,438215,1796,10,N,N,-,-1,-1
REOPER.txt,436531,438296,1765,10,N,N,-,-1,-1
REOPER.txt,436786,438443,1657,10,N,N,-,-1,-1
REOPER.txt,436927,438658,1731,10,N,N,-,-1,-1
REOPER.txt,437019,438787,1768,10,N,N,-,-1,-1
REOPER.txt,437402,439094,1692,10,N,Y,1448280297446,84055,84972
REOPER.txt,437470,439240,1770,10,N,Y,1448280297446,84055,84972
REOPER.txt,437823,439498,1675,10,N,Y,1448280297446,84055,84972
REOPER.txt,437988,439812,1824,10,N,Y,1448280297446,84055,84972
REOPER.txt,438120,439918,1798,10,N,Y,1448280297446,84055,84972
REOPER.txt,438216,440059,1843,10,Y,Y,1448280297446,84055,84972
REOPER.txt,438297,440228,1931,10,Y,Y,1448280297446,84055,84972
REOPER.txt,438444,440382,1938,10,Y,Y,1448280297446,84055,84972
REOPER.txt,438659,440693,2034,10,Y,Y,1448280297446,84055,84972
REOPER.txt,438790,440752,1962,10,Y,Y,1448280297446,84055,84972
REOPER.txt,439096,440817,1721,10,Y,Y,1448280297446,84055,84972
REOPER.txt,439241,440838,1597,10,Y,Y,1448280297446,84055,84972
REOPER.txt,439499,440853,1354,10,Y,Y,1448280297446,84055,84972
REOPER.txt,439815,440874,1059,10,Y,Y,1448280297446,84055,84972
REOPER.txt,439919,441098,1179,10,Y,Y,1448280297446,84055,84972
REOPER.txt,440062,441195,1133,10,N,Y,1448280297446,84055,84972
REOPER.txt,440229,441374,1145,10,N,Y,1448280297446,84055,84972
REOPER.txt,440383,441645,1262,10,N,Y,1448280297446,84055,84972
REOPER.txt,440696,441769,1073,10,N,Y,1448280297446,84055,84972
REOPER.txt,440755,442020,1265,10,N,Y,1448280297446,84055,84972
REOPER.txt,440818,442187,1369,10,N,Y,1448280297446,84055,84972
REOPER.txt,440839,442237,1398,10,N,Y,1448280297446,84055,84972
REOPER.txt,440854,442350,1496,10,N,Y,1448280297446,84055,84972
REOPER.txt,440875,442462,1587,10,N,Y,1448280297446,84055,84972
REOPER.txt,441099,442570,1471,10,N,Y,1448280297446,84055,84972
REOPER.txt,441198,442755,1557,10,N,N,-,-1,-1
REOPER.txt,441377,442824,1447,10,N,N,-,-1,-1
REOPER.txt,441646,442938,1292,10,N,N,-,-1,-1
REOPER.txt,441771,443178,1407,10,N,N,-,-1,-1
REOPER.txt,442021,443201,1180,10,N,N,-,-1,-1
REOPER.txt,442190,443230,1040,10,N,N,-,-1,-1
REOPER.txt,442238,443376,1138,10,N,N,-,-1,-1
REOPER.txt,442351,443417,1066,10,N,N,-,-1,-1
REOPER.txt,442463,443443,980,10,N,N,-,-1,-1
REOPER.txt,442571,443459,888,10,N,N,-,-1,-1
REOPER.txt,442756,443523,767,10,N,N,-,-1,-1
REOPER.txt,442825,443569,744,10,N,N,-,-1,-1
REOPER.txt,442941,443613,672,10,N,N,-,-1,-1
REOPER.txt,443183,443673,490,10,N,N,-,-1,-1
REOPER.txt,443202,443720,518,10,N,N,-,-1,-1
REOPER.txt,443231,443868,637,10,N,N,-,-1,-1
REOPER.txt,443377,443917,540,10,N,N,-,-1,-1
REOPER.txt,443418,443947,529,10,N,N,-,-1,-1
REOPER.txt,443444,444008,564,10,N,N,-,-1,-1
REOPER.txt,443460,444038,578,10,N,N,-,-1,-1
REOPER.txt,443524,444074,550,10,N,N,-,-1,-1
REOPER.txt,443570,444097,527,10,N,N,-,-1,-1
REOPER.txt,443614,444201,587,10,N,N,-,-1,-1
REOPER.txt,443674,444319,645,10,N,N,-,-1,-1
REOPER.txt,443721,444359,638,10,N,N,-,-1,-1
REOPER.txt,443869,444399,530,10,N,N,-,-1,-1
REOPER.txt,443918,444482,564,10,N,N,-,-1,-1
REOPER.txt,443949,444610,661,10,N,N,-,-1,-1
REOPER.txt,444009,444671,662,10,N,N,-,-1,-1
REOPER.txt,444039,444744,705,10,N,N,-,-1,-1
REOPER.txt,444076,444777,701,10,N,N,-,-1,-1
REOPER.txt,444098,444933,835,10,N,N,-,-1,-1
REOPER.txt,444203,444975,772,10,N,N,-,-1,-1
REOPER.txt,444320,445062,742,10,N,N,-,-1,-1
REOPER.txt,444360,445192,832,10,N,N,-,-1,-1
REOPER.txt,444401,445441,1040,10,N,N,-,-1,-1
REOPER.txt,444483,445527,1044,10,N,N,-,-1,-1
REOPER.txt,444611,445646,1035,10,N,N,-,-1,-1
REOPER.txt,444672,445682,1010,10,N,N,-,-1,-1
REOPER.txt,444747,445703,956,10,N,N,-,-1,-1
REOPER.txt,444778,445716,938,10,N,N,-,-1,-1
REOPER.txt,444935,445736,801,10,N,N,-,-1,-1
REOPER.txt,444976,445826,850,10,N,N,-,-1,-1
REOPER.txt,445063,445847,784,10,N,N,-,-1,-1
REOPER.txt,445193,445918,725,10,N,N,-,-1,-1
REOPER.txt,445442,445993,551,10,N,N,-,-1,-1
REOPER.txt,445530,446099,569,10,N,N,-,-1,-1
REOPER.txt,445651,446139,488,10,N,N,-,-1,-1
REOPER.txt,445685,446175,490,10,N,N,-,-1,-1
REOPER.txt,445704,446292,588,10,N,N,-,-1,-1
REOPER.txt,445717,446389,672,10,N,N,-,-1,-1
REOPER.txt,445737,446480,743,10,N,N,-,-1,-1
REOPER.txt,445827,446491,664,10,N,N,-,-1,-1
REOPER.txt,445848,446513,665,10,N,N,-,-1,-1
REOPER.txt,445919,446649,730,10,N,N,-,-1,-1
REOPER.txt,445994,446778,784,10,N,N,-,-1,-1
REOPER.txt,446100,447100,1000,10,N,N,-,-1,-1
REOPER.txt,446140,447239,1099,10,N,N,-,-1,-1
REOPER.txt,446178,447468,1290,10,N,N,-,-1,-1
REOPER.txt,446293,447613,1320,10,N,N,-,-1,-1
REOPER.txt,446390,447697,1307,10,Y,N,-,-1,-1
REOPER.txt,446480,448014,1534,10,Y,N,-,-1,-1
REOPER.txt,446492,448041,1549,10,Y,N,-,-1,-1
REOPER.txt,446514,448654,2140,10,Y,N,-,-1,-1
REOPER.txt,446650,448851,2201,10,Y,N,-,-1,-1
REOPER.txt,446779,449054,2275,10,Y,N,-,-1,-1
REOPER.txt,447103,449489,2386,10,Y,N,-,-1,-1
REOPER.txt,447240,449554,2314,10,Y,N,-,-1,-1
REOPER.txt,447469,449695,2226,10,Y,N,-,-1,-1
REOPER.txt,447616,449806,2190,10,Y,N,-,-1,-1
REOPER.txt,447700,449937,2237,10,Y,N,-,-1,-1
REOPER.txt,448019,450081,2062,10,Y,N,-,-1,-1
REOPER.txt,448044,450285,2241,10,Y,N,-,-1,-1
REOPER.txt,448657,450413,1756,10,Y,Y,1448278279697,58861,59444
REOPER.txt,448852,450572,1720,10,Y,Y,1448278279697,58861,59444
REOPER.txt,449055,450675,1620,10,Y,Y,1448278279697,58861,59444
REOPER.txt,449490,450727,1237,10,Y,Y,1448278279697,58861,59444
REOPER.txt,449557,450891,1334,10,N,Y,1448278279697,58861,59444
REOPER.txt,449696,450970,1274,10,N,Y,1448278279697,58861,59444
REOPER.txt,449807,451141,1334,10,N,Y,1448278279697,58861,59444
REOPER.txt,449938,451198,1260,10,N,Y,1448278279697,58861,59444
REOPER.txt,450082,451660,1578,10,N,Y,1448278279697,58861,59444
REOPER.txt,450288,451890,1602,10,N,Y,1448278279697,58861,59444
REOPER.txt,450414,451956,1542,10,N,Y,1448278279697,58861,59444
REOPER.txt,450573,452213,1640,10,N,Y,1448278279697,58861,59444
REOPER.txt,450677,452249,1572,10,N,Y,1448278279697,58861,59444
REOPER.txt,450728,452344,1616,10,N,Y,1448278279697,58861,59444
REOPER.txt,450892,452470,1578,10,N,Y,1448278279697,58861,59444
REOPER.txt,450971,452617,1646,10,N,Y,1448278279697,58861,59444
REOPER.txt,451142,452783,1641,10,N,Y,1448286451685,111065,112127
REOPER.txt,451199,452905,1706,10,N,Y,1448286451685,111065,112127
REOPER.txt,451662,453006,1344,10,N,Y,1448286451685,111065,112127
REOPER.txt,451893,453050,1157,10,N,Y,1448286451685,111065,112127
REOPER.txt,451957,453265,1308,10,N,Y,1448286451685,111065,112127
REOPER.txt,452214,453374,1160,10,N,Y,1448286451685,111065,112127
REOPER.txt,452250,453402,1152,10,N,Y,1448286451685,111065,112127
REOPER.txt,452345,453415,1070,10,N,Y,1448286451685,111065,112127
REOPER.txt,452471,453533,1062,10,N,Y,1448286451685,111065,112127
REOPER.txt,452618,453618,1000,10,N,Y,1448286451685,111065,112127
REOPER.txt,452784,453671,887,10,N,N,-,-1,-1
REOPER.txt,452906,453739,833,10,N,N,-,-1,-1
REOPER.txt,453006,453870,864,10,N,N,-,-1,-1
REOPER.txt,453051,453977,926,10,N,Y,1448279813455,71525,72226
REOPER.txt,453266,454059,793,10,N,Y,1448279813455,71525,72226
REOPER.txt,453377,454212,835,10,N,Y,1448279813455,71525,72226
REOPER.txt,453402,454337,935,10,N,Y,1448279813455,71525,72226
REOPER.txt,453418,454458,1040,10,N,Y,1448279813455,71525,72226
REOPER.txt,453535,454550,1015,10,N,Y,1448279813455,71525,72226
REOPER.txt,453619,454572,953,10,N,Y,1448279813455,71525,72226
REOPER.txt,453672,454612,940,10,N,Y,1448279813455,71525,72226
REOPER.txt,453740,454694,954,10,N,Y,1448279813455,71525,72226
REOPER.txt,453875,454868,993,10,N,Y,1448279813455,71525,72226
REOPER.txt,453978,455151,1173,10,N,Y,1448279813455,71525,72226
REOPER.txt,454060,455262,1202,10,N,Y,1448279813455,71525,72226
REOPER.txt,454212,455361,1149,10,N,Y,1448279813455,71525,72226
REOPER.txt,454338,455458,1120,10,N,Y,1448279813455,71525,72226
REOPER.txt,454459,455697,1238,10,N,Y,1448279813455,71525,72226
REOPER.txt,454551,455801,1250,10,N,Y,1448279813455,71525,72226
REOPER.txt,454573,455938,1365,10,N,Y,1448279813455,71525,72226
REOPER.txt,454613,456109,1496,10,N,Y,1448279813455,71525,72226
REOPER.txt,454696,456267,1571,10,N,Y,1437475017618,98942,100041
REOPER.txt,454869,456688,1819,10,N,Y,1437475017618,98942,100041
REOPER.txt,455152,456868,1716,10,N,Y,1437475017618,98942,100041
REOPER.txt,455263,457045,1782,10,Y,Y,1437475017618,98942,100041
REOPER.txt,455362,457140,1778,10,Y,Y,1437475017618,98942,100041
REOPER.txt,455459,457195,1736,10,Y,Y,1437475017618,98942,100041
REOPER.txt,455698,457227,1529,10,Y,Y,1437475017618,98942,100041
REOPER.txt,455802,457443,1641,10,N,Y,1437475017618,98942,100041
REOPER.txt,455939,457663,1724,10,Y,Y,1437475017618,98942,100041
REOPER.txt,456112,457713,1601,10,Y,Y,1437475017618,98942,100041
REOPER.txt,456268,457748,1480,10,Y,Y,1437475017618,98942,100041
REOPER.txt,456689,457807,1118,10,N,Y,1437475017618,98942,100041
REOPER.txt,456869,457841,972,10,N,Y,1437475017618,98942,100041
REOPER.txt,457048,458062,1014,10,N,Y,1437475017618,98942,100041
REOPER.txt,457143,458262,1119,10,Y,Y,1437475017618,98942,100041
REOPER.txt,457197,458523,1326,10,Y,Y,1437475017618,98942,100041
REOPER.txt,457228,458735,1507,10,Y,Y,1437475017618,98942,100041
REOPER.txt,457444,458826,1382,10,N,Y,1437475017618,98942,100041
REOPER.txt,457664,458979,1315,10,N,Y,1437475017618,98942,100041
REOPER.txt,457714,459208,1494,10,N,Y,1437475017618,98942,100041
REOPER.txt,457750,459378,1628,10,N,Y,1437475017618,98942,100041
REOPER.txt,457808,459799,1991,10,N,Y,1437475017618,98942,100041
REOPER.txt,457842,459974,2132,10,N,Y,1437475017618,98942,100041
REOPER.txt,458063,460135,2072,10,N,Y,1437475017618,98942,100041
REOPER.txt,458263,460531,2268,10,N,Y,1448287490368,120754,123385
REOPER.txt,458524,460591,2067,10,N,Y,1448287490368,120754,123385
REOPER.txt,458738,460843,2105,10,N,Y,1448287490368,120754,123385
REOPER.txt,458827,460941,2114,10,N,Y,1448287490368,120754,123385
REOPER.txt,458980,461140,2160,10,N,Y,1448287490368,120754,123385
REOPER.txt,459209,461204,1995,10,N,Y,1448287490368,120754,123385
REOPER.txt,459379,461493,2114,10,N,Y,1448287490368,120754,123385
REOPER.txt,459800,461694,1894,10,N,Y,1448287490368,120754,123385
REOPER.txt,459977,461774,1797,10,N,Y,1448287490368,120754,123385
REOPER.txt,460137,461853,1716,10,N,Y,1448287490368,120754,123385
REOPER.txt,460532,462024,1492,10,N,Y,1448287490368,120754,123385
REOPER.txt,460592,462358,1766,10,N,Y,1448287490368,120754,123385
REOPER.txt,460844,462576,1732,10,N,Y,1448315360596,182069,182233
REOPER.txt,460942,462648,1706,10,N,Y,1448315360596,182069,182233
REOPER.txt,461141,462740,1599,10,N,Y,1448315360596,182069,182233
REOPER.txt,461205,463216,2011,10,N,Y,1448315360596,182069,182233
REOPER.txt,461496,463296,1800,10,N,Y,1448315360596,182069,182233
REOPER.txt,461695,463399,1704,10,N,Y,1448315360596,182069,182233
REOPER.txt,461776,463845,2069,10,N,Y,1448315360596,182069,182233
REOPER.txt,461854,463879,2025,10,N,Y,1448315360596,182069,182233
REOPER.txt,462025,464008,1983,10,N,Y,1448315360596,182069,182233
REOPER.txt,462359,464236,1877,10,N,Y,1448315360596,182069,182233
REOPER.txt,462577,464272,1695,10,N,Y,1448315360596,182069,182233
REOPER.txt,462649,464516,1867,10,N,Y,1448315360596,182069,182233
REOPER.txt,462741,464617,1876,10,N,Y,1448315360596,182069,182233
REOPER.txt,463217,464989,1772,10,N,Y,1448315360596,182069,182233
REOPER.txt,463299,465145,1846,10,N,N,-,-1,-1
REOPER.txt,463400,465663,2263,10,N,N,-,-1,-1
REOPER.txt,463846,465736,1890,10,N,N,-,-1,-1
REOPER.txt,463880,465837,1957,10,N,N,-,-1,-1
REOPER.txt,464009,466096,2087,10,N,N,-,-1,-1
REOPER.txt,464241,466126,1885,10,N,N,-,-1,-1
REOPER.txt,464275,466217,1942,10,N,N,-,-1,-1
REOPER.txt,464517,466413,1896,10,N,N,-,-1,-1
REOPER.txt,464620,466457,1837,10,N,N,-,-1,-1
REOPER.txt,464990,466622,1632,10,N,N,-,-1,-1
REOPER.txt,465146,466983,1837,10,N,N,-,-1,-1
REOPER.txt,465664,467314,1650,10,N,N,-,-1,-1
REOPER.txt,465738,467451,1713,10,N,N,-,-1,-1
REOPER.txt,465839,467644,1805,10,N,N,-,-1,-1
REOPER.txt,466097,467740,1643,10,N,N,-,-1,-1
REOPER.txt,466127,467868,1741,10,N,N,-,-1,-1
REOPER.txt,466218,467906,1688,10,N,N,-,-1,-1
REOPER.txt,466414,467930,1516,10,N,N,-,-1,-1
REOPER.txt,466458,468031,1573,10,N,N,-,-1,-1
REOPER.txt,466623,468096,1473,10,N,N,-,-1,-1
REOPER.txt,466984,468290,1306,10,N,N,-,-1,-1
REOPER.txt,467317,468414,1097,10,N,N,-,-1,-1
REOPER.txt,467452,468521,1069,10,N,N,-,-1,-1
REOPER.txt,467645,468609,964,10,N,N,-,-1,-1
REOPER.txt,467741,468706,965,10,N,N,-,-1,-1
REOPER.txt,467873,468860,987,10,N,N,-,-1,-1
REOPER.txt,467909,468953,1044,10,N,N,-,-1,-1
REOPER.txt,467931,469102,1171,10,N,N,-,-1,-1
REOPER.txt,468032,469274,1242,10,N,N,-,-1,-1
REOPER.txt,468097,469455,1358,10,N,N,-,-1,-1
REOPER.txt,468292,469546,1254,10,N,N,-,-1,-1
REOPER.txt,468415,469588,1173,10,N,N,-,-1,-1
REOPER.txt,468523,469711,1188,10,N,N,-,-1,-1
REOPER.txt,468610,469744,1134,10,N,N,-,-1,-1
REOPER.txt,468707,469899,1192,10,N,N,-,-1,-1
REOPER.txt,468861,470128,1267,10,N,N,-,-1,-1
REOPER.txt,468955,470197,1242,10,N,N,-,-1,-1
REOPER.txt,469105,470262,1157,10,N,N,-,-1,-1
REOPER.txt,469276,470546,1270,10,N,N,-,-1,-1
REOPER.txt,469458,470619,1161,10,N,N,-,-1,-1
REOPER.txt,469547,470702,1155,10,N,N,-,-1,-1
REOPER.txt,469589,470941,1352,10,N,N,-,-1,-1
REOPER.txt,469712,471278,1566,10,N,N,-,-1,-1
REOPER.txt,469745,471388,1643,10,N,N,-,-1,-1
REOPER.txt,469900,471475,1575,10,N,N,-,-1,-1
REOPER.txt,470129,471575,1446,10,N,N,-,-1,-1
REOPER.txt,470198,471658,1460,10,N,N,-,-1,-1
REOPER.txt,470264,471860,1596,10,N,N,-,-1,-1
REOPER.txt,470547,471963,1416,10,N,N,-,-1,-1
REOPER.txt,470620,472032,1412,10,N,N,-,-1,-1
REOPER.txt,470704,472271,1567,10,N,N,-,-1,-1
REOPER.txt,470942,472399,1457,10,N,N,-,-1,-1
REOPER.txt,471279,472719,1440,10,N,N,-,-1,-1
REOPER.txt,471389,472744,1355,10,N,N,-,-1,-1
REOPER.txt,471477,473175,1698,10,N,N,-,-1,-1
REOPER.txt,471578,473255,1677,10,N,N,-,-1,-1
REOPER.txt,471661,473368,1707,10,N,N,-,-1,-1
REOPER.txt,471861,473491,1630,10,N,N,-,-1,-1
REOPER.txt,471964,473525,1561,10,N,N,-,-1,-1
REOPER.txt,472033,473661,1628,10,N,N,-,-1,-1
REOPER.txt,472272,473736,1464,10,N,N,-,-1,-1
REOPER.txt,472402,473928,1526,10,N,Y,1448274893770,25386,26202
REOPER.txt,472720,474017,1297,10,N,Y,1448274893770,25386,26202
REOPER.txt,472745,474192,1447,10,N,Y,1448274893770,25386,26202
REOPER.txt,473178,474251,1073,10,N,Y,1448274893770,25386,26202
REOPER.txt,473256,474388,1132,10,N,Y,1448274893770,25386,26202
REOPER.txt,473369,474571,1202,10,N,Y,1448274893770,25386,26202
REOPER.txt,473492,474724,1232,10,N,Y,1448274893770,25386,26202
REOPER.txt,473526,474753,1227,10,N,Y,1448274893770,25386,26202
REOPER.txt,473662,474823,1161,10,N,Y,1448274893770,25386,26202
REOPER.txt,473739,475077,1338,10,N,Y,1448274893770,25386,26202
REOPER.txt,473929,475195,1266,10,N,Y,1448274893770,25386,26202
REOPER.txt,474018,475288,1270,10,N,Y,1448274893770,25386,26202
REOPER.txt,474193,475425,1232,10,N,Y,1448274893770,25386,26202
REOPER.txt,474252,475543,1291,10,N,Y,1448274893770,25386,26202
REOPER.txt,474389,475587,1198,10,N,Y,1448274893770,25386,26202
REOPER.txt,474572,475634,1062,10,N,Y,1448274893770,25386,26202
REOPER.txt,474726,475777,1051,10,N,Y,1448274893770,25386,26202
REOPER.txt,474754,475828,1074,10,N,Y,1448274893770,25386,26202
REOPER.txt,474826,475885,1059,10,N,Y,1448274893770,25386,26202
REOPER.txt,475078,476042,964,10,N,Y,1448274893770,25386,26202
REOPER.txt,475198,476167,969,10,N,Y,1448274893770,25386,26202
REOPER.txt,475289,476258,969,10,N,Y,1448274893770,25386,26202
REOPER.txt,475426,476424,998,10,N,Y,1448274893770,25386,26202
REOPER.txt,475544,476551,1007,10,N,Y,1448274893770,25386,26202
REOPER.txt,475588,476587,999,10,N,Y,1448274893770,25386,26202
REOPER.txt,475637,476846,1209,10,Y,Y,1448274893770,25386,26202
REOPER.txt,475778,476946,1168,10,N,Y,1448274893770,25386,26202
REOPER.txt,475829,476973,1144,10,N,Y,1448274893770,25386,26202
REOPER.txt,475886,477142,1256,10,N,Y,1448274893770,25386,26202
REOPER.txt,476043,477256,1213,10,N,Y,1448274893770,25386,26202
REOPER.txt,476168,477323,1155,10,N,Y,1448274893770,25386,26202
REOPER.txt,476259,477514,1255,10,N,Y,1448274893770,25386,26202
REOPER.txt,476425,477579,1154,10,N,Y,1448274893770,25386,26202
REOPER.txt,476552,477614,1062,10,N,Y,1448274893770,25386,26202
REOPER.txt,476588,477744,1156,10,N,Y,1448274893770,25386,26202
REOPER.txt,476847,477839,992,10,N,Y,1448274893770,25386,26202
REOPER.txt,476947,477974,1027,10,N,Y,1448274893770,25386,26202
REOPER.txt,476974,478055,1081,10,N,Y,1448274893770,25386,26202
REOPER.txt,477143,478275,1132,10,N,Y,1448274893770,25386,26202
REOPER.txt,477257,478384,1127,10,N,Y,1448274893770,25386,26202
REOPER.txt,477324,478500,1176,10,N,Y,1448274893770,25386,26202
REOPER.txt,477517,478786,1269,10,N,Y,1448311811907,157566,161100
REOPER.txt,477580,478826,1246,10,N,Y,1448311811907,157566,161100
REOPER.txt,477615,478930,1315,10,N,Y,1448311811907,157566,161100
REOPER.txt,477745,479053,1308,10,N,Y,1448311811907,157566,161100
REOPER.txt,477840,479155,1315,10,N,Y,1448311811907,157566,161100
REOPER.txt,477975,479466,1491,10,N,Y,1448311811907,157566,161100
REOPER.txt,478056,479705,1649,10,N,Y,1448311811907,157566,161100
REOPER.txt,478276,479814,1538,10,Y,Y,1448311811907,157566,161100
REOPER.txt,478385,480083,1698,10,Y,Y,1448311811907,157566,161100
REOPER.txt,478501,480092,1591,10,Y,Y,1448311811907,157566,161100
REOPER.txt,478787,480127,1340,10,Y,Y,1448311811907,157566,161100
REOPER.txt,478829,480385,1556,10,Y,Y,1448311811907,157566,161100
REOPER.txt,478933,480477,1544,10,Y,Y,1448322273366,219239,219544
REOPER.txt,479054,480572,1518,10,Y,Y,1448322273366,219239,219544
REOPER.txt,479156,480630,1474,10,Y,Y,1448322273366,219239,219544
REOPER.txt,479469,480766,1297,10,Y,Y,1448322273366,219239,219544
REOPER.txt,479706,480827,1121,10,Y,Y,1448322273366,219239,219544
REOPER.txt,479815,480955,1140,10,N,Y,1448322273366,219239,219544
REOPER.txt,480084,481075,991,10,N,Y,1448322273366,219239,219544
REOPER.txt,480093,481159,1066,10,N,Y,1448322273366,219239,219544
REOPER.txt,480130,481261,1131,10,N,Y,1448322273366,219239,219544
REOPER.txt,480386,481414,1028,10,N,Y,1448322273366,219239,219544
REOPER.txt,480478,481577,1099,10,N,Y,1448322273366,219239,219544
REOPER.txt,480573,481676,1103,10,N,Y,1448322273366,219239,219544
REOPER.txt,480631,481778,1147,10,N,Y,1448322273366,219239,219544
REOPER.txt,480767,481886,1119,10,N,N,-,-1,-1
REOPER.txt,480828,481978,1150,10,N,N,-,-1,-1
REOPER.txt,480956,482056,1100,10,N,N,-,-1,-1
REOPER.txt,481076,482188,1112,10,N,N,-,-1,-1
REOPER.txt,481162,482220,1058,10,N,N,-,-1,-1
REOPER.txt,481262,482316,1054,10,N,N,-,-1,-1
REOPER.txt,481415,482405,990,10,N,N,-,-1,-1
REOPER.txt,481578,482413,835,10,N,N,-,-1,-1
REOPER.txt,481677,482590,913,10,N,N,-,-1,-1
REOPER.txt,481779,482669,890,10,N,N,-,-1,-1
REOPER.txt,481887,482722,835,10,N,N,-,-1,-1
REOPER.txt,481979,482738,759,10,N,N,-,-1,-1
REOPER.txt,482057,482991,934,10,N,N,-,-1,-1
REOPER.txt,482190,483094,904,10,N,N,-,-1,-1
REOPER.txt,482221,483301,1080,10,N,N,-,-1,-1
REOPER.txt,482319,483427,1108,10,N,N,-,-1,-1
REOPER.txt,482408,483708,1300,10,N,N,-,-1,-1
REOPER.txt,482414,483908,1494,10,N,N,-,-1,-1
REOPER.txt,482591,483953,1362,10,N,N,-,-1,-1
REOPER.txt,482670,484141,1471,10,N,N,-,-1,-1
REOPER.txt,482722,484242,1520,10,N,N,-,-1,-1
REOPER.txt,482739,484369,1630,10,N,N,-,-1,-1
REOPER.txt,482992,484504,1512,10,N,N,-,-1,-1
REOPER.txt,483095,484774,1679,10,N,N,-,-1,-1
REOPER.txt,483302,484864,1562,10,N,N,-,-1,-1
REOPER.txt,483428,484979,1551,10,N,N,-,-1,-1
REOPER.txt,483709,485092,1383,10,N,N,-,-1,-1
REOPER.txt,483910,485266,1356,10,N,N,-,-1,-1
REOPER.txt,483954,485357,1403,10,N,N,-,-1,-1
REOPER.txt,484142,485457,1315,10,N,N,-,-1,-1
REOPER.txt,484247,485574,1327,10,N,N,-,-1,-1
REOPER.txt,484372,485756,1384,10,N,N,-,-1,-1
REOPER.txt,484505,486054,1549,10,N,N,-,-1,-1
REOPER.txt,484775,486114,1339,10,N,N,-,-1,-1
REOPER.txt,484865,486687,1822,10,N,N,-,-1,-1
REOPER.txt,484980,486695,1715,10,N,N,-,-1,-1
REOPER.txt,485094,486785,1691,10,N,N,-,-1,-1
REOPER.txt,485269,486952,1683,10,N,N,-,-1,-1
REOPER.txt,485358,487211,1853,10,N,N,-,-1,-1
REOPER.txt,485458,487256,1798,10,N,N,-,-1,-1
REOPER.txt,485576,487334,1758,10,N,N,-,-1,-1
REOPER.txt,485757,487517,1760,10,N,N,-,-1,-1
REOPER.txt,486055,487542,1487,10,N,N,-,-1,-1
REOPER.txt,486117,488137,2020,10,N,N,-,-1,-1
REOPER.txt,486688,488344,1656,10,N,N,-,-1,-1
REOPER.txt,486698,488444,1746,10,N,N,-,-1,-1
REOPER.txt,486786,488619,1833,10,N,N,-,-1,-1
REOPER.txt,486953,488891,1938,10,N,N,-,-1,-1
REOPER.txt,487212,489049,1837,10,N,N,-,-1,-1
REOPER.txt,487257,489057,1800,10,N,N,-,-1,-1
REOPER.txt,487335,489180,1845,10,N,N,-,-1,-1
REOPER.txt,487522,489307,1785,10,N,N,-,-1,-1
REOPER.txt,487545,489366,1821,10,N,N,-,-1,-1
REOPER.txt,488140,489510,1370,10,N,N,-,-1,-1
REOPER.txt,488345,489637,1292,10,N,N,-,-1,-1
REOPER.txt,488445,489815,1370,10,N,N,-,-1,-1
REOPER.txt,488620,490247,1627,10,N,N,-,-1,-1
REOPER.txt,488892,490327,1435,10,N,N,-,-1,-1
REOPER.txt,489052,490394,1342,10,N,N,-,-1,-1
REOPER.txt,489058,490517,1459,10,N,N,-,-1,-1
REOPER.txt,489181,490583,1402,10,N,N,-,-1,-1
REOPER.txt,489308,490661,1353,10,N,N,-,-1,-1
REOPER.txt,489368,490713,1345,10,N,N,-,-1,-1
REOPER.txt,489511,490827,1316,10,N,N,-,-1,-1
REOPER.txt,489639,490857,1218,10,N,N,-,-1,-1
REOPER.txt,489818,491126,1308,10,N,N,-,-1,-1
REOPER.txt,490248,491270,1022,10,N,N,-,-1,-1
REOPER.txt,490328,491540,1212,10,N,N,-,-1,-1
REOPER.txt,490395,491610,1215,10,N,N,-,-1,-1
REOPER.txt,490518,492085,1567,10,N,N,-,-1,-1
REOPER.txt,490584,492264,1680,10,N,N,-,-1,-1
REOPER.txt,490662,492337,1675,10,N,N,-,-1,-1
REOPER.txt,490714,492453,1739,10,N,N,-,-1,-1
REOPER.txt,490828,492851,2023,10,N,N,-,-1,-1
REOPER.txt,490858,492969,2111,10,N,N,-,-1,-1
REOPER.txt,491127,493013,1886,10,N,N,-,-1,-1
REOPER.txt,491273,493105,1832,10,N,N,-,-1,-1
REOPER.txt,491543,493340,1797,10,N,N,-,-1,-1
REOPER.txt,491611,493538,1927,10,N,N,-,-1,-1
REOPER.txt,492088,493735,1647,10,N,N,-,-1,-1
REOPER.txt,492265,494006,1741,10,N,N,-,-1,-1
REOPER.txt,492338,494311,1973,10,N,N,-,-1,-1
REOPER.txt,492454,494523,2069,10,N,N,-,-1,-1
REOPER.txt,492852,494745,1893,10,N,N,-,-1,-1
REOPER.txt,492970,494957,1987,10,N,N,-,-1,-1
REOPER.txt,493016,495261,2245,10,N,N,-,-1,-1
REOPER.txt,493106,495507,2401,10,N,N,-,-1,-1
REOPER.txt,493343,495598,2255,10,N,N,-,-1,-1
REOPER.txt,493539,495882,2343,10,N,N,-,-1,-1
REOPER.txt,493736,496127,2391,10,N,N,-,-1,-1
REOPER.txt,494007,496370,2363,10,N,N,-,-1,-1
REOPER.txt,494312,496863,2551,10,N,N,-,-1,-1
REOPER.txt,494524,497121,2597,10,N,N,-,-1,-1
REOPER.txt,494746,497269,2523,10,N,N,-,-1,-1
REOPER.txt,494960,497557,2597,10,N,N,-,-1,-1
REOPER.txt,495262,497611,2349,10,N,N,-,-1,-1
REOPER.txt,495508,497872,2364,10,N,N,-,-1,-1
REOPER.txt,495599,497875,2276,10,Y,N,-,-1,-1
REOPER.txt,495883,497970,2087,10,Y,N,-,-1,-1
REOPER.txt,496128,498042,1914,10,N,N,-,-1,-1
REOPER.txt,496373,498080,1707,10,N,N,-,-1,-1
REOPER.txt,496864,498230,1366,10,N,N,-,-1,-1
REOPER.txt,497124,498335,1211,10,N,N,-,-1,-1
REOPER.txt,497270,498651,1381,10,N,N,-,-1,-1
REOPER.txt,497558,498785,1227,10,N,N,-,-1,-1
REOPER.txt,497612,498978,1366,10,N,N,-,-1,-1
REOPER.txt,497872,499150,1278,10,N,N,-,-1,-1
REOPER.txt,497875,499235,1360,10,N,N,-,-1,-1
REOPER.txt,497973,499375,1402,10,N,N,-,-1,-1
REOPER.txt,498043,499640,1597,10,N,N,-,-1,-1
REOPER.txt,498082,499714,1632,10,N,N,-,-1,-1
REOPER.txt,498231,499805,1574,10,N,N,-,-1,-1
REOPER.txt,498336,499918,1582,10,N,N,-,-1,-1
REOPER.txt,498652,500124,1472,10,N,N,-,-1,-1
REOPER.txt,498786,500202,1416,10,N,N,-,-1,-1
REOPER.txt,498981,500237,1256,10,N,N,-,-1,-1
REOPER.txt,499152,500322,1170,10,N,N,-,-1,-1
REOPER.txt,499236,500459,1223,10,N,N,-,-1,-1
REOPER.txt,499377,500669,1292,10,N,N,-,-1,-1
REOPER.txt,499643,501011,1368,10,N,N,-,-1,-1
REOPER.txt,499715,501175,1460,10,N,N,-,-1,-1
REOPER.txt,499807,501305,1498,10,N,N,-,-1,-1
REOPER.txt,499920,501694,1774,10,N,N,-,-1,-1
REOPER.txt,500127,501965,1838,10,N,N,-,-1,-1
REOPER.txt,500203,502082,1879,10,N,N,-,-1,-1
REOPER.txt,500238,502138,1900,10,N,N,-,-1,-1
REOPER.txt,500323,502287,1964,10,N,N,-,-1,-1
REOPER.txt,500460,502315,1855,10,N,N,-,-1,-1
REOPER.txt,500670,502481,1811,10,N,N,-,-1,-1
REOPER.txt,501012,502589,1577,10,N,N,-,-1,-1
REOPER.txt,501176,502827,1651,10,N,N,-,-1,-1
REOPER.txt,501308,502888,1580,10,N,N,-,-1,-1
REOPER.txt,501695,503195,1500,10,N,N,-,-1,-1
REOPER.txt,501966,503364,1398,10,N,N,-,-1,-1
REOPER.txt,502084,503584,1500,10,N,N,-,-1,-1
REOPER.txt,502139,503816,1677,10,N,N,-,-1,-1
REOPER.txt,502288,503871,1583,10,N,N,-,-1,-1
REOPER.txt,502316,504117,1801,10,N,N,-,-1,-1
REOPER.txt,502482,504138,1656,10,N,N,-,-1,-1
REOPER.txt,502590,504323,1733,10,N,N,-,-1,-1
REOPER.txt,502828,504395,1567,10,N,N,-,-1,-1
REOPER.txt,502889,504595,1706,10,N,N,-,-1,-1
REOPER.txt,503197,504842,1645,10,N,N,-,-1,-1
REOPER.txt,503365,505405,2040,10,N,N,-,-1,-1
REOPER.txt,503585,505655,2070,10,Y,Y,1448039370049,20775,21297
REOPER.txt,503817,505726,1909,10,N,Y,1448039370049,20775,21297
REOPER.txt,503874,506035,2161,10,Y,Y,1448039370049,20775,21297
REOPER.txt,504118,506154,2036,10,Y,Y,1448039370049,20775,21297
REOPER.txt,504141,506260,2119,10,Y,Y,1448039370049,20775,21297
REOPER.txt,504324,506371,2047,10,Y,Y,1448039370049,20775,21297
REOPER.txt,504396,506568,2172,10,Y,Y,1448039370049,20775,21297
REOPER.txt,504596,506801,2205,10,Y,Y,1448039370049,20775,21297
REOPER.txt,504843,506929,2086,10,Y,Y,1448039370049,20775,21297
REOPER.txt,505408,507178,1770,10,Y,Y,1448039370049,20775,21297
REOPER.txt,505656,507237,1581,10,N,Y,1448039370049,20775,21297
REOPER.txt,505727,507545,1818,10,Y,Y,1448039370049,20775,21297
REOPER.txt,506036,507585,1549,10,Y,Y,1448039370049,20775,21297
REOPER.txt,506157,508075,1918,10,Y,Y,1448039370049,20775,21297
REOPER.txt,506261,508155,1894,10,Y,Y,1448039370049,20775,21297
REOPER.txt,506372,508357,1985,10,Y,Y,1448039370049,20775,21297
REOPER.txt,506569,508459,1890,10,Y,Y,1448039370049,20775,21297
REOPER.txt,506802,508618,1816,10,Y,Y,1448039370049,20775,21297
REOPER.txt,506930,508646,1716,10,Y,Y,1448039370049,20775,21297
REOPER.txt,507179,508846,1667,10,Y,Y,1448039370049,20775,21297
REOPER.txt,507238,508992,1754,10,Y,Y,1448039370049,20775,21297
REOPER.txt,507550,509151,1601,10,Y,Y,1448277167610,40886,47737
REOPER.txt,507586,509397,1811,10,Y,Y,1448277167610,40886,47737
REOPER.txt,508076,509589,1513,10,Y,Y,1448277167610,40886,47737
REOPER.txt,508156,509694,1538,10,Y,Y,1448277167610,40886,47737
REOPER.txt,508360,509807,1447,10,N,Y,1448277167610,40886,47737
REOPER.txt,508461,509978,1517,10,N,Y,1448277167610,40886,47737
REOPER.txt,508619,510338,1719,10,N,Y,1448277167610,40886,47737
REOPER.txt,508647,510527,1880,10,N,Y,1448277167610,40886,47737
REOPER.txt,508847,510572,1725,10,N,Y,1448277167610,40886,47737
REOPER.txt,508993,510609,1616,10,N,Y,1448277167610,40886,47737
REOPER.txt,509154,510756,1602,10,N,Y,1448310549245,137491,141408
REOPER.txt,509398,510863,1465,10,N,Y,1448310549245,137491,141408
REOPER.txt,509590,510958,1368,10,N,Y,1448310549245,137491,141408
REOPER.txt,509695,511114,1419,10,N,Y,1448310549245,137491,141408
REOPER.txt,509810,511182,1372,10,N,Y,1448310549245,137491,141408
REOPER.txt,509980,511222,1242,10,N,Y,1448310549245,137491,141408
REOPER.txt,510339,511320,981,10,N,Y,1448310549245,137491,141408
REOPER.txt,510530,511446,916,10,N,Y,1448310549245,137491,141408
REOPER.txt,510573,511511,938,10,N,Y,1448310549245,137491,141408
REOPER.txt,510610,511743,1133,10,N,Y,1448310549245,137491,141408
REOPER.txt,510757,511865,1108,10,N,Y,1448310549245,137491,141408
REOPER.txt,510864,512069,1205,10,N,Y,1448310549245,137491,141408
REOPER.txt,510960,512225,1265,10,N,Y,1448310549245,137491,141408
REOPER.txt,511115,512368,1253,10,N,Y,1448310549245,137491,141408
REOPER.txt,511185,512521,1336,10,N,Y,1448310549245,137491,141408
REOPER.txt,511225,512644,1419,10,N,Y,1448310549245,137491,141408
REOPER.txt,511321,512926,1605,10,N,Y,1448310549245,137491,141408
REOPER.txt,511447,512972,1525,10,N,Y,1448312844411,173573,174472
REOPER.txt,511512,513030,1518,10,N,Y,1448312844411,173573,174472
REOPER.txt,511744,513116,1372,10,N,Y,1448312844411,173573,174472
REOPER.txt,511867,513367,1500,10,Y,Y,1448312844411,173573,174472
REOPER.txt,512070,513541,1471,10,Y,Y,1448312844411,173573,174472
REOPER.txt,512226,513599,1373,10,Y,Y,1448312844411,173573,174472
REOPER.txt,512369,513889,1520,10,Y,Y,1448312844411,173573,174472
REOPER.txt,512524,513980,1456,10,Y,Y,1448312844411,173573,174472
REOPER.txt,512645,514116,1471,10,N,Y,1448312844411,173573,174472
REOPER.txt,512927,514303,1376,10,Y,Y,1448312844411,173573,174472
REOPER.txt,512973,514562,1589,10,Y,Y,1448312844411,173573,174472
REOPER.txt,513032,514721,1689,10,Y,Y,1448312844411,173573,174472
REOPER.txt,513117,514768,1651,10,Y,Y,1448312844411,173573,174472
REOPER.txt,513368,514840,1472,10,Y,Y,1448312844411,173573,174472
REOPER.txt,513544,514931,1387,10,N,Y,1448312844411,173573,174472
REOPER.txt,513600,514983,1383,10,N,Y,1448312844411,173573,174472
REOPER.txt,513890,515120,1230,10,N,Y,1448312844411,173573,174472
REOPER.txt,513981,515513,1532,10,N,Y,1448312844411,173573,174472
REOPER.txt,514119,515641,1522,10,N,N,-,-1,-1
REOPER.txt,514304,515828,1524,10,N,N,-,-1,-1
REOPER.txt,514564,516024,1460,10,N,N,-,-1,-1
REOPER.txt,514722,516105,1383,10,N,N,-,-1,-1
REOPER.txt,514771,516289,1518,10,N,N,-,-1,-1
REOPER.txt,514843,516497,1654,10,N,N,-,-1,-1
REOPER.txt,514932,516664,1732,10,Y,N,-,-1,-1
REOPER.txt,514984,516858,1874,10,N,N,-,-1,-1
REOPER.txt,515123,517102,1979,10,N,N,-,-1,-1
REOPER.txt,515514,517151,1637,10,N,N,-,-1,-1
REOPER.txt,515644,517378,1734,10,N,N,-,-1,-1
REOPER.txt,515829,517449,1620,10,N,N,-,-1,-1
REOPER.txt,516026,517544,1518,10,N,N,-,-1,-1
REOPER.txt,516106,517844,1738,10,N,N,-,-1,-1
REOPER.txt,516292,518057,1765,10,N,N,-,-1,-1
REOPER.txt,516498,518128,1630,10,N,N,-,-1,-1
REOPER.txt,516665,518333,1668,10,N,N,-,-1,-1
REOPER.txt,516859,518341,1482,10,N,N,-,-1,-1
REOPER.txt,517103,518619,1516,10,N,N,-,-1,-1
REOPER.txt,517152,518740,1588,10,N,N,-,-1,-1
REOPER.txt,517379,518926,1547,10,N,N,-,-1,-1
REOPER.txt,517450,519017,1567,10,N,N,-,-1,-1
REOPER.txt,517545,519512,1967,10,N,N,-,-1,-1
REOPER.txt,517845,519783,1938,10,N,N,-,-1,-1
REOPER.txt,518058,519978,1920,10,N,N,-,-1,-1
REOPER.txt,518130,520069,1939,10,N,N,-,-1,-1
REOPER.txt,518336,520114,1778,10,N,N,-,-1,-1
REOPER.txt,518342,520152,1810,10,N,N,-,-1,-1
REOPER.txt,518620,520319,1699,10,N,N,-,-1,-1
REOPER.txt,518741,520395,1654,10,N,N,-,-1,-1
REOPER.txt,518929,520620,1691,10,N,N,-,-1,-1
REOPER.txt,519018,520820,1802,10,N,N,-,-1,-1
REOPER.txt,519513,521055,1542,10,N,N,-,-1,-1
REOPER.txt,519784,521162,1378,10,N,N,-,-1,-1
REOPER.txt,519980,521228,1248,10,N,N,-,-1,-1
REOPER.txt,520072,521309,1237,10,N,N,-,-1,-1
REOPER.txt,520115,521475,1360,10,N,N,-,-1,-1
REOPER.txt,520153,521515,1362,10,N,N,-,-1,-1
REOPER.txt,520321,521538,1217,10,N,N,-,-1,-1
REOPER.txt,520396,521595,1199,10,N,N,-,-1,-1
REOPER.txt,520621,521789,1168,10,N,Y,1448279620157,70041,71486
REOPER.txt,520822,522024,1202,10,N,Y,1448279620157,70041,71486
REOPER.txt,521055,522060,1005,10,N,Y,1448279620157,70041,71486
REOPER.txt,521164,522123,959,10,N,Y,1448279620157,70041,71486
REOPER.txt,521229,522410,1181,10,N,Y,1448279620157,70041,71486
REOPER.txt,521310,522512,1202,10,N,Y,1448279620157,70041,71486
REOPER.txt,521476,522583,1107,10,N,Y,1448279620157,70041,71486
REOPER.txt,521516,522650,1134,10,N,Y,1448279620157,70041,71486
REOPER.txt,521539,522665,1126,10,N,Y,1448279620157,70041,71486
REOPER.txt,521596,522720,1124,10,N,Y,1448279620157,70041,71486
REOPER.txt,521790,522757,967,10,N,Y,1448279620157,70041,71486
REOPER.txt,522029,522778,749,10,N,Y,1448279620157,70041,71486
REOPER.txt,522063,522860,797,10,N,Y,1448279620157,70041,71486
REOPER.txt,522124,522938,814,10,N,Y,1448279620157,70041,71486
REOPER.txt,522413,523100,687,10,N,Y,1448279620157,70041,71486
REOPER.txt,522513,523173,660,10,N,Y,1448279620157,70041,71486
REOPER.txt,522584,523335,751,10,N,Y,1448279620157,70041,71486
REOPER.txt,522651,523400,749,10,N,Y,1448279620157,70041,71486
REOPER.txt,522666,523494,828,10,N,Y,1448279620157,70041,71486
REOPER.txt,522721,523641,920,10,N,Y,1448279620157,70041,71486
REOPER.txt,522758,523712,954,10,N,Y,1448279620157,70041,71486
REOPER.txt,522779,523805,1026,10,N,Y,1448279620157,70041,71486
REOPER.txt,522861,523844,983,10,N,Y,1448279620157,70041,71486
REOPER.txt,522939,523880,941,10,N,Y,1448279620157,70041,71486
REOPER.txt,523101,524134,1033,10,N,Y,1448279620157,70041,71486
REOPER.txt,523175,524201,1026,10,N,Y,1448279620157,70041,71486
REOPER.txt,523338,524525,1187,10,N,Y,1448279620157,70041,71486
REOPER.txt,523401,524701,1300,10,N,Y,1448279620157,70041,71486
REOPER.txt,523495,524962,1467,10,N,Y,1448279620157,70041,71486
REOPER.txt,523642,525152,1510,10,N,Y,1448279620157,70041,71486
REOPER.txt,523714,525404,1690,10,N,Y,1448279620157,70041,71486
REOPER.txt,523806,525705,1899,10,N,Y,1448279620157,70041,71486
REOPER.txt,523845,525732,1887,10,N,Y,1448279620157,70041,71486
REOPER.txt,523881,525914,2033,10,N,Y,1448279620157,70041,71486
REOPER.txt,524135,526032,1897,10,N,Y,1448279620157,70041,71486
REOPER.txt,524202,526350,2148,10,N,Y,1448279620157,70041,71486
REOPER.txt,524526,526443,1917,10,N,Y,1448279620157,70041,71486
REOPER.txt,524702,526599,1897,10,N,Y,1448279620157,70041,71486
REOPER.txt,524963,526678,1715,10,N,Y,1448279620157,70041,71486
REOPER.txt,525153,526918,1765,10,N,Y,1448279620157,70041,71486
REOPER.txt,525407,527078,1671,10,N,Y,1448322979449,227304,227638
REOPER.txt,525708,527290,1582,10,N,Y,1448322979449,227304,227638
REOPER.txt,525733,527566,1833,10,N,Y,1448322979449,227304,227638
REOPER.txt,525915,527726,1811,10,N,Y,1448322979449,227304,227638
REOPER.txt,526033,527996,1963,10,Y,Y,1448322979449,227304,227638
REOPER.txt,526353,528259,1906,10,Y,Y,1448322979449,227304,227638
REOPER.txt,526444,528369,1925,10,Y,Y,1448322979449,227304,227638
REOPER.txt,526600,528587,1987,10,Y,Y,1448322979449,227304,227638
REOPER.txt,526683,528735,2052,10,Y,Y,1448322979449,227304,227638
REOPER.txt,526919,528862,1943,10,Y,Y,1448322979449,227304,227638
REOPER.txt,527079,529004,1925,10,Y,Y,1448322979449,227304,227638
REOPER.txt,527291,529042,1751,10,Y,Y,1448322979449,227304,227638
REOPER.txt,527567,529141,1574,10,Y,Y,1448322979449,227304,227638
REOPER.txt,527727,529266,1539,10,N,Y,1448322979449,227304,227638
REOPER.txt,527997,529448,1451,10,N,Y,1448322979449,227304,227638
REOPER.txt,528260,529571,1311,10,N,Y,1448322979449,227304,227638
REOPER.txt,528372,529820,1448,10,N,N,-,-1,-1
REOPER.txt,528589,529943,1354,10,N,N,-,-1,-1
REOPER.txt,528736,530055,1319,10,N,N,-,-1,-1
REOPER.txt,528863,530117,1254,10,N,N,-,-1,-1
REOPER.txt,529005,530222,1217,10,N,N,-,-1,-1
REOPER.txt,529043,530430,1387,10,N,N,-,-1,-1
REOPER.txt,529144,530554,1410,10,N,N,-,-1,-1
REOPER.txt,529267,530719,1452,10,N,N,-,-1,-1
REOPER.txt,529449,530811,1362,10,N,Y,1448287306770,114686,120152
REOPER.txt,529572,530981,1409,10,N,Y,1448287306770,114686,120152
REOPER.txt,529821,531065,1244,10,N,Y,1448287306770,114686,120152
REOPER.txt,529944,531165,1221,10,N,Y,1448287306770,114686,120152
REOPER.txt,530056,531231,1175,10,N,Y,1448287306770,114686,120152
REOPER.txt,530118,531317,1199,10,N,Y,1448287306770,114686,120152
REOPER.txt,530223,531452,1229,10,N,Y,1448287306770,114686,120152
REOPER.txt,530431,531639,1208,10,N,Y,1448287306770,114686,120152
REOPER.txt,530555,531990,1435,10,N,Y,1448287306770,114686,120152
REOPER.txt,530722,532059,1337,10,N,Y,1448287306770,114686,120152
REOPER.txt,530812,532112,1300,10,N,Y,1448287306770,114686,120152
REOPER.txt,530982,532161,1179,10,N,Y,1448287306770,114686,120152
REOPER.txt,531066,532285,1219,10,N,Y,1448287306770,114686,120152
REOPER.txt,531166,532377,1211,10,N,Y,1448287306770,114686,120152
REOPER.txt,531233,532440,1207,10,N,Y,1448287306770,114686,120152
REOPER.txt,531318,532606,1288,10,N,Y,1448287306770,114686,120152
REOPER.txt,531454,532750,1296,10,N,Y,1448287306770,114686,120152
REOPER.txt,531640,532814,1174,10,N,Y,1448287306770,114686,120152
REOPER.txt,531991,532911,920,10,N,Y,1448287306770,114686,120152
REOPER.txt,532060,533074,1014,10,N,Y,1448287306770,114686,120152
REOPER.txt,532113,533289,1176,10,N,Y,1448277582432,52552,54595
REOPER.txt,532162,533352,1190,10,N,Y,1448277582432,52552,54595
REOPER.txt,532286,533480,1194,10,N,Y,1448277582432,52552,54595
REOPER.txt,532378,533689,1311,10,N,Y,1448277582432,52552,54595
REOPER.txt,532441,533757,1316,10,N,Y,1448277582432,52552,54595
REOPER.txt,532609,533929,1320,10,N,Y,1448277582432,52552,54595
REOPER.txt,532751,534148,1397,10,N,Y,1448277582432,52552,54595
REOPER.txt,532817,534342,1525,10,N,Y,1448277582432,52552,54595
REOPER.txt,532912,534509,1597,10,N,Y,1448277582432,52552,54595
REOPER.txt,533079,534521,1442,10,N,Y,1448277582432,52552,54595
REOPER.txt,533290,534603,1313,10,N,Y,1448277582432,52552,54595
REOPER.txt,533354,534699,1345,10,N,Y,1448277582432,52552,54595
REOPER.txt,533481,534875,1394,10,N,Y,1448277582432,52552,54595
REOPER.txt,533691,534921,1230,10,N,Y,1448277582432,52552,54595
REOPER.txt,533760,535103,1343,10,N,Y,1448277582432,52552,54595
REOPER.txt,533931,535244,1313,10,N,Y,1448277582432,52552,54595
REOPER.txt,534150,535389,1239,10,N,Y,1437490253936,460795,462238
REOPER.txt,534343,535567,1224,10,N,Y,1437490253936,460795,462238
REOPER.txt,534510,535718,1208,10,N,Y,1437490253936,460795,462238
REOPER.txt,534522,535959,1437,10,N,Y,1437490253936,460795,462238
REOPER.txt,534604,536064,1460,10,N,Y,1437490253936,460795,462238
REOPER.txt,534700,536172,1472,10,N,Y,1437490253936,460795,462238
REOPER.txt,534876,536231,1355,10,N,Y,1437490253936,460795,462238
REOPER.txt,534922,536306,1384,10,N,Y,1437490253936,460795,462238
REOPER.txt,535104,536342,1238,10,N,Y,1437490253936,460795,462238
REOPER.txt,535247,536472,1225,10,N,Y,1437490253936,460795,462238
REOPER.txt,535390,536655,1265,10,N,Y,1437490253936,460795,462238
REOPER.txt,535569,536927,1358,10,N,Y,1437490253936,460795,462238
REOPER.txt,535719,537029,1310,10,N,Y,1437490253936,460795,462238
REOPER.txt,535960,537173,1213,10,N,Y,1437490253936,460795,462238
REOPER.txt,536065,537286,1221,10,N,Y,1437490253936,460795,462238
REOPER.txt,536173,537390,1217,10,N,Y,1437490253936,460795,462238
REOPER.txt,536232,537609,1377,10,N,Y,1437490253936,460795,462238
REOPER.txt,536309,537744,1435,10,N,Y,1437490253936,460795,462238
REOPER.txt,536343,537799,1456,10,N,Y,1437490253936,460795,462238
REOPER.txt,536474,537889,1415,10,N,Y,1437490253936,460795,462238
REOPER.txt,536656,537998,1342,10,N,N,-,-1,-1
REOPER.txt,536928,538133,1205,10,N,N,-,-1,-1
REOPER.txt,537032,538212,1180,10,N,N,-,-1,-1
REOPER.txt,537174,538358,1184,10,N,N,-,-1,-1
REOPER.txt,537287,538547,1260,10,N,N,-,-1,-1
REOPER.txt,537391,538612,1221,10,N,N,-,-1,-1
REOPER.txt,537610,538812,1202,10,N,N,-,-1,-1
REOPER.txt,537745,539172,1427,10,N,N,-,-1,-1
REOPER.txt,537800,539327,1527,10,N,N,-,-1,-1
REOPER.txt,537891,539543,1652,10,N,N,-,-1,-1
REOPER.txt,538000,539651,1651,10,N,N,-,-1,-1
REOPER.txt,538134,539858,1724,10,N,N,-,-1,-1
REOPER.txt,538213,539985,1772,10,N,N,-,-1,-1
REOPER.txt,538361,540339,1978,10,N,N,-,-1,-1
REOPER.txt,538548,540470,1922,10,N,N,-,-1,-1
REOPER.txt,538613,540749,2136,10,N,N,-,-1,-1
REOPER.txt,538813,540784,1971,10,N,N,-,-1,-1
REOPER.txt,539173,540860,1687,10,N,N,-,-1,-1
REOPER.txt,539328,540942,1614,10,N,N,-,-1,-1
REOPER.txt,539544,541238,1694,10,N,N,-,-1,-1
REOPER.txt,539656,541368,1712,10,N,N,-,-1,-1
REOPER.txt,539861,541526,1665,10,N,N,-,-1,-1
REOPER.txt,539986,541638,1652,10,N,N,-,-1,-1
REOPER.txt,540342,541688,1346,10,N,N,-,-1,-1
REOPER.txt,540471,541766,1295,10,N,N,-,-1,-1
REOPER.txt,540750,542012,1262,10,N,N,-,-1,-1
REOPER.txt,540786,542169,1383,10,N,N,-,-1,-1
REOPER.txt,540861,542250,1389,10,N,N,-,-1,-1
REOPER.txt,540945,542422,1477,10,N,N,-,-1,-1
REOPER.txt,541239,542489,1250,10,N,N,-,-1,-1
REOPER.txt,541369,542680,1311,10,N,N,-,-1,-1
REOPER.txt,541527,542763,1236,10,N,N,-,-1,-1
REOPER.txt,541639,542869,1230,10,N,N,-,-1,-1
REOPER.txt,541689,543022,1333,10,N,N,-,-1,-1
REOPER.txt,541767,543287,1520,10,N,N,-,-1,-1
REOPER.txt,542013,543377,1364,10,N,N,-,-1,-1
REOPER.txt,542170,543560,1390,10,N,N,-,-1,-1
REOPER.txt,542251,543688,1437,10,N,N,-,-1,-1
REOPER.txt,542423,543849,1426,10,N,N,-,-1,-1
REOPER.txt,542490,543931,1441,10,N,N,-,-1,-1
REOPER.txt,542683,544035,1352,10,N,N,-,-1,-1
REOPER.txt,542764,544073,1309,10,N,N,-,-1,-1
REOPER.txt,542870,544197,1327,10,N,N,-,-1,-1
REOPER.txt,543024,544312,1288,10,N,N,-,-1,-1
REOPER.txt,543288,544404,1116,10,N,N,-,-1,-1
REOPER.txt,543378,544746,1368,10,N,N,-,-1,-1
REOPER.txt,543563,544832,1269,10,N,N,-,-1,-1
REOPER.txt,543689,544919,1230,10,N,N,-,-1,-1
REOPER.txt,543852,545095,1243,10,N,N,-,-1,-1
REOPER.txt,543932,545367,1435,10,N,N,-,-1,-1
REOPER.txt,544036,545418,1382,10,N,N,-,-1,-1
REOPER.txt,544074,545604,1530,10,N,N,-,-1,-1
REOPER.txt,544198,545729,1531,10,N,N,-,-1,-1
REOPER.txt,544313,545856,1543,10,N,N,-,-1,-1
REOPER.txt,544405,546083,1678,10,N,N,-,-1,-1
REOPER.txt,544747,546399,1652,10,N,N,-,-1,-1
REOPER.txt,544833,546558,1725,10,N,N,-,-1,-1
REOPER.txt,544920,546697,1777,10,N,N,-,-1,-1
REOPER.txt,545096,546847,1751,10,N,N,-,-1,-1
REOPER.txt,545368,547075,1707,10,N,N,-,-1,-1
REOPER.txt,545419,547163,1744,10,N,N,-,-1,-1
REOPER.txt,545605,547213,1608,10,N,N,-,-1,-1
REOPER.txt,545732,547428,1696,10,N,N,-,-1,-1
REOPER.txt,545857,547616,1759,10,N,N,-,-1,-1
REOPER.txt,546084,547707,1623,10,N,N,-,-1,-1
REOPER.txt,546402,547932,1530,10,N,N,-,-1,-1
REOPER.txt,546559,548009,1450,10,N,N,-,-1,-1
REOPER.txt,546698,548283,1585,10,N,N,-,-1,-1
REOPER.txt,546849,548354,1505,10,N,N,-,-1,-1
REOPER.txt,547075,548520,1445,10,N,N,-,-1,-1
REOPER.txt,547166,548679,1513,10,N,N,-,-1,-1
REOPER.txt,547214,548758,1544,10,N,N,-,-1,-1
REOPER.txt,547429,548953,1524,10,N,N,-,-1,-1
REOPER.txt,547618,549065,1447,10,N,N,-,-1,-1
REOPER.txt,547708,549326,1618,10,N,N,-,-1,-1
REOPER.txt,547933,549376,1443,10,N,N,-,-1,-1
REOPER.txt,548010,549432,1422,10,N,N,-,-1,-1
REOPER.txt,548286,549597,1311,10,N,N,-,-1,-1
REOPER.txt,548355,549656,1301,10,N,N,-,-1,-1
REOPER.txt,548521,549715,1194,10,N,N,-,-1,-1
REOPER.txt,548680,549866,1186,10,N,N,-,-1,-1
REOPER.txt,548761,549890,1129,10,N,N,-,-1,-1
REOPER.txt,548954,550105,1151,10,N,N,-,-1,-1
REOPER.txt,549066,550142,1076,10,N,N,-,-1,-1
REOPER.txt,549327,550849,1522,10,N,N,-,-1,-1
REOPER.txt,549377,550935,1558,10,N,N,-,-1,-1
REOPER.txt,549433,551022,1589,10,N,N,-,-1,-1
REOPER.txt,549598,551107,1509,10,N,N,-,-1,-1
REOPER.txt,549657,551229,1572,10,N,N,-,-1,-1
REOPER.txt,549716,551274,1558,10,N,N,-,-1,-1
REOPER.txt,549871,551528,1657,10,N,N,-,-1,-1
REOPER.txt,549893,551929,2036,10,N,N,-,-1,-1
REOPER.txt,550105,552252,2147,10,N,N,-,-1,-1
REOPER.txt,550143,552549,2406,10,Y,N,-,-1,-1
REOPER.txt,550852,552640,1788,10,N,N,-,-1,-1
REOPER.txt,550936,552766,1830,10,N,N,-,-1,-1
REOPER.txt,551023,552904,1881,10,N,N,-,-1,-1
REOPER.txt,551108,553009,1901,10,N,N,-,-1,-1
REOPER.txt,551230,553051,1821,10,N,N,-,-1,-1
REOPER.txt,551276,553369,2093,10,N,N,-,-1,-1
REOPER.txt,551529,553405,1876,10,N,N,-,-1,-1
REOPER.txt,551930,553753,1823,10,N,N,-,-1,-1
REOPER.txt,552253,553941,1688,10,N,N,-,-1,-1
REOPER.txt,552550,554075,1525,10,N,N,-,-1,-1
REOPER.txt,552642,554276,1634,10,N,N,-,-1,-1
REOPER.txt,552766,554383,1617,10,N,N,-,-1,-1
REOPER.txt,552905,554477,1572,10,N,N,-,-1,-1
REOPER.txt,553012,554671,1659,10,N,N,-,-1,-1
REOPER.txt,553052,554759,1707,10,N,N,-,-1,-1
REOPER.txt,553374,554871,1497,10,N,N,-,-1,-1
REOPER.txt,553408,554999,1591,10,N,N,-,-1,-1
REOPER.txt,553754,555102,1348,10,N,N,-,-1,-1
REOPER.txt,553942,555189,1247,10,N,N,-,-1,-1
REOPER.txt,554076,555302,1226,10,N,N,-,-1,-1
REOPER.txt,554279,555412,1133,10,N,N,-,-1,-1
REOPER.txt,554384,555546,1162,10,N,N,-,-1,-1
REOPER.txt,554478,555621,1143,10,N,N,-,-1,-1
REOPER.txt,554672,555805,1133,10,N,N,-,-1,-1
REOPER.txt,554760,556015,1255,10,N,N,-,-1,-1
REOPER.txt,554872,556166,1294,10,N,N,-,-1,-1
REOPER.txt,555000,556325,1325,10,N,N,-,-1,-1
REOPER.txt,555105,556528,1423,10,N,N,-,-1,-1
REOPER.txt,555190,556816,1626,10,N,N,-,-1,-1
REOPER.txt,555304,556996,1692,10,N,N,-,-1,-1
REOPER.txt,555413,557200,1787,10,N,N,-,-1,-1
REOPER.txt,555547,557274,1727,10,N,N,-,-1,-1
REOPER.txt,555623,557522,1899,10,N,N,-,-1,-1
REOPER.txt,555806,557901,2095,10,Y,N,-,-1,-1
REOPER.txt,556017,558120,2103,10,Y,N,-,-1,-1
REOPER.txt,556167,558219,2052,10,N,N,-,-1,-1
REOPER.txt,556326,558229,1903,10,N,N,-,-1,-1
REOPER.txt,556531,558404,1873,10,N,N,-,-1,-1
REOPER.txt,556817,558656,1839,10,N,N,-,-1,-1
REOPER.txt,556999,558814,1815,10,N,N,-,-1,-1
REOPER.txt,557201,558850,1649,10,N,N,-,-1,-1
REOPER.txt,557276,559038,1762,10,N,N,-,-1,-1
REOPER.txt,557523,559259,1736,10,N,N,-,-1,-1
REOPER.txt,557902,559345,1443,10,N,N,-,-1,-1
REOPER.txt,558123,559353,1230,10,N,N,-,-1,-1
REOPER.txt,558220,559509,1289,10,N,N,-,-1,-1
REOPER.txt,558230,559592,1362,10,N,N,-,-1,-1
REOPER.txt,558405,559896,1491,10,Y,N,-,-1,-1
REOPER.txt,558657,560304,1647,10,Y,N,-,-1,-1
REOPER.txt,558815,560573,1758,10,Y,N,-,-1,-1
REOPER.txt,558851,560778,1927,10,Y,N,-,-1,-1
REOPER.txt,559039,560949,1910,10,Y,N,-,-1,-1
REOPER.txt,559260,560985,1725,10,Y,N,-,-1,-1
REOPER.txt,559346,561016,1670,10,Y,N,-,-1,-1
REOPER.txt,559354,561140,1786,10,Y,N,-,-1,-1
REOPER.txt,559510,561367,1857,10,Y,N,-,-1,-1
REOPER.txt,559595,561557,1962,10,Y,N,-,-1,-1
REOPER.txt,559896,561667,1771,10,Y,N,-,-1,-1
REOPER.txt,560306,561990,1684,10,Y,N,-,-1,-1
REOPER.txt,560576,562131,1555,10,Y,N,-,-1,-1
REOPER.txt,560779,562239,1460,10,N,N,-,-1,-1
REOPER.txt,560954,562349,1395,10,N,N,-,-1,-1
REOPER.txt,560988,562611,1623,10,N,N,-,-1,-1
REOPER.txt,561017,562800,1783,10,N,N,-,-1,-1
REOPER.txt,561141,562812,1671,10,N,N,-,-1,-1
REOPER.txt,561370,563163,1793,10,N,N,-,-1,-1
REOPER.txt,561558,563290,1732,10,N,N,-,-1,-1
REOPER.txt,561668,563392,1724,10,N,N,-,-1,-1
REOPER.txt,561991,563628,1637,10,Y,N,-,-1,-1
REOPER.txt,562132,563796,1664,10,Y,N,-,-1,-1
REOPER.txt,562240,563955,1715,10,Y,N,-,-1,-1
REOPER.txt,562352,564187,1835,10,Y,N,-,-1,-1
REOPER.txt,562613,564304,1691,10,Y,N,-,-1,-1
REOPER.txt,562801,564533,1732,10,Y,N,-,-1,-1
REOPER.txt,562813,564594,1781,10,Y,N,-,-1,-1
REOPER.txt,563164,564774,1610,10,Y,N,-,-1,-1
REOPER.txt,563292,564999,1707,10,Y,N,-,-1,-1
REOPER.txt,563394,565095,1701,10,Y,N,-,-1,-1
REOPER.txt,563631,565184,1553,10,Y,N,-,-1,-1
REOPER.txt,563797,565239,1442,10,Y,N,-,-1,-1
REOPER.txt,563958,565453,1495,10,Y,N,-,-1,-1
REOPER.txt,564188,565552,1364,10,Y,N,-,-1,-1
REOPER.txt,564305,565733,1428,10,Y,N,-,-1,-1
REOPER.txt,564534,565926,1392,10,N,N,-,-1,-1
REOPER.txt,564597,566126,1529,10,N,N,-,-1,-1
REOPER.txt,564775,566213,1438,10,N,N,-,-1,-1
REOPER.txt,565002,566324,1322,10,N,N,-,-1,-1
REOPER.txt,565096,566395,1299,10,N,N,-,-1,-1
REOPER.txt,565185,566534,1349,10,N,N,-,-1,-1
REOPER.txt,565240,566699,1459,10,N,N,-,-1,-1
REOPER.txt,565454,566802,1348,10,N,N,-,-1,-1
REOPER.txt,565553,567028,1475,10,N,N,-,-1,-1
REOPER.txt,565734,567164,1430,10,N,N,-,-1,-1
REOPER.txt,565929,567297,1368,10,N,N,-,-1,-1
REOPER.txt,566128,567570,1442,10,N,N,-,-1,-1
REOPER.txt,566214,567906,1692,10,N,N,-,-1,-1
REOPER.txt,566325,568113,1788,10,N,N,-,-1,-1
REOPER.txt,566396,568251,1855,10,N,N,-,-1,-1
REOPER.txt,566535,568361,1826,10,N,N,-,-1,-1
REOPER.txt,566700,568406,1706,10,N,N,-,-1,-1
REOPER.txt,566805,568591,1786,10,N,N,-,-1,-1
REOPER.txt,567029,568700,1671,10,N,N,-,-1,-1
REOPER.txt,567165,568811,1646,10,N,N,-,-1,-1
REOPER.txt,567299,569069,1770,10,N,N,-,-1,-1
REOPER.txt,567571,569268,1697,10,N,N,-,-1,-1
REOPER.txt,567909,569494,1585,10,N,N,-,-1,-1
REOPER.txt,568116,569551,1435,10,N,N,-,-1,-1
REOPER.txt,568252,570028,1776,10,N,N,-,-1,-1
REOPER.txt,568362,570043,1681,10,N,N,-,-1,-1
REOPER.txt,568407,570080,1673,10,N,N,-,-1,-1
REOPER.txt,568593,570165,1572,10,N,N,-,-1,-1
REOPER.txt,568702,570446,1744,10,Y,N,-,-1,-1
REOPER.txt,568812,570557,1745,10,Y,N,-,-1,-1
REOPER.txt,569072,570801,1729,10,Y,N,-,-1,-1
REOPER.txt,569269,570877,1608,10,N,N,-,-1,-1
REOPER.txt,569494,571097,1603,10,N,N,-,-1,-1
REOPER.txt,569552,571254,1702,10,N,N,-,-1,-1
REOPER.txt,570029,571432,1403,10,N,N,-,-1,-1
REOPER.txt,570044,571525,1481,10,N,N,-,-1,-1
REOPER.txt,570081,571823,1742,10,N,N,-,-1,-1
REOPER.txt,570166,571878,1712,10,N,N,-,-1,-1
REOPER.txt,570447,572094,1647,10,N,N,-,-1,-1
REOPER.txt,570558,572229,1671,10,N,N,-,-1,-1
REOPER.txt,570802,572467,1665,10,N,N,-,-1,-1
REOPER.txt,570878,572538,1660,10,N,N,-,-1,-1
REOPER.txt,571098,572801,1703,10,N,N,-,-1,-1
REOPER.txt,571257,572941,1684,10,N,N,-,-1,-1
REOPER.txt,571433,573102,1669,10,N,N,-,-1,-1
REOPER.txt,571526,573282,1756,10,N,N,-,-1,-1
REOPER.txt,571826,573451,1625,10,N,N,-,-1,-1
REOPER.txt,571880,573627,1747,10,N,N,-,-1,-1
REOPER.txt,572096,573758,1662,10,N,N,-,-1,-1
REOPER.txt,572232,573818,1586,10,N,N,-,-1,-1
REOPER.txt,572468,573988,1520,10,N,N,-,-1,-1
REOPER.txt,572539,574125,1586,10,N,N,-,-1,-1
REOPER.txt,572802,574286,1484,10,N,N,-,-1,-1
REOPER.txt,572942,574707,1765,10,N,N,-,-1,-1
REOPER.txt,573103,574862,1759,10,N,N,-,-1,-1
REOPER.txt,573285,575080,1795,10,N,N,-,-1,-1
REOPER.txt,573452,575187,1735,10,N,N,-,-1,-1
REOPER.txt,573628,575226,1598,10,N,N,-,-1,-1
REOPER.txt,573759,575362,1603,10,N,N,-,-1,-1
REOPER.txt,573819,575451,1632,10,N,N,-,-1,-1
REOPER.txt,573989,575489,1500,10,N,N,-,-1,-1
REOPER.txt,574126,575598,1472,10,N,N,-,-1,-1
REOPER.txt,574289,575715,1426,10,N,N,-,-1,-1
REOPER.txt,574708,575881,1173,10,N,N,-,-1,-1
REOPER.txt,574863,575977,1114,10,N,N,-,-1,-1
REOPER.txt,575081,576036,955,10,N,N,-,-1,-1
REOPER.txt,575188,576128,940,10,N,N,-,-1,-1
REOPER.txt,575227,576189,962,10,N,N,-,-1,-1
REOPER.txt,575365,576397,1032,10,Y,N,-,-1,-1
REOPER.txt,575454,576629,1175,10,Y,N,-,-1,-1
REOPER.txt,575490,576825,1335,10,Y,N,-,-1,-1
REOPER.txt,575599,577033,1434,10,Y,N,-,-1,-1
REOPER.txt,575716,577060,1344,10,Y,N,-,-1,-1
REOPER.txt,575882,577267,1385,10,Y,N,-,-1,-1
REOPER.txt,575978,577866,1888,10,Y,N,-,-1,-1
REOPER.txt,576037,578031,1994,10,Y,N,-,-1,-1
REOPER.txt,576130,578247,2117,10,Y,N,-,-1,-1
REOPER.txt,576190,578420,2230,10,Y,N,-,-1,-1
REOPER.txt,576398,578608,2210,10,Y,N,-,-1,-1
REOPER.txt,576630,578678,2048,10,Y,N,-,-1,-1
REOPER.txt,576826,579131,2305,10,N,N,-,-1,-1
REOPER.txt,577036,579256,2220,10,N,N,-,-1,-1
REOPER.txt,577061,579555,2494,10,N,N,-,-1,-1
REOPER.txt,577268,579659,2391,10,N,N,-,-1,-1
REOPER.txt,577869,579719,1850,10,N,N,-,-1,-1
REOPER.txt,578033,579940,1907,10,N,N,-,-1,-1
REOPER.txt,578248,580115,1867,10,N,N,-,-1,-1
REOPER.txt,578421,580531,2110,10,N,N,-,-1,-1
REOPER.txt,578609,580688,2079,10,N,N,-,-1,-1
REOPER.txt,578679,580875,2196,10,N,N,-,-1,-1
REOPER.txt,579134,580965,1831,10,N,N,-,-1,-1
REOPER.txt,579257,581070,1813,10,N,N,-,-1,-1
REOPER.txt,579558,581349,1791,10,N,N,-,-1,-1
REOPER.txt,579660,581693,2033,10,N,N,-,-1,-1
REOPER.txt,579721,581877,2156,10,Y,N,-,-1,-1
REOPER.txt,579941,581939,1998,10,Y,N,-,-1,-1
REOPER.txt,580116,582274,2158,10,Y,N,-,-1,-1
REOPER.txt,580534,582375,1841,10,N,N,-,-1,-1
REOPER.txt,580689,582444,1755,10,N,N,-,-1,-1
REOPER.txt,580876,582732,1856,10,Y,N,-,-1,-1
REOPER.txt,580966,582828,1862,10,Y,N,-,-1,-1
REOPER.txt,581071,583153,2082,10,Y,N,-,-1,-1
REOPER.txt,581350,583263,1913,10,Y,N,-,-1,-1
REOPER.txt,581694,583424,1730,10,N,N,-,-1,-1
REOPER.txt,581878,583536,1658,10,N,N,-,-1,-1
REOPER.txt,581940,583700,1760,10,N,N,-,-1,-1
REOPER.txt,582275,583890,1615,10,N,N,-,-1,-1
REOPER.txt,582376,583946,1570,10,N,N,-,-1,-1
REOPER.txt,582445,584070,1625,10,N,N,-,-1,-1
REOPER.txt,582735,584293,1558,10,Y,N,-,-1,-1
REOPER.txt,582831,584365,1534,10,N,N,-,-1,-1
REOPER.txt,583154,584448,1294,10,Y,N,-,-1,-1
REOPER.txt,583264,584516,1252,10,Y,N,-,-1,-1
REOPER.txt,583425,584543,1118,10,Y,N,-,-1,-1
REOPER.txt,583539,584702,1163,10,N,N,-,-1,-1
REOPER.txt,583702,584755,1053,10,N,N,-,-1,-1
REOPER.txt,583891,584902,1011,10,N,N,-,-1,-1
REOPER.txt,583947,585259,1312,10,N,N,-,-1,-1
REOPER.txt,584071,585285,1214,10,N,N,-,-1,-1
REOPER.txt,584294,585339,1045,10,N,N,-,-1,-1
REOPER.txt,584367,585386,1019,10,N,N,-,-1,-1
REOPER.txt,584449,585425,976,10,N,N,-,-1,-1
REOPER.txt,584521,585567,1046,10,N,N,-,-1,-1
REOPER.txt,584544,585723,1179,10,N,N,-,-1,-1
REOPER.txt,584703,585752,1049,10,N,N,-,-1,-1
REOPER.txt,584756,585998,1242,10,N,N,-,-1,-1
REOPER.txt,584903,586298,1395,10,N,N,-,-1,-1
REOPER.txt,585260,586389,1129,10,N,N,-,-1,-1
REOPER.txt,585286,586425,1139,10,N,N,-,-1,-1
REOPER.txt,585340,586540,1200,10,N,N,-,-1,-1
REOPER.txt,585387,586623,1236,10,N,N,-,-1,-1
REOPER.txt,585426,586704,1278,10,N,N,-,-1,-1
REOPER.txt,585568,586795,1227,10,N,N,-,-1,-1
REOPER.txt,585724,586955,1231,10,N,N,-,-1,-1
REOPER.txt,585753,586995,1242,10,N,N,-,-1,-1
REOPER.txt,585998,587081,1083,10,N,N,-,-1,-1
REOPER.txt,586299,587152,853,10,N,N,-,-1,-1
REOPER.txt,586394,587322,928,10,N,N,-,-1,-1
REOPER.txt,586428,587340,912,10,N,N,-,-1,-1
REOPER.txt,586542,587502,960,10,N,N,-,-1,-1
REOPER.txt,586624,587531,907,10,N,N,-,-1,-1
REOPER.txt,586705,587640,935,10,N,N,-,-1,-1
REOPER.txt,586796,587646,850,10,N,N,-,-1,-1
REOPER.txt,586956,587730,774,10,N,N,-,-1,-1
REOPER.txt,586996,587844,848,10,N,N,-,-1,-1
REOPER.txt,587084,588195,1111,10,N,N,-,-1,-1
REOPER.txt,587153,588217,1064,10,N,N,-,-1,-1
REOPER.txt,587323,588365,1042,10,N,N,-,-1,-1
REOPER.txt,587341,588634,1293,10,N,N,-,-1,-1
REOPER.txt,587503,588859,1356,10,N,N,-,-1,-1
REOPER.txt,587532,588973,1441,10,N,N,-,-1,-1
REOPER.txt,587641,589229,1588,10,N,N,-,-1,-1
REOPER.txt,587647,589300,1653,10,N,N,-,-1,-1
REOPER.txt,587732,589555,1823,10,N,N,-,-1,-1
REOPER.txt,587847,589726,1879,10,N,N,-,-1,-1
REOPER.txt,588200,589885,1685,10,N,N,-,-1,-1
REOPER.txt,588218,589975,1757,10,N,N,-,-1,-1
REOPER.txt,588366,590022,1656,10,N,N,-,-1,-1
REOPER.txt,588635,590074,1439,10,N,N,-,-1,-1
REOPER.txt,588860,590131,1271,10,N,N,-,-1,-1
REOPER.txt,588974,590634,1660,10,N,N,-,-1,-1
REOPER.txt,589230,590738,1508,10,N,N,-,-1,-1
REOPER.txt,589301,590844,1543,10,N,N,-,-1,-1
REOPER.txt,589556,591083,1527,10,N,N,-,-1,-1
REOPER.txt,589727,591217,1490,10,N,N,-,-1,-1
REOPER.txt,589886,591422,1536,10,N,N,-,-1,-1
REOPER.txt,589976,591563,1587,10,Y,N,-,-1,-1
REOPER.txt,590025,591674,1649,10,Y,N,-,-1,-1
REOPER.txt,590075,591816,1741,10,Y,N,-,-1,-1
REOPER.txt,590133,592011,1878,10,Y,N,-,-1,-1
REOPER.txt,590637,592244,1607,10,Y,N,-,-1,-1
REOPER.txt,590739,592479,1740,10,Y,N,-,-1,-1
REOPER.txt,590845,592659,1814,10,Y,N,-,-1,-1
REOPER.txt,591084,592815,1731,10,N,N,-,-1,-1
REOPER.txt,591218,592860,1642,10,N,N,-,-1,-1
REOPER.txt,591423,593067,1644,10,Y,N,-,-1,-1
REOPER.txt,591565,593171,1606,10,Y,N,-,-1,-1
REOPER.txt,591675,593318,1643,10,Y,N,-,-1,-1
REOPER.txt,591817,593389,1572,10,Y,N,-,-1,-1
REOPER.txt,592012,593522,1510,10,Y,N,-,-1,-1
REOPER.txt,592245,593599,1354,10,N,N,-,-1,-1
REOPER.txt,592480,593892,1412,10,Y,N,-,-1,-1
REOPER.txt,592662,594149,1487,10,Y,N,-,-1,-1
REOPER.txt,592818,594269,1451,10,Y,N,-,-1,-1
REOPER.txt,592861,594392,1531,10,Y,N,-,-1,-1
REOPER.txt,593068,594643,1575,10,Y,N,-,-1,-1
REOPER.txt,593172,594958,1786,10,Y,N,-,-1,-1
REOPER.txt,593319,595112,1793,10,Y,N,-,-1,-1
REOPER.txt,593390,595183,1793,10,Y,N,-,-1,-1
REOPER.txt,593523,595312,1789,10,Y,N,-,-1,-1
REOPER.txt,593602,595411,1809,10,Y,N,-,-1,-1
REOPER.txt,593893,595596,1703,10,Y,N,-,-1,-1
REOPER.txt,594150,595938,1788,10,N,N,-,-1,-1
REOPER.txt,594271,596400,2129,10,N,N,-,-1,-1
REOPER.txt,594393,596512,2119,10,N,N,-,-1,-1
REOPER.txt,594644,596770,2126,10,N,N,-,-1,-1
REOPER.txt,594961,596908,1947,10,N,N,-,-1,-1
REOPER.txt,595113,597027,1914,10,N,N,-,-1,-1
REOPER.txt,595184,597214,2030,10,N,N,-,-1,-1
REOPER.txt,595313,597256,1943,10,N,N,-,-1,-1
REOPER.txt,595412,597342,1930,10,N,N,-,-1,-1
REOPER.txt,595597,597562,1965,10,N,N,-,-1,-1
REOPER.txt,595939,597823,1884,10,N,N,-,-1,-1
REOPER.txt,596402,597944,1542,10,N,N,-,-1,-1
REOPER.txt,596514,598189,1675,10,N,N,-,-1,-1
REOPER.txt,596771,598279,1508,10,N,N,-,-1,-1
REOPER.txt,596909,598500,1591,10,N,N,-,-1,-1
REOPER.txt,597028,598669,1641,10,N,N,-,-1,-1
REOPER.txt,597217,598890,1673,10,N,N,-,-1,-1
REOPER.txt,597257,598966,1709,10,N,N,-,-1,-1
REOPER.txt,597343,599171,1828,10,N,N,-,-1,-1
REOPER.txt,597563,599305,1742,10,N,N,-,-1,-1
REOPER.txt,597824,599405,1581,10,N,N,-,-1,-1
REOPER.txt,597945,599489,1544,10,N,N,-,-1,-1
REOPER.txt,598190,599562,1372,10,N,N,-,-1,-1
REOPER.txt,598282,599842,1560,10,N,N,-,-1,-1
REOPER.txt,598501,600006,1505,10,N,N,-,-1,-1
REOPER.txt,598670,600313,1643,10,N,N,-,-1,-1
REOPER.txt,598891,600560,1669,10,N,N,-,-1,-1
REOPER.txt,598967,600641,1674,10,N,N,-,-1,-1
REOPER.txt,599172,600751,1579,10,N,N,-,-1,-1
REOPER.txt,599307,600806,1499,10,N,N,-,-1,-1
REOPER.txt,599406,601151,1745,10,N,N,-,-1,-1
REOPER.txt,599490,601280,1790,10,N,N,-,-1,-1
REOPER.txt,599563,601617,2054,10,N,N,-,-1,-1
REOPER.txt,599845,601689,1844,10,N,N,-,-1,-1
REOPER.txt,600007,602224,2217,10,N,N,-,-1,-1
REOPER.txt,600314,602364,2050,10,N,N,-,-1,-1
REOPER.txt,600561,602467,1906,10,N,N,-,-1,-1
REOPER.txt,600642,602698,2056,10,N,N,-,-1,-1
REOPER.txt,600752,602719,1967,10,N,N,-,-1,-1
REOPER.txt,600808,602769,1961,10,N,N,-,-1,-1
REOPER.txt,601151,603093,1942,10,N,N,-,-1,-1
REOPER.txt,601281,603217,1936,10,N,N,-,-1,-1
REOPER.txt,601618,603449,1831,10,N,N,-,-1,-1
REOPER.txt,601690,603732,2042,10,N,N,-,-1,-1
REOPER.txt,602225,603752,1527,10,N,N,-,-1,-1
REOPER.txt,602365,603913,1548,10,N,N,-,-1,-1
REOPER.txt,602468,604231,1763,10,N,N,-,-1,-1
REOPER.txt,602703,604374,1671,10,N,N,-,-1,-1
REOPER.txt,602720,604620,1900,10,N,N,-,-1,-1
REOPER.txt,602770,604788,2018,10,N,N,-,-1,-1
REOPER.txt,603094,604845,1751,10,N,N,-,-1,-1
REOPER.txt,603218,605153,1935,10,N,N,-,-1,-1
REOPER.txt,603450,605222,1772,10,N,N,-,-1,-1
REOPER.txt,603733,605322,1589,10,N,N,-,-1,-1
REOPER.txt,603753,605434,1681,10,N,N,-,-1,-1
REOPER.txt,603913,605508,1595,10,N,N,-,-1,-1
REOPER.txt,604232,605522,1290,10,N,N,-,-1,-1
REOPER.txt,604375,605768,1393,10,N,N,-,-1,-1
REOPER.txt,604623,606391,1768,10,N,N,-,-1,-1
REOPER.txt,604791,606584,1793,10,N,N,-,-1,-1
REOPER.txt,604846,606791,1945,10,N,N,-,-1,-1
REOPER.txt,605154,606934,1780,10,N,N,-,-1,-1
REOPER.txt,605223,606971,1748,10,N,N,-,-1,-1
REOPER.txt,605322,607163,1841,10,N,N,-,-1,-1
REOPER.txt,605439,607298,1859,10,N,N,-,-1,-1
REOPER.txt,605509,607436,1927,10,N,N,-,-1,-1
REOPER.txt,605524,607547,2023,10,N,N,-,-1,-1
REOPER.txt,605769,607797,2028,10,N,N,-,-1,-1
REOPER.txt,606394,608108,1714,10,N,N,-,-1,-1
REOPER.txt,606585,608440,1855,10,N,N,-,-1,-1
REOPER.txt,606792,608771,1979,10,N,N,-,-1,-1
REOPER.txt,606939,608851,1912,10,N,N,-,-1,-1
REOPER.txt,606974,608902,1928,10,N,N,-,-1,-1
REOPER.txt,607164,609014,1850,10,N,N,-,-1,-1
REOPER.txt,607300,609134,1834,10,N,N,-,-1,-1
REOPER.txt,607439,609187,1748,10,N,N,-,-1,-1
REOPER.txt,607548,609380,1832,10,N,N,-,-1,-1
REOPER.txt,607798,609462,1664,10,N,N,-,-1,-1
REOPER.txt,608109,609590,1481,10,N,N,-,-1,-1
REOPER.txt,608441,609752,1311,10,N,N,-,-1,-1
REOPER.txt,608772,609827,1055,10,N,N,-,-1,-1
REOPER.txt,608852,609999,1147,10,N,N,-,-1,-1
REOPER.txt,608903,610268,1365,10,N,N,-,-1,-1
REOPER.txt,609015,610478,1463,10,N,N,-,-1,-1
REOPER.txt,609135,610615,1480,10,N,N,-,-1,-1
REOPER.txt,609188,610628,1440,10,N,N,-,-1,-1
REOPER.txt,609383,610736,1353,10,N,N,-,-1,-1
REOPER.txt,609463,610907,1444,10,N,N,-,-1,-1
REOPER.txt,609592,610981,1389,10,N,N,-,-1,-1
REOPER.txt,609753,611170,1417,10,N,N,-,-1,-1
REOPER.txt,609828,611440,1612,10,N,N,-,-1,-1
REOPER.txt,610000,611483,1483,10,N,N,-,-1,-1
REOPER.txt,610269,611640,1371,10,N,N,-,-1,-1
REOPER.txt,610479,611750,1271,10,N,N,-,-1,-1
REOPER.txt,610618,612167,1549,10,N,N,-,-1,-1
REOPER.txt,610629,612346,1717,10,N,N,-,-1,-1
REOPER.txt,610739,612475,1736,10,N,N,-,-1,-1
REOPER.txt,610908,612531,1623,10,N,N,-,-1,-1
REOPER.txt,610982,612676,1694,10,N,N,-,-1,-1
REOPER.txt,611171,612936,1765,10,N,N,-,-1,-1
REOPER.txt,611441,612994,1553,10,N,N,-,-1,-1
REOPER.txt,611485,613172,1687,10,N,N,-,-1,-1
REOPER.txt,611643,613292,1649,10,N,N,-,-1,-1
REOPER.txt,611753,613398,1645,10,N,N,-,-1,-1
REOPER.txt,612170,613475,1305,10,N,N,-,-1,-1
REOPER.txt,612347,613733,1386,10,N,N,-,-1,-1
REOPER.txt,612476,613857,1381,10,N,N,-,-1,-1
REOPER.txt,612532,614068,1536,10,N,N,-,-1,-1
REOPER.txt,612677,614187,1510,10,N,N,-,-1,-1
REOPER.txt,612937,614233,1296,10,N,N,-,-1,-1
REOPER.txt,612997,614445,1448,10,N,N,-,-1,-1
REOPER.txt,613173,614718,1545,10,N,N,-,-1,-1
REOPER.txt,613293,614847,1554,10,N,N,-,-1,-1
REOPER.txt,613399,614875,1476,10,N,N,-,-1,-1
REOPER.txt,613476,614986,1510,10,N,N,-,-1,-1
REOPER.txt,613734,615130,1396,10,N,N,-,-1,-1
REOPER.txt,613858,615278,1420,10,N,N,-,-1,-1
REOPER.txt,614069,615379,1310,10,N,N,-,-1,-1
REOPER.txt,614190,615626,1436,10,N,N,-,-1,-1
REOPER.txt,614234,615657,1423,10,N,N,-,-1,-1
REOPER.txt,614448,615845,1397,10,N,N,-,-1,-1
REOPER.txt,614719,615888,1169,10,N,N,-,-1,-1
REOPER.txt,614848,615986,1138,10,N,N,-,-1,-1
REOPER.txt,614877,616059,1182,10,N,N,-,-1,-1
REOPER.txt,614987,616276,1289,10,N,N,-,-1,-1
REOPER.txt,615131,616649,1518,10,N,N,-,-1,-1
REOPER.txt,615279,616744,1465,10,N,N,-,-1,-1
REOPER.txt,615380,616859,1479,10,N,N,-,-1,-1
REOPER.txt,615627,617097,1470,10,N,N,-,-1,-1
REOPER.txt,615658,617351,1693,10,N,N,-,-1,-1
REOPER.txt,615846,617631,1785,10,N,N,-,-1,-1
REOPER.txt,615889,617784,1895,10,N,N,-,-1,-1
REOPER.txt,615987,617993,2006,10,N,N,-,-1,-1
REOPER.txt,616062,618175,2113,10,N,N,-,-1,-1
REOPER.txt,616278,618444,2166,10,N,N,-,-1,-1
REOPER.txt,616652,618856,2204,10,N,N,-,-1,-1
REOPER.txt,616745,618933,2188,10,Y,N,-,-1,-1
REOPER.txt,616860,619093,2233,10,N,N,-,-1,-1
REOPER.txt,617098,619455,2357,10,N,N,-,-1,-1
REOPER.txt,617354,619628,2274,10,N,N,-,-1,-1
REOPER.txt,617632,619685,2053,10,N,N,-,-1,-1
REOPER.txt,617787,619785,1998,10,N,N,-,-1,-1
REOPER.txt,617996,619827,1831,10,N,N,-,-1,-1
REOPER.txt,618175,619925,1750,10,N,N,-,-1,-1
REOPER.txt,618445,620104,1659,10,N,N,-,-1,-1
REOPER.txt,618857,620261,1404,10,N,N,-,-1,-1
REOPER.txt,618935,620338,1403,10,N,N,-,-1,-1
REOPER.txt,619094,620695,1601,10,N,N,-,-1,-1
REOPER.txt,619456,620787,1331,10,N,N,-,-1,-1
REOPER.txt,619629,620869,1240,10,N,N,-,-1,-1
REOPER.txt,619686,621115,1429,10,N,N,-,-1,-1
REOPER.txt,619786,621294,1508,10,N,N,-,-1,-1
REOPER.txt,619828,621458,1630,10,N,N,-,-1,-1
REOPER.txt,619926,621494,1568,10,N,N,-,-1,-1
REOPER.txt,620105,621580,1475,10,N,N,-,-1,-1
REOPER.txt,620262,621740,1478,10,N,N,-,-1,-1
REOPER.txt,620339,621927,1588,10,N,N,-,-1,-1
REOPER.txt,620697,622209,1512,10,N,N,-,-1,-1
REOPER.txt,620788,622358,1570,10,N,N,-,-1,-1
REOPER.txt,620871,622481,1610,10,N,N,-,-1,-1
REOPER.txt,621118,622674,1556,10,N,N,-,-1,-1
REOPER.txt,621295,622978,1683,10,N,N,-,-1,-1
REOPER.txt,621463,623313,1850,10,N,N,-,-1,-1
REOPER.txt,621497,623341,1844,10,N,N,-,-1,-1
REOPER.txt,621581,623530,1949,10,N,N,-,-1,-1
REOPER.txt,621741,623748,2007,10,N,N,-,-1,-1
REOPER.txt,621928,623888,1960,10,N,N,-,-1,-1
REOPER.txt,622210,624208,1998,10,N,N,-,-1,-1
REOPER.txt,622359,624212,1853,10,N,N,-,-1,-1
REOPER.txt,622482,624585,2103,10,N,N,-,-1,-1
REOPER.txt,622676,624590,1914,10,N,N,-,-1,-1
REOPER.txt,622979,625048,2069,10,N,N,-,-1,-1
REOPER.txt,623318,625067,1749,10,N,N,-,-1,-1
REOPER.txt,623342,625107,1765,10,N,N,-,-1,-1
REOPER.txt,623531,625333,1802,10,N,N,-,-1,-1
REOPER.txt,623749,625378,1629,10,N,N,-,-1,-1
REOPER.txt,623889,625435,1546,10,N,N,-,-1,-1
REOPER.txt,624209,625738,1529,10,N,N,-,-1,-1
REOPER.txt,624213,625907,1694,10,N,N,-,-1,-1
REOPER.txt,624586,625932,1346,10,N,N,-,-1,-1
REOPER.txt,624591,626198,1607,10,N,N,-,-1,-1
REOPER.txt,625048,626285,1237,10,N,N,-,-1,-1
REOPER.txt,625070,626426,1356,10,N,N,-,-1,-1
REOPER.txt,625110,626580,1470,10,N,N,-,-1,-1
REOPER.txt,625335,626859,1524,10,N,N,-,-1,-1
REOPER.txt,625379,626926,1547,10,N,N,-,-1,-1
REOPER.txt,625436,627123,1687,10,N,N,-,-1,-1
REOPER.txt,625741,627269,1528,10,N,N,-,-1,-1
REOPER.txt,625908,627415,1507,10,N,N,-,-1,-1
REOPER.txt,625933,627504,1571,10,N,N,-,-1,-1
REOPER.txt,626199,627591,1392,10,N,N,-,-1,-1
REOPER.txt,626287,627682,1395,10,N,N,-,-1,-1
REOPER.txt,626427,627779,1352,10,N,N,-,-1,-1
REOPER.txt,626581,627879,1298,10,Y,N,-,-1,-1
REOPER.txt,626860,627930,1070,10,N,N,-,-1,-1
REOPER.txt,626927,628298,1371,10,Y,N,-,-1,-1
REOPER.txt,627126,628653,1527,10,Y,N,-,-1,-1
REOPER.txt,627270,628910,1640,10,N,N,-,-1,-1
REOPER.txt,627416,629059,1643,10,Y,N,-,-1,-1
REOPER.txt,627505,629134,1629,10,Y,N,-,-1,-1
REOPER.txt,627592,629183,1591,10,Y,N,-,-1,-1
REOPER.txt,627683,629301,1618,10,Y,N,-,-1,-1
REOPER.txt,627780,629363,1583,10,N,N,-,-1,-1
REOPER.txt,627881,629391,1510,10,N,N,-,-1,-1
REOPER.txt,627931,629425,1494,10,N,N,-,-1,-1
REOPER.txt,628299,629807,1508,10,N,N,-,-1,-1
REOPER.txt,628656,629970,1314,10,N,N,-,-1,-1
REOPER.txt,628911,630163,1252,10,N,N,-,-1,-1
REOPER.txt,629060,630329,1269,10,N,N,-,-1,-1
REOPER.txt,629135,630400,1265,10,N,N,-,-1,-1
REOPER.txt,629185,630444,1259,10,N,N,-,-1,-1
REOPER.txt,629302,630548,1246,10,N,N,-,-1,-1
REOPER.txt,629364,630663,1299,10,N,N,-,-1,-1
REOPER.txt,629394,630707,1313,10,N,N,-,-1,-1
REOPER.txt,629428,630830,1402,10,N,N,-,-1,-1
REOPER.txt,629808,631098,1290,10,N,N,-,-1,-1
REOPER.txt,629972,631138,1166,10,N,N,-,-1,-1
REOPER.txt,630166,631223,1057,10,N,N,-,-1,-1
REOPER.txt,630330,631626,1296,10,N,N,-,-1,-1
REOPER.txt,630401,631698,1297,10,N,N,-,-1,-1
REOPER.txt,630445,631802,1357,10,N,N,-,-1,-1
REOPER.txt,630549,631963,1414,10,N,N,-,-1,-1
REOPER.txt,630664,632266,1602,10,N,N,-,-1,-1
REOPER.txt,630708,632303,1595,10,N,N,-,-1,-1
REOPER.txt,630831,632406,1575,10,N,N,-,-1,-1
REOPER.txt,631099,632459,1360,10,N,N,-,-1,-1
REOPER.txt,631139,632694,1555,10,N,N,-,-1,-1
REOPER.txt,631224,632781,1557,10,N,N,-,-1,-1
REOPER.txt,631626,632953,1327,10,N,N,-,-1,-1
REOPER.txt,631700,633142,1442,10,N,N,-,-1,-1
REOPER.txt,631803,633250,1447,10,N,N,-,-1,-1
REOPER.txt,631966,633474,1508,10,Y,N,-,-1,-1
REOPER.txt,632269,633753,1484,10,N,N,-,-1,-1
REOPER.txt,632304,634079,1775,10,Y,N,-,-1,-1
REOPER.txt,632407,634100,1693,10,Y,N,-,-1,-1
REOPER.txt,632460,634241,1781,10,Y,N,-,-1,-1
REOPER.txt,632695,634469,1774,10,Y,N,-,-1,-1
REOPER.txt,632782,634586,1804,10,Y,N,-,-1,-1
REOPER.txt,632954,634738,1784,10,Y,N,-,-1,-1
REOPER.txt,633145,634902,1757,10,Y,N,-,-1,-1
REOPER.txt,633251,635064,1813,10,Y,N,-,-1,-1
REOPER.txt,633475,635159,1684,10,N,N,-,-1,-1
REOPER.txt,633753,635272,1519,10,N,N,-,-1,-1
REOPER.txt,634084,635431,1347,10,N,N,-,-1,-1
REOPER.txt,634101,635755,1654,10,N,N,-,-1,-1
REOPER.txt,634242,635855,1613,10,N,N,-,-1,-1
REOPER.txt,634472,635907,1435,10,N,N,-,-1,-1
REOPER.txt,634587,635977,1390,10,N,N,-,-1,-1
REOPER.txt,634739,636055,1316,10,N,N,-,-1,-1
REOPER.txt,634904,636145,1241,10,N,N,-,-1,-1
REOPER.txt,635065,636225,1160,10,N,N,-,-1,-1
REOPER.txt,635160,636432,1272,10,N,N,-,-1,-1
REOPER.txt,635273,636839,1566,10,N,N,-,-1,-1
REOPER.txt,635432,636898,1466,10,N,N,-,-1,-1
REOPER.txt,635756,637117,1361,10,N,N,-,-1,-1
REOPER.txt,635856,637317,1461,10,N,N,-,-1,-1
REOPER.txt,635910,637490,1580,10,N,N,-,-1,-1
REOPER.txt,635978,637732,1754,10,Y,N,-,-1,-1
REOPER.txt,636056,637766,1710,10,Y,N,-,-1,-1
REOPER.txt,636146,637879,1733,10,Y,N,-,-1,-1
REOPER.txt,636226,638032,1806,10,Y,N,-,-1,-1
REOPER.txt,636433,638282,1849,10,Y,N,-,-1,-1
REOPER.txt,636840,638664,1824,10,N,N,-,-1,-1
REOPER.txt,636899,638837,1938,10,N,N,-,-1,-1
REOPER.txt,637120,638994,1874,10,N,N,-,-1,-1
REOPER.txt,637318,639116,1798,10,N,N,-,-1,-1
REOPER.txt,637492,639241,1749,10,N,N,-,-1,-1
REOPER.txt,637733,639506,1773,10,N,N,-,-1,-1
REOPER.txt,637767,639522,1755,10,N,N,-,-1,-1
REOPER.txt,637880,639690,1810,10,N,N,-,-1,-1
REOPER.txt,638035,640115,2080,10,Y,N,-,-1,-1
REOPER.txt,638283,640215,1932,10,Y,N,-,-1,-1
REOPER.txt,638665,640414,1749,10,N,N,-,-1,-1
REOPER.txt,638840,640647,1807,10,N,N,-,-1,-1
REOPER.txt,638996,640747,1751,10,N,N,-,-1,-1
REOPER.txt,639117,640929,1812,10,N,N,-,-1,-1
REOPER.txt,639242,641128,1886,10,N,N,-,-1,-1
REOPER.txt,639509,641162,1653,10,N,N,-,-1,-1
REOPER.txt,639523,641329,1806,10,N,N,-,-1,-1
REOPER.txt,639691,641333,1642,10,N,N,-,-1,-1
REOPER.txt,640118,641485,1367,10,N,N,-,-1,-1
REOPER.txt,640218,641868,1650,10,N,N,-,-1,-1
REOPER.txt,640415,642103,1688,10,N,N,-,-1,-1
REOPER.txt,640648,642550,1902,10,N,N,-,-1,-1
REOPER.txt,640748,642791,2043,10,N,N,-,-1,-1
REOPER.txt,640931,642930,1999,10,N,N,-,-1,-1
REOPER.txt,641129,643017,1888,10,N,N,-,-1,-1
REOPER.txt,641163,643036,1873,10,N,N,-,-1,-1
REOPER.txt,641330,643112,1782,10,N,N,-,-1,-1
REOPER.txt,641336,643125,1789,10,N,N,-,-1,-1
REOPER.txt,641486,643299,1813,10,N,N,-,-1,-1
REOPER.txt,641871,643339,1468,10,N,N,-,-1,-1
REOPER.txt,642104,643426,1322,10,N,N,-,-1,-1
REOPER.txt,642551,643721,1170,10,N,N,-,-1,-1
REOPER.txt,642792,643900,1108,10,N,N,-,-1,-1
REOPER.txt,642931,644138,1207,10,N,N,-,-1,-1
REOPER.txt,643018,644352,1334,10,N,N,-,-1,-1
REOPER.txt,643036,644504,1468,10,Y,N,-,-1,-1
REOPER.txt,643115,644751,1636,10,N,N,-,-1,-1
REOPER.txt,643126,644971,1845,10,N,N,-,-1,-1
REOPER.txt,643300,645016,1716,10,Y,N,-,-1,-1
REOPER.txt,643341,645381,2040,10,Y,N,-,-1,-1
REOPER.txt,643427,645393,1966,10,Y,N,-,-1,-1
REOPER.txt,643722,645697,1975,10,Y,N,-,-1,-1
REOPER.txt,643901,646124,2223,10,Y,N,-,-1,-1
REOPER.txt,644139,646441,2302,10,Y,N,-,-1,-1
REOPER.txt,644353,646512,2159,10,N,N,-,-1,-1
REOPER.txt,644506,646600,2094,10,N,N,-,-1,-1
REOPER.txt,644752,646629,1877,10,N,N,-,-1,-1
REOPER.txt,644972,646666,1694,10,N,N,-,-1,-1
REOPER.txt,645017,646692,1675,10,N,N,-,-1,-1
REOPER.txt,645382,648282,2900,10,N,N,-,-1,-1
REOPER.txt,645394,648495,3101,10,N,N,-,-1,-1
REOPER.txt,645698,648693,2995,10,N,N,-,-1,-1
REOPER.txt,646127,648753,2626,10,N,N,-,-1,-1
REOPER.txt,646442,648903,2461,10,N,N,-,-1,-1
REOPER.txt,646513,649028,2515,10,N,N,-,-1,-1
REOPER.txt,646601,649239,2638,10,N,N,-,-1,-1
REOPER.txt,646630,649615,2985,10,N,N,-,-1,-1
REOPER.txt,646671,650127,3456,10,N,N,-,-1,-1
REOPER.txt,646695,650225,3530,10,N,N,-,-1,-1
REOPER.txt,648285,650343,2058,10,N,N,-,-1,-1
REOPER.txt,648496,650481,1985,10,N,N,-,-1,-1
REOPER.txt,648694,650671,1977,10,N,N,-,-1,-1
REOPER.txt,648754,650820,2066,10,N,N,-,-1,-1
REOPER.txt,648904,650987,2083,10,N,N,-,-1,-1
REOPER.txt,649029,651166,2137,10,N,N,-,-1,-1
REOPER.txt,649242,651291,2049,10,N,N,-,-1,-1
REOPER.txt,649616,651386,1770,10,N,N,-,-1,-1
REOPER.txt,650128,651664,1536,10,N,N,-,-1,-1
REOPER.txt,650226,651716,1490,10,N,N,-,-1,-1
REOPER.txt,650346,651774,1428,10,N,N,-,-1,-1
REOPER.txt,650482,651782,1300,10,N,N,-,-1,-1
REOPER.txt,650672,651838,1166,10,N,N,-,-1,-1
REOPER.txt,650821,652075,1254,10,N,N,-,-1,-1
REOPER.txt,650988,652121,1133,10,N,N,-,-1,-1
REOPER.txt,651167,652148,981,10,N,N,-,-1,-1
REOPER.txt,651292,652185,893,10,N,N,-,-1,-1
REOPER.txt,651389,652279,890,10,N,N,-,-1,-1
REOPER.txt,651664,652379,715,10,N,N,-,-1,-1
REOPER.txt,651718,652629,911,10,N,N,-,-1,-1
REOPER.txt,651776,652815,1039,10,N,N,-,-1,-1
REOPER.txt,651783,652958,1175,10,N,N,-,-1,-1
REOPER.txt,651839,653123,1284,10,N,N,-,-1,-1
REOPER.txt,652076,653278,1202,10,N,N,-,-1,-1
REOPER.txt,652122,653513,1391,10,N,N,-,-1,-1
REOPER.txt,652149,653750,1601,10,N,N,-,-1,-1
REOPER.txt,652188,653889,1701,10,N,N,-,-1,-1
REOPER.txt,652282,653903,1621,10,N,N,-,-1,-1
REOPER.txt,652380,653959,1579,10,N,N,-,-1,-1
REOPER.txt,652630,654211,1581,10,N,N,-,-1,-1
REOPER.txt,652817,654674,1857,10,N,N,-,-1,-1
REOPER.txt,652961,654795,1834,10,N,N,-,-1,-1
REOPER.txt,653124,655087,1963,10,N,N,-,-1,-1
REOPER.txt,653280,655151,1871,10,N,N,-,-1,-1
REOPER.txt,653516,655320,1804,10,N,N,-,-1,-1
REOPER.txt,653751,655604,1853,10,N,N,-,-1,-1
REOPER.txt,653892,655704,1812,10,N,N,-,-1,-1
REOPER.txt,653904,655859,1955,10,N,N,-,-1,-1
REOPER.txt,653962,655945,1983,10,N,N,-,-1,-1
REOPER.txt,654212,656017,1805,10,N,N,-,-1,-1
REOPER.txt,654675,656177,1502,10,N,N,-,-1,-1
REOPER.txt,654796,656269,1473,10,N,N,-,-1,-1
REOPER.txt,655090,656351,1261,10,N,N,-,-1,-1
REOPER.txt,655152,656464,1312,10,N,N,-,-1,-1
REOPER.txt,655321,656702,1381,10,N,N,-,-1,-1
REOPER.txt,655605,656963,1358,10,N,N,-,-1,-1
REOPER.txt,655707,657149,1442,10,N,N,-,-1,-1
REOPER.txt,655860,657251,1391,10,N,N,-,-1,-1
REOPER.txt,655946,657599,1653,10,N,N,-,-1,-1
REOPER.txt,656018,657878,1860,10,N,N,-,-1,-1
REOPER.txt,656178,658286,2108,10,N,N,-,-1,-1
REOPER.txt,656270,658443,2173,10,N,N,-,-1,-1
REOPER.txt,656352,658578,2226,10,N,N,-,-1,-1
REOPER.txt,656467,658800,2333,10,N,N,-,-1,-1
REOPER.txt,656705,658916,2211,10,N,N,-,-1,-1
REOPER.txt,656964,659085,2121,10,N,N,-,-1,-1
REOPER.txt,657151,659150,1999,10,N,N,-,-1,-1
REOPER.txt,657252,659205,1953,10,N,N,-,-1,-1
REOPER.txt,657600,659278,1678,10,N,N,-,-1,-1
REOPER.txt,657881,659334,1453,10,N,N,-,-1,-1
REOPER.txt,658289,659588,1299,10,N,N,-,-1,-1
REOPER.txt,658444,659685,1241,10,N,N,-,-1,-1
REOPER.txt,658579,659782,1203,10,N,N,-,-1,-1
REOPER.txt,658801,659990,1189,10,N,N,-,-1,-1
REOPER.txt,658917,660160,1243,10,N,N,-,-1,-1
REOPER.txt,659086,660328,1242,10,N,N,-,-1,-1
REOPER.txt,659152,660483,1331,10,N,N,-,-1,-1
REOPER.txt,659207,660760,1553,10,N,N,-,-1,-1
REOPER.txt,659279,660852,1573,10,N,N,-,-1,-1
REOPER.txt,659335,661037,1702,10,N,N,-,-1,-1
REOPER.txt,659589,661154,1565,10,N,N,-,-1,-1
REOPER.txt,659686,661267,1581,10,N,N,-,-1,-1
REOPER.txt,659785,661328,1543,10,N,N,-,-1,-1
REOPER.txt,659991,661394,1403,10,N,N,-,-1,-1
REOPER.txt,660163,661613,1450,10,N,N,-,-1,-1
REOPER.txt,660329,661697,1368,10,N,N,-,-1,-1
REOPER.txt,660486,661752,1266,10,N,N,-,-1,-1
REOPER.txt,660762,662011,1249,10,N,N,-,-1,-1
REOPER.txt,660855,662134,1279,10,N,N,-,-1,-1
REOPER.txt,661040,662213,1173,10,N,N,-,-1,-1
REOPER.txt,661155,662346,1191,10,N,N,-,-1,-1
REOPER.txt,661268,662554,1286,10,N,N,-,-1,-1
REOPER.txt,661329,662639,1310,10,N,N,-,-1,-1
REOPER.txt,661395,662764,1369,10,N,N,-,-1,-1
REOPER.txt,661614,662920,1306,10,N,N,-,-1,-1
REOPER.txt,661698,663140,1442,10,N,N,-,-1,-1
REOPER.txt,661753,663305,1552,10,N,N,-,-1,-1
REOPER.txt,662011,663377,1366,10,N,N,-,-1,-1
REOPER.txt,662135,663443,1308,10,N,N,-,-1,-1
REOPER.txt,662214,663521,1307,10,N,N,-,-1,-1
REOPER.txt,662347,663736,1389,10,N,N,-,-1,-1
REOPER.txt,662555,664111,1556,10,N,N,-,-1,-1
REOPER.txt,662640,664322,1682,10,N,N,-,-1,-1
REOPER.txt,662765,664332,1567,10,N,N,-,-1,-1
REOPER.txt,662921,664581,1660,10,N,N,-,-1,-1
REOPER.txt,663141,665241,2100,10,N,N,-,-1,-1
REOPER.txt,663306,665496,2190,10,N,N,-,-1,-1
REOPER.txt,663378,665663,2285,10,N,N,-,-1,-1
REOPER.txt,663444,665867,2423,10,N,N,-,-1,-1
REOPER.txt,663522,666014,2492,10,N,N,-,-1,-1
REOPER.txt,663739,666046,2307,10,N,N,-,-1,-1
REOPER.txt,664112,666441,2329,10,N,N,-,-1,-1
REOPER.txt,664325,666881,2556,10,N,N,-,-1,-1
REOPER.txt,664333,667149,2816,10,N,N,-,-1,-1
REOPER.txt,664584,667170,2586,10,N,N,-,-1,-1
REOPER.txt,665244,667288,2044,10,N,N,-,-1,-1
REOPER.txt,665497,667464,1967,10,N,N,-,-1,-1
REOPER.txt,665664,667813,2149,10,N,N,-,-1,-1
REOPER.txt,665868,667936,2068,10,N,N,-,-1,-1
REOPER.txt,666019,668046,2027,10,N,N,-,-1,-1
REOPER.txt,666047,668403,2356,10,N,N,-,-1,-1
REOPER.txt,666444,668549,2105,10,N,N,-,-1,-1
REOPER.txt,666882,668899,2017,10,N,N,-,-1,-1
REOPER.txt,667150,669007,1857,10,N,N,-,-1,-1
REOPER.txt,667172,669088,1916,10,N,N,-,-1,-1
REOPER.txt,667289,669206,1917,10,N,N,-,-1,-1
REOPER.txt,667465,669331,1866,10,N,N,-,-1,-1
REOPER.txt,667816,669616,1800,10,N,N,-,-1,-1
REOPER.txt,667939,669642,1703,10,N,N,-,-1,-1
REOPER.txt,668048,670024,1976,10,N,N,-,-1,-1
REOPER.txt,668404,670120,1716,10,N,N,-,-1,-1
REOPER.txt,668549,670172,1623,10,N,N,-,-1,-1
REOPER.txt,668902,670310,1408,10,N,N,-,-1,-1
REOPER.txt,669009,670512,1503,10,N,N,-,-1,-1
REOPER.txt,669089,670646,1557,10,N,N,-,-1,-1
REOPER.txt,669207,670846,1639,10,N,N,-,-1,-1
REOPER.txt,669332,671003,1671,10,N,N,-,-1,-1
REOPER.txt,669621,671056,1435,10,N,N,-,-1,-1
REOPER.txt,669643,671061,1418,10,N,N,-,-1,-1
REOPER.txt,670024,671093,1069,10,N,N,-,-1,-1
REOPER.txt,670123,671129,1006,10,N,N,-,-1,-1
REOPER.txt,670174,671317,1143,10,N,N,-,-1,-1
REOPER.txt,670311,671461,1150,10,N,N,-,-1,-1
REOPER.txt,670513,671508,995,10,N,N,-,-1,-1
REOPER.txt,670647,671588,941,10,N,N,-,-1,-1
REOPER.txt,670849,671624,775,10,N,N,-,-1,-1
REOPER.txt,671004,671884,880,10,N,N,-,-1,-1
REOPER.txt,671057,672091,1034,10,N,N,-,-1,-1
REOPER.txt,671062,672117,1055,10,N,N,-,-1,-1
REOPER.txt,671094,672184,1090,10,N,N,-,-1,-1
REOPER.txt,671130,672605,1475,10,N,N,-,-1,-1
REOPER.txt,671317,672700,1383,10,N,N,-,-1,-1
REOPER.txt,671462,672748,1286,10,N,N,-,-1,-1
REOPER.txt,671509,672787,1278,10,N,N,-,-1,-1
REOPER.txt,671593,672882,1289,10,N,N,-,-1,-1
REOPER.txt,671627,672980,1353,10,N,N,-,-1,-1
REOPER.txt,671885,673073,1188,10,N,N,-,-1,-1
REOPER.txt,672096,673236,1140,10,N,N,-,-1,-1
REOPER.txt,672120,673467,1347,10,N,N,-,-1,-1
REOPER.txt,672186,673682,1496,10,N,N,-,-1,-1
REOPER.txt,672606,673753,1147,10,N,N,-,-1,-1
REOPER.txt,672701,673982,1281,10,N,N,-,-1,-1
REOPER.txt,672750,674039,1289,10,N,N,-,-1,-1
REOPER.txt,672788,674101,1313,10,N,N,-,-1,-1
REOPER.txt,672885,674285,1400,10,N,N,-,-1,-1
REOPER.txt,672981,674491,1510,10,N,N,-,-1,-1
REOPER.txt,673074,674603,1529,10,N,N,-,-1,-1
REOPER.txt,673237,674742,1505,10,N,N,-,-1,-1
REOPER.txt,673470,674943,1473,10,N,N,-,-1,-1
REOPER.txt,673685,674997,1312,10,N,N,-,-1,-1
REOPER.txt,673754,675042,1288,10,N,N,-,-1,-1
REOPER.txt,673983,675253,1270,10,N,N,-,-1,-1
REOPER.txt,674040,675316,1276,10,N,N,-,-1,-1
REOPER.txt,674102,675474,1372,10,N,N,-,-1,-1
REOPER.txt,674288,675714,1426,10,N,N,-,-1,-1
REOPER.txt,674491,675785,1294,10,N,N,-,-1,-1
REOPER.txt,674604,675858,1254,10,N,N,-,-1,-1
REOPER.txt,674743,675955,1212,10,N,N,-,-1,-1
REOPER.txt,674946,675979,1033,10,N,N,-,-1,-1
REOPER.txt,674998,675992,994,10,N,N,-,-1,-1
REOPER.txt,675043,676010,967,10,N,N,-,-1,-1
REOPER.txt,675254,676048,794,10,N,N,-,-1,-1
REOPER.txt,675317,676299,982,10,N,N,-,-1,-1
REOPER.txt,675477,676410,933,10,N,N,-,-1,-1
REOPER.txt,675715,676452,737,10,N,N,-,-1,-1
REOPER.txt,675786,676619,833,10,N,N,-,-1,-1
REOPER.txt,675861,677014,1153,10,N,N,-,-1,-1
REOPER.txt,675956,677160,1204,10,N,N,-,-1,-1
REOPER.txt,675980,677358,1378,10,N,N,-,-1,-1
REOPER.txt,675993,677438,1445,10,N,N,-,-1,-1
REOPER.txt,676012,677543,1531,10,N,N,-,-1,-1
REOPER.txt,676051,677724,1673,10,N,N,-,-1,-1
REOPER.txt,676300,677785,1485,10,N,N,-,-1,-1
REOPER.txt,676411,677905,1494,10,N,N,-,-1,-1
REOPER.txt,676453,677941,1488,10,N,N,-,-1,-1
REOPER.txt,676620,677968,1348,10,N,N,-,-1,-1
REOPER.txt,677015,678012,997,10,N,N,-,-1,-1
REOPER.txt,677160,678113,953,10,N,N,-,-1,-1
REOPER.txt,677359,678191,832,10,N,N,-,-1,-1
REOPER.txt,677438,678345,907,10,N,N,-,-1,-1
REOPER.txt,677544,678451,907,10,N,N,-,-1,-1
REOPER.txt,677725,678568,843,10,N,N,-,-1,-1
REOPER.txt,677786,678637,851,10,N,N,-,-1,-1
REOPER.txt,677910,678872,962,10,N,N,-,-1,-1
REOPER.txt,677944,678971,1027,10,N,N,-,-1,-1
REOPER.txt,677969,679367,1398,10,N,N,-,-1,-1
REOPER.txt,678013,679540,1527,10,N,N,-,-1,-1
REOPER.txt,678114,679606,1492,10,N,N,-,-1,-1
REOPER.txt,678192,679628,1436,10,N,N,-,-1,-1
REOPER.txt,678346,679667,1321,10,N,N,-,-1,-1
REOPER.txt,678452,679953,1501,10,N,N,-,-1,-1
REOPER.txt,678569,680362,1793,10,N,N,-,-1,-1
REOPER.txt,678638,680623,1985,10,N,N,-,-1,-1
REOPER.txt,678873,680854,1981,10,N,N,-,-1,-1
REOPER.txt,678972,680979,2007,10,N,N,-,-1,-1
REOPER.txt,679370,680985,1615,10,N,N,-,-1,-1
REOPER.txt,679541,681174,1633,10,N,N,-,-1,-1
REOPER.txt,679607,681233,1626,10,N,N,-,-1,-1
REOPER.txt,679629,681316,1687,10,N,N,-,-1,-1
REOPER.txt,679668,681521,1853,10,Y,N,-,-1,-1
REOPER.txt,679954,681545,1591,10,Y,N,-,-1,-1
REOPER.txt,680363,681625,1262,10,N,N,-,-1,-1
REOPER.txt,680624,682082,1458,10,N,N,-,-1,-1
REOPER.txt,680855,682271,1416,10,N,N,-,-1,-1
REOPER.txt,680980,682454,1474,10,N,N,-,-1,-1
REOPER.txt,680986,682536,1550,10,N,N,-,-1,-1
REOPER.txt,681175,682628,1453,10,N,N,-,-1,-1
REOPER.txt,681234,682862,1628,10,N,N,-,-1,-1
REOPER.txt,681319,683015,1696,10,N,N,-,-1,-1
REOPER.txt,681524,683083,1559,10,N,N,-,-1,-1
REOPER.txt,681546,683147,1601,10,N,N,-,-1,-1
REOPER.txt,681626,683249,1623,10,N,N,-,-1,-1
REOPER.txt,682083,683323,1240,10,N,N,-,-1,-1
REOPER.txt,682272,683494,1222,10,N,N,-,-1,-1
REOPER.txt,682456,683750,1294,10,N,N,-,-1,-1
REOPER.txt,682537,683895,1358,10,N,N,-,-1,-1
REOPER.txt,682629,684065,1436,10,N,N,-,-1,-1
REOPER.txt,682863,684210,1347,10,N,N,-,-1,-1
REOPER.txt,683016,684522,1506,10,Y,N,-,-1,-1
REOPER.txt,683084,684806,1722,10,Y,N,-,-1,-1
REOPER.txt,683148,685093,1945,10,Y,N,-,-1,-1
REOPER.txt,683250,685262,2012,10,Y,N,-,-1,-1
REOPER.txt,683324,685304,1980,10,Y,N,-,-1,-1
REOPER.txt,683495,685366,1871,10,Y,N,-,-1,-1
REOPER.txt,683751,685503,1752,10,Y,N,-,-1,-1
REOPER.txt,683895,685702,1807,10,Y,N,-,-1,-1
REOPER.txt,684067,685876,1809,10,Y,N,-,-1,-1
REOPER.txt,684211,685949,1738,10,Y,N,-,-1,-1
REOPER.txt,684523,686129,1606,10,Y,N,-,-1,-1
REOPER.txt,684807,686187,1380,10,Y,N,-,-1,-1
REOPER.txt,685094,686395,1301,10,Y,N,-,-1,-1
REOPER.txt,685265,686594,1329,10,N,N,-,-1,-1
REOPER.txt,685307,686717,1410,10,N,N,-,-1,-1
REOPER.txt,685368,686959,1591,10,Y,N,-,-1,-1
REOPER.txt,685504,687048,1544,10,N,N,-,-1,-1
REOPER.txt,685702,687315,1613,10,Y,N,-,-1,-1
REOPER.txt,685878,687340,1462,10,Y,N,-,-1,-1
REOPER.txt,685950,687453,1503,10,Y,N,-,-1,-1
REOPER.txt,686130,687708,1578,10,Y,N,-,-1,-1
REOPER.txt,686188,687875,1687,10,Y,N,-,-1,-1
REOPER.txt,686398,687895,1497,10,Y,N,-,-1,-1
REOPER.txt,686595,688046,1451,10,Y,N,-,-1,-1
REOPER.txt,686718,688054,1336,10,Y,N,-,-1,-1
REOPER.txt,686960,688086,1126,10,N,N,-,-1,-1
REOPER.txt,687049,688214,1165,10,N,N,-,-1,-1
REOPER.txt,687320,688362,1042,10,N,N,-,-1,-1
REOPER.txt,687341,688385,1044,10,N,N,-,-1,-1
REOPER.txt,687454,688576,1122,10,N,N,-,-1,-1
REOPER.txt,687709,688607,898,10,N,N,-,-1,-1
REOPER.txt,687876,688643,767,10,N,N,-,-1,-1
REOPER.txt,687896,688794,898,10,N,N,-,-1,-1
REOPER.txt,688047,689124,1077,10,N,N,-,-1,-1
REOPER.txt,688056,689260,1204,10,N,N,-,-1,-1
REOPER.txt,688089,689348,1259,10,N,N,-,-1,-1
REOPER.txt,688215,689451,1236,10,N,N,-,-1,-1
REOPER.txt,688363,689853,1490,10,N,N,-,-1,-1
REOPER.txt,688386,689970,1584,10,N,N,-,-1,-1
REOPER.txt,688577,690166,1589,10,N,N,-,-1,-1
REOPER.txt,688608,690308,1700,10,N,N,-,-1,-1
REOPER.txt,688646,690423,1777,10,N,N,-,-1,-1
REOPER.txt,688795,690518,1723,10,N,N,-,-1,-1
REOPER.txt,689127,690713,1586,10,N,N,-,-1,-1
REOPER.txt,689261,690925,1664,10,N,N,-,-1,-1
REOPER.txt,689350,690953,1603,10,N,N,-,-1,-1
REOPER.txt,689452,691247,1795,10,N,N,-,-1,-1
REOPER.txt,689854,691394,1540,10,N,N,-,-1,-1
REOPER.txt,689971,691617,1646,10,N,N,-,-1,-1
REOPER.txt,690169,691925,1756,10,Y,N,-,-1,-1
REOPER.txt,690309,691966,1657,10,Y,N,-,-1,-1
REOPER.txt,690424,691992,1568,10,Y,N,-,-1,-1
REOPER.txt,690519,692060,1541,10,Y,N,-,-1,-1
REOPER.txt,690713,692241,1528,10,Y,N,-,-1,-1
REOPER.txt,690930,692769,1839,10,Y,N,-,-1,-1
REOPER.txt,690954,692913,1959,10,Y,N,-,-1,-1
REOPER.txt,691248,693096,1848,10,N,N,-,-1,-1
REOPER.txt,691396,693196,1800,10,N,N,-,-1,-1
REOPER.txt,691619,693258,1639,10,N,N,-,-1,-1
REOPER.txt,691926,693380,1454,10,N,N,-,-1,-1
REOPER.txt,691966,693420,1454,10,N,N,-,-1,-1
REOPER.txt,691993,693462,1469,10,N,N,-,-1,-1
REOPER.txt,692061,693550,1489,10,N,N,-,-1,-1
REOPER.txt,692242,693614,1372,10,N,N,-,-1,-1
REOPER.txt,692770,693742,972,10,N,N,-,-1,-1
REOPER.txt,692914,693800,886,10,N,N,-,-1,-1
REOPER.txt,693097,694009,912,10,N,N,-,-1,-1
REOPER.txt,693197,694106,909,10,N,N,-,-1,-1
REOPER.txt,693261,694192,931,10,N,N,-,-1,-1
REOPER.txt,693381,694263,882,10,N,N,-,-1,-1
REOPER.txt,693422,694327,905,10,N,N,-,-1,-1
REOPER.txt,693463,694351,888,10,N,N,-,-1,-1
REOPER.txt,693553,694388,835,10,N,N,-,-1,-1
REOPER.txt,693615,694681,1066,10,N,N,-,-1,-1
REOPER.txt,693743,694751,1008,10,N,N,-,-1,-1
REOPER.txt,693801,694952,1151,10,N,N,-,-1,-1
REOPER.txt,694010,695128,1118,10,N,N,-,-1,-1
REOPER.txt,694108,695176,1068,10,N,N,-,-1,-1
REOPER.txt,694193,695239,1046,10,N,N,-,-1,-1
REOPER.txt,694263,695261,998,10,N,N,-,-1,-1
REOPER.txt,694329,695361,1032,10,N,N,-,-1,-1
REOPER.txt,694352,695390,1038,10,N,N,-,-1,-1
REOPER.txt,694389,695463,1074,10,N,N,-,-1,-1
REOPER.txt,694682,695582,900,10,N,N,-,-1,-1
REOPER.txt,694752,695730,978,10,N,N,-,-1,-1
REOPER.txt,694955,695834,879,10,N,N,-,-1,-1
REOPER.txt,695129,695936,807,10,N,N,-,-1,-1
REOPER.txt,695177,696088,911,10,N,N,-,-1,-1
REOPER.txt,695240,696283,1043,10,N,N,-,-1,-1
REOPER.txt,695262,696316,1054,10,N,N,-,-1,-1
REOPER.txt,695362,696406,1044,10,N,N,-,-1,-1
REOPER.txt,695391,696419,1028,10,N,N,-,-1,-1
REOPER.txt,695464,696483,1019,10,N,N,-,-1,-1
REOPER.txt,695584,696516,932,10,N,N,-,-1,-1
REOPER.txt,695731,696585,854,10,N,N,-,-1,-1
REOPER.txt,695835,696617,782,10,N,N,-,-1,-1
REOPER.txt,695937,696729,792,10,N,N,-,-1,-1
REOPER.txt,696089,696844,755,10,N,N,-,-1,-1
REOPER.txt,696284,696981,697,10,N,N,-,-1,-1
REOPER.txt,696317,697012,695,10,N,N,-,-1,-1
REOPER.txt,696409,697052,643,10,N,N,-,-1,-1
REOPER.txt,696420,697092,672,10,N,N,-,-1,-1
REOPER.txt,696484,697166,682,10,N,N,-,-1,-1
REOPER.txt,696517,697209,692,10,N,N,-,-1,-1
REOPER.txt,696586,697273,687,10,N,N,-,-1,-1
REOPER.txt,696618,697297,679,10,N,N,-,-1,-1
REOPER.txt,696731,697481,750,10,N,N,-,-1,-1
REOPER.txt,696845,697569,724,10,N,N,-,-1,-1
REOPER.txt,696984,697602,618,10,N,N,-,-1,-1
REOPER.txt,697013,697673,660,10,N,N,-,-1,-1
REOPER.txt,697053,697768,715,10,N,N,-,-1,-1
REOPER.txt,697093,697965,872,10,N,N,-,-1,-1
REOPER.txt,697167,698290,1123,10,N,N,-,-1,-1
REOPER.txt,697210,698566,1356,10,Y,N,-,-1,-1
REOPER.txt,697274,698745,1471,10,N,N,-,-1,-1
REOPER.txt,697299,698834,1535,10,N,N,-,-1,-1
REOPER.txt,697482,698988,1506,10,N,N,-,-1,-1
REOPER.txt,697570,699053,1483,10,N,N,-,-1,-1
REOPER.txt,697605,699385,1780,10,Y,N,-,-1,-1
REOPER.txt,697674,699692,2018,10,Y,N,-,-1,-1
REOPER.txt,697770,699818,2048,10,N,N,-,-1,-1
REOPER.txt,697966,700255,2289,10,N,N,-,-1,-1
REOPER.txt,698291,700455,2164,10,N,N,-,-1,-1
REOPER.txt,698567,700599,2032,10,N,N,-,-1,-1
REOPER.txt,698746,700643,1897,10,N,N,-,-1,-1
REOPER.txt,698834,700759,1925,10,N,N,-,-1,-1
REOPER.txt,698989,700869,1880,10,N,N,-,-1,-1
REOPER.txt,699054,700983,1929,10,N,N,-,-1,-1
REOPER.txt,699386,701040,1654,10,N,N,-,-1,-1
REOPER.txt,699693,701088,1395,10,N,N,-,-1,-1
REOPER.txt,699819,701158,1339,10,N,N,-,-1,-1
REOPER.txt,700256,701415,1159,10,N,N,-,-1,-1
REOPER.txt,700456,701451,995,10,N,N,-,-1,-1
REOPER.txt,700600,701543,943,10,N,N,-,-1,-1
REOPER.txt,700644,701544,900,10,N,N,-,-1,-1
REOPER.txt,700760,701605,845,10,N,N,-,-1,-1
REOPER.txt,700870,701782,912,10,N,N,-,-1,-1
REOPER.txt,700984,702043,1059,10,N,N,-,-1,-1
REOPER.txt,701041,702094,1053,10,N,N,-,-1,-1
REOPER.txt,701089,702208,1119,10,N,N,-,-1,-1
REOPER.txt,701159,702608,1449,10,N,N,-,-1,-1
REOPER.txt,701420,702823,1403,10,N,N,-,-1,-1
REOPER.txt,701454,703020,1566,10,Y,N,-,-1,-1
REOPER.txt,701543,703215,1672,10,Y,N,-,-1,-1
REOPER.txt,701544,703299,1755,10,Y,N,-,-1,-1
REOPER.txt,701606,703398,1792,10,N,N,-,-1,-1
REOPER.txt,701784,703555,1771,10,Y,N,-,-1,-1
REOPER.txt,702044,703711,1667,10,N,N,-,-1,-1
REOPER.txt,702095,703798,1703,10,N,N,-,-1,-1
REOPER.txt,702209,703863,1654,10,N,N,-,-1,-1
REOPER.txt,702611,704082,1471,10,N,N,-,-1,-1
REOPER.txt,702825,704187,1362,10,N,N,-,-1,-1
REOPER.txt,703021,704508,1487,10,N,N,-,-1,-1
REOPER.txt,703216,704626,1410,10,N,N,-,-1,-1
REOPER.txt,703300,704663,1363,10,N,N,-,-1,-1
REOPER.txt,703399,704694,1295,10,N,N,-,-1,-1
REOPER.txt,703556,704838,1282,10,N,N,-,-1,-1
REOPER.txt,703712,704991,1279,10,N,N,-,-1,-1
REOPER.txt,703799,705144,1345,10,N,N,-,-1,-1
REOPER.txt,703865,705202,1337,10,N,N,-,-1,-1
REOPER.txt,704085,705318,1233,10,N,N,-,-1,-1
REOPER.txt,704188,705354,1166,10,Y,N,-,-1,-1
REOPER.txt,704509,705420,911,10,N,N,-,-1,-1
REOPER.txt,704627,705571,944,10,N,N,-,-1,-1
REOPER.txt,704664,705663,999,10,N,N,-,-1,-1
REOPER.txt,704697,705833,1136,10,N,N,-,-1,-1
REOPER.txt,704840,705895,1055,10,Y,N,-,-1,-1
REOPER.txt,704994,705973,979,10,N,N,-,-1,-1
REOPER.txt,705145,706347,1202,10,N,N,-,-1,-1
REOPER.txt,705203,706615,1412,10,N,N,-,-1,-1
REOPER.txt,705323,706721,1398,10,N,N,-,-1,-1
REOPER.txt,705357,706732,1375,10,N,N,-,-1,-1
REOPER.txt,705423,706903,1480,10,N,N,-,-1,-1
REOPER.txt,705572,706976,1404,10,N,N,-,-1,-1
REOPER.txt,705664,707172,1508,10,N,N,-,-1,-1
REOPER.txt,705834,707334,1500,10,N,N,-,-1,-1
REOPER.txt,705896,707552,1656,10,N,N,-,-1,-1
REOPER.txt,705974,707669,1695,10,N,N,-,-1,-1
REOPER.txt,706348,707967,1619,10,Y,N,-,-1,-1
REOPER.txt,706616,708087,1471,10,Y,N,-,-1,-1
REOPER.txt,706722,708267,1545,10,Y,N,-,-1,-1
REOPER.txt,706733,708397,1664,10,N,N,-,-1,-1
REOPER.txt,706904,708442,1538,10,Y,N,-,-1,-1
REOPER.txt,706978,708625,1647,10,Y,N,-,-1,-1
REOPER.txt,707173,708717,1544,10,N,N,-,-1,-1
REOPER.txt,707335,708865,1530,10,N,N,-,-1,-1
REOPER.txt,707553,708900,1347,10,N,N,-,-1,-1
REOPER.txt,707672,709031,1359,10,N,N,-,-1,-1
REOPER.txt,707968,709287,1319,10,N,N,-,-1,-1
REOPER.txt,708090,709656,1566,10,N,N,-,-1,-1
REOPER.txt,708270,709777,1507,10,N,N,-,-1,-1
REOPER.txt,708398,709959,1561,10,N,N,-,-1,-1
REOPER.txt,708443,710201,1758,10,N,N,-,-1,-1
REOPER.txt,708626,710455,1829,10,N,N,-,-1,-1
REOPER.txt,708720,710518,1798,10,N,N,-,-1,-1
REOPER.txt,708870,710591,1721,10,N,N,-,-1,-1
REOPER.txt,708903,710836,1933,10,N,N,-,-1,-1
REOPER.txt,709032,710868,1836,10,N,N,-,-1,-1
REOPER.txt,709288,710902,1614,10,N,N,-,-1,-1
REOPER.txt,709657,710935,1278,10,N,N,-,-1,-1
REOPER.txt,709778,711092,1314,10,N,N,-,-1,-1
REOPER.txt,709960,711173,1213,10,N,N,-,-1,-1
REOPER.txt,710204,711244,1040,10,N,N,-,-1,-1
REOPER.txt,710456,711262,806,10,N,N,-,-1,-1
REOPER.txt,710519,711295,776,10,N,N,-,-1,-1
REOPER.txt,710592,711450,858,10,N,N,-,-1,-1
REOPER.txt,710841,711533,692,10,N,N,-,-1,-1
REOPER.txt,710869,711623,754,10,N,N,-,-1,-1
REOPER.txt,710903,711721,818,10,N,N,-,-1,-1
REOPER.txt,710936,711882,946,10,N,N,-,-1,-1
REOPER.txt,711094,711940,846,10,N,N,-,-1,-1
REOPER.txt,711174,712038,864,10,N,N,-,-1,-1
REOPER.txt,711245,712187,942,10,N,N,-,-1,-1
REOPER.txt,711263,712340,1077,10,N,N,-,-1,-1
REOPER.txt,711296,712400,1104,10,N,N,-,-1,-1
REOPER.txt,711451,712520,1069,10,N,N,-,-1,-1
REOPER.txt,711536,712636,1100,10,N,N,-,-1,-1
REOPER.txt,711624,712678,1054,10,N,N,-,-1,-1
REOPER.txt,711722,712796,1074,10,N,N,-,-1,-1
REOPER.txt,711883,712948,1065,10,N,N,-,-1,-1
REOPER.txt,711941,712982,1041,10,N,N,-,-1,-1
REOPER.txt,712039,713109,1070,10,N,N,-,-1,-1
REOPER.txt,712188,713221,1033,10,N,N,-,-1,-1
REOPER.txt,712342,713368,1026,10,N,N,-,-1,-1
REOPER.txt,712402,713545,1143,10,N,N,-,-1,-1
REOPER.txt,712522,713626,1104,10,N,N,-,-1,-1
REOPER.txt,712639,713734,1095,10,N,N,-,-1,-1
REOPER.txt,712681,713815,1134,10,N,N,-,-1,-1
REOPER.txt,712797,713955,1158,10,N,N,-,-1,-1
REOPER.txt,712950,714138,1188,10,N,N,-,-1,-1
REOPER.txt,712983,714287,1304,10,N,N,-,-1,-1
REOPER.txt,713110,714378,1268,10,N,N,-,-1,-1
REOPER.txt,713222,714442,1220,10,N,N,-,-1,-1
REOPER.txt,713369,714556,1187,10,N,N,-,-1,-1
REOPER.txt,713546,714619,1073,10,N,N,-,-1,-1
REOPER.txt,713627,714680,1053,10,N,N,-,-1,-1
REOPER.txt,713737,714749,1012,10,N,N,-,-1,-1
REOPER.txt,713816,715031,1215,10,N,N,-,-1,-1
REOPER.txt,713957,715158,1201,10,N,N,-,-1,-1
REOPER.txt,714141,715271,1130,10,N,N,-,-1,-1
REOPER.txt,714288,715295,1007,10,N,N,-,-1,-1
REOPER.txt,714379,715446,1067,10,N,N,-,-1,-1
REOPER.txt,714443,715771,1328,10,N,N,-,-1,-1
REOPER.txt,714558,715978,1420,10,N,N,-,-1,-1
REOPER.txt,714620,716277,1657,10,N,N,-,-1,-1
REOPER.txt,714681,716348,1667,10,N,N,-,-1,-1
REOPER.txt,714750,716511,1761,10,N,N,-,-1,-1
REOPER.txt,715033,716561,1528,10,N,N,-,-1,-1
REOPER.txt,715159,716660,1501,10,N,N,-,-1,-1
REOPER.txt,715272,716774,1502,10,N,N,-,-1,-1
REOPER.txt,715296,716905,1609,10,N,N,-,-1,-1
REOPER.txt,715447,717017,1570,10,N,N,-,-1,-1
REOPER.txt,715772,717157,1385,10,N,N,-,-1,-1
REOPER.txt,715979,717207,1228,10,N,N,-,-1,-1
REOPER.txt,716278,717286,1008,10,N,N,-,-1,-1
REOPER.txt,716349,717402,1053,10,N,N,-,-1,-1
REOPER.txt,716512,717536,1024,10,N,N,-,-1,-1
REOPER.txt,716562,717739,1177,10,N,N,-,-1,-1
REOPER.txt,716662,717836,1174,10,N,N,-,-1,-1
REOPER.txt,716775,718092,1317,10,N,N,-,-1,-1
REOPER.txt,716906,718128,1222,10,N,N,-,-1,-1
REOPER.txt,717018,718345,1327,10,N,N,-,-1,-1
REOPER.txt,717159,718551,1392,10,N,N,-,-1,-1
REOPER.txt,717208,718723,1515,10,N,N,-,-1,-1
REOPER.txt,717287,718878,1591,10,N,N,-,-1,-1
REOPER.txt,717405,718980,1575,10,N,N,-,-1,-1
REOPER.txt,717537,719244,1707,10,N,N,-,-1,-1
REOPER.txt,717740,719369,1629,10,N,N,-,-1,-1
REOPER.txt,717839,719659,1820,10,N,N,-,-1,-1
REOPER.txt,718093,719692,1599,10,N,N,-,-1,-1
REOPER.txt,718129,719817,1688,10,N,N,-,-1,-1
REOPER.txt,718348,719914,1566,10,N,N,-,-1,-1
REOPER.txt,718552,719992,1440,10,N,N,-,-1,-1
REOPER.txt,718724,720027,1303,10,N,N,-,-1,-1
REOPER.txt,718881,720184,1303,10,N,N,-,-1,-1
REOPER.txt,718981,720250,1269,10,N,N,-,-1,-1
REOPER.txt,719245,720462,1217,10,N,N,-,-1,-1
REOPER.txt,719370,720630,1260,10,N,N,-,-1,-1
REOPER.txt,719662,720847,1185,10,N,N,-,-1,-1
REOPER.txt,719693,720997,1304,10,N,N,-,-1,-1
REOPER.txt,719818,721069,1251,10,N,N,-,-1,-1
REOPER.txt,719917,721202,1285,10,N,N,-,-1,-1
REOPER.txt,719993,721228,1235,10,N,N,-,-1,-1
REOPER.txt,720029,721396,1367,10,N,N,-,-1,-1
REOPER.txt,720187,721565,1378,10,N,N,-,-1,-1
REOPER.txt,720251,722208,1957,10,N,N,-,-1,-1
REOPER.txt,720464,722282,1818,10,N,N,-,-1,-1
REOPER.txt,720632,722438,1806,10,N,N,-,-1,-1
REOPER.txt,720849,722696,1847,10,N,N,-,-1,-1
REOPER.txt,720998,722893,1895,10,N,N,-,-1,-1
REOPER.txt,721070,723175,2105,10,N,N,-,-1,-1
REOPER.txt,721207,723357,2150,10,N,N,-,-1,-1
REOPER.txt,721231,723476,2245,10,N,N,-,-1,-1
REOPER.txt,721397,723611,2214,10,N,N,-,-1,-1
REOPER.txt,721566,723827,2261,10,N,N,-,-1,-1
REOPER.txt,722211,724230,2019,10,N,N,-,-1,-1
REOPER.txt,722283,724365,2082,10,N,N,-,-1,-1
REOPER.txt,722439,724652,2213,10,N,N,-,-1,-1
REOPER.txt,722697,724784,2087,10,N,N,-,-1,-1
REOPER.txt,722896,724973,2077,10,N,N,-,-1,-1
REOPER.txt,723176,725007,1831,10,N,N,-,-1,-1
REOPER.txt,723358,725067,1709,10,N,N,-,-1,-1
REOPER.txt,723477,725137,1660,10,N,N,-,-1,-1
REOPER.txt,723612,725206,1594,10,N,N,-,-1,-1
REOPER.txt,723827,725236,1409,10,N,N,-,-1,-1
REOPER.txt,724231,725522,1291,10,N,N,-,-1,-1
REOPER.txt,724366,725601,1235,10,N,N,-,-1,-1
REOPER.txt,724653,725740,1087,10,N,N,-,-1,-1
REOPER.txt,724785,726102,1317,10,N,N,-,-1,-1
REOPER.txt,724978,726254,1276,10,N,N,-,-1,-1
REOPER.txt,725008,726392,1384,10,N,N,-,-1,-1
REOPER.txt,725069,726447,1378,10,N,N,-,-1,-1
REOPER.txt,725138,726579,1441,10,N,N,-,-1,-1
REOPER.txt,725207,726825,1618,10,N,N,-,-1,-1
REOPER.txt,725237,726843,1606,10,N,N,-,-1,-1
REOPER.txt,725523,726895,1372,10,N,N,-,-1,-1
REOPER.txt,725602,727111,1509,10,N,N,-,-1,-1
REOPER.txt,725741,727446,1705,10,N,N,-,-1,-1
REOPER.txt,726103,727565,1462,10,N,N,-,-1,-1
REOPER.txt,726257,727722,1465,10,N,N,-,-1,-1
REOPER.txt,726393,727859,1466,10,N,N,-,-1,-1
REOPER.txt,726448,728020,1572,10,N,N,-,-1,-1
REOPER.txt,726580,728047,1467,10,N,N,-,-1,-1
REOPER.txt,726828,728091,1263,10,N,N,-,-1,-1
REOPER.txt,726844,728129,1285,10,N,N,-,-1,-1
REOPER.txt,726896,728200,1304,10,N,N,-,-1,-1
REOPER.txt,727112,728296,1184,10,N,N,-,-1,-1
REOPER.txt,727447,728320,873,10,N,N,-,-1,-1
REOPER.txt,727568,728381,813,10,N,N,-,-1,-1
REOPER.txt,727724,728492,768,10,N,N,-,-1,-1
REOPER.txt,727860,728620,760,10,N,N,-,-1,-1
REOPER.txt,728020,728636,616,10,N,N,-,-1,-1
REOPER.txt,728049,728736,687,10,N,N,-,-1,-1
REOPER.txt,728092,728826,734,10,N,N,-,-1,-1
REOPER.txt,728130,728901,771,10,N,N,-,-1,-1
REOPER.txt,728201,729358,1157,10,N,N,-,-1,-1
REOPER.txt,728297,729636,1339,10,N,N,-,-1,-1
REOPER.txt,728321,729952,1631,10,N,N,-,-1,-1
REOPER.txt,728382,730155,1773,10,N,N,-,-1,-1
REOPER.txt,728493,730172,1679,10,N,N,-,-1,-1
REOPER.txt,728621,730394,1773,10,N,N,-,-1,-1
REOPER.txt,728637,730457,1820,10,N,N,-,-1,-1
REOPER.txt,728737,730543,1806,10,N,N,-,-1,-1
REOPER.txt,728827,730680,1853,10,N,N,-,-1,-1
REOPER.txt,728904,730846,1942,10,N,N,-,-1,-1
REOPER.txt,729361,731035,1674,10,N,N,-,-1,-1
REOPER.txt,729637,731123,1486,10,N,N,-,-1,-1
REOPER.txt,729953,731183,1230,10,N,N,-,-1,-1
REOPER.txt,730155,731206,1051,10,N,N,-,-1,-1
REOPER.txt,730173,731214,1041,10,N,N,-,-1,-1
REOPER.txt,730397,731290,893,10,N,N,-,-1,-1
REOPER.txt,730457,731384,927,10,N,N,-,-1,-1
REOPER.txt,730544,731556,1012,10,N,N,-,-1,-1
REOPER.txt,730681,731725,1044,10,N,N,-,-1,-1
REOPER.txt,730849,731804,955,10,N,N,-,-1,-1
REOPER.txt,731036,731986,950,10,N,N,-,-1,-1
REOPER.txt,731124,732052,928,10,N,N,-,-1,-1
REOPER.txt,731184,732182,998,10,N,N,-,-1,-1
REOPER.txt,731207,732336,1129,10,N,N,-,-1,-1
REOPER.txt,731215,732441,1226,10,N,N,-,-1,-1
REOPER.txt,731291,732514,1223,10,N,N,-,-1,-1
REOPER.txt,731387,732624,1237,10,N,N,-,-1,-1
REOPER.txt,731557,732860,1303,10,N,N,-,-1,-1
REOPER.txt,731726,732913,1187,10,N,N,-,-1,-1
REOPER.txt,731807,732930,1123,10,N,N,-,-1,-1
REOPER.txt,731987,733056,1069,10,N,N,-,-1,-1
REOPER.txt,732055,733269,1214,10,N,N,-,-1,-1
REOPER.txt,732183,733302,1119,10,N,N,-,-1,-1
REOPER.txt,732338,733644,1306,10,N,N,-,-1,-1
REOPER.txt,732442,733966,1524,10,N,N,-,-1,-1
REOPER.txt,732515,734077,1562,10,N,N,-,-1,-1
REOPER.txt,732626,734279,1653,10,N,N,-,-1,-1
REOPER.txt,732861,734328,1467,10,N,N,-,-1,-1
REOPER.txt,732913,734595,1682,10,N,N,-,-1,-1
REOPER.txt,732931,734851,1920,10,N,N,-,-1,-1
REOPER.txt,733057,734960,1903,10,N,N,-,-1,-1
REOPER.txt,733274,735017,1743,10,N,N,-,-1,-1
REOPER.txt,733303,735276,1973,10,N,N,-,-1,-1
REOPER.txt,733644,735361,1717,10,N,N,-,-1,-1
REOPER.txt,733966,735397,1431,10,N,N,-,-1,-1
REOPER.txt,734079,735699,1620,10,N,N,-,-1,-1
REOPER.txt,734280,735748,1468,10,N,N,-,-1,-1
REOPER.txt,734329,735893,1564,10,N,N,-,-1,-1
REOPER.txt,734596,736339,1743,10,N,N,-,-1,-1
REOPER.txt,734852,736665,1813,10,N,N,-,-1,-1
REOPER.txt,734961,736722,1761,10,N,N,-,-1,-1
REOPER.txt,735018,736811,1793,10,N,N,-,-1,-1
REOPER.txt,735277,737179,1902,10,N,N,-,-1,-1
REOPER.txt,735366,737250,1884,10,N,N,-,-1,-1
REOPER.txt,735400,737262,1862,10,N,N,-,-1,-1
REOPER.txt,735702,737401,1699,10,N,N,-,-1,-1
REOPER.txt,735750,737533,1783,10,N,N,-,-1,-1
REOPER.txt,735896,737621,1725,10,N,N,-,-1,-1
REOPER.txt,736340,737816,1476,10,N,N,-,-1,-1
REOPER.txt,736667,738093,1426,10,N,N,-,-1,-1
REOPER.txt,736724,738369,1645,10,N,N,-,-1,-1
REOPER.txt,736812,738561,1749,10,N,N,-,-1,-1
REOPER.txt,737180,738854,1674,10,N,N,-,-1,-1
REOPER.txt,737251,739153,1902,10,N,N,-,-1,-1
REOPER.txt,737263,739195,1932,10,N,N,-,-1,-1
REOPER.txt,737402,739272,1870,10,N,N,-,-1,-1
REOPER.txt,737534,739308,1774,10,N,N,-,-1,-1
REOPER.txt,737622,739410,1788,10,N,N,-,-1,-1
REOPER.txt,737817,739499,1682,10,N,N,-,-1,-1
REOPER.txt,738094,739815,1721,10,N,N,-,-1,-1
REOPER.txt,738369,739930,1561,10,N,N,-,-1,-1
REOPER.txt,738562,740129,1567,10,N,N,-,-1,-1
REOPER.txt,738855,740213,1358,10,N,N,-,-1,-1
REOPER.txt,739154,740298,1144,10,N,N,-,-1,-1
REOPER.txt,739196,740370,1174,10,N,N,-,-1,-1
REOPER.txt,739277,740543,1266,10,N,N,-,-1,-1
REOPER.txt,739311,740720,1409,10,Y,N,-,-1,-1
REOPER.txt,739413,740800,1387,10,Y,N,-,-1,-1
REOPER.txt,739500,741016,1516,10,Y,N,-,-1,-1
REOPER.txt,739816,741255,1439,10,Y,N,-,-1,-1
REOPER.txt,739931,741344,1413,10,Y,N,-,-1,-1
REOPER.txt,740130,741429,1299,10,Y,N,-,-1,-1
REOPER.txt,740215,741541,1326,10,N,N,-,-1,-1
REOPER.txt,740299,742027,1728,10,N,N,-,-1,-1
REOPER.txt,740371,742116,1745,10,N,N,-,-1,-1
REOPER.txt,740546,742171,1625,10,N,N,-,-1,-1
REOPER.txt,740722,742436,1714,10,Y,N,-,-1,-1
REOPER.txt,740801,743040,2239,10,N,N,-,-1,-1
REOPER.txt,741017,743082,2065,10,N,N,-,-1,-1
REOPER.txt,741256,743111,1855,10,N,N,-,-1,-1
REOPER.txt,741347,743467,2120,10,N,N,-,-1,-1
REOPER.txt,741430,743492,2062,10,N,N,-,-1,-1
REOPER.txt,741541,743689,2148,10,N,N,-,-1,-1
REOPER.txt,742028,743900,1872,10,N,N,-,-1,-1
REOPER.txt,742117,744300,2183,10,N,N,-,-1,-1
REOPER.txt,742171,744524,2353,10,N,N,-,-1,-1
REOPER.txt,742437,744623,2186,10,N,N,-,-1,-1
REOPER.txt,743043,744724,1681,10,N,N,-,-1,-1
REOPER.txt,743085,744808,1723,10,N,N,-,-1,-1
REOPER.txt,743112,744888,1776,10,N,N,-,-1,-1
REOPER.txt,743472,744988,1516,10,N,N,-,-1,-1
REOPER.txt,743495,745083,1588,10,N,N,-,-1,-1
REOPER.txt,743691,745356,1665,10,N,N,-,-1,-1
REOPER.txt,743901,745408,1507,10,N,N,-,-1,-1
REOPER.txt,744301,745447,1146,10,N,N,-,-1,-1
REOPER.txt,744527,745610,1083,10,N,N,-,-1,-1
REOPER.txt,744624,745923,1299,10,N,N,-,-1,-1
REOPER.txt,744725,746056,1331,10,N,N,-,-1,-1
REOPER.txt,744809,746100,1291,10,N,N,-,-1,-1
REOPER.txt,744889,746206,1317,10,N,N,-,-1,-1
REOPER.txt,744991,746300,1309,10,N,N,-,-1,-1
REOPER.txt,745086,746344,1258,10,N,N,-,-1,-1
REOPER.txt,745357,746434,1077,10,N,N,-,-1,-1
REOPER.txt,745409,746551,1142,10,N,N,-,-1,-1
REOPER.txt,745448,746694,1246,10,N,N,-,-1,-1
REOPER.txt,745611,746796,1185,10,N,N,-,-1,-1
REOPER.txt,745926,746840,914,10,N,N,-,-1,-1
REOPER.txt,746057,746896,839,10,N,N,-,-1,-1
REOPER.txt,746101,747162,1061,10,N,N,-,-1,-1
REOPER.txt,746207,747448,1241,10,N,N,-,-1,-1
REOPER.txt,746302,747480,1178,10,N,N,-,-1,-1
REOPER.txt,746345,747519,1174,10,N,N,-,-1,-1
REOPER.txt,746435,747560,1125,10,N,N,-,-1,-1
REOPER.txt,746552,747595,1043,10,N,N,-,-1,-1
REOPER.txt,746695,747745,1050,10,N,N,-,-1,-1
REOPER.txt,746797,748170,1373,10,N,N,-,-1,-1
REOPER.txt,746841,748248,1407,10,N,N,-,-1,-1
REOPER.txt,746897,748499,1602,10,N,N,-,-1,-1
REOPER.txt,747163,748618,1455,10,N,N,-,-1,-1
REOPER.txt,747449,748690,1241,10,Y,N,-,-1,-1
REOPER.txt,747481,748755,1274,10,Y,N,-,-1,-1
REOPER.txt,747520,748941,1421,10,Y,N,-,-1,-1
REOPER.txt,747561,749087,1526,10,Y,N,-,-1,-1
REOPER.txt,747597,749265,1668,10,Y,N,-,-1,-1
REOPER.txt,747746,749348,1602,10,Y,N,-,-1,-1
REOPER.txt,748171,749594,1423,10,Y,N,-,-1,-1
REOPER.txt,748249,749863,1614,10,Y,N,-,-1,-1
REOPER.txt,748500,750081,1581,10,Y,N,-,-1,-1
REOPER.txt,748619,750375,1756,10,Y,N,-,-1,-1
REOPER.txt,748693,750456,1763,10,Y,N,-,-1,-1
REOPER.txt,748758,750624,1866,10,Y,N,-,-1,-1
REOPER.txt,748942,750962,2020,10,Y,N,-,-1,-1
REOPER.txt,749088,751176,2088,10,Y,N,-,-1,-1
REOPER.txt,749267,751344,2077,10,Y,N,-,-1,-1
REOPER.txt,749349,751497,2148,10,Y,N,-,-1,-1
REOPER.txt,749595,751695,2100,10,N,N,-,-1,-1
REOPER.txt,749864,751976,2112,10,N,N,-,-1,-1
REOPER.txt,750082,752134,2052,10,N,N,-,-1,-1
REOPER.txt,750378,752232,1854,10,N,N,-,-1,-1
REOPER.txt,750457,752436,1979,10,N,N,-,-1,-1
REOPER.txt,750625,752648,2023,10,N,N,-,-1,-1
REOPER.txt,750964,752809,1845,10,N,N,-,-1,-1
REOPER.txt,751177,752971,1794,10,N,N,-,-1,-1
REOPER.txt,751345,753008,1663,10,N,N,-,-1,-1
REOPER.txt,751498,753077,1579,10,N,N,-,-1,-1
REOPER.txt,751696,753368,1672,10,N,N,-,-1,-1
REOPER.txt,751979,753717,1738,10,N,N,-,-1,-1
REOPER.txt,752135,753850,1715,10,Y,N,-,-1,-1
REOPER.txt,752235,753966,1731,10,Y,N,-,-1,-1
REOPER.txt,752437,754008,1571,10,Y,N,-,-1,-1
REOPER.txt,752649,754093,1444,10,N,N,-,-1,-1
REOPER.txt,752812,754350,1538,10,N,N,-,-1,-1
REOPER.txt,752972,754551,1579,10,N,N,-,-1,-1
REOPER.txt,753009,754887,1878,10,N,N,-,-1,-1
REOPER.txt,753078,754978,1900,10,N,N,-,-1,-1
REOPER.txt,753369,755280,1911,10,N,N,-,-1,-1
REOPER.txt,753720,755393,1673,10,N,N,-,-1,-1
REOPER.txt,753851,755497,1646,10,N,N,-,-1,-1
REOPER.txt,753967,755632,1665,10,N,N,-,-1,-1
REOPER.txt,754009,755694,1685,10,N,N,-,-1,-1
REOPER.txt,754094,755770,1676,10,N,N,-,-1,-1
REOPER.txt,754351,755907,1556,10,N,N,-,-1,-1
REOPER.txt,754554,756082,1528,10,N,N,-,-1,-1
REOPER.txt,754888,756151,1263,10,N,N,-,-1,-1
REOPER.txt,754979,756260,1281,10,N,N,-,-1,-1
REOPER.txt,755281,756431,1150,10,N,N,-,-1,-1
REOPER.txt,755394,756701,1307,10,N,N,-,-1,-1
REOPER.txt,755500,756804,1304,10,N,N,-,-1,-1
REOPER.txt,755633,756880,1247,10,N,N,-,-1,-1
REOPER.txt,755697,756928,1231,10,N,N,-,-1,-1
REOPER.txt,755771,756955,1184,10,N,N,-,-1,-1
REOPER.txt,755908,757133,1225,10,N,N,-,-1,-1
REOPER.txt,756084,757307,1223,10,N,N,-,-1,-1
REOPER.txt,756152,757392,1240,10,N,N,-,-1,-1
REOPER.txt,756261,757457,1196,10,N,N,-,-1,-1
REOPER.txt,756432,757487,1055,10,N,N,-,-1,-1
REOPER.txt,756702,757550,848,10,N,N,-,-1,-1
REOPER.txt,756807,757716,909,10,N,N,-,-1,-1
REOPER.txt,756881,757781,900,10,N,N,-,-1,-1
REOPER.txt,756929,757952,1023,10,N,N,-,-1,-1
REOPER.txt,756958,758054,1096,10,N,N,-,-1,-1
REOPER.txt,757134,758294,1160,10,N,N,-,-1,-1
REOPER.txt,757308,758543,1235,10,N,N,-,-1,-1
REOPER.txt,757393,758910,1517,10,Y,N,-,-1,-1
REOPER.txt,757462,758948,1486,10,Y,N,-,-1,-1
REOPER.txt,757488,759062,1574,10,Y,N,-,-1,-1
REOPER.txt,757550,759212,1662,10,N,N,-,-1,-1
REOPER.txt,757717,759218,1501,10,N,N,-,-1,-1
REOPER.txt,757782,759330,1548,10,N,N,-,-1,-1
REOPER.txt,757953,759457,1504,10,N,N,-,-1,-1
REOPER.txt,758055,759493,1438,10,N,N,-,-1,-1
REOPER.txt,758297,759677,1380,10,N,N,-,-1,-1
REOPER.txt,758544,759897,1353,10,N,N,-,-1,-1
REOPER.txt,758911,760135,1224,10,N,N,-,-1,-1
REOPER.txt,758949,760367,1418,10,N,N,-,-1,-1
REOPER.txt,759063,760497,1434,10,N,N,-,-1,-1
REOPER.txt,759214,760731,1517,10,Y,N,-,-1,-1
REOPER.txt,759219,760866,1647,10,Y,N,-,-1,-1
REOPER.txt,759332,761007,1675,10,Y,N,-,-1,-1
REOPER.txt,759462,761102,1640,10,Y,N,-,-1,-1
REOPER.txt,759496,761249,1753,10,Y,N,-,-1,-1
REOPER.txt,759678,761403,1725,10,Y,N,-,-1,-1
REOPER.txt,759898,761507,1609,10,Y,N,-,-1,-1
REOPER.txt,760136,761603,1467,10,N,N,-,-1,-1
REOPER.txt,760369,761715,1346,10,N,N,-,-1,-1
REOPER.txt,760498,761957,1459,10,N,N,-,-1,-1
REOPER.txt,760732,762134,1402,10,N,N,-,-1,-1
REOPER.txt,760867,762439,1572,10,N,N,-,-1,-1
REOPER.txt,761010,762774,1764,10,N,N,-,-1,-1
REOPER.txt,761103,762869,1766,10,N,N,-,-1,-1
REOPER.txt,761250,762939,1689,10,N,N,-,-1,-1
REOPER.txt,761404,763074,1670,10,N,N,-,-1,-1
REOPER.txt,761508,763101,1593,10,N,N,-,-1,-1
REOPER.txt,761604,763276,1672,10,Y,N,-,-1,-1
REOPER.txt,761716,763425,1709,10,Y,N,-,-1,-1
REOPER.txt,761958,763693,1735,10,Y,N,-,-1,-1
REOPER.txt,762136,763854,1718,10,Y,N,-,-1,-1
REOPER.txt,762440,764065,1625,10,Y,N,-,-1,-1
REOPER.txt,762775,764319,1544,10,Y,N,-,-1,-1
REOPER.txt,762870,764413,1543,10,Y,N,-,-1,-1
REOPER.txt,762940,764753,1813,10,Y,N,-,-1,-1
REOPER.txt,763077,764893,1816,10,Y,N,-,-1,-1
REOPER.txt,763102,764930,1828,10,Y,N,-,-1,-1
REOPER.txt,763277,765169,1892,10,N,N,-,-1,-1
REOPER.txt,763428,765342,1914,10,N,N,-,-1,-1
REOPER.txt,763694,765386,1692,10,N,N,-,-1,-1
REOPER.txt,763855,765681,1826,10,N,N,-,-1,-1
REOPER.txt,764066,765787,1721,10,N,N,-,-1,-1
REOPER.txt,764320,765822,1502,10,N,N,-,-1,-1
REOPER.txt,764413,765952,1539,10,N,N,-,-1,-1
REOPER.txt,764754,766091,1337,10,N,N,-,-1,-1
REOPER.txt,764898,766197,1299,10,N,N,-,-1,-1
REOPER.txt,764931,766400,1469,10,N,N,-,-1,-1
REOPER.txt,765170,766505,1335,10,N,N,-,-1,-1
REOPER.txt,765343,766643,1300,10,N,N,-,-1,-1
REOPER.txt,765388,766787,1399,10,N,N,-,-1,-1
REOPER.txt,765682,766892,1210,10,N,N,-,-1,-1
REOPER.txt,765788,767026,1238,10,N,N,-,-1,-1
REOPER.txt,765823,767116,1293,10,N,N,-,-1,-1
REOPER.txt,765953,767211,1258,10,N,N,-,-1,-1
REOPER.txt,766094,767271,1177,10,N,N,-,-1,-1
REOPER.txt,766199,767373,1174,10,N,N,-,-1,-1
REOPER.txt,766401,767618,1217,10,N,N,-,-1,-1
REOPER.txt,766506,767915,1409,10,N,N,-,-1,-1
REOPER.txt,766644,767989,1345,10,N,N,-,-1,-1
REOPER.txt,766790,768067,1277,10,N,N,-,-1,-1
REOPER.txt,766893,768224,1331,10,N,N,-,-1,-1
REOPER.txt,767029,768356,1327,10,N,N,-,-1,-1
REOPER.txt,767117,768454,1337,10,N,N,-,-1,-1
REOPER.txt,767212,768584,1372,10,N,N,-,-1,-1
REOPER.txt,767272,768682,1410,10,N,N,-,-1,-1
REOPER.txt,767374,769408,2034,10,N,N,-,-1,-1
REOPER.txt,767619,769636,2017,10,N,N,-,-1,-1
REOPER.txt,767917,769827,1910,10,N,N,-,-1,-1
REOPER.txt,767990,769913,1923,10,N,N,-,-1,-1
REOPER.txt,768068,770017,1949,10,N,N,-,-1,-1
REOPER.txt,768227,770129,1902,10,N,N,-,-1,-1
REOPER.txt,768357,770196,1839,10,N,N,-,-1,-1
REOPER.txt,768455,770343,1888,10,N,N,-,-1,-1
REOPER.txt,768585,770382,1797,10,N,N,-,-1,-1
REOPER.txt,768683,770461,1778,10,N,N,-,-1,-1
REOPER.txt,769409,770491,1082,10,N,N,-,-1,-1
REOPER.txt,769637,770564,927,10,N,N,-,-1,-1
REOPER.txt,769828,770674,846,10,N,N,-,-1,-1
REOPER.txt,769914,770886,972,10,N,N,-,-1,-1
REOPER.txt,770018,771018,1000,10,N,N,-,-1,-1
REOPER.txt,770130,771183,1053,10,N,N,-,-1,-1
REOPER.txt,770198,771270,1072,10,N,N,-,-1,-1
REOPER.txt,770344,771366,1022,10,N,N,-,-1,-1
REOPER.txt,770383,771443,1060,10,N,N,-,-1,-1
REOPER.txt,770464,771550,1086,10,N,N,-,-1,-1
REOPER.txt,770492,771759,1267,10,N,N,-,-1,-1
REOPER.txt,770565,771848,1283,10,N,N,-,-1,-1
REOPER.txt,770674,771987,1313,10,N,N,-,-1,-1
REOPER.txt,770887,772081,1194,10,N,N,-,-1,-1
REOPER.txt,771019,772290,1271,10,N,N,-,-1,-1
REOPER.txt,771184,772309,1125,10,N,N,-,-1,-1
REOPER.txt,771272,772462,1190,10,N,N,-,-1,-1
REOPER.txt,771367,772608,1241,10,N,N,-,-1,-1
REOPER.txt,771444,772679,1235,10,N,N,-,-1,-1
REOPER.txt,771551,772863,1312,10,Y,N,-,-1,-1
REOPER.txt,771762,772970,1208,10,N,N,-,-1,-1
REOPER.txt,771849,773068,1219,10,Y,N,-,-1,-1
REOPER.txt,771988,773224,1236,10,Y,N,-,-1,-1
REOPER.txt,772083,773293,1210,10,Y,N,-,-1,-1
REOPER.txt,772295,773401,1106,10,Y,N,-,-1,-1
REOPER.txt,772310,773633,1323,10,Y,N,-,-1,-1
REOPER.txt,772463,773766,1303,10,Y,N,-,-1,-1
REOPER.txt,772609,773851,1242,10,Y,N,-,-1,-1
REOPER.txt,772680,774035,1355,10,Y,N,-,-1,-1
REOPER.txt,772864,774094,1230,10,N,N,-,-1,-1
REOPER.txt,772971,774310,1339,10,N,N,-,-1,-1
REOPER.txt,773069,774483,1414,10,N,N,-,-1,-1
REOPER.txt,773225,774636,1411,10,N,N,-,-1,-1
REOPER.txt,773294,774783,1489,10,N,N,-,-1,-1
REOPER.txt,773404,775282,1878,10,Y,N,-,-1,-1
REOPER.txt,773636,775476,1840,10,N,N,-,-1,-1
REOPER.txt,773767,775698,1931,10,Y,N,-,-1,-1
REOPER.txt,773853,775920,2067,10,Y,N,-,-1,-1
REOPER.txt,774036,775938,1902,10,Y,N,-,-1,-1
REOPER.txt,774097,776084,1987,10,Y,N,-,-1,-1
REOPER.txt,774311,776287,1976,10,Y,N,-,-1,-1
REOPER.txt,774485,776488,2003,10,Y,N,-,-1,-1
REOPER.txt,774637,776667,2030,10,Y,N,-,-1,-1
REOPER.txt,774784,776803,2019,10,Y,N,-,-1,-1
REOPER.txt,775283,776948,1665,10,N,N,-,-1,-1
REOPER.txt,775477,777100,1623,10,N,N,-,-1,-1
REOPER.txt,775699,777265,1566,10,N,N,-,-1,-1
REOPER.txt,775921,777367,1446,10,N,N,-,-1,-1
REOPER.txt,775939,777503,1564,10,N,N,-,-1,-1
REOPER.txt,776084,777591,1507,10,N,N,-,-1,-1
REOPER.txt,776288,777696,1408,10,N,N,-,-1,-1
REOPER.txt,776491,777772,1281,10,N,N,-,-1,-1
REOPER.txt,776668,777972,1304,10,N,N,-,-1,-1
REOPER.txt,776806,778105,1299,10,N,N,-,-1,-1
REOPER.txt,776950,778141,1191,10,N,N,-,-1,-1
REOPER.txt,777101,778395,1294,10,N,N,-,-1,-1
REOPER.txt,777266,778597,1331,10,N,N,-,-1,-1
REOPER.txt,777368,778664,1296,10,N,N,-,-1,-1
REOPER.txt,777504,778766,1262,10,N,N,-,-1,-1
REOPER.txt,777592,778931,1339,10,N,N,-,-1,-1
REOPER.txt,777697,779082,1385,10,N,N,-,-1,-1
REOPER.txt,777773,779121,1348,10,N,N,-,-1,-1
REOPER.txt,777973,779213,1240,10,N,N,-,-1,-1
REOPER.txt,778110,779249,1139,10,N,N,-,-1,-1
REOPER.txt,778144,779287,1143,10,N,N,-,-1,-1
REOPER.txt,778396,779295,899,10,N,N,-,-1,-1
REOPER.txt,778598,779374,776,10,N,N,-,-1,-1
REOPER.txt,778665,779441,776,10,N,N,-,-1,-1
REOPER.txt,778767,779694,927,10,N,N,-,-1,-1
REOPER.txt,778932,779818,886,10,N,N,-,-1,-1
REOPER.txt,779083,779884,801,10,N,N,-,-1,-1
REOPER.txt,779123,779960,837,10,N,N,-,-1,-1
REOPER.txt,779214,779961,747,10,N,N,-,-1,-1
REOPER.txt,779250,779990,740,10,N,N,-,-1,-1
REOPER.txt,779289,780157,868,10,N,N,-,-1,-1
REOPER.txt,779296,780232,936,10,N,N,-,-1,-1
REOPER.txt,779375,780435,1060,10,N,N,-,-1,-1
REOPER.txt,779442,780553,1111,10,N,N,-,-1,-1
REOPER.txt,779695,780759,1064,10,N,N,-,-1,-1
REOPER.txt,779819,780856,1037,10,N,N,-,-1,-1
REOPER.txt,779885,780994,1109,10,N,N,-,-1,-1
REOPER.txt,779960,781114,1154,10,N,N,-,-1,-1
REOPER.txt,779962,781369,1407,10,N,N,-,-1,-1
REOPER.txt,779991,781497,1506,10,N,N,-,-1,-1
REOPER.txt,780160,781730,1570,10,N,N,-,-1,-1
REOPER.txt,780232,781865,1633,10,N,N,-,-1,-1
REOPER.txt,780436,781901,1465,10,Y,N,-,-1,-1
REOPER.txt,780554,781918,1364,10,Y,N,-,-1,-1
REOPER.txt,780760,782042,1282,10,Y,N,-,-1,-1
REOPER.txt,780858,782087,1229,10,N,N,-,-1,-1
REOPER.txt,780995,782409,1414,10,N,N,-,-1,-1
REOPER.txt,781115,782558,1443,10,N,N,-,-1,-1
REOPER.txt,781370,782687,1317,10,N,N,-,-1,-1
REOPER.txt,781498,782698,1200,10,N,N,-,-1,-1
REOPER.txt,781731,782865,1134,10,N,N,-,-1,-1
REOPER.txt,781870,783099,1229,10,N,N,-,-1,-1
REOPER.txt,781904,783246,1342,10,N,N,-,-1,-1
REOPER.txt,781919,783475,1556,10,N,N,-,-1,-1
REOPER.txt,782043,783730,1687,10,N,N,-,-1,-1
REOPER.txt,782088,783774,1686,10,N,N,-,-1,-1
REOPER.txt,782411,783884,1473,10,N,N,-,-1,-1
REOPER.txt,782559,784063,1504,10,N,N,-,-1,-1
REOPER.txt,782688,784204,1516,10,N,N,-,-1,-1
REOPER.txt,782700,784430,1730,10,N,N,-,-1,-1
REOPER.txt,782866,784544,1678,10,N,N,-,-1,-1
REOPER.txt,783100,784643,1543,10,N,N,-,-1,-1
REOPER.txt,783247,784819,1572,10,N,N,-,-1,-1
REOPER.txt,783478,784954,1476,10,N,N,-,-1,-1
REOPER.txt,783731,785044,1313,10,N,N,-,-1,-1
REOPER.txt,783775,785207,1432,10,N,N,-,-1,-1
REOPER.txt,783885,785262,1377,10,N,N,-,-1,-1
REOPER.txt,784066,785329,1263,10,N,N,-,-1,-1
REOPER.txt,784205,785357,1152,10,N,N,-,-1,-1
REOPER.txt,784431,785378,947,10,N,N,-,-1,-1
REOPER.txt,784545,785390,845,10,N,N,-,-1,-1
REOPER.txt,784644,785428,784,10,N,N,-,-1,-1
REOPER.txt,784821,785460,639,10,N,N,-,-1,-1
REOPER.txt,784955,785485,530,10,N,N,-,-1,-1
REOPER.txt,785045,785503,458,10,N,N,-,-1,-1
REOPER.txt,785208,785532,324,10,N,N,-,-1,-1
REOPER.txt,785263,785568,305,10,N,N,-,-1,-1
REOPER.txt,785330,785596,266,10,N,N,-,-1,-1
REOPER.txt,785358,785620,262,10,N,N,-,-1,-1
REOPER.txt,785379,785646,267,10,N,N,-,-1,-1
REOPER.txt,785391,785726,335,10,N,N,-,-1,-1
REOPER.txt,785429,786123,694,10,N,N,-,-1,-1
REOPER.txt,785461,786491,1030,10,N,N,-,-1,-1
REOPER.txt,785486,786553,1067,10,N,N,-,-1,-1
REOPER.txt,785504,786870,1366,10,N,N,-,-1,-1
REOPER.txt,785537,786984,1447,10,N,N,-,-1,-1
REOPER.txt,785571,787178,1607,10,N,N,-,-1,-1
REOPER.txt,785597,787275,1678,10,N,N,-,-1,-1
REOPER.txt,785622,787408,1786,10,N,N,-,-1,-1
REOPER.txt,785647,787595,1948,10,N,N,-,-1,-1
REOPER.txt,785729,787719,1990,10,N,N,-,-1,-1
REOPER.txt,786124,787925,1801,10,N,N,-,-1,-1
REOPER.txt,786492,788102,1610,10,N,N,-,-1,-1
REOPER.txt,786554,788266,1712,10,N,N,-,-1,-1
REOPER.txt,786871,788415,1544,10,N,N,-,-1,-1
REOPER.txt,786985,788511,1526,10,N,N,-,-1,-1
REOPER.txt,787179,788537,1358,10,N,N,-,-1,-1
REOPER.txt,787277,788621,1344,10,N,N,-,-1,-1
REOPER.txt,787409,789480,2071,10,N,N,-,-1,-1
REOPER.txt,787596,789751,2155,10,N,N,-,-1,-1
REOPER.txt,787722,789992,2270,10,N,N,-,-1,-1
REOPER.txt,787926,790102,2176,10,N,N,-,-1,-1
REOPER.txt,788103,790200,2097,10,N,N,-,-1,-1
REOPER.txt,788269,790443,2174,10,N,N,-,-1,-1
REOPER.txt,788416,790649,2233,10,N,N,-,-1,-1
REOPER.txt,788516,790840,2324,10,N,N,-,-1,-1
REOPER.txt,788540,790887,2347,10,N,N,-,-1,-1
REOPER.txt,788622,791263,2641,10,N,N,-,-1,-1
REOPER.txt,789483,791390,1907,10,N,N,-,-1,-1
REOPER.txt,789753,791583,1830,10,N,N,-,-1,-1
REOPER.txt,789993,791679,1686,10,N,N,-,-1,-1
REOPER.txt,790103,791802,1699,10,Y,N,-,-1,-1
REOPER.txt,790201,791919,1718,10,Y,N,-,-1,-1
REOPER.txt,790446,792020,1574,10,Y,N,-,-1,-1
REOPER.txt,790650,792149,1499,10,Y,N,-,-1,-1
REOPER.txt,790842,792202,1360,10,Y,N,-,-1,-1
REOPER.txt,790888,792375,1487,10,Y,N,-,-1,-1
REOPER.txt,791264,792560,1296,10,Y,N,-,-1,-1
REOPER.txt,791393,792658,1265,10,Y,N,-,-1,-1
REOPER.txt,791584,792970,1386,10,Y,N,-,-1,-1
REOPER.txt,791680,793066,1386,10,Y,N,-,-1,-1
REOPER.txt,791803,793261,1458,10,N,N,-,-1,-1
REOPER.txt,791920,793427,1507,10,N,N,-,-1,-1
REOPER.txt,792023,793628,1605,10,N,N,-,-1,-1
REOPER.txt,792150,793694,1544,10,N,N,-,-1,-1
REOPER.txt,792205,793841,1636,10,N,N,-,-1,-1
REOPER.txt,792377,793864,1487,10,N,N,-,-1,-1
REOPER.txt,792561,794111,1550,10,N,N,-,-1,-1
REOPER.txt,792660,794206,1546,10,Y,N,-,-1,-1
REOPER.txt,792971,794294,1323,10,N,N,-,-1,-1
REOPER.txt,793067,794376,1309,10,N,N,-,-1,-1
REOPER.txt,793264,794415,1151,10,N,N,-,-1,-1
REOPER.txt,793428,794495,1067,10,N,N,-,-1,-1
REOPER.txt,793629,794523,894,10,N,N,-,-1,-1
REOPER.txt,793695,794536,841,10,N,N,-,-1,-1
REOPER.txt,793846,794747,901,10,N,N,-,-1,-1
REOPER.txt,793865,794914,1049,10,N,N,-,-1,-1
REOPER.txt,794112,795010,898,10,N,N,-,-1,-1
REOPER.txt,794207,795319,1112,10,N,N,-,-1,-1
REOPER.txt,794295,795456,1161,10,N,N,-,-1,-1
REOPER.txt,794376,795532,1156,10,N,N,-,-1,-1
REOPER.txt,794416,795568,1152,10,N,N,-,-1,-1
REOPER.txt,794496,795630,1134,10,N,N,-,-1,-1
REOPER.txt,794524,795933,1409,10,N,N,-,-1,-1
REOPER.txt,794539,796280,1741,10,Y,N,-,-1,-1
REOPER.txt,794750,796482,1732,10,N,N,-,-1,-1
REOPER.txt,794916,796558,1642,10,N,N,-,-1,-1
REOPER.txt,795011,796686,1675,10,N,N,-,-1,-1
REOPER.txt,795322,796969,1647,10,Y,N,-,-1,-1
REOPER.txt,795457,797054,1597,10,Y,N,-,-1,-1
REOPER.txt,795537,797249,1712,10,Y,N,-,-1,-1
REOPER.txt,795571,797336,1765,10,Y,N,-,-1,-1
REOPER.txt,795631,797390,1759,10,Y,N,-,-1,-1
REOPER.txt,795934,797558,1624,10,Y,N,-,-1,-1
REOPER.txt,796281,797596,1315,10,Y,N,-,-1,-1
REOPER.txt,796483,797815,1332,10,Y,N,-,-1,-1
REOPER.txt,796560,797905,1345,10,Y,N,-,-1,-1
REOPER.txt,796687,798057,1370,10,Y,N,-,-1,-1
REOPER.txt,796969,798402,1433,10,Y,N,-,-1,-1
REOPER.txt,797057,798832,1775,10,N,N,-,-1,-1
REOPER.txt,797250,798983,1733,10,N,N,-,-1,-1
REOPER.txt,797337,799446,2109,10,N,N,-,-1,-1
REOPER.txt,797391,799527,2136,10,N,N,-,-1,-1
REOPER.txt,797563,799864,2301,10,N,N,-,-1,-1
REOPER.txt,797597,799953,2356,10,N,N,-,-1,-1
REOPER.txt,797816,800095,2279,10,N,N,-,-1,-1
REOPER.txt,797906,800349,2443,10,N,N,-,-1,-1
REOPER.txt,798058,800723,2665,10,N,N,-,-1,-1
REOPER.txt,798405,800838,2433,10,N,N,-,-1,-1
REOPER.txt,798833,801003,2170,10,N,N,-,-1,-1
REOPER.txt,798984,801291,2307,10,N,N,-,-1,-1
REOPER.txt,799449,801397,1948,10,N,N,-,-1,-1
REOPER.txt,799528,801444,1916,10,N,N,-,-1,-1
REOPER.txt,799865,801488,1623,10,N,N,-,-1,-1
REOPER.txt,799954,801720,1766,10,N,N,-,-1,-1
REOPER.txt,800096,801784,1688,10,N,N,-,-1,-1
REOPER.txt,800352,801810,1458,10,N,N,-,-1,-1
REOPER.txt,800724,802328,1604,10,N,N,-,-1,-1
REOPER.txt,800839,802389,1550,10,N,N,-,-1,-1
REOPER.txt,801006,802484,1478,10,N,N,-,-1,-1
REOPER.txt,801292,802585,1293,10,N,N,-,-1,-1
REOPER.txt,801398,802637,1239,10,N,N,-,-1,-1
REOPER.txt,801445,802793,1348,10,N,N,-,-1,-1
REOPER.txt,801489,802879,1390,10,N,N,-,-1,-1
REOPER.txt,801723,803070,1347,10,N,N,-,-1,-1
REOPER.txt,801785,803374,1589,10,N,N,-,-1,-1
REOPER.txt,801811,803550,1739,10,N,N,-,-1,-1
REOPER.txt,802331,803644,1313,10,N,N,-,-1,-1
REOPER.txt,802390,803782,1392,10,N,N,-,-1,-1
REOPER.txt,802486,803869,1383,10,N,N,-,-1,-1
REOPER.txt,802586,803994,1408,10,N,N,-,-1,-1
REOPER.txt,802638,804056,1418,10,N,N,-,-1,-1
REOPER.txt,802794,804222,1428,10,N,N,-,-1,-1
REOPER.txt,802880,804259,1379,10,N,N,-,-1,-1
REOPER.txt,803073,804371,1298,10,N,N,-,-1,-1
REOPER.txt,803375,804458,1083,10,N,N,-,-1,-1
REOPER.txt,803553,804520,967,10,N,N,-,-1,-1
REOPER.txt,803645,804650,1005,10,N,N,-,-1,-1
REOPER.txt,803783,804816,1033,10,N,N,-,-1,-1
REOPER.txt,803871,804833,962,10,N,N,-,-1,-1
REOPER.txt,803995,804965,970,10,N,N,-,-1,-1
REOPER.txt,804059,805110,1051,10,N,N,-,-1,-1
REOPER.txt,804223,805328,1105,10,N,N,-,-1,-1
REOPER.txt,804260,805431,1171,10,N,N,-,-1,-1
REOPER.txt,804372,805487,1115,10,N,N,-,-1,-1
REOPER.txt,804461,805565,1104,10,N,N,-,-1,-1
REOPER.txt,804521,805623,1102,10,N,N,-,-1,-1
REOPER.txt,804651,805874,1223,10,N,N,-,-1,-1
REOPER.txt,804817,806010,1193,10,N,N,-,-1,-1
REOPER.txt,804834,806326,1492,10,N,N,-,-1,-1
REOPER.txt,804966,806542,1576,10,N,N,-,-1,-1
REOPER.txt,805111,806655,1544,10,N,N,-,-1,-1
REOPER.txt,805329,806720,1391,10,N,N,-,-1,-1
REOPER.txt,805432,806838,1406,10,N,N,-,-1,-1
REOPER.txt,805488,806889,1401,10,N,N,-,-1,-1
REOPER.txt,805566,806920,1354,10,N,N,-,-1,-1
REOPER.txt,805624,807152,1528,10,N,N,-,-1,-1
REOPER.txt,805875,807419,1544,10,N,N,-,-1,-1
REOPER.txt,806011,807511,1500,10,N,N,-,-1,-1
REOPER.txt,806327,807580,1253,10,N,N,-,-1,-1
REOPER.txt,806543,807749,1206,10,N,N,-,-1,-1
REOPER.txt,806658,807814,1156,10,N,N,-,-1,-1
REOPER.txt,806721,807910,1189,10,N,N,-,-1,-1
REOPER.txt,806839,808092,1253,10,N,N,-,-1,-1
REOPER.txt,806892,808132,1240,10,N,N,-,-1,-1
REOPER.txt,806921,808242,1321,10,N,N,-,-1,-1
REOPER.txt,807153,808275,1122,10,N,N,-,-1,-1
REOPER.txt,807422,808403,981,10,N,N,-,-1,-1
REOPER.txt,807512,808419,907,10,N,N,-,-1,-1
REOPER.txt,807582,808599,1017,10,N,N,-,-1,-1
REOPER.txt,807750,808810,1060,10,N,N,-,-1,-1
REOPER.txt,807815,808922,1107,10,N,N,-,-1,-1
REOPER.txt,807911,809034,1123,10,N,N,-,-1,-1
REOPER.txt,808093,809267,1174,10,N,N,-,-1,-1
REOPER.txt,808133,809441,1308,10,N,N,-,-1,-1
REOPER.txt,808243,809498,1255,10,N,N,-,-1,-1
REOPER.txt,808277,809687,1410,10,N,N,-,-1,-1
REOPER.txt,808408,809830,1422,10,N,N,-,-1,-1
REOPER.txt,808420,810169,1749,10,N,N,-,-1,-1
REOPER.txt,808600,810323,1723,10,N,N,-,-1,-1
REOPER.txt,808811,810440,1629,10,N,N,-,-1,-1
REOPER.txt,808923,810682,1759,10,N,N,-,-1,-1
REOPER.txt,809035,810862,1827,10,N,N,-,-1,-1
REOPER.txt,809268,811006,1738,10,N,N,-,-1,-1
REOPER.txt,809442,811076,1634,10,N,N,-,-1,-1
REOPER.txt,809499,811152,1653,10,N,N,-,-1,-1
REOPER.txt,809690,811359,1669,10,N,N,-,-1,-1
REOPER.txt,809831,811855,2024,10,N,N,-,-1,-1
REOPER.txt,810170,812054,1884,10,N,N,-,-1,-1
REOPER.txt,810326,812066,1740,10,N,N,-,-1,-1
REOPER.txt,810441,812358,1917,10,N,N,-,-1,-1
REOPER.txt,810683,812538,1855,10,N,N,-,-1,-1
REOPER.txt,810864,812693,1829,10,N,N,-,-1,-1
REOPER.txt,811007,812762,1755,10,N,N,-,-1,-1
REOPER.txt,811077,812857,1780,10,N,N,-,-1,-1
REOPER.txt,811153,812929,1776,10,N,N,-,-1,-1
REOPER.txt,811362,813084,1722,10,N,N,-,-1,-1
REOPER.txt,811858,813191,1333,10,N,N,-,-1,-1
REOPER.txt,812055,813338,1283,10,N,N,-,-1,-1
REOPER.txt,812067,813546,1479,10,N,N,-,-1,-1
REOPER.txt,812359,813662,1303,10,N,N,-,-1,-1
REOPER.txt,812539,813790,1251,10,N,N,-,-1,-1
REOPER.txt,812694,813852,1158,10,N,N,-,-1,-1
REOPER.txt,812763,814029,1266,10,N,N,-,-1,-1
REOPER.txt,812860,814144,1284,10,N,N,-,-1,-1
REOPER.txt,812930,814225,1295,10,N,N,-,-1,-1
REOPER.txt,813085,814350,1265,10,N,N,-,-1,-1
REOPER.txt,813192,814496,1304,10,N,N,-,-1,-1
REOPER.txt,813339,814587,1248,10,N,N,-,-1,-1
REOPER.txt,813549,814760,1211,10,N,N,-,-1,-1
REOPER.txt,813663,815082,1419,10,N,N,-,-1,-1
REOPER.txt,813791,815358,1567,10,N,N,-,-1,-1
REOPER.txt,813855,815617,1762,10,Y,N,-,-1,-1
REOPER.txt,814030,815677,1647,10,Y,N,-,-1,-1
REOPER.txt,814147,815793,1646,10,Y,N,-,-1,-1
REOPER.txt,814226,815890,1664,10,Y,N,-,-1,-1
REOPER.txt,814351,815989,1638,10,Y,N,-,-1,-1
REOPER.txt,814497,816101,1604,10,Y,N,-,-1,-1
REOPER.txt,814588,816201,1613,10,N,N,-,-1,-1
REOPER.txt,814761,816312,1551,10,N,N,-,-1,-1
REOPER.txt,815083,816578,1495,10,N,N,-,-1,-1
REOPER.txt,815359,816652,1293,10,N,N,-,-1,-1
REOPER.txt,815618,816857,1239,10,N,N,-,-1,-1
REOPER.txt,815678,816971,1293,10,N,N,-,-1,-1
REOPER.txt,815796,817271,1475,10,N,N,-,-1,-1
REOPER.txt,815891,817542,1651,10,N,N,-,-1,-1
REOPER.txt,815990,817590,1600,10,N,N,-,-1,-1
REOPER.txt,816102,817710,1608,10,N,N,-,-1,-1
REOPER.txt,816201,817831,1630,10,N,N,-,-1,-1
REOPER.txt,816313,817867,1554,10,N,N,-,-1,-1
REOPER.txt,816579,817987,1408,10,N,N,-,-1,-1
REOPER.txt,816653,818086,1433,10,N,N,-,-1,-1
REOPER.txt,816858,818186,1328,10,N,N,-,-1,-1
REOPER.txt,816972,818236,1264,10,N,N,-,-1,-1
REOPER.txt,817272,818612,1340,10,N,N,-,-1,-1
REOPER.txt,817543,818810,1267,10,N,N,-,-1,-1
REOPER.txt,817591,818987,1396,10,N,N,-,-1,-1
REOPER.txt,817711,819135,1424,10,N,N,-,-1,-1
REOPER.txt,817836,819325,1489,10,N,N,-,-1,-1
REOPER.txt,817870,819596,1726,10,N,N,-,-1,-1
REOPER.txt,817988,819683,1695,10,N,N,-,-1,-1
REOPER.txt,818087,819798,1711,10,N,N,-,-1,-1
REOPER.txt,818187,819856,1669,10,N,N,-,-1,-1
REOPER.txt,818239,820196,1957,10,N,N,-,-1,-1
REOPER.txt,818613,820338,1725,10,N,N,-,-1,-1
REOPER.txt,818813,820426,1613,10,N,N,-,-1,-1
REOPER.txt,818987,820543,1556,10,N,N,-,-1,-1
REOPER.txt,819137,820651,1514,10,N,N,-,-1,-1
REOPER.txt,819326,820695,1369,10,N,N,-,-1,-1
REOPER.txt,819597,820824,1227,10,N,N,-,-1,-1
REOPER.txt,819684,820956,1272,10,N,N,-,-1,-1
REOPER.txt,819799,821122,1323,10,N,N,-,-1,-1
REOPER.txt,819857,821288,1431,10,N,N,-,-1,-1
REOPER.txt,820199,821426,1227,10,N,N,-,-1,-1
REOPER.txt,820339,821541,1202,10,N,N,-,-1,-1
REOPER.txt,820427,821659,1232,10,N,N,-,-1,-1
REOPER.txt,820544,821746,1202,10,N,N,-,-1,-1
REOPER.txt,820652,821855,1203,10,N,N,-,-1,-1
REOPER.txt,820696,821950,1254,10,N,N,-,-1,-1
REOPER.txt,820825,822184,1359,10,N,N,-,-1,-1
REOPER.txt,820957,822744,1787,10,N,N,-,-1,-1
REOPER.txt,821123,822853,1730,10,N,N,-,-1,-1
REOPER.txt,821289,822954,1665,10,N,N,-,-1,-1
REOPER.txt,821429,823080,1651,10,N,N,-,-1,-1
REOPER.txt,821543,823221,1678,10,N,N,-,-1,-1
REOPER.txt,821660,823337,1677,10,N,N,-,-1,-1
REOPER.txt,821747,823442,1695,10,N,N,-,-1,-1
REOPER.txt,821856,823510,1654,10,N,N,-,-1,-1
REOPER.txt,821950,823561,1611,10,N,N,-,-1,-1
REOPER.txt,822185,823623,1438,10,N,N,-,-1,-1
REOPER.txt,822745,823696,951,10,N,N,-,-1,-1
REOPER.txt,822854,823714,860,10,N,N,-,-1,-1
REOPER.txt,822955,823772,817,10,N,N,-,-1,-1
REOPER.txt,823081,823962,881,10,N,N,-,-1,-1
REOPER.txt,823222,824121,899,10,N,N,-,-1,-1
REOPER.txt,823338,824642,1304,10,N,N,-,-1,-1
REOPER.txt,823443,825031,1588,10,N,N,-,-1,-1
REOPER.txt,823511,825307,1796,10,N,N,-,-1,-1
REOPER.txt,823562,825692,2130,10,N,N,-,-1,-1
REOPER.txt,823624,825870,2246,10,N,N,-,-1,-1
REOPER.txt,823701,825954,2253,10,N,N,-,-1,-1
REOPER.txt,823715,826043,2328,10,N,N,-,-1,-1
REOPER.txt,823772,826438,2666,10,N,N,-,-1,-1
REOPER.txt,823963,827256,3293,10,N,N,-,-1,-1
REOPER.txt,824124,827318,3194,10,N,N,-,-1,-1
REOPER.txt,824642,827520,2878,10,Y,N,-,-1,-1
REOPER.txt,825032,827542,2510,10,Y,N,-,-1,-1
REOPER.txt,825310,827545,2235,10,Y,N,-,-1,-1
REOPER.txt,825693,827582,1889,10,N,N,-,-1,-1
THIRTY.txt,1,2895,2894,10,N,N,-,-1,-1
THIRTY.txt,203,3219,3016,10,N,N,-,-1,-1
THIRTY.txt,445,3237,2792,10,N,N,-,-1,-1
THIRTY.txt,515,3614,3099,10,N,N,-,-1,-1
THIRTY.txt,984,3948,2964,10,N,N,-,-1,-1
THIRTY.txt,1000,4268,3268,10,Y,N,-,-1,-1
THIRTY.txt,1244,4578,3334,10,Y,N,-,-1,-1
THIRTY.txt,1555,4866,3311,10,Y,N,-,-1,-1
THIRTY.txt,2243,5210,2967,10,Y,N,-,-1,-1
THIRTY.txt,2577,5601,3024,10,Y,N,-,-1,-1
THIRTY.txt,2896,5988,3092,10,Y,N,-,-1,-1
THIRTY.txt,3220,5990,2770,10,Y,N,-,-1,-1
THIRTY.txt,3238,6010,2772,10,Y,N,-,-1,-1
THIRTY.txt,3615,6319,2704,10,Y,N,-,-1,-1
THIRTY.txt,3949,6689,2740,10,N,N,-,-1,-1
THIRTY.txt,4269,7085,2816,10,N,N,-,-1,-1
THIRTY.txt,4579,7109,2530,10,N,N,-,-1,-1
THIRTY.txt,4867,7111,2244,10,N,N,-,-1,-1
THIRTY.txt,5211,7320,2109,10,N,N,-,-1,-1
THIRTY.txt,5602,7412,1810,10,N,N,-,-1,-1
THIRTY.txt,5989,8155,2166,10,N,N,-,-1,-1
THIRTY.txt,5991,8157,2166,10,N,N,-,-1,-1
THIRTY.txt,6011,8509,2498,10,N,N,-,-1,-1
THIRTY.txt,6320,8825,2505,10,N,N,-,-1,-1
THIRTY.txt,6690,9746,3056,10,N,N,-,-1,-1
THIRTY.txt,7086,9748,2662,10,N,N,-,-1,-1
THIRTY.txt,7110,10205,3095,10,N,N,-,-1,-1
THIRTY.txt,7112,10370,3258,10,N,N,-,-1,-1
THIRTY.txt,7321,10588,3267,10,N,N,-,-1,-1
THIRTY.txt,7413,10767,3354,10,N,N,-,-1,-1
THIRTY.txt,8156,10867,2711,10,N,N,-,-1,-1
THIRTY.txt,8158,10983,2825,10,N,N,-,-1,-1
THIRTY.txt,8510,11086,2576,10,N,N,-,-1,-1
THIRTY.txt,8826,11341,2515,10,N,N,-,-1,-1
THIRTY.txt,9747,11702,1955,10,N,N,-,-1,-1
THIRTY.txt,9749,12059,2310,10,N,N,-,-1,-1
THIRTY.txt,10206,12362,2156,10,N,N,-,-1,-1
THIRTY.txt,10372,12793,2421,10,N,N,-,-1,-1
THIRTY.txt,10589,12939,2350,10,N,N,-,-1,-1
THIRTY.txt,10770,13132,2362,10,N,N,-,-1,-1
THIRTY.txt,10868,13405,2537,10,N,N,-,-1,-1
THIRTY.txt,10984,13422,2438,10,N,N,-,-1,-1
THIRTY.txt,11087,13447,2360,10,N,N,-,-1,-1
THIRTY.txt,11344,13762,2418,10,N,N,-,-1,-1
THIRTY.txt,11703,13807,2104,10,N,N,-,-1,-1
THIRTY.txt,12062,13850,1788,10,N,N,-,-1,-1
THIRTY.txt,12363,14048,1685,10,N,N,-,-1,-1
THIRTY.txt,12796,14201,1405,10,N,N,-,-1,-1
THIRTY.txt,12941,14289,1348,10,N,N,-,-1,-1
THIRTY.txt,13133,14568,1435,10,N,N,-,-1,-1
THIRTY.txt,13408,14866,1458,10,N,N,-,-1,-1
THIRTY.txt,13425,15120,1695,10,N,N,-,-1,-1
THIRTY.txt,13452,15202,1750,10,N,N,-,-1,-1
THIRTY.txt,13765,15580,1815,10,Y,N,-,-1,-1
THIRTY.txt,13808,15697,1889,10,Y,N,-,-1,-1
THIRTY.txt,13851,15854,2003,10,Y,N,-,-1,-1
THIRTY.txt,14049,15958,1909,10,Y,N,-,-1,-1
THIRTY.txt,14202,16360,2158,10,Y,N,-,-1,-1
THIRTY.txt,14290,16423,2133,10,Y,N,-,-1,-1
THIRTY.txt,14571,16479,1908,10,Y,N,-,-1,-1
THIRTY.txt,14867,16620,1753,10,Y,N,-,-1,-1
THIRTY.txt,15123,16909,1786,10,Y,N,-,-1,-1
THIRTY.txt,15203,16984,1781,10,Y,Y,1448313482895,176553,176862
THIRTY.txt,15582,17104,1522,10,Y,Y,1448313482895,176553,176862
THIRTY.txt,15698,17405,1707,10,Y,Y,1448313482895,176553,176862
THIRTY.txt,15857,17521,1664,10,Y,Y,1448313482895,176553,176862
THIRTY.txt,15959,17802,1843,10,Y,Y,1448313482895,176553,176862
THIRTY.txt,16361,17885,1524,10,Y,Y,1448313482895,176553,176862
THIRTY.txt,16424,17997,1573,10,Y,Y,1448313482895,176553,176862
THIRTY.txt,16480,18136,1656,10,Y,Y,1448313482895,176553,176862
THIRTY.txt,16621,18320,1699,10,Y,Y,1448313482895,176553,176862
THIRTY.txt,16912,18344,1432,10,N,Y,1448313482895,176553,176862
THIRTY.txt,16985,18477,1492,10,N,Y,1448313482895,176553,176862
THIRTY.txt,17106,18696,1590,10,N,Y,1448313482895,176553,176862
THIRTY.txt,17406,18934,1528,10,Y,Y,1448313482895,176553,176862
THIRTY.txt,17522,19029,1507,10,Y,Y,1448313482895,176553,176862
THIRTY.txt,17803,19162,1359,10,Y,Y,1448313482895,176553,176862
THIRTY.txt,17886,19718,1832,10,Y,Y,1448313482895,176553,176862
THIRTY.txt,17998,19909,1911,10,Y,Y,1448359440819,262798,263079
THIRTY.txt,18139,20100,1961,10,Y,Y,1448359440819,262798,263079
THIRTY.txt,18321,20395,2074,10,Y,Y,1448359440819,262798,263079
THIRTY.txt,18345,20626,2281,10,Y,Y,1448359440819,262798,263079
THIRTY.txt,18478,20764,2286,10,Y,Y,1448359440819,262798,263079
THIRTY.txt,18697,20837,2140,10,Y,Y,1448359440819,262798,263079
THIRTY.txt,18937,21053,2116,10,Y,Y,1448359440819,262798,263079
THIRTY.txt,19030,21139,2109,10,Y,Y,1448359440819,262798,263079
THIRTY.txt,19163,21473,2310,10,Y,Y,1448359440819,262798,263079
THIRTY.txt,19718,21687,1969,10,Y,N,-,-1,-1
THIRTY.txt,19910,21779,1869,10,N,N,-,-1,-1
THIRTY.txt,20101,22028,1927,10,N,N,-,-1,-1
THIRTY.txt,20396,22054,1658,10,N,N,-,-1,-1
THIRTY.txt,20627,22260,1633,10,N,N,-,-1,-1
THIRTY.txt,20767,22372,1605,10,N,N,-,-1,-1
THIRTY.txt,20838,22482,1644,10,N,N,-,-1,-1
THIRTY.txt,21058,22610,1552,10,N,N,-,-1,-1
THIRTY.txt,21139,22737,1598,10,N,N,-,-1,-1
THIRTY.txt,21473,22866,1393,10,N,N,-,-1,-1
THIRTY.txt,21689,22953,1264,10,N,N,-,-1,-1
THIRTY.txt,21780,23457,1677,10,N,N,-,-1,-1
THIRTY.txt,22029,23589,1560,10,N,N,-,-1,-1
THIRTY.txt,22057,23745,1688,10,N,N,-,-1,-1
THIRTY.txt,22262,23943,1681,10,N,N,-,-1,-1
THIRTY.txt,22373,24024,1651,10,N,N,-,-1,-1
THIRTY.txt,22483,24248,1765,10,N,N,-,-1,-1
THIRTY.txt,22611,24300,1689,10,N,N,-,-1,-1
THIRTY.txt,22738,24401,1663,10,N,N,-,-1,-1
THIRTY.txt,22869,24753,1884,10,N,N,-,-1,-1
THIRTY.txt,22953,25012,2059,10,N,N,-,-1,-1
THIRTY.txt,23458,25101,1643,10,N,N,-,-1,-1
THIRTY.txt,23590,25280,1690,10,N,N,-,-1,-1
THIRTY.txt,23746,25360,1614,10,N,N,-,-1,-1
THIRTY.txt,23944,25503,1559,10,N,N,-,-1,-1
THIRTY.txt,24025,25638,1613,10,N,N,-,-1,-1
THIRTY.txt,24249,25669,1420,10,N,N,-,-1,-1
THIRTY.txt,24301,25703,1402,10,N,N,-,-1,-1
THIRTY.txt,24404,25780,1376,10,N,N,-,-1,-1
THIRTY.txt,24754,25837,1083,10,N,N,-,-1,-1
THIRTY.txt,25013,25916,903,10,N,N,-,-1,-1
THIRTY.txt,25102,25993,891,10,N,N,-,-1,-1
THIRTY.txt,25281,26089,808,10,N,N,-,-1,-1
THIRTY.txt,25362,26264,902,10,N,N,-,-1,-1
THIRTY.txt,25504,26373,869,10,N,N,-,-1,-1
THIRTY.txt,25639,26554,915,10,N,N,-,-1,-1
THIRTY.txt,25670,26626,956,10,N,N,-,-1,-1
THIRTY.txt,25704,26722,1018,10,N,N,-,-1,-1
THIRTY.txt,25781,26874,1093,10,N,N,-,-1,-1
THIRTY.txt,25838,27136,1298,10,N,N,-,-1,-1
THIRTY.txt,25919,27214,1295,10,N,N,-,-1,-1
THIRTY.txt,25996,27429,1433,10,N,N,-,-1,-1
THIRTY.txt,26090,27571,1481,10,N,N,-,-1,-1
THIRTY.txt,26265,27743,1478,10,N,N,-,-1,-1
THIRTY.txt,26375,27946,1571,10,N,N,-,-1,-1
THIRTY.txt,26555,28105,1550,10,N,N,-,-1,-1
THIRTY.txt,26627,28202,1575,10,N,N,-,-1,-1
THIRTY.txt,26723,28288,1565,10,N,N,-,-1,-1
THIRTY.txt,26875,28446,1571,10,N,N,-,-1,-1
THIRTY.txt,27139,28546,1407,10,N,N,-,-1,-1
THIRTY.txt,27215,28705,1490,10,N,Y,1448325046337,230539,231128
THIRTY.txt,27430,28927,1497,10,N,Y,1448325046337,230539,231128
THIRTY.txt,27572,29014,1442,10,N,Y,1448325046337,230539,231128
THIRTY.txt,27745,29371,1626,10,Y,Y,1448325046337,230539,231128
THIRTY.txt,27947,29416,1469,10,Y,Y,1448325046337,230539,231128
THIRTY.txt,28106,29549,1443,10,Y,Y,1448325046337,230539,231128
THIRTY.txt,28203,29808,1605,10,Y,Y,1448325046337,230539,231128
THIRTY.txt,28289,29850,1561,10,N,Y,1448325046337,230539,231128
THIRTY.txt,28448,30026,1578,10,Y,Y,1448325046337,230539,231128
THIRTY.txt,28549,30181,1632,10,Y,Y,1448325046337,230539,231128
THIRTY.txt,28706,30388,1682,10,Y,Y,1448325046337,230539,231128
THIRTY.txt,28928,30729,1801,10,Y,Y,1448325046337,230539,231128
THIRTY.txt,29015,30959,1944,10,Y,Y,1448325046337,230539,231128
THIRTY.txt,29374,31031,1657,10,N,Y,1448321627053,211159,212725
THIRTY.txt,29416,31186,1770,10,N,Y,1448321627053,211159,212725
THIRTY.txt,29550,31557,2007,10,N,Y,1448321627053,211159,212725
THIRTY.txt,29809,31646,1837,10,N,Y,1448279813455,71525,72226
THIRTY.txt,29851,31982,2131,10,N,Y,1448279813455,71525,72226
THIRTY.txt,30027,32129,2102,10,N,Y,1448279813455,71525,72226
THIRTY.txt,30184,32160,1976,10,N,Y,1448279813455,71525,72226
THIRTY.txt,30389,32324,1935,10,N,Y,1448279813455,71525,72226
THIRTY.txt,30730,32503,1773,10,N,Y,1448279813455,71525,72226
THIRTY.txt,30960,32725,1765,10,N,Y,1448279813455,71525,72226
THIRTY.txt,31032,32801,1769,10,N,Y,1448279813455,71525,72226
THIRTY.txt,31187,32999,1812,10,N,Y,1448279813455,71525,72226
THIRTY.txt,31560,33069,1509,10,N,Y,1448279813455,71525,72226
THIRTY.txt,31647,33134,1487,10,N,Y,1448279813455,71525,72226
THIRTY.txt,31983,33259,1276,10,N,Y,1448279813455,71525,72226
THIRTY.txt,32130,33359,1229,10,N,Y,1448279813455,71525,72226
THIRTY.txt,32163,33531,1368,10,N,Y,1448312844411,173573,174472
THIRTY.txt,32325,33585,1260,10,N,Y,1448312844411,173573,174472
THIRTY.txt,32505,33644,1139,10,N,Y,1448312844411,173573,174472
THIRTY.txt,32728,33829,1101,10,N,Y,1448312844411,173573,174472
THIRTY.txt,32802,33867,1065,10,N,Y,1448312844411,173573,174472
THIRTY.txt,33000,34011,1011,10,N,Y,1448312844411,173573,174472
THIRTY.txt,33070,34202,1132,10,N,Y,1448312844411,173573,174472
THIRTY.txt,33135,34449,1314,10,N,Y,1448312844411,173573,174472
THIRTY.txt,33260,34497,1237,10,N,Y,1448312844411,173573,174472
THIRTY.txt,33360,34610,1250,10,N,Y,1448312844411,173573,174472
THIRTY.txt,33532,34789,1257,10,N,Y,1448312844411,173573,174472
THIRTY.txt,33586,34973,1387,10,N,Y,1448312844411,173573,174472
THIRTY.txt,33645,35155,1510,10,Y,Y,1448312844411,173573,174472
THIRTY.txt,33831,35294,1463,10,Y,Y,1448312844411,173573,174472
THIRTY.txt,33870,35407,1537,10,Y,Y,1448312844411,173573,174472
THIRTY.txt,34012,35550,1538,10,Y,Y,1448312844411,173573,174472
THIRTY.txt,34205,35673,1468,10,Y,N,-,-1,-1
THIRTY.txt,34452,35700,1248,10,Y,N,-,-1,-1
THIRTY.txt,34499,35996,1497,10,Y,N,-,-1,-1
THIRTY.txt,34611,36194,1583,10,N,N,-,-1,-1
THIRTY.txt,34791,36341,1550,10,N,N,-,-1,-1
THIRTY.txt,34974,36661,1687,10,N,N,-,-1,-1
THIRTY.txt,35155,36947,1792,10,Y,N,-,-1,-1
THIRTY.txt,35295,37284,1989,10,Y,N,-,-1,-1
THIRTY.txt,35408,37641,2233,10,Y,N,-,-1,-1
THIRTY.txt,35551,37943,2392,10,Y,N,-,-1,-1
THIRTY.txt,35674,38050,2376,10,Y,N,-,-1,-1
THIRTY.txt,35703,38306,2603,10,Y,N,-,-1,-1
THIRTY.txt,35999,38387,2388,10,Y,N,-,-1,-1
THIRTY.txt,36196,38481,2285,10,Y,N,-,-1,-1
THIRTY.txt,36342,38582,2240,10,Y,N,-,-1,-1
THIRTY.txt,36663,38807,2144,10,Y,N,-,-1,-1
THIRTY.txt,36950,38995,2045,10,N,N,-,-1,-1
THIRTY.txt,37285,39095,1810,10,N,N,-,-1,-1
THIRTY.txt,37642,39188,1546,10,N,N,-,-1,-1
THIRTY.txt,37946,39412,1466,10,N,N,-,-1,-1
THIRTY.txt,38051,39577,1526,10,N,N,-,-1,-1
THIRTY.txt,38307,39703,1396,10,N,N,-,-1,-1
THIRTY.txt,38389,39870,1481,10,N,N,-,-1,-1
THIRTY.txt,38482,39911,1429,10,Y,N,-,-1,-1
THIRTY.txt,38583,40125,1542,10,Y,N,-,-1,-1
THIRTY.txt,38810,40333,1523,10,Y,Y,1448367094347,278355,278591
THIRTY.txt,38997,40387,1390,10,Y,Y,1448367094347,278355,278591
THIRTY.txt,39097,40672,1575,10,Y,Y,1448367094347,278355,278591
THIRTY.txt,39189,40860,1671,10,Y,Y,1448367094347,278355,278591
THIRTY.txt,39413,40894,1481,10,Y,Y,1448367094347,278355,278591
THIRTY.txt,39578,40956,1378,10,Y,Y,1448367094347,278355,278591
THIRTY.txt,39706,41389,1683,10,Y,Y,1448367094347,278355,278591
THIRTY.txt,39871,41446,1575,10,Y,Y,1448367094347,278355,278591
THIRTY.txt,39912,41514,1602,10,Y,Y,1448367094347,278355,278591
THIRTY.txt,40125,41780,1655,10,Y,Y,1448367094347,278355,278591
THIRTY.txt,40335,42038,1703,10,Y,Y,1437471855423,351318,351853
THIRTY.txt,40388,42218,1830,10,Y,Y,1437471855423,351318,351853
THIRTY.txt,40673,42375,1702,10,N,Y,1437471855423,351318,351853
THIRTY.txt,40861,42550,1689,10,Y,Y,1437471855423,351318,351853
THIRTY.txt,40895,42737,1842,10,Y,Y,1437471855423,351318,351853
THIRTY.txt,40957,42831,1874,10,Y,Y,1437471855423,351318,351853
THIRTY.txt,41390,43044,1654,10,N,Y,1437471855423,351318,351853
THIRTY.txt,41447,43103,1656,10,N,Y,1437471855423,351318,351853
THIRTY.txt,41517,43208,1691,10,N,Y,1437471855423,351318,351853
THIRTY.txt,41781,43312,1531,10,N,Y,1437471855423,351318,351853
THIRTY.txt,42040,43524,1484,10,N,Y,1437471855423,351318,351853
THIRTY.txt,42223,43573,1350,10,N,Y,1437471855423,351318,351853
THIRTY.txt,42376,43684,1308,10,N,Y,1437471855423,351318,351853
THIRTY.txt,42551,43788,1237,10,N,Y,1437471855423,351318,351853
THIRTY.txt,42738,43843,1105,10,N,Y,1437471855423,351318,351853
THIRTY.txt,42832,43977,1145,10,N,Y,1437471855423,351318,351853
THIRTY.txt,43045,44013,968,10,N,Y,1437471855423,351318,351853
THIRTY.txt,43103,44149,1046,10,N,Y,1437471855423,351318,351853
THIRTY.txt,43211,44325,1114,10,N,Y,1448312128598,172353,173027
THIRTY.txt,43313,44346,1033,10,N,Y,1448312128598,172353,173027
THIRTY.txt,43525,44442,917,10,N,Y,1448312128598,172353,173027
THIRTY.txt,43574,44565,991,10,N,Y,1448312128598,172353,173027
THIRTY.txt,43685,44791,1106,10,N,Y,1448312128598,172353,173027
THIRTY.txt,43789,44894,1105,10,N,Y,1448313674408,176614,178600
THIRTY.txt,43848,45326,1478,10,N,Y,1448313674408,176614,178600
THIRTY.txt,43978,45467,1489,10,N,Y,1448313674408,176614,178600
THIRTY.txt,44015,45772,1757,10,N,Y,1448313674408,176614,178600
THIRTY.txt,44150,45928,1778,10,N,Y,1448313674408,176614,178600
THIRTY.txt,44326,46154,1828,10,N,Y,1448313674408,176614,178600
THIRTY.txt,44347,46207,1860,10,N,Y,1448313674408,176614,178600
THIRTY.txt,44443,46314,1871,10,N,Y,1448313674408,176614,178600
THIRTY.txt,44566,46567,2001,10,Y,Y,1448313674408,176614,178600
THIRTY.txt,44794,46678,1884,10,Y,Y,1448313674408,176614,178600
THIRTY.txt,44895,46762,1867,10,Y,Y,1448313674408,176614,178600
THIRTY.txt,45327,47163,1836,10,N,Y,1448313674408,176614,178600
THIRTY.txt,45468,47338,1870,10,N,Y,1448313674408,176614,178600
THIRTY.txt,45775,47464,1689,10,N,Y,1448313674408,176614,178600
THIRTY.txt,45929,47483,1554,10,N,Y,1448313674408,176614,178600
THIRTY.txt,46155,47529,1374,10,N,Y,1448313674408,176614,178600
THIRTY.txt,46207,47651,1444,10,N,N,-,-1,-1
THIRTY.txt,46315,47735,1420,10,N,N,-,-1,-1
THIRTY.txt,46568,48016,1448,10,N,N,-,-1,-1
THIRTY.txt,46680,48113,1433,10,N,N,-,-1,-1
THIRTY.txt,46763,48225,1462,10,N,N,-,-1,-1
THIRTY.txt,47164,48393,1229,10,N,N,-,-1,-1
THIRTY.txt,47339,48484,1145,10,N,N,-,-1,-1
THIRTY.txt,47465,48602,1137,10,N,N,-,-1,-1
THIRTY.txt,47485,48651,1166,10,N,N,-,-1,-1
THIRTY.txt,47532,48673,1141,10,N,N,-,-1,-1
THIRTY.txt,47652,48768,1116,10,N,N,-,-1,-1
THIRTY.txt,47736,48994,1258,10,N,N,-,-1,-1
THIRTY.txt,48019,49194,1175,10,N,N,-,-1,-1
THIRTY.txt,48114,49222,1108,10,N,N,-,-1,-1
THIRTY.txt,48226,49400,1174,10,N,N,-,-1,-1
THIRTY.txt,48394,49500,1106,10,N,N,-,-1,-1
THIRTY.txt,48485,49538,1053,10,N,N,-,-1,-1
THIRTY.txt,48604,49597,993,10,N,N,-,-1,-1
THIRTY.txt,48652,49660,1008,10,N,N,-,-1,-1
THIRTY.txt,48676,49786,1110,10,N,N,-,-1,-1
THIRTY.txt,48769,49934,1165,10,N,N,-,-1,-1
THIRTY.txt,48999,49995,996,10,N,N,-,-1,-1
THIRTY.txt,49195,50136,941,10,N,N,-,-1,-1
THIRTY.txt,49223,50216,993,10,N,N,-,-1,-1
THIRTY.txt,49401,50342,941,10,N,N,-,-1,-1
THIRTY.txt,49501,50378,877,10,N,N,-,-1,-1
THIRTY.txt,49539,50700,1161,10,Y,N,-,-1,-1
THIRTY.txt,49600,50865,1265,10,Y,N,-,-1,-1
THIRTY.txt,49661,50939,1278,10,Y,N,-,-1,-1
THIRTY.txt,49787,51179,1392,10,Y,N,-,-1,-1
THIRTY.txt,49935,51344,1409,10,Y,N,-,-1,-1
THIRTY.txt,49997,51656,1659,10,Y,N,-,-1,-1
THIRTY.txt,50137,51724,1587,10,N,N,-,-1,-1
THIRTY.txt,50217,52037,1820,10,Y,N,-,-1,-1
THIRTY.txt,50345,52233,1888,10,Y,N,-,-1,-1
THIRTY.txt,50379,52573,2194,10,N,N,-,-1,-1
THIRTY.txt,50701,52886,2185,10,N,N,-,-1,-1
THIRTY.txt,50867,53152,2285,10,N,N,-,-1,-1
THIRTY.txt,50940,53359,2419,10,N,N,-,-1,-1
THIRTY.txt,51180,53435,2255,10,N,N,-,-1,-1
THIRTY.txt,51345,53497,2152,10,N,N,-,-1,-1
THIRTY.txt,51659,53708,2049,10,N,N,-,-1,-1
THIRTY.txt,51725,53793,2068,10,Y,N,-,-1,-1
THIRTY.txt,52038,53956,1918,10,N,N,-,-1,-1
THIRTY.txt,52236,54098,1862,10,N,N,-,-1,-1
THIRTY.txt,52574,54182,1608,10,N,N,-,-1,-1
THIRTY.txt,52887,54372,1485,10,N,N,-,-1,-1
THIRTY.txt,53153,54478,1325,10,N,N,-,-1,-1
THIRTY.txt,53362,54742,1380,10,N,N,-,-1,-1
THIRTY.txt,53436,54911,1475,10,N,N,-,-1,-1
THIRTY.txt,53498,55010,1512,10,N,N,-,-1,-1
THIRTY.txt,53713,55075,1362,10,N,Y,1448322095209,213778,214023
THIRTY.txt,53795,55294,1499,10,N,Y,1448322095209,213778,214023
THIRTY.txt,53957,55316,1359,10,N,Y,1448322095209,213778,214023
THIRTY.txt,54099,55498,1399,10,Y,Y,1448322095209,213778,214023
THIRTY.txt,54183,55635,1452,10,Y,Y,1448322095209,213778,214023
THIRTY.txt,54373,55816,1443,10,Y,Y,1448322095209,213778,214023
THIRTY.txt,54479,55946,1467,10,Y,Y,1448322095209,213778,214023
THIRTY.txt,54745,56090,1345,10,Y,Y,1448322095209,213778,214023
THIRTY.txt,54912,56226,1314,10,Y,Y,1448322095209,213778,214023
THIRTY.txt,55011,56304,1293,10,Y,Y,1448322095209,213778,214023
THIRTY.txt,55078,56321,1243,10,Y,Y,1448322095209,213778,214023
THIRTY.txt,55295,56343,1048,10,N,Y,1448322095209,213778,214023
THIRTY.txt,55317,56465,1148,10,N,Y,1448322095209,213778,214023
THIRTY.txt,55503,56718,1215,10,N,Y,1448322095209,213778,214023
THIRTY.txt,55641,56852,1211,10,N,Y,1448322095209,213778,214023
THIRTY.txt,55817,56977,1160,10,N,Y,1448322095209,213778,214023
THIRTY.txt,55947,57063,1116,10,N,Y,1448322095209,213778,214023
THIRTY.txt,56091,57373,1282,10,N,Y,1448322095209,213778,214023
THIRTY.txt,56227,57609,1382,10,Y,Y,1448322095209,213778,214023
THIRTY.txt,56305,57634,1329,10,Y,Y,1448322095209,213778,214023
THIRTY.txt,56322,57723,1401,10,Y,Y,1448322095209,213778,214023
THIRTY.txt,56344,57763,1419,10,Y,Y,1448322095209,213778,214023
THIRTY.txt,56468,58037,1569,10,Y,N,-,-1,-1
THIRTY.txt,56719,58100,1381,10,Y,N,-,-1,-1
THIRTY.txt,56853,58340,1487,10,Y,N,-,-1,-1
THIRTY.txt,56979,58506,1527,10,Y,N,-,-1,-1
THIRTY.txt,57068,58734,1666,10,Y,N,-,-1,-1
THIRTY.txt,57376,58986,1610,10,N,N,-,-1,-1
THIRTY.txt,57610,59083,1473,10,N,N,-,-1,-1
THIRTY.txt,57635,59124,1489,10,N,N,-,-1,-1
THIRTY.txt,57724,59268,1544,10,N,Y,1448278425221,65586,65914
THIRTY.txt,57764,59331,1567,10,N,Y,1448278425221,65586,65914
THIRTY.txt,58038,59404,1366,10,N,Y,1448278425221,65586,65914
THIRTY.txt,58101,59593,1492,10,N,Y,1448278425221,65586,65914
THIRTY.txt,58343,59854,1511,10,N,Y,1448278425221,65586,65914
THIRTY.txt,58507,60034,1527,10,N,Y,1448278425221,65586,65914
THIRTY.txt,58735,60133,1398,10,N,Y,1448278425221,65586,65914
THIRTY.txt,58987,60388,1401,10,N,Y,1448278425221,65586,65914
THIRTY.txt,59086,60568,1482,10,Y,Y,1448278425221,65586,65914
THIRTY.txt,59125,60789,1664,10,Y,Y,1448278425221,65586,65914
THIRTY.txt,59269,60915,1646,10,Y,Y,1448278425221,65586,65914
THIRTY.txt,59333,61205,1872,10,Y,Y,1448278425221,65586,65914
THIRTY.txt,59405,61428,2023,10,Y,Y,1448278425221,65586,65914
THIRTY.txt,59594,61482,1888,10,Y,Y,1448278425221,65586,65914
THIRTY.txt,59855,61556,1701,10,Y,Y,1448278425221,65586,65914
THIRTY.txt,60035,61932,1897,10,Y,Y,1448278425221,65586,65914
THIRTY.txt,60134,62171,2037,10,Y,Y,1448278425221,65586,65914
THIRTY.txt,60389,62303,1914,10,Y,Y,1448278425221,65586,65914
THIRTY.txt,60571,62434,1863,10,N,Y,1448278425221,65586,65914
THIRTY.txt,60790,62521,1731,10,N,Y,1448278425221,65586,65914
THIRTY.txt,60916,62889,1973,10,N,Y,1448278425221,65586,65914
THIRTY.txt,61206,62948,1742,10,N,Y,1448278425221,65586,65914
THIRTY.txt,61429,63264,1835,10,N,Y,1448278425221,65586,65914
THIRTY.txt,61483,63346,1863,10,N,Y,1448396118064,295199,297352
THIRTY.txt,61560,63511,1951,10,N,Y,1448396118064,295199,297352
THIRTY.txt,61933,63755,1822,10,N,Y,1448396118064,295199,297352
THIRTY.txt,62172,63942,1770,10,N,Y,1448396118064,295199,297352
THIRTY.txt,62306,64117,1811,10,N,N,-,-1,-1
THIRTY.txt,62435,64211,1776,10,N,N,-,-1,-1
THIRTY.txt,62522,64476,1954,10,N,N,-,-1,-1
THIRTY.txt,62890,64666,1776,10,N,N,-,-1,-1
THIRTY.txt,62949,64697,1748,10,N,N,-,-1,-1
THIRTY.txt,63269,64859,1590,10,N,N,-,-1,-1
THIRTY.txt,63348,64964,1616,10,N,N,-,-1,-1
THIRTY.txt,63512,65033,1521,10,N,N,-,-1,-1
THIRTY.txt,63756,65087,1331,10,N,N,-,-1,-1
THIRTY.txt,63943,65134,1191,10,N,N,-,-1,-1
THIRTY.txt,64118,65224,1106,10,N,N,-,-1,-1
THIRTY.txt,64212,65407,1195,10,N,N,-,-1,-1
THIRTY.txt,64479,65437,958,10,N,N,-,-1,-1
THIRTY.txt,64667,65628,961,10,N,N,-,-1,-1
THIRTY.txt,64698,65696,998,10,N,N,-,-1,-1
THIRTY.txt,64864,66254,1390,10,N,N,-,-1,-1
THIRTY.txt,64965,66297,1332,10,N,N,-,-1,-1
THIRTY.txt,65034,66577,1543,10,N,N,-,-1,-1
THIRTY.txt,65088,66663,1575,10,N,N,-,-1,-1
THIRTY.txt,65134,66745,1611,10,N,N,-,-1,-1
THIRTY.txt,65225,66896,1671,10,N,N,-,-1,-1
THIRTY.txt,65410,66967,1557,10,N,N,-,-1,-1
THIRTY.txt,65438,67199,1761,10,N,N,-,-1,-1
THIRTY.txt,65629,67427,1798,10,N,N,-,-1,-1
THIRTY.txt,65698,67620,1922,10,N,N,-,-1,-1
THIRTY.txt,66255,67985,1730,10,N,N,-,-1,-1
THIRTY.txt,66298,68084,1786,10,N,N,-,-1,-1
THIRTY.txt,66580,68187,1607,10,N,N,-,-1,-1
THIRTY.txt,66666,68231,1565,10,N,N,-,-1,-1
THIRTY.txt,66746,68254,1508,10,N,N,-,-1,-1
THIRTY.txt,66897,68445,1548,10,N,N,-,-1,-1
THIRTY.txt,66968,68588,1620,10,N,N,-,-1,-1
THIRTY.txt,67200,68736,1536,10,N,N,-,-1,-1
THIRTY.txt,67430,68749,1319,10,N,N,-,-1,-1
THIRTY.txt,67621,68781,1160,10,N,N,-,-1,-1
THIRTY.txt,67986,69023,1037,10,N,N,-,-1,-1
THIRTY.txt,68085,69204,1119,10,N,N,-,-1,-1
THIRTY.txt,68189,69381,1192,10,N,N,-,-1,-1
THIRTY.txt,68232,69612,1380,10,N,N,-,-1,-1
THIRTY.txt,68256,69670,1414,10,N,N,-,-1,-1
THIRTY.txt,68448,69776,1328,10,N,N,-,-1,-1
THIRTY.txt,68589,69833,1244,10,N,N,-,-1,-1
THIRTY.txt,68737,70000,1263,10,N,N,-,-1,-1
THIRTY.txt,68752,70064,1312,10,N,N,-,-1,-1
THIRTY.txt,68784,70261,1477,10,N,N,-,-1,-1
THIRTY.txt,69024,70632,1608,10,N,N,-,-1,-1
THIRTY.txt,69205,70933,1728,10,N,N,-,-1,-1
THIRTY.txt,69382,71106,1724,10,N,N,-,-1,-1
THIRTY.txt,69613,71165,1552,10,N,N,-,-1,-1
THIRTY.txt,69671,71304,1633,10,N,N,-,-1,-1
THIRTY.txt,69777,71730,1953,10,N,N,-,-1,-1
THIRTY.txt,69834,72054,2220,10,N,N,-,-1,-1
THIRTY.txt,70001,72151,2150,10,N,N,-,-1,-1
THIRTY.txt,70065,72352,2287,10,Y,N,-,-1,-1
THIRTY.txt,70262,72652,2390,10,N,N,-,-1,-1
THIRTY.txt,70633,72849,2216,10,N,N,-,-1,-1
THIRTY.txt,70936,73102,2166,10,N,N,-,-1,-1
THIRTY.txt,71107,73272,2165,10,N,N,-,-1,-1
THIRTY.txt,71168,73574,2406,10,N,N,-,-1,-1
THIRTY.txt,71305,73811,2506,10,N,N,-,-1,-1
THIRTY.txt,71731,74145,2414,10,N,N,-,-1,-1
THIRTY.txt,72055,74218,2163,10,N,N,-,-1,-1
THIRTY.txt,72152,74366,2214,10,N,Y,1448314402792,179959,180202
THIRTY.txt,72353,74458,2105,10,N,Y,1448314402792,179959,180202
THIRTY.txt,72655,74684,2029,10,N,Y,1448314402792,179959,180202
THIRTY.txt,72851,74974,2123,10,N,Y,1448314402792,179959,180202
THIRTY.txt,73103,75056,1953,10,N,Y,1448314402792,179959,180202
THIRTY.txt,73273,75237,1964,10,Y,Y,1448314402792,179959,180202
THIRTY.txt,73575,75400,1825,10,N,Y,1448314402792,179959,180202
THIRTY.txt,73812,75864,2052,10,Y,Y,1448314402792,179959,180202
THIRTY.txt,74146,76079,1933,10,Y,Y,1448314402792,179959,180202
THIRTY.txt,74221,76134,1913,10,Y,Y,1448314402792,179959,180202
THIRTY.txt,74368,76247,1879,10,Y,Y,1448314402792,179959,180202
THIRTY.txt,74459,76549,2090,10,Y,Y,1448314402792,179959,180202
THIRTY.txt,74685,76636,1951,10,Y,Y,1448314402792,179959,180202
THIRTY.txt,74975,76976,2001,10,Y,Y,1448314402792,179959,180202
THIRTY.txt,75057,77214,2157,10,Y,Y,1448314402792,179959,180202
THIRTY.txt,75238,77387,2149,10,Y,Y,1448314402792,179959,180202
THIRTY.txt,75403,77520,2117,10,Y,N,-,-1,-1
THIRTY.txt,75865,77793,1928,10,Y,N,-,-1,-1
THIRTY.txt,76080,77980,1900,10,N,N,-,-1,-1
THIRTY.txt,76135,78072,1937,10,N,N,-,-1,-1
THIRTY.txt,76252,78349,2097,10,Y,N,-,-1,-1
THIRTY.txt,76552,78445,1893,10,Y,N,-,-1,-1
THIRTY.txt,76637,78489,1852,10,Y,N,-,-1,-1
THIRTY.txt,76977,78571,1594,10,Y,N,-,-1,-1
THIRTY.txt,77215,78743,1528,10,Y,N,-,-1,-1
THIRTY.txt,77388,78956,1568,10,Y,N,-,-1,-1
THIRTY.txt,77523,79037,1514,10,Y,N,-,-1,-1
THIRTY.txt,77794,79117,1323,10,Y,N,-,-1,-1
THIRTY.txt,77981,79154,1173,10,Y,N,-,-1,-1
THIRTY.txt,78073,79214,1141,10,Y,N,-,-1,-1
THIRTY.txt,78350,79342,992,10,N,N,-,-1,-1
THIRTY.txt,78446,79485,1039,10,N,N,-,-1,-1
THIRTY.txt,78490,79607,1117,10,N,N,-,-1,-1
THIRTY.txt,78574,79811,1237,10,N,N,-,-1,-1
THIRTY.txt,78744,79861,1117,10,N,N,-,-1,-1
THIRTY.txt,78957,80010,1053,10,N,N,-,-1,-1
THIRTY.txt,79038,80165,1127,10,N,N,-,-1,-1
THIRTY.txt,79118,80472,1354,10,Y,N,-,-1,-1
THIRTY.txt,79155,80790,1635,10,Y,N,-,-1,-1
THIRTY.txt,79215,80929,1714,10,Y,N,-,-1,-1
THIRTY.txt,79343,80970,1627,10,Y,N,-,-1,-1
THIRTY.txt,79486,80993,1507,10,Y,N,-,-1,-1
THIRTY.txt,79610,81083,1473,10,Y,N,-,-1,-1
THIRTY.txt,79813,81151,1338,10,Y,N,-,-1,-1
THIRTY.txt,79863,81249,1386,10,N,N,-,-1,-1
THIRTY.txt,80011,81310,1299,10,N,N,-,-1,-1
THIRTY.txt,80166,81441,1275,10,N,N,-,-1,-1
THIRTY.txt,80475,81555,1080,10,N,N,-,-1,-1
THIRTY.txt,80792,81640,848,10,N,N,-,-1,-1
THIRTY.txt,80930,81810,880,10,N,N,-,-1,-1
THIRTY.txt,80971,82069,1098,10,N,N,-,-1,-1
THIRTY.txt,80994,82208,1214,10,N,N,-,-1,-1
THIRTY.txt,81083,82241,1158,10,N,N,-,-1,-1
THIRTY.txt,81152,82262,1110,10,N,N,-,-1,-1
THIRTY.txt,81252,82267,1015,10,N,N,-,-1,-1
THIRTY.txt,81311,82579,1268,10,N,Y,1448323072174,227638,227786
THIRTY.txt,81442,82700,1258,10,N,Y,1448323072174,227638,227786
THIRTY.txt,81557,82828,1271,10,Y,Y,1448323072174,227638,227786
THIRTY.txt,81641,83051,1410,10,Y,Y,1448323072174,227638,227786
THIRTY.txt,81812,83244,1432,10,Y,Y,1448323072174,227638,227786
THIRTY.txt,82072,83469,1397,10,Y,Y,1448323072174,227638,227786
THIRTY.txt,82209,83708,1499,10,Y,Y,1448323072174,227638,227786
THIRTY.txt,82246,83769,1523,10,Y,Y,1448323072174,227638,227786
THIRTY.txt,82264,83928,1664,10,Y,Y,1448323072174,227638,227786
THIRTY.txt,82272,84094,1822,10,Y,Y,1448323072174,227638,227786
THIRTY.txt,82580,84212,1632,10,Y,Y,1448323072174,227638,227786
THIRTY.txt,82702,84488,1786,10,Y,Y,1448323072174,227638,227786
THIRTY.txt,82829,84673,1844,10,Y,Y,1448323072174,227638,227786
THIRTY.txt,83052,84703,1651,10,Y,Y,1448323072174,227638,227786
THIRTY.txt,83247,84938,1691,10,N,N,-,-1,-1
THIRTY.txt,83469,85199,1730,10,N,N,-,-1,-1
THIRTY.txt,83709,85291,1582,10,N,N,-,-1,-1
THIRTY.txt,83770,85580,1810,10,N,N,-,-1,-1
THIRTY.txt,83933,85727,1794,10,N,N,-,-1,-1
THIRTY.txt,84095,86001,1906,10,N,N,-,-1,-1
THIRTY.txt,84213,86253,2040,10,Y,N,-,-1,-1
THIRTY.txt,84489,86547,2058,10,Y,N,-,-1,-1
THIRTY.txt,84676,86874,2198,10,N,N,-,-1,-1
THIRTY.txt,84704,87116,2412,10,Y,N,-,-1,-1
THIRTY.txt,84939,87332,2393,10,Y,N,-,-1,-1
THIRTY.txt,85200,87468,2268,10,Y,N,-,-1,-1
THIRTY.txt,85292,87673,2381,10,Y,N,-,-1,-1
THIRTY.txt,85583,87923,2340,10,Y,N,-,-1,-1
THIRTY.txt,85729,88033,2304,10,Y,N,-,-1,-1
THIRTY.txt,86002,88114,2112,10,N,N,-,-1,-1
THIRTY.txt,86254,88354,2100,10,N,N,-,-1,-1
THIRTY.txt,86549,88628,2079,10,N,N,-,-1,-1
THIRTY.txt,86877,88670,1793,10,N,N,-,-1,-1
THIRTY.txt,87117,88906,1789,10,N,N,-,-1,-1
THIRTY.txt,87333,88938,1605,10,N,N,-,-1,-1
THIRTY.txt,87470,89171,1701,10,N,N,-,-1,-1
THIRTY.txt,87674,89235,1561,10,N,N,-,-1,-1
THIRTY.txt,87924,89325,1401,10,N,N,-,-1,-1
THIRTY.txt,88034,89400,1366,10,N,N,-,-1,-1
THIRTY.txt,88117,89472,1355,10,N,N,-,-1,-1
THIRTY.txt,88355,89605,1250,10,N,N,-,-1,-1
THIRTY.txt,88629,89707,1078,10,N,N,-,-1,-1
THIRTY.txt,88673,89841,1168,10,N,N,-,-1,-1
THIRTY.txt,88907,89977,1070,10,N,N,-,-1,-1
THIRTY.txt,88940,90084,1144,10,N,N,-,-1,-1
THIRTY.txt,89172,90206,1034,10,N,N,-,-1,-1
THIRTY.txt,89236,90252,1016,10,N,N,-,-1,-1
THIRTY.txt,89326,90341,1015,10,N,N,-,-1,-1
THIRTY.txt,89401,90410,1009,10,N,N,-,-1,-1
THIRTY.txt,89473,90459,986,10,N,N,-,-1,-1
THIRTY.txt,89606,90556,950,10,N,N,-,-1,-1
THIRTY.txt,89708,90615,907,10,N,N,-,-1,-1
THIRTY.txt,89844,90694,850,10,N,N,-,-1,-1
THIRTY.txt,89978,90723,745,10,N,N,-,-1,-1
THIRTY.txt,90085,90849,764,10,N,N,-,-1,-1
THIRTY.txt,90207,90967,760,10,N,N,-,-1,-1
THIRTY.txt,90253,91069,816,10,N,N,-,-1,-1
THIRTY.txt,90346,91371,1025,10,N,N,-,-1,-1
THIRTY.txt,90413,91416,1003,10,N,N,-,-1,-1
THIRTY.txt,90461,91490,1029,10,N,N,-,-1,-1
THIRTY.txt,90557,91765,1208,10,N,N,-,-1,-1
THIRTY.txt,90618,91808,1190,10,N,N,-,-1,-1
THIRTY.txt,90697,91960,1263,10,N,N,-,-1,-1
THIRTY.txt,90724,92061,1337,10,N,N,-,-1,-1
THIRTY.txt,90852,92165,1313,10,N,N,-,-1,-1
THIRTY.txt,90968,92269,1301,10,N,Y,1448287094676,113323,113870
THIRTY.txt,91070,92311,1241,10,N,Y,1448287094676,113323,113870
THIRTY.txt,91373,92584,1211,10,N,Y,1448287094676,113323,113870
THIRTY.txt,91419,92693,1274,10,N,Y,1448287094676,113323,113870
THIRTY.txt,91491,92903,1412,10,N,Y,1448287094676,113323,113870
THIRTY.txt,91767,92994,1227,10,N,Y,1448287094676,113323,113870
THIRTY.txt,91809,93055,1246,10,N,Y,1448287094676,113323,113870
THIRTY.txt,91961,93274,1313,10,N,Y,1448287094676,113323,113870
THIRTY.txt,92062,93367,1305,10,N,Y,1448287094676,113323,113870
THIRTY.txt,92168,93681,1513,10,N,Y,1448287094676,113323,113870
THIRTY.txt,92270,93769,1499,10,N,Y,1448287094676,113323,113870
THIRTY.txt,92313,93972,1659,10,N,Y,1448287094676,113323,113870
THIRTY.txt,92585,94020,1435,10,N,Y,1448287094676,113323,113870
THIRTY.txt,92694,94156,1462,10,N,Y,1448287094676,113323,113870
THIRTY.txt,92906,94237,1331,10,N,Y,1448287094676,113323,113870
THIRTY.txt,92995,94291,1296,10,N,Y,1448287094676,113323,113870
THIRTY.txt,93057,94504,1447,10,N,Y,1448287094676,113323,113870
THIRTY.txt,93274,94594,1320,10,N,Y,1448287094676,113323,113870
THIRTY.txt,93368,94912,1544,10,N,Y,1448287094676,113323,113870
THIRTY.txt,93682,95011,1329,10,N,Y,1448287094676,113323,113870
THIRTY.txt,93771,95130,1359,10,N,Y,1448287094676,113323,113870
THIRTY.txt,93974,95265,1291,10,N,Y,1448287094676,113323,113870
THIRTY.txt,94021,95290,1269,10,N,Y,1448287094676,113323,113870
THIRTY.txt,94159,95465,1306,10,N,Y,1448287094676,113323,113870
THIRTY.txt,94238,95593,1355,10,Y,Y,1448287094676,113323,113870
THIRTY.txt,94292,95723,1431,10,Y,Y,1448287094676,113323,113870
THIRTY.txt,94505,95763,1258,10,Y,Y,1448287094676,113323,113870
THIRTY.txt,94595,95817,1222,10,Y,Y,1448287094676,113323,113870
THIRTY.txt,94913,95944,1031,10,Y,Y,1448287094676,113323,113870
THIRTY.txt,95012,95980,968,10,Y,Y,1448287094676,113323,113870
THIRTY.txt,95135,96042,907,10,Y,N,-,-1,-1
THIRTY.txt,95266,96213,947,10,N,N,-,-1,-1
THIRTY.txt,95291,96248,957,10,N,N,-,-1,-1
THIRTY.txt,95466,96538,1072,10,N,N,-,-1,-1
THIRTY.txt,95594,96734,1140,10,N,N,-,-1,-1
THIRTY.txt,95725,96888,1163,10,N,N,-,-1,-1
THIRTY.txt,95764,97063,1299,10,N,N,-,-1,-1
THIRTY.txt,95820,97188,1368,10,N,N,-,-1,-1
THIRTY.txt,95945,97226,1281,10,N,N,-,-1,-1
THIRTY.txt,95981,97301,1320,10,Y,N,-,-1,-1
THIRTY.txt,96043,97362,1319,10,Y,N,-,-1,-1
THIRTY.txt,96214,97472,1258,10,Y,N,-,-1,-1
THIRTY.txt,96249,97642,1393,10,Y,N,-,-1,-1
THIRTY.txt,96539,97875,1336,10,N,N,-,-1,-1
THIRTY.txt,96737,97925,1188,10,N,N,-,-1,-1
THIRTY.txt,96889,98042,1153,10,N,N,-,-1,-1
THIRTY.txt,97064,98356,1292,10,N,N,-,-1,-1
THIRTY.txt,97189,98724,1535,10,N,N,-,-1,-1
THIRTY.txt,97228,98931,1703,10,N,N,-,-1,-1
THIRTY.txt,97302,98999,1697,10,N,N,-,-1,-1
THIRTY.txt,97365,99086,1721,10,N,N,-,-1,-1
THIRTY.txt,97473,99189,1716,10,N,N,-,-1,-1
THIRTY.txt,97643,99486,1843,10,N,N,-,-1,-1
THIRTY.txt,97877,99548,1671,10,N,N,-,-1,-1
THIRTY.txt,97927,99728,1801,10,N,N,-,-1,-1
THIRTY.txt,98043,99925,1882,10,N,N,-,-1,-1
THIRTY.txt,98359,100145,1786,10,N,N,-,-1,-1
THIRTY.txt,98727,100239,1512,10,N,N,-,-1,-1
THIRTY.txt,98932,100372,1440,10,N,N,-,-1,-1
THIRTY.txt,99002,100579,1577,10,N,N,-,-1,-1
THIRTY.txt,99087,100800,1713,10,N,N,-,-1,-1
THIRTY.txt,99191,100919,1728,10,N,N,-,-1,-1
THIRTY.txt,99487,101244,1757,10,N,N,-,-1,-1
THIRTY.txt,99550,101318,1768,10,N,N,-,-1,-1
THIRTY.txt,99730,101395,1665,10,N,N,-,-1,-1
THIRTY.txt,99925,101433,1508,10,N,N,-,-1,-1
THIRTY.txt,100146,101451,1305,10,N,N,-,-1,-1
THIRTY.txt,100240,101687,1447,10,N,N,-,-1,-1
THIRTY.txt,100375,101919,1544,10,N,N,-,-1,-1
THIRTY.txt,100580,101931,1351,10,N,N,-,-1,-1
THIRTY.txt,100801,102143,1342,10,N,Y,1436867017136,105674,106651
THIRTY.txt,100921,102239,1318,10,N,Y,1436867017136,105674,106651
THIRTY.txt,101249,102284,1035,10,N,Y,1436867017136,105674,106651
THIRTY.txt,101322,102407,1085,10,N,Y,1436867017136,105674,106651
THIRTY.txt,101395,102435,1040,10,N,Y,1436867017136,105674,106651
THIRTY.txt,101436,102617,1181,10,N,Y,1436867017136,105674,106651
THIRTY.txt,101451,102859,1408,10,N,Y,1436867017136,105674,106651
THIRTY.txt,101689,103024,1335,10,N,Y,1436867017136,105674,106651
THIRTY.txt,101920,103197,1277,10,N,Y,1436867017136,105674,106651
THIRTY.txt,101934,103249,1315,10,N,Y,1436867017136,105674,106651
THIRTY.txt,102144,103362,1218,10,N,Y,1436867017136,105674,106651
THIRTY.txt,102240,103440,1200,10,N,Y,1436867017136,105674,106651
THIRTY.txt,102285,103741,1456,10,N,Y,1436867017136,105674,106651
THIRTY.txt,102408,103920,1512,10,N,Y,1436867017136,105674,106651
THIRTY.txt,102436,104082,1646,10,N,Y,1436867017136,105674,106651
THIRTY.txt,102619,104242,1623,10,Y,Y,1436867017136,105674,106651
THIRTY.txt,102860,104403,1543,10,Y,Y,1436867017136,105674,106651
THIRTY.txt,103025,104478,1453,10,Y,Y,1448310549245,137491,141408
THIRTY.txt,103199,104619,1420,10,Y,Y,1448310549245,137491,141408
THIRTY.txt,103252,104863,1611,10,Y,Y,1448310549245,137491,141408
THIRTY.txt,103363,104977,1614,10,Y,Y,1448310549245,137491,141408
THIRTY.txt,103441,105090,1649,10,Y,Y,1448310549245,137491,141408
THIRTY.txt,103742,105184,1442,10,N,Y,1448310549245,137491,141408
THIRTY.txt,103921,105260,1339,10,N,Y,1448310549245,137491,141408
THIRTY.txt,104083,105330,1247,10,N,Y,1448310549245,137491,141408
THIRTY.txt,104245,105502,1257,10,N,N,-,-1,-1
THIRTY.txt,104404,105772,1368,10,N,N,-,-1,-1
THIRTY.txt,104479,105923,1444,10,N,N,-,-1,-1
THIRTY.txt,104620,106141,1521,10,N,N,-,-1,-1
THIRTY.txt,104864,106231,1367,10,N,N,-,-1,-1
THIRTY.txt,104978,106465,1487,10,N,N,-,-1,-1
THIRTY.txt,105091,106508,1417,10,N,N,-,-1,-1
THIRTY.txt,105186,106780,1594,10,N,N,-,-1,-1
THIRTY.txt,105261,107061,1800,10,N,N,-,-1,-1
THIRTY.txt,105333,107095,1762,10,Y,N,-,-1,-1
THIRTY.txt,105503,107204,1701,10,N,N,-,-1,-1
THIRTY.txt,105773,107306,1533,10,N,Y,1448278279697,58861,59444
THIRTY.txt,105924,107665,1741,10,N,Y,1448278279697,58861,59444
THIRTY.txt,106141,107833,1692,10,N,Y,1448278279697,58861,59444
THIRTY.txt,106232,107881,1649,10,N,Y,1448278279697,58861,59444
THIRTY.txt,106468,107977,1509,10,N,Y,1448278279697,58861,59444
THIRTY.txt,106509,108009,1500,10,N,Y,1448278279697,58861,59444
THIRTY.txt,106781,108142,1361,10,N,Y,1448278279697,58861,59444
THIRTY.txt,107061,108392,1331,10,N,Y,1448278279697,58861,59444
THIRTY.txt,107096,108630,1534,10,N,Y,1448278279697,58861,59444
THIRTY.txt,107205,108869,1664,10,N,Y,1448278279697,58861,59444
THIRTY.txt,107307,109088,1781,10,N,Y,1448278279697,58861,59444
THIRTY.txt,107667,109282,1615,10,N,Y,1448278279697,58861,59444
THIRTY.txt,107836,109448,1612,10,N,Y,1448278279697,58861,59444
THIRTY.txt,107882,109560,1678,10,N,Y,1448278279697,58861,59444
THIRTY.txt,107980,109851,1871,10,Y,Y,1448278279697,58861,59444
THIRTY.txt,108011,110113,2102,10,Y,Y,1448278279697,58861,59444
THIRTY.txt,108143,110203,2060,10,Y,Y,1448278279697,58861,59444
THIRTY.txt,108395,110270,1875,10,Y,Y,1448278279697,58861,59444
THIRTY.txt,108631,110302,1671,10,Y,Y,1448278279697,58861,59444
THIRTY.txt,108870,110569,1699,10,Y,Y,1448278279697,58861,59444
THIRTY.txt,109089,110740,1651,10,Y,Y,1448278279697,58861,59444
THIRTY.txt,109283,111172,1889,10,N,Y,1448278279697,58861,59444
THIRTY.txt,109450,111533,2083,10,N,Y,1448278279697,58861,59444
THIRTY.txt,109563,111694,2131,10,N,N,-,-1,-1
THIRTY.txt,109852,111862,2010,10,N,N,-,-1,-1
THIRTY.txt,110116,112070,1954,10,N,N,-,-1,-1
THIRTY.txt,110204,112265,2061,10,N,N,-,-1,-1
THIRTY.txt,110271,112356,2085,10,N,N,-,-1,-1
THIRTY.txt,110303,112600,2297,10,Y,N,-,-1,-1
THIRTY.txt,110570,112782,2212,10,Y,N,-,-1,-1
THIRTY.txt,110741,112966,2225,10,N,N,-,-1,-1
THIRTY.txt,111173,113289,2116,10,N,N,-,-1,-1
THIRTY.txt,111534,113489,1955,10,N,N,-,-1,-1
THIRTY.txt,111695,113594,1899,10,N,N,-,-1,-1
THIRTY.txt,111864,113696,1832,10,N,N,-,-1,-1
THIRTY.txt,112071,113908,1837,10,N,N,-,-1,-1
THIRTY.txt,112266,113942,1676,10,N,N,-,-1,-1
THIRTY.txt,112357,114066,1709,10,N,N,-,-1,-1
THIRTY.txt,112601,114197,1596,10,N,N,-,-1,-1
THIRTY.txt,112785,114199,1414,10,N,N,-,-1,-1
THIRTY.txt,112969,114373,1404,10,N,N,-,-1,-1
THIRTY.txt,113291,114485,1194,10,N,N,-,-1,-1
THIRTY.txt,113491,114580,1089,10,N,N,-,-1,-1
THIRTY.txt,113595,114800,1205,10,N,N,-,-1,-1
THIRTY.txt,113697,114836,1139,10,N,N,-,-1,-1
THIRTY.txt,113911,114893,982,10,N,N,-,-1,-1
THIRTY.txt,113943,115004,1061,10,N,N,-,-1,-1
THIRTY.txt,114067,115031,964,10,N,N,-,-1,-1
THIRTY.txt,114198,115082,884,10,N,N,-,-1,-1
THIRTY.txt,114200,115248,1048,10,N,Y,1437477878183,427206,428439
THIRTY.txt,114374,115394,1020,10,N,Y,1437477878183,427206,428439
THIRTY.txt,114487,115501,1014,10,N,Y,1437477878183,427206,428439
THIRTY.txt,114583,115728,1145,10,N,Y,1437477878183,427206,428439
THIRTY.txt,114801,115834,1033,10,N,Y,1437477878183,427206,428439
THIRTY.txt,114838,116001,1163,10,N,Y,1437477878183,427206,428439
THIRTY.txt,114895,116319,1424,10,N,Y,1437477878183,427206,428439
THIRTY.txt,115006,116454,1448,10,N,Y,1437477878183,427206,428439
THIRTY.txt,115034,116512,1478,10,N,Y,1437477878183,427206,428439
THIRTY.txt,115085,116656,1571,10,N,Y,1437477878183,427206,428439
THIRTY.txt,115249,116793,1544,10,N,Y,1437477878183,427206,428439
THIRTY.txt,115395,116839,1444,10,N,Y,1437477878183,427206,428439
THIRTY.txt,115502,116987,1485,10,N,Y,1437477878183,427206,428439
THIRTY.txt,115729,117260,1531,10,N,Y,1437477878183,427206,428439
THIRTY.txt,115837,117474,1637,10,N,Y,1448322273366,219239,219544
THIRTY.txt,116002,117743,1741,10,Y,Y,1448322273366,219239,219544
THIRTY.txt,116320,117904,1584,10,Y,Y,1448322273366,219239,219544
THIRTY.txt,116455,117957,1502,10,Y,Y,1448322273366,219239,219544
THIRTY.txt,116513,118187,1674,10,Y,Y,1448322273366,219239,219544
THIRTY.txt,116657,118316,1659,10,N,Y,1437475017618,98942,100041
THIRTY.txt,116794,118358,1564,10,N,Y,1437475017618,98942,100041
THIRTY.txt,116840,118447,1607,10,N,Y,1437475017618,98942,100041
THIRTY.txt,116987,118750,1763,10,Y,Y,1437475017618,98942,100041
THIRTY.txt,117261,118893,1632,10,Y,Y,1437475017618,98942,100041
THIRTY.txt,117475,119037,1562,10,Y,Y,1437475017618,98942,100041
THIRTY.txt,117744,119104,1360,10,Y,Y,1437475017618,98942,100041
THIRTY.txt,117909,119385,1476,10,Y,Y,1437475017618,98942,100041
THIRTY.txt,117959,119543,1584,10,Y,Y,1437475017618,98942,100041
THIRTY.txt,118190,119707,1517,10,Y,Y,1437475017618,98942,100041
THIRTY.txt,118317,119843,1526,10,N,Y,1437475017618,98942,100041
THIRTY.txt,118359,120072,1713,10,Y,Y,1437475017618,98942,100041
THIRTY.txt,118448,120140,1692,10,Y,Y,1437475017618,98942,100041
THIRTY.txt,118751,120368,1617,10,Y,Y,1437475017618,98942,100041
THIRTY.txt,118895,120535,1640,10,Y,Y,1448311594480,155711,156312
THIRTY.txt,119040,120578,1538,10,Y,Y,1448311594480,155711,156312
THIRTY.txt,119105,120677,1572,10,Y,Y,1448311594480,155711,156312
THIRTY.txt,119386,120734,1348,10,Y,Y,1448311594480,155711,156312
THIRTY.txt,119544,120851,1307,10,Y,Y,1448311594480,155711,156312
THIRTY.txt,119708,120971,1263,10,Y,Y,1448311594480,155711,156312
THIRTY.txt,119844,121095,1251,10,Y,Y,1448311594480,155711,156312
THIRTY.txt,120075,121341,1266,10,N,Y,1448311594480,155711,156312
THIRTY.txt,120141,121536,1395,10,N,Y,1448311594480,155711,156312
THIRTY.txt,120369,121690,1321,10,N,N,-,-1,-1
THIRTY.txt,120536,121793,1257,10,N,N,-,-1,-1
THIRTY.txt,120579,121869,1290,10,N,N,-,-1,-1
THIRTY.txt,120680,122081,1401,10,N,N,-,-1,-1
THIRTY.txt,120735,122246,1511,10,N,N,-,-1,-1
THIRTY.txt,120852,122655,1803,10,N,N,-,-1,-1
THIRTY.txt,120972,122807,1835,10,N,N,-,-1,-1
THIRTY.txt,121096,123134,2038,10,N,N,-,-1,-1
THIRTY.txt,121342,123353,2011,10,N,N,-,-1,-1
THIRTY.txt,121537,123570,2033,10,N,N,-,-1,-1
THIRTY.txt,121693,123651,1958,10,N,Y,1448315575026,182236,182361
THIRTY.txt,121795,123777,1982,10,N,Y,1448315575026,182236,182361
THIRTY.txt,121870,123972,2102,10,Y,Y,1448315575026,182236,182361
THIRTY.txt,122082,124094,2012,10,Y,Y,1448315575026,182236,182361
THIRTY.txt,122247,124113,1866,10,Y,Y,1448315575026,182236,182361
THIRTY.txt,122658,124284,1626,10,N,Y,1448315575026,182236,182361
THIRTY.txt,122808,124362,1554,10,N,Y,1448315575026,182236,182361
THIRTY.txt,123135,124563,1428,10,N,Y,1448315575026,182236,182361
THIRTY.txt,123354,124619,1265,10,N,Y,1448315575026,182236,182361
THIRTY.txt,123573,124907,1334,10,N,Y,1448315575026,182236,182361
THIRTY.txt,123652,125029,1377,10,N,Y,1448315575026,182236,182361
THIRTY.txt,123778,125226,1448,10,N,Y,1448315575026,182236,182361
THIRTY.txt,123973,125406,1433,10,N,Y,1448315575026,182236,182361
THIRTY.txt,124097,125747,1650,10,N,N,-,-1,-1
THIRTY.txt,124114,125988,1874,10,N,N,-,-1,-1
THIRTY.txt,124285,126243,1958,10,N,N,-,-1,-1
THIRTY.txt,124363,126439,2076,10,N,N,-,-1,-1
THIRTY.txt,124564,126775,2211,10,N,N,-,-1,-1
THIRTY.txt,124622,126885,2263,10,N,N,-,-1,-1
THIRTY.txt,124908,126969,2061,10,N,N,-,-1,-1
THIRTY.txt,125030,127157,2127,10,N,N,-,-1,-1
THIRTY.txt,125228,127332,2104,10,N,N,-,-1,-1
THIRTY.txt,125409,127577,2168,10,N,N,-,-1,-1
THIRTY.txt,125748,127697,1949,10,N,N,-,-1,-1
THIRTY.txt,125990,127934,1944,10,N,N,-,-1,-1
THIRTY.txt,126244,128109,1865,10,N,N,-,-1,-1
THIRTY.txt,126444,128150,1706,10,N,N,-,-1,-1
THIRTY.txt,126778,128344,1566,10,N,N,-,-1,-1
THIRTY.txt,126886,128430,1544,10,N,N,-,-1,-1
THIRTY.txt,126971,128581,1610,10,N,N,-,-1,-1
THIRTY.txt,127158,128846,1688,10,N,N,-,-1,-1
THIRTY.txt,127333,128969,1636,10,N,N,-,-1,-1
THIRTY.txt,127580,129021,1441,10,N,N,-,-1,-1
THIRTY.txt,127700,129194,1494,10,N,N,-,-1,-1
THIRTY.txt,127935,129333,1398,10,N,N,-,-1,-1
THIRTY.txt,128110,129561,1451,10,N,N,-,-1,-1
THIRTY.txt,128151,129797,1646,10,N,N,-,-1,-1
THIRTY.txt,128347,130034,1687,10,N,N,-,-1,-1
THIRTY.txt,128431,130129,1698,10,N,N,-,-1,-1
THIRTY.txt,128582,130328,1746,10,N,N,-,-1,-1
THIRTY.txt,128847,130570,1723,10,N,N,-,-1,-1
THIRTY.txt,128972,130601,1629,10,N,N,-,-1,-1
THIRTY.txt,129023,130705,1682,10,N,N,-,-1,-1
THIRTY.txt,129195,130862,1667,10,N,N,-,-1,-1
THIRTY.txt,129333,131126,1793,10,N,N,-,-1,-1
THIRTY.txt,129562,131336,1774,10,N,N,-,-1,-1
THIRTY.txt,129798,131475,1677,10,N,N,-,-1,-1
THIRTY.txt,130035,131582,1547,10,N,N,-,-1,-1
THIRTY.txt,130132,131649,1517,10,N,N,-,-1,-1
THIRTY.txt,130330,131710,1380,10,N,N,-,-1,-1
THIRTY.txt,130571,131896,1325,10,N,N,-,-1,-1
THIRTY.txt,130602,132010,1408,10,N,N,-,-1,-1
THIRTY.txt,130706,132080,1374,10,N,N,-,-1,-1
THIRTY.txt,130865,132354,1489,10,N,N,-,-1,-1
THIRTY.txt,131127,132629,1502,10,N,N,-,-1,-1
THIRTY.txt,131336,132767,1431,10,N,N,-,-1,-1
THIRTY.txt,131476,132863,1387,10,N,N,-,-1,-1
THIRTY.txt,131585,132927,1342,10,N,N,-,-1,-1
THIRTY.txt,131650,133178,1528,10,N,N,-,-1,-1
THIRTY.txt,131711,133419,1708,10,N,N,-,-1,-1
THIRTY.txt,131897,133592,1695,10,N,N,-,-1,-1
THIRTY.txt,132011,133843,1832,10,N,N,-,-1,-1
THIRTY.txt,132081,133975,1894,10,N,N,-,-1,-1
THIRTY.txt,132355,134265,1910,10,N,N,-,-1,-1
THIRTY.txt,132632,134542,1910,10,N,N,-,-1,-1
THIRTY.txt,132769,134658,1889,10,N,N,-,-1,-1
THIRTY.txt,132864,134969,2105,10,N,N,-,-1,-1
THIRTY.txt,132928,135091,2163,10,N,N,-,-1,-1
THIRTY.txt,133180,135108,1928,10,N,N,-,-1,-1
THIRTY.txt,133420,135377,1957,10,N,N,-,-1,-1
THIRTY.txt,133593,135420,1827,10,N,N,-,-1,-1
THIRTY.txt,133844,135499,1655,10,N,N,-,-1,-1
THIRTY.txt,133976,135648,1672,10,N,N,-,-1,-1
THIRTY.txt,134268,135723,1455,10,N,N,-,-1,-1
THIRTY.txt,134545,135870,1325,10,N,N,-,-1,-1
THIRTY.txt,134659,135895,1236,10,N,N,-,-1,-1
THIRTY.txt,134970,135991,1021,10,N,N,-,-1,-1
THIRTY.txt,135092,136023,931,10,N,N,-,-1,-1
THIRTY.txt,135109,136109,1000,10,N,N,-,-1,-1
THIRTY.txt,135378,136122,744,10,N,N,-,-1,-1
THIRTY.txt,135423,136129,706,10,N,N,-,-1,-1
THIRTY.txt,135500,136155,655,10,N,N,-,-1,-1
THIRTY.txt,135649,136192,543,10,N,N,-,-1,-1
THIRTY.txt,135723,136196,473,10,N,N,-,-1,-1
THIRTY.txt,135871,136207,336,10,N,N,-,-1,-1
THIRTY.txt,135900,136226,326,10,N,N,-,-1,-1
THIRTY.txt,135991,136239,248,10,N,N,-,-1,-1
THIRTY.txt,136025,136279,254,10,N,N,-,-1,-1
THIRTY.txt,136109,136336,227,10,N,N,-,-1,-1
THIRTY.txt,136123,136338,215,10,N,N,-,-1,-1
THIRTY.txt,136132,136340,208,10,N,N,-,-1,-1
THIRTY.txt,136155,136357,202,10,N,N,-,-1,-1
THIRTY.txt,136193,136498,305,10,N,N,-,-1,-1
THIRTY.txt,136197,136504,307,10,N,N,-,-1,-1
THIRTY.txt,136210,136513,303,10,N,N,-,-1,-1
THIRTY.txt,136226,136517,291,10,N,N,-,-1,-1
THIRTY.txt,136239,136523,284,10,N,N,-,-1,-1
THIRTY.txt,136284,136525,241,10,N,N,-,-1,-1
THIRTY.txt,136336,136527,191,10,N,N,-,-1,-1
THIRTY.txt,136338,136528,190,10,N,N,-,-1,-1
THIRTY.txt,136341,136554,213,10,N,N,-,-1,-1
THIRTY.txt,136359,136565,206,10,N,N,-,-1,-1
THIRTY.txt,136501,136581,80,10,N,N,-,-1,-1
THIRTY.txt,136505,136582,77,10,N,N,-,-1,-1
THIRTY.txt,136513,136592,79,10,N,N,-,-1,-1
THIRTY.txt,136518,136594,76,10,N,N,-,-1,-1
THIRTY.txt,136523,136606,83,10,N,N,-,-1,-1
THIRTY.txt,136525,136622,97,10,N,N,-,-1,-1
THIRTY.txt,136527,136628,101,10,N,N,-,-1,-1
THIRTY.txt,136528,136640,112,10,N,N,-,-1,-1
THIRTY.txt,136555,136665,110,10,N,N,-,-1,-1
THIRTY.txt,136567,136667,100,10,N,N,-,-1,-1
THIRTY.txt,136581,136676,95,10,N,N,-,-1,-1
THIRTY.txt,136582,136684,102,10,N,N,-,-1,-1
THIRTY.txt,136593,136703,110,10,N,N,-,-1,-1
THIRTY.txt,136596,136735,139,10,N,N,-,-1,-1
THIRTY.txt,136607,136767,160,10,N,N,-,-1,-1
THIRTY.txt,136627,136785,158,10,N,N,-,-1,-1
THIRTY.txt,136628,136799,171,10,N,N,-,-1,-1
THIRTY.txt,136645,136816,171,10,N,N,-,-1,-1
THIRTY.txt,136665,136817,152,10,N,N,-,-1,-1
THIRTY.txt,136672,136818,146,10,N,N,-,-1,-1
THIRTY.txt,136677,136850,173,10,N,N,-,-1,-1
THIRTY.txt,136689,136872,183,10,N,N,-,-1,-1
THIRTY.txt,136704,136879,175,10,N,N,-,-1,-1
THIRTY.txt,136737,136901,164,10,N,N,-,-1,-1
THIRTY.txt,136772,136904,132,10,N,N,-,-1,-1
THIRTY.txt,136787,136945,158,10,N,N,-,-1,-1
THIRTY.txt,136802,136978,176,10,N,N,-,-1,-1
THIRTY.txt,136816,136985,169,10,N,N,-,-1,-1
THIRTY.txt,136817,136993,176,10,N,N,-,-1,-1
THIRTY.txt,136823,136995,172,10,N,N,-,-1,-1
THIRTY.txt,136852,137005,153,10,N,N,-,-1,-1
THIRTY.txt,136874,137051,177,10,N,N,-,-1,-1
THIRTY.txt,136884,137073,189,10,N,N,-,-1,-1
THIRTY.txt,136901,137076,175,10,N,N,-,-1,-1
THIRTY.txt,136904,137082,178,10,N,N,-,-1,-1
THIRTY.txt,136950,137092,142,10,N,N,-,-1,-1
THIRTY.txt,136978,137547,569,10,N,N,-,-1,-1
THIRTY.txt,136986,137799,813,10,N,N,-,-1,-1
THIRTY.txt,136993,137900,907,10,N,N,-,-1,-1
THIRTY.txt,136995,138169,1174,10,N,N,-,-1,-1
THIRTY.txt,137005,138283,1278,10,N,N,-,-1,-1
THIRTY.txt,137051,138721,1670,10,Y,N,-,-1,-1
THIRTY.txt,137073,138838,1765,10,Y,N,-,-1,-1
THIRTY.txt,137076,138845,1769,10,Y,N,-,-1,-1
THIRTY.txt,137083,138943,1860,10,Y,N,-,-1,-1
THIRTY.txt,137092,139191,2099,10,Y,N,-,-1,-1
THIRTY.txt,137548,139288,1740,10,Y,N,-,-1,-1
THIRTY.txt,137800,139505,1705,10,N,N,-,-1,-1
THIRTY.txt,137901,139587,1686,10,N,N,-,-1,-1
THIRTY.txt,138172,139619,1447,10,N,N,-,-1,-1
THIRTY.txt,138284,139671,1387,10,N,N,-,-1,-1
THIRTY.txt,138722,139774,1052,10,N,N,-,-1,-1
THIRTY.txt,138841,139877,1036,10,N,N,-,-1,-1
THIRTY.txt,138850,140054,1204,10,N,N,-,-1,-1
THIRTY.txt,138944,140101,1157,10,N,N,-,-1,-1
THIRTY.txt,139192,140293,1101,10,N,N,-,-1,-1
THIRTY.txt,139289,140527,1238,10,N,N,-,-1,-1
THIRTY.txt,139506,140629,1123,10,N,N,-,-1,-1
THIRTY.txt,139588,140887,1299,10,N,N,-,-1,-1
THIRTY.txt,139620,140984,1364,10,N,N,-,-1,-1
THIRTY.txt,139674,141023,1349,10,N,N,-,-1,-1
THIRTY.txt,139775,141283,1508,10,N,N,-,-1,-1
THIRTY.txt,139878,141411,1533,10,N,N,-,-1,-1
THIRTY.txt,140055,141658,1603,10,N,N,-,-1,-1
THIRTY.txt,140102,141731,1629,10,N,N,-,-1,-1
THIRTY.txt,140294,141950,1656,10,N,N,-,-1,-1
THIRTY.txt,140528,142002,1474,10,N,N,-,-1,-1
THIRTY.txt,140632,142562,1930,10,N,N,-,-1,-1
THIRTY.txt,140888,142585,1697,10,N,N,-,-1,-1
THIRTY.txt,140985,142642,1657,10,N,N,-,-1,-1
THIRTY.txt,141023,142856,1833,10,N,N,-,-1,-1
THIRTY.txt,141284,142933,1649,10,N,N,-,-1,-1
THIRTY.txt,141412,143160,1748,10,N,N,-,-1,-1
THIRTY.txt,141661,143406,1745,10,N,N,-,-1,-1
THIRTY.txt,141732,143502,1770,10,N,N,-,-1,-1
THIRTY.txt,141953,143630,1677,10,N,N,-,-1,-1
THIRTY.txt,142003,144034,2031,10,N,N,-,-1,-1
THIRTY.txt,142563,144199,1636,10,N,N,-,-1,-1
THIRTY.txt,142585,144267,1682,10,N,N,-,-1,-1
THIRTY.txt,142644,144425,1781,10,N,N,-,-1,-1
THIRTY.txt,142857,144557,1700,10,N,N,-,-1,-1
THIRTY.txt,142934,144999,2065,10,N,N,-,-1,-1
THIRTY.txt,143163,145077,1914,10,N,N,-,-1,-1
THIRTY.txt,143407,145267,1860,10,N,N,-,-1,-1
THIRTY.txt,143503,145400,1897,10,N,N,-,-1,-1
THIRTY.txt,143630,145592,1962,10,N,N,-,-1,-1
THIRTY.txt,144035,145626,1591,10,N,N,-,-1,-1
THIRTY.txt,144200,145717,1517,10,N,N,-,-1,-1
THIRTY.txt,144268,145785,1517,10,N,N,-,-1,-1
THIRTY.txt,144427,145835,1408,10,N,Y,1448280297446,84055,84972
THIRTY.txt,144558,146066,1508,10,N,Y,1448280297446,84055,84972
THIRTY.txt,144999,146207,1208,10,N,Y,1448280297446,84055,84972
THIRTY.txt,145079,146389,1310,10,N,Y,1448280297446,84055,84972
THIRTY.txt,145268,146592,1324,10,N,Y,1448280297446,84055,84972
THIRTY.txt,145401,146694,1293,10,N,Y,1448280297446,84055,84972
THIRTY.txt,145593,146744,1151,10,N,Y,1448280297446,84055,84972
THIRTY.txt,145627,146902,1275,10,N,Y,1448280297446,84055,84972
THIRTY.txt,145720,147279,1559,10,N,Y,1448280297446,84055,84972
THIRTY.txt,145786,147373,1587,10,N,Y,1448280297446,84055,84972
THIRTY.txt,145836,147606,1770,10,N,Y,1448280297446,84055,84972
THIRTY.txt,146069,147851,1782,10,N,Y,1448280297446,84055,84972
THIRTY.txt,146208,148468,2260,10,N,Y,1448280297446,84055,84972
THIRTY.txt,146392,148565,2173,10,N,Y,1448280297446,84055,84972
THIRTY.txt,146593,148795,2202,10,Y,Y,1448280297446,84055,84972
THIRTY.txt,146695,149038,2343,10,Y,Y,1448280297446,84055,84972
THIRTY.txt,146745,149301,2556,10,Y,Y,1448280297446,84055,84972
THIRTY.txt,146903,149535,2632,10,Y,Y,1448280297446,84055,84972
THIRTY.txt,147280,149885,2605,10,Y,Y,1448280297446,84055,84972
THIRTY.txt,147374,150200,2826,10,Y,Y,1448280297446,84055,84972
THIRTY.txt,147607,150447,2840,10,Y,Y,1448280297446,84055,84972
THIRTY.txt,147854,150517,2663,10,Y,N,-,-1,-1
THIRTY.txt,148469,150615,2146,10,Y,N,-,-1,-1
THIRTY.txt,148566,150698,2132,10,Y,N,-,-1,-1
THIRTY.txt,148796,150879,2083,10,N,N,-,-1,-1
THIRTY.txt,149039,150940,1901,10,N,N,-,-1,-1
THIRTY.txt,149304,151050,1746,10,N,N,-,-1,-1
THIRTY.txt,149536,151181,1645,10,N,Y,1448287490368,120754,123385
THIRTY.txt,149886,151214,1328,10,N,Y,1448287490368,120754,123385
THIRTY.txt,150201,151428,1227,10,N,Y,1448287490368,120754,123385
THIRTY.txt,150448,151666,1218,10,N,Y,1448287490368,120754,123385
THIRTY.txt,150518,151946,1428,10,N,Y,1448287490368,120754,123385
THIRTY.txt,150616,152157,1541,10,N,Y,1448287490368,120754,123385
THIRTY.txt,150699,152228,1529,10,N,Y,1448287490368,120754,123385
THIRTY.txt,150881,152436,1555,10,N,Y,1448287490368,120754,123385
THIRTY.txt,150941,152614,1673,10,N,Y,1448287490368,120754,123385
THIRTY.txt,151053,152906,1853,10,N,Y,1448287490368,120754,123385
THIRTY.txt,151182,153068,1886,10,N,Y,1448287490368,120754,123385
THIRTY.txt,151215,153337,2122,10,N,Y,1448287490368,120754,123385
THIRTY.txt,151429,153358,1929,10,N,Y,1448287490368,120754,123385
THIRTY.txt,151667,153380,1713,10,N,Y,1448287490368,120754,123385
THIRTY.txt,151947,153507,1560,10,N,Y,1448287490368,120754,123385
THIRTY.txt,152160,153834,1674,10,N,Y,1448287490368,120754,123385
THIRTY.txt,152229,153916,1687,10,N,Y,1448287490368,120754,123385
THIRTY.txt,152437,153999,1562,10,N,Y,1448287490368,120754,123385
THIRTY.txt,152616,154104,1488,10,N,Y,1448287490368,120754,123385
THIRTY.txt,152907,154244,1337,10,N,Y,1448287490368,120754,123385
THIRTY.txt,153069,154291,1222,10,N,Y,1448287490368,120754,123385
THIRTY.txt,153337,154491,1154,10,N,Y,1448287490368,120754,123385
THIRTY.txt,153359,154594,1235,10,N,Y,1448287490368,120754,123385
THIRTY.txt,153383,154768,1385,10,N,Y,1448287490368,120754,123385
THIRTY.txt,153510,154872,1362,10,N,Y,1448314503640,180207,180355
THIRTY.txt,153835,155264,1429,10,N,Y,1448314503640,180207,180355
THIRTY.txt,153917,155501,1584,10,N,Y,1448314503640,180207,180355
THIRTY.txt,154000,155536,1536,10,N,Y,1448314503640,180207,180355
THIRTY.txt,154105,155589,1484,10,N,Y,1448314503640,180207,180355
THIRTY.txt,154247,155821,1574,10,N,Y,1448314503640,180207,180355
THIRTY.txt,154293,155988,1695,10,N,Y,1448314503640,180207,180355
THIRTY.txt,154492,156248,1756,10,N,Y,1448314503640,180207,180355
THIRTY.txt,154597,156380,1783,10,N,Y,1448314503640,180207,180355
THIRTY.txt,154773,156803,2030,10,Y,Y,1448314503640,180207,180355
THIRTY.txt,154873,156831,1958,10,Y,Y,1448314503640,180207,180355
THIRTY.txt,155266,156856,1590,10,N,Y,1448314503640,180207,180355
THIRTY.txt,155502,157071,1569,10,N,Y,1448314503640,180207,180355
THIRTY.txt,155537,157180,1643,10,N,Y,1448314503640,180207,180355
THIRTY.txt,155590,157249,1659,10,N,N,-,-1,-1
THIRTY.txt,155822,157395,1573,10,N,N,-,-1,-1
THIRTY.txt,155989,157476,1487,10,N,N,-,-1,-1
THIRTY.txt,156249,157633,1384,10,N,N,-,-1,-1
THIRTY.txt,156385,157864,1479,10,N,N,-,-1,-1
THIRTY.txt,156804,158050,1246,10,N,N,-,-1,-1
THIRTY.txt,156834,158187,1353,10,N,N,-,-1,-1
THIRTY.txt,156857,158394,1537,10,N,N,-,-1,-1
THIRTY.txt,157072,158561,1489,10,N,N,-,-1,-1
THIRTY.txt,157182,158788,1606,10,N,N,-,-1,-1
THIRTY.txt,157250,159006,1756,10,N,N,-,-1,-1
THIRTY.txt,157396,159078,1682,10,N,N,-,-1,-1
THIRTY.txt,157477,159242,1765,10,N,N,-,-1,-1
THIRTY.txt,157634,159408,1774,10,N,N,-,-1,-1
THIRTY.txt,157865,159543,1678,10,N,N,-,-1,-1
THIRTY.txt,158053,159679,1626,10,N,N,-,-1,-1
THIRTY.txt,158188,159858,1670,10,N,N,-,-1,-1
THIRTY.txt,158395,159913,1518,10,N,N,-,-1,-1
THIRTY.txt,158562,160023,1461,10,N,N,-,-1,-1
THIRTY.txt,158789,160456,1667,10,N,N,-,-1,-1
THIRTY.txt,159009,160548,1539,10,N,N,-,-1,-1
THIRTY.txt,159079,160863,1784,10,N,N,-,-1,-1
THIRTY.txt,159243,161110,1867,10,N,N,-,-1,-1
THIRTY.txt,159409,161308,1899,10,N,N,-,-1,-1
THIRTY.txt,159545,161408,1863,10,N,N,-,-1,-1
THIRTY.txt,159680,161534,1854,10,N,N,-,-1,-1
THIRTY.txt,159859,161631,1772,10,N,N,-,-1,-1
THIRTY.txt,159914,161775,1861,10,N,N,-,-1,-1
THIRTY.txt,160024,161923,1899,10,N,N,-,-1,-1
THIRTY.txt,160457,162024,1567,10,N,N,-,-1,-1
THIRTY.txt,160551,162074,1523,10,N,N,-,-1,-1
THIRTY.txt,160864,162153,1289,10,N,N,-,-1,-1
THIRTY.txt,161111,162285,1174,10,N,N,-,-1,-1
THIRTY.txt,161309,162524,1215,10,N,N,-,-1,-1
THIRTY.txt,161409,162642,1233,10,N,N,-,-1,-1
THIRTY.txt,161535,162754,1219,10,N,N,-,-1,-1
THIRTY.txt,161632,163021,1389,10,N,N,-,-1,-1
THIRTY.txt,161776,163204,1428,10,N,N,-,-1,-1
THIRTY.txt,161926,163244,1318,10,N,N,-,-1,-1
THIRTY.txt,162025,163580,1555,10,N,N,-,-1,-1
THIRTY.txt,162075,163638,1563,10,N,N,-,-1,-1
THIRTY.txt,162154,163696,1542,10,N,N,-,-1,-1
THIRTY.txt,162286,163724,1438,10,N,N,-,-1,-1
THIRTY.txt,162525,163868,1343,10,N,N,-,-1,-1
THIRTY.txt,162643,163896,1253,10,N,N,-,-1,-1
THIRTY.txt,162756,163963,1207,10,N,N,-,-1,-1
THIRTY.txt,163022,164021,999,10,N,N,-,-1,-1
THIRTY.txt,163205,164041,836,10,N,N,-,-1,-1
THIRTY.txt,163247,164220,973,10,N,N,-,-1,-1
THIRTY.txt,163581,164335,754,10,N,N,-,-1,-1
THIRTY.txt,163640,164596,956,10,N,N,-,-1,-1
THIRTY.txt,163697,164603,906,10,N,N,-,-1,-1
THIRTY.txt,163725,164641,916,10,N,N,-,-1,-1
THIRTY.txt,163869,164884,1015,10,N,N,-,-1,-1
THIRTY.txt,163897,164925,1028,10,N,N,-,-1,-1
THIRTY.txt,163964,165281,1317,10,N,N,-,-1,-1
THIRTY.txt,164022,165494,1472,10,N,N,-,-1,-1
THIRTY.txt,164046,165582,1536,10,N,N,-,-1,-1
THIRTY.txt,164221,165874,1653,10,N,N,-,-1,-1
THIRTY.txt,164338,166087,1749,10,N,N,-,-1,-1
THIRTY.txt,164597,166147,1550,10,N,N,-,-1,-1
THIRTY.txt,164604,166232,1628,10,N,N,-,-1,-1
THIRTY.txt,164642,166425,1783,10,N,Y,1448313800274,179025,179317
THIRTY.txt,164886,166513,1627,10,N,Y,1448313800274,179025,179317
THIRTY.txt,164926,166628,1702,10,N,Y,1448313800274,179025,179317
THIRTY.txt,165282,166721,1439,10,N,Y,1448313800274,179025,179317
THIRTY.txt,165497,166809,1312,10,N,Y,1448313800274,179025,179317
THIRTY.txt,165583,166857,1274,10,N,Y,1448313800274,179025,179317
THIRTY.txt,165875,167121,1246,10,N,Y,1448313800274,179025,179317
THIRTY.txt,166089,167209,1120,10,N,Y,1448313800274,179025,179317
THIRTY.txt,166148,167238,1090,10,N,Y,1448313800274,179025,179317
THIRTY.txt,166235,167262,1027,10,N,Y,1448313800274,179025,179317
THIRTY.txt,166427,167515,1088,10,N,Y,1448313800274,179025,179317
THIRTY.txt,166514,167690,1176,10,N,Y,1448313800274,179025,179317
THIRTY.txt,166629,167954,1325,10,N,Y,1448313800274,179025,179317
THIRTY.txt,166722,168270,1548,10,N,Y,1448313800274,179025,179317
THIRTY.txt,166810,168327,1517,10,N,Y,1448313800274,179025,179317
THIRTY.txt,166858,168450,1592,10,N,Y,1448313800274,179025,179317
THIRTY.txt,167124,168588,1464,10,N,N,-,-1,-1
THIRTY.txt,167210,168705,1495,10,N,N,-,-1,-1
THIRTY.txt,167239,168854,1615,10,N,N,-,-1,-1
THIRTY.txt,167263,169036,1773,10,N,N,-,-1,-1
THIRTY.txt,167515,169240,1725,10,N,N,-,-1,-1
THIRTY.txt,167691,169335,1644,10,N,N,-,-1,-1
THIRTY.txt,167955,169572,1617,10,N,N,-,-1,-1
THIRTY.txt,168271,169668,1397,10,N,N,-,-1,-1
THIRTY.txt,168328,169876,1548,10,N,N,-,-1,-1
THIRTY.txt,168453,170265,1812,10,Y,N,-,-1,-1
THIRTY.txt,168589,170614,2025,10,Y,N,-,-1,-1
THIRTY.txt,168710,170835,2125,10,Y,N,-,-1,-1
THIRTY.txt,168857,170927,2070,10,Y,N,-,-1,-1
THIRTY.txt,169036,171011,1975,10,Y,N,-,-1,-1
THIRTY.txt,169242,171284,2042,10,Y,N,-,-1,-1
THIRTY.txt,169337,171563,2226,10,Y,N,-,-1,-1
THIRTY.txt,169573,171648,2075,10,Y,N,-,-1,-1
THIRTY.txt,169669,171877,2208,10,Y,N,-,-1,-1
THIRTY.txt,169877,171921,2044,10,Y,N,-,-1,-1
THIRTY.txt,170266,172358,2092,10,N,Y,1448360754961,270225,271673
THIRTY.txt,170615,172451,1836,10,N,Y,1448360754961,270225,271673
THIRTY.txt,170838,172706,1868,10,N,Y,1448360754961,270225,271673
THIRTY.txt,170929,172834,1905,10,N,Y,1448360754961,270225,271673
THIRTY.txt,171012,172927,1915,10,N,Y,1448360754961,270225,271673
THIRTY.txt,171285,173171,1886,10,Y,Y,1448360754961,270225,271673
THIRTY.txt,171564,173203,1639,10,Y,Y,1448360754961,270225,271673
THIRTY.txt,171649,173253,1604,10,Y,Y,1448360754961,270225,271673
THIRTY.txt,171878,173400,1522,10,Y,Y,1448360754961,270225,271673
THIRTY.txt,171922,173650,1728,10,Y,Y,1448360754961,270225,271673
THIRTY.txt,172363,173930,1567,10,Y,Y,1448360754961,270225,271673
THIRTY.txt,172452,174066,1614,10,Y,Y,1448360754961,270225,271673
THIRTY.txt,172707,174188,1481,10,Y,Y,1448360754961,270225,271673
THIRTY.txt,172836,174212,1376,10,Y,Y,1448360754961,270225,271673
THIRTY.txt,172928,174234,1306,10,Y,Y,1448360754961,270225,271673
THIRTY.txt,173174,174329,1155,10,N,Y,1448360754961,270225,271673
THIRTY.txt,173206,174421,1215,10,N,Y,1448360754961,270225,271673
THIRTY.txt,173254,174499,1245,10,N,Y,1448360754961,270225,271673
THIRTY.txt,173401,174548,1147,10,N,Y,1448360754961,270225,271673
THIRTY.txt,173651,174583,932,10,N,Y,1448360754961,270225,271673
THIRTY.txt,173931,174633,702,10,N,Y,1448322979449,227304,227638
THIRTY.txt,174068,174725,657,10,N,Y,1448322979449,227304,227638
THIRTY.txt,174189,175014,825,10,N,Y,1448322979449,227304,227638
THIRTY.txt,174213,175167,954,10,N,Y,1448322979449,227304,227638
THIRTY.txt,174235,175205,970,10,N,Y,1448322979449,227304,227638
THIRTY.txt,174330,175243,913,10,N,Y,1448322979449,227304,227638
THIRTY.txt,174423,175380,957,10,N,Y,1448322979449,227304,227638
THIRTY.txt,174502,175702,1200,10,N,Y,1448322979449,227304,227638
THIRTY.txt,174551,175848,1297,10,N,Y,1448322979449,227304,227638
THIRTY.txt,174586,176134,1548,10,N,Y,1448322979449,227304,227638
THIRTY.txt,174635,176246,1611,10,N,Y,1448322979449,227304,227638
THIRTY.txt,174726,176397,1671,10,N,Y,1448322979449,227304,227638
THIRTY.txt,175015,176743,1728,10,N,Y,1448322979449,227304,227638
THIRTY.txt,175172,176858,1686,10,N,N,-,-1,-1
THIRTY.txt,175208,177025,1817,10,N,N,-,-1,-1
THIRTY.txt,175244,177150,1906,10,N,N,-,-1,-1
THIRTY.txt,175381,177332,1951,10,N,N,-,-1,-1
THIRTY.txt,175703,177444,1741,10,N,Y,1448369582981,281838,282369
THIRTY.txt,175849,177654,1805,10,N,Y,1448369582981,281838,282369
THIRTY.txt,176137,177759,1622,10,N,Y,1448369582981,281838,282369
THIRTY.txt,176247,178277,2030,10,N,Y,1448369582981,281838,282369
THIRTY.txt,176402,178350,1948,10,N,Y,1448369582981,281838,282369
THIRTY.txt,176746,178492,1746,10,N,Y,1448369582981,281838,282369
THIRTY.txt,176859,178685,1826,10,N,Y,1448369582981,281838,282369
THIRTY.txt,177026,178843,1817,10,N,Y,1448359608080,265546,265784
THIRTY.txt,177151,179051,1900,10,N,Y,1448359608080,265546,265784
THIRTY.txt,177335,179064,1729,10,N,Y,1448359608080,265546,265784
THIRTY.txt,177445,179145,1700,10,N,Y,1448359608080,265546,265784
THIRTY.txt,177655,179293,1638,10,N,Y,1448359608080,265546,265784
THIRTY.txt,177761,179472,1711,10,N,Y,1448359608080,265546,265784
THIRTY.txt,178280,179713,1433,10,N,Y,1448359608080,265546,265784
THIRTY.txt,178351,179850,1499,10,N,Y,1448359608080,265546,265784
THIRTY.txt,178493,180064,1571,10,N,Y,1448359608080,265546,265784
THIRTY.txt,178687,180295,1608,10,N,Y,1448359608080,265546,265784
THIRTY.txt,178844,180682,1838,10,N,Y,1448285913012,108803,110925
THIRTY.txt,179052,180913,1861,10,N,Y,1448285913012,108803,110925
THIRTY.txt,179065,181031,1966,10,N,Y,1448285913012,108803,110925
THIRTY.txt,179146,181124,1978,10,N,Y,1448285913012,108803,110925
THIRTY.txt,179298,181287,1989,10,N,Y,1448285913012,108803,110925
THIRTY.txt,179474,181446,1972,10,N,Y,1448285913012,108803,110925
THIRTY.txt,179714,181818,2104,10,N,Y,1448285913012,108803,110925
THIRTY.txt,179851,182019,2168,10,N,Y,1448285913012,108803,110925
THIRTY.txt,180066,182185,2119,10,N,Y,1448285913012,108803,110925
THIRTY.txt,180296,182296,2000,10,N,Y,1448285913012,108803,110925
THIRTY.txt,180683,182419,1736,10,N,N,-,-1,-1
THIRTY.txt,180914,182805,1891,10,N,Y,1448366290289,275380,275651
THIRTY.txt,181034,183066,2032,10,N,Y,1448366290289,275380,275651
THIRTY.txt,181125,183271,2146,10,N,Y,1448366290289,275380,275651
THIRTY.txt,181289,183485,2196,10,N,Y,1448366290289,275380,275651
THIRTY.txt,181447,183782,2335,10,N,Y,1448366290289,275380,275651
THIRTY.txt,181819,184086,2267,10,N,Y,1448366290289,275380,275651
THIRTY.txt,182020,184175,2155,10,N,Y,1448366290289,275380,275651
THIRTY.txt,182186,184267,2081,10,N,Y,1448366290289,275380,275651
THIRTY.txt,182299,184413,2114,10,N,Y,1448366290289,275380,275651
THIRTY.txt,182420,184502,2082,10,N,Y,1448366290289,275380,275651
THIRTY.txt,182806,184807,2001,10,N,Y,1448366290289,275380,275651
THIRTY.txt,183067,184897,1830,10,N,Y,1448366290289,275380,275651
THIRTY.txt,183272,184914,1642,10,N,Y,1448366290289,275380,275651
THIRTY.txt,183486,185009,1523,10,N,N,-,-1,-1
THIRTY.txt,183785,185071,1286,10,N,N,-,-1,-1
THIRTY.txt,184091,185216,1125,10,N,N,-,-1,-1
THIRTY.txt,184177,185257,1080,10,N,N,-,-1,-1
THIRTY.txt,184268,185337,1069,10,N,N,-,-1,-1
THIRTY.txt,184414,185412,998,10,N,N,-,-1,-1
THIRTY.txt,184503,185528,1025,10,N,N,-,-1,-1
THIRTY.txt,184808,185646,838,10,N,N,-,-1,-1
THIRTY.txt,184900,185696,796,10,N,N,-,-1,-1
THIRTY.txt,184916,185926,1010,10,N,N,-,-1,-1
THIRTY.txt,185010,185990,980,10,N,N,-,-1,-1
THIRTY.txt,185072,186162,1090,10,N,N,-,-1,-1
THIRTY.txt,185217,186188,971,10,N,N,-,-1,-1
THIRTY.txt,185258,186361,1103,10,N,N,-,-1,-1
THIRTY.txt,185342,186388,1046,10,N,N,-,-1,-1
THIRTY.txt,185413,186513,1100,10,N,N,-,-1,-1
THIRTY.txt,185529,186590,1061,10,N,N,-,-1,-1
THIRTY.txt,185647,186645,998,10,N,N,-,-1,-1
THIRTY.txt,185697,186801,1104,10,N,N,-,-1,-1
THIRTY.txt,185927,186989,1062,10,N,N,-,-1,-1
THIRTY.txt,185991,187028,1037,10,N,N,-,-1,-1
THIRTY.txt,186163,187162,999,10,N,N,-,-1,-1
THIRTY.txt,186189,187344,1155,10,N,N,-,-1,-1
THIRTY.txt,186362,187449,1087,10,N,N,-,-1,-1
THIRTY.txt,186389,187471,1082,10,N,N,-,-1,-1
THIRTY.txt,186514,187516,1002,10,N,N,-,-1,-1
THIRTY.txt,186591,187674,1083,10,N,N,-,-1,-1
THIRTY.txt,186646,187789,1143,10,N,N,-,-1,-1
THIRTY.txt,186802,188035,1233,10,Y,N,-,-1,-1
THIRTY.txt,186990,188212,1222,10,N,N,-,-1,-1
THIRTY.txt,187031,188625,1594,10,N,N,-,-1,-1
THIRTY.txt,187163,188648,1485,10,N,N,-,-1,-1
THIRTY.txt,187345,188733,1388,10,N,N,-,-1,-1
THIRTY.txt,187450,188884,1434,10,N,N,-,-1,-1
THIRTY.txt,187472,189117,1645,10,Y,N,-,-1,-1
THIRTY.txt,187519,189196,1677,10,Y,N,-,-1,-1
THIRTY.txt,187674,189291,1617,10,N,N,-,-1,-1
THIRTY.txt,187790,189369,1579,10,N,N,-,-1,-1
THIRTY.txt,188036,189450,1414,10,N,N,-,-1,-1
THIRTY.txt,188214,189539,1325,10,N,N,-,-1,-1
THIRTY.txt,188626,189591,965,10,N,N,-,-1,-1
THIRTY.txt,188649,189675,1026,10,N,N,-,-1,-1
THIRTY.txt,188734,189727,993,10,N,N,-,-1,-1
THIRTY.txt,188885,189836,951,10,N,N,-,-1,-1
THIRTY.txt,189120,189926,806,10,N,N,-,-1,-1
THIRTY.txt,189197,190056,859,10,N,N,-,-1,-1
THIRTY.txt,189292,190263,971,10,N,N,-,-1,-1
THIRTY.txt,189371,190476,1105,10,N,N,-,-1,-1
THIRTY.txt,189451,190534,1083,10,N,N,-,-1,-1
THIRTY.txt,189540,190600,1060,10,N,N,-,-1,-1
THIRTY.txt,189592,190685,1093,10,N,N,-,-1,-1
THIRTY.txt,189677,190754,1077,10,N,N,-,-1,-1
THIRTY.txt,189729,190766,1037,10,N,N,-,-1,-1
THIRTY.txt,189837,190817,980,10,N,N,-,-1,-1
THIRTY.txt,189929,190910,981,10,N,N,-,-1,-1
THIRTY.txt,190057,191104,1047,10,N,N,-,-1,-1
THIRTY.txt,190264,191221,957,10,N,N,-,-1,-1
THIRTY.txt,190477,191380,903,10,N,N,-,-1,-1
THIRTY.txt,190535,191518,983,10,N,N,-,-1,-1
THIRTY.txt,190601,191689,1088,10,N,N,-,-1,-1
THIRTY.txt,190686,191715,1029,10,N,N,-,-1,-1
THIRTY.txt,190755,191774,1019,10,N,N,-,-1,-1
THIRTY.txt,190767,191839,1072,10,N,N,-,-1,-1
THIRTY.txt,190820,191905,1085,10,N,N,-,-1,-1
THIRTY.txt,190911,192021,1110,10,N,N,-,-1,-1
THIRTY.txt,191105,192132,1027,10,N,N,-,-1,-1
THIRTY.txt,191222,192226,1004,10,N,N,-,-1,-1
THIRTY.txt,191382,192372,990,10,N,N,-,-1,-1
THIRTY.txt,191519,192552,1033,10,N,N,-,-1,-1
THIRTY.txt,191692,192570,878,10,N,N,-,-1,-1
THIRTY.txt,191716,192642,926,10,N,N,-,-1,-1
THIRTY.txt,191775,192699,924,10,N,N,-,-1,-1
THIRTY.txt,191842,192847,1005,10,N,N,-,-1,-1
THIRTY.txt,191906,192979,1073,10,N,N,-,-1,-1
THIRTY.txt,192023,193105,1082,10,Y,N,-,-1,-1
THIRTY.txt,192133,193324,1191,10,Y,N,-,-1,-1
THIRTY.txt,192227,193471,1244,10,Y,N,-,-1,-1
THIRTY.txt,192374,193556,1182,10,Y,N,-,-1,-1
THIRTY.txt,192553,193616,1063,10,Y,N,-,-1,-1
THIRTY.txt,192573,193719,1146,10,Y,N,-,-1,-1
THIRTY.txt,192643,193811,1168,10,Y,N,-,-1,-1
THIRTY.txt,192700,193945,1245,10,Y,N,-,-1,-1
THIRTY.txt,192848,194013,1165,10,Y,N,-,-1,-1
THIRTY.txt,192980,194207,1227,10,Y,N,-,-1,-1
THIRTY.txt,193106,194356,1250,10,Y,N,-,-1,-1
THIRTY.txt,193327,194476,1149,10,Y,N,-,-1,-1
THIRTY.txt,193472,194694,1222,10,Y,N,-,-1,-1
THIRTY.txt,193557,194750,1193,10,Y,N,-,-1,-1
THIRTY.txt,193617,194845,1228,10,Y,N,-,-1,-1
THIRTY.txt,193720,194991,1271,10,Y,N,-,-1,-1
THIRTY.txt,193812,195025,1213,10,Y,N,-,-1,-1
THIRTY.txt,193946,195109,1163,10,Y,N,-,-1,-1
THIRTY.txt,194014,195142,1128,10,Y,N,-,-1,-1
THIRTY.txt,194208,195294,1086,10,Y,N,-,-1,-1
THIRTY.txt,194357,195359,1002,10,Y,N,-,-1,-1
THIRTY.txt,194479,195475,996,10,Y,N,-,-1,-1
THIRTY.txt,194695,195561,866,10,Y,N,-,-1,-1
THIRTY.txt,194751,195769,1018,10,Y,N,-,-1,-1
THIRTY.txt,194846,195840,994,10,Y,N,-,-1,-1
THIRTY.txt,194992,196002,1010,10,Y,N,-,-1,-1
THIRTY.txt,195026,196143,1117,10,Y,N,-,-1,-1
THIRTY.txt,195110,196230,1120,10,Y,N,-,-1,-1
THIRTY.txt,195143,196431,1288,10,Y,N,-,-1,-1
THIRTY.txt,195295,196518,1223,10,N,N,-,-1,-1
THIRTY.txt,195359,196544,1185,10,N,N,-,-1,-1
THIRTY.txt,195476,196651,1175,10,N,N,-,-1,-1
THIRTY.txt,195561,196697,1136,10,N,N,-,-1,-1
THIRTY.txt,195770,196698,928,10,N,N,-,-1,-1
THIRTY.txt,195841,196885,1044,10,N,N,-,-1,-1
THIRTY.txt,196005,197014,1009,10,N,N,-,-1,-1
THIRTY.txt,196144,197144,1000,10,N,N,-,-1,-1
THIRTY.txt,196231,197380,1149,10,N,N,-,-1,-1
THIRTY.txt,196432,197533,1101,10,N,N,-,-1,-1
THIRTY.txt,196519,197598,1079,10,N,N,-,-1,-1
THIRTY.txt,196549,197637,1088,10,N,N,-,-1,-1
THIRTY.txt,196652,197858,1206,10,N,N,-,-1,-1
THIRTY.txt,196697,197986,1289,10,N,N,-,-1,-1
THIRTY.txt,196699,198386,1687,10,N,N,-,-1,-1
THIRTY.txt,196886,198499,1613,10,N,N,-,-1,-1
THIRTY.txt,197017,198612,1595,10,N,N,-,-1,-1
THIRTY.txt,197145,198786,1641,10,N,N,-,-1,-1
THIRTY.txt,197381,198950,1569,10,N,N,-,-1,-1
THIRTY.txt,197534,199327,1793,10,N,N,-,-1,-1
THIRTY.txt,197601,199520,1919,10,N,N,-,-1,-1
THIRTY.txt,197638,199831,2193,10,N,N,-,-1,-1
THIRTY.txt,197860,200089,2229,10,Y,N,-,-1,-1
THIRTY.txt,197987,200233,2246,10,Y,N,-,-1,-1
THIRTY.txt,198389,200290,1901,10,Y,N,-,-1,-1
THIRTY.txt,198500,200401,1901,10,N,N,-,-1,-1
THIRTY.txt,198613,200457,1844,10,N,N,-,-1,-1
THIRTY.txt,198787,200588,1801,10,N,N,-,-1,-1
THIRTY.txt,198951,200701,1750,10,N,N,-,-1,-1
THIRTY.txt,199329,200743,1414,10,N,N,-,-1,-1
THIRTY.txt,199523,200938,1415,10,N,N,-,-1,-1
THIRTY.txt,199832,201098,1266,10,N,N,-,-1,-1
THIRTY.txt,200089,201162,1073,10,N,N,-,-1,-1
THIRTY.txt,200234,201355,1121,10,N,N,-,-1,-1
THIRTY.txt,200291,201529,1238,10,N,N,-,-1,-1
THIRTY.txt,200404,201651,1247,10,N,N,-,-1,-1
THIRTY.txt,200458,201770,1312,10,N,N,-,-1,-1
THIRTY.txt,200589,201909,1320,10,N,N,-,-1,-1
THIRTY.txt,200702,202059,1357,10,N,N,-,-1,-1
THIRTY.txt,200745,202384,1639,10,Y,Y,1448281071558,89330,89524
THIRTY.txt,200939,202494,1555,10,Y,Y,1448281071558,89330,89524
THIRTY.txt,201098,202676,1578,10,Y,Y,1448281071558,89330,89524
THIRTY.txt,201165,202765,1600,10,Y,Y,1448281071558,89330,89524
THIRTY.txt,201357,202806,1449,10,Y,Y,1448281071558,89330,89524
THIRTY.txt,201530,202872,1342,10,N,Y,1448281071558,89330,89524
THIRTY.txt,201652,203110,1458,10,Y,Y,1448281071558,89330,89524
THIRTY.txt,201771,203230,1459,10,N,Y,1448281071558,89330,89524
THIRTY.txt,201910,203285,1375,10,N,Y,1448281071558,89330,89524
THIRTY.txt,202062,203362,1300,10,N,Y,1448281071558,89330,89524
THIRTY.txt,202385,203659,1274,10,N,Y,1448280884746,88496,89294
THIRTY.txt,202495,203767,1272,10,N,Y,1448280884746,88496,89294
THIRTY.txt,202677,203950,1273,10,N,Y,1448280884746,88496,89294
THIRTY.txt,202766,204027,1261,10,N,Y,1448280884746,88496,89294
THIRTY.txt,202808,204054,1246,10,N,Y,1448280884746,88496,89294
THIRTY.txt,202873,204145,1272,10,N,Y,1448280884746,88496,89294
THIRTY.txt,203115,204258,1143,10,N,Y,1448280884746,88496,89294
THIRTY.txt,203231,204331,1100,10,N,Y,1448280884746,88496,89294
THIRTY.txt,203285,204523,1238,10,N,Y,1448280884746,88496,89294
THIRTY.txt,203363,204583,1220,10,N,Y,1448280884746,88496,89294
THIRTY.txt,203661,204688,1027,10,N,N,-,-1,-1
THIRTY.txt,203768,204837,1069,10,N,N,-,-1,-1
THIRTY.txt,203951,204970,1019,10,N,N,-,-1,-1
THIRTY.txt,204030,205005,975,10,N,N,-,-1,-1
THIRTY.txt,204056,205057,1001,10,N,N,-,-1,-1
THIRTY.txt,204146,205101,955,10,N,N,-,-1,-1
THIRTY.txt,204259,205228,969,10,N,N,-,-1,-1
THIRTY.txt,204332,205565,1233,10,N,N,-,-1,-1
THIRTY.txt,204526,205608,1082,10,N,N,-,-1,-1
THIRTY.txt,204586,205684,1098,10,N,N,-,-1,-1
THIRTY.txt,204689,205851,1162,10,N,N,-,-1,-1
THIRTY.txt,204838,205869,1031,10,N,N,-,-1,-1
THIRTY.txt,204971,206015,1044,10,N,N,-,-1,-1
THIRTY.txt,205008,206150,1142,10,N,N,-,-1,-1
THIRTY.txt,205060,206549,1489,10,N,N,-,-1,-1
THIRTY.txt,205102,206686,1584,10,N,N,-,-1,-1
THIRTY.txt,205229,206744,1515,10,N,N,-,-1,-1
THIRTY.txt,205565,206995,1430,10,N,N,-,-1,-1
THIRTY.txt,205609,207184,1575,10,N,N,-,-1,-1
THIRTY.txt,205685,207223,1538,10,N,N,-,-1,-1
THIRTY.txt,205854,207264,1410,10,N,N,-,-1,-1
THIRTY.txt,205872,207565,1693,10,N,N,-,-1,-1
THIRTY.txt,206016,207821,1805,10,N,N,-,-1,-1
THIRTY.txt,206155,207928,1773,10,N,N,-,-1,-1
THIRTY.txt,206552,208075,1523,10,N,N,-,-1,-1
THIRTY.txt,206687,208175,1488,10,N,N,-,-1,-1
THIRTY.txt,206746,208511,1765,10,N,N,-,-1,-1
THIRTY.txt,206996,208740,1744,10,N,N,-,-1,-1
THIRTY.txt,207185,208874,1689,10,N,N,-,-1,-1
THIRTY.txt,207224,209113,1889,10,N,N,-,-1,-1
THIRTY.txt,207265,209303,2038,10,N,N,-,-1,-1
THIRTY.txt,207568,209431,1863,10,N,N,-,-1,-1
THIRTY.txt,207822,209597,1775,10,N,N,-,-1,-1
THIRTY.txt,207929,209895,1966,10,N,N,-,-1,-1
THIRTY.txt,208076,210135,2059,10,N,Y,1448393918391,289044,290517
THIRTY.txt,208176,210325,2149,10,N,Y,1448393918391,289044,290517
THIRTY.txt,208512,210451,1939,10,N,Y,1448393918391,289044,290517
THIRTY.txt,208743,210723,1980,10,N,Y,1448393918391,289044,290517
THIRTY.txt,208875,210974,2099,10,N,Y,1448393918391,289044,290517
THIRTY.txt,209114,211074,1960,10,N,Y,1448393918391,289044,290517
THIRTY.txt,209304,211114,1810,10,N,Y,1448393918391,289044,290517
THIRTY.txt,209432,211249,1817,10,N,Y,1448393918391,289044,290517
THIRTY.txt,209598,211435,1837,10,N,Y,1448393918391,289044,290517
THIRTY.txt,209898,211584,1686,10,N,Y,1448393918391,289044,290517
THIRTY.txt,210136,211837,1701,10,N,Y,1448393918391,289044,290517
THIRTY.txt,210326,211961,1635,10,N,Y,1448393552252,287738,288962
THIRTY.txt,210452,212199,1747,10,N,Y,1448393552252,287738,288962
THIRTY.txt,210726,212324,1598,10,N,Y,1437471397525,350644,351290
THIRTY.txt,210976,212394,1418,10,N,Y,1437471397525,350644,351290
THIRTY.txt,211076,212562,1486,10,N,Y,1437471397525,350644,351290
THIRTY.txt,211115,212744,1629,10,N,Y,1437471397525,350644,351290
THIRTY.txt,211250,213040,1790,10,N,Y,1437471397525,350644,351290
THIRTY.txt,211436,213269,1833,10,N,Y,1437471397525,350644,351290
THIRTY.txt,211585,213444,1859,10,N,Y,1437471397525,350644,351290
THIRTY.txt,211840,213491,1651,10,N,Y,1437471397525,350644,351290
THIRTY.txt,211962,213618,1656,10,N,Y,1437471397525,350644,351290
THIRTY.txt,212200,213994,1794,10,N,Y,1437471397525,350644,351290
THIRTY.txt,212325,214067,1742,10,N,Y,1437471397525,350644,351290
THIRTY.txt,212395,214182,1787,10,N,Y,1437471397525,350644,351290
THIRTY.txt,212563,214290,1727,10,N,Y,1437471397525,350644,351290
THIRTY.txt,212745,214408,1663,10,N,Y,1437471397525,350644,351290
THIRTY.txt,213041,214562,1521,10,N,Y,1437471397525,350644,351290
THIRTY.txt,213272,214688,1416,10,N,Y,1448357582358,234204,234401
THIRTY.txt,213445,214751,1306,10,N,Y,1448357582358,234204,234401
THIRTY.txt,213492,214841,1349,10,N,Y,1448285563397,102964,108476
THIRTY.txt,213619,215006,1387,10,N,Y,1448285563397,102964,108476
THIRTY.txt,213995,215158,1163,10,N,Y,1448285563397,102964,108476
THIRTY.txt,214068,215317,1249,10,N,Y,1448285563397,102964,108476
THIRTY.txt,214183,215366,1183,10,N,Y,1448285563397,102964,108476
THIRTY.txt,214291,215500,1209,10,N,Y,1448285563397,102964,108476
THIRTY.txt,214410,215742,1332,10,Y,Y,1448285563397,102964,108476
THIRTY.txt,214564,215782,1218,10,Y,Y,1448285563397,102964,108476
THIRTY.txt,214691,215884,1193,10,N,Y,1448285563397,102964,108476
THIRTY.txt,214752,216009,1257,10,N,Y,1448285563397,102964,108476
THIRTY.txt,214842,216110,1268,10,N,Y,1448285563397,102964,108476
THIRTY.txt,215007,216450,1443,10,Y,Y,1448285563397,102964,108476
THIRTY.txt,215159,216713,1554,10,Y,Y,1448285563397,102964,108476
THIRTY.txt,215318,216931,1613,10,Y,Y,1448285563397,102964,108476
THIRTY.txt,215369,216983,1614,10,Y,Y,1448285563397,102964,108476
THIRTY.txt,215501,217072,1571,10,N,Y,1448285563397,102964,108476
THIRTY.txt,215743,217378,1635,10,N,Y,1448285563397,102964,108476
THIRTY.txt,215783,217557,1774,10,N,Y,1448285563397,102964,108476
THIRTY.txt,215885,217733,1848,10,N,Y,1448285563397,102964,108476
THIRTY.txt,216010,217912,1902,10,Y,Y,1448285563397,102964,108476
THIRTY.txt,216111,218099,1988,10,Y,Y,1448285563397,102964,108476
THIRTY.txt,216451,218233,1782,10,N,Y,1448285563397,102964,108476
THIRTY.txt,216715,218343,1628,10,N,Y,1448285563397,102964,108476
THIRTY.txt,216934,218616,1682,10,N,N,-,-1,-1
THIRTY.txt,216986,218742,1756,10,N,N,-,-1,-1
THIRTY.txt,217073,218974,1901,10,N,N,-,-1,-1
THIRTY.txt,217379,219083,1704,10,N,N,-,-1,-1
THIRTY.txt,217559,219216,1657,10,N,N,-,-1,-1
THIRTY.txt,217734,219389,1655,10,N,N,-,-1,-1
THIRTY.txt,217913,219544,1631,10,N,N,-,-1,-1
THIRTY.txt,218100,219744,1644,10,N,Y,1448394636895,292272,293963
THIRTY.txt,218234,219937,1703,10,N,Y,1448394636895,292272,293963
THIRTY.txt,218345,220000,1655,10,N,Y,1448394636895,292272,293963
THIRTY.txt,218619,220242,1623,10,N,Y,1448287306770,114686,120152
THIRTY.txt,218743,220489,1746,10,Y,Y,1448287306770,114686,120152
THIRTY.txt,218977,220564,1587,10,Y,Y,1448287306770,114686,120152
THIRTY.txt,219084,220872,1788,10,Y,Y,1448287306770,114686,120152
THIRTY.txt,219217,221049,1832,10,Y,Y,1448287306770,114686,120152
THIRTY.txt,219390,221105,1715,10,Y,Y,1448287306770,114686,120152
THIRTY.txt,219545,221323,1778,10,Y,Y,1448287306770,114686,120152
THIRTY.txt,219745,221511,1766,10,Y,Y,1448287306770,114686,120152
THIRTY.txt,219938,221727,1789,10,Y,Y,1448287306770,114686,120152
THIRTY.txt,220001,221923,1922,10,Y,Y,1448287306770,114686,120152
THIRTY.txt,220243,222001,1758,10,Y,Y,1448287306770,114686,120152
THIRTY.txt,220492,222077,1585,10,N,N,-,-1,-1
THIRTY.txt,220565,222116,1551,10,N,N,-,-1,-1
THIRTY.txt,220873,222237,1364,10,N,N,-,-1,-1
THIRTY.txt,221050,222399,1349,10,N,N,-,-1,-1
THIRTY.txt,221106,222517,1411,10,N,N,-,-1,-1
THIRTY.txt,221324,222821,1497,10,N,N,-,-1,-1
THIRTY.txt,221514,222994,1480,10,N,N,-,-1,-1
THIRTY.txt,221732,223274,1542,10,N,N,-,-1,-1
THIRTY.txt,221924,223344,1420,10,N,N,-,-1,-1
THIRTY.txt,222002,223457,1455,10,N,N,-,-1,-1
THIRTY.txt,222080,223552,1472,10,N,N,-,-1,-1
THIRTY.txt,222119,223749,1630,10,N,N,-,-1,-1
THIRTY.txt,222238,223887,1649,10,N,N,-,-1,-1
THIRTY.txt,222400,224030,1630,10,N,N,-,-1,-1
THIRTY.txt,222518,224164,1646,10,N,N,-,-1,-1
THIRTY.txt,222822,224307,1485,10,N,N,-,-1,-1
THIRTY.txt,222995,224636,1641,10,N,N,-,-1,-1
THIRTY.txt,223276,224701,1425,10,N,N,-,-1,-1
THIRTY.txt,223349,224776,1427,10,N,N,-,-1,-1
THIRTY.txt,223458,224953,1495,10,N,N,-,-1,-1
THIRTY.txt,223555,225047,1492,10,N,N,-,-1,-1
THIRTY.txt,223750,225160,1410,10,N,N,-,-1,-1
THIRTY.txt,223888,225231,1343,10,N,N,-,-1,-1
THIRTY.txt,224031,225554,1523,10,N,N,-,-1,-1
THIRTY.txt,224166,225686,1520,10,N,N,-,-1,-1
THIRTY.txt,224307,225780,1473,10,N,N,-,-1,-1
THIRTY.txt,224639,225932,1293,10,N,N,-,-1,-1
THIRTY.txt,224702,226066,1364,10,N,N,-,-1,-1
THIRTY.txt,224777,226316,1539,10,N,N,-,-1,-1
THIRTY.txt,224957,226437,1480,10,N,N,-,-1,-1
THIRTY.txt,225051,226481,1430,10,N,N,-,-1,-1
THIRTY.txt,225160,226781,1621,10,N,N,-,-1,-1
THIRTY.txt,225231,226926,1695,10,N,N,-,-1,-1
THIRTY.txt,225555,227230,1675,10,N,N,-,-1,-1
THIRTY.txt,225689,227460,1771,10,N,N,-,-1,-1
THIRTY.txt,225781,227546,1765,10,N,N,-,-1,-1
THIRTY.txt,225933,227769,1836,10,N,N,-,-1,-1
THIRTY.txt,226067,227902,1835,10,N,N,-,-1,-1
THIRTY.txt,226319,228379,2060,10,Y,Y,1448393386565,284140,284575
THIRTY.txt,226438,228492,2054,10,Y,Y,1448393386565,284140,284575
THIRTY.txt,226483,228567,2084,10,Y,Y,1448393386565,284140,284575
THIRTY.txt,226783,228582,1799,10,N,Y,1448393386565,284140,284575
THIRTY.txt,226927,228676,1749,10,N,Y,1448393386565,284140,284575
THIRTY.txt,227230,228726,1496,10,N,Y,1448393386565,284140,284575
THIRTY.txt,227463,229197,1734,10,Y,Y,1448393386565,284140,284575
THIRTY.txt,227547,229378,1831,10,Y,Y,1448393386565,284140,284575
THIRTY.txt,227771,229501,1730,10,Y,Y,1448393386565,284140,284575
THIRTY.txt,227903,229598,1695,10,Y,Y,1448393386565,284140,284575
THIRTY.txt,228380,229777,1397,10,Y,Y,1448393386565,284140,284575
THIRTY.txt,228494,229967,1473,10,Y,Y,1448393386565,284140,284575
THIRTY.txt,228568,230006,1438,10,Y,Y,1448393386565,284140,284575
THIRTY.txt,228583,230242,1659,10,Y,Y,1448393386565,284140,284575
THIRTY.txt,228676,230358,1682,10,Y,Y,1448393386565,284140,284575
THIRTY.txt,228727,230388,1661,10,Y,Y,1448393386565,284140,284575
THIRTY.txt,229198,230501,1303,10,N,Y,1448393386565,284140,284575
THIRTY.txt,229379,230585,1206,10,N,Y,1448393386565,284140,284575
THIRTY.txt,229504,230711,1207,10,N,N,-,-1,-1
THIRTY.txt,229600,230821,1221,10,N,N,-,-1,-1
THIRTY.txt,229778,230906,1128,10,N,N,-,-1,-1
THIRTY.txt,229968,231064,1096,10,N,N,-,-1,-1
THIRTY.txt,230007,231166,1159,10,N,N,-,-1,-1
THIRTY.txt,230247,231261,1014,10,N,N,-,-1,-1
THIRTY.txt,230359,231277,918,10,N,N,-,-1,-1
THIRTY.txt,230389,231388,999,10,N,N,-,-1,-1
THIRTY.txt,230504,231400,896,10,N,N,-,-1,-1
THIRTY.txt,230586,231422,836,10,N,N,-,-1,-1
THIRTY.txt,230712,231581,869,10,N,N,-,-1,-1
THIRTY.txt,230822,231588,766,10,N,N,-,-1,-1
THIRTY.txt,230907,231863,956,10,N,N,-,-1,-1
THIRTY.txt,231065,231920,855,10,N,N,-,-1,-1
THIRTY.txt,231167,231986,819,10,N,N,-,-1,-1
THIRTY.txt,231262,232206,944,10,N,N,-,-1,-1
THIRTY.txt,231278,232271,993,10,N,N,-,-1,-1
THIRTY.txt,231389,232453,1064,10,N,N,-,-1,-1
THIRTY.txt,231401,232545,1144,10,N,N,-,-1,-1
THIRTY.txt,231423,232716,1293,10,N,N,-,-1,-1
THIRTY.txt,231584,232819,1235,10,N,N,-,-1,-1
THIRTY.txt,231589,233017,1428,10,N,N,-,-1,-1
THIRTY.txt,231866,233090,1224,10,N,N,-,-1,-1
THIRTY.txt,231926,233262,1336,10,N,N,-,-1,-1
THIRTY.txt,231990,233635,1645,10,N,N,-,-1,-1
THIRTY.txt,232207,233666,1459,10,N,N,-,-1,-1
THIRTY.txt,232272,233748,1476,10,N,N,-,-1,-1
THIRTY.txt,232454,233846,1392,10,N,N,-,-1,-1
THIRTY.txt,232546,234003,1457,10,N,N,-,-1,-1
THIRTY.txt,232717,234225,1508,10,Y,N,-,-1,-1
THIRTY.txt,232820,234286,1466,10,Y,N,-,-1,-1
THIRTY.txt,233020,234358,1338,10,Y,N,-,-1,-1
THIRTY.txt,233091,234422,1331,10,Y,N,-,-1,-1
THIRTY.txt,233263,234465,1202,10,Y,N,-,-1,-1
THIRTY.txt,233637,234547,910,10,N,N,-,-1,-1
THIRTY.txt,233667,234634,967,10,N,N,-,-1,-1
THIRTY.txt,233749,234829,1080,10,N,N,-,-1,-1
THIRTY.txt,233847,234979,1132,10,N,N,-,-1,-1
THIRTY.txt,234004,235188,1184,10,N,N,-,-1,-1
THIRTY.txt,234228,235580,1352,10,N,N,-,-1,-1
THIRTY.txt,234287,235830,1543,10,N,N,-,-1,-1
THIRTY.txt,234359,236001,1642,10,N,N,-,-1,-1
THIRTY.txt,234425,236101,1676,10,N,N,-,-1,-1
THIRTY.txt,234468,236268,1800,10,N,N,-,-1,-1
THIRTY.txt,234548,236465,1917,10,N,N,-,-1,-1
THIRTY.txt,234635,236603,1968,10,N,N,-,-1,-1
THIRTY.txt,234832,236736,1904,10,N,N,-,-1,-1
THIRTY.txt,234982,236968,1986,10,N,N,-,-1,-1
THIRTY.txt,235189,237027,1838,10,N,N,-,-1,-1
THIRTY.txt,235581,237039,1458,10,N,N,-,-1,-1
THIRTY.txt,235831,237062,1231,10,N,N,-,-1,-1
THIRTY.txt,236002,237063,1061,10,N,N,-,-1,-1
THIRTY.txt,236104,237073,969,10,N,N,-,-1,-1
THIRTY.txt,236269,237420,1151,10,N,N,-,-1,-1
THIRTY.txt,236466,237556,1090,10,Y,N,-,-1,-1
THIRTY.txt,236604,237879,1275,10,Y,N,-,-1,-1
THIRTY.txt,236738,238179,1441,10,Y,N,-,-1,-1
THIRTY.txt,236973,238368,1395,10,N,N,-,-1,-1
THIRTY.txt,237027,238506,1479,10,N,N,-,-1,-1
THIRTY.txt,237039,238599,1560,10,N,N,-,-1,-1
THIRTY.txt,237062,238632,1570,10,N,N,-,-1,-1
THIRTY.txt,237063,238685,1622,10,N,N,-,-1,-1
THIRTY.txt,237074,238970,1896,10,N,N,-,-1,-1
THIRTY.txt,237423,239110,1687,10,N,N,-,-1,-1
THIRTY.txt,237556,239188,1632,10,N,N,-,-1,-1
THIRTY.txt,237880,239317,1437,10,N,N,-,-1,-1
THIRTY.txt,238180,239395,1215,10,N,N,-,-1,-1
THIRTY.txt,238369,239440,1071,10,N,N,-,-1,-1
THIRTY.txt,238509,239658,1149,10,N,N,-,-1,-1
THIRTY.txt,238602,239666,1064,10,N,N,-,-1,-1
THIRTY.txt,238633,239760,1127,10,N,N,-,-1,-1
THIRTY.txt,238686,239966,1280,10,N,N,-,-1,-1
THIRTY.txt,238971,240068,1097,10,N,N,-,-1,-1
THIRTY.txt,239111,240155,1044,10,N,N,-,-1,-1
THIRTY.txt,239189,240266,1077,10,N,N,-,-1,-1
THIRTY.txt,239320,240365,1045,10,N,N,-,-1,-1
THIRTY.txt,239396,240506,1110,10,N,N,-,-1,-1
THIRTY.txt,239441,240622,1181,10,N,N,-,-1,-1
THIRTY.txt,239659,240716,1057,10,N,N,-,-1,-1
THIRTY.txt,239667,240899,1232,10,N,N,-,-1,-1
THIRTY.txt,239761,240992,1231,10,N,N,-,-1,-1
THIRTY.txt,239967,241104,1137,10,N,N,-,-1,-1
THIRTY.txt,240069,241402,1333,10,N,N,-,-1,-1
THIRTY.txt,240156,241591,1435,10,N,N,-,-1,-1
THIRTY.txt,240267,241808,1541,10,N,N,-,-1,-1
THIRTY.txt,240366,241865,1499,10,N,N,-,-1,-1
THIRTY.txt,240507,241927,1420,10,N,N,-,-1,-1
THIRTY.txt,240625,242030,1405,10,N,N,-,-1,-1
THIRTY.txt,240717,242153,1436,10,N,N,-,-1,-1
THIRTY.txt,240900,242206,1306,10,N,N,-,-1,-1
THIRTY.txt,240993,242327,1334,10,N,N,-,-1,-1
THIRTY.txt,241105,242450,1345,10,N,N,-,-1,-1
THIRTY.txt,241403,242510,1107,10,Y,N,-,-1,-1
THIRTY.txt,241594,242558,964,10,Y,N,-,-1,-1
THIRTY.txt,241809,242631,822,10,Y,N,-,-1,-1
THIRTY.txt,241866,242652,786,10,Y,N,-,-1,-1
THIRTY.txt,241928,242831,903,10,Y,N,-,-1,-1
THIRTY.txt,242031,242923,892,10,Y,N,-,-1,-1
THIRTY.txt,242154,243143,989,10,Y,N,-,-1,-1
THIRTY.txt,242208,243238,1030,10,Y,N,-,-1,-1
THIRTY.txt,242328,243284,956,10,Y,N,-,-1,-1
THIRTY.txt,242451,243431,980,10,N,N,-,-1,-1
THIRTY.txt,242513,243557,1044,10,N,N,-,-1,-1
THIRTY.txt,242560,243620,1060,10,N,N,-,-1,-1
THIRTY.txt,242634,243908,1274,10,N,N,-,-1,-1
THIRTY.txt,242653,244302,1649,10,N,N,-,-1,-1
THIRTY.txt,242834,244365,1531,10,N,N,-,-1,-1
THIRTY.txt,242926,244557,1631,10,N,N,-,-1,-1
THIRTY.txt,243143,244812,1669,10,N,N,-,-1,-1
THIRTY.txt,243239,245150,1911,10,N,N,-,-1,-1
THIRTY.txt,243285,245222,1937,10,N,N,-,-1,-1
THIRTY.txt,243432,245362,1930,10,N,N,-,-1,-1
THIRTY.txt,243558,245543,1985,10,N,N,-,-1,-1
THIRTY.txt,243623,245638,2015,10,N,N,-,-1,-1
THIRTY.txt,243909,245722,1813,10,N,N,-,-1,-1
THIRTY.txt,244303,245863,1560,10,N,N,-,-1,-1
THIRTY.txt,244366,246082,1716,10,N,N,-,-1,-1
THIRTY.txt,244558,246274,1716,10,N,N,-,-1,-1
THIRTY.txt,244815,246369,1554,10,N,N,-,-1,-1
THIRTY.txt,245153,246474,1321,10,N,N,-,-1,-1
THIRTY.txt,245223,246497,1274,10,N,N,-,-1,-1
THIRTY.txt,245363,246529,1166,10,N,N,-,-1,-1
THIRTY.txt,245545,246588,1043,10,N,N,-,-1,-1
THIRTY.txt,245639,246773,1134,10,N,N,-,-1,-1
THIRTY.txt,245723,246931,1208,10,N,N,-,-1,-1
THIRTY.txt,245864,247047,1183,10,N,N,-,-1,-1
THIRTY.txt,246083,247121,1038,10,N,N,-,-1,-1
THIRTY.txt,246274,247290,1016,10,N,N,-,-1,-1
THIRTY.txt,246370,247417,1047,10,N,N,-,-1,-1
THIRTY.txt,246475,247523,1048,10,N,N,-,-1,-1
THIRTY.txt,246500,247744,1244,10,N,N,-,-1,-1
THIRTY.txt,246530,247832,1302,10,N,N,-,-1,-1
THIRTY.txt,246589,248043,1454,10,N,N,-,-1,-1
THIRTY.txt,246774,248177,1403,10,N,N,-,-1,-1
THIRTY.txt,246932,248224,1292,10,N,N,-,-1,-1
THIRTY.txt,247050,248265,1215,10,N,N,-,-1,-1
THIRTY.txt,247122,248394,1272,10,N,N,-,-1,-1
THIRTY.txt,247291,248470,1179,10,N,N,-,-1,-1
THIRTY.txt,247418,248554,1136,10,N,N,-,-1,-1
THIRTY.txt,247524,248687,1163,10,N,N,-,-1,-1
THIRTY.txt,247747,248779,1032,10,N,N,-,-1,-1
THIRTY.txt,247833,248792,959,10,N,N,-,-1,-1
THIRTY.txt,248044,248845,801,10,N,N,-,-1,-1
THIRTY.txt,248179,248980,801,10,N,N,-,-1,-1
THIRTY.txt,248227,249060,833,10,N,N,-,-1,-1
THIRTY.txt,248266,249258,992,10,N,N,-,-1,-1
THIRTY.txt,248395,249298,903,10,N,N,-,-1,-1
THIRTY.txt,248472,249386,914,10,N,N,-,-1,-1
THIRTY.txt,248555,249456,901,10,N,N,-,-1,-1
THIRTY.txt,248688,249616,928,10,N,N,-,-1,-1
THIRTY.txt,248780,249725,945,10,N,N,-,-1,-1
THIRTY.txt,248793,249753,960,10,N,N,-,-1,-1
THIRTY.txt,248846,249853,1007,10,N,N,-,-1,-1
THIRTY.txt,248981,249935,954,10,N,N,-,-1,-1
THIRTY.txt,249061,250011,950,10,N,N,-,-1,-1
THIRTY.txt,249259,250102,843,10,N,N,-,-1,-1
THIRTY.txt,249301,250259,958,10,N,N,-,-1,-1
THIRTY.txt,249391,250408,1017,10,N,N,-,-1,-1
THIRTY.txt,249461,250711,1250,10,N,N,-,-1,-1
THIRTY.txt,249616,250828,1212,10,N,N,-,-1,-1
THIRTY.txt,249726,250901,1175,10,N,N,-,-1,-1
THIRTY.txt,249754,250953,1199,10,N,N,-,-1,-1
THIRTY.txt,249855,251381,1526,10,N,Y,1448316079788,183824,184995
THIRTY.txt,249936,251438,1502,10,N,Y,1448316079788,183824,184995
THIRTY.txt,250012,251647,1635,10,N,Y,1448316079788,183824,184995
THIRTY.txt,250104,251653,1549,10,N,Y,1448316079788,183824,184995
THIRTY.txt,250262,251742,1480,10,N,Y,1448316079788,183824,184995
THIRTY.txt,250409,251881,1472,10,N,Y,1448316079788,183824,184995
THIRTY.txt,250712,251943,1231,10,N,Y,1448316079788,183824,184995
THIRTY.txt,250829,252116,1287,10,N,Y,1448316079788,183824,184995
THIRTY.txt,250904,252274,1370,10,N,Y,1448316079788,183824,184995
THIRTY.txt,250955,252511,1556,10,N,Y,1448316079788,183824,184995
THIRTY.txt,251382,252567,1185,10,N,Y,1448316079788,183824,184995
THIRTY.txt,251440,252651,1211,10,N,Y,1448316079788,183824,184995
THIRTY.txt,251648,252765,1117,10,N,Y,1448316079788,183824,184995
THIRTY.txt,251654,252968,1314,10,N,Y,1448316079788,183824,184995
THIRTY.txt,251744,253307,1563,10,N,Y,1448316079788,183824,184995
THIRTY.txt,251884,253502,1618,10,N,N,-,-1,-1
THIRTY.txt,251944,253559,1615,10,N,N,-,-1,-1
THIRTY.txt,252117,253745,1628,10,N,N,-,-1,-1
THIRTY.txt,252275,253923,1648,10,N,N,-,-1,-1
THIRTY.txt,252512,254214,1702,10,N,N,-,-1,-1
THIRTY.txt,252570,254523,1953,10,Y,N,-,-1,-1
THIRTY.txt,252652,254604,1952,10,Y,N,-,-1,-1
THIRTY.txt,252766,254822,2056,10,Y,N,-,-1,-1
THIRTY.txt,252969,254961,1992,10,N,N,-,-1,-1
THIRTY.txt,253308,255225,1917,10,N,N,-,-1,-1
THIRTY.txt,253503,255296,1793,10,N,N,-,-1,-1
THIRTY.txt,253560,255462,1902,10,N,N,-,-1,-1
THIRTY.txt,253748,255594,1846,10,N,N,-,-1,-1
THIRTY.txt,253924,255914,1990,10,N,N,-,-1,-1
THIRTY.txt,254215,256103,1888,10,N,N,-,-1,-1
THIRTY.txt,254524,256233,1709,10,N,N,-,-1,-1
THIRTY.txt,254605,256354,1749,10,N,N,-,-1,-1
THIRTY.txt,254825,256570,1745,10,N,N,-,-1,-1
THIRTY.txt,254962,256760,1798,10,N,N,-,-1,-1
THIRTY.txt,255226,256944,1718,10,N,N,-,-1,-1
THIRTY.txt,255297,257067,1770,10,N,Y,1448315841759,183531,183799
THIRTY.txt,255465,257242,1777,10,N,Y,1448315841759,183531,183799
THIRTY.txt,255595,257305,1710,10,N,Y,1448315841759,183531,183799
THIRTY.txt,255915,257467,1552,10,N,Y,1448315841759,183531,183799
THIRTY.txt,256104,257913,1809,10,N,Y,1448315841759,183531,183799
THIRTY.txt,256234,257942,1708,10,N,Y,1448315841759,183531,183799
THIRTY.txt,256355,258370,2015,10,N,Y,1448315841759,183531,183799
THIRTY.txt,256571,258439,1868,10,N,Y,1448315841759,183531,183799
THIRTY.txt,256763,258558,1795,10,N,Y,1448315841759,183531,183799
THIRTY.txt,256945,258765,1820,10,N,Y,1448315841759,183531,183799
THIRTY.txt,257068,258823,1755,10,N,Y,1448315841759,183531,183799
THIRTY.txt,257243,259018,1775,10,N,Y,1448315841759,183531,183799
THIRTY.txt,257307,259133,1826,10,N,Y,1448315841759,183531,183799
THIRTY.txt,257468,259296,1828,10,N,N,-,-1,-1
THIRTY.txt,257916,259548,1632,10,N,N,-,-1,-1
THIRTY.txt,257943,259621,1678,10,N,N,-,-1,-1
THIRTY.txt,258371,259724,1353,10,N,N,-,-1,-1
THIRTY.txt,258440,259960,1520,10,N,N,-,-1,-1
THIRTY.txt,258559,260155,1596,10,N,N,-,-1,-1
THIRTY.txt,258768,260380,1612,10,N,N,-,-1,-1
THIRTY.txt,258824,260729,1905,10,N,N,-,-1,-1
THIRTY.txt,259019,260984,1965,10,N,Y,1448282044001,101941,102395
THIRTY.txt,259136,261031,1895,10,N,Y,1448282044001,101941,102395
THIRTY.txt,259297,261204,1907,10,N,Y,1448282044001,101941,102395
THIRTY.txt,259551,261273,1722,10,N,Y,1448282044001,101941,102395
THIRTY.txt,259622,261469,1847,10,N,Y,1448282044001,101941,102395
THIRTY.txt,259725,261597,1872,10,N,Y,1448282044001,101941,102395
THIRTY.txt,259961,261675,1714,10,N,Y,1448282044001,101941,102395
THIRTY.txt,260157,261733,1576,10,N,Y,1448282044001,101941,102395
THIRTY.txt,260381,261842,1461,10,N,Y,1448282044001,101941,102395
THIRTY.txt,260734,261927,1193,10,N,Y,1448282044001,101941,102395
THIRTY.txt,260985,262203,1218,10,N,Y,1448282044001,101941,102395
THIRTY.txt,261032,262340,1308,10,N,Y,1448282044001,101941,102395
THIRTY.txt,261206,262498,1292,10,N,Y,1448282044001,101941,102395
THIRTY.txt,261274,262537,1263,10,N,Y,1448282044001,101941,102395
THIRTY.txt,261470,262651,1181,10,N,Y,1448282044001,101941,102395
THIRTY.txt,261598,262785,1187,10,Y,Y,1448282044001,101941,102395
THIRTY.txt,261676,262814,1138,10,Y,Y,1448282044001,101941,102395
THIRTY.txt,261734,262904,1170,10,Y,Y,1448282044001,101941,102395
THIRTY.txt,261843,263036,1193,10,Y,Y,1448282044001,101941,102395
THIRTY.txt,261928,263145,1217,10,Y,Y,1448282044001,101941,102395
THIRTY.txt,262204,263327,1123,10,N,Y,1448282044001,101941,102395
THIRTY.txt,262345,263367,1022,10,N,Y,1448282044001,101941,102395
THIRTY.txt,262499,263382,883,10,N,N,-,-1,-1
THIRTY.txt,262540,263418,878,10,N,N,-,-1,-1
THIRTY.txt,262652,263477,825,10,N,N,-,-1,-1
THIRTY.txt,262786,263525,739,10,N,N,-,-1,-1
THIRTY.txt,262815,263673,858,10,N,N,-,-1,-1
THIRTY.txt,262905,263701,796,10,N,N,-,-1,-1
THIRTY.txt,263037,263807,770,10,N,N,-,-1,-1
THIRTY.txt,263147,263988,841,10,N,N,-,-1,-1
THIRTY.txt,263328,264121,793,10,N,N,-,-1,-1
THIRTY.txt,263370,264234,864,10,N,N,-,-1,-1
THIRTY.txt,263383,264278,895,10,N,N,-,-1,-1
THIRTY.txt,263419,264452,1033,10,N,N,-,-1,-1
THIRTY.txt,263479,264559,1080,10,N,N,-,-1,-1
THIRTY.txt,263527,264632,1105,10,N,N,-,-1,-1
THIRTY.txt,263674,264734,1060,10,N,N,-,-1,-1
THIRTY.txt,263702,264856,1154,10,N,N,-,-1,-1
THIRTY.txt,263810,264919,1109,10,N,N,-,-1,-1
THIRTY.txt,263990,265034,1044,10,N,N,-,-1,-1
THIRTY.txt,264122,265083,961,10,N,N,-,-1,-1
THIRTY.txt,264237,265207,970,10,N,N,-,-1,-1
THIRTY.txt,264279,265503,1224,10,N,N,-,-1,-1
THIRTY.txt,264453,265554,1101,10,N,N,-,-1,-1
THIRTY.txt,264560,265647,1087,10,N,N,-,-1,-1
THIRTY.txt,264635,265761,1126,10,N,N,-,-1,-1
THIRTY.txt,264734,265928,1194,10,N,N,-,-1,-1
THIRTY.txt,264857,266214,1357,10,N,N,-,-1,-1
THIRTY.txt,264920,266479,1559,10,Y,N,-,-1,-1
THIRTY.txt,265035,266675,1640,10,Y,N,-,-1,-1
THIRTY.txt,265084,266764,1680,10,N,N,-,-1,-1
THIRTY.txt,265210,267007,1797,10,N,N,-,-1,-1
THIRTY.txt,265504,267085,1581,10,N,N,-,-1,-1
THIRTY.txt,265555,267138,1583,10,N,N,-,-1,-1
THIRTY.txt,265649,267194,1545,10,N,N,-,-1,-1
THIRTY.txt,265762,267228,1466,10,N,N,-,-1,-1
THIRTY.txt,265933,267488,1555,10,N,N,-,-1,-1
THIRTY.txt,266217,267554,1337,10,N,N,-,-1,-1
THIRTY.txt,266480,267618,1138,10,N,N,-,-1,-1
THIRTY.txt,266676,267673,997,10,N,N,-,-1,-1
THIRTY.txt,266766,267845,1079,10,N,N,-,-1,-1
THIRTY.txt,267008,268025,1017,10,N,N,-,-1,-1
THIRTY.txt,267088,268213,1125,10,N,N,-,-1,-1
THIRTY.txt,267139,268272,1133,10,N,N,-,-1,-1
THIRTY.txt,267200,268329,1129,10,N,N,-,-1,-1
THIRTY.txt,267229,268473,1244,10,N,N,-,-1,-1
THIRTY.txt,267489,268536,1047,10,N,N,-,-1,-1
THIRTY.txt,267555,268672,1117,10,N,N,-,-1,-1
THIRTY.txt,267619,268970,1351,10,N,N,-,-1,-1
THIRTY.txt,267674,269088,1414,10,N,N,-,-1,-1
THIRTY.txt,267846,269268,1422,10,N,N,-,-1,-1
THIRTY.txt,268025,269433,1408,10,N,N,-,-1,-1
THIRTY.txt,268218,269539,1321,10,N,N,-,-1,-1
THIRTY.txt,268273,269745,1472,10,N,N,-,-1,-1
THIRTY.txt,268330,269840,1510,10,N,N,-,-1,-1
THIRTY.txt,268474,269876,1402,10,N,N,-,-1,-1
THIRTY.txt,268537,270196,1659,10,N,N,-,-1,-1
THIRTY.txt,268673,270331,1658,10,N,N,-,-1,-1
THIRTY.txt,268971,270465,1494,10,N,N,-,-1,-1
THIRTY.txt,269091,270547,1456,10,N,N,-,-1,-1
THIRTY.txt,269269,270964,1695,10,N,N,-,-1,-1
THIRTY.txt,269435,271081,1646,10,N,N,-,-1,-1
THIRTY.txt,269540,271318,1778,10,N,N,-,-1,-1
THIRTY.txt,269746,271364,1618,10,N,N,-,-1,-1
THIRTY.txt,269841,271556,1715,10,N,N,-,-1,-1
THIRTY.txt,269878,271684,1806,10,N,N,-,-1,-1
THIRTY.txt,270197,271940,1743,10,N,N,-,-1,-1
THIRTY.txt,270336,272338,2002,10,N,N,-,-1,-1
THIRTY.txt,270467,272458,1991,10,N,N,-,-1,-1
THIRTY.txt,270548,272786,2238,10,Y,N,-,-1,-1
THIRTY.txt,270965,273053,2088,10,Y,N,-,-1,-1
THIRTY.txt,271082,273116,2034,10,Y,N,-,-1,-1
THIRTY.txt,271320,273200,1880,10,Y,N,-,-1,-1
THIRTY.txt,271366,273517,2151,10,Y,N,-,-1,-1
THIRTY.txt,271559,273658,2099,10,N,N,-,-1,-1
THIRTY.txt,271685,273984,2299,10,N,N,-,-1,-1
THIRTY.txt,271941,274030,2089,10,Y,N,-,-1,-1
THIRTY.txt,272339,274322,1983,10,Y,N,-,-1,-1
THIRTY.txt,272459,274741,2282,10,Y,N,-,-1,-1
THIRTY.txt,272787,274911,2124,10,N,Y,1448315012079,181380,182053
THIRTY.txt,273054,274932,1878,10,N,Y,1448315012079,181380,182053
THIRTY.txt,273119,275001,1882,10,N,Y,1448315012079,181380,182053
THIRTY.txt,273200,275130,1930,10,N,Y,1448315012079,181380,182053
THIRTY.txt,273522,275198,1676,10,N,Y,1448315012079,181380,182053
THIRTY.txt,273660,275466,1806,10,Y,Y,1448315012079,181380,182053
THIRTY.txt,273985,275590,1605,10,N,Y,1448315012079,181380,182053
THIRTY.txt,274031,275699,1668,10,N,Y,1448315012079,181380,182053
THIRTY.txt,274323,275892,1569,10,N,Y,1448315012079,181380,182053
THIRTY.txt,274744,275903,1159,10,N,Y,1448315012079,181380,182053
THIRTY.txt,274912,275981,1069,10,N,Y,1448315012079,181380,182053
THIRTY.txt,274934,276337,1403,10,N,Y,1448315012079,181380,182053
THIRTY.txt,275002,276500,1498,10,N,Y,1448315012079,181380,182053
THIRTY.txt,275131,276728,1597,10,N,Y,1448315012079,181380,182053
THIRTY.txt,275199,276854,1655,10,N,Y,1448315012079,181380,182053
THIRTY.txt,275467,277061,1594,10,N,Y,1448315012079,181380,182053
THIRTY.txt,275591,277573,1982,10,N,Y,1448315012079,181380,182053
THIRTY.txt,275701,277623,1922,10,N,Y,1448315012079,181380,182053
THIRTY.txt,275893,277743,1850,10,N,Y,1448315012079,181380,182053
THIRTY.txt,275903,277867,1964,10,N,Y,1448315012079,181380,182053
THIRTY.txt,275982,277977,1995,10,N,Y,1448315012079,181380,182053
THIRTY.txt,276338,278250,1912,10,N,Y,1448315012079,181380,182053
THIRTY.txt,276501,278275,1774,10,N,Y,1448039370049,20775,21297
THIRTY.txt,276729,278408,1679,10,N,Y,1448039370049,20775,21297
THIRTY.txt,276855,278624,1769,10,N,Y,1448039370049,20775,21297
THIRTY.txt,277062,278860,1798,10,N,Y,1448039370049,20775,21297
THIRTY.txt,277574,278971,1397,10,N,Y,1448039370049,20775,21297
THIRTY.txt,277624,279126,1502,10,Y,Y,1448039370049,20775,21297
THIRTY.txt,277744,279331,1587,10,Y,Y,1448039370049,20775,21297
THIRTY.txt,277870,279377,1507,10,Y,Y,1448039370049,20775,21297
THIRTY.txt,277978,279527,1549,10,Y,Y,1448039370049,20775,21297
THIRTY.txt,278251,279623,1372,10,N,Y,1448039370049,20775,21297
THIRTY.txt,278276,279806,1530,10,N,Y,1448039370049,20775,21297
THIRTY.txt,278409,279940,1531,10,N,Y,1448039370049,20775,21297
THIRTY.txt,278629,280126,1497,10,N,Y,1448039370049,20775,21297
THIRTY.txt,278861,280231,1370,10,N,Y,1448039370049,20775,21297
THIRTY.txt,278972,280277,1305,10,N,Y,1448039370049,20775,21297
THIRTY.txt,279127,280377,1250,10,N,Y,1448039370049,20775,21297
THIRTY.txt,279334,280484,1150,10,N,N,-,-1,-1
THIRTY.txt,279378,280536,1158,10,N,N,-,-1,-1
THIRTY.txt,279528,280598,1070,10,N,N,-,-1,-1
THIRTY.txt,279624,280700,1076,10,N,N,-,-1,-1
THIRTY.txt,279807,280829,1022,10,N,N,-,-1,-1
THIRTY.txt,279942,281174,1232,10,N,N,-,-1,-1
THIRTY.txt,280127,281304,1177,10,N,Y,1448281888079,98877,102290
THIRTY.txt,280236,281391,1155,10,N,Y,1448281888079,98877,102290
THIRTY.txt,280280,281525,1245,10,N,Y,1448281888079,98877,102290
THIRTY.txt,280378,281623,1245,10,N,Y,1448281888079,98877,102290
THIRTY.txt,280485,281744,1259,10,N,Y,1448281888079,98877,102290
THIRTY.txt,280537,281872,1335,10,N,Y,1448281888079,98877,102290
THIRTY.txt,280599,282027,1428,10,N,Y,1448281888079,98877,102290
THIRTY.txt,280701,282294,1593,10,N,Y,1448281888079,98877,102290
THIRTY.txt,280830,282551,1721,10,N,Y,1448281888079,98877,102290
THIRTY.txt,281177,282704,1527,10,Y,Y,1448281888079,98877,102290
THIRTY.txt,281305,282837,1532,10,N,Y,1448281888079,98877,102290
THIRTY.txt,281392,283009,1617,10,N,Y,1448281888079,98877,102290
THIRTY.txt,281527,283129,1602,10,N,Y,1448281888079,98877,102290
THIRTY.txt,281624,283333,1709,10,N,Y,1448281888079,98877,102290
THIRTY.txt,281745,283772,2027,10,N,Y,1448281888079,98877,102290
THIRTY.txt,281873,283999,2126,10,N,Y,1448281888079,98877,102290
THIRTY.txt,282028,284261,2233,10,Y,Y,1448281888079,98877,102290
THIRTY.txt,282295,284545,2250,10,Y,Y,1448281888079,98877,102290
THIRTY.txt,282553,284737,2184,10,N,Y,1448281888079,98877,102290
THIRTY.txt,282705,284834,2129,10,N,Y,1448281888079,98877,102290
THIRTY.txt,282840,285003,2163,10,N,N,-,-1,-1
THIRTY.txt,283010,285081,2071,10,N,N,-,-1,-1
THIRTY.txt,283131,285162,2031,10,N,N,-,-1,-1
THIRTY.txt,283334,285333,1999,10,N,N,-,-1,-1
THIRTY.txt,283774,285393,1619,10,N,N,-,-1,-1
THIRTY.txt,284002,285526,1524,10,N,N,-,-1,-1
THIRTY.txt,284262,285711,1449,10,N,N,-,-1,-1
THIRTY.txt,284546,285963,1417,10,N,N,-,-1,-1
THIRTY.txt,284738,286015,1277,10,N,N,-,-1,-1
THIRTY.txt,284835,286138,1303,10,N,N,-,-1,-1
THIRTY.txt,285008,286202,1194,10,N,N,-,-1,-1
THIRTY.txt,285083,286227,1144,10,N,N,-,-1,-1
THIRTY.txt,285163,286307,1144,10,N,N,-,-1,-1
THIRTY.txt,285336,286356,1020,10,N,N,-,-1,-1
THIRTY.txt,285394,286566,1172,10,N,N,-,-1,-1
THIRTY.txt,285528,286768,1240,10,N,N,-,-1,-1
THIRTY.txt,285712,287022,1310,10,N,Y,1448311811907,157566,161100
THIRTY.txt,285966,287078,1112,10,N,Y,1448311811907,157566,161100
THIRTY.txt,286017,287226,1209,10,N,Y,1448311811907,157566,161100
THIRTY.txt,286139,287313,1174,10,N,Y,1448311811907,157566,161100
THIRTY.txt,286203,287431,1228,10,N,Y,1448311811907,157566,161100
THIRTY.txt,286228,287458,1230,10,N,Y,1448311811907,157566,161100
THIRTY.txt,286307,287601,1294,10,N,Y,1448311811907,157566,161100
THIRTY.txt,286358,287645,1287,10,N,Y,1448311811907,157566,161100
THIRTY.txt,286571,287762,1191,10,N,Y,1448311811907,157566,161100
THIRTY.txt,286769,287825,1056,10,N,Y,1448311811907,157566,161100
THIRTY.txt,287023,287922,899,10,N,Y,1448311811907,157566,161100
THIRTY.txt,287079,288190,1111,10,N,Y,1448311811907,157566,161100
THIRTY.txt,287227,288335,1108,10,N,Y,1448311811907,157566,161100
THIRTY.txt,287316,288637,1321,10,N,Y,1448311811907,157566,161100
THIRTY.txt,287432,288712,1280,10,N,Y,1448311811907,157566,161100
THIRTY.txt,287459,288789,1330,10,N,Y,1448311811907,157566,161100
THIRTY.txt,287602,288883,1281,10,N,Y,1448311811907,157566,161100
THIRTY.txt,287646,289027,1381,10,N,Y,1448311811907,157566,161100
THIRTY.txt,287765,289198,1433,10,N,N,-,-1,-1
THIRTY.txt,287826,289337,1511,10,N,N,-,-1,-1
THIRTY.txt,287925,289477,1552,10,N,N,-,-1,-1
THIRTY.txt,288193,289628,1435,10,N,N,-,-1,-1
THIRTY.txt,288336,289766,1430,10,N,N,-,-1,-1
THIRTY.txt,288638,289886,1248,10,N,N,-,-1,-1
THIRTY.txt,288713,289921,1208,10,N,N,-,-1,-1
THIRTY.txt,288790,290181,1391,10,N,N,-,-1,-1
THIRTY.txt,288884,290203,1319,10,N,N,-,-1,-1
THIRTY.txt,289030,290306,1276,10,N,N,-,-1,-1
THIRTY.txt,289199,290385,1186,10,N,N,-,-1,-1
THIRTY.txt,289338,290536,1198,10,N,N,-,-1,-1
THIRTY.txt,289478,290912,1434,10,N,N,-,-1,-1
THIRTY.txt,289629,291329,1700,10,N,N,-,-1,-1
THIRTY.txt,289767,291425,1658,10,N,N,-,-1,-1
THIRTY.txt,289887,291627,1740,10,N,N,-,-1,-1
THIRTY.txt,289922,291732,1810,10,N,N,-,-1,-1
THIRTY.txt,290182,291808,1626,10,N,N,-,-1,-1
THIRTY.txt,290204,291884,1680,10,N,N,-,-1,-1
THIRTY.txt,290308,292141,1833,10,N,N,-,-1,-1
THIRTY.txt,290385,292298,1913,10,N,N,-,-1,-1
THIRTY.txt,290539,292439,1900,10,N,N,-,-1,-1
THIRTY.txt,290913,292547,1634,10,N,N,-,-1,-1
THIRTY.txt,291330,292676,1346,10,N,N,-,-1,-1
THIRTY.txt,291426,292718,1292,10,N,N,-,-1,-1
THIRTY.txt,291628,292845,1217,10,N,N,-,-1,-1
THIRTY.txt,291735,292947,1212,10,N,N,-,-1,-1
THIRTY.txt,291809,292981,1172,10,N,N,-,-1,-1
THIRTY.txt,291885,293054,1169,10,N,N,-,-1,-1
THIRTY.txt,292142,293088,946,10,N,N,-,-1,-1
THIRTY.txt,292299,293217,918,10,N,N,-,-1,-1
THIRTY.txt,292440,293259,819,10,N,N,-,-1,-1
THIRTY.txt,292548,293426,878,10,N,N,-,-1,-1
THIRTY.txt,292677,293528,851,10,N,N,-,-1,-1
THIRTY.txt,292719,293654,935,10,N,N,-,-1,-1
THIRTY.txt,292847,293691,844,10,N,N,-,-1,-1
THIRTY.txt,292948,293791,843,10,N,N,-,-1,-1
THIRTY.txt,292984,293968,984,10,N,N,-,-1,-1
THIRTY.txt,293054,294111,1057,10,N,N,-,-1,-1
THIRTY.txt,293090,294335,1245,10,N,N,-,-1,-1
THIRTY.txt,293218,294463,1245,10,N,N,-,-1,-1
THIRTY.txt,293261,294627,1366,10,N,N,-,-1,-1
THIRTY.txt,293428,294647,1219,10,N,N,-,-1,-1
THIRTY.txt,293529,294774,1245,10,N,N,-,-1,-1
THIRTY.txt,293657,294814,1157,10,N,N,-,-1,-1
THIRTY.txt,293694,295067,1373,10,N,N,-,-1,-1
THIRTY.txt,293794,295239,1445,10,N,N,-,-1,-1
THIRTY.txt,293969,295422,1453,10,N,N,-,-1,-1
THIRTY.txt,294112,295651,1539,10,N,N,-,-1,-1
THIRTY.txt,294336,295763,1427,10,N,N,-,-1,-1
THIRTY.txt,294465,295929,1464,10,N,N,-,-1,-1
THIRTY.txt,294630,296008,1378,10,N,N,-,-1,-1
THIRTY.txt,294650,296042,1392,10,N,N,-,-1,-1
THIRTY.txt,294776,296067,1291,10,N,N,-,-1,-1
THIRTY.txt,294815,296127,1312,10,N,N,-,-1,-1
THIRTY.txt,295068,296220,1152,10,N,N,-,-1,-1
THIRTY.txt,295240,296392,1152,10,N,N,-,-1,-1
THIRTY.txt,295423,296579,1156,10,N,N,-,-1,-1
THIRTY.txt,295652,296675,1023,10,N,N,-,-1,-1
THIRTY.txt,295764,297008,1244,10,N,N,-,-1,-1
THIRTY.txt,295930,297314,1384,10,N,N,-,-1,-1
THIRTY.txt,296009,297629,1620,10,N,N,-,-1,-1
THIRTY.txt,296043,297795,1752,10,N,N,-,-1,-1
THIRTY.txt,296068,297961,1893,10,N,N,-,-1,-1
THIRTY.txt,296128,298261,2133,10,N,N,-,-1,-1
THIRTY.txt,296223,298465,2242,10,N,N,-,-1,-1
THIRTY.txt,296393,298552,2159,10,N,N,-,-1,-1
THIRTY.txt,296580,298994,2414,10,N,N,-,-1,-1
THIRTY.txt,296677,299054,2377,10,N,N,-,-1,-1
THIRTY.txt,297009,299262,2253,10,N,N,-,-1,-1
THIRTY.txt,297319,299286,1967,10,N,N,-,-1,-1
THIRTY.txt,297632,299531,1899,10,Y,N,-,-1,-1
THIRTY.txt,297796,299666,1870,10,Y,N,-,-1,-1
THIRTY.txt,297962,299730,1768,10,Y,N,-,-1,-1
THIRTY.txt,298262,299906,1644,10,Y,N,-,-1,-1
THIRTY.txt,298466,300143,1677,10,Y,N,-,-1,-1
THIRTY.txt,298552,300371,1819,10,Y,N,-,-1,-1
THIRTY.txt,298997,300537,1540,10,Y,N,-,-1,-1
THIRTY.txt,299055,300594,1539,10,Y,N,-,-1,-1
THIRTY.txt,299263,300766,1503,10,Y,N,-,-1,-1
THIRTY.txt,299288,300848,1560,10,Y,N,-,-1,-1
THIRTY.txt,299534,300901,1367,10,Y,N,-,-1,-1
THIRTY.txt,299667,301325,1658,10,Y,N,-,-1,-1
THIRTY.txt,299731,301359,1628,10,N,Y,1448311366799,143137,146264
THIRTY.txt,299907,301479,1572,10,N,Y,1448311366799,143137,146264
THIRTY.txt,300144,301643,1499,10,N,Y,1448311366799,143137,146264
THIRTY.txt,300372,301793,1421,10,N,Y,1448311366799,143137,146264
THIRTY.txt,300538,301941,1403,10,N,Y,1448311366799,143137,146264
THIRTY.txt,300595,301960,1365,10,N,Y,1448311366799,143137,146264
THIRTY.txt,300767,302147,1380,10,N,Y,1448311366799,143137,146264
THIRTY.txt,300849,302435,1586,10,N,Y,1448311366799,143137,146264
THIRTY.txt,300902,302548,1646,10,N,Y,1448278147591,54631,55869
THIRTY.txt,301326,302688,1362,10,N,Y,1448278147591,54631,55869
THIRTY.txt,301360,302953,1593,10,N,Y,1448278147591,54631,55869
THIRTY.txt,301481,303167,1686,10,N,Y,1448278147591,54631,55869
THIRTY.txt,301644,303245,1601,10,N,Y,1448278147591,54631,55869
THIRTY.txt,301796,303469,1673,10,N,Y,1448278147591,54631,55869
THIRTY.txt,301942,303517,1575,10,N,Y,1448278147591,54631,55869
THIRTY.txt,301961,303910,1949,10,Y,Y,1448278147591,54631,55869
THIRTY.txt,302148,303944,1796,10,Y,Y,1448278147591,54631,55869
THIRTY.txt,302438,304119,1681,10,N,Y,1448278147591,54631,55869
THIRTY.txt,302549,304311,1762,10,Y,Y,1448278147591,54631,55869
THIRTY.txt,302689,304529,1840,10,Y,Y,1448278147591,54631,55869
THIRTY.txt,302954,304609,1655,10,N,Y,1448278147591,54631,55869
THIRTY.txt,303169,304973,1804,10,N,Y,1448278147591,54631,55869
THIRTY.txt,303246,305061,1815,10,N,Y,1448278147591,54631,55869
THIRTY.txt,303472,305171,1699,10,Y,Y,1448278147591,54631,55869
THIRTY.txt,303519,305224,1705,10,Y,Y,1448278147591,54631,55869
THIRTY.txt,303910,305453,1543,10,Y,Y,1448278147591,54631,55869
THIRTY.txt,303945,305630,1685,10,Y,Y,1448278147591,54631,55869
THIRTY.txt,304120,305875,1755,10,Y,Y,1448278147591,54631,55869
THIRTY.txt,304312,305929,1617,10,N,Y,1448278147591,54631,55869
THIRTY.txt,304532,306246,1714,10,Y,Y,1437472966198,394609,395892
THIRTY.txt,304610,306277,1667,10,Y,Y,1437472966198,394609,395892
THIRTY.txt,304975,306294,1319,10,Y,Y,1437472966198,394609,395892
THIRTY.txt,305062,306320,1258,10,Y,Y,1437472966198,394609,395892
THIRTY.txt,305173,306774,1601,10,Y,Y,1437472966198,394609,395892
THIRTY.txt,305225,306922,1697,10,Y,Y,1437472966198,394609,395892
THIRTY.txt,305454,307034,1580,10,Y,Y,1437472966198,394609,395892
THIRTY.txt,305631,307069,1438,10,Y,Y,1437472966198,394609,395892
THIRTY.txt,305876,307109,1233,10,Y,Y,1437472966198,394609,395892
THIRTY.txt,305929,307417,1488,10,Y,Y,1437472966198,394609,395892
THIRTY.txt,306247,307566,1319,10,N,Y,1437472966198,394609,395892
THIRTY.txt,306278,307664,1386,10,N,Y,1437472966198,394609,395892
THIRTY.txt,306295,307874,1579,10,N,Y,1437472966198,394609,395892
THIRTY.txt,306321,307910,1589,10,N,Y,1437472966198,394609,395892
THIRTY.txt,306775,307990,1215,10,N,Y,1437472966198,394609,395892
THIRTY.txt,306923,308026,1103,10,N,Y,1437472966198,394609,395892
THIRTY.txt,307035,308180,1145,10,N,N,-,-1,-1
THIRTY.txt,307070,308190,1120,10,N,N,-,-1,-1
THIRTY.txt,307111,308448,1337,10,N,N,-,-1,-1
THIRTY.txt,307420,308529,1109,10,N,N,-,-1,-1
THIRTY.txt,307567,308684,1117,10,N,N,-,-1,-1
THIRTY.txt,307665,308906,1241,10,N,N,-,-1,-1
THIRTY.txt,307875,309046,1171,10,N,N,-,-1,-1
THIRTY.txt,307911,309146,1235,10,N,N,-,-1,-1
THIRTY.txt,307992,309325,1333,10,N,N,-,-1,-1
THIRTY.txt,308027,309534,1507,10,N,N,-,-1,-1
THIRTY.txt,308181,309846,1665,10,N,N,-,-1,-1
THIRTY.txt,308195,310051,1856,10,N,N,-,-1,-1
THIRTY.txt,308449,310114,1665,10,N,N,-,-1,-1
THIRTY.txt,308532,310273,1741,10,N,N,-,-1,-1
THIRTY.txt,308685,310443,1758,10,N,N,-,-1,-1
THIRTY.txt,308907,310662,1755,10,N,N,-,-1,-1
THIRTY.txt,309047,310808,1761,10,N,N,-,-1,-1
THIRTY.txt,309147,311090,1943,10,N,N,-,-1,-1
THIRTY.txt,309326,311156,1830,10,N,N,-,-1,-1
THIRTY.txt,309536,311437,1901,10,N,N,-,-1,-1
THIRTY.txt,309849,311499,1650,10,N,N,-,-1,-1
THIRTY.txt,310052,311641,1589,10,N,N,-,-1,-1
THIRTY.txt,310115,311949,1834,10,N,N,-,-1,-1
THIRTY.txt,310274,312033,1759,10,N,N,-,-1,-1
THIRTY.txt,310444,312185,1741,10,N,N,-,-1,-1
THIRTY.txt,310663,312236,1573,10,N,N,-,-1,-1
THIRTY.txt,310809,312294,1485,10,N,N,-,-1,-1
THIRTY.txt,311093,312453,1360,10,N,N,-,-1,-1
THIRTY.txt,311157,312611,1454,10,N,N,-,-1,-1
THIRTY.txt,311438,312707,1269,10,N,N,-,-1,-1
THIRTY.txt,311500,312776,1276,10,N,N,-,-1,-1
THIRTY.txt,311642,312841,1199,10,N,N,-,-1,-1
THIRTY.txt,311952,313048,1096,10,N,N,-,-1,-1
THIRTY.txt,312034,313220,1186,10,N,N,-,-1,-1
THIRTY.txt,312187,313324,1137,10,N,N,-,-1,-1
THIRTY.txt,312238,313393,1155,10,N,N,-,-1,-1
THIRTY.txt,312295,313489,1194,10,N,N,-,-1,-1
THIRTY.txt,312454,313668,1214,10,N,N,-,-1,-1
THIRTY.txt,312612,313825,1213,10,N,N,-,-1,-1
THIRTY.txt,312708,313958,1250,10,N,N,-,-1,-1
THIRTY.txt,312777,314309,1532,10,N,N,-,-1,-1
THIRTY.txt,312842,314432,1590,10,N,Y,1448367229258,278623,278697
THIRTY.txt,313051,314650,1599,10,N,Y,1448367229258,278623,278697
THIRTY.txt,313221,314854,1633,10,N,Y,1448277582432,52552,54595
THIRTY.txt,313325,315056,1731,10,N,Y,1448277582432,52552,54595
THIRTY.txt,313394,315157,1763,10,N,Y,1448277582432,52552,54595
THIRTY.txt,313490,315240,1750,10,N,Y,1448277582432,52552,54595
THIRTY.txt,313669,315307,1638,10,N,Y,1448277582432,52552,54595
THIRTY.txt,313826,315523,1697,10,N,Y,1448277582432,52552,54595
THIRTY.txt,313959,315640,1681,10,N,Y,1448277582432,52552,54595
THIRTY.txt,314312,315763,1451,10,N,Y,1448277582432,52552,54595
THIRTY.txt,314433,316016,1583,10,Y,Y,1448277582432,52552,54595
THIRTY.txt,314651,316287,1636,10,Y,Y,1448277582432,52552,54595
THIRTY.txt,314856,316467,1611,10,N,Y,1448277582432,52552,54595
THIRTY.txt,315057,316576,1519,10,N,Y,1437490253936,460795,462238
THIRTY.txt,315158,316769,1611,10,Y,Y,1437490253936,460795,462238
THIRTY.txt,315242,316921,1679,10,N,Y,1437490253936,460795,462238
THIRTY.txt,315308,317130,1822,10,N,Y,1437490253936,460795,462238
THIRTY.txt,315526,317235,1709,10,N,Y,1437490253936,460795,462238
THIRTY.txt,315641,317593,1952,10,N,Y,1437490253936,460795,462238
THIRTY.txt,315764,317778,2014,10,N,Y,1437490253936,460795,462238
THIRTY.txt,316017,318142,2125,10,N,Y,1437490253936,460795,462238
THIRTY.txt,316288,318366,2078,10,N,Y,1437490253936,460795,462238
THIRTY.txt,316470,318653,2183,10,N,Y,1437490253936,460795,462238
THIRTY.txt,316577,318844,2267,10,N,Y,1437490253936,460795,462238
THIRTY.txt,316770,318945,2175,10,N,Y,1437490253936,460795,462238
THIRTY.txt,316922,319056,2134,10,N,Y,1437490253936,460795,462238
THIRTY.txt,317131,319231,2100,10,N,Y,1437490253936,460795,462238
THIRTY.txt,317236,319386,2150,10,Y,Y,1437490253936,460795,462238
THIRTY.txt,317594,319632,2038,10,Y,Y,1437490253936,460795,462238
THIRTY.txt,317781,319877,2096,10,Y,Y,1448357159811,231190,232925
THIRTY.txt,318143,320059,1916,10,Y,Y,1448357159811,231190,232925
THIRTY.txt,318367,320101,1734,10,Y,Y,1448357159811,231190,232925
THIRTY.txt,318654,320219,1565,10,N,Y,1448357159811,231190,232925
THIRTY.txt,318845,320281,1436,10,N,Y,1448357159811,231190,232925
THIRTY.txt,318946,320484,1538,10,N,Y,1448357159811,231190,232925
THIRTY.txt,319057,320637,1580,10,N,Y,1448357159811,231190,232925
THIRTY.txt,319232,320699,1467,10,N,Y,1448357159811,231190,232925
THIRTY.txt,319387,320818,1431,10,N,Y,1448357159811,231190,232925
THIRTY.txt,319635,321139,1504,10,N,N,-,-1,-1
THIRTY.txt,319878,321426,1548,10,N,N,-,-1,-1
THIRTY.txt,320060,321586,1526,10,N,N,-,-1,-1
THIRTY.txt,320102,321694,1592,10,N,N,-,-1,-1
THIRTY.txt,320220,321911,1691,10,N,N,-,-1,-1
THIRTY.txt,320284,321966,1682,10,N,N,-,-1,-1
THIRTY.txt,320485,322030,1545,10,N,N,-,-1,-1
THIRTY.txt,320643,322164,1521,10,N,N,-,-1,-1
THIRTY.txt,320702,322266,1564,10,N,N,-,-1,-1
THIRTY.txt,320819,322507,1688,10,N,N,-,-1,-1
THIRTY.txt,321141,322805,1664,10,N,N,-,-1,-1
THIRTY.txt,321427,323010,1583,10,N,N,-,-1,-1
THIRTY.txt,321586,323296,1710,10,N,N,-,-1,-1
THIRTY.txt,321695,323439,1744,10,N,N,-,-1,-1
THIRTY.txt,321912,323582,1670,10,N,N,-,-1,-1
THIRTY.txt,321967,323624,1657,10,N,N,-,-1,-1
THIRTY.txt,322031,323735,1704,10,Y,N,-,-1,-1
THIRTY.txt,322165,323920,1755,10,Y,N,-,-1,-1
THIRTY.txt,322267,323962,1695,10,N,N,-,-1,-1
THIRTY.txt,322508,324192,1684,10,N,N,-,-1,-1
THIRTY.txt,322806,324402,1596,10,N,N,-,-1,-1
THIRTY.txt,323011,324517,1506,10,N,N,-,-1,-1
THIRTY.txt,323297,324604,1307,10,N,N,-,-1,-1
THIRTY.txt,323442,324693,1251,10,N,N,-,-1,-1
THIRTY.txt,323583,324847,1264,10,N,N,-,-1,-1
THIRTY.txt,323627,324905,1278,10,N,N,-,-1,-1
THIRTY.txt,323736,325136,1400,10,N,N,-,-1,-1
THIRTY.txt,323921,325248,1327,10,N,N,-,-1,-1
THIRTY.txt,323963,325336,1373,10,N,N,-,-1,-1
THIRTY.txt,324193,325360,1167,10,N,N,-,-1,-1
THIRTY.txt,324402,325383,981,10,N,N,-,-1,-1
THIRTY.txt,324518,325401,883,10,N,N,-,-1,-1
THIRTY.txt,324605,325672,1067,10,N,N,-,-1,-1
THIRTY.txt,324694,325772,1078,10,N,N,-,-1,-1
THIRTY.txt,324848,325893,1045,10,N,N,-,-1,-1
THIRTY.txt,324906,326164,1258,10,N,N,-,-1,-1
THIRTY.txt,325137,326210,1073,10,N,N,-,-1,-1
THIRTY.txt,325250,326582,1332,10,Y,Y,1437470299748,152207,152889
THIRTY.txt,325337,326681,1344,10,Y,Y,1437470299748,152207,152889
THIRTY.txt,325362,326840,1478,10,Y,Y,1437470299748,152207,152889
THIRTY.txt,325386,327059,1673,10,Y,Y,1437470299748,152207,152889
THIRTY.txt,325406,327319,1913,10,Y,Y,1437470299748,152207,152889
THIRTY.txt,325675,327357,1682,10,Y,Y,1437470299748,152207,152889
THIRTY.txt,325773,327494,1721,10,Y,Y,1437470299748,152207,152889
THIRTY.txt,325895,327629,1734,10,Y,Y,1437470299748,152207,152889
THIRTY.txt,326165,327631,1466,10,Y,Y,1437470299748,152207,152889
THIRTY.txt,326211,327761,1550,10,Y,Y,1437470299748,152207,152889
THIRTY.txt,326583,327969,1386,10,N,Y,1437470299748,152207,152889
THIRTY.txt,326682,328130,1448,10,N,Y,1437470299748,152207,152889
THIRTY.txt,326843,328419,1576,10,N,Y,1448313994373,179347,179715
THIRTY.txt,327060,328628,1568,10,N,Y,1448359878707,265791,267089
THIRTY.txt,327319,328719,1400,10,N,Y,1448359878707,265791,267089
THIRTY.txt,327357,328874,1517,10,N,Y,1448359878707,265791,267089
THIRTY.txt,327500,329108,1608,10,N,Y,1448359878707,265791,267089
THIRTY.txt,327629,329289,1660,10,N,Y,1448359878707,265791,267089
THIRTY.txt,327633,329598,1965,10,N,Y,1448359878707,265791,267089
THIRTY.txt,327762,329621,1859,10,N,Y,1448359878707,265791,267089
THIRTY.txt,327971,329814,1843,10,N,Y,1448359878707,265791,267089
THIRTY.txt,328135,329900,1765,10,N,N,-,-1,-1
THIRTY.txt,328422,330046,1624,10,N,N,-,-1,-1
THIRTY.txt,328629,330111,1482,10,N,N,-,-1,-1
THIRTY.txt,328720,330272,1552,10,N,N,-,-1,-1
THIRTY.txt,328875,330406,1531,10,N,N,-,-1,-1
THIRTY.txt,329110,330547,1437,10,N,Y,1448039533036,21326,21680
THIRTY.txt,329290,330656,1366,10,N,Y,1448039533036,21326,21680
THIRTY.txt,329600,330937,1337,10,N,Y,1448039533036,21326,21680
THIRTY.txt,329622,331032,1410,10,N,Y,1448039533036,21326,21680
THIRTY.txt,329815,331281,1466,10,N,Y,1448039533036,21326,21680
THIRTY.txt,329901,331477,1576,10,N,Y,1448039533036,21326,21680
THIRTY.txt,330049,331689,1640,10,N,Y,1448039533036,21326,21680
THIRTY.txt,330112,331793,1681,10,N,Y,1448039533036,21326,21680
THIRTY.txt,330273,331998,1725,10,N,Y,1448039533036,21326,21680
THIRTY.txt,330408,332100,1692,10,N,Y,1448039533036,21326,21680
THIRTY.txt,330548,332226,1678,10,N,Y,1448039533036,21326,21680
THIRTY.txt,330656,332294,1638,10,N,Y,1448039533036,21326,21680
THIRTY.txt,330942,332451,1509,10,N,Y,1448039533036,21326,21680
THIRTY.txt,331033,332758,1725,10,N,Y,1448039533036,21326,21680
THIRTY.txt,331282,332829,1547,10,N,Y,1448039533036,21326,21680
THIRTY.txt,331478,332983,1505,10,N,Y,1448039533036,21326,21680
THIRTY.txt,331690,333154,1464,10,N,N,-,-1,-1
THIRTY.txt,331796,333344,1548,10,N,N,-,-1,-1
THIRTY.txt,332000,333488,1488,10,N,N,-,-1,-1
THIRTY.txt,332102,333710,1608,10,N,N,-,-1,-1
THIRTY.txt,332227,333911,1684,10,N,N,-,-1,-1
THIRTY.txt,332295,333936,1641,10,N,N,-,-1,-1
THIRTY.txt,332453,334019,1566,10,N,N,-,-1,-1
THIRTY.txt,332759,334110,1351,10,N,N,-,-1,-1
THIRTY.txt,332830,334190,1360,10,N,N,-,-1,-1
THIRTY.txt,332984,334395,1411,10,N,N,-,-1,-1
THIRTY.txt,333156,334627,1471,10,N,N,-,-1,-1
THIRTY.txt,333347,334697,1350,10,N,N,-,-1,-1
THIRTY.txt,333490,334726,1236,10,N,N,-,-1,-1
THIRTY.txt,333711,334788,1077,10,N,N,-,-1,-1
THIRTY.txt,333914,334844,930,10,N,N,-,-1,-1
THIRTY.txt,333938,334859,921,10,N,N,-,-1,-1
THIRTY.txt,334020,334973,953,10,N,Y,1448394918930,293978,294297
THIRTY.txt,334111,335224,1113,10,N,Y,1448394918930,293978,294297
THIRTY.txt,334191,335473,1282,10,N,Y,1448394918930,293978,294297
THIRTY.txt,334396,335620,1224,10,N,Y,1448394918930,293978,294297
THIRTY.txt,334628,335781,1153,10,N,Y,1448394918930,293978,294297
THIRTY.txt,334698,335926,1228,10,N,Y,1448394918930,293978,294297
THIRTY.txt,334727,335993,1266,10,N,Y,1448394918930,293978,294297
THIRTY.txt,334789,336297,1508,10,N,Y,1448394918930,293978,294297
THIRTY.txt,334847,336598,1751,10,N,Y,1448394918930,293978,294297
THIRTY.txt,334862,336687,1825,10,N,Y,1448394918930,293978,294297
THIRTY.txt,334974,336806,1832,10,N,Y,1448394918930,293978,294297
THIRTY.txt,335226,336958,1732,10,N,Y,1448394918930,293978,294297
THIRTY.txt,335474,337072,1598,10,N,Y,1448394918930,293978,294297
THIRTY.txt,335621,337157,1536,10,N,Y,1448394918930,293978,294297
THIRTY.txt,335782,337194,1412,10,N,Y,1448394918930,293978,294297
THIRTY.txt,335929,337342,1413,10,N,Y,1448369703497,282374,282547
THIRTY.txt,335994,337505,1511,10,N,Y,1448369703497,282374,282547
THIRTY.txt,336298,337650,1352,10,N,Y,1448369703497,282374,282547
THIRTY.txt,336599,337846,1247,10,N,Y,1448369703497,282374,282547
THIRTY.txt,336688,337961,1273,10,N,Y,1448369703497,282374,282547
THIRTY.txt,336807,338013,1206,10,N,Y,1448369703497,282374,282547
THIRTY.txt,336959,338146,1187,10,N,Y,1448369703497,282374,282547
THIRTY.txt,337074,338281,1207,10,N,Y,1448369703497,282374,282547
THIRTY.txt,337158,338418,1260,10,N,Y,1448369703497,282374,282547
THIRTY.txt,337195,338658,1463,10,N,Y,1448369703497,282374,282547
THIRTY.txt,337343,338791,1448,10,N,Y,1448369703497,282374,282547
THIRTY.txt,337506,338793,1287,10,N,Y,1448369703497,282374,282547
THIRTY.txt,337651,338904,1253,10,N,Y,1448369703497,282374,282547
THIRTY.txt,337847,339156,1309,10,N,Y,1448369703497,282374,282547
THIRTY.txt,337962,339221,1259,10,N,Y,1448369703497,282374,282547
THIRTY.txt,338014,339382,1368,10,N,Y,1448286451685,111065,112127
THIRTY.txt,338147,339554,1407,10,N,Y,1448286451685,111065,112127
THIRTY.txt,338282,339768,1486,10,N,Y,1448286451685,111065,112127
THIRTY.txt,338419,340019,1600,10,N,Y,1448286451685,111065,112127
THIRTY.txt,338661,340357,1696,10,N,Y,1448286451685,111065,112127
THIRTY.txt,338792,340454,1662,10,N,Y,1448286451685,111065,112127
THIRTY.txt,338794,340685,1891,10,N,Y,1448286451685,111065,112127
THIRTY.txt,338905,341049,2144,10,N,Y,1448286451685,111065,112127
THIRTY.txt,339156,341139,1983,10,N,Y,1448286451685,111065,112127
THIRTY.txt,339222,341348,2126,10,N,Y,1448286451685,111065,112127
THIRTY.txt,339383,341372,1989,10,N,Y,1448286451685,111065,112127
THIRTY.txt,339555,341668,2113,10,N,Y,1448286451685,111065,112127
THIRTY.txt,339769,341831,2062,10,N,Y,1448286451685,111065,112127
THIRTY.txt,340020,342076,2056,10,N,Y,1448286451685,111065,112127
THIRTY.txt,340360,342177,1817,10,N,N,-,-1,-1
THIRTY.txt,340456,342410,1954,10,N,N,-,-1,-1
THIRTY.txt,340686,342753,2067,10,N,N,-,-1,-1
THIRTY.txt,341050,342913,1863,10,N,N,-,-1,-1
THIRTY.txt,341140,343013,1873,10,N,N,-,-1,-1
THIRTY.txt,341349,343091,1742,10,N,N,-,-1,-1
THIRTY.txt,341375,343346,1971,10,N,N,-,-1,-1
THIRTY.txt,341670,343575,1905,10,N,N,-,-1,-1
THIRTY.txt,341832,343636,1804,10,N,N,-,-1,-1
THIRTY.txt,342077,343786,1709,10,N,N,-,-1,-1
THIRTY.txt,342180,343996,1816,10,N,Y,1448279089520,67624,69991
THIRTY.txt,342411,344067,1656,10,N,Y,1448279089520,67624,69991
THIRTY.txt,342754,344187,1433,10,N,Y,1448279089520,67624,69991
THIRTY.txt,342914,344438,1524,10,N,Y,1448279089520,67624,69991
THIRTY.txt,343016,344607,1591,10,N,Y,1448279089520,67624,69991
THIRTY.txt,343092,344823,1731,10,N,Y,1448279089520,67624,69991
THIRTY.txt,343347,344907,1560,10,N,Y,1448279089520,67624,69991
THIRTY.txt,343576,345056,1480,10,N,Y,1448279089520,67624,69991
THIRTY.txt,343637,345287,1650,10,N,Y,1448279089520,67624,69991
THIRTY.txt,343789,345419,1630,10,N,Y,1448279089520,67624,69991
THIRTY.txt,343997,345740,1743,10,N,Y,1448279089520,67624,69991
THIRTY.txt,344068,345902,1834,10,N,Y,1448279089520,67624,69991
THIRTY.txt,344188,346023,1835,10,N,Y,1448279089520,67624,69991
THIRTY.txt,344439,346165,1726,10,N,Y,1448279089520,67624,69991
THIRTY.txt,344608,346217,1609,10,N,Y,1448279089520,67624,69991
THIRTY.txt,344823,346344,1521,10,N,Y,1448279089520,67624,69991
THIRTY.txt,344908,346476,1568,10,N,Y,1448279089520,67624,69991
THIRTY.txt,345059,346620,1561,10,N,Y,1448279089520,67624,69991
THIRTY.txt,345288,346780,1492,10,N,Y,1448279089520,67624,69991
THIRTY.txt,345420,346913,1493,10,N,Y,1448279089520,67624,69991
THIRTY.txt,345742,347102,1360,10,N,Y,1448279089520,67624,69991
THIRTY.txt,345903,347177,1274,10,N,Y,1448279089520,67624,69991
THIRTY.txt,346024,347276,1252,10,N,Y,1448280423373,85694,86154
THIRTY.txt,346166,347488,1322,10,N,Y,1448280423373,85694,86154
THIRTY.txt,346218,347695,1477,10,N,Y,1448280423373,85694,86154
THIRTY.txt,346346,347728,1382,10,N,Y,1448280423373,85694,86154
THIRTY.txt,346479,347946,1467,10,N,Y,1448280423373,85694,86154
THIRTY.txt,346621,348361,1740,10,N,Y,1437476486340,221621,222520
THIRTY.txt,346781,348444,1663,10,N,Y,1437476486340,221621,222520
THIRTY.txt,346914,348614,1700,10,N,Y,1437476486340,221621,222520
THIRTY.txt,347103,348777,1674,10,N,Y,1437476486340,221621,222520
THIRTY.txt,347178,348946,1768,10,N,Y,1437476486340,221621,222520
THIRTY.txt,347277,349002,1725,10,N,Y,1437476486340,221621,222520
THIRTY.txt,347490,349074,1584,10,N,Y,1437476486340,221621,222520
THIRTY.txt,347696,349240,1544,10,N,Y,1437476486340,221621,222520
THIRTY.txt,347729,349483,1754,10,N,Y,1437476486340,221621,222520
THIRTY.txt,347947,349677,1730,10,N,Y,1437476486340,221621,222520
THIRTY.txt,348364,350035,1671,10,N,N,-,-1,-1
THIRTY.txt,348445,350273,1828,10,N,N,-,-1,-1
THIRTY.txt,348614,350306,1692,10,N,N,-,-1,-1
THIRTY.txt,348778,350536,1758,10,N,N,-,-1,-1
THIRTY.txt,348948,350667,1719,10,N,N,-,-1,-1
THIRTY.txt,349003,350707,1704,10,N,N,-,-1,-1
THIRTY.txt,349075,350930,1855,10,N,N,-,-1,-1
THIRTY.txt,349241,351179,1938,10,N,N,-,-1,-1
THIRTY.txt,349484,351269,1785,10,N,N,-,-1,-1
THIRTY.txt,349680,351529,1849,10,N,N,-,-1,-1
THIRTY.txt,350036,351636,1600,10,N,Y,1448322713112,221941,223038
THIRTY.txt,350274,351866,1592,10,N,Y,1448322713112,221941,223038
THIRTY.txt,350307,352026,1719,10,N,Y,1448322713112,221941,223038
THIRTY.txt,350537,352224,1687,10,N,Y,1448322713112,221941,223038
THIRTY.txt,350670,352401,1731,10,N,Y,1448322713112,221941,223038
THIRTY.txt,350708,352601,1893,10,N,Y,1448322713112,221941,223038
THIRTY.txt,350931,352652,1721,10,N,Y,1448322713112,221941,223038
THIRTY.txt,351180,352698,1518,10,N,Y,1448322713112,221941,223038
THIRTY.txt,351271,352734,1463,10,N,Y,1448322713112,221941,223038
THIRTY.txt,351534,352797,1263,10,N,Y,1448322713112,221941,223038
THIRTY.txt,351637,352830,1193,10,N,Y,1448322713112,221941,223038
THIRTY.txt,351867,353094,1227,10,N,Y,1448322713112,221941,223038
THIRTY.txt,352027,353192,1165,10,N,Y,1448322713112,221941,223038
THIRTY.txt,352225,353212,987,10,N,Y,1448322713112,221941,223038
THIRTY.txt,352402,353297,895,10,N,Y,1448322713112,221941,223038
THIRTY.txt,352602,353361,759,10,N,Y,1448322713112,221941,223038
THIRTY.txt,352653,353495,842,10,N,Y,1448322713112,221941,223038
THIRTY.txt,352699,353662,963,10,N,Y,1448322713112,221941,223038
THIRTY.txt,352735,353777,1042,10,N,Y,1448322713112,221941,223038
THIRTY.txt,352798,353874,1076,10,N,Y,1448322713112,221941,223038
THIRTY.txt,352831,354039,1208,10,N,Y,1448322713112,221941,223038
THIRTY.txt,353095,354091,996,10,N,Y,1448322713112,221941,223038
THIRTY.txt,353195,354253,1058,10,N,Y,1448322713112,221941,223038
THIRTY.txt,353212,354389,1177,10,N,Y,1448322713112,221941,223038
THIRTY.txt,353298,354542,1244,10,N,Y,1448322713112,221941,223038
THIRTY.txt,353362,355050,1688,10,N,Y,1448322713112,221941,223038
THIRTY.txt,353497,355195,1698,10,N,Y,1448322713112,221941,223038
THIRTY.txt,353663,355352,1689,10,N,Y,1448322713112,221941,223038
THIRTY.txt,353778,355524,1746,10,N,Y,1448322713112,221941,223038
THIRTY.txt,353875,355717,1842,10,N,Y,1448322713112,221941,223038
THIRTY.txt,354040,356076,2036,10,N,N,-,-1,-1
THIRTY.txt,354092,356359,2267,10,N,N,-,-1,-1
THIRTY.txt,354253,356423,2170,10,N,N,-,-1,-1
THIRTY.txt,354392,356602,2210,10,N,N,-,-1,-1
THIRTY.txt,354547,356955,2408,10,N,N,-,-1,-1
THIRTY.txt,355051,357067,2016,10,N,N,-,-1,-1
THIRTY.txt,355196,357296,2100,10,N,N,-,-1,-1
THIRTY.txt,355354,357762,2408,10,N,N,-,-1,-1
THIRTY.txt,355525,357960,2435,10,N,N,-,-1,-1
THIRTY.txt,355718,358131,2413,10,N,N,-,-1,-1
THIRTY.txt,356077,358322,2245,10,N,N,-,-1,-1
THIRTY.txt,356360,358383,2023,10,N,N,-,-1,-1
THIRTY.txt,356424,358473,2049,10,N,N,-,-1,-1
THIRTY.txt,356607,358750,2143,10,N,N,-,-1,-1
THIRTY.txt,356958,358836,1878,10,N,N,-,-1,-1
THIRTY.txt,357068,358908,1840,10,N,N,-,-1,-1
THIRTY.txt,357298,358934,1636,10,N,N,-,-1,-1
THIRTY.txt,357763,359278,1515,10,N,N,-,-1,-1
THIRTY.txt,357961,359336,1375,10,N,N,-,-1,-1
THIRTY.txt,358133,359389,1256,10,N,N,-,-1,-1
THIRTY.txt,358323,359488,1165,10,N,N,-,-1,-1
THIRTY.txt,358385,359532,1147,10,N,N,-,-1,-1
THIRTY.txt,358475,359663,1188,10,N,N,-,-1,-1
THIRTY.txt,358751,360073,1322,10,N,N,-,-1,-1
THIRTY.txt,358839,360209,1370,10,N,N,-,-1,-1
THIRTY.txt,358911,360434,1523,10,N,N,-,-1,-1
THIRTY.txt,358935,360520,1585,10,N,N,-,-1,-1
THIRTY.txt,359279,360691,1412,10,N,N,-,-1,-1
THIRTY.txt,359341,360879,1538,10,N,N,-,-1,-1
THIRTY.txt,359390,360978,1588,10,N,N,-,-1,-1
THIRTY.txt,359489,361093,1604,10,N,N,-,-1,-1
THIRTY.txt,359533,361274,1741,10,N,N,-,-1,-1
THIRTY.txt,359664,361320,1656,10,N,N,-,-1,-1
THIRTY.txt,360076,361403,1327,10,N,N,-,-1,-1
THIRTY.txt,360210,361472,1262,10,N,N,-,-1,-1
THIRTY.txt,360435,361671,1236,10,N,N,-,-1,-1
THIRTY.txt,360521,361892,1371,10,N,N,-,-1,-1
THIRTY.txt,360693,362035,1342,10,N,N,-,-1,-1
THIRTY.txt,360882,362261,1379,10,N,N,-,-1,-1
THIRTY.txt,360979,362430,1451,10,N,N,-,-1,-1
THIRTY.txt,361094,362672,1578,10,N,N,-,-1,-1
THIRTY.txt,361275,362679,1404,10,N,N,-,-1,-1
THIRTY.txt,361323,362783,1460,10,N,N,-,-1,-1
THIRTY.txt,361404,362860,1456,10,N,N,-,-1,-1
THIRTY.txt,361473,363192,1719,10,N,N,-,-1,-1
THIRTY.txt,361672,363365,1693,10,N,N,-,-1,-1
THIRTY.txt,361894,363398,1504,10,N,N,-,-1,-1
THIRTY.txt,362036,363413,1377,10,N,N,-,-1,-1
THIRTY.txt,362262,363679,1417,10,N,N,-,-1,-1
THIRTY.txt,362431,363904,1473,10,N,N,-,-1,-1
THIRTY.txt,362672,363953,1281,10,N,N,-,-1,-1
THIRTY.txt,362680,364066,1386,10,N,N,-,-1,-1
THIRTY.txt,362788,364207,1419,10,N,N,-,-1,-1
THIRTY.txt,362866,364283,1417,10,N,N,-,-1,-1
THIRTY.txt,363195,364432,1237,10,N,N,-,-1,-1
THIRTY.txt,363366,364601,1235,10,N,N,-,-1,-1
THIRTY.txt,363399,364741,1342,10,Y,N,-,-1,-1
THIRTY.txt,363414,364876,1462,10,Y,N,-,-1,-1
THIRTY.txt,363680,364914,1234,10,Y,N,-,-1,-1
THIRTY.txt,363905,365098,1193,10,N,N,-,-1,-1
THIRTY.txt,363954,365211,1257,10,N,N,-,-1,-1
THIRTY.txt,364069,365389,1320,10,N,N,-,-1,-1
THIRTY.txt,364208,365407,1199,10,N,N,-,-1,-1
THIRTY.txt,364284,365468,1184,10,N,N,-,-1,-1
THIRTY.txt,364433,365620,1187,10,N,N,-,-1,-1
THIRTY.txt,364602,365828,1226,10,N,N,-,-1,-1
THIRTY.txt,364743,365959,1216,10,N,N,-,-1,-1
THIRTY.txt,364877,366044,1167,10,N,N,-,-1,-1
THIRTY.txt,364915,366078,1163,10,N,N,-,-1,-1
THIRTY.txt,365099,366135,1036,10,N,N,-,-1,-1
THIRTY.txt,365212,366174,962,10,N,N,-,-1,-1
THIRTY.txt,365390,366345,955,10,N,N,-,-1,-1
THIRTY.txt,365408,366463,1055,10,N,N,-,-1,-1
THIRTY.txt,365469,366482,1013,10,N,N,-,-1,-1
THIRTY.txt,365621,366537,916,10,N,N,-,-1,-1
THIRTY.txt,365829,366579,750,10,N,N,-,-1,-1
THIRTY.txt,365960,366749,789,10,N,N,-,-1,-1
THIRTY.txt,366047,366999,952,10,N,N,-,-1,-1
THIRTY.txt,366079,367123,1044,10,N,N,-,-1,-1
THIRTY.txt,366136,367274,1138,10,N,N,-,-1,-1
THIRTY.txt,366175,367401,1226,10,N,N,-,-1,-1
THIRTY.txt,366348,367493,1145,10,N,N,-,-1,-1
THIRTY.txt,366464,367842,1378,10,N,N,-,-1,-1
THIRTY.txt,366483,367905,1422,10,N,N,-,-1,-1
THIRTY.txt,366539,368063,1524,10,N,N,-,-1,-1
THIRTY.txt,366580,368162,1582,10,N,N,-,-1,-1
THIRTY.txt,366751,368297,1546,10,N,N,-,-1,-1
THIRTY.txt,367000,368328,1328,10,N,N,-,-1,-1
THIRTY.txt,367123,368434,1311,10,N,N,-,-1,-1
THIRTY.txt,367275,368657,1382,10,N,N,-,-1,-1
THIRTY.txt,367402,368958,1556,10,N,N,-,-1,-1
THIRTY.txt,367494,369207,1713,10,N,N,-,-1,-1
THIRTY.txt,367845,369373,1528,10,N,N,-,-1,-1
THIRTY.txt,367906,369676,1770,10,N,N,-,-1,-1
THIRTY.txt,368064,369811,1747,10,N,N,-,-1,-1
THIRTY.txt,368163,369944,1781,10,N,Y,1448322514970,220165,221397
THIRTY.txt,368298,370100,1802,10,N,Y,1448322514970,220165,221397
THIRTY.txt,368331,370356,2025,10,N,Y,1448322514970,220165,221397
THIRTY.txt,368436,370691,2255,10,N,Y,1448322514970,220165,221397
THIRTY.txt,368658,370789,2131,10,N,Y,1448322514970,220165,221397
THIRTY.txt,368959,370940,1981,10,N,Y,1448322514970,220165,221397
THIRTY.txt,369208,371312,2104,10,N,Y,1448322514970,220165,221397
THIRTY.txt,369376,371520,2144,10,N,Y,1448322514970,220165,221397
THIRTY.txt,369677,371666,1989,10,Y,Y,1448322514970,220165,221397
THIRTY.txt,369812,371707,1895,10,Y,Y,1448322514970,220165,221397
THIRTY.txt,369945,371921,1976,10,Y,Y,1448322514970,220165,221397
THIRTY.txt,370101,372097,1996,10,Y,Y,1448322514970,220165,221397
THIRTY.txt,370358,372307,1949,10,Y,Y,1448322514970,220165,221397
THIRTY.txt,370694,372455,1761,10,N,N,-,-1,-1
THIRTY.txt,370791,372610,1819,10,N,N,-,-1,-1
THIRTY.txt,370941,372723,1782,10,N,N,-,-1,-1
THIRTY.txt,371313,372866,1553,10,N,Y,1448281320115,89144,91129
THIRTY.txt,371521,373094,1573,10,N,Y,1448281320115,89144,91129
THIRTY.txt,371667,373200,1533,10,N,Y,1448281320115,89144,91129
THIRTY.txt,371708,373452,1744,10,N,Y,1448281320115,89144,91129
THIRTY.txt,371923,373564,1641,10,N,Y,1448281320115,89144,91129
THIRTY.txt,372100,373637,1537,10,N,Y,1448281320115,89144,91129
THIRTY.txt,372308,373761,1453,10,N,Y,1448281320115,89144,91129
THIRTY.txt,372456,373896,1440,10,N,Y,1448281320115,89144,91129
THIRTY.txt,372611,373984,1373,10,N,Y,1448281320115,89144,91129
THIRTY.txt,372724,374309,1585,10,N,Y,1448281320115,89144,91129
THIRTY.txt,372867,374366,1499,10,N,Y,1448281320115,89144,91129
THIRTY.txt,373095,374418,1323,10,N,Y,1448281320115,89144,91129
THIRTY.txt,373202,374489,1287,10,N,Y,1448281320115,89144,91129
THIRTY.txt,373453,374747,1294,10,N,Y,1448281320115,89144,91129
THIRTY.txt,373565,374934,1369,10,N,Y,1448281320115,89144,91129
THIRTY.txt,373638,374963,1325,10,N,Y,1448281320115,89144,91129
THIRTY.txt,373764,375102,1338,10,N,N,-,-1,-1
THIRTY.txt,373897,375381,1484,10,N,N,-,-1,-1
THIRTY.txt,373985,375508,1523,10,N,N,-,-1,-1
THIRTY.txt,374310,375796,1486,10,N,N,-,-1,-1
THIRTY.txt,374369,375851,1482,10,N,N,-,-1,-1
THIRTY.txt,374421,375954,1533,10,N,N,-,-1,-1
THIRTY.txt,374490,376212,1722,10,N,N,-,-1,-1
THIRTY.txt,374748,376280,1532,10,N,N,-,-1,-1
THIRTY.txt,374935,376366,1431,10,N,N,-,-1,-1
THIRTY.txt,374964,376421,1457,10,N,N,-,-1,-1
THIRTY.txt,375102,376525,1423,10,N,N,-,-1,-1
THIRTY.txt,375382,376595,1213,10,N,N,-,-1,-1
THIRTY.txt,375510,376745,1235,10,N,N,-,-1,-1
THIRTY.txt,375797,376771,974,10,N,N,-,-1,-1
THIRTY.txt,375852,376868,1016,10,Y,N,-,-1,-1
THIRTY.txt,375959,377068,1109,10,Y,N,-,-1,-1
THIRTY.txt,376213,377165,952,10,Y,N,-,-1,-1
THIRTY.txt,376283,377493,1210,10,Y,N,-,-1,-1
THIRTY.txt,376367,377597,1230,10,Y,N,-,-1,-1
THIRTY.txt,376422,377872,1450,10,Y,N,-,-1,-1
THIRTY.txt,376526,377990,1464,10,Y,N,-,-1,-1
THIRTY.txt,376596,378444,1848,10,Y,N,-,-1,-1
THIRTY.txt,376746,378509,1763,10,Y,N,-,-1,-1
THIRTY.txt,376772,378658,1886,10,Y,N,-,-1,-1
THIRTY.txt,376869,378752,1883,10,Y,N,-,-1,-1
THIRTY.txt,377069,379058,1989,10,N,N,-,-1,-1
THIRTY.txt,377166,379159,1993,10,N,N,-,-1,-1
THIRTY.txt,377498,379249,1751,10,N,N,-,-1,-1
THIRTY.txt,377598,379542,1944,10,N,N,-,-1,-1
THIRTY.txt,377873,379915,2042,10,N,N,-,-1,-1
THIRTY.txt,377991,380086,2095,10,N,N,-,-1,-1
THIRTY.txt,378445,380163,1718,10,N,N,-,-1,-1
THIRTY.txt,378510,380206,1696,10,N,N,-,-1,-1
THIRTY.txt,378659,380471,1812,10,N,N,-,-1,-1
THIRTY.txt,378755,380640,1885,10,N,N,-,-1,-1
THIRTY.txt,379059,380709,1650,10,N,N,-,-1,-1
THIRTY.txt,379160,381023,1863,10,N,N,-,-1,-1
THIRTY.txt,379252,381160,1908,10,N,N,-,-1,-1
THIRTY.txt,379543,381250,1707,10,N,N,-,-1,-1
THIRTY.txt,379916,381461,1545,10,N,N,-,-1,-1
THIRTY.txt,380087,381758,1671,10,N,N,-,-1,-1
THIRTY.txt,380164,381823,1659,10,N,N,-,-1,-1
THIRTY.txt,380207,381954,1747,10,N,N,-,-1,-1
THIRTY.txt,380472,381975,1503,10,N,N,-,-1,-1
THIRTY.txt,380643,382011,1368,10,N,N,-,-1,-1
THIRTY.txt,380710,382080,1370,10,N,N,-,-1,-1
THIRTY.txt,381024,382110,1086,10,N,N,-,-1,-1
THIRTY.txt,381161,382239,1078,10,N,N,-,-1,-1
THIRTY.txt,381251,382283,1032,10,N,N,-,-1,-1
THIRTY.txt,381462,382351,889,10,N,N,-,-1,-1
THIRTY.txt,381759,382394,635,10,N,N,-,-1,-1
THIRTY.txt,381825,382599,774,10,N,N,-,-1,-1
THIRTY.txt,381955,382883,928,10,N,N,-,-1,-1
THIRTY.txt,381977,382939,962,10,N,N,-,-1,-1
THIRTY.txt,382012,383136,1124,10,N,N,-,-1,-1
THIRTY.txt,382081,383192,1111,10,N,N,-,-1,-1
THIRTY.txt,382111,383256,1145,10,N,N,-,-1,-1
THIRTY.txt,382240,383528,1288,10,N,N,-,-1,-1
THIRTY.txt,382284,383817,1533,10,N,N,-,-1,-1
THIRTY.txt,382352,384039,1687,10,N,N,-,-1,-1
THIRTY.txt,382399,384119,1720,10,N,N,-,-1,-1
THIRTY.txt,382600,384321,1721,10,N,N,-,-1,-1
THIRTY.txt,382884,384442,1558,10,N,N,-,-1,-1
THIRTY.txt,382940,384487,1547,10,N,N,-,-1,-1
THIRTY.txt,383137,384631,1494,10,N,N,-,-1,-1
THIRTY.txt,383194,384708,1514,10,N,N,-,-1,-1
THIRTY.txt,383257,384784,1527,10,N,N,-,-1,-1
THIRTY.txt,383529,384814,1285,10,N,N,-,-1,-1
THIRTY.txt,383818,385071,1253,10,N,N,-,-1,-1
THIRTY.txt,384040,385250,1210,10,N,N,-,-1,-1
THIRTY.txt,384124,385348,1224,10,N,N,-,-1,-1
THIRTY.txt,384322,385491,1169,10,N,N,-,-1,-1
THIRTY.txt,384443,385842,1399,10,N,N,-,-1,-1
THIRTY.txt,384488,385978,1490,10,N,N,-,-1,-1
THIRTY.txt,384632,386034,1402,10,N,N,-,-1,-1
THIRTY.txt,384709,386210,1501,10,N,N,-,-1,-1
THIRTY.txt,384785,386285,1500,10,N,N,-,-1,-1
THIRTY.txt,384815,386482,1667,10,N,N,-,-1,-1
THIRTY.txt,385072,386629,1557,10,N,N,-,-1,-1
THIRTY.txt,385251,386884,1633,10,N,N,-,-1,-1
THIRTY.txt,385349,387148,1799,10,N,N,-,-1,-1
THIRTY.txt,385494,387193,1699,10,N,N,-,-1,-1
THIRTY.txt,385843,387331,1488,10,N,N,-,-1,-1
THIRTY.txt,385979,387641,1662,10,N,N,-,-1,-1
THIRTY.txt,386035,387762,1727,10,N,N,-,-1,-1
THIRTY.txt,386211,387802,1591,10,N,N,-,-1,-1
THIRTY.txt,386286,387851,1565,10,N,N,-,-1,-1
THIRTY.txt,386484,387906,1422,10,N,N,-,-1,-1
THIRTY.txt,386630,387934,1304,10,N,N,-,-1,-1
THIRTY.txt,386885,388104,1219,10,N,N,-,-1,-1
THIRTY.txt,387149,388198,1049,10,N,N,-,-1,-1
THIRTY.txt,387196,388474,1278,10,N,N,-,-1,-1
THIRTY.txt,387333,388596,1263,10,N,N,-,-1,-1
THIRTY.txt,387642,388651,1009,10,N,N,-,-1,-1
THIRTY.txt,387763,388721,958,10,N,N,-,-1,-1
THIRTY.txt,387804,388912,1108,10,N,N,-,-1,-1
THIRTY.txt,387852,389096,1244,10,N,N,-,-1,-1
THIRTY.txt,387906,389468,1562,10,N,N,-,-1,-1
THIRTY.txt,387937,389645,1708,10,N,N,-,-1,-1
THIRTY.txt,388105,389773,1668,10,N,N,-,-1,-1
THIRTY.txt,388199,389956,1757,10,N,N,-,-1,-1
THIRTY.txt,388475,390137,1662,10,N,N,-,-1,-1
THIRTY.txt,388598,390530,1932,10,N,N,-,-1,-1
THIRTY.txt,388654,390607,1953,10,N,N,-,-1,-1
THIRTY.txt,388722,390730,2008,10,N,N,-,-1,-1
THIRTY.txt,388913,391009,2096,10,N,N,-,-1,-1
THIRTY.txt,389098,391116,2018,10,N,N,-,-1,-1
THIRTY.txt,389469,391295,1826,10,N,N,-,-1,-1
THIRTY.txt,389646,391384,1738,10,N,N,-,-1,-1
THIRTY.txt,389774,391431,1657,10,N,N,-,-1,-1
THIRTY.txt,389958,391577,1619,10,N,N,-,-1,-1
THIRTY.txt,390142,391710,1568,10,N,N,-,-1,-1
THIRTY.txt,390533,391801,1268,10,N,N,-,-1,-1
THIRTY.txt,390608,392035,1427,10,N,N,-,-1,-1
THIRTY.txt,390731,392194,1463,10,N,N,-,-1,-1
THIRTY.txt,391012,392251,1239,10,N,N,-,-1,-1
THIRTY.txt,391117,392401,1284,10,N,N,-,-1,-1
THIRTY.txt,391296,392564,1268,10,N,N,-,-1,-1
THIRTY.txt,391385,392591,1206,10,N,N,-,-1,-1
THIRTY.txt,391437,392655,1218,10,N,Y,1448366833867,275966,276698
THIRTY.txt,391581,392739,1158,10,N,Y,1448366833867,275966,276698
THIRTY.txt,391712,392843,1131,10,N,Y,1448366833867,275966,276698
THIRTY.txt,391802,392980,1178,10,N,Y,1448366833867,275966,276698
THIRTY.txt,392036,393041,1005,10,N,Y,1448366833867,275966,276698
THIRTY.txt,392195,393126,931,10,N,Y,1448366833867,275966,276698
THIRTY.txt,392252,393289,1037,10,N,Y,1448366833867,275966,276698
THIRTY.txt,392402,393337,935,10,N,Y,1448366833867,275966,276698
THIRTY.txt,392565,393490,925,10,N,Y,1448366833867,275966,276698
THIRTY.txt,392594,393736,1142,10,N,Y,1448366833867,275966,276698
THIRTY.txt,392656,393775,1119,10,N,Y,1448366833867,275966,276698
THIRTY.txt,392741,393862,1121,10,N,Y,1448366833867,275966,276698
THIRTY.txt,392844,393898,1054,10,N,Y,1448366833867,275966,276698
THIRTY.txt,392982,394175,1193,10,N,Y,1448366833867,275966,276698
THIRTY.txt,393042,394218,1176,10,N,Y,1448366833867,275966,276698
THIRTY.txt,393128,394323,1195,10,N,Y,1448366833867,275966,276698
THIRTY.txt,393294,394451,1157,10,N,Y,1448366833867,275966,276698
THIRTY.txt,393338,394753,1415,10,N,Y,1448366833867,275966,276698
THIRTY.txt,393491,395049,1558,10,N,Y,1448366833867,275966,276698
THIRTY.txt,393739,395247,1508,10,N,Y,1448279620157,70041,71486
THIRTY.txt,393776,395638,1862,10,N,Y,1448279620157,70041,71486
THIRTY.txt,393862,395668,1806,10,N,Y,1448279620157,70041,71486
THIRTY.txt,393899,395925,2026,10,N,Y,1448279620157,70041,71486
THIRTY.txt,394176,395975,1799,10,N,Y,1448279620157,70041,71486
THIRTY.txt,394221,396177,1956,10,N,Y,1437472380836,351899,352666
THIRTY.txt,394325,396396,2071,10,N,Y,1437472380836,351899,352666
THIRTY.txt,394452,396613,2161,10,Y,Y,1437472380836,351899,352666
THIRTY.txt,394758,396912,2154,10,N,Y,1437472380836,351899,352666
THIRTY.txt,395050,396937,1887,10,N,Y,1437472380836,351899,352666
THIRTY.txt,395248,397262,2014,10,N,Y,1437472380836,351899,352666
THIRTY.txt,395639,397428,1789,10,N,Y,1437472380836,351899,352666
THIRTY.txt,395671,397591,1920,10,N,Y,1437472380836,351899,352666
THIRTY.txt,395926,397813,1887,10,N,Y,1437472380836,351899,352666
THIRTY.txt,395976,397856,1880,10,N,Y,1437472380836,351899,352666
THIRTY.txt,396178,398096,1918,10,N,Y,1437472380836,351899,352666
THIRTY.txt,396397,398336,1939,10,N,Y,1437472380836,351899,352666
THIRTY.txt,396613,398462,1849,10,N,Y,1437472380836,351899,352666
THIRTY.txt,396913,398623,1710,10,N,Y,1437472380836,351899,352666
THIRTY.txt,396938,398833,1895,10,N,Y,1437472380836,351899,352666
THIRTY.txt,397265,398957,1692,10,N,Y,1448322397200,219547,220107
THIRTY.txt,397429,399090,1661,10,N,Y,1448322397200,219547,220107
THIRTY.txt,397592,399276,1684,10,N,Y,1448322397200,219547,220107
THIRTY.txt,397814,399453,1639,10,N,Y,1448322397200,219547,220107
THIRTY.txt,397857,399505,1648,10,N,Y,1448322397200,219547,220107
THIRTY.txt,398101,399513,1412,10,N,N,-,-1,-1
THIRTY.txt,398337,399667,1330,10,N,N,-,-1,-1
THIRTY.txt,398464,399748,1284,10,N,N,-,-1,-1
THIRTY.txt,398625,399885,1260,10,N,N,-,-1,-1
THIRTY.txt,398835,399955,1120,10,N,N,-,-1,-1
THIRTY.txt,398959,400070,1111,10,N,Y,1448368866047,278997,279078
THIRTY.txt,399093,400120,1027,10,N,Y,1448368866047,278997,279078
THIRTY.txt,399277,400176,899,10,N,Y,1448368866047,278997,279078
THIRTY.txt,399456,400264,808,10,N,Y,1448368866047,278997,279078
THIRTY.txt,399508,400319,811,10,N,Y,1448368866047,278997,279078
THIRTY.txt,399514,400424,910,10,N,Y,1448368866047,278997,279078
THIRTY.txt,399670,400485,815,10,N,Y,1448368866047,278997,279078
THIRTY.txt,399749,400687,938,10,N,Y,1448368866047,278997,279078
THIRTY.txt,399886,400752,866,10,N,Y,1448368866047,278997,279078
THIRTY.txt,399956,400850,894,10,N,Y,1448368866047,278997,279078
THIRTY.txt,400071,400859,788,10,N,Y,1448368866047,278997,279078
THIRTY.txt,400121,401058,937,10,N,Y,1448368866047,278997,279078
THIRTY.txt,400177,401226,1049,10,N,Y,1448368866047,278997,279078
THIRTY.txt,400265,401282,1017,10,N,Y,1448368866047,278997,279078
THIRTY.txt,400322,401492,1170,10,N,N,-,-1,-1
THIRTY.txt,400425,401630,1205,10,N,N,-,-1,-1
THIRTY.txt,400486,401736,1250,10,N,N,-,-1,-1
THIRTY.txt,400688,401805,1117,10,N,N,-,-1,-1
THIRTY.txt,400752,402048,1296,10,Y,N,-,-1,-1
THIRTY.txt,400851,402290,1439,10,Y,N,-,-1,-1
THIRTY.txt,400861,402398,1537,10,Y,N,-,-1,-1
THIRTY.txt,401059,402643,1584,10,Y,N,-,-1,-1
THIRTY.txt,401227,402737,1510,10,Y,N,-,-1,-1
THIRTY.txt,401287,402831,1544,10,Y,N,-,-1,-1
THIRTY.txt,401493,402922,1429,10,Y,N,-,-1,-1
THIRTY.txt,401631,403137,1506,10,Y,N,-,-1,-1
THIRTY.txt,401737,403166,1429,10,Y,N,-,-1,-1
THIRTY.txt,401806,403333,1527,10,Y,N,-,-1,-1
THIRTY.txt,402049,403385,1336,10,Y,N,-,-1,-1
THIRTY.txt,402291,403439,1148,10,N,N,-,-1,-1
THIRTY.txt,402401,403518,1117,10,N,N,-,-1,-1
THIRTY.txt,402644,403847,1203,10,N,N,-,-1,-1
THIRTY.txt,402738,403988,1250,10,N,N,-,-1,-1
THIRTY.txt,402832,404327,1495,10,N,N,-,-1,-1
THIRTY.txt,402923,404605,1682,10,N,N,-,-1,-1
THIRTY.txt,403138,404737,1599,10,N,N,-,-1,-1
THIRTY.txt,403167,404824,1657,10,N,N,-,-1,-1
THIRTY.txt,403334,404916,1582,10,N,N,-,-1,-1
THIRTY.txt,403388,404965,1577,10,N,N,-,-1,-1
THIRTY.txt,403440,405158,1718,10,N,N,-,-1,-1
THIRTY.txt,403519,405341,1822,10,N,N,-,-1,-1
THIRTY.txt,403848,405408,1560,10,N,N,-,-1,-1
THIRTY.txt,403988,405598,1610,10,N,N,-,-1,-1
THIRTY.txt,404332,405809,1477,10,N,N,-,-1,-1
THIRTY.txt,404606,406104,1498,10,N,N,-,-1,-1
THIRTY.txt,404738,406155,1417,10,N,N,-,-1,-1
THIRTY.txt,404826,406330,1504,10,N,N,-,-1,-1
THIRTY.txt,404918,406523,1605,10,Y,N,-,-1,-1
THIRTY.txt,404967,406675,1708,10,N,N,-,-1,-1
THIRTY.txt,405159,406852,1693,10,N,N,-,-1,-1
THIRTY.txt,405342,406999,1657,10,N,N,-,-1,-1
THIRTY.txt,405409,407055,1646,10,N,N,-,-1,-1
THIRTY.txt,405599,407081,1482,10,N,N,-,-1,-1
THIRTY.txt,405810,407088,1278,10,N,Y,1448275407308,26987,29181
THIRTY.txt,406109,407206,1097,10,N,Y,1448275407308,26987,29181
THIRTY.txt,406156,407355,1199,10,N,Y,1448275407308,26987,29181
THIRTY.txt,406332,407637,1305,10,Y,Y,1448275407308,26987,29181
THIRTY.txt,406525,408007,1482,10,N,Y,1448275407308,26987,29181
THIRTY.txt,406677,408081,1404,10,N,Y,1448275407308,26987,29181
THIRTY.txt,406853,408406,1553,10,N,Y,1448275407308,26987,29181
THIRTY.txt,407000,408448,1448,10,N,Y,1448275407308,26987,29181
THIRTY.txt,407058,408626,1568,10,N,Y,1448275407308,26987,29181
THIRTY.txt,407082,408767,1685,10,N,Y,1448275407308,26987,29181
THIRTY.txt,407089,408875,1786,10,N,Y,1448275407308,26987,29181
THIRTY.txt,407208,408911,1703,10,N,Y,1448275407308,26987,29181
THIRTY.txt,407357,409061,1704,10,N,Y,1448275407308,26987,29181
THIRTY.txt,407638,409161,1523,10,N,Y,1448275407308,26987,29181
THIRTY.txt,408008,409188,1180,10,N,Y,1448275407308,26987,29181
THIRTY.txt,408082,409245,1163,10,N,Y,1448038356234,18463,18881
THIRTY.txt,408409,409369,960,10,N,N,-,-1,-1
THIRTY.txt,408450,409382,932,10,N,N,-,-1,-1
THIRTY.txt,408627,409555,928,10,N,N,-,-1,-1
THIRTY.txt,408769,409613,844,10,N,N,-,-1,-1
THIRTY.txt,408876,409743,867,10,N,N,-,-1,-1
THIRTY.txt,408912,409795,883,10,N,N,-,-1,-1
THIRTY.txt,409063,409843,780,10,N,N,-,-1,-1
THIRTY.txt,409162,409926,764,10,N,N,-,-1,-1
THIRTY.txt,409189,409982,793,10,N,N,-,-1,-1
THIRTY.txt,409248,410011,763,10,N,N,-,-1,-1
THIRTY.txt,409370,410072,702,10,N,N,-,-1,-1
THIRTY.txt,409383,410137,754,10,N,N,-,-1,-1
THIRTY.txt,409556,410310,754,10,N,N,-,-1,-1
THIRTY.txt,409614,410399,785,10,N,N,-,-1,-1
THIRTY.txt,409743,410702,959,10,N,N,-,-1,-1
THIRTY.txt,409798,410973,1175,10,N,N,-,-1,-1
THIRTY.txt,409844,411446,1602,10,N,N,-,-1,-1
THIRTY.txt,409929,411464,1535,10,N,N,-,-1,-1
THIRTY.txt,409985,411890,1905,10,N,N,-,-1,-1
THIRTY.txt,410012,412017,2005,10,N,N,-,-1,-1
THIRTY.txt,410073,412254,2181,10,N,Y,1448369361055,281280,281814
THIRTY.txt,410138,412448,2310,10,N,Y,1448369361055,281280,281814
THIRTY.txt,410311,412592,2281,10,N,Y,1448369361055,281280,281814
THIRTY.txt,410400,412763,2363,10,N,Y,1448369361055,281280,281814
THIRTY.txt,410707,412940,2233,10,N,Y,1448369361055,281280,281814
THIRTY.txt,410974,413172,2198,10,N,Y,1448369361055,281280,281814
THIRTY.txt,411447,413251,1804,10,N,Y,1448369361055,281280,281814
THIRTY.txt,411465,413449,1984,10,N,Y,1448369361055,281280,281814
THIRTY.txt,411891,413539,1648,10,N,Y,1448369361055,281280,281814
THIRTY.txt,412020,413656,1636,10,N,Y,1448369361055,281280,281814
THIRTY.txt,412255,413749,1494,10,N,Y,1448313123004,175370,176057
THIRTY.txt,412449,413951,1502,10,N,Y,1448313123004,175370,176057
THIRTY.txt,412594,414164,1570,10,N,Y,1448313123004,175370,176057
THIRTY.txt,412764,414397,1633,10,N,Y,1448313123004,175370,176057
THIRTY.txt,412941,414553,1612,10,N,Y,1448313123004,175370,176057
THIRTY.txt,413175,414832,1657,10,Y,Y,1448313123004,175370,176057
THIRTY.txt,413252,415039,1787,10,Y,Y,1448313123004,175370,176057
THIRTY.txt,413450,415283,1833,10,Y,Y,1448313123004,175370,176057
THIRTY.txt,413540,415432,1892,10,Y,Y,1448313123004,175370,176057
THIRTY.txt,413658,415567,1909,10,Y,Y,1448313123004,175370,176057
THIRTY.txt,413750,415771,2021,10,Y,Y,1448313123004,175370,176057
THIRTY.txt,413952,415930,1978,10,Y,Y,1448313123004,175370,176057
THIRTY.txt,414165,416065,1900,10,Y,Y,1448313123004,175370,176057
THIRTY.txt,414400,416175,1775,10,Y,N,-,-1,-1
THIRTY.txt,414554,416478,1924,10,N,N,-,-1,-1
THIRTY.txt,414834,416586,1752,10,N,N,-,-1,-1
THIRTY.txt,415040,416629,1589,10,N,N,-,-1,-1
THIRTY.txt,415285,416943,1658,10,N,N,-,-1,-1
THIRTY.txt,415437,417004,1567,10,N,N,-,-1,-1
THIRTY.txt,415568,417214,1646,10,N,N,-,-1,-1
THIRTY.txt,415772,417284,1512,10,N,N,-,-1,-1
THIRTY.txt,415931,417444,1513,10,N,N,-,-1,-1
THIRTY.txt,416066,417592,1526,10,N,N,-,-1,-1
THIRTY.txt,416176,417725,1549,10,N,N,-,-1,-1
THIRTY.txt,416479,417914,1435,10,N,N,-,-1,-1
THIRTY.txt,416588,418065,1477,10,N,N,-,-1,-1
THIRTY.txt,416632,418114,1482,10,N,N,-,-1,-1
THIRTY.txt,416944,418260,1316,10,N,N,-,-1,-1
THIRTY.txt,417009,418421,1412,10,N,N,-,-1,-1
THIRTY.txt,417216,418464,1248,10,N,N,-,-1,-1
THIRTY.txt,417285,418550,1265,10,N,N,-,-1,-1
THIRTY.txt,417445,418647,1202,10,N,N,-,-1,-1
THIRTY.txt,417593,418853,1260,10,N,N,-,-1,-1
THIRTY.txt,417726,419027,1301,10,N,N,-,-1,-1
THIRTY.txt,417915,419099,1184,10,N,N,-,-1,-1
THIRTY.txt,418068,419150,1082,10,N,N,-,-1,-1
THIRTY.txt,418116,419369,1253,10,N,Y,1448323254416,230223,230526
THIRTY.txt,418261,419494,1233,10,N,Y,1448323254416,230223,230526
THIRTY.txt,418422,419631,1209,10,N,Y,1448323254416,230223,230526
THIRTY.txt,418465,419819,1354,10,N,Y,1448323254416,230223,230526
THIRTY.txt,418552,419992,1440,10,N,Y,1448323254416,230223,230526
THIRTY.txt,418648,420197,1549,10,N,Y,1448323254416,230223,230526
THIRTY.txt,418854,420224,1370,10,N,Y,1448280673594,87462,88501
THIRTY.txt,419028,420378,1350,10,N,Y,1448280673594,87462,88501
THIRTY.txt,419101,420598,1497,10,N,Y,1448280673594,87462,88501
THIRTY.txt,419153,420970,1817,10,N,Y,1448280673594,87462,88501
THIRTY.txt,419370,421093,1723,10,N,Y,1448280673594,87462,88501
THIRTY.txt,419496,421142,1646,10,Y,Y,1448280673594,87462,88501
THIRTY.txt,419632,421196,1564,10,N,Y,1448280673594,87462,88501
THIRTY.txt,419820,421330,1510,10,N,Y,1448280673594,87462,88501
THIRTY.txt,419993,421399,1406,10,Y,Y,1448280673594,87462,88501
THIRTY.txt,420200,421468,1268,10,Y,Y,1448280673594,87462,88501
THIRTY.txt,420226,421601,1375,10,Y,Y,1448280673594,87462,88501
THIRTY.txt,420378,421635,1257,10,Y,Y,1448280673594,87462,88501
THIRTY.txt,420599,421837,1238,10,Y,Y,1448280673594,87462,88501
THIRTY.txt,420972,421959,987,10,N,Y,1448280673594,87462,88501
THIRTY.txt,421094,422070,976,10,N,Y,1448280673594,87462,88501
THIRTY.txt,421143,422314,1171,10,N,Y,1448280673594,87462,88501
THIRTY.txt,421197,422707,1510,10,Y,Y,1448280673594,87462,88501
THIRTY.txt,421331,422748,1417,10,Y,Y,1448280673594,87462,88501
THIRTY.txt,421400,422936,1536,10,Y,Y,1448280673594,87462,88501
THIRTY.txt,421469,423091,1622,10,Y,Y,1448280673594,87462,88501
THIRTY.txt,421604,423196,1592,10,Y,Y,1448280673594,87462,88501
THIRTY.txt,421640,423297,1657,10,Y,Y,1448316411409,206556,208475
THIRTY.txt,421838,423488,1650,10,Y,Y,1448316411409,206556,208475
THIRTY.txt,421960,423905,1945,10,Y,Y,1448316411409,206556,208475
THIRTY.txt,422071,424290,2219,10,Y,Y,1448316411409,206556,208475
THIRTY.txt,422319,424316,1997,10,N,N,-,-1,-1
THIRTY.txt,422707,424645,1938,10,N,N,-,-1,-1
THIRTY.txt,422749,424716,1967,10,N,N,-,-1,-1
THIRTY.txt,422937,424859,1922,10,N,N,-,-1,-1
THIRTY.txt,423092,425008,1916,10,N,N,-,-1,-1
THIRTY.txt,423197,425162,1965,10,N,N,-,-1,-1
THIRTY.txt,423298,425292,1994,10,N,N,-,-1,-1
THIRTY.txt,423489,425559,2070,10,N,N,-,-1,-1
THIRTY.txt,423908,425623,1715,10,N,N,-,-1,-1
THIRTY.txt,424291,425892,1601,10,N,N,-,-1,-1
THIRTY.txt,424317,425949,1632,10,N,N,-,-1,-1
THIRTY.txt,424646,426255,1609,10,N,N,-,-1,-1
THIRTY.txt,424719,426377,1658,10,N,N,-,-1,-1
THIRTY.txt,424860,426490,1630,10,N,N,-,-1,-1
THIRTY.txt,425009,426687,1678,10,N,N,-,-1,-1
THIRTY.txt,425163,426768,1605,10,N,N,-,-1,-1
THIRTY.txt,425293,426881,1588,10,Y,N,-,-1,-1
THIRTY.txt,425562,427074,1512,10,Y,N,-,-1,-1
THIRTY.txt,425624,427212,1588,10,N,N,-,-1,-1
THIRTY.txt,425893,427345,1452,10,N,N,-,-1,-1
THIRTY.txt,425950,427550,1600,10,N,Y,1448314706721,180385,181191
THIRTY.txt,426256,427794,1538,10,N,Y,1448314706721,180385,181191
THIRTY.txt,426378,427979,1601,10,N,Y,1448314706721,180385,181191
THIRTY.txt,426491,428144,1653,10,N,Y,1448314706721,180385,181191
THIRTY.txt,426688,428365,1677,10,N,Y,1448314706721,180385,181191
THIRTY.txt,426769,428624,1855,10,N,Y,1448314706721,180385,181191
THIRTY.txt,426882,428829,1947,10,N,Y,1448314706721,180385,181191
THIRTY.txt,427075,429050,1975,10,N,Y,1448314706721,180385,181191
THIRTY.txt,427213,429420,2207,10,N,Y,1448314706721,180385,181191
THIRTY.txt,427348,429567,2219,10,N,Y,1448314706721,180385,181191
THIRTY.txt,427552,429892,2340,10,N,Y,1448314706721,180385,181191
THIRTY.txt,427795,430111,2316,10,N,Y,1448314706721,180385,181191
THIRTY.txt,427980,430278,2298,10,N,Y,1448314706721,180385,181191
THIRTY.txt,428147,430435,2288,10,N,N,-,-1,-1
THIRTY.txt,428366,430771,2405,10,N,N,-,-1,-1
THIRTY.txt,428627,430932,2305,10,N,N,-,-1,-1
THIRTY.txt,428830,431123,2293,10,N,N,-,-1,-1
THIRTY.txt,429051,431636,2585,10,N,N,-,-1,-1
THIRTY.txt,429423,431688,2265,10,N,N,-,-1,-1
THIRTY.txt,429568,432243,2675,10,N,N,-,-1,-1
THIRTY.txt,429893,432393,2500,10,N,N,-,-1,-1
THIRTY.txt,430112,432540,2428,10,N,N,-,-1,-1
THIRTY.txt,430279,432667,2388,10,N,N,-,-1,-1
THIRTY.txt,430437,432801,2364,10,N,N,-,-1,-1
THIRTY.txt,430772,432847,2075,10,N,N,-,-1,-1
THIRTY.txt,430934,433196,2262,10,N,N,-,-1,-1
THIRTY.txt,431126,433610,2484,10,N,N,-,-1,-1
THIRTY.txt,431637,433754,2117,10,N,N,-,-1,-1
THIRTY.txt,431689,433962,2273,10,N,N,-,-1,-1
THIRTY.txt,432244,434175,1931,10,N,N,-,-1,-1
THIRTY.txt,432394,434274,1880,10,N,N,-,-1,-1
THIRTY.txt,432541,434462,1921,10,N,N,-,-1,-1
THIRTY.txt,432668,434565,1897,10,N,N,-,-1,-1
THIRTY.txt,432804,434814,2010,10,N,N,-,-1,-1
THIRTY.txt,432852,435063,2211,10,N,N,-,-1,-1
THIRTY.txt,433197,435196,1999,10,N,N,-,-1,-1
THIRTY.txt,433611,435466,1855,10,N,N,-,-1,-1
THIRTY.txt,433755,435757,2002,10,N,N,-,-1,-1
THIRTY.txt,433963,435822,1859,10,N,N,-,-1,-1
THIRTY.txt,434178,435908,1730,10,N,Y,1448286880729,112151,113274
THIRTY.txt,434276,435986,1710,10,N,Y,1448286880729,112151,113274
THIRTY.txt,434463,436245,1782,10,N,Y,1448286880729,112151,113274
THIRTY.txt,434567,436528,1961,10,N,Y,1448286880729,112151,113274
THIRTY.txt,434815,436736,1921,10,N,Y,1448286880729,112151,113274
THIRTY.txt,435065,436916,1851,10,N,Y,1448286880729,112151,113274
THIRTY.txt,435199,437118,1919,10,N,Y,1448286880729,112151,113274
THIRTY.txt,435467,437304,1837,10,N,Y,1448286880729,112151,113274
THIRTY.txt,435758,437531,1773,10,N,Y,1448286880729,112151,113274
THIRTY.txt,435825,437705,1880,10,N,Y,1448286880729,112151,113274
THIRTY.txt,435909,437906,1997,10,Y,Y,1448286880729,112151,113274
THIRTY.txt,435987,438131,2144,10,Y,Y,1448286880729,112151,113274
THIRTY.txt,436246,438227,1981,10,Y,Y,1448286880729,112151,113274
THIRTY.txt,436531,438321,1790,10,Y,Y,1448286880729,112151,113274
THIRTY.txt,436737,438444,1707,10,Y,Y,1448286880729,112151,113274
THIRTY.txt,436917,438631,1714,10,Y,Y,1448286880729,112151,113274
THIRTY.txt,437119,438786,1667,10,Y,Y,1448358276684,234999,235995
THIRTY.txt,437305,438989,1684,10,Y,Y,1448358276684,234999,235995
THIRTY.txt,437532,439207,1675,10,Y,Y,1448038803075,18895,19670
THIRTY.txt,437708,439318,1610,10,N,Y,1448038803075,18895,19670
THIRTY.txt,437907,439347,1440,10,N,Y,1448038803075,18895,19670
THIRTY.txt,438133,439449,1316,10,N,Y,1448038803075,18895,19670
THIRTY.txt,438229,439627,1398,10,N,Y,1448038803075,18895,19670
THIRTY.txt,438322,439771,1449,10,N,Y,1448038803075,18895,19670
THIRTY.txt,438445,440078,1633,10,N,Y,1448038803075,18895,19670
THIRTY.txt,438632,440267,1635,10,N,Y,1448038803075,18895,19670
THIRTY.txt,438787,440368,1581,10,N,Y,1448038803075,18895,19670
THIRTY.txt,438992,440432,1440,10,N,Y,1448038803075,18895,19670
THIRTY.txt,439207,440531,1324,10,N,Y,1448038803075,18895,19670
THIRTY.txt,439320,440571,1251,10,N,Y,1448038803075,18895,19670
THIRTY.txt,439348,440993,1645,10,N,Y,1448038803075,18895,19670
THIRTY.txt,439450,441195,1745,10,N,Y,1448038803075,18895,19670
THIRTY.txt,439628,441510,1882,10,N,Y,1448038803075,18895,19670
THIRTY.txt,439772,441733,1961,10,N,Y,1448038803075,18895,19670
THIRTY.txt,440079,441999,1920,10,N,Y,1448038803075,18895,19670
THIRTY.txt,440268,442072,1804,10,N,Y,1448038803075,18895,19670
THIRTY.txt,440369,442218,1849,10,N,Y,1448038803075,18895,19670
THIRTY.txt,440433,442452,2019,10,N,Y,1448038803075,18895,19670
THIRTY.txt,440534,442645,2111,10,N,N,-,-1,-1
THIRTY.txt,440572,442789,2217,10,N,N,-,-1,-1
THIRTY.txt,440994,442941,1947,10,N,N,-,-1,-1
THIRTY.txt,441196,443164,1968,10,N,N,-,-1,-1
THIRTY.txt,441511,443218,1707,10,N,N,-,-1,-1
THIRTY.txt,441734,443343,1609,10,N,N,-,-1,-1
THIRTY.txt,442000,443485,1485,10,N,N,-,-1,-1
THIRTY.txt,442075,443805,1730,10,Y,N,-,-1,-1
THIRTY.txt,442219,443928,1709,10,Y,N,-,-1,-1
THIRTY.txt,442454,444086,1632,10,Y,N,-,-1,-1
THIRTY.txt,442646,444119,1473,10,Y,N,-,-1,-1
THIRTY.txt,442790,444354,1564,10,Y,N,-,-1,-1
THIRTY.txt,442943,444481,1538,10,N,N,-,-1,-1
THIRTY.txt,443167,444699,1532,10,N,N,-,-1,-1
THIRTY.txt,443219,444784,1565,10,N,N,-,-1,-1
THIRTY.txt,443344,445070,1726,10,N,N,-,-1,-1
THIRTY.txt,443486,445157,1671,10,N,N,-,-1,-1
THIRTY.txt,443806,445413,1607,10,N,N,-,-1,-1
THIRTY.txt,443929,445477,1548,10,N,N,-,-1,-1
THIRTY.txt,444087,445559,1472,10,N,N,-,-1,-1
THIRTY.txt,444120,445586,1466,10,N,N,-,-1,-1
THIRTY.txt,444355,445617,1262,10,N,N,-,-1,-1
THIRTY.txt,444484,445787,1303,10,N,N,-,-1,-1
THIRTY.txt,444700,445840,1140,10,N,N,-,-1,-1
THIRTY.txt,444785,445868,1083,10,N,N,-,-1,-1
THIRTY.txt,445073,445961,888,10,N,N,-,-1,-1
THIRTY.txt,445158,446005,847,10,N,N,-,-1,-1
THIRTY.txt,445414,446164,750,10,N,N,-,-1,-1
THIRTY.txt,445478,446250,772,10,N,N,-,-1,-1
THIRTY.txt,445562,446362,800,10,N,N,-,-1,-1
THIRTY.txt,445587,446548,961,10,N,N,-,-1,-1
THIRTY.txt,445618,446706,1088,10,N,N,-,-1,-1
THIRTY.txt,445788,446887,1099,10,N,N,-,-1,-1
THIRTY.txt,445841,446958,1117,10,N,N,-,-1,-1
THIRTY.txt,445869,447076,1207,10,N,Y,1448366492754,275659,275884
THIRTY.txt,445963,447163,1200,10,N,Y,1448366492754,275659,275884
THIRTY.txt,446008,447334,1326,10,N,Y,1448366492754,275659,275884
THIRTY.txt,446165,447388,1223,10,N,Y,1448366492754,275659,275884
THIRTY.txt,446251,447664,1413,10,N,Y,1448366492754,275659,275884
THIRTY.txt,446363,447836,1473,10,N,Y,1448366492754,275659,275884
THIRTY.txt,446549,447928,1379,10,N,Y,1448366492754,275659,275884
THIRTY.txt,446707,448164,1457,10,N,Y,1448366492754,275659,275884
THIRTY.txt,446888,448296,1408,10,N,Y,1448366492754,275659,275884
THIRTY.txt,446961,448434,1473,10,N,Y,1448366492754,275659,275884
THIRTY.txt,447077,448585,1508,10,N,Y,1448366492754,275659,275884
THIRTY.txt,447164,448795,1631,10,N,Y,1448316586529,210063,210674
THIRTY.txt,447335,448867,1532,10,N,Y,1448316586529,210063,210674
THIRTY.txt,447389,449091,1702,10,N,Y,1448316586529,210063,210674
THIRTY.txt,447665,449268,1603,10,N,Y,1448316586529,210063,210674
THIRTY.txt,447837,449365,1528,10,N,Y,1448316586529,210063,210674
THIRTY.txt,447929,449773,1844,10,N,Y,1448316586529,210063,210674
THIRTY.txt,448165,449959,1794,10,N,Y,1448316586529,210063,210674
THIRTY.txt,448301,450306,2005,10,N,Y,1448316586529,210063,210674
THIRTY.txt,448435,450333,1898,10,N,Y,1448316586529,210063,210674
THIRTY.txt,448586,450616,2030,10,N,Y,1448316586529,210063,210674
THIRTY.txt,448796,450693,1897,10,N,Y,1448316586529,210063,210674
THIRTY.txt,448868,450826,1958,10,N,Y,1448316586529,210063,210674
THIRTY.txt,449092,451174,2082,10,N,Y,1448316586529,210063,210674
THIRTY.txt,449269,451315,2046,10,N,Y,1448316586529,210063,210674
THIRTY.txt,449368,451439,2071,10,N,Y,1448316586529,210063,210674
THIRTY.txt,449774,451576,1802,10,N,Y,1448316586529,210063,210674
THIRTY.txt,449960,451760,1800,10,N,N,-,-1,-1
THIRTY.txt,450309,451795,1486,10,N,N,-,-1,-1
THIRTY.txt,450334,451876,1542,10,N,N,-,-1,-1
THIRTY.txt,450617,451957,1340,10,N,N,-,-1,-1
THIRTY.txt,450695,452074,1379,10,N,N,-,-1,-1
THIRTY.txt,450827,452215,1388,10,N,N,-,-1,-1
THIRTY.txt,451175,452387,1212,10,N,N,-,-1,-1
THIRTY.txt,451316,452566,1250,10,N,N,-,-1,-1
THIRTY.txt,451440,452631,1191,10,N,N,-,-1,-1
THIRTY.txt,451577,452817,1240,10,N,N,-,-1,-1
THIRTY.txt,451761,452891,1130,10,N,N,-,-1,-1
THIRTY.txt,451796,452894,1098,10,N,N,-,-1,-1
THIRTY.txt,451879,453145,1266,10,N,N,-,-1,-1
THIRTY.txt,451960,453310,1350,10,N,N,-,-1,-1
THIRTY.txt,452075,453419,1344,10,N,N,-,-1,-1
THIRTY.txt,452216,453480,1264,10,N,N,-,-1,-1
THIRTY.txt,452388,453615,1227,10,N,N,-,-1,-1
THIRTY.txt,452567,453657,1090,10,N,N,-,-1,-1
THIRTY.txt,452633,453680,1047,10,N,N,-,-1,-1
THIRTY.txt,452818,453703,885,10,N,N,-,-1,-1
THIRTY.txt,452893,453711,818,10,N,N,-,-1,-1
THIRTY.txt,452894,453921,1027,10,N,N,-,-1,-1
THIRTY.txt,453147,454186,1039,10,N,N,-,-1,-1
THIRTY.txt,453313,454486,1173,10,N,N,-,-1,-1
THIRTY.txt,453420,454585,1165,10,N,N,-,-1,-1
THIRTY.txt,453481,454727,1246,10,N,N,-,-1,-1
THIRTY.txt,453616,454884,1268,10,N,N,-,-1,-1
THIRTY.txt,453658,455086,1428,10,N,N,-,-1,-1
THIRTY.txt,453681,455401,1720,10,Y,N,-,-1,-1
THIRTY.txt,453706,455434,1728,10,Y,N,-,-1,-1
THIRTY.txt,453714,455734,2020,10,Y,N,-,-1,-1
THIRTY.txt,453922,456103,2181,10,Y,N,-,-1,-1
THIRTY.txt,454187,456208,2021,10,Y,N,-,-1,-1
THIRTY.txt,454487,456352,1865,10,Y,N,-,-1,-1
THIRTY.txt,454586,456595,2009,10,Y,N,-,-1,-1
THIRTY.txt,454728,456977,2249,10,Y,N,-,-1,-1
THIRTY.txt,454885,457147,2262,10,Y,N,-,-1,-1
THIRTY.txt,455091,457393,2302,10,N,Y,1448279941918,72406,72905
THIRTY.txt,455404,457773,2369,10,Y,Y,1448279941918,72406,72905
THIRTY.txt,455435,457842,2407,10,Y,Y,1448279941918,72406,72905
THIRTY.txt,455735,458068,2333,10,Y,Y,1448279941918,72406,72905
THIRTY.txt,456106,458204,2098,10,Y,Y,1448279941918,72406,72905
THIRTY.txt,456209,458342,2133,10,Y,Y,1448279941918,72406,72905
THIRTY.txt,456353,458539,2186,10,Y,Y,1448279941918,72406,72905
THIRTY.txt,456596,458701,2105,10,Y,Y,1448279941918,72406,72905
THIRTY.txt,456979,458982,2003,10,Y,Y,1448279941918,72406,72905
THIRTY.txt,457148,459210,2062,10,Y,Y,1448279941918,72406,72905
THIRTY.txt,457394,459335,1941,10,Y,Y,1448279941918,72406,72905
THIRTY.txt,457774,459616,1842,10,Y,Y,1448279941918,72406,72905
THIRTY.txt,457843,459737,1894,10,Y,Y,1448279941918,72406,72905
THIRTY.txt,458069,460425,2356,10,Y,Y,1448279941918,72406,72905
THIRTY.txt,458209,460677,2468,10,N,N,-,-1,-1
THIRTY.txt,458343,460903,2560,10,Y,N,-,-1,-1
THIRTY.txt,458540,461041,2501,10,N,N,-,-1,-1
THIRTY.txt,458701,461208,2507,10,N,N,-,-1,-1
THIRTY.txt,458983,461587,2604,10,N,N,-,-1,-1
THIRTY.txt,459211,461787,2576,10,N,N,-,-1,-1
THIRTY.txt,459336,462030,2694,10,N,N,-,-1,-1
THIRTY.txt,459617,462170,2553,10,N,N,-,-1,-1
THIRTY.txt,459738,462624,2886,10,N,N,-,-1,-1
THIRTY.txt,460428,462848,2420,10,N,N,-,-1,-1
THIRTY.txt,460678,462932,2254,10,N,N,-,-1,-1
THIRTY.txt,460904,463130,2226,10,N,N,-,-1,-1
THIRTY.txt,461042,463334,2292,10,N,N,-,-1,-1
THIRTY.txt,461208,463609,2401,10,N,N,-,-1,-1
THIRTY.txt,461588,463693,2105,10,N,N,-,-1,-1
THIRTY.txt,461788,463976,2188,10,N,N,-,-1,-1
THIRTY.txt,462031,464172,2141,10,N,Y,1437028092146,121457,123204
THIRTY.txt,462170,464178,2008,10,N,Y,1437028092146,121457,123204
THIRTY.txt,462625,464231,1606,10,N,Y,1437028092146,121457,123204
THIRTY.txt,462849,464367,1518,10,N,Y,1437028092146,121457,123204
THIRTY.txt,462933,464443,1510,10,N,Y,1437028092146,121457,123204
THIRTY.txt,463131,464703,1572,10,N,Y,1437028092146,121457,123204
THIRTY.txt,463335,464828,1493,10,N,Y,1437028092146,121457,123204
THIRTY.txt,463610,464941,1331,10,N,Y,1437028092146,121457,123204
THIRTY.txt,463694,464993,1299,10,N,Y,1437028092146,121457,123204
THIRTY.txt,463977,465257,1280,10,N,Y,1437028092146,121457,123204
THIRTY.txt,464173,465436,1263,10,N,Y,1437028092146,121457,123204
THIRTY.txt,464179,465772,1593,10,Y,Y,1437028092146,121457,123204
THIRTY.txt,464232,465840,1608,10,Y,Y,1437028092146,121457,123204
THIRTY.txt,464368,466140,1772,10,Y,Y,1437028092146,121457,123204
THIRTY.txt,464445,466397,1952,10,Y,Y,1437028092146,121457,123204
THIRTY.txt,464704,466673,1969,10,Y,N,-,-1,-1
THIRTY.txt,464833,466934,2101,10,Y,N,-,-1,-1
THIRTY.txt,464944,467021,2077,10,Y,N,-,-1,-1
THIRTY.txt,464994,467095,2101,10,Y,N,-,-1,-1
THIRTY.txt,465258,467136,1878,10,N,N,-,-1,-1
THIRTY.txt,465437,467357,1920,10,N,N,-,-1,-1
THIRTY.txt,465774,467621,1847,10,N,N,-,-1,-1
THIRTY.txt,465843,467693,1850,10,N,N,-,-1,-1
THIRTY.txt,466141,467823,1682,10,N,N,-,-1,-1
THIRTY.txt,466398,468152,1754,10,Y,N,-,-1,-1
THIRTY.txt,466674,468306,1632,10,Y,N,-,-1,-1
THIRTY.txt,466937,468440,1503,10,N,N,-,-1,-1
THIRTY.txt,467022,468569,1547,10,Y,N,-,-1,-1
THIRTY.txt,467096,468908,1812,10,Y,N,-,-1,-1
THIRTY.txt,467138,469121,1983,10,Y,N,-,-1,-1
THIRTY.txt,467358,469197,1839,10,Y,N,-,-1,-1
THIRTY.txt,467622,469460,1838,10,Y,N,-,-1,-1
THIRTY.txt,467694,469639,1945,10,Y,N,-,-1,-1
THIRTY.txt,467824,469803,1979,10,Y,N,-,-1,-1
THIRTY.txt,468155,469927,1772,10,N,N,-,-1,-1
THIRTY.txt,468307,470156,1849,10,N,N,-,-1,-1
THIRTY.txt,468441,470291,1850,10,Y,N,-,-1,-1
THIRTY.txt,468570,470315,1745,10,N,N,-,-1,-1
THIRTY.txt,468909,470423,1514,10,Y,N,-,-1,-1
THIRTY.txt,469124,470657,1533,10,N,N,-,-1,-1
THIRTY.txt,469198,470723,1525,10,N,N,-,-1,-1
THIRTY.txt,469461,470857,1396,10,Y,N,-,-1,-1
THIRTY.txt,469640,470934,1294,10,Y,N,-,-1,-1
THIRTY.txt,469804,471243,1439,10,Y,N,-,-1,-1
THIRTY.txt,469928,471494,1566,10,Y,N,-,-1,-1
THIRTY.txt,470157,471659,1502,10,Y,N,-,-1,-1
THIRTY.txt,470293,471717,1424,10,Y,N,-,-1,-1
THIRTY.txt,470316,471758,1442,10,Y,Y,1448274783410,21836,25159
THIRTY.txt,470424,471869,1445,10,N,Y,1448274783410,21836,25159
THIRTY.txt,470658,472011,1353,10,N,Y,1448274783410,21836,25159
THIRTY.txt,470726,472170,1444,10,Y,Y,1448274783410,21836,25159
THIRTY.txt,470858,472442,1584,10,Y,Y,1448274783410,21836,25159
THIRTY.txt,470935,472820,1885,10,N,Y,1448274783410,21836,25159
THIRTY.txt,471244,472890,1646,10,N,Y,1448275023016,26258,26837
THIRTY.txt,471496,473144,1648,10,N,Y,1448275023016,26258,26837
THIRTY.txt,471660,473443,1783,10,N,Y,1448275023016,26258,26837
THIRTY.txt,471720,473588,1868,10,N,Y,1448275023016,26258,26837
THIRTY.txt,471759,473666,1907,10,N,Y,1448275023016,26258,26837
THIRTY.txt,471870,473773,1903,10,N,Y,1448275023016,26258,26837
THIRTY.txt,472012,474104,2092,10,N,Y,1448275023016,26258,26837
THIRTY.txt,472171,474254,2083,10,N,Y,1448275023016,26258,26837
THIRTY.txt,472443,474381,1938,10,N,Y,1448275023016,26258,26837
THIRTY.txt,472823,474564,1741,10,N,Y,1448275023016,26258,26837
THIRTY.txt,472891,474690,1799,10,N,Y,1448275023016,26258,26837
THIRTY.txt,473145,474864,1719,10,N,Y,1448275023016,26258,26837
THIRTY.txt,473444,474911,1467,10,N,Y,1448275023016,26258,26837
THIRTY.txt,473589,475069,1480,10,N,Y,1448275023016,26258,26837
THIRTY.txt,473667,475176,1509,10,N,Y,1448275023016,26258,26837
THIRTY.txt,473774,475239,1465,10,N,Y,1448275023016,26258,26837
THIRTY.txt,474107,475415,1308,10,N,Y,1448312968013,174511,175025
THIRTY.txt,474255,475482,1227,10,N,Y,1448312968013,174511,175025
THIRTY.txt,474382,475613,1231,10,N,Y,1448312968013,174511,175025
THIRTY.txt,474565,475668,1103,10,N,Y,1448312968013,174511,175025
THIRTY.txt,474691,475922,1231,10,N,Y,1448312968013,174511,175025
THIRTY.txt,474865,476070,1205,10,N,Y,1448312968013,174511,175025
THIRTY.txt,474912,476295,1383,10,N,Y,1448312968013,174511,175025
THIRTY.txt,475070,476543,1473,10,N,Y,1448312968013,174511,175025
THIRTY.txt,475177,476658,1481,10,N,Y,1448312968013,174511,175025
THIRTY.txt,475240,476725,1485,10,N,Y,1448312968013,174511,175025
THIRTY.txt,475416,476939,1523,10,N,Y,1448312968013,174511,175025
THIRTY.txt,475483,477162,1679,10,N,Y,1448312968013,174511,175025
THIRTY.txt,475613,477326,1713,10,N,N,-,-1,-1
THIRTY.txt,475669,477505,1836,10,N,N,-,-1,-1
THIRTY.txt,475923,477666,1743,10,N,N,-,-1,-1
THIRTY.txt,476071,477832,1761,10,N,N,-,-1,-1
THIRTY.txt,476296,477966,1670,10,N,N,-,-1,-1
THIRTY.txt,476544,478102,1558,10,N,N,-,-1,-1
THIRTY.txt,476659,478196,1537,10,N,N,-,-1,-1
THIRTY.txt,476726,478308,1582,10,N,N,-,-1,-1
THIRTY.txt,476940,478395,1455,10,N,N,-,-1,-1
THIRTY.txt,477163,478769,1606,10,N,N,-,-1,-1
THIRTY.txt,477327,478884,1557,10,N,N,-,-1,-1
THIRTY.txt,477506,479108,1602,10,N,Y,1448314861876,180438,180657
THIRTY.txt,477671,479159,1488,10,N,Y,1448314861876,180438,180657
THIRTY.txt,477833,479227,1394,10,N,Y,1448314861876,180438,180657
THIRTY.txt,477967,479239,1272,10,N,Y,1448314861876,180438,180657
THIRTY.txt,478104,479479,1375,10,Y,Y,1448314861876,180438,180657
THIRTY.txt,478197,479615,1418,10,Y,Y,1448314861876,180438,180657
THIRTY.txt,478309,479718,1409,10,Y,Y,1448314861876,180438,180657
THIRTY.txt,478398,479855,1457,10,Y,Y,1448314861876,180438,180657
THIRTY.txt,478770,479982,1212,10,N,Y,1448314861876,180438,180657
THIRTY.txt,478887,480114,1227,10,N,Y,1448314861876,180438,180657
THIRTY.txt,479109,480158,1049,10,N,Y,1448314861876,180438,180657
THIRTY.txt,479160,480299,1139,10,N,Y,1448314861876,180438,180657
THIRTY.txt,479228,480418,1190,10,N,Y,1448314861876,180438,180657
THIRTY.txt,479244,480433,1189,10,N,Y,1448314861876,180438,180657
THIRTY.txt,479480,480476,996,10,N,Y,1448314861876,180438,180657
THIRTY.txt,479616,480675,1059,10,N,Y,1448314861876,180438,180657
THIRTY.txt,479719,480835,1116,10,N,Y,1448314861876,180438,180657
THIRTY.txt,479856,481052,1196,10,N,Y,1448314861876,180438,180657
THIRTY.txt,479983,481231,1248,10,N,Y,1448314861876,180438,180657
THIRTY.txt,480115,481357,1242,10,N,Y,1448314861876,180438,180657
THIRTY.txt,480161,481485,1324,10,N,Y,1448314861876,180438,180657
THIRTY.txt,480300,481674,1374,10,N,Y,1448314861876,180438,180657
THIRTY.txt,480419,481856,1437,10,N,Y,1448314861876,180438,180657
THIRTY.txt,480434,481992,1558,10,N,Y,1448314861876,180438,180657
THIRTY.txt,480479,482315,1836,10,N,Y,1448314861876,180438,180657
THIRTY.txt,480677,482491,1814,10,N,Y,1448314861876,180438,180657
THIRTY.txt,480836,482718,1882,10,N,Y,1448395538701,294934,295016
THIRTY.txt,481053,482782,1729,10,N,Y,1448395538701,294934,295016
THIRTY.txt,481234,483099,1865,10,N,Y,1448395538701,294934,295016
THIRTY.txt,481358,483292,1934,10,N,Y,1448395538701,294934,295016
THIRTY.txt,481486,483555,2069,10,Y,Y,1448395538701,294934,295016
THIRTY.txt,481676,483617,1941,10,Y,Y,1448395538701,294934,295016
THIRTY.txt,481857,484039,2182,10,Y,Y,1448395538701,294934,295016
THIRTY.txt,481993,484275,2282,10,Y,Y,1448314192885,179720,179950
THIRTY.txt,482316,484336,2020,10,N,Y,1448314192885,179720,179950
THIRTY.txt,482494,484608,2114,10,N,Y,1448314192885,179720,179950
THIRTY.txt,482719,484676,1957,10,N,Y,1448037533268,13930,15031
THIRTY.txt,482783,484830,2047,10,N,Y,1448037533268,13930,15031
THIRTY.txt,483100,485103,2003,10,N,Y,1448037533268,13930,15031
THIRTY.txt,483293,485320,2027,10,N,Y,1448037533268,13930,15031
THIRTY.txt,483556,485502,1946,10,N,Y,1448037533268,13930,15031
THIRTY.txt,483620,485575,1955,10,N,Y,1448037533268,13930,15031
THIRTY.txt,484040,485955,1915,10,N,Y,1448037533268,13930,15031
THIRTY.txt,484276,486074,1798,10,N,Y,1448037533268,13930,15031
THIRTY.txt,484337,486465,2128,10,N,Y,1448037533268,13930,15031
THIRTY.txt,484611,486604,1993,10,N,Y,1448037533268,13930,15031
THIRTY.txt,484677,486644,1967,10,N,Y,1448037533268,13930,15031
THIRTY.txt,484831,486889,2058,10,Y,Y,1448037533268,13930,15031
THIRTY.txt,485104,487015,1911,10,Y,Y,1448037533268,13930,15031
THIRTY.txt,485322,487271,1949,10,N,Y,1448037533268,13930,15031
THIRTY.txt,485503,487472,1969,10,N,Y,1448037533268,13930,15031
THIRTY.txt,485578,487639,2061,10,N,N,-,-1,-1
THIRTY.txt,485956,487748,1792,10,N,N,-,-1,-1
THIRTY.txt,486079,487861,1782,10,N,N,-,-1,-1
THIRTY.txt,486468,487907,1439,10,N,N,-,-1,-1
THIRTY.txt,486606,488063,1457,10,N,N,-,-1,-1
THIRTY.txt,486645,488339,1694,10,N,N,-,-1,-1
THIRTY.txt,486890,488475,1585,10,N,N,-,-1,-1
THIRTY.txt,487016,488702,1686,10,N,N,-,-1,-1
THIRTY.txt,487272,488778,1506,10,N,N,-,-1,-1
THIRTY.txt,487475,488896,1421,10,N,N,-,-1,-1
THIRTY.txt,487641,488994,1353,10,N,Y,1448274893770,25386,26202
THIRTY.txt,487749,488995,1246,10,N,Y,1448274893770,25386,26202
THIRTY.txt,487862,489125,1263,10,N,Y,1448274893770,25386,26202
THIRTY.txt,487908,489263,1355,10,N,Y,1448274893770,25386,26202
THIRTY.txt,488064,489451,1387,10,N,Y,1448274893770,25386,26202
THIRTY.txt,488342,489550,1208,10,N,Y,1448274893770,25386,26202
THIRTY.txt,488476,489639,1163,10,N,Y,1448274893770,25386,26202
THIRTY.txt,488703,489691,988,10,N,Y,1448274893770,25386,26202
THIRTY.txt,488779,489770,991,10,N,Y,1448274893770,25386,26202
THIRTY.txt,488898,490002,1104,10,N,Y,1448274893770,25386,26202
THIRTY.txt,488994,490243,1249,10,N,Y,1448274893770,25386,26202
THIRTY.txt,488996,490368,1372,10,N,Y,1448274893770,25386,26202
THIRTY.txt,489126,490486,1360,10,N,Y,1448274893770,25386,26202
THIRTY.txt,489264,490868,1604,10,N,Y,1448274893770,25386,26202
THIRTY.txt,489452,490896,1444,10,N,Y,1448274893770,25386,26202
THIRTY.txt,489551,490954,1403,10,N,Y,1448274893770,25386,26202
THIRTY.txt,489640,491244,1604,10,N,Y,1448274893770,25386,26202
THIRTY.txt,489694,491312,1618,10,N,Y,1448039123601,19678,19935
THIRTY.txt,489771,491700,1929,10,Y,Y,1448039123601,19678,19935
THIRTY.txt,490003,491999,1996,10,Y,Y,1448039123601,19678,19935
THIRTY.txt,490244,492151,1907,10,Y,Y,1448039123601,19678,19935
THIRTY.txt,490369,492352,1983,10,Y,Y,1448039123601,19678,19935
THIRTY.txt,490488,492524,2036,10,Y,Y,1448039123601,19678,19935
THIRTY.txt,490869,492558,1689,10,Y,Y,1448039123601,19678,19935
THIRTY.txt,490897,492704,1807,10,Y,Y,1448039123601,19678,19935
THIRTY.txt,490955,492788,1833,10,Y,Y,1448039123601,19678,19935
THIRTY.txt,491247,492976,1729,10,Y,Y,1448039123601,19678,19935
THIRTY.txt,491313,493084,1771,10,Y,Y,1448039123601,19678,19935
THIRTY.txt,491701,493175,1474,10,N,Y,1448039123601,19678,19935
THIRTY.txt,492000,493376,1376,10,N,Y,1448039123601,19678,19935
THIRTY.txt,492156,493495,1339,10,N,N,-,-1,-1
THIRTY.txt,492355,493578,1223,10,N,N,-,-1,-1
THIRTY.txt,492525,493637,1112,10,N,N,-,-1,-1
THIRTY.txt,492559,493671,1112,10,N,N,-,-1,-1
THIRTY.txt,492706,493894,1188,10,N,N,-,-1,-1
THIRTY.txt,492789,494000,1211,10,N,N,-,-1,-1
THIRTY.txt,492977,494106,1129,10,N,N,-,-1,-1
THIRTY.txt,493085,494374,1289,10,N,N,-,-1,-1
THIRTY.txt,493176,494432,1256,10,N,N,-,-1,-1
THIRTY.txt,493377,494526,1149,10,N,N,-,-1,-1
THIRTY.txt,493496,494663,1167,10,N,N,-,-1,-1
THIRTY.txt,493581,494793,1212,10,N,N,-,-1,-1
THIRTY.txt,493638,494994,1356,10,N,N,-,-1,-1
THIRTY.txt,493672,495135,1463,10,N,N,-,-1,-1
THIRTY.txt,493895,495384,1489,10,N,N,-,-1,-1
THIRTY.txt,494001,495600,1599,10,N,N,-,-1,-1
THIRTY.txt,494107,495688,1581,10,N,N,-,-1,-1
THIRTY.txt,494375,495810,1435,10,N,N,-,-1,-1
THIRTY.txt,494433,495992,1559,10,N,N,-,-1,-1
THIRTY.txt,494527,496176,1649,10,N,N,-,-1,-1
THIRTY.txt,494666,496403,1737,10,N,N,-,-1,-1
THIRTY.txt,494794,496867,2073,10,N,N,-,-1,-1
THIRTY.txt,494995,497119,2124,10,N,N,-,-1,-1
THIRTY.txt,495136,497168,2032,10,N,N,-,-1,-1
THIRTY.txt,495384,497305,1921,10,N,N,-,-1,-1
THIRTY.txt,495601,497394,1793,10,N,N,-,-1,-1
THIRTY.txt,495689,497706,2017,10,N,N,-,-1,-1
THIRTY.txt,495811,497751,1940,10,N,N,-,-1,-1
THIRTY.txt,495993,497976,1983,10,N,N,-,-1,-1
THIRTY.txt,496178,498230,2052,10,N,N,-,-1,-1
THIRTY.txt,496404,498429,2025,10,N,N,-,-1,-1
THIRTY.txt,496868,498648,1780,10,N,N,-,-1,-1
THIRTY.txt,497120,498851,1731,10,N,N,-,-1,-1
THIRTY.txt,497169,498907,1738,10,N,Y,1448277167610,40886,47737
THIRTY.txt,497308,499079,1771,10,N,Y,1448277167610,40886,47737
THIRTY.txt,497395,499175,1780,10,N,Y,1448277167610,40886,47737
THIRTY.txt,497708,499363,1655,10,N,Y,1448277167610,40886,47737
THIRTY.txt,497752,499555,1803,10,N,Y,1448277167610,40886,47737
THIRTY.txt,497977,499748,1771,10,N,Y,1448277167610,40886,47737
THIRTY.txt,498231,500148,1917,10,N,Y,1448277167610,40886,47737
THIRTY.txt,498431,500336,1905,10,N,Y,1448277167610,40886,47737
THIRTY.txt,498649,500452,1803,10,N,Y,1448277167610,40886,47737
THIRTY.txt,498854,500728,1874,10,N,Y,1448277167610,40886,47737
THIRTY.txt,498908,500873,1965,10,N,Y,1448277167610,40886,47737
THIRTY.txt,499080,501129,2049,10,N,Y,1448277167610,40886,47737
THIRTY.txt,499176,501435,2259,10,N,Y,1448277167610,40886,47737
THIRTY.txt,499364,501676,2312,10,Y,Y,1448277167610,40886,47737
THIRTY.txt,499558,502195,2637,10,Y,Y,1448277167610,40886,47737
THIRTY.txt,499749,502359,2610,10,N,Y,1448277167610,40886,47737
THIRTY.txt,500149,502533,2384,10,N,Y,1448360140810,268069,269800
THIRTY.txt,500337,502796,2459,10,N,Y,1448360140810,268069,269800
THIRTY.txt,500453,503054,2601,10,N,Y,1448360140810,268069,269800
THIRTY.txt,500731,503206,2475,10,N,Y,1448360140810,268069,269800
THIRTY.txt,500874,503220,2346,10,N,Y,1448360140810,268069,269800
THIRTY.txt,501130,503347,2217,10,N,Y,1448360140810,268069,269800
THIRTY.txt,501436,503476,2040,10,N,Y,1448360140810,268069,269800
THIRTY.txt,501677,503693,2016,10,N,Y,1448360140810,268069,269800
THIRTY.txt,502198,503849,1651,10,N,N,-,-1,-1
THIRTY.txt,502360,504005,1645,10,N,N,-,-1,-1
THIRTY.txt,502534,504276,1742,10,N,N,-,-1,-1
THIRTY.txt,502798,504577,1779,10,Y,N,-,-1,-1
THIRTY.txt,503056,504828,1772,10,Y,N,-,-1,-1
THIRTY.txt,503206,504944,1738,10,N,N,-,-1,-1
THIRTY.txt,503221,505073,1852,10,N,N,-,-1,-1
THIRTY.txt,503348,505283,1935,10,N,Y,1448281491382,97818,98860
THIRTY.txt,503477,505454,1977,10,N,Y,1448281491382,97818,98860
THIRTY.txt,503696,505549,1853,10,N,Y,1448281491382,97818,98860
THIRTY.txt,503850,505681,1831,10,N,Y,1448281491382,97818,98860
THIRTY.txt,504006,505902,1896,10,N,Y,1448281491382,97818,98860
THIRTY.txt,504277,505921,1644,10,N,Y,1448281491382,97818,98860
THIRTY.txt,504578,506195,1617,10,N,Y,1448281491382,97818,98860
THIRTY.txt,504829,506278,1449,10,N,Y,1448281491382,97818,98860
THIRTY.txt,504945,506679,1734,10,N,Y,1448281491382,97818,98860
THIRTY.txt,505076,506755,1679,10,Y,Y,1448281491382,97818,98860
THIRTY.txt,505284,506885,1601,10,Y,Y,1448281491382,97818,98860
THIRTY.txt,505456,506950,1494,10,Y,Y,1448281491382,97818,98860
THIRTY.txt,505550,507184,1634,10,Y,Y,1448281491382,97818,98860
THIRTY.txt,505681,507328,1647,10,Y,Y,1448281491382,97818,98860
THIRTY.txt,505903,507677,1774,10,Y,Y,1448281491382,97818,98860
THIRTY.txt,505922,507739,1817,10,Y,Y,1448281491382,97818,98860
THIRTY.txt,506195,507856,1661,10,N,N,-,-1,-1
THIRTY.txt,506279,508106,1827,10,N,N,-,-1,-1
THIRTY.txt,506680,508204,1524,10,N,N,-,-1,-1
THIRTY.txt,506758,508290,1532,10,N,N,-,-1,-1
THIRTY.txt,506887,508323,1436,10,N,N,-,-1,-1
THIRTY.txt,506951,508628,1677,10,Y,N,-,-1,-1
THIRTY.txt,507186,508802,1616,10,Y,N,-,-1,-1
THIRTY.txt,507329,509103,1774,10,N,N,-,-1,-1
THIRTY.txt,507679,509266,1587,10,N,N,-,-1,-1
THIRTY.txt,507740,509493,1753,10,Y,N,-,-1,-1
THIRTY.txt,507859,509502,1643,10,Y,N,-,-1,-1
THIRTY.txt,508107,509745,1638,10,Y,N,-,-1,-1
THIRTY.txt,508206,509973,1767,10,Y,N,-,-1,-1
THIRTY.txt,508291,510466,2175,10,N,N,-,-1,-1
THIRTY.txt,508324,510699,2375,10,N,N,-,-1,-1
THIRTY.txt,508631,510813,2182,10,Y,N,-,-1,-1
THIRTY.txt,508803,511016,2213,10,Y,N,-,-1,-1
THIRTY.txt,509104,511039,1935,10,Y,N,-,-1,-1
THIRTY.txt,509267,511285,2018,10,Y,N,-,-1,-1
THIRTY.txt,509494,511640,2146,10,N,N,-,-1,-1
THIRTY.txt,509505,511875,2370,10,N,Y,1448315360596,182069,182233
THIRTY.txt,509746,511984,2238,10,N,Y,1448315360596,182069,182233
THIRTY.txt,509973,511998,2025,10,N,Y,1448315360596,182069,182233
THIRTY.txt,510467,512170,1703,10,N,Y,1448315360596,182069,182233
THIRTY.txt,510702,512242,1540,10,N,Y,1448315360596,182069,182233
THIRTY.txt,510814,512321,1507,10,N,Y,1448315360596,182069,182233
THIRTY.txt,511017,512446,1429,10,N,Y,1448315360596,182069,182233
THIRTY.txt,511040,512700,1660,10,N,Y,1448315360596,182069,182233
THIRTY.txt,511286,512787,1501,10,N,Y,1448315360596,182069,182233
THIRTY.txt,511641,512979,1338,10,N,Y,1448315360596,182069,182233
THIRTY.txt,511875,513152,1277,10,N,Y,1448315360596,182069,182233
THIRTY.txt,511985,513560,1575,10,N,Y,1448315360596,182069,182233
THIRTY.txt,512000,513799,1799,10,N,Y,1448315360596,182069,182233
THIRTY.txt,512173,514037,1864,10,N,Y,1448315360596,182069,182233
THIRTY.txt,512243,514089,1846,10,N,Y,1448315360596,182069,182233
THIRTY.txt,512323,514253,1930,10,Y,Y,1448315360596,182069,182233
THIRTY.txt,512447,514336,1889,10,Y,Y,1448315360596,182069,182233
THIRTY.txt,512701,514498,1797,10,Y,Y,1448315360596,182069,182233
THIRTY.txt,512788,514568,1780,10,Y,Y,1448315360596,182069,182233
THIRTY.txt,512982,514818,1836,10,Y,Y,1448315360596,182069,182233
THIRTY.txt,513153,514874,1721,10,Y,Y,1448315360596,182069,182233
THIRTY.txt,513562,515040,1478,10,Y,Y,1448315360596,182069,182233
THIRTY.txt,513800,515165,1365,10,N,Y,1448315360596,182069,182233
THIRTY.txt,514040,515284,1244,10,N,N,-,-1,-1
THIRTY.txt,514090,515496,1406,10,N,N,-,-1,-1
THIRTY.txt,514254,515565,1311,10,N,N,-,-1,-1
THIRTY.txt,514338,515641,1303,10,N,N,-,-1,-1
THIRTY.txt,514499,515899,1400,10,N,N,-,-1,-1
THIRTY.txt,514569,516064,1495,10,N,N,-,-1,-1
THIRTY.txt,514819,516187,1368,10,N,N,-,-1,-1
THIRTY.txt,514875,516490,1615,10,N,N,-,-1,-1
THIRTY.txt,515041,516652,1611,10,N,N,-,-1,-1
THIRTY.txt,515167,516805,1638,10,N,N,-,-1,-1
THIRTY.txt,515285,516981,1696,10,N,N,-,-1,-1
THIRTY.txt,515497,517087,1590,10,N,N,-,-1,-1
THIRTY.txt,515566,517334,1768,10,N,N,-,-1,-1
THIRTY.txt,515642,517579,1937,10,N,N,-,-1,-1
THIRTY.txt,515900,517603,1703,10,N,N,-,-1,-1
THIRTY.txt,516066,517750,1684,10,N,N,-,-1,-1
THIRTY.txt,516192,517840,1648,10,N,N,-,-1,-1
THIRTY.txt,516493,517960,1467,10,N,N,-,-1,-1
THIRTY.txt,516653,518145,1492,10,N,N,-,-1,-1
THIRTY.txt,516806,518248,1442,10,N,N,-,-1,-1
THIRTY.txt,516982,518342,1360,10,N,N,-,-1,-1
THIRTY.txt,517088,518610,1522,10,N,N,-,-1,-1
THIRTY.txt,517335,518800,1465,10,N,N,-,-1,-1
THIRTY.txt,517580,518942,1362,10,N,N,-,-1,-1
THIRTY.txt,517604,519015,1411,10,N,N,-,-1,-1
THIRTY.txt,517753,519274,1521,10,N,N,-,-1,-1
THIRTY.txt,517841,519368,1527,10,N,Y,1448038101349,15101,17486
THIRTY.txt,517962,519545,1583,10,N,Y,1448038101349,15101,17486
THIRTY.txt,518146,519717,1571,10,N,Y,1448038101349,15101,17486
THIRTY.txt,518250,519829,1579,10,N,Y,1448038101349,15101,17486
THIRTY.txt,518344,519966,1622,10,N,Y,1448038101349,15101,17486
THIRTY.txt,518611,520069,1458,10,N,Y,1448038101349,15101,17486
THIRTY.txt,518801,520354,1553,10,N,Y,1448038101349,15101,17486
THIRTY.txt,518947,520393,1446,10,N,Y,1448038101349,15101,17486
THIRTY.txt,519020,520419,1399,10,N,Y,1448038101349,15101,17486
THIRTY.txt,519275,520772,1497,10,N,Y,1448038101349,15101,17486
THIRTY.txt,519369,520963,1594,10,N,Y,1448038101349,15101,17486
THIRTY.txt,519547,521032,1485,10,N,Y,1448038101349,15101,17486
THIRTY.txt,519718,521154,1436,10,N,Y,1448038101349,15101,17486
THIRTY.txt,519830,521339,1509,10,N,N,-,-1,-1
THIRTY.txt,519967,521635,1668,10,N,N,-,-1,-1
THIRTY.txt,520070,521788,1718,10,N,N,-,-1,-1
THIRTY.txt,520355,522015,1660,10,N,N,-,-1,-1
THIRTY.txt,520394,522291,1897,10,N,N,-,-1,-1
THIRTY.txt,520420,522360,1940,10,N,Y,1437477480340,424837,425856
THIRTY.txt,520773,522470,1697,10,N,Y,1437477480340,424837,425856
THIRTY.txt,520966,522607,1641,10,N,Y,1437477480340,424837,425856
THIRTY.txt,521033,522805,1772,10,N,Y,1437477480340,424837,425856
THIRTY.txt,521155,523082,1927,10,N,Y,1437477480340,424837,425856
THIRTY.txt,521340,523158,1818,10,N,Y,1437477480340,424837,425856
THIRTY.txt,521636,523344,1708,10,N,Y,1437477480340,424837,425856
THIRTY.txt,521789,523808,2019,10,Y,Y,1437477480340,424837,425856
THIRTY.txt,522017,524082,2065,10,Y,Y,1437477480340,424837,425856
THIRTY.txt,522294,524166,1872,10,Y,Y,1437477480340,424837,425856
THIRTY.txt,522361,524496,2135,10,Y,Y,1437477480340,424837,425856
THIRTY.txt,522471,524720,2249,10,Y,Y,1437477480340,424837,425856
THIRTY.txt,522608,524869,2261,10,Y,Y,1437477480340,424837,425856
THIRTY.txt,522806,525101,2295,10,Y,Y,1437477480340,424837,425856
THIRTY.txt,523083,525334,2251,10,Y,Y,1437477480340,424837,425856
THIRTY.txt,523159,525598,2439,10,Y,Y,1437477480340,424837,425856
THIRTY.txt,523345,525929,2584,10,Y,Y,1448276340407,30017,39003
THIRTY.txt,523811,526036,2225,10,Y,Y,1448276340407,30017,39003
THIRTY.txt,524083,526234,2151,10,Y,Y,1448276340407,30017,39003
THIRTY.txt,524167,526324,2157,10,Y,Y,1448276340407,30017,39003
THIRTY.txt,524497,526621,2124,10,Y,Y,1448276340407,30017,39003
THIRTY.txt,524721,526663,1942,10,N,Y,1448276340407,30017,39003
THIRTY.txt,524871,526695,1824,10,N,Y,1448276340407,30017,39003
THIRTY.txt,525104,526727,1623,10,N,Y,1448276340407,30017,39003
THIRTY.txt,525335,526885,1550,10,N,Y,1448276340407,30017,39003
THIRTY.txt,525599,526985,1386,10,N,Y,1448276340407,30017,39003
THIRTY.txt,525930,527021,1091,10,N,Y,1448276340407,30017,39003
THIRTY.txt,526037,527092,1055,10,N,N,-,-1,-1
THIRTY.txt,526235,527128,893,10,N,N,-,-1,-1
THIRTY.txt,526327,527164,837,10,N,N,-,-1,-1
THIRTY.txt,526622,527200,578,10,N,N,-,-1,-1
THIRTY.txt,526664,527236,572,10,N,N,-,-1,-1
THIRTY.txt,526696,527272,576,10,N,N,-,-1,-1
THIRTY.txt,526728,527460,732,10,N,N,-,-1,-1
THIRTY.txt,526885,527580,695,10,N,N,-,-1,-1
THIRTY.txt,526986,527735,749,10,N,N,-,-1,-1
THIRTY.txt,527022,527895,873,10,N,N,-,-1,-1
THIRTY.txt,527093,528154,1061,10,N,N,-,-1,-1
THIRTY.txt,527129,528488,1359,10,N,N,-,-1,-1
THIRTY.txt,527165,528856,1691,10,N,N,-,-1,-1
THIRTY.txt,527201,528991,1790,10,N,N,-,-1,-1
THIRTY.txt,527237,529188,1951,10,N,N,-,-1,-1
THIRTY.txt,527273,529255,1982,10,N,N,-,-1,-1
THIRTY.txt,527461,529510,2049,10,Y,N,-,-1,-1
THIRTY.txt,527581,529569,1988,10,Y,Y,1448366973491,278203,278343
THIRTY.txt,527736,529669,1933,10,Y,Y,1448366973491,278203,278343
THIRTY.txt,527896,529779,1883,10,Y,Y,1448366973491,278203,278343
THIRTY.txt,528155,529818,1663,10,Y,Y,1448366973491,278203,278343
THIRTY.txt,528490,530125,1635,10,Y,Y,1448366973491,278203,278343
THIRTY.txt,528859,530248,1389,10,Y,Y,1448366973491,278203,278343
THIRTY.txt,528992,530390,1398,10,Y,Y,1448366973491,278203,278343
THIRTY.txt,529189,530553,1364,10,Y,Y,1448366973491,278203,278343
THIRTY.txt,529256,530701,1445,10,N,Y,1448366973491,278203,278343
THIRTY.txt,529511,530824,1313,10,N,Y,1448366973491,278203,278343
THIRTY.txt,529570,530888,1318,10,N,Y,1448366973491,278203,278343
THIRTY.txt,529670,531010,1340,10,Y,Y,1448366973491,278203,278343
THIRTY.txt,529780,531108,1328,10,N,Y,1448366973491,278203,278343
THIRTY.txt,529819,531277,1458,10,N,Y,1448366973491,278203,278343
THIRTY.txt,530128,531490,1362,10,N,N,-,-1,-1
THIRTY.txt,530249,531608,1359,10,N,N,-,-1,-1
THIRTY.txt,530391,531860,1469,10,Y,N,-,-1,-1
THIRTY.txt,530554,531939,1385,10,N,N,-,-1,-1
THIRTY.txt,530702,532173,1471,10,Y,N,-,-1,-1
THIRTY.txt,530827,532258,1431,10,Y,N,-,-1,-1
THIRTY.txt,530889,532340,1451,10,N,N,-,-1,-1
THIRTY.txt,531011,532704,1693,10,N,N,-,-1,-1
THIRTY.txt,531109,532792,1683,10,N,N,-,-1,-1
THIRTY.txt,531278,532911,1633,10,Y,N,-,-1,-1
THIRTY.txt,531491,533081,1590,10,Y,N,-,-1,-1
THIRTY.txt,531609,533114,1505,10,Y,N,-,-1,-1
THIRTY.txt,531863,533131,1268,10,N,N,-,-1,-1
THIRTY.txt,531940,533135,1195,10,N,N,-,-1,-1
THIRTY.txt,532174,533369,1195,10,N,N,-,-1,-1
THIRTY.txt,532260,533492,1232,10,N,N,-,-1,-1
THIRTY.txt,532341,533661,1320,10,N,N,-,-1,-1
THIRTY.txt,532705,533745,1040,10,N,N,-,-1,-1
THIRTY.txt,532793,533916,1123,10,N,N,-,-1,-1
THIRTY.txt,532913,534317,1404,10,N,N,-,-1,-1
THIRTY.txt,533084,534494,1410,10,N,Y,1448357431466,233540,233770
THIRTY.txt,533114,534795,1681,10,Y,Y,1448357431466,233540,233770
THIRTY.txt,533132,534931,1799,10,Y,Y,1448357431466,233540,233770
THIRTY.txt,533140,535100,1960,10,Y,Y,1448357431466,233540,233770
THIRTY.txt,533370,535465,2095,10,Y,Y,1448357431466,233540,233770
THIRTY.txt,533494,535657,2163,10,Y,Y,1448357431466,233540,233770
THIRTY.txt,533662,535776,2114,10,Y,Y,1448357431466,233540,233770
THIRTY.txt,533747,535920,2173,10,Y,Y,1448357431466,233540,233770
THIRTY.txt,533917,536040,2123,10,Y,Y,1448357431466,233540,233770
THIRTY.txt,534318,536151,1833,10,Y,Y,1448357431466,233540,233770
THIRTY.txt,534495,536297,1802,10,Y,Y,1448357431466,233540,233770
THIRTY.txt,534798,536752,1954,10,Y,N,-,-1,-1
THIRTY.txt,534932,537056,2124,10,Y,N,-,-1,-1
THIRTY.txt,535101,537134,2033,10,Y,N,-,-1,-1
THIRTY.txt,535466,537619,2153,10,Y,N,-,-1,-1
THIRTY.txt,535660,537873,2213,10,N,N,-,-1,-1
THIRTY.txt,535777,538190,2413,10,N,N,-,-1,-1
THIRTY.txt,535921,538429,2508,10,Y,N,-,-1,-1
THIRTY.txt,536041,538675,2634,10,Y,N,-,-1,-1
THIRTY.txt,536152,538812,2660,10,Y,N,-,-1,-1
THIRTY.txt,536298,539050,2752,10,Y,N,-,-1,-1
THIRTY.txt,536753,539189,2436,10,Y,N,-,-1,-1
THIRTY.txt,537059,539331,2272,10,N,N,-,-1,-1
THIRTY.txt,537135,539527,2392,10,N,N,-,-1,-1
THIRTY.txt,537620,539687,2067,10,N,N,-,-1,-1
THIRTY.txt,537876,539799,1923,10,Y,N,-,-1,-1
THIRTY.txt,538191,540100,1909,10,Y,N,-,-1,-1
THIRTY.txt,538430,540269,1839,10,N,N,-,-1,-1
THIRTY.txt,538676,540397,1721,10,N,N,-,-1,-1
THIRTY.txt,538813,540658,1845,10,N,N,-,-1,-1
THIRTY.txt,539053,541285,2232,10,N,N,-,-1,-1
THIRTY.txt,539190,541759,2569,10,N,N,-,-1,-1
THIRTY.txt,539332,543581,4249,10,N,N,-,-1,-1
THIRTY.txt,539532,543587,4055,10,N,N,-,-1,-1
THIRTY.txt,539688,543813,4125,10,N,N,-,-1,-1
THIRTY.txt,539800,543819,4019,10,N,N,-,-1,-1
THIRTY.txt,540101,544285,4184,10,N,N,-,-1,-1
THIRTY.txt,540270,544291,4021,10,N,N,-,-1,-1
THIRTY.txt,540398,545939,5541,10,N,N,-,-1,-1
THIRTY.txt,540663,549941,9278,10,N,N,-,-1,-1
THIRTY.txt,541286,555302,14016,10,N,N,-,-1,-1
THIRTY.txt,541760,555308,13548,10,N,N,-,-1,-1
THIRTY.txt,543582,555487,11905,10,N,N,-,-1,-1
THIRTY.txt,543588,556923,13335,10,N,N,-,-1,-1
THIRTY.txt,543814,557069,13255,10,N,N,-,-1,-1
THIRTY.txt,543820,557204,13384,10,N,N,-,-1,-1
THIRTY.txt,544286,558077,13791,10,N,N,-,-1,-1
THIRTY.txt,544292,558289,13997,10,N,N,-,-1,-1
THIRTY.txt,545940,559079,13139,10,N,N,-,-1,-1
THIRTY.txt,549942,559955,10013,10,N,N,-,-1,-1
THIRTY.txt,555303,563533,8230,10,N,N,-,-1,-1
THIRTY.txt,555309,568507,13198,10,N,N,-,-1,-1
THIRTY.txt,555488,569271,13783,10,N,N,-,-1,-1
THIRTY.txt,556924,570720,13796,10,N,N,-,-1,-1
THIRTY.txt,557070,570727,13657,10,N,N,-,-1,-1
THIRTY.txt,557205,570838,13633,10,N,N,-,-1,-1
THIRTY.txt,558078,571079,13001,10,N,N,-,-1,-1
THIRTY.txt,558290,571205,12915,10,N,N,-,-1,-1
THIRTY.txt,559080,575368,16288,10,N,N,-,-1,-1
THIRTY.txt,559956,575375,15419,10,N,N,-,-1,-1
THIRTY.txt,563534,577982,14448,10,N,N,-,-1,-1
THIRTY.txt,568508,577995,9487,10,N,N,-,-1,-1
TWOMEN.txt,2,3380,3378,10,N,N,-,-1,-1
TWOMEN.txt,348,3588,3240,10,N,N,-,-1,-1
TWOMEN.txt,558,3859,3301,10,N,N,-,-1,-1
TWOMEN.txt,757,4101,3344,10,N,N,-,-1,-1
TWOMEN.txt,1391,4469,3078,10,N,N,-,-1,-1
TWOMEN.txt,1593,4501,2908,10,N,N,-,-1,-1
TWOMEN.txt,1880,4544,2664,10,N,N,-,-1,-1
TWOMEN.txt,2187,4582,2395,10,N,N,-,-1,-1
TWOMEN.txt,2308,4622,2314,10,N,N,-,-1,-1
TWOMEN.txt,2988,4655,1667,10,N,N,-,-1,-1
TWOMEN.txt,3381,4697,1316,10,N,N,-,-1,-1
TWOMEN.txt,3590,4757,1167,10,N,N,-,-1,-1
TWOMEN.txt,3860,4808,948,10,N,N,-,-1,-1
TWOMEN.txt,4102,4843,741,10,N,N,-,-1,-1
TWOMEN.txt,4472,4876,404,10,N,N,-,-1,-1
TWOMEN.txt,4506,4908,402,10,N,N,-,-1,-1
TWOMEN.txt,4545,4927,382,10,N,N,-,-1,-1
TWOMEN.txt,4583,4961,378,10,N,N,-,-1,-1
TWOMEN.txt,4623,5009,386,10,N,N,-,-1,-1
TWOMEN.txt,4656,5034,378,10,N,N,-,-1,-1
TWOMEN.txt,4698,5059,361,10,N,N,-,-1,-1
TWOMEN.txt,4758,5092,334,10,N,N,-,-1,-1
TWOMEN.txt,4809,5150,341,10,N,N,-,-1,-1
TWOMEN.txt,4844,5183,339,10,N,N,-,-1,-1
TWOMEN.txt,4877,5239,362,10,N,N,-,-1,-1
TWOMEN.txt,4909,5274,365,10,N,N,-,-1,-1
TWOMEN.txt,4928,5322,394,10,N,N,-,-1,-1
TWOMEN.txt,4962,5370,408,10,N,N,-,-1,-1
TWOMEN.txt,5012,5605,593,10,N,N,-,-1,-1
TWOMEN.txt,5035,5707,672,10,N,N,-,-1,-1
TWOMEN.txt,5061,5784,723,10,N,N,-,-1,-1
TWOMEN.txt,5093,5821,728,10,N,N,-,-1,-1
TWOMEN.txt,5151,5834,683,10,N,N,-,-1,-1
TWOMEN.txt,5184,5925,741,10,N,N,-,-1,-1
TWOMEN.txt,5240,6385,1145,10,N,N,-,-1,-1
TWOMEN.txt,5276,6776,1500,10,Y,N,-,-1,-1
TWOMEN.txt,5323,7023,1700,10,Y,N,-,-1,-1
TWOMEN.txt,5375,7230,1855,10,Y,N,-,-1,-1
TWOMEN.txt,5607,7309,1702,10,Y,N,-,-1,-1
TWOMEN.txt,5708,7551,1843,10,Y,N,-,-1,-1
TWOMEN.txt,5785,7601,1816,10,Y,N,-,-1,-1
TWOMEN.txt,5822,7794,1972,10,Y,N,-,-1,-1
TWOMEN.txt,5836,7926,2090,10,Y,N,-,-1,-1
TWOMEN.txt,5928,8109,2181,10,Y,N,-,-1,-1
TWOMEN.txt,6386,8205,1819,10,N,N,-,-1,-1
TWOMEN.txt,6777,8367,1590,10,N,N,-,-1,-1
TWOMEN.txt,7024,8695,1671,10,N,N,-,-1,-1
TWOMEN.txt,7231,8759,1528,10,N,N,-,-1,-1
TWOMEN.txt,7310,8791,1481,10,N,N,-,-1,-1
TWOMEN.txt,7553,8848,1295,10,N,N,-,-1,-1
TWOMEN.txt,7603,8865,1262,10,N,N,-,-1,-1
TWOMEN.txt,7795,9010,1215,10,N,N,-,-1,-1
TWOMEN.txt,7928,9027,1099,10,N,N,-,-1,-1
TWOMEN.txt,8110,9271,1161,10,N,N,-,-1,-1
TWOMEN.txt,8205,9595,1390,10,N,N,-,-1,-1
TWOMEN.txt,8368,9768,1400,10,N,N,-,-1,-1
TWOMEN.txt,8697,9862,1165,10,N,N,-,-1,-1
TWOMEN.txt,8762,10052,1290,10,N,N,-,-1,-1
TWOMEN.txt,8792,10168,1376,10,N,Y,1437477480340,424837,425856
TWOMEN.txt,8851,10373,1522,10,N,Y,1437477480340,424837,425856
TWOMEN.txt,8867,10749,1882,10,N,Y,1437477480340,424837,425856
TWOMEN.txt,9011,10950,1939,10,N,Y,1437477480340,424837,425856
TWOMEN.txt,9028,11087,2059,10,N,Y,1437477480340,424837,425856
TWOMEN.txt,9273,11248,1975,10,N,Y,1437477480340,424837,425856
TWOMEN.txt,9596,11400,1804,10,N,Y,1437477480340,424837,425856
TWOMEN.txt,9770,11543,1773,10,N,Y,1437477480340,424837,425856
TWOMEN.txt,9863,11863,2000,10,N,Y,1437477480340,424837,425856
TWOMEN.txt,10054,12001,1947,10,N,Y,1437477480340,424837,425856
TWOMEN.txt,10169,12490,2321,10,N,Y,1437477480340,424837,425856
TWOMEN.txt,10374,12635,2261,10,N,Y,1437477480340,424837,425856
TWOMEN.txt,10750,12850,2100,10,N,Y,1437477480340,424837,425856
TWOMEN.txt,10952,13027,2075,10,N,N,-,-1,-1
TWOMEN.txt,11088,13090,2002,10,N,N,-,-1,-1
TWOMEN.txt,11249,13159,1910,10,N,N,-,-1,-1
TWOMEN.txt,11401,13286,1885,10,N,N,-,-1,-1
TWOMEN.txt,11544,13531,1987,10,N,N,-,-1,-1
TWOMEN.txt,11865,13641,1776,10,N,N,-,-1,-1
TWOMEN.txt,12004,13815,1811,10,N,N,-,-1,-1
TWOMEN.txt,12491,14068,1577,10,N,N,-,-1,-1
TWOMEN.txt,12636,14522,1886,10,Y,N,-,-1,-1
TWOMEN.txt,12851,14827,1976,10,Y,N,-,-1,-1
TWOMEN.txt,13027,15227,2200,10,Y,N,-,-1,-1
TWOMEN.txt,13092,15295,2203,10,Y,N,-,-1,-1
TWOMEN.txt,13160,15536,2376,10,Y,N,-,-1,-1
TWOMEN.txt,13287,15635,2348,10,Y,N,-,-1,-1
TWOMEN.txt,13532,15858,2326,10,Y,N,-,-1,-1
TWOMEN.txt,13642,15997,2355,10,Y,N,-,-1,-1
TWOMEN.txt,13816,16094,2278,10,Y,N,-,-1,-1
TWOMEN.txt,14073,16631,2558,10,N,N,-,-1,-1
TWOMEN.txt,14523,16839,2316,10,N,N,-,-1,-1
TWOMEN.txt,14829,16923,2094,10,N,N,-,-1,-1
TWOMEN.txt,15228,17025,1797,10,N,N,-,-1,-1
TWOMEN.txt,15296,17204,1908,10,N,N,-,-1,-1
TWOMEN.txt,15537,17433,1896,10,N,N,-,-1,-1
TWOMEN.txt,15636,17703,2067,10,N,N,-,-1,-1
TWOMEN.txt,15859,17767,1908,10,N,N,-,-1,-1
TWOMEN.txt,16002,17918,1916,10,N,N,-,-1,-1
TWOMEN.txt,16095,17965,1870,10,N,N,-,-1,-1
TWOMEN.txt,16632,18020,1388,10,N,N,-,-1,-1
TWOMEN.txt,16840,18223,1383,10,N,N,-,-1,-1
TWOMEN.txt,16924,18472,1548,10,N,N,-,-1,-1
TWOMEN.txt,17026,18846,1820,10,N,N,-,-1,-1
TWOMEN.txt,17205,19018,1813,10,N,N,-,-1,-1
TWOMEN.txt,17434,19430,1996,10,N,N,-,-1,-1
TWOMEN.txt,17704,19784,2080,10,N,N,-,-1,-1
TWOMEN.txt,17768,19850,2082,10,N,N,-,-1,-1
TWOMEN.txt,17923,19956,2033,10,N,N,-,-1,-1
TWOMEN.txt,17966,20134,2168,10,N,N,-,-1,-1
TWOMEN.txt,18021,20164,2143,10,N,N,-,-1,-1
TWOMEN.txt,18225,20166,1941,10,N,N,-,-1,-1
TWOMEN.txt,18473,20202,1729,10,N,N,-,-1,-1
TWOMEN.txt,18847,20223,1376,10,N,N,-,-1,-1
TWOMEN.txt,19019,20285,1266,10,N,N,-,-1,-1
TWOMEN.txt,19432,20690,1258,10,N,N,-,-1,-1
TWOMEN.txt,19787,20807,1020,10,N,N,-,-1,-1
TWOMEN.txt,19851,20849,998,10,N,N,-,-1,-1
TWOMEN.txt,19957,21045,1088,10,N,N,-,-1,-1
TWOMEN.txt,20135,21093,958,10,N,N,-,-1,-1
TWOMEN.txt,20164,21157,993,10,N,N,-,-1,-1
TWOMEN.txt,20167,21209,1042,10,N,N,-,-1,-1
TWOMEN.txt,20204,21325,1121,10,N,N,-,-1,-1
TWOMEN.txt,20226,21384,1158,10,N,N,-,-1,-1
TWOMEN.txt,20287,21606,1319,10,N,N,-,-1,-1
TWOMEN.txt,20691,21773,1082,10,N,N,-,-1,-1
TWOMEN.txt,20808,21796,988,10,N,N,-,-1,-1
TWOMEN.txt,20850,21813,963,10,N,N,-,-1,-1
TWOMEN.txt,21047,22194,1147,10,N,N,-,-1,-1
TWOMEN.txt,21094,22280,1186,10,N,N,-,-1,-1
TWOMEN.txt,21159,22445,1286,10,N,N,-,-1,-1
TWOMEN.txt,21210,22503,1293,10,N,N,-,-1,-1
TWOMEN.txt,21326,22550,1224,10,N,N,-,-1,-1
TWOMEN.txt,21386,22555,1169,10,N,N,-,-1,-1
TWOMEN.txt,21607,22826,1219,10,N,N,-,-1,-1
TWOMEN.txt,21774,23044,1270,10,N,N,-,-1,-1
TWOMEN.txt,21798,23123,1325,10,N,N,-,-1,-1
TWOMEN.txt,21815,23352,1537,10,N,N,-,-1,-1
TWOMEN.txt,22195,23431,1236,10,N,N,-,-1,-1
TWOMEN.txt,22282,23567,1285,10,N,N,-,-1,-1
TWOMEN.txt,22450,23649,1199,10,N,N,-,-1,-1
TWOMEN.txt,22504,23729,1225,10,N,N,-,-1,-1
TWOMEN.txt,22551,23802,1251,10,N,N,-,-1,-1
TWOMEN.txt,22556,23902,1346,10,N,N,-,-1,-1
TWOMEN.txt,22828,23924,1096,10,N,N,-,-1,-1
TWOMEN.txt,23045,23937,892,10,N,N,-,-1,-1
TWOMEN.txt,23125,23954,829,10,N,N,-,-1,-1
TWOMEN.txt,23354,23976,622,10,N,N,-,-1,-1
TWOMEN.txt,23432,23984,552,10,N,N,-,-1,-1
TWOMEN.txt,23568,23988,420,10,N,N,-,-1,-1
TWOMEN.txt,23650,24056,406,10,N,N,-,-1,-1
TWOMEN.txt,23730,24234,504,10,N,N,-,-1,-1
TWOMEN.txt,23804,24257,453,10,N,N,-,-1,-1
TWOMEN.txt,23905,24270,365,10,N,N,-,-1,-1
TWOMEN.txt,23925,24286,361,10,N,N,-,-1,-1
TWOMEN.txt,23939,24389,450,10,N,N,-,-1,-1
TWOMEN.txt,23956,24423,467,10,N,N,-,-1,-1
TWOMEN.txt,23977,24446,469,10,N,N,-,-1,-1
TWOMEN.txt,23985,24469,484,10,N,N,-,-1,-1
TWOMEN.txt,23992,24475,483,10,N,N,-,-1,-1
TWOMEN.txt,24056,24534,478,10,N,N,-,-1,-1
TWOMEN.txt,24237,24571,334,10,N,N,-,-1,-1
TWOMEN.txt,24258,24653,395,10,N,N,-,-1,-1
TWOMEN.txt,24272,24915,643,10,N,N,-,-1,-1
TWOMEN.txt,24288,25075,787,10,N,N,-,-1,-1
TWOMEN.txt,24390,25096,706,10,N,N,-,-1,-1
TWOMEN.txt,24426,25118,692,10,N,N,-,-1,-1
TWOMEN.txt,24447,25250,803,10,N,N,-,-1,-1
TWOMEN.txt,24472,25289,817,10,N,N,-,-1,-1
TWOMEN.txt,24476,25307,831,10,N,N,-,-1,-1
TWOMEN.txt,24535,25426,891,10,N,N,-,-1,-1
TWOMEN.txt,24573,25452,879,10,N,N,-,-1,-1
TWOMEN.txt,24656,25601,945,10,N,N,-,-1,-1
TWOMEN.txt,24917,25670,753,10,N,N,-,-1,-1
TWOMEN.txt,25077,25876,799,10,N,N,-,-1,-1
TWOMEN.txt,25097,25927,830,10,N,N,-,-1,-1
TWOMEN.txt,25120,25946,826,10,N,N,-,-1,-1
TWOMEN.txt,25251,25969,718,10,N,N,-,-1,-1
TWOMEN.txt,25290,26101,811,10,N,N,-,-1,-1
TWOMEN.txt,25308,26239,931,10,N,N,-,-1,-1
TWOMEN.txt,25427,26433,1006,10,N,N,-,-1,-1
TWOMEN.txt,25454,26498,1044,10,N,N,-,-1,-1
TWOMEN.txt,25602,26676,1074,10,N,N,-,-1,-1
TWOMEN.txt,25671,26850,1179,10,N,N,-,-1,-1
TWOMEN.txt,25877,27145,1268,10,N,N,-,-1,-1
TWOMEN.txt,25930,27209,1279,10,N,N,-,-1,-1
TWOMEN.txt,25947,27478,1531,10,N,N,-,-1,-1
TWOMEN.txt,25971,27672,1701,10,N,N,-,-1,-1
TWOMEN.txt,26103,27872,1769,10,N,N,-,-1,-1
TWOMEN.txt,26240,28051,1811,10,N,N,-,-1,-1
TWOMEN.txt,26434,28303,1869,10,N,N,-,-1,-1
TWOMEN.txt,26501,28461,1960,10,N,N,-,-1,-1
TWOMEN.txt,26677,28734,2057,10,N,N,-,-1,-1
TWOMEN.txt,26851,28784,1933,10,N,N,-,-1,-1
TWOMEN.txt,27146,28895,1749,10,N,N,-,-1,-1
TWOMEN.txt,27210,29133,1923,10,N,N,-,-1,-1
TWOMEN.txt,27479,29451,1972,10,N,N,-,-1,-1
TWOMEN.txt,27674,29496,1822,10,N,N,-,-1,-1
TWOMEN.txt,27873,29849,1976,10,N,N,-,-1,-1
TWOMEN.txt,28052,29935,1883,10,N,N,-,-1,-1
TWOMEN.txt,28305,29989,1684,10,N,N,-,-1,-1
TWOMEN.txt,28462,30017,1555,10,N,N,-,-1,-1
TWOMEN.txt,28735,30020,1285,10,N,N,-,-1,-1
TWOMEN.txt,28785,30037,1252,10,N,N,-,-1,-1
TWOMEN.txt,28896,30052,1156,10,N,N,-,-1,-1
TWOMEN.txt,29134,30059,925,10,N,N,-,-1,-1
TWOMEN.txt,29454,30091,637,10,N,N,-,-1,-1
TWOMEN.txt,29497,30150,653,10,N,N,-,-1,-1
TWOMEN.txt,29850,30183,333,10,N,N,-,-1,-1
TWOMEN.txt,29936,30244,308,10,N,N,-,-1,-1
TWOMEN.txt,29990,30291,301,10,N,N,-,-1,-1
TWOMEN.txt,30019,30374,355,10,N,N,-,-1,-1
TWOMEN.txt,30020,30397,377,10,N,N,-,-1,-1
TWOMEN.txt,30039,30422,383,10,N,N,-,-1,-1
TWOMEN.txt,30053,30471,418,10,N,N,-,-1,-1
TWOMEN.txt,30060,30490,430,10,N,N,-,-1,-1
TWOMEN.txt,30093,30501,408,10,N,N,-,-1,-1
TWOMEN.txt,30152,30515,363,10,N,N,-,-1,-1
TWOMEN.txt,30184,30550,366,10,N,N,-,-1,-1
TWOMEN.txt,30245,30571,326,10,N,N,-,-1,-1
TWOMEN.txt,30292,30600,308,10,N,N,-,-1,-1
TWOMEN.txt,30377,30609,232,10,N,N,-,-1,-1
TWOMEN.txt,30400,30616,216,10,N,N,-,-1,-1
TWOMEN.txt,30424,30626,202,10,N,N,-,-1,-1
TWOMEN.txt,30472,30652,180,10,N,N,-,-1,-1
TWOMEN.txt,30491,30663,172,10,N,N,-,-1,-1
TWOMEN.txt,30502,30676,174,10,N,N,-,-1,-1
TWOMEN.txt,30516,30684,168,10,N,N,-,-1,-1
TWOMEN.txt,30551,30749,198,10,N,N,-,-1,-1
TWOMEN.txt,30576,30790,214,10,N,N,-,-1,-1
TWOMEN.txt,30601,30834,233,10,N,N,-,-1,-1
TWOMEN.txt,30611,30909,298,10,N,N,-,-1,-1
TWOMEN.txt,30617,31127,510,10,N,N,-,-1,-1
TWOMEN.txt,30629,31164,535,10,N,N,-,-1,-1
TWOMEN.txt,30653,31218,565,10,N,N,-,-1,-1
TWOMEN.txt,30665,31270,605,10,N,N,-,-1,-1
TWOMEN.txt,30677,31285,608,10,N,N,-,-1,-1
TWOMEN.txt,30686,31397,711,10,N,N,-,-1,-1
TWOMEN.txt,30750,31425,675,10,N,N,-,-1,-1
TWOMEN.txt,30791,31453,662,10,N,N,-,-1,-1
TWOMEN.txt,30836,31608,772,10,N,N,-,-1,-1
TWOMEN.txt,30910,31620,710,10,N,N,-,-1,-1
TWOMEN.txt,31129,31642,513,10,N,N,-,-1,-1
TWOMEN.txt,31165,31664,499,10,N,N,-,-1,-1
TWOMEN.txt,31219,31679,460,10,N,N,-,-1,-1
TWOMEN.txt,31272,31819,547,10,N,N,-,-1,-1
TWOMEN.txt,31286,31866,580,10,N,N,-,-1,-1
TWOMEN.txt,31398,31959,561,10,N,N,-,-1,-1
TWOMEN.txt,31426,31963,537,10,N,N,-,-1,-1
TWOMEN.txt,31455,31968,513,10,N,N,-,-1,-1
TWOMEN.txt,31609,31975,366,10,N,N,-,-1,-1
TWOMEN.txt,31623,31976,353,10,N,N,-,-1,-1
TWOMEN.txt,31644,32022,378,10,N,N,-,-1,-1
TWOMEN.txt,31666,32103,437,10,N,N,-,-1,-1
TWOMEN.txt,31681,32208,527,10,N,N,-,-1,-1
TWOMEN.txt,31821,32253,432,10,N,N,-,-1,-1
TWOMEN.txt,31867,32406,539,10,N,N,-,-1,-1
TWOMEN.txt,31960,32599,639,10,N,N,-,-1,-1
TWOMEN.txt,31964,32649,685,10,N,N,-,-1,-1
TWOMEN.txt,31969,32711,742,10,N,N,-,-1,-1
TWOMEN.txt,31975,32810,835,10,N,N,-,-1,-1
TWOMEN.txt,31977,32865,888,10,N,N,-,-1,-1
TWOMEN.txt,32027,32878,851,10,N,N,-,-1,-1
TWOMEN.txt,32105,32883,778,10,N,N,-,-1,-1
TWOMEN.txt,32210,32904,694,10,N,N,-,-1,-1
TWOMEN.txt,32254,32927,673,10,N,N,-,-1,-1
TWOMEN.txt,32408,32944,536,10,N,N,-,-1,-1
TWOMEN.txt,32601,33201,600,10,N,N,-,-1,-1
TWOMEN.txt,32650,33617,967,10,N,N,-,-1,-1
TWOMEN.txt,32713,33891,1178,10,N,N,-,-1,-1
TWOMEN.txt,32812,33942,1130,10,N,N,-,-1,-1
TWOMEN.txt,32867,33955,1088,10,N,N,-,-1,-1
TWOMEN.txt,32879,33995,1116,10,N,N,-,-1,-1
TWOMEN.txt,32886,34051,1165,10,N,N,-,-1,-1
TWOMEN.txt,32905,34179,1274,10,N,N,-,-1,-1
TWOMEN.txt,32929,34220,1291,10,N,N,-,-1,-1
TWOMEN.txt,32946,34306,1360,10,N,N,-,-1,-1
TWOMEN.txt,33202,34362,1160,10,N,N,-,-1,-1
TWOMEN.txt,33624,34391,767,10,N,N,-,-1,-1
TWOMEN.txt,33893,34440,547,10,N,N,-,-1,-1
TWOMEN.txt,33945,34497,552,10,N,N,-,-1,-1
TWOMEN.txt,33956,34562,606,10,N,N,-,-1,-1
TWOMEN.txt,33998,34638,640,10,N,N,-,-1,-1
TWOMEN.txt,34052,34675,623,10,N,N,-,-1,-1
TWOMEN.txt,34180,34686,506,10,N,N,-,-1,-1
TWOMEN.txt,34221,34743,522,10,N,N,-,-1,-1
TWOMEN.txt,34308,34813,505,10,N,N,-,-1,-1
TWOMEN.txt,34364,34870,506,10,N,N,-,-1,-1
TWOMEN.txt,34392,34895,503,10,N,N,-,-1,-1
TWOMEN.txt,34441,34916,475,10,N,N,-,-1,-1
TWOMEN.txt,34498,34939,441,10,N,N,-,-1,-1
TWOMEN.txt,34564,34972,408,10,N,N,-,-1,-1
TWOMEN.txt,34639,35014,375,10,N,N,-,-1,-1
TWOMEN.txt,34677,35059,382,10,N,N,-,-1,-1
TWOMEN.txt,34686,35113,427,10,N,N,-,-1,-1
TWOMEN.txt,34745,35232,487,10,N,N,-,-1,-1
TWOMEN.txt,34815,35290,475,10,N,N,-,-1,-1
TWOMEN.txt,34873,35312,439,10,N,N,-,-1,-1
TWOMEN.txt,34896,35327,431,10,N,N,-,-1,-1
TWOMEN.txt,34918,35339,421,10,N,N,-,-1,-1
TWOMEN.txt,34940,35382,442,10,N,N,-,-1,-1
TWOMEN.txt,34974,35401,427,10,N,N,-,-1,-1
TWOMEN.txt,35016,35432,416,10,N,N,-,-1,-1
TWOMEN.txt,35060,35557,497,10,N,N,-,-1,-1
TWOMEN.txt,35114,35566,452,10,N,N,-,-1,-1
TWOMEN.txt,35237,35724,487,10,N,N,-,-1,-1
TWOMEN.txt,35291,35742,451,10,N,N,-,-1,-1
TWOMEN.txt,35313,35765,452,10,N,N,-,-1,-1
TWOMEN.txt,35329,35788,459,10,N,N,-,-1,-1
TWOMEN.txt,35339,35804,465,10,N,N,-,-1,-1
TWOMEN.txt,35383,35834,451,10,N,N,-,-1,-1
TWOMEN.txt,35402,36001,599,10,N,N,-,-1,-1
TWOMEN.txt,35433,36003,570,10,N,N,-,-1,-1
TWOMEN.txt,35558,36056,498,10,N,N,-,-1,-1
TWOMEN.txt,35568,36160,592,10,N,N,-,-1,-1
TWOMEN.txt,35726,36198,472,10,N,N,-,-1,-1
TWOMEN.txt,35745,36231,486,10,N,N,-,-1,-1
TWOMEN.txt,35766,36253,487,10,N,N,-,-1,-1
TWOMEN.txt,35790,36273,483,10,N,N,-,-1,-1
TWOMEN.txt,35807,36279,472,10,N,N,-,-1,-1
TWOMEN.txt,35835,36286,451,10,N,N,-,-1,-1
TWOMEN.txt,36002,36354,352,10,N,N,-,-1,-1
TWOMEN.txt,36005,36420,415,10,N,N,-,-1,-1
TWOMEN.txt,36058,36755,697,10,N,N,-,-1,-1
TWOMEN.txt,36161,36789,628,10,N,N,-,-1,-1
TWOMEN.txt,36199,36801,602,10,N,N,-,-1,-1
TWOMEN.txt,36234,36847,613,10,N,N,-,-1,-1
TWOMEN.txt,36254,36904,650,10,N,N,-,-1,-1
TWOMEN.txt,36275,36915,640,10,N,N,-,-1,-1
TWOMEN.txt,36280,36918,638,10,N,N,-,-1,-1
TWOMEN.txt,36288,37036,748,10,N,N,-,-1,-1
TWOMEN.txt,36355,37083,728,10,N,N,-,-1,-1
TWOMEN.txt,36421,37140,719,10,N,N,-,-1,-1
TWOMEN.txt,36757,37159,402,10,N,N,-,-1,-1
TWOMEN.txt,36791,37185,394,10,N,N,-,-1,-1
TWOMEN.txt,36802,37255,453,10,N,N,-,-1,-1
TWOMEN.txt,36850,37296,446,10,N,N,-,-1,-1
TWOMEN.txt,36906,37318,412,10,N,N,-,-1,-1
TWOMEN.txt,36917,37406,489,10,N,N,-,-1,-1
TWOMEN.txt,36919,37551,632,10,N,N,-,-1,-1
TWOMEN.txt,37038,37582,544,10,N,N,-,-1,-1
TWOMEN.txt,37084,37595,511,10,N,N,-,-1,-1
TWOMEN.txt,37142,37674,532,10,N,N,-,-1,-1
TWOMEN.txt,37161,37705,544,10,N,N,-,-1,-1
TWOMEN.txt,37186,37763,577,10,N,N,-,-1,-1
TWOMEN.txt,37257,37866,609,10,N,N,-,-1,-1
TWOMEN.txt,37299,37900,601,10,N,N,-,-1,-1
TWOMEN.txt,37319,37916,597,10,N,N,-,-1,-1
TWOMEN.txt,37407,37948,541,10,N,N,-,-1,-1
TWOMEN.txt,37553,37961,408,10,N,N,-,-1,-1
TWOMEN.txt,37583,37983,400,10,N,N,-,-1,-1
TWOMEN.txt,37596,37994,398,10,N,N,-,-1,-1
TWOMEN.txt,37676,38158,482,10,N,N,-,-1,-1
TWOMEN.txt,37706,38199,493,10,N,N,-,-1,-1
TWOMEN.txt,37765,38292,527,10,N,N,-,-1,-1
TWOMEN.txt,37868,38313,445,10,N,N,-,-1,-1
TWOMEN.txt,37901,38331,430,10,N,N,-,-1,-1
TWOMEN.txt,37918,38760,842,10,N,N,-,-1,-1
TWOMEN.txt,37949,38890,941,10,N,N,-,-1,-1
TWOMEN.txt,37964,38906,942,10,N,N,-,-1,-1
TWOMEN.txt,37984,38928,944,10,N,N,-,-1,-1
TWOMEN.txt,37996,38955,959,10,N,N,-,-1,-1
TWOMEN.txt,38160,39062,902,10,N,N,-,-1,-1
TWOMEN.txt,38201,39339,1138,10,N,N,-,-1,-1
TWOMEN.txt,38293,39447,1154,10,N,N,-,-1,-1
TWOMEN.txt,38316,39502,1186,10,N,N,-,-1,-1
TWOMEN.txt,38333,39537,1204,10,N,N,-,-1,-1
TWOMEN.txt,38762,40034,1272,10,N,N,-,-1,-1
TWOMEN.txt,38891,40218,1327,10,N,N,-,-1,-1
TWOMEN.txt,38909,40454,1545,10,N,N,-,-1,-1
TWOMEN.txt,38929,40648,1719,10,N,N,-,-1,-1
TWOMEN.txt,38957,40820,1863,10,N,N,-,-1,-1
TWOMEN.txt,39063,40974,1911,10,N,N,-,-1,-1
TWOMEN.txt,39340,41086,1746,10,N,N,-,-1,-1
TWOMEN.txt,39448,41123,1675,10,N,N,-,-1,-1
TWOMEN.txt,39505,41150,1645,10,N,N,-,-1,-1
TWOMEN.txt,39538,41201,1663,10,N,N,-,-1,-1
TWOMEN.txt,40035,41270,1235,10,N,N,-,-1,-1
TWOMEN.txt,40219,41364,1145,10,N,N,-,-1,-1
TWOMEN.txt,40455,41541,1086,10,N,N,-,-1,-1
TWOMEN.txt,40649,41621,972,10,N,N,-,-1,-1
TWOMEN.txt,40821,41804,983,10,N,N,-,-1,-1
TWOMEN.txt,40976,41864,888,10,N,N,-,-1,-1
TWOMEN.txt,41089,41930,841,10,N,N,-,-1,-1
TWOMEN.txt,41123,42007,884,10,N,N,-,-1,-1
TWOMEN.txt,41151,42090,939,10,N,N,-,-1,-1
TWOMEN.txt,41204,42160,956,10,N,N,-,-1,-1
TWOMEN.txt,41272,42190,918,10,N,N,-,-1,-1
TWOMEN.txt,41365,42197,832,10,N,N,-,-1,-1
TWOMEN.txt,41546,42204,658,10,N,N,-,-1,-1
TWOMEN.txt,41623,42226,603,10,N,N,-,-1,-1
TWOMEN.txt,41805,42233,428,10,N,N,-,-1,-1
TWOMEN.txt,41865,42244,379,10,N,N,-,-1,-1
TWOMEN.txt,41932,42258,326,10,N,N,-,-1,-1
TWOMEN.txt,42009,42279,270,10,N,N,-,-1,-1
TWOMEN.txt,42092,42422,330,10,N,N,-,-1,-1
TWOMEN.txt,42163,42653,490,10,N,N,-,-1,-1
TWOMEN.txt,42191,42684,493,10,N,N,-,-1,-1
TWOMEN.txt,42197,42792,595,10,N,N,-,-1,-1
TWOMEN.txt,42206,42936,730,10,N,N,-,-1,-1
TWOMEN.txt,42229,43006,777,10,N,N,-,-1,-1
TWOMEN.txt,42235,43138,903,10,N,N,-,-1,-1
TWOMEN.txt,42246,43176,930,10,N,N,-,-1,-1
TWOMEN.txt,42258,43293,1035,10,N,N,-,-1,-1
TWOMEN.txt,42280,43480,1200,10,N,N,-,-1,-1
TWOMEN.txt,42423,43545,1122,10,N,N,-,-1,-1
TWOMEN.txt,42654,43576,922,10,N,N,-,-1,-1
TWOMEN.txt,42685,43678,993,10,N,N,-,-1,-1
TWOMEN.txt,42793,43741,948,10,N,N,-,-1,-1
TWOMEN.txt,42938,43755,817,10,N,N,-,-1,-1
TWOMEN.txt,43011,43784,773,10,N,N,-,-1,-1
TWOMEN.txt,43139,43821,682,10,N,N,-,-1,-1
TWOMEN.txt,43177,43880,703,10,N,N,-,-1,-1
TWOMEN.txt,43295,43930,635,10,N,N,-,-1,-1
TWOMEN.txt,43481,44087,606,10,N,N,-,-1,-1
TWOMEN.txt,43547,44149,602,10,N,N,-,-1,-1
TWOMEN.txt,43578,44234,656,10,N,N,-,-1,-1
TWOMEN.txt,43680,44316,636,10,N,N,-,-1,-1
TWOMEN.txt,43742,44617,875,10,N,N,-,-1,-1
TWOMEN.txt,43756,44685,929,10,N,N,-,-1,-1
TWOMEN.txt,43785,44813,1028,10,N,N,-,-1,-1
TWOMEN.txt,43822,45186,1364,10,N,N,-,-1,-1
TWOMEN.txt,43883,45351,1468,10,N,N,-,-1,-1
TWOMEN.txt,43931,45403,1472,10,N,N,-,-1,-1
TWOMEN.txt,44088,45551,1463,10,N,N,-,-1,-1
TWOMEN.txt,44150,45838,1688,10,N,N,-,-1,-1
TWOMEN.txt,44236,46063,1827,10,N,N,-,-1,-1
TWOMEN.txt,44317,46227,1910,10,N,N,-,-1,-1
TWOMEN.txt,44618,46389,1771,10,N,N,-,-1,-1
TWOMEN.txt,44688,46728,2040,10,N,N,-,-1,-1
TWOMEN.txt,44815,46897,2082,10,N,N,-,-1,-1
TWOMEN.txt,45187,47073,1886,10,N,N,-,-1,-1
TWOMEN.txt,45352,47210,1858,10,N,N,-,-1,-1
TWOMEN.txt,45404,47293,1889,10,N,N,-,-1,-1
TWOMEN.txt,45552,47854,2302,10,N,N,-,-1,-1
TWOMEN.txt,45839,48117,2278,10,N,N,-,-1,-1
TWOMEN.txt,46066,48239,2173,10,N,N,-,-1,-1
TWOMEN.txt,46228,48438,2210,10,N,N,-,-1,-1
TWOMEN.txt,46390,48531,2141,10,N,N,-,-1,-1
TWOMEN.txt,46729,48575,1846,10,N,N,-,-1,-1
TWOMEN.txt,46898,48606,1708,10,N,N,-,-1,-1
TWOMEN.txt,47074,48666,1592,10,N,N,-,-1,-1
TWOMEN.txt,47212,48869,1657,10,N,N,-,-1,-1
TWOMEN.txt,47294,49055,1761,10,N,N,-,-1,-1
TWOMEN.txt,47855,49370,1515,10,N,N,-,-1,-1
TWOMEN.txt,48118,49508,1390,10,N,N,-,-1,-1
TWOMEN.txt,48240,49556,1316,10,N,N,-,-1,-1
TWOMEN.txt,48440,49571,1131,10,N,N,-,-1,-1
TWOMEN.txt,48532,49587,1055,10,N,N,-,-1,-1
TWOMEN.txt,48575,49700,1125,10,N,N,-,-1,-1
TWOMEN.txt,48607,49811,1204,10,N,N,-,-1,-1
TWOMEN.txt,48667,49820,1153,10,N,N,-,-1,-1
TWOMEN.txt,48870,49825,955,10,N,N,-,-1,-1
TWOMEN.txt,49056,49889,833,10,N,N,-,-1,-1
TWOMEN.txt,49371,49975,604,10,N,N,-,-1,-1
TWOMEN.txt,49509,50029,520,10,N,N,-,-1,-1
TWOMEN.txt,49558,50130,572,10,N,N,-,-1,-1
TWOMEN.txt,49573,50139,566,10,N,N,-,-1,-1
TWOMEN.txt,49589,50144,555,10,N,N,-,-1,-1
TWOMEN.txt,49701,50201,500,10,N,N,-,-1,-1
TWOMEN.txt,49813,50246,433,10,N,N,-,-1,-1
TWOMEN.txt,49822,50256,434,10,N,N,-,-1,-1
TWOMEN.txt,49827,50262,435,10,N,N,-,-1,-1
TWOMEN.txt,49890,50310,420,10,N,N,-,-1,-1
TWOMEN.txt,49979,50347,368,10,N,N,-,-1,-1
TWOMEN.txt,50034,50356,322,10,N,N,-,-1,-1
TWOMEN.txt,50132,50364,232,10,N,N,-,-1,-1
TWOMEN.txt,50140,50417,277,10,N,N,-,-1,-1
TWOMEN.txt,50150,50461,311,10,N,N,-,-1,-1
TWOMEN.txt,50202,50499,297,10,N,N,-,-1,-1
TWOMEN.txt,50249,50550,301,10,N,N,-,-1,-1
TWOMEN.txt,50257,50599,342,10,N,N,-,-1,-1
TWOMEN.txt,50264,50652,388,10,N,N,-,-1,-1
TWOMEN.txt,50311,50739,428,10,N,N,-,-1,-1
TWOMEN.txt,50349,50993,644,10,N,N,-,-1,-1
TWOMEN.txt,50357,51168,811,10,N,N,-,-1,-1
TWOMEN.txt,50367,51359,992,10,N,N,-,-1,-1
TWOMEN.txt,50418,51412,994,10,N,N,-,-1,-1
TWOMEN.txt,50462,51491,1029,10,N,N,-,-1,-1
TWOMEN.txt,50501,51676,1175,10,N,N,-,-1,-1
TWOMEN.txt,50551,51821,1270,10,N,N,-,-1,-1
TWOMEN.txt,50602,52014,1412,10,N,N,-,-1,-1
TWOMEN.txt,50653,52155,1502,10,N,N,-,-1,-1
TWOMEN.txt,50740,52224,1484,10,N,N,-,-1,-1
TWOMEN.txt,50994,52346,1352,10,N,N,-,-1,-1
TWOMEN.txt,51169,52428,1259,10,N,N,-,-1,-1
TWOMEN.txt,51361,52558,1197,10,N,N,-,-1,-1
TWOMEN.txt,51417,52697,1280,10,N,N,-,-1,-1
TWOMEN.txt,51492,52741,1249,10,N,N,-,-1,-1
TWOMEN.txt,51677,52861,1184,10,N,N,-,-1,-1
TWOMEN.txt,51822,53232,1410,10,N,N,-,-1,-1
TWOMEN.txt,52015,53301,1286,10,N,N,-,-1,-1
TWOMEN.txt,52156,53349,1193,10,N,N,-,-1,-1
TWOMEN.txt,52225,54064,1839,10,N,N,-,-1,-1
TWOMEN.txt,52347,54158,1811,10,N,N,-,-1,-1
TWOMEN.txt,52430,54859,2429,10,N,N,-,-1,-1
TWOMEN.txt,52559,55083,2524,10,N,N,-,-1,-1
TWOMEN.txt,52698,55321,2623,10,N,N,-,-1,-1
TWOMEN.txt,52742,55555,2813,10,N,N,-,-1,-1
TWOMEN.txt,52862,55870,3008,10,N,N,-,-1,-1
TWOMEN.txt,53236,56131,2895,10,N,N,-,-1,-1
TWOMEN.txt,53302,56305,3003,10,N,N,-,-1,-1
TWOMEN.txt,53354,56554,3200,10,N,N,-,-1,-1
TWOMEN.txt,54065,56705,2640,10,N,N,-,-1,-1
TWOMEN.txt,54160,56852,2692,10,N,N,-,-1,-1
TWOMEN.txt,54860,56993,2133,10,N,N,-,-1,-1
TWOMEN.txt,55084,57206,2122,10,N,N,-,-1,-1
TWOMEN.txt,55322,57404,2082,10,N,N,-,-1,-1
TWOMEN.txt,55557,57638,2081,10,N,N,-,-1,-1
TWOMEN.txt,55871,57893,2022,10,N,N,-,-1,-1
TWOMEN.txt,56132,58127,1995,10,N,N,-,-1,-1
TWOMEN.txt,56307,58223,1916,10,N,N,-,-1,-1
TWOMEN.txt,56555,58347,1792,10,N,N,-,-1,-1
TWOMEN.txt,56707,58404,1697,10,N,N,-,-1,-1
TWOMEN.txt,56853,58513,1660,10,N,N,-,-1,-1
TWOMEN.txt,56995,58518,1523,10,N,N,-,-1,-1
TWOMEN.txt,57208,58712,1504,10,N,N,-,-1,-1
TWOMEN.txt,57405,58919,1514,10,N,N,-,-1,-1
TWOMEN.txt,57639,58979,1340,10,N,N,-,-1,-1
TWOMEN.txt,57895,59193,1298,10,N,N,-,-1,-1
TWOMEN.txt,58128,59262,1134,10,N,N,-,-1,-1
TWOMEN.txt,58224,59377,1153,10,N,N,-,-1,-1
TWOMEN.txt,58348,59510,1162,10,N,N,-,-1,-1
TWOMEN.txt,58405,59704,1299,10,N,N,-,-1,-1
TWOMEN.txt,58514,60090,1576,10,N,N,-,-1,-1
TWOMEN.txt,58519,60113,1594,10,N,N,-,-1,-1
TWOMEN.txt,58713,60152,1439,10,N,N,-,-1,-1
TWOMEN.txt,58920,60321,1401,10,N,N,-,-1,-1
TWOMEN.txt,58984,60553,1569,10,N,N,-,-1,-1
TWOMEN.txt,59195,60651,1456,10,N,N,-,-1,-1
TWOMEN.txt,59265,60658,1393,10,N,N,-,-1,-1
TWOMEN.txt,59379,60668,1289,10,N,N,-,-1,-1
TWOMEN.txt,59511,60778,1267,10,N,N,-,-1,-1
TWOMEN.txt,59705,60803,1098,10,N,N,-,-1,-1
TWOMEN.txt,60093,60876,783,10,N,N,-,-1,-1
TWOMEN.txt,60114,60898,784,10,N,N,-,-1,-1
TWOMEN.txt,60155,60920,765,10,N,N,-,-1,-1
TWOMEN.txt,60323,60941,618,10,N,N,-,-1,-1
TWOMEN.txt,60556,60972,416,10,N,N,-,-1,-1
TWOMEN.txt,60654,61005,351,10,N,N,-,-1,-1
TWOMEN.txt,60659,61022,363,10,N,N,-,-1,-1
TWOMEN.txt,60671,61090,419,10,N,N,-,-1,-1
TWOMEN.txt,60780,61188,408,10,N,N,-,-1,-1
TWOMEN.txt,60804,61234,430,10,N,N,-,-1,-1
TWOMEN.txt,60879,61319,440,10,N,N,-,-1,-1
TWOMEN.txt,60899,61353,454,10,N,N,-,-1,-1
TWOMEN.txt,60922,61415,493,10,N,N,-,-1,-1
TWOMEN.txt,60943,61444,501,10,N,N,-,-1,-1
TWOMEN.txt,60973,61651,678,10,N,N,-,-1,-1
TWOMEN.txt,61006,61741,735,10,N,N,-,-1,-1
TWOMEN.txt,61023,61805,782,10,N,N,-,-1,-1
TWOMEN.txt,61090,61815,725,10,N,N,-,-1,-1
TWOMEN.txt,61189,61838,649,10,N,N,-,-1,-1
TWOMEN.txt,61235,61899,664,10,N,N,-,-1,-1
TWOMEN.txt,61320,61969,649,10,N,N,-,-1,-1
TWOMEN.txt,61356,62030,674,10,N,N,-,-1,-1
TWOMEN.txt,61416,62105,689,10,N,N,-,-1,-1
TWOMEN.txt,61444,62150,706,10,N,N,-,-1,-1
TWOMEN.txt,61653,62225,572,10,N,N,-,-1,-1
TWOMEN.txt,61742,62290,548,10,N,N,-,-1,-1
TWOMEN.txt,61806,62540,734,10,N,N,-,-1,-1
TWOMEN.txt,61816,62649,833,10,N,N,-,-1,-1
TWOMEN.txt,61840,62924,1084,10,N,N,-,-1,-1
TWOMEN.txt,61900,62991,1091,10,N,N,-,-1,-1
TWOMEN.txt,61970,63120,1150,10,N,N,-,-1,-1
TWOMEN.txt,62031,63327,1296,10,N,N,-,-1,-1
TWOMEN.txt,62106,63555,1449,10,N,N,-,-1,-1
TWOMEN.txt,62152,63653,1501,10,N,N,-,-1,-1
TWOMEN.txt,62227,63849,1622,10,N,N,-,-1,-1
TWOMEN.txt,62293,64104,1811,10,N,N,-,-1,-1
TWOMEN.txt,62542,64225,1683,10,N,N,-,-1,-1
TWOMEN.txt,62650,64533,1883,10,N,N,-,-1,-1
TWOMEN.txt,62925,64639,1714,10,N,N,-,-1,-1
TWOMEN.txt,62992,64717,1725,10,N,N,-,-1,-1
TWOMEN.txt,63121,64857,1736,10,N,N,-,-1,-1
TWOMEN.txt,63328,65016,1688,10,N,N,-,-1,-1
TWOMEN.txt,63556,65094,1538,10,N,N,-,-1,-1
TWOMEN.txt,63654,65167,1513,10,N,N,-,-1,-1
TWOMEN.txt,63850,65331,1481,10,N,N,-,-1,-1
TWOMEN.txt,64105,65399,1294,10,N,N,-,-1,-1
TWOMEN.txt,64226,65495,1269,10,N,N,-,-1,-1
TWOMEN.txt,64535,65524,989,10,N,N,-,-1,-1
TWOMEN.txt,64640,65592,952,10,N,N,-,-1,-1
TWOMEN.txt,64718,65980,1262,10,N,N,-,-1,-1
TWOMEN.txt,64858,66167,1309,10,N,N,-,-1,-1
TWOMEN.txt,65017,66298,1281,10,N,N,-,-1,-1
TWOMEN.txt,65095,66334,1239,10,N,N,-,-1,-1
TWOMEN.txt,65168,66427,1259,10,N,N,-,-1,-1
TWOMEN.txt,65332,66632,1300,10,N,N,-,-1,-1
TWOMEN.txt,65400,66755,1355,10,N,N,-,-1,-1
TWOMEN.txt,65496,66834,1338,10,N,N,-,-1,-1
TWOMEN.txt,65525,66962,1437,10,N,N,-,-1,-1
TWOMEN.txt,65594,66997,1403,10,N,N,-,-1,-1
TWOMEN.txt,65982,67203,1221,10,N,N,-,-1,-1
TWOMEN.txt,66168,67334,1166,10,N,N,-,-1,-1
TWOMEN.txt,66299,67419,1120,10,N,N,-,-1,-1
TWOMEN.txt,66335,67487,1152,10,N,N,-,-1,-1
TWOMEN.txt,66429,67622,1193,10,N,N,-,-1,-1
TWOMEN.txt,66633,67648,1015,10,N,N,-,-1,-1
TWOMEN.txt,66758,67732,974,10,N,N,-,-1,-1
TWOMEN.txt,66835,67925,1090,10,N,N,-,-1,-1
TWOMEN.txt,66966,67941,975,10,N,N,-,-1,-1
TWOMEN.txt,66998,67949,951,10,N,N,-,-1,-1
TWOMEN.txt,67205,67960,755,10,N,N,-,-1,-1
TWOMEN.txt,67335,68058,723,10,N,N,-,-1,-1
TWOMEN.txt,67420,68284,864,10,N,N,-,-1,-1
TWOMEN.txt,67488,68427,939,10,N,N,-,-1,-1
TWOMEN.txt,67622,68500,878,10,N,N,-,-1,-1
TWOMEN.txt,67650,68533,883,10,N,N,-,-1,-1
TWOMEN.txt,67733,68677,944,10,N,N,-,-1,-1
TWOMEN.txt,67926,68707,781,10,N,N,-,-1,-1
TWOMEN.txt,67943,68784,841,10,N,N,-,-1,-1
TWOMEN.txt,67951,68840,889,10,N,N,-,-1,-1
TWOMEN.txt,67962,68950,988,10,N,N,-,-1,-1
TWOMEN.txt,68059,69072,1013,10,N,N,-,-1,-1
TWOMEN.txt,68285,69132,847,10,N,N,-,-1,-1
TWOMEN.txt,68428,69322,894,10,N,Y,1437470299748,152207,152889
TWOMEN.txt,68501,69619,1118,10,N,Y,1437470299748,152207,152889
TWOMEN.txt,68535,69702,1167,10,N,Y,1437470299748,152207,152889
TWOMEN.txt,68678,69987,1309,10,N,Y,1437470299748,152207,152889
TWOMEN.txt,68708,70163,1455,10,N,Y,1437470299748,152207,152889
TWOMEN.txt,68786,70255,1469,10,N,Y,1437470299748,152207,152889
TWOMEN.txt,68841,70381,1540,10,N,Y,1437470299748,152207,152889
TWOMEN.txt,68952,70445,1493,10,N,Y,1437470299748,152207,152889
TWOMEN.txt,69073,70533,1460,10,N,Y,1437470299748,152207,152889
TWOMEN.txt,69133,70931,1798,10,N,Y,1437470299748,152207,152889
TWOMEN.txt,69323,71244,1921,10,N,Y,1437470299748,152207,152889
TWOMEN.txt,69620,71537,1917,10,N,Y,1437470299748,152207,152889
TWOMEN.txt,69704,71690,1986,10,N,Y,1437470299748,152207,152889
TWOMEN.txt,69988,71969,1981,10,N,Y,1437470299748,152207,152889
TWOMEN.txt,70164,71997,1833,10,N,Y,1437470299748,152207,152889
TWOMEN.txt,70256,72133,1877,10,N,Y,1437470299748,152207,152889
TWOMEN.txt,70382,72365,1983,10,N,Y,1437470299748,152207,152889
TWOMEN.txt,70448,72389,1941,10,N,N,-,-1,-1
TWOMEN.txt,70534,72687,2153,10,N,N,-,-1,-1
TWOMEN.txt,70933,72786,1853,10,N,N,-,-1,-1
TWOMEN.txt,71246,72908,1662,10,N,N,-,-1,-1
TWOMEN.txt,71539,73010,1471,10,N,N,-,-1,-1
TWOMEN.txt,71692,73135,1443,10,N,N,-,-1,-1
TWOMEN.txt,71970,73288,1318,10,N,N,-,-1,-1
TWOMEN.txt,71998,73342,1344,10,N,N,-,-1,-1
TWOMEN.txt,72134,73460,1326,10,N,N,-,-1,-1
TWOMEN.txt,72366,73539,1173,10,N,N,-,-1,-1
TWOMEN.txt,72391,73614,1223,10,N,N,-,-1,-1
TWOMEN.txt,72688,73802,1114,10,N,N,-,-1,-1
TWOMEN.txt,72787,73828,1041,10,N,N,-,-1,-1
TWOMEN.txt,72909,74010,1101,10,N,N,-,-1,-1
TWOMEN.txt,73011,74203,1192,10,N,N,-,-1,-1
TWOMEN.txt,73140,74291,1151,10,N,N,-,-1,-1
TWOMEN.txt,73289,74379,1090,10,N,N,-,-1,-1
TWOMEN.txt,73343,74427,1084,10,N,N,-,-1,-1
TWOMEN.txt,73461,74619,1158,10,N,N,-,-1,-1
TWOMEN.txt,73541,74838,1297,10,N,N,-,-1,-1
TWOMEN.txt,73615,75039,1424,10,N,N,-,-1,-1
TWOMEN.txt,73803,75144,1341,10,N,N,-,-1,-1
TWOMEN.txt,73829,75157,1328,10,N,N,-,-1,-1
TWOMEN.txt,74011,75224,1213,10,N,N,-,-1,-1
TWOMEN.txt,74204,75287,1083,10,N,N,-,-1,-1
TWOMEN.txt,74292,75318,1026,10,N,N,-,-1,-1
TWOMEN.txt,74379,75340,961,10,N,N,-,-1,-1
TWOMEN.txt,74428,75352,924,10,N,N,-,-1,-1
TWOMEN.txt,74620,75371,751,10,N,N,-,-1,-1
TWOMEN.txt,74839,75588,749,10,N,N,-,-1,-1
TWOMEN.txt,75041,75619,578,10,N,N,-,-1,-1
TWOMEN.txt,75145,75628,483,10,N,N,-,-1,-1
TWOMEN.txt,75159,75664,505,10,N,N,-,-1,-1
TWOMEN.txt,75225,75686,461,10,N,N,-,-1,-1
TWOMEN.txt,75288,75979,691,10,N,N,-,-1,-1
TWOMEN.txt,75321,76152,831,10,N,N,-,-1,-1
TWOMEN.txt,75341,76507,1166,10,N,N,-,-1,-1
TWOMEN.txt,75355,76522,1167,10,N,N,-,-1,-1
TWOMEN.txt,75373,76540,1167,10,N,N,-,-1,-1
TWOMEN.txt,75589,76575,986,10,N,N,-,-1,-1
TWOMEN.txt,75622,76691,1069,10,N,N,-,-1,-1
TWOMEN.txt,75628,76769,1141,10,N,N,-,-1,-1
TWOMEN.txt,75667,76790,1123,10,N,N,-,-1,-1
TWOMEN.txt,75688,76816,1128,10,N,N,-,-1,-1
TWOMEN.txt,75980,76986,1006,10,N,N,-,-1,-1
TWOMEN.txt,76153,77191,1038,10,N,N,-,-1,-1
TWOMEN.txt,76508,77385,877,10,N,N,-,-1,-1
TWOMEN.txt,76525,77420,895,10,N,N,-,-1,-1
TWOMEN.txt,76541,77472,931,10,N,N,-,-1,-1
TWOMEN.txt,76578,77480,902,10,N,N,-,-1,-1
TWOMEN.txt,76694,77553,859,10,N,N,-,-1,-1
TWOMEN.txt,76772,77554,782,10,N,N,-,-1,-1
TWOMEN.txt,76791,77691,900,10,N,N,-,-1,-1
TWOMEN.txt,76817,77813,996,10,N,N,-,-1,-1
TWOMEN.txt,76987,77903,916,10,N,N,-,-1,-1
TWOMEN.txt,77192,78045,853,10,N,N,-,-1,-1
TWOMEN.txt,77387,78090,703,10,N,N,-,-1,-1
TWOMEN.txt,77421,78115,694,10,N,N,-,-1,-1
TWOMEN.txt,77474,78146,672,10,N,N,-,-1,-1
TWOMEN.txt,77481,78313,832,10,N,N,-,-1,-1
TWOMEN.txt,77553,78609,1056,10,N,N,-,-1,-1
TWOMEN.txt,77555,78735,1180,10,N,N,-,-1,-1
TWOMEN.txt,77692,78847,1155,10,N,N,-,-1,-1
TWOMEN.txt,77814,78874,1060,10,N,N,-,-1,-1
TWOMEN.txt,77905,79056,1151,10,N,N,-,-1,-1
TWOMEN.txt,78046,79194,1148,10,N,N,-,-1,-1
TWOMEN.txt,78093,79277,1184,10,N,N,-,-1,-1
TWOMEN.txt,78116,79527,1411,10,N,N,-,-1,-1
TWOMEN.txt,78148,79912,1764,10,N,N,-,-1,-1
TWOMEN.txt,78314,79965,1651,10,N,N,-,-1,-1
TWOMEN.txt,78610,80108,1498,10,N,N,-,-1,-1
TWOMEN.txt,78736,80271,1535,10,N,N,-,-1,-1
TWOMEN.txt,78848,80392,1544,10,N,N,-,-1,-1
TWOMEN.txt,78875,80414,1539,10,N,N,-,-1,-1
TWOMEN.txt,79057,80436,1379,10,N,N,-,-1,-1
TWOMEN.txt,79199,80439,1240,10,N,N,-,-1,-1
TWOMEN.txt,79280,80455,1175,10,N,N,-,-1,-1
TWOMEN.txt,79529,80641,1112,10,N,N,-,-1,-1
TWOMEN.txt,79914,80779,865,10,N,N,-,-1,-1
TWOMEN.txt,79966,80799,833,10,N,N,-,-1,-1
TWOMEN.txt,80109,80887,778,10,N,N,-,-1,-1
TWOMEN.txt,80272,80938,666,10,N,N,-,-1,-1
TWOMEN.txt,80395,81063,668,10,N,N,-,-1,-1
TWOMEN.txt,80415,81179,764,10,N,N,-,-1,-1
TWOMEN.txt,80438,81410,972,10,N,N,-,-1,-1
TWOMEN.txt,80439,81651,1212,10,N,N,-,-1,-1
TWOMEN.txt,80457,81702,1245,10,N,N,-,-1,-1
TWOMEN.txt,80642,81748,1106,10,N,N,-,-1,-1
TWOMEN.txt,80783,81785,1002,10,N,N,-,-1,-1
TWOMEN.txt,80800,81828,1028,10,N,N,-,-1,-1
TWOMEN.txt,80892,81977,1085,10,N,N,-,-1,-1
TWOMEN.txt,80939,82078,1139,10,N,N,-,-1,-1
TWOMEN.txt,81064,82277,1213,10,N,N,-,-1,-1
TWOMEN.txt,81180,82408,1228,10,N,N,-,-1,-1
TWOMEN.txt,81411,82457,1046,10,N,N,-,-1,-1
TWOMEN.txt,81652,82493,841,10,N,N,-,-1,-1
TWOMEN.txt,81704,82572,868,10,N,N,-,-1,-1
TWOMEN.txt,81749,82607,858,10,N,N,-,-1,-1
TWOMEN.txt,81786,82647,861,10,N,N,-,-1,-1
TWOMEN.txt,81829,82680,851,10,N,N,-,-1,-1
TWOMEN.txt,81978,82728,750,10,N,N,-,-1,-1
TWOMEN.txt,82080,82750,670,10,N,N,-,-1,-1
TWOMEN.txt,82278,82785,507,10,N,N,-,-1,-1
TWOMEN.txt,82410,82974,564,10,N,N,-,-1,-1
TWOMEN.txt,82457,83205,748,10,N,N,-,-1,-1
TWOMEN.txt,82494,83330,836,10,N,N,-,-1,-1
TWOMEN.txt,82573,83426,853,10,N,N,-,-1,-1
TWOMEN.txt,82609,83439,830,10,N,N,-,-1,-1
TWOMEN.txt,82648,83587,939,10,N,N,-,-1,-1
TWOMEN.txt,82685,83827,1142,10,N,N,-,-1,-1
TWOMEN.txt,82729,83901,1172,10,N,N,-,-1,-1
TWOMEN.txt,82753,83919,1166,10,N,N,-,-1,-1
TWOMEN.txt,82786,83942,1156,10,N,N,-,-1,-1
TWOMEN.txt,82975,83959,984,10,N,N,-,-1,-1
TWOMEN.txt,83206,84199,993,10,N,N,-,-1,-1
TWOMEN.txt,83332,84261,929,10,N,N,-,-1,-1
TWOMEN.txt,83430,84498,1068,10,N,N,-,-1,-1
TWOMEN.txt,83441,84604,1163,10,N,N,-,-1,-1
TWOMEN.txt,83588,84875,1287,10,N,N,-,-1,-1
TWOMEN.txt,83828,84961,1133,10,N,N,-,-1,-1
TWOMEN.txt,83903,85006,1103,10,N,N,-,-1,-1
TWOMEN.txt,83920,85030,1110,10,N,N,-,-1,-1
TWOMEN.txt,83945,85054,1109,10,N,N,-,-1,-1
TWOMEN.txt,83961,85071,1110,10,N,N,-,-1,-1
TWOMEN.txt,84201,85234,1033,10,N,N,-,-1,-1
TWOMEN.txt,84266,85409,1143,10,N,N,-,-1,-1
TWOMEN.txt,84500,85615,1115,10,N,N,-,-1,-1
TWOMEN.txt,84606,85748,1142,10,N,N,-,-1,-1
TWOMEN.txt,84876,85902,1026,10,N,N,-,-1,-1
TWOMEN.txt,84963,85914,951,10,N,N,-,-1,-1
TWOMEN.txt,85009,86012,1003,10,N,N,-,-1,-1
TWOMEN.txt,85033,86044,1011,10,N,N,-,-1,-1
TWOMEN.txt,85056,86152,1096,10,N,N,-,-1,-1
TWOMEN.txt,85073,86276,1203,10,N,N,-,-1,-1
TWOMEN.txt,85235,86372,1137,10,N,N,-,-1,-1
TWOMEN.txt,85411,86447,1036,10,N,N,-,-1,-1
TWOMEN.txt,85616,86621,1005,10,N,N,-,-1,-1
TWOMEN.txt,85749,86639,890,10,N,N,-,-1,-1
TWOMEN.txt,85904,86768,864,10,N,N,-,-1,-1
TWOMEN.txt,85918,86872,954,10,N,N,-,-1,-1
TWOMEN.txt,86013,86923,910,10,N,N,-,-1,-1
TWOMEN.txt,86046,87020,974,10,N,N,-,-1,-1
TWOMEN.txt,86154,87359,1205,10,N,N,-,-1,-1
TWOMEN.txt,86278,87404,1126,10,N,N,-,-1,-1
TWOMEN.txt,86373,87473,1100,10,N,N,-,-1,-1
TWOMEN.txt,86448,87553,1105,10,N,N,-,-1,-1
TWOMEN.txt,86623,87592,969,10,N,N,-,-1,-1
TWOMEN.txt,86640,87615,975,10,N,N,-,-1,-1
TWOMEN.txt,86769,87661,892,10,N,N,-,-1,-1
TWOMEN.txt,86874,87681,807,10,N,N,-,-1,-1
TWOMEN.txt,86924,87722,798,10,N,N,-,-1,-1
TWOMEN.txt,87021,87944,923,10,N,N,-,-1,-1
TWOMEN.txt,87361,88099,738,10,N,N,-,-1,-1
TWOMEN.txt,87405,88175,770,10,N,N,-,-1,-1
TWOMEN.txt,87475,88219,744,10,N,N,-,-1,-1
TWOMEN.txt,87556,88378,822,10,N,N,-,-1,-1
TWOMEN.txt,87593,88626,1033,10,N,N,-,-1,-1
TWOMEN.txt,87620,88714,1094,10,N,N,-,-1,-1
TWOMEN.txt,87662,88816,1154,10,N,N,-,-1,-1
TWOMEN.txt,87683,88929,1246,10,N,N,-,-1,-1
TWOMEN.txt,87723,89030,1307,10,N,N,-,-1,-1
TWOMEN.txt,87945,89049,1104,10,N,N,-,-1,-1
TWOMEN.txt,88100,89080,980,10,N,N,-,-1,-1
TWOMEN.txt,88177,89104,927,10,N,N,-,-1,-1
TWOMEN.txt,88220,89129,909,10,N,N,-,-1,-1
TWOMEN.txt,88380,89174,794,10,N,N,-,-1,-1
TWOMEN.txt,88627,89226,599,10,N,N,-,-1,-1
TWOMEN.txt,88716,89291,575,10,N,N,-,-1,-1
TWOMEN.txt,88817,89361,544,10,N,N,-,-1,-1
TWOMEN.txt,88932,89398,466,10,N,N,-,-1,-1
TWOMEN.txt,89032,89622,590,10,N,N,-,-1,-1
TWOMEN.txt,89051,89677,626,10,N,N,-,-1,-1
TWOMEN.txt,89082,89756,674,10,N,N,-,-1,-1
TWOMEN.txt,89107,89855,748,10,N,N,-,-1,-1
TWOMEN.txt,89131,90038,907,10,N,N,-,-1,-1
TWOMEN.txt,89176,90048,872,10,N,N,-,-1,-1
TWOMEN.txt,89228,90052,824,10,N,N,-,-1,-1
TWOMEN.txt,89292,90101,809,10,N,N,-,-1,-1
TWOMEN.txt,89362,90119,757,10,N,N,-,-1,-1
TWOMEN.txt,89399,90139,740,10,N,N,-,-1,-1
TWOMEN.txt,89623,90227,604,10,N,N,-,-1,-1
TWOMEN.txt,89677,90232,555,10,N,N,-,-1,-1
TWOMEN.txt,89757,90243,486,10,N,N,-,-1,-1
TWOMEN.txt,89856,90298,442,10,N,N,-,-1,-1
TWOMEN.txt,90039,90334,295,10,N,N,-,-1,-1
TWOMEN.txt,90049,90355,306,10,N,N,-,-1,-1
TWOMEN.txt,90055,90374,319,10,N,N,-,-1,-1
TWOMEN.txt,90102,90376,274,10,N,N,-,-1,-1
TWOMEN.txt,90120,90393,273,10,N,N,-,-1,-1
TWOMEN.txt,90140,90442,302,10,N,N,-,-1,-1
TWOMEN.txt,90229,90465,236,10,N,N,-,-1,-1
TWOMEN.txt,90233,90473,240,10,N,N,-,-1,-1
TWOMEN.txt,90244,90484,240,10,N,N,-,-1,-1
TWOMEN.txt,90300,90696,396,10,N,N,-,-1,-1
TWOMEN.txt,90335,90787,452,10,N,N,-,-1,-1
TWOMEN.txt,90357,91143,786,10,N,N,-,-1,-1
TWOMEN.txt,90375,91364,989,10,N,N,-,-1,-1
TWOMEN.txt,90377,91597,1220,10,N,N,-,-1,-1
TWOMEN.txt,90398,91776,1378,10,N,N,-,-1,-1
TWOMEN.txt,90443,91950,1507,10,N,N,-,-1,-1
TWOMEN.txt,90467,92099,1632,10,N,N,-,-1,-1
TWOMEN.txt,90474,92259,1785,10,N,N,-,-1,-1
TWOMEN.txt,90486,92385,1899,10,N,N,-,-1,-1
TWOMEN.txt,90697,92629,1932,10,N,N,-,-1,-1
TWOMEN.txt,90788,92688,1900,10,N,N,-,-1,-1
TWOMEN.txt,91144,92753,1609,10,N,N,-,-1,-1
TWOMEN.txt,91366,92861,1495,10,N,N,-,-1,-1
TWOMEN.txt,91599,92934,1335,10,N,N,-,-1,-1
TWOMEN.txt,91778,93006,1228,10,N,N,-,-1,-1
TWOMEN.txt,91951,93020,1069,10,N,N,-,-1,-1
TWOMEN.txt,92100,93047,947,10,N,N,-,-1,-1
TWOMEN.txt,92259,93064,805,10,N,N,-,-1,-1
TWOMEN.txt,92387,93072,685,10,N,N,-,-1,-1
TWOMEN.txt,92631,93094,463,10,N,N,-,-1,-1
TWOMEN.txt,92690,93232,542,10,N,N,-,-1,-1
TWOMEN.txt,92754,93535,781,10,N,N,-,-1,-1
TWOMEN.txt,92862,93705,843,10,N,N,-,-1,-1
TWOMEN.txt,92936,93769,833,10,N,N,-,-1,-1
TWOMEN.txt,93007,93830,823,10,N,N,-,-1,-1
TWOMEN.txt,93021,93846,825,10,N,N,-,-1,-1
TWOMEN.txt,93048,93857,809,10,N,N,-,-1,-1
TWOMEN.txt,93065,93991,926,10,N,N,-,-1,-1
TWOMEN.txt,93073,94069,996,10,N,N,-,-1,-1
TWOMEN.txt,93096,94173,1077,10,N,N,-,-1,-1
TWOMEN.txt,93233,94241,1008,10,N,N,-,-1,-1
TWOMEN.txt,93537,94282,745,10,N,N,-,-1,-1
TWOMEN.txt,93710,94361,651,10,N,N,-,-1,-1
TWOMEN.txt,93774,94369,595,10,N,N,-,-1,-1
TWOMEN.txt,93831,94512,681,10,N,N,-,-1,-1
TWOMEN.txt,93847,94564,717,10,N,N,-,-1,-1
TWOMEN.txt,93859,94629,770,10,N,N,-,-1,-1
TWOMEN.txt,93992,94809,817,10,N,N,-,-1,-1
TWOMEN.txt,94070,94875,805,10,N,N,-,-1,-1
TWOMEN.txt,94174,94897,723,10,N,N,-,-1,-1
TWOMEN.txt,94242,94910,668,10,N,N,-,-1,-1
TWOMEN.txt,94283,94913,630,10,N,N,-,-1,-1
TWOMEN.txt,94361,94919,558,10,N,N,-,-1,-1
TWOMEN.txt,94371,94931,560,10,N,N,-,-1,-1
TWOMEN.txt,94513,95011,498,10,N,N,-,-1,-1
TWOMEN.txt,94565,95289,724,10,N,N,-,-1,-1
TWOMEN.txt,94630,95381,751,10,N,N,-,-1,-1
TWOMEN.txt,94810,95511,701,10,N,N,-,-1,-1
TWOMEN.txt,94878,95553,675,10,N,N,-,-1,-1
TWOMEN.txt,94898,95690,792,10,N,N,-,-1,-1
TWOMEN.txt,94912,95845,933,10,N,N,-,-1,-1
TWOMEN.txt,94913,95912,999,10,N,N,-,-1,-1
TWOMEN.txt,94921,95930,1009,10,N,N,-,-1,-1
TWOMEN.txt,94933,95947,1014,10,N,N,-,-1,-1
TWOMEN.txt,95012,96269,1257,10,N,N,-,-1,-1
TWOMEN.txt,95291,96536,1245,10,N,N,-,-1,-1
TWOMEN.txt,95381,96720,1339,10,N,N,-,-1,-1
TWOMEN.txt,95512,96823,1311,10,N,N,-,-1,-1
TWOMEN.txt,95554,97174,1620,10,N,N,-,-1,-1
TWOMEN.txt,95691,97195,1504,10,N,N,-,-1,-1
TWOMEN.txt,95846,97250,1404,10,N,N,-,-1,-1
TWOMEN.txt,95914,97271,1357,10,N,N,-,-1,-1
TWOMEN.txt,95931,97292,1361,10,N,N,-,-1,-1
TWOMEN.txt,95949,97339,1390,10,N,N,-,-1,-1
TWOMEN.txt,96270,97740,1470,10,N,N,-,-1,-1
TWOMEN.txt,96537,97820,1283,10,N,N,-,-1,-1
TWOMEN.txt,96721,97886,1165,10,N,N,-,-1,-1
TWOMEN.txt,96825,97914,1089,10,N,N,-,-1,-1
TWOMEN.txt,97176,97936,760,10,N,N,-,-1,-1
TWOMEN.txt,97200,97979,779,10,N,N,-,-1,-1
TWOMEN.txt,97251,98063,812,10,N,N,-,-1,-1
TWOMEN.txt,97273,98258,985,10,N,N,-,-1,-1
TWOMEN.txt,97294,98427,1133,10,N,N,-,-1,-1
TWOMEN.txt,97340,98501,1161,10,N,N,-,-1,-1
TWOMEN.txt,97741,98709,968,10,N,N,-,-1,-1
TWOMEN.txt,97821,98760,939,10,N,N,-,-1,-1
TWOMEN.txt,97889,98983,1094,10,N,N,-,-1,-1
TWOMEN.txt,97916,99217,1301,10,N,N,-,-1,-1
TWOMEN.txt,97938,99367,1429,10,N,N,-,-1,-1
TWOMEN.txt,97980,99647,1667,10,N,N,-,-1,-1
TWOMEN.txt,98064,99653,1589,10,N,N,-,-1,-1
TWOMEN.txt,98259,99658,1399,10,N,N,-,-1,-1
TWOMEN.txt,98428,99668,1240,10,N,N,-,-1,-1
TWOMEN.txt,98503,99679,1176,10,N,N,-,-1,-1
TWOMEN.txt,98710,99686,976,10,N,N,-,-1,-1
TWOMEN.txt,98761,99728,967,10,N,N,-,-1,-1
TWOMEN.txt,98984,99984,1000,10,N,N,-,-1,-1
TWOMEN.txt,99219,100018,799,10,N,N,-,-1,-1
TWOMEN.txt,99368,100035,667,10,N,N,-,-1,-1
TWOMEN.txt,99650,100173,523,10,N,N,-,-1,-1
TWOMEN.txt,99653,100719,1066,10,N,N,-,-1,-1
TWOMEN.txt,99659,100835,1176,10,N,N,-,-1,-1
TWOMEN.txt,99668,100976,1308,10,N,N,-,-1,-1
TWOMEN.txt,99680,101023,1343,10,N,N,-,-1,-1
TWOMEN.txt,99688,101050,1362,10,N,N,-,-1,-1
TWOMEN.txt,99729,101066,1337,10,N,N,-,-1,-1
TWOMEN.txt,99985,101149,1164,10,N,N,-,-1,-1
TWOMEN.txt,100020,101268,1248,10,N,N,-,-1,-1
TWOMEN.txt,100036,101288,1252,10,N,N,-,-1,-1
TWOMEN.txt,100174,101325,1151,10,N,N,-,-1,-1
TWOMEN.txt,100720,101412,692,10,N,N,-,-1,-1
TWOMEN.txt,100837,101652,815,10,N,N,-,-1,-1
TWOMEN.txt,100977,101841,864,10,N,N,-,-1,-1
TWOMEN.txt,101026,101842,816,10,N,N,-,-1,-1
TWOMEN.txt,101053,101903,850,10,N,N,-,-1,-1
TWOMEN.txt,101068,101954,886,10,N,N,-,-1,-1
TWOMEN.txt,101150,102098,948,10,N,N,-,-1,-1
TWOMEN.txt,101270,102209,939,10,N,N,-,-1,-1
TWOMEN.txt,101289,102259,970,10,N,N,-,-1,-1
TWOMEN.txt,101327,102354,1027,10,N,N,-,-1,-1
TWOMEN.txt,101413,102429,1016,10,N,N,-,-1,-1
TWOMEN.txt,101653,102460,807,10,N,N,-,-1,-1
TWOMEN.txt,101841,102486,645,10,N,N,-,-1,-1
TWOMEN.txt,101844,102639,795,10,N,N,-,-1,-1
TWOMEN.txt,101906,102761,855,10,N,N,-,-1,-1
TWOMEN.txt,101956,102843,887,10,N,N,-,-1,-1
TWOMEN.txt,102099,103133,1034,10,N,N,-,-1,-1
TWOMEN.txt,102210,103236,1026,10,N,N,-,-1,-1
TWOMEN.txt,102261,103242,981,10,N,N,-,-1,-1
TWOMEN.txt,102355,103245,890,10,N,N,-,-1,-1
TWOMEN.txt,102434,103263,829,10,N,N,-,-1,-1
TWOMEN.txt,102461,103306,845,10,N,N,-,-1,-1
TWOMEN.txt,102487,103342,855,10,N,N,-,-1,-1
TWOMEN.txt,102640,103390,750,10,N,N,-,-1,-1
TWOMEN.txt,102762,103492,730,10,N,N,-,-1,-1
TWOMEN.txt,102845,103773,928,10,N,N,-,-1,-1
TWOMEN.txt,103135,104052,917,10,N,N,-,-1,-1
TWOMEN.txt,103241,104178,937,10,N,N,-,-1,-1
TWOMEN.txt,103244,104364,1120,10,N,N,-,-1,-1
TWOMEN.txt,103246,104383,1137,10,N,N,-,-1,-1
TWOMEN.txt,103264,104414,1150,10,N,N,-,-1,-1
TWOMEN.txt,103307,104572,1265,10,N,N,-,-1,-1
TWOMEN.txt,103343,104618,1275,10,N,N,-,-1,-1
TWOMEN.txt,103391,104750,1359,10,N,N,-,-1,-1
TWOMEN.txt,103493,105096,1603,10,N,N,-,-1,-1
TWOMEN.txt,103775,105286,1511,10,N,N,-,-1,-1
TWOMEN.txt,104053,105386,1333,10,N,N,-,-1,-1
TWOMEN.txt,104180,105702,1522,10,N,N,-,-1,-1
TWOMEN.txt,104367,106088,1721,10,N,N,-,-1,-1
TWOMEN.txt,104384,106247,1863,10,N,N,-,-1,-1
TWOMEN.txt,104415,106456,2041,10,N,N,-,-1,-1
TWOMEN.txt,104573,106583,2010,10,N,N,-,-1,-1
TWOMEN.txt,104619,106630,2011,10,N,N,-,-1,-1
TWOMEN.txt,104751,106735,1984,10,N,N,-,-1,-1
TWOMEN.txt,105097,106879,1782,10,N,N,-,-1,-1
TWOMEN.txt,105287,107006,1719,10,N,N,-,-1,-1
TWOMEN.txt,105387,107243,1856,10,N,N,-,-1,-1
TWOMEN.txt,105704,107290,1586,10,N,N,-,-1,-1
TWOMEN.txt,106090,107525,1435,10,N,N,-,-1,-1
TWOMEN.txt,106248,107739,1491,10,N,N,-,-1,-1
TWOMEN.txt,106458,107813,1355,10,N,N,-,-1,-1
TWOMEN.txt,106584,108138,1554,10,N,N,-,-1,-1
TWOMEN.txt,106632,108273,1641,10,N,N,-,-1,-1
TWOMEN.txt,106736,108367,1631,10,N,N,-,-1,-1
TWOMEN.txt,106880,108930,2050,10,N,N,-,-1,-1
TWOMEN.txt,107007,108957,1950,10,N,N,-,-1,-1
TWOMEN.txt,107244,109106,1862,10,N,N,-,-1,-1
TWOMEN.txt,107291,109187,1896,10,N,N,-,-1,-1
TWOMEN.txt,107527,109265,1738,10,N,N,-,-1,-1
TWOMEN.txt,107741,109537,1796,10,N,N,-,-1,-1
TWOMEN.txt,107814,109591,1777,10,N,N,-,-1,-1
TWOMEN.txt,108139,109632,1493,10,N,N,-,-1,-1
TWOMEN.txt,108275,109662,1387,10,N,N,-,-1,-1
TWOMEN.txt,108368,109782,1414,10,N,N,-,-1,-1
TWOMEN.txt,108933,110108,1175,10,N,N,-,-1,-1
TWOMEN.txt,108959,110162,1203,10,N,N,-,-1,-1
TWOMEN.txt,109107,110285,1178,10,N,N,-,-1,-1
TWOMEN.txt,109188,110476,1288,10,N,N,-,-1,-1
TWOMEN.txt,109266,110595,1329,10,N,N,-,-1,-1
TWOMEN.txt,109539,110783,1244,10,N,N,-,-1,-1
TWOMEN.txt,109596,111163,1567,10,N,N,-,-1,-1
TWOMEN.txt,109634,111184,1550,10,N,N,-,-1,-1
TWOMEN.txt,109664,111197,1533,10,N,N,-,-1,-1
TWOMEN.txt,109784,111248,1464,10,N,N,-,-1,-1
TWOMEN.txt,110110,111268,1158,10,N,N,-,-1,-1
TWOMEN.txt,110164,111380,1216,10,N,N,-,-1,-1
TWOMEN.txt,110286,111393,1107,10,N,N,-,-1,-1
TWOMEN.txt,110477,111487,1010,10,N,N,-,-1,-1
TWOMEN.txt,110597,111578,981,10,N,N,-,-1,-1
TWOMEN.txt,110785,111593,808,10,N,N,-,-1,-1
TWOMEN.txt,111168,111703,535,10,N,N,-,-1,-1
TWOMEN.txt,111185,111810,625,10,N,N,-,-1,-1
TWOMEN.txt,111198,111819,621,10,N,N,-,-1,-1
TWOMEN.txt,111250,111967,717,10,N,N,-,-1,-1
TWOMEN.txt,111270,112108,838,10,N,N,-,-1,-1
TWOMEN.txt,111384,112125,741,10,N,N,-,-1,-1
TWOMEN.txt,111394,112204,810,10,N,N,-,-1,-1
TWOMEN.txt,111489,112273,784,10,N,N,-,-1,-1
TWOMEN.txt,111579,112517,938,10,N,N,-,-1,-1
TWOMEN.txt,111595,112620,1025,10,N,N,-,-1,-1
TWOMEN.txt,111705,112869,1164,10,N,N,-,-1,-1
TWOMEN.txt,111812,112962,1150,10,N,N,-,-1,-1
TWOMEN.txt,111832,113056,1224,10,N,N,-,-1,-1
TWOMEN.txt,111969,113170,1201,10,N,N,-,-1,-1
TWOMEN.txt,112109,113233,1124,10,N,N,-,-1,-1
TWOMEN.txt,112127,113300,1173,10,N,N,-,-1,-1
TWOMEN.txt,112205,113305,1100,10,N,N,-,-1,-1
TWOMEN.txt,112274,113310,1036,10,N,N,-,-1,-1
TWOMEN.txt,112519,113331,812,10,N,N,-,-1,-1
TWOMEN.txt,112622,113349,727,10,N,N,-,-1,-1
TWOMEN.txt,112871,113383,512,10,N,N,-,-1,-1
TWOMEN.txt,112964,113444,480,10,N,N,-,-1,-1
TWOMEN.txt,113058,113544,486,10,N,N,-,-1,-1
TWOMEN.txt,113171,113658,487,10,N,N,-,-1,-1
TWOMEN.txt,113235,113922,687,10,N,N,-,-1,-1
TWOMEN.txt,113301,114112,811,10,N,N,-,-1,-1
TWOMEN.txt,113306,114238,932,10,N,N,-,-1,-1
TWOMEN.txt,113311,114415,1104,10,N,N,-,-1,-1
TWOMEN.txt,113335,114485,1150,10,N,N,-,-1,-1
TWOMEN.txt,113350,114550,1200,10,N,N,-,-1,-1
TWOMEN.txt,113385,114715,1330,10,N,N,-,-1,-1
TWOMEN.txt,113446,114740,1294,10,N,N,-,-1,-1
TWOMEN.txt,113546,114886,1340,10,N,N,-,-1,-1
TWOMEN.txt,113660,115049,1389,10,N,N,-,-1,-1
TWOMEN.txt,113924,115361,1437,10,N,N,-,-1,-1
TWOMEN.txt,114113,115506,1393,10,N,N,-,-1,-1
TWOMEN.txt,114239,115771,1532,10,N,N,-,-1,-1
TWOMEN.txt,114416,115891,1475,10,N,N,-,-1,-1
TWOMEN.txt,114486,115987,1501,10,N,N,-,-1,-1
TWOMEN.txt,114551,116104,1553,10,N,N,-,-1,-1
TWOMEN.txt,114716,116173,1457,10,N,N,-,-1,-1
TWOMEN.txt,114741,116282,1541,10,N,N,-,-1,-1
TWOMEN.txt,114887,116320,1433,10,N,N,-,-1,-1
TWOMEN.txt,115050,116419,1369,10,N,N,-,-1,-1
TWOMEN.txt,115363,116555,1192,10,N,N,-,-1,-1
TWOMEN.txt,115507,116732,1225,10,N,N,-,-1,-1
TWOMEN.txt,115772,116831,1059,10,N,N,-,-1,-1
TWOMEN.txt,115893,116945,1052,10,N,N,-,-1,-1
TWOMEN.txt,115988,117129,1141,10,N,N,-,-1,-1
TWOMEN.txt,116105,117279,1174,10,N,N,-,-1,-1
TWOMEN.txt,116174,117324,1150,10,N,N,-,-1,-1
TWOMEN.txt,116283,117439,1156,10,N,N,-,-1,-1
TWOMEN.txt,116321,117462,1141,10,N,N,-,-1,-1
TWOMEN.txt,116421,117676,1255,10,N,N,-,-1,-1
TWOMEN.txt,116556,117868,1312,10,N,N,-,-1,-1
TWOMEN.txt,116734,118052,1318,10,N,N,-,-1,-1
TWOMEN.txt,116834,118308,1474,10,N,N,-,-1,-1
TWOMEN.txt,116946,118365,1419,10,N,N,-,-1,-1
TWOMEN.txt,117131,118506,1375,10,N,N,-,-1,-1
TWOMEN.txt,117280,118602,1322,10,N,N,-,-1,-1
TWOMEN.txt,117326,118772,1446,10,N,N,-,-1,-1
TWOMEN.txt,117441,118859,1418,10,N,N,-,-1,-1
TWOMEN.txt,117467,118934,1467,10,N,N,-,-1,-1
TWOMEN.txt,117679,119052,1373,10,N,N,-,-1,-1
TWOMEN.txt,117869,119160,1291,10,N,N,-,-1,-1
TWOMEN.txt,118054,119401,1347,10,N,N,-,-1,-1
TWOMEN.txt,118311,119577,1266,10,N,N,-,-1,-1
TWOMEN.txt,118367,119795,1428,10,N,N,-,-1,-1
TWOMEN.txt,118508,120417,1909,10,N,N,-,-1,-1
TWOMEN.txt,118604,120450,1846,10,N,N,-,-1,-1
TWOMEN.txt,118773,120523,1750,10,N,N,-,-1,-1
TWOMEN.txt,118861,120710,1849,10,N,N,-,-1,-1
TWOMEN.txt,118934,120722,1788,10,N,N,-,-1,-1
TWOMEN.txt,119053,120787,1734,10,N,N,-,-1,-1
TWOMEN.txt,119161,120936,1775,10,N,N,-,-1,-1
TWOMEN.txt,119402,121107,1705,10,N,N,-,-1,-1
TWOMEN.txt,119578,121413,1835,10,N,N,-,-1,-1
TWOMEN.txt,119797,121545,1748,10,N,N,-,-1,-1
TWOMEN.txt,120420,121654,1234,10,N,N,-,-1,-1
TWOMEN.txt,120452,121846,1394,10,N,N,-,-1,-1
TWOMEN.txt,120524,121929,1405,10,N,N,-,-1,-1
TWOMEN.txt,120712,121993,1281,10,N,N,-,-1,-1
TWOMEN.txt,120723,122452,1729,10,N,N,-,-1,-1
TWOMEN.txt,120788,122571,1783,10,N,N,-,-1,-1
TWOMEN.txt,120937,122601,1664,10,N,N,-,-1,-1
TWOMEN.txt,121108,122735,1627,10,N,Y,1436867017136,105674,106651
TWOMEN.txt,121415,122854,1439,10,N,Y,1436867017136,105674,106651
TWOMEN.txt,121546,122906,1360,10,N,Y,1436867017136,105674,106651
TWOMEN.txt,121656,123092,1436,10,N,Y,1436867017136,105674,106651
TWOMEN.txt,121847,123260,1413,10,N,Y,1436867017136,105674,106651
TWOMEN.txt,121931,123313,1382,10,N,Y,1436867017136,105674,106651
TWOMEN.txt,121994,123388,1394,10,N,Y,1436867017136,105674,106651
TWOMEN.txt,122454,123820,1366,10,N,Y,1436867017136,105674,106651
TWOMEN.txt,122572,123851,1279,10,N,Y,1436867017136,105674,106651
TWOMEN.txt,122606,123963,1357,10,N,Y,1436867017136,105674,106651
TWOMEN.txt,122736,124096,1360,10,N,Y,1436867017136,105674,106651
TWOMEN.txt,122855,124181,1326,10,N,Y,1436867017136,105674,106651
TWOMEN.txt,122907,124464,1557,10,N,Y,1436867017136,105674,106651
TWOMEN.txt,123094,124618,1524,10,N,Y,1436867017136,105674,106651
TWOMEN.txt,123261,124737,1476,10,N,N,-,-1,-1
TWOMEN.txt,123314,124926,1612,10,N,N,-,-1,-1
TWOMEN.txt,123389,125021,1632,10,N,N,-,-1,-1
TWOMEN.txt,123823,125044,1221,10,N,N,-,-1,-1
TWOMEN.txt,123853,125226,1373,10,N,N,-,-1,-1
TWOMEN.txt,123964,125567,1603,10,N,N,-,-1,-1
TWOMEN.txt,124097,125629,1532,10,N,Y,1437472380836,351899,352666
TWOMEN.txt,124183,125637,1454,10,N,Y,1437472380836,351899,352666
TWOMEN.txt,124465,125640,1175,10,N,Y,1437472380836,351899,352666
TWOMEN.txt,124619,125726,1107,10,N,Y,1437472380836,351899,352666
TWOMEN.txt,124738,125803,1065,10,N,Y,1437472380836,351899,352666
TWOMEN.txt,124928,125894,966,10,N,Y,1437472380836,351899,352666
TWOMEN.txt,125022,125957,935,10,N,Y,1437472380836,351899,352666
TWOMEN.txt,125046,125991,945,10,N,Y,1437472380836,351899,352666
TWOMEN.txt,125228,126132,904,10,N,Y,1437472380836,351899,352666
TWOMEN.txt,125570,126156,586,10,N,Y,1437472380836,351899,352666
TWOMEN.txt,125630,126232,602,10,N,Y,1437472380836,351899,352666
TWOMEN.txt,125637,126315,678,10,N,Y,1437472380836,351899,352666
TWOMEN.txt,125642,126366,724,10,N,Y,1437472380836,351899,352666
TWOMEN.txt,125727,126464,737,10,N,Y,1437472380836,351899,352666
TWOMEN.txt,125804,126589,785,10,N,Y,1437472380836,351899,352666
TWOMEN.txt,125895,126740,845,10,N,Y,1437472380836,351899,352666
TWOMEN.txt,125958,127003,1045,10,N,Y,1437472380836,351899,352666
TWOMEN.txt,125992,127133,1141,10,N,Y,1437472380836,351899,352666
TWOMEN.txt,126133,127418,1285,10,N,Y,1437472380836,351899,352666
TWOMEN.txt,126157,127441,1284,10,N,Y,1437472380836,351899,352666
TWOMEN.txt,126233,127594,1361,10,N,Y,1437472380836,351899,352666
TWOMEN.txt,126315,127639,1324,10,N,N,-,-1,-1
TWOMEN.txt,126368,127887,1519,10,N,N,-,-1,-1
TWOMEN.txt,126465,127988,1523,10,N,N,-,-1,-1
TWOMEN.txt,126590,128184,1594,10,N,N,-,-1,-1
TWOMEN.txt,126742,128275,1533,10,N,N,-,-1,-1
TWOMEN.txt,127004,128339,1335,10,N,N,-,-1,-1
TWOMEN.txt,127134,128397,1263,10,N,N,-,-1,-1
TWOMEN.txt,127419,128531,1112,10,N,N,-,-1,-1
TWOMEN.txt,127442,128579,1137,10,N,N,-,-1,-1
TWOMEN.txt,127595,128640,1045,10,N,N,-,-1,-1
TWOMEN.txt,127641,128643,1002,10,N,N,-,-1,-1
TWOMEN.txt,127892,128849,957,10,N,N,-,-1,-1
TWOMEN.txt,127989,128926,937,10,N,N,-,-1,-1
TWOMEN.txt,128185,129176,991,10,N,N,-,-1,-1
TWOMEN.txt,128277,129333,1056,10,N,N,-,-1,-1
TWOMEN.txt,128340,129531,1191,10,N,N,-,-1,-1
TWOMEN.txt,128399,129571,1172,10,N,N,-,-1,-1
TWOMEN.txt,128532,129689,1157,10,N,N,-,-1,-1
TWOMEN.txt,128579,129967,1388,10,N,N,-,-1,-1
TWOMEN.txt,128640,129978,1338,10,N,N,-,-1,-1
TWOMEN.txt,128644,130019,1375,10,N,N,-,-1,-1
TWOMEN.txt,128852,130021,1169,10,N,N,-,-1,-1
TWOMEN.txt,128927,130133,1206,10,N,N,-,-1,-1
TWOMEN.txt,129177,130160,983,10,N,N,-,-1,-1
TWOMEN.txt,129335,130356,1021,10,N,N,-,-1,-1
TWOMEN.txt,129532,130478,946,10,N,N,-,-1,-1
TWOMEN.txt,129573,130508,935,10,N,N,-,-1,-1
TWOMEN.txt,129694,130690,996,10,N,N,-,-1,-1
TWOMEN.txt,129969,130808,839,10,N,N,-,-1,-1
TWOMEN.txt,129979,130892,913,10,N,N,-,-1,-1
TWOMEN.txt,130020,130937,917,10,N,N,-,-1,-1
TWOMEN.txt,130021,131185,1164,10,N,N,-,-1,-1
TWOMEN.txt,130136,131388,1252,10,N,N,-,-1,-1
TWOMEN.txt,130161,131568,1407,10,N,N,-,-1,-1
TWOMEN.txt,130357,131604,1247,10,N,N,-,-1,-1
TWOMEN.txt,130480,131623,1143,10,N,N,-,-1,-1
TWOMEN.txt,130510,131627,1117,10,N,N,-,-1,-1
TWOMEN.txt,130692,131645,953,10,N,N,-,-1,-1
TWOMEN.txt,130809,131749,940,10,N,N,-,-1,-1
TWOMEN.txt,130893,131806,913,10,N,N,-,-1,-1
TWOMEN.txt,130938,131846,908,10,N,N,-,-1,-1
TWOMEN.txt,131186,131956,770,10,N,N,-,-1,-1
TWOMEN.txt,131390,133088,1698,10,N,N,-,-1,-1
TWOMEN.txt,131571,133431,1860,10,N,N,-,-1,-1
TWOMEN.txt,131606,133460,1854,10,N,N,-,-1,-1
TWOMEN.txt,131624,133740,2116,10,N,N,-,-1,-1
TWOMEN.txt,131628,133837,2209,10,N,N,-,-1,-1
TWOMEN.txt,131647,134027,2380,10,N,N,-,-1,-1
TWOMEN.txt,131750,134156,2406,10,N,N,-,-1,-1
TWOMEN.txt,131806,134462,2656,10,N,N,-,-1,-1
TWOMEN.txt,131847,134647,2800,10,N,N,-,-1,-1
TWOMEN.txt,131957,134761,2804,10,N,N,-,-1,-1
TWOMEN.txt,133089,134798,1709,10,N,N,-,-1,-1
TWOMEN.txt,133434,134801,1367,10,N,N,-,-1,-1
TWOMEN.txt,133462,135088,1626,10,N,N,-,-1,-1
TWOMEN.txt,133742,135181,1439,10,N,N,-,-1,-1
TWOMEN.txt,133838,135295,1457,10,N,N,-,-1,-1
TWOMEN.txt,134029,135399,1370,10,N,N,-,-1,-1
TWOMEN.txt,134157,135635,1478,10,N,N,-,-1,-1
TWOMEN.txt,134464,135648,1184,10,N,N,-,-1,-1
TWOMEN.txt,134648,135666,1018,10,N,N,-,-1,-1
TWOMEN.txt,134762,135867,1105,10,N,N,-,-1,-1
TWOMEN.txt,134800,135880,1080,10,N,N,-,-1,-1
TWOMEN.txt,134806,135913,1107,10,N,N,-,-1,-1
TWOMEN.txt,135090,135951,861,10,N,N,-,-1,-1
TWOMEN.txt,135182,136099,917,10,N,N,-,-1,-1
TWOMEN.txt,135296,136216,920,10,N,N,-,-1,-1
TWOMEN.txt,135400,136318,918,10,N,N,-,-1,-1
TWOMEN.txt,135638,136343,705,10,N,N,-,-1,-1
TWOMEN.txt,135649,136459,810,10,N,N,-,-1,-1
TWOMEN.txt,135668,136736,1068,10,N,N,-,-1,-1
TWOMEN.txt,135870,136888,1018,10,N,N,-,-1,-1
TWOMEN.txt,135881,136952,1071,10,N,N,-,-1,-1
TWOMEN.txt,135917,137048,1131,10,N,N,-,-1,-1
TWOMEN.txt,135952,137217,1265,10,N,N,-,-1,-1
TWOMEN.txt,136100,137351,1251,10,N,N,-,-1,-1
TWOMEN.txt,136217,137545,1328,10,N,N,-,-1,-1
TWOMEN.txt,136323,137666,1343,10,N,N,-,-1,-1
TWOMEN.txt,136345,137857,1512,10,N,N,-,-1,-1
TWOMEN.txt,136460,137964,1504,10,N,N,-,-1,-1
TWOMEN.txt,136737,138125,1388,10,N,N,-,-1,-1
TWOMEN.txt,136890,138168,1278,10,N,N,-,-1,-1
TWOMEN.txt,136953,138213,1260,10,N,N,-,-1,-1
TWOMEN.txt,137049,138387,1338,10,N,N,-,-1,-1
TWOMEN.txt,137218,138472,1254,10,N,N,-,-1,-1
TWOMEN.txt,137353,138540,1187,10,N,N,-,-1,-1
TWOMEN.txt,137546,138588,1042,10,N,N,-,-1,-1
TWOMEN.txt,137667,138676,1009,10,N,N,-,-1,-1
TWOMEN.txt,137860,138719,859,10,N,N,-,-1,-1
TWOMEN.txt,137965,138810,845,10,N,N,-,-1,-1
TWOMEN.txt,138125,138880,755,10,N,N,-,-1,-1
TWOMEN.txt,138169,139045,876,10,N,N,-,-1,-1
TWOMEN.txt,138214,139213,999,10,N,N,-,-1,-1
TWOMEN.txt,138387,139322,935,10,N,N,-,-1,-1
TWOMEN.txt,138473,139390,917,10,N,N,-,-1,-1
TWOMEN.txt,138542,139490,948,10,N,N,-,-1,-1
TWOMEN.txt,138589,139557,968,10,N,N,-,-1,-1
TWOMEN.txt,138677,139579,902,10,N,N,-,-1,-1
TWOMEN.txt,138720,139582,862,10,N,N,-,-1,-1
TWOMEN.txt,138811,139599,788,10,N,N,-,-1,-1
TWOMEN.txt,138882,139620,738,10,N,N,-,-1,-1
TWOMEN.txt,139046,139671,625,10,N,N,-,-1,-1
TWOMEN.txt,139214,139692,478,10,N,N,-,-1,-1
TWOMEN.txt,139324,139799,475,10,N,N,-,-1,-1
TWOMEN.txt,139395,139863,468,10,N,N,-,-1,-1
TWOMEN.txt,139493,139890,397,10,N,N,-,-1,-1
TWOMEN.txt,139558,139911,353,10,N,N,-,-1,-1
TWOMEN.txt,139581,139939,358,10,N,N,-,-1,-1
TWOMEN.txt,139582,139995,413,10,N,N,-,-1,-1
TWOMEN.txt,139601,140107,506,10,N,N,-,-1,-1
TWOMEN.txt,139621,140142,521,10,N,N,-,-1,-1
TWOMEN.txt,139672,140240,568,10,N,N,-,-1,-1
TWOMEN.txt,139693,140294,601,10,N,N,-,-1,-1
TWOMEN.txt,139801,140325,524,10,N,N,-,-1,-1
TWOMEN.txt,139865,140347,482,10,N,N,-,-1,-1
TWOMEN.txt,139892,140443,551,10,N,N,-,-1,-1
TWOMEN.txt,139914,140561,647,10,N,N,-,-1,-1
TWOMEN.txt,139942,140763,821,10,N,N,-,-1,-1
TWOMEN.txt,139997,140818,821,10,N,N,-,-1,-1
TWOMEN.txt,140108,140891,783,10,N,N,-,-1,-1
TWOMEN.txt,140144,141003,859,10,N,N,-,-1,-1
TWOMEN.txt,140241,141024,783,10,N,N,-,-1,-1
TWOMEN.txt,140296,141047,751,10,N,N,-,-1,-1
TWOMEN.txt,140328,141065,737,10,N,N,-,-1,-1
TWOMEN.txt,140350,141138,788,10,N,N,-,-1,-1
TWOMEN.txt,140444,141207,763,10,N,N,-,-1,-1
TWOMEN.txt,140562,141293,731,10,N,N,-,-1,-1
TWOMEN.txt,140764,141318,554,10,N,N,-,-1,-1
TWOMEN.txt,140823,141397,574,10,N,N,-,-1,-1
TWOMEN.txt,140892,141513,621,10,N,N,-,-1,-1
TWOMEN.txt,141006,141520,514,10,N,N,-,-1,-1
TWOMEN.txt,141025,141523,498,10,N,N,-,-1,-1
TWOMEN.txt,141050,141664,614,10,N,N,-,-1,-1
TWOMEN.txt,141067,141788,721,10,N,N,-,-1,-1
TWOMEN.txt,141139,141870,731,10,N,N,-,-1,-1
TWOMEN.txt,141209,141917,708,10,N,N,-,-1,-1
TWOMEN.txt,141293,141928,635,10,N,N,-,-1,-1
TWOMEN.txt,141320,141944,624,10,N,N,-,-1,-1
TWOMEN.txt,141399,141978,579,10,N,N,-,-1,-1
TWOMEN.txt,141514,142093,579,10,N,N,-,-1,-1
TWOMEN.txt,141522,142382,860,10,N,N,-,-1,-1
TWOMEN.txt,141523,142539,1016,10,N,N,-,-1,-1
TWOMEN.txt,141665,142571,906,10,N,N,-,-1,-1
TWOMEN.txt,141791,142802,1011,10,N,N,-,-1,-1
TWOMEN.txt,141873,142910,1037,10,N,N,-,-1,-1
TWOMEN.txt,141918,142919,1001,10,N,N,-,-1,-1
TWOMEN.txt,141930,142953,1023,10,N,N,-,-1,-1
TWOMEN.txt,141946,142975,1029,10,N,N,-,-1,-1
TWOMEN.txt,141979,142986,1007,10,N,N,-,-1,-1
TWOMEN.txt,142096,142994,898,10,N,N,-,-1,-1
TWOMEN.txt,142384,143115,731,10,N,N,-,-1,-1
TWOMEN.txt,142541,143139,598,10,N,N,-,-1,-1
TWOMEN.txt,142574,143199,625,10,N,N,-,-1,-1
TWOMEN.txt,142803,143282,479,10,N,N,-,-1,-1
TWOMEN.txt,142911,143416,505,10,N,N,-,-1,-1
TWOMEN.txt,142920,143623,703,10,N,N,-,-1,-1
TWOMEN.txt,142956,143650,694,10,N,N,-,-1,-1
TWOMEN.txt,142976,143668,692,10,N,N,-,-1,-1
TWOMEN.txt,142989,143679,690,10,N,N,-,-1,-1
TWOMEN.txt,142994,143803,809,10,N,N,-,-1,-1
TWOMEN.txt,143116,144039,923,10,N,N,-,-1,-1
TWOMEN.txt,143140,144217,1077,10,N,N,-,-1,-1
TWOMEN.txt,143200,144224,1024,10,N,N,-,-1,-1
TWOMEN.txt,143284,144300,1016,10,N,N,-,-1,-1
TWOMEN.txt,143417,144393,976,10,N,N,-,-1,-1
TWOMEN.txt,143625,144529,904,10,N,N,-,-1,-1
TWOMEN.txt,143653,144597,944,10,N,N,-,-1,-1
TWOMEN.txt,143669,144640,971,10,N,N,-,-1,-1
TWOMEN.txt,143681,144689,1008,10,N,Y,1437476486340,221621,222520
TWOMEN.txt,143805,144692,887,10,N,Y,1437476486340,221621,222520
TWOMEN.txt,144041,144787,746,10,N,Y,1437476486340,221621,222520
TWOMEN.txt,144217,144928,711,10,N,Y,1437476486340,221621,222520
TWOMEN.txt,144224,144953,729,10,N,Y,1437476486340,221621,222520
TWOMEN.txt,144301,145009,708,10,N,Y,1437476486340,221621,222520
TWOMEN.txt,144395,145057,662,10,N,Y,1437476486340,221621,222520
TWOMEN.txt,144530,145070,540,10,N,Y,1437476486340,221621,222520
TWOMEN.txt,144598,145106,508,10,N,Y,1437476486340,221621,222520
TWOMEN.txt,144642,145158,516,10,N,Y,1437476486340,221621,222520
TWOMEN.txt,144689,145240,551,10,N,Y,1437476486340,221621,222520
TWOMEN.txt,144693,145311,618,10,N,Y,1437476486340,221621,222520
TWOMEN.txt,144788,145475,687,10,N,Y,1437476486340,221621,222520
TWOMEN.txt,144930,145504,574,10,N,Y,1437476486340,221621,222520
TWOMEN.txt,144954,145568,614,10,N,Y,1437476486340,221621,222520
TWOMEN.txt,145014,145662,648,10,N,N,-,-1,-1
TWOMEN.txt,145058,145716,658,10,N,N,-,-1,-1
TWOMEN.txt,145072,145754,682,10,N,N,-,-1,-1
TWOMEN.txt,145107,145790,683,10,N,N,-,-1,-1
TWOMEN.txt,145159,145817,658,10,N,N,-,-1,-1
TWOMEN.txt,145241,146060,819,10,N,N,-,-1,-1
TWOMEN.txt,145313,146067,754,10,N,N,-,-1,-1
TWOMEN.txt,145475,146132,657,10,N,N,-,-1,-1
TWOMEN.txt,145505,146278,773,10,N,N,-,-1,-1
TWOMEN.txt,145569,146299,730,10,N,N,-,-1,-1
TWOMEN.txt,145663,146426,763,10,N,N,-,-1,-1
TWOMEN.txt,145717,146529,812,10,N,N,-,-1,-1
TWOMEN.txt,145754,146533,779,10,N,N,-,-1,-1
TWOMEN.txt,145791,146543,752,10,N,N,-,-1,-1
TWOMEN.txt,145819,146559,740,10,N,N,-,-1,-1
TWOMEN.txt,146060,146617,557,10,N,N,-,-1,-1
TWOMEN.txt,146067,146636,569,10,N,N,-,-1,-1
TWOMEN.txt,146134,146709,575,10,N,N,-,-1,-1
TWOMEN.txt,146279,146772,493,10,N,N,-,-1,-1
TWOMEN.txt,146301,146794,493,10,N,N,-,-1,-1
TWOMEN.txt,146427,146805,378,10,N,N,-,-1,-1
TWOMEN.txt,146530,146943,413,10,N,N,-,-1,-1
TWOMEN.txt,146534,147026,492,10,N,N,-,-1,-1
TWOMEN.txt,146545,147101,556,10,N,N,-,-1,-1
TWOMEN.txt,146561,147235,674,10,N,N,-,-1,-1
TWOMEN.txt,146618,147268,650,10,N,N,-,-1,-1
TWOMEN.txt,146637,147307,670,10,N,N,-,-1,-1
TWOMEN.txt,146710,147386,676,10,N,N,-,-1,-1
TWOMEN.txt,146775,147419,644,10,N,N,-,-1,-1
TWOMEN.txt,146795,147545,750,10,N,N,-,-1,-1
TWOMEN.txt,146807,147582,775,10,N,N,-,-1,-1
TWOMEN.txt,146944,147671,727,10,N,N,-,-1,-1
TWOMEN.txt,147027,147693,666,10,N,N,-,-1,-1
TWOMEN.txt,147102,147704,602,10,N,N,-,-1,-1
TWOMEN.txt,147236,147850,614,10,N,N,-,-1,-1
TWOMEN.txt,147269,147874,605,10,N,N,-,-1,-1
TWOMEN.txt,147308,147932,624,10,N,N,-,-1,-1
TWOMEN.txt,147388,147938,550,10,N,N,-,-1,-1
TWOMEN.txt,147419,147961,542,10,N,N,-,-1,-1
TWOMEN.txt,147546,148000,454,10,N,N,-,-1,-1
TWOMEN.txt,147583,148040,457,10,N,N,-,-1,-1
TWOMEN.txt,147674,148054,380,10,N,N,-,-1,-1
TWOMEN.txt,147694,148257,563,10,N,N,-,-1,-1
TWOMEN.txt,147707,148286,579,10,N,N,-,-1,-1
TWOMEN.txt,147851,148492,641,10,N,N,-,-1,-1
TWOMEN.txt,147875,148548,673,10,N,N,-,-1,-1
TWOMEN.txt,147934,148692,758,10,N,N,-,-1,-1
TWOMEN.txt,147939,148708,769,10,N,N,-,-1,-1
TWOMEN.txt,147962,148720,758,10,N,N,-,-1,-1
TWOMEN.txt,148005,148737,732,10,N,N,-,-1,-1
TWOMEN.txt,148041,148742,701,10,N,N,-,-1,-1
TWOMEN.txt,148054,148765,711,10,N,N,-,-1,-1
TWOMEN.txt,148258,149103,845,10,N,N,-,-1,-1
TWOMEN.txt,148287,149142,855,10,N,N,-,-1,-1
TWOMEN.txt,148494,149270,776,10,N,N,-,-1,-1
TWOMEN.txt,148550,149311,761,10,N,N,-,-1,-1
TWOMEN.txt,148694,149342,648,10,N,N,-,-1,-1
TWOMEN.txt,148709,149421,712,10,N,N,-,-1,-1
TWOMEN.txt,148723,149426,703,10,N,N,-,-1,-1
TWOMEN.txt,148739,149441,702,10,N,N,-,-1,-1
TWOMEN.txt,148743,149524,781,10,N,N,-,-1,-1
TWOMEN.txt,148766,149609,843,10,N,N,-,-1,-1
TWOMEN.txt,149104,149667,563,10,N,N,-,-1,-1
TWOMEN.txt,149144,149668,524,10,N,N,-,-1,-1
TWOMEN.txt,149271,149679,408,10,N,N,-,-1,-1
TWOMEN.txt,149312,149713,401,10,N,N,-,-1,-1
TWOMEN.txt,149343,149798,455,10,N,N,-,-1,-1
TWOMEN.txt,149423,149822,399,10,N,N,-,-1,-1
TWOMEN.txt,149427,149843,416,10,N,N,-,-1,-1
TWOMEN.txt,149442,149860,418,10,N,N,-,-1,-1
TWOMEN.txt,149525,149876,351,10,N,N,-,-1,-1
TWOMEN.txt,149614,149964,350,10,N,N,-,-1,-1
TWOMEN.txt,149667,150023,356,10,N,N,-,-1,-1
TWOMEN.txt,149669,150094,425,10,N,N,-,-1,-1
TWOMEN.txt,149682,150321,639,10,N,N,-,-1,-1
TWOMEN.txt,149715,150434,719,10,N,N,-,-1,-1
TWOMEN.txt,149799,150472,673,10,N,N,-,-1,-1
TWOMEN.txt,149825,150647,822,10,N,N,-,-1,-1
TWOMEN.txt,149844,150701,857,10,N,N,-,-1,-1
TWOMEN.txt,149863,150736,873,10,N,N,-,-1,-1
TWOMEN.txt,149878,150783,905,10,N,N,-,-1,-1
TWOMEN.txt,149965,150882,917,10,N,N,-,-1,-1
TWOMEN.txt,150025,150928,903,10,N,N,-,-1,-1
TWOMEN.txt,150095,150951,856,10,N,N,-,-1,-1
TWOMEN.txt,150322,150998,676,10,N,N,-,-1,-1
TWOMEN.txt,150435,151011,576,10,N,N,-,-1,-1
TWOMEN.txt,150474,151132,658,10,N,N,-,-1,-1
TWOMEN.txt,150648,151331,683,10,N,N,-,-1,-1
TWOMEN.txt,150702,151392,690,10,N,N,-,-1,-1
TWOMEN.txt,150737,151471,734,10,N,N,-,-1,-1
TWOMEN.txt,150784,151616,832,10,N,N,-,-1,-1
TWOMEN.txt,150883,151659,776,10,N,N,-,-1,-1
TWOMEN.txt,150931,151677,746,10,N,N,-,-1,-1
TWOMEN.txt,150956,151808,852,10,N,N,-,-1,-1
TWOMEN.txt,150999,151879,880,10,N,N,-,-1,-1
TWOMEN.txt,151013,151929,916,10,N,N,-,-1,-1
TWOMEN.txt,151133,151978,845,10,N,N,-,-1,-1
TWOMEN.txt,151333,152018,685,10,N,N,-,-1,-1
TWOMEN.txt,151395,152039,644,10,N,N,-,-1,-1
TWOMEN.txt,151472,152051,579,10,N,N,-,-1,-1
TWOMEN.txt,151618,152061,443,10,N,N,-,-1,-1
TWOMEN.txt,151660,152068,408,10,N,N,-,-1,-1
TWOMEN.txt,151678,152115,437,10,N,N,-,-1,-1
TWOMEN.txt,151809,152212,403,10,N,N,-,-1,-1
TWOMEN.txt,151881,152244,363,10,N,N,-,-1,-1
TWOMEN.txt,151930,152404,474,10,N,N,-,-1,-1
TWOMEN.txt,151979,152488,509,10,N,N,-,-1,-1
TWOMEN.txt,152021,152543,522,10,N,N,-,-1,-1
TWOMEN.txt,152040,152557,517,10,N,N,-,-1,-1
TWOMEN.txt,152054,152564,510,10,N,N,-,-1,-1
TWOMEN.txt,152062,152577,515,10,N,N,-,-1,-1
TWOMEN.txt,152070,152715,645,10,N,N,-,-1,-1
TWOMEN.txt,152117,152785,668,10,N,N,-,-1,-1
TWOMEN.txt,152214,152839,625,10,N,N,-,-1,-1
TWOMEN.txt,152245,153019,774,10,N,N,-,-1,-1
TWOMEN.txt,152408,153101,693,10,N,N,-,-1,-1
TWOMEN.txt,152493,153132,639,10,N,N,-,-1,-1
TWOMEN.txt,152544,153154,610,10,N,N,-,-1,-1
TWOMEN.txt,152559,153164,605,10,N,N,-,-1,-1
TWOMEN.txt,152565,153178,613,10,N,N,-,-1,-1
TWOMEN.txt,152579,153292,713,10,N,N,-,-1,-1
TWOMEN.txt,152716,153385,669,10,N,N,-,-1,-1
TWOMEN.txt,152786,153409,623,10,N,N,-,-1,-1
TWOMEN.txt,152841,153420,579,10,N,N,-,-1,-1
TWOMEN.txt,153020,153437,417,10,N,N,-,-1,-1
TWOMEN.txt,153102,153490,388,10,N,N,-,-1,-1
TWOMEN.txt,153135,153507,372,10,N,N,-,-1,-1
TWOMEN.txt,153155,153572,417,10,N,N,-,-1,-1
TWOMEN.txt,153166,153598,432,10,N,N,-,-1,-1
TWOMEN.txt,153180,153727,547,10,N,N,-,-1,-1
TWOMEN.txt,153294,153964,670,10,N,N,-,-1,-1
TWOMEN.txt,153389,153989,600,10,N,N,-,-1,-1
TWOMEN.txt,153410,153993,583,10,N,N,-,-1,-1
TWOMEN.txt,153422,154087,665,10,N,N,-,-1,-1
TWOMEN.txt,153439,154190,751,10,N,N,-,-1,-1
TWOMEN.txt,153491,154244,753,10,N,N,-,-1,-1
TWOMEN.txt,153508,154349,841,10,N,N,-,-1,-1
TWOMEN.txt,153573,154369,796,10,N,N,-,-1,-1
TWOMEN.txt,153599,154380,781,10,N,N,-,-1,-1
TWOMEN.txt,153729,154478,749,10,N,N,-,-1,-1
TWOMEN.txt,153966,154516,550,10,N,N,-,-1,-1
TWOMEN.txt,153990,154632,642,10,N,N,-,-1,-1
TWOMEN.txt,153998,154726,728,10,N,N,-,-1,-1
TWOMEN.txt,154088,154915,827,10,N,N,-,-1,-1
TWOMEN.txt,154192,154985,793,10,N,N,-,-1,-1
TWOMEN.txt,154246,155122,876,10,N,N,-,-1,-1
TWOMEN.txt,154351,155130,779,10,N,N,-,-1,-1
TWOMEN.txt,154370,155157,787,10,N,N,-,-1,-1
TWOMEN.txt,154382,155270,888,10,N,N,-,-1,-1
TWOMEN.txt,154479,155414,935,10,N,N,-,-1,-1
TWOMEN.txt,154517,155596,1079,10,N,N,-,-1,-1
TWOMEN.txt,154634,155813,1179,10,N,N,-,-1,-1
TWOMEN.txt,154727,155830,1103,10,N,N,-,-1,-1
TWOMEN.txt,154916,155863,947,10,N,N,-,-1,-1
TWOMEN.txt,154987,155905,918,10,N,N,-,-1,-1
TWOMEN.txt,155123,155909,786,10,N,N,-,-1,-1
TWOMEN.txt,155131,155992,861,10,N,N,-,-1,-1
TWOMEN.txt,155160,156031,871,10,N,N,-,-1,-1
TWOMEN.txt,155271,156061,790,10,N,N,-,-1,-1
TWOMEN.txt,155415,156169,754,10,N,N,-,-1,-1
TWOMEN.txt,155597,156309,712,10,N,N,-,-1,-1
TWOMEN.txt,155814,156311,497,10,N,N,-,-1,-1
TWOMEN.txt,155831,156416,585,10,N,N,-,-1,-1
TWOMEN.txt,155865,156469,604,10,N,N,-,-1,-1
TWOMEN.txt,155908,156481,573,10,N,N,-,-1,-1
TWOMEN.txt,155910,156506,596,10,N,N,-,-1,-1
TWOMEN.txt,155993,156513,520,10,N,N,-,-1,-1
TWOMEN.txt,156032,156596,564,10,N,N,-,-1,-1
TWOMEN.txt,156062,156650,588,10,N,N,-,-1,-1
TWOMEN.txt,156171,156669,498,10,N,N,-,-1,-1
TWOMEN.txt,156310,156761,451,10,N,N,-,-1,-1
TWOMEN.txt,156311,156845,534,10,N,N,-,-1,-1
TWOMEN.txt,156417,157046,629,10,N,N,-,-1,-1
TWOMEN.txt,156469,157173,704,10,N,N,-,-1,-1
TWOMEN.txt,156483,157362,879,10,N,N,-,-1,-1
TWOMEN.txt,156506,157441,935,10,N,N,-,-1,-1
TWOMEN.txt,156513,157515,1002,10,N,N,-,-1,-1
TWOMEN.txt,156598,157572,974,10,N,N,-,-1,-1
TWOMEN.txt,156652,157718,1066,10,N,N,-,-1,-1
TWOMEN.txt,156671,157795,1124,10,N,N,-,-1,-1
TWOMEN.txt,156762,157836,1074,10,N,N,-,-1,-1
TWOMEN.txt,156847,157919,1072,10,N,N,-,-1,-1
TWOMEN.txt,157047,157970,923,10,N,N,-,-1,-1
TWOMEN.txt,157174,158176,1002,10,N,N,-,-1,-1
TWOMEN.txt,157363,158250,887,10,N,N,-,-1,-1
TWOMEN.txt,157442,158329,887,10,N,N,-,-1,-1
TWOMEN.txt,157517,158426,909,10,N,N,-,-1,-1
TWOMEN.txt,157574,158465,891,10,N,N,-,-1,-1
TWOMEN.txt,157722,158562,840,10,N,N,-,-1,-1
TWOMEN.txt,157796,158685,889,10,N,N,-,-1,-1
TWOMEN.txt,157837,158825,988,10,N,N,-,-1,-1
TWOMEN.txt,157920,159086,1166,10,N,N,-,-1,-1
TWOMEN.txt,157971,159129,1158,10,N,N,-,-1,-1
TWOMEN.txt,158177,159135,958,10,N,N,-,-1,-1
TWOMEN.txt,158251,159265,1014,10,N,N,-,-1,-1
TWOMEN.txt,158330,159483,1153,10,N,N,-,-1,-1
TWOMEN.txt,158428,159502,1074,10,N,N,-,-1,-1
TWOMEN.txt,158466,159537,1071,10,N,Y,1437477878183,427206,428439
TWOMEN.txt,158567,159772,1205,10,N,Y,1437477878183,427206,428439
TWOMEN.txt,158686,159814,1128,10,N,Y,1437477878183,427206,428439
TWOMEN.txt,158826,159866,1040,10,N,Y,1437477878183,427206,428439
TWOMEN.txt,159087,159992,905,10,N,Y,1437477878183,427206,428439
TWOMEN.txt,159129,160126,997,10,N,Y,1437477878183,427206,428439
TWOMEN.txt,159138,160188,1050,10,N,Y,1437477878183,427206,428439
TWOMEN.txt,159266,160292,1026,10,N,Y,1437477878183,427206,428439
TWOMEN.txt,159485,160419,934,10,N,Y,1437477878183,427206,428439
TWOMEN.txt,159504,160541,1037,10,N,Y,1437477878183,427206,428439
TWOMEN.txt,159538,160638,1100,10,N,Y,1437477878183,427206,428439
TWOMEN.txt,159773,160909,1136,10,N,Y,1437477878183,427206,428439
TWOMEN.txt,159815,160949,1134,10,N,Y,1437477878183,427206,428439
TWOMEN.txt,159867,161063,1196,10,N,Y,1437477878183,427206,428439
TWOMEN.txt,159993,161076,1083,10,N,Y,1437477878183,427206,428439
TWOMEN.txt,160127,161144,1017,10,N,Y,1437477878183,427206,428439
TWOMEN.txt,160193,161224,1031,10,N,Y,1437477878183,427206,428439
TWOMEN.txt,160295,161296,1001,10,N,N,-,-1,-1
TWOMEN.txt,160421,161404,983,10,N,N,-,-1,-1
TWOMEN.txt,160543,161523,980,10,N,N,-,-1,-1
TWOMEN.txt,160639,161527,888,10,N,N,-,-1,-1
TWOMEN.txt,160911,161545,634,10,N,N,-,-1,-1
TWOMEN.txt,160950,161558,608,10,N,N,-,-1,-1
TWOMEN.txt,161067,161568,501,10,N,N,-,-1,-1
TWOMEN.txt,161078,161596,518,10,N,N,-,-1,-1
TWOMEN.txt,161145,161623,478,10,N,N,-,-1,-1
TWOMEN.txt,161225,161726,501,10,N,N,-,-1,-1
TWOMEN.txt,161297,161786,489,10,N,N,-,-1,-1
TWOMEN.txt,161405,161922,517,10,N,N,-,-1,-1
TWOMEN.txt,161526,162056,530,10,N,N,-,-1,-1
TWOMEN.txt,161528,162071,543,10,N,N,-,-1,-1
TWOMEN.txt,161546,162288,742,10,N,N,-,-1,-1
TWOMEN.txt,161560,162574,1014,10,N,N,-,-1,-1
TWOMEN.txt,161570,162693,1123,10,N,N,-,-1,-1
TWOMEN.txt,161598,162751,1153,10,N,N,-,-1,-1
TWOMEN.txt,161626,163124,1498,10,N,N,-,-1,-1
TWOMEN.txt,161728,163174,1446,10,N,N,-,-1,-1
TWOMEN.txt,161788,163236,1448,10,N,N,-,-1,-1
TWOMEN.txt,161923,163290,1367,10,N,N,-,-1,-1
TWOMEN.txt,162058,163358,1300,10,N,N,-,-1,-1
TWOMEN.txt,162073,163370,1297,10,N,N,-,-1,-1
TWOMEN.txt,162289,163447,1158,10,N,N,-,-1,-1
TWOMEN.txt,162575,163757,1182,10,N,N,-,-1,-1
TWOMEN.txt,162695,163892,1197,10,N,N,-,-1,-1
TWOMEN.txt,162752,164111,1359,10,N,N,-,-1,-1
TWOMEN.txt,163125,164196,1071,10,N,N,-,-1,-1
TWOMEN.txt,163176,164307,1131,10,N,N,-,-1,-1
TWOMEN.txt,163237,164388,1151,10,N,N,-,-1,-1
TWOMEN.txt,163291,164439,1148,10,N,N,-,-1,-1
TWOMEN.txt,163359,164611,1252,10,N,N,-,-1,-1
TWOMEN.txt,163375,164674,1299,10,N,N,-,-1,-1
TWOMEN.txt,163447,164717,1270,10,N,N,-,-1,-1
TWOMEN.txt,163758,164723,965,10,N,N,-,-1,-1
TWOMEN.txt,163893,164733,840,10,N,N,-,-1,-1
TWOMEN.txt,164113,164737,624,10,N,N,-,-1,-1
TWOMEN.txt,164197,164812,615,10,N,N,-,-1,-1
TWOMEN.txt,164308,164845,537,10,N,N,-,-1,-1
TWOMEN.txt,164390,164980,590,10,N,N,-,-1,-1
TWOMEN.txt,164440,165066,626,10,N,N,-,-1,-1
TWOMEN.txt,164616,165114,498,10,N,N,-,-1,-1
TWOMEN.txt,164675,165232,557,10,N,N,-,-1,-1
TWOMEN.txt,164719,165320,601,10,N,N,-,-1,-1
TWOMEN.txt,164724,165346,622,10,N,N,-,-1,-1
TWOMEN.txt,164734,165362,628,10,N,N,-,-1,-1
TWOMEN.txt,164737,165391,654,10,N,N,-,-1,-1
TWOMEN.txt,164813,165410,597,10,N,N,-,-1,-1
TWOMEN.txt,164847,165446,599,10,N,N,-,-1,-1
TWOMEN.txt,164981,165452,471,10,N,N,-,-1,-1
TWOMEN.txt,165067,165619,552,10,N,N,-,-1,-1
TWOMEN.txt,165116,165704,588,10,N,N,-,-1,-1
TWOMEN.txt,165234,165855,621,10,N,N,-,-1,-1
TWOMEN.txt,165321,165897,576,10,N,N,-,-1,-1
TWOMEN.txt,165348,165912,564,10,N,N,-,-1,-1
TWOMEN.txt,165363,165930,567,10,N,N,-,-1,-1
TWOMEN.txt,165394,165947,553,10,N,N,-,-1,-1
TWOMEN.txt,165411,165972,561,10,N,N,-,-1,-1
TWOMEN.txt,165448,165978,530,10,N,N,-,-1,-1
TWOMEN.txt,165454,166028,574,10,N,N,-,-1,-1
TWOMEN.txt,165620,166042,422,10,N,N,-,-1,-1
TWOMEN.txt,165706,166052,346,10,N,N,-,-1,-1
TWOMEN.txt,165856,166060,204,10,N,N,-,-1,-1
TWOMEN.txt,165898,166159,261,10,N,N,-,-1,-1
TWOMEN.txt,165914,166320,406,10,N,N,-,-1,-1
TWOMEN.txt,165931,166432,501,10,N,N,-,-1,-1
TWOMEN.txt,165948,166473,525,10,N,N,-,-1,-1
TWOMEN.txt,165974,166514,540,10,N,N,-,-1,-1
TWOMEN.txt,165983,166583,600,10,N,N,-,-1,-1
TWOMEN.txt,166029,166602,573,10,N,N,-,-1,-1
TWOMEN.txt,166044,166615,571,10,N,N,-,-1,-1
TWOMEN.txt,166054,166626,572,10,N,N,-,-1,-1
TWOMEN.txt,166062,166724,662,10,N,N,-,-1,-1
TWOMEN.txt,166161,166728,567,10,N,N,-,-1,-1
TWOMEN.txt,166321,167332,1011,10,N,N,-,-1,-1
TWOMEN.txt,166434,167338,904,10,N,N,-,-1,-1
TWOMEN.txt,166474,167441,967,10,N,N,-,-1,-1
TWOMEN.txt,166515,167477,962,10,N,N,-,-1,-1
TWOMEN.txt,166586,167736,1150,10,N,N,-,-1,-1
TWOMEN.txt,166603,167831,1228,10,N,N,-,-1,-1
TWOMEN.txt,166616,167870,1254,10,N,N,-,-1,-1
TWOMEN.txt,166628,167875,1247,10,N,N,-,-1,-1
TWOMEN.txt,166725,167913,1188,10,N,N,-,-1,-1
TWOMEN.txt,166729,168037,1308,10,N,N,-,-1,-1
TWOMEN.txt,167334,168211,877,10,N,N,-,-1,-1
TWOMEN.txt,167339,168232,893,10,N,N,-,-1,-1
TWOMEN.txt,167442,168275,833,10,N,N,-,-1,-1
TWOMEN.txt,167478,168490,1012,10,N,N,-,-1,-1
TWOMEN.txt,167737,168642,905,10,N,N,-,-1,-1
TWOMEN.txt,167831,168790,959,10,N,N,-,-1,-1
TWOMEN.txt,167871,168840,969,10,N,N,-,-1,-1
TWOMEN.txt,167876,168913,1037,10,N,N,-,-1,-1
TWOMEN.txt,167914,169014,1100,10,N,N,-,-1,-1
TWOMEN.txt,168038,169266,1228,10,N,N,-,-1,-1
TWOMEN.txt,168214,169442,1228,10,N,N,-,-1,-1
TWOMEN.txt,168233,169484,1251,10,N,N,-,-1,-1
TWOMEN.txt,168276,169524,1248,10,N,N,-,-1,-1
TWOMEN.txt,168492,169546,1054,10,N,N,-,-1,-1
TWOMEN.txt,168643,169562,919,10,N,N,-,-1,-1
TWOMEN.txt,168790,169579,789,10,N,N,-,-1,-1
TWOMEN.txt,168841,169584,743,10,N,N,-,-1,-1
TWOMEN.txt,168914,169646,732,10,N,N,-,-1,-1
TWOMEN.txt,169016,169747,731,10,N,N,-,-1,-1
TWOMEN.txt,169267,170000,733,10,N,N,-,-1,-1
TWOMEN.txt,169443,170087,644,10,N,N,-,-1,-1
TWOMEN.txt,169485,170189,704,10,N,N,-,-1,-1
TWOMEN.txt,169527,170208,681,10,N,N,-,-1,-1
TWOMEN.txt,169547,170485,938,10,N,N,-,-1,-1
TWOMEN.txt,169564,170557,993,10,N,N,-,-1,-1
TWOMEN.txt,169580,170814,1234,10,N,N,-,-1,-1
TWOMEN.txt,169586,170837,1251,10,N,N,-,-1,-1
TWOMEN.txt,169648,171005,1357,10,N,N,-,-1,-1
TWOMEN.txt,169748,171035,1287,10,N,N,-,-1,-1
TWOMEN.txt,170001,171080,1079,10,N,N,-,-1,-1
TWOMEN.txt,170088,171147,1059,10,N,N,-,-1,-1
TWOMEN.txt,170191,171173,982,10,N,N,-,-1,-1
TWOMEN.txt,170209,171192,983,10,N,N,-,-1,-1
TWOMEN.txt,170487,171216,729,10,N,N,-,-1,-1
TWOMEN.txt,170558,171223,665,10,N,N,-,-1,-1
TWOMEN.txt,170815,171297,482,10,N,N,-,-1,-1
TWOMEN.txt,170838,171419,581,10,N,N,-,-1,-1
TWOMEN.txt,171006,171466,460,10,N,N,-,-1,-1
TWOMEN.txt,171036,171657,621,10,N,N,-,-1,-1
TWOMEN.txt,171081,171777,696,10,N,N,-,-1,-1
TWOMEN.txt,171149,171852,703,10,N,N,-,-1,-1
TWOMEN.txt,171176,171870,694,10,N,N,-,-1,-1
TWOMEN.txt,171193,171920,727,10,N,N,-,-1,-1
TWOMEN.txt,171218,171942,724,10,N,N,-,-1,-1
TWOMEN.txt,171224,171966,742,10,N,N,-,-1,-1
TWOMEN.txt,171298,171980,682,10,N,N,-,-1,-1
TWOMEN.txt,171420,172349,929,10,N,N,-,-1,-1
TWOMEN.txt,171468,172385,917,10,N,N,-,-1,-1
TWOMEN.txt,171658,172612,954,10,N,N,-,-1,-1
TWOMEN.txt,171779,172730,951,10,N,N,-,-1,-1
TWOMEN.txt,171853,172776,923,10,N,N,-,-1,-1
TWOMEN.txt,171871,172796,925,10,N,N,-,-1,-1
TWOMEN.txt,171923,172819,896,10,N,N,-,-1,-1
TWOMEN.txt,171943,172835,892,10,N,N,-,-1,-1
TWOMEN.txt,171968,173064,1096,10,N,N,-,-1,-1
TWOMEN.txt,171981,173065,1084,10,N,N,-,-1,-1
TWOMEN.txt,172351,173120,769,10,N,N,-,-1,-1
TWOMEN.txt,172386,173212,826,10,N,N,-,-1,-1
TWOMEN.txt,172614,173246,632,10,N,N,-,-1,-1
TWOMEN.txt,172732,173290,558,10,N,N,-,-1,-1
TWOMEN.txt,172777,173363,586,10,N,N,-,-1,-1
TWOMEN.txt,172799,173502,703,10,N,N,-,-1,-1
TWOMEN.txt,172820,173577,757,10,N,N,-,-1,-1
TWOMEN.txt,172837,173720,883,10,N,N,-,-1,-1
TWOMEN.txt,173064,173811,747,10,N,N,-,-1,-1
TWOMEN.txt,173066,173886,820,10,N,N,-,-1,-1
TWOMEN.txt,173121,173939,818,10,N,N,-,-1,-1
TWOMEN.txt,173214,173984,770,10,N,N,-,-1,-1
TWOMEN.txt,173247,174015,768,10,N,N,-,-1,-1
TWOMEN.txt,173291,174087,796,10,N,N,-,-1,-1
TWOMEN.txt,173364,174126,762,10,N,N,-,-1,-1
TWOMEN.txt,173503,174190,687,10,N,N,-,-1,-1
TWOMEN.txt,173578,174334,756,10,N,N,-,-1,-1
TWOMEN.txt,173721,174392,671,10,N,N,-,-1,-1
TWOMEN.txt,173812,174494,682,10,N,N,-,-1,-1
TWOMEN.txt,173887,174573,686,10,N,N,-,-1,-1
TWOMEN.txt,173941,174611,670,10,N,N,-,-1,-1
TWOMEN.txt,173988,174736,748,10,N,N,-,-1,-1
TWOMEN.txt,174018,174947,929,10,N,N,-,-1,-1
TWOMEN.txt,174088,175114,1026,10,N,N,-,-1,-1
TWOMEN.txt,174128,175413,1285,10,N,N,-,-1,-1
TWOMEN.txt,174191,175544,1353,10,N,N,-,-1,-1
TWOMEN.txt,174335,175650,1315,10,N,N,-,-1,-1
TWOMEN.txt,174395,175770,1375,10,N,N,-,-1,-1
TWOMEN.txt,174496,175855,1359,10,N,N,-,-1,-1
TWOMEN.txt,174574,175917,1343,10,N,N,-,-1,-1
TWOMEN.txt,174613,176062,1449,10,N,N,-,-1,-1
TWOMEN.txt,174737,176133,1396,10,N,N,-,-1,-1
TWOMEN.txt,174948,176220,1272,10,N,N,-,-1,-1
TWOMEN.txt,175115,176303,1188,10,N,N,-,-1,-1
TWOMEN.txt,175414,176485,1071,10,N,N,-,-1,-1
TWOMEN.txt,175545,176497,952,10,N,N,-,-1,-1
TWOMEN.txt,175655,176504,849,10,N,N,-,-1,-1
TWOMEN.txt,175772,176541,769,10,N,N,-,-1,-1
TWOMEN.txt,175856,176605,749,10,N,N,-,-1,-1
TWOMEN.txt,175918,176707,789,10,N,N,-,-1,-1
TWOMEN.txt,176064,176955,891,10,N,N,-,-1,-1
TWOMEN.txt,176135,177037,902,10,N,N,-,-1,-1
TWOMEN.txt,176221,177156,935,10,N,N,-,-1,-1
TWOMEN.txt,176306,177280,974,10,N,N,-,-1,-1
TWOMEN.txt,176488,177329,841,10,N,N,-,-1,-1
TWOMEN.txt,176498,177343,845,10,N,N,-,-1,-1
TWOMEN.txt,176505,177378,873,10,N,N,-,-1,-1
TWOMEN.txt,176543,177460,917,10,N,N,-,-1,-1
TWOMEN.txt,176607,177589,982,10,N,N,-,-1,-1
TWOMEN.txt,176708,177900,1192,10,N,N,-,-1,-1
TWOMEN.txt,176956,178120,1164,10,N,N,-,-1,-1
TWOMEN.txt,177038,178351,1313,10,N,N,-,-1,-1
TWOMEN.txt,177157,178466,1309,10,N,N,-,-1,-1
TWOMEN.txt,177285,178605,1320,10,N,N,-,-1,-1
TWOMEN.txt,177330,178627,1297,10,N,N,-,-1,-1
TWOMEN.txt,177343,178633,1290,10,N,N,-,-1,-1
TWOMEN.txt,177380,178661,1281,10,N,N,-,-1,-1
TWOMEN.txt,177461,178740,1279,10,N,N,-,-1,-1
TWOMEN.txt,177590,178996,1406,10,N,N,-,-1,-1
TWOMEN.txt,177902,179214,1312,10,N,N,-,-1,-1
TWOMEN.txt,178122,179393,1271,10,N,N,-,-1,-1
TWOMEN.txt,178352,179474,1122,10,N,N,-,-1,-1
TWOMEN.txt,178467,179610,1143,10,N,N,-,-1,-1
TWOMEN.txt,178608,179670,1062,10,N,N,-,-1,-1
TWOMEN.txt,178628,179720,1092,10,N,N,-,-1,-1
TWOMEN.txt,178633,179763,1130,10,N,N,-,-1,-1
TWOMEN.txt,178663,179899,1236,10,N,N,-,-1,-1
TWOMEN.txt,178741,179948,1207,10,N,N,-,-1,-1
TWOMEN.txt,178997,179996,999,10,N,N,-,-1,-1
TWOMEN.txt,179215,180084,869,10,N,N,-,-1,-1
TWOMEN.txt,179394,180242,848,10,N,N,-,-1,-1
TWOMEN.txt,179476,180253,777,10,N,N,-,-1,-1
TWOMEN.txt,179611,180268,657,10,N,N,-,-1,-1
TWOMEN.txt,179671,180291,620,10,N,N,-,-1,-1
TWOMEN.txt,179721,180303,582,10,N,N,-,-1,-1
TWOMEN.txt,179764,180436,672,10,N,N,-,-1,-1
TWOMEN.txt,179900,180511,611,10,N,N,-,-1,-1
TWOMEN.txt,179950,180644,694,10,N,N,-,-1,-1
TWOMEN.txt,179997,180684,687,10,N,N,-,-1,-1
TWOMEN.txt,180085,180919,834,10,N,N,-,-1,-1
TWOMEN.txt,180245,181068,823,10,N,N,-,-1,-1
TWOMEN.txt,180255,181261,1006,10,N,N,-,-1,-1
TWOMEN.txt,180269,181288,1019,10,N,N,-,-1,-1
TWOMEN.txt,180291,181492,1201,10,N,N,-,-1,-1
TWOMEN.txt,180304,181661,1357,10,N,N,-,-1,-1
TWOMEN.txt,180437,181763,1326,10,N,N,-,-1,-1
TWOMEN.txt,180513,181803,1290,10,N,N,-,-1,-1
TWOMEN.txt,180649,181925,1276,10,N,N,-,-1,-1
TWOMEN.txt,180685,181990,1305,10,N,N,-,-1,-1
TWOMEN.txt,180920,182026,1106,10,N,N,-,-1,-1
TWOMEN.txt,181069,182046,977,10,N,N,-,-1,-1
TWOMEN.txt,181261,182178,917,10,N,N,-,-1,-1
TWOMEN.txt,181290,182201,911,10,N,N,-,-1,-1
TWOMEN.txt,181494,182205,711,10,N,N,-,-1,-1
TWOMEN.txt,181662,182606,944,10,N,N,-,-1,-1
TWOMEN.txt,181764,182707,943,10,N,N,-,-1,-1
TWOMEN.txt,181804,182724,920,10,N,N,-,-1,-1
TWOMEN.txt,181927,182756,829,10,N,N,-,-1,-1
TWOMEN.txt,181991,182850,859,10,N,N,-,-1,-1
TWOMEN.txt,182026,183017,991,10,N,N,-,-1,-1
TWOMEN.txt,182047,183237,1190,10,N,N,-,-1,-1
TWOMEN.txt,182181,183820,1639,10,N,N,-,-1,-1
TWOMEN.txt,182202,183871,1669,10,N,N,-,-1,-1
TWOMEN.txt,182206,183938,1732,10,N,N,-,-1,-1
TWOMEN.txt,182608,183988,1380,10,N,N,-,-1,-1
TWOMEN.txt,182710,184076,1366,10,N,N,-,-1,-1
TWOMEN.txt,182725,184237,1512,10,N,N,-,-1,-1
TWOMEN.txt,182758,184398,1640,10,N,N,-,-1,-1
TWOMEN.txt,182851,184414,1563,10,N,N,-,-1,-1
TWOMEN.txt,183018,184542,1524,10,N,N,-,-1,-1
TWOMEN.txt,183239,184693,1454,10,N,N,-,-1,-1
TWOMEN.txt,183821,184724,903,10,N,N,-,-1,-1
TWOMEN.txt,183872,184765,893,10,N,N,-,-1,-1
TWOMEN.txt,183940,184782,842,10,N,N,-,-1,-1
TWOMEN.txt,183988,185053,1065,10,N,N,-,-1,-1
TWOMEN.txt,184081,185222,1141,10,N,N,-,-1,-1
TWOMEN.txt,184238,185318,1080,10,N,N,-,-1,-1
TWOMEN.txt,184400,185488,1088,10,N,N,-,-1,-1
TWOMEN.txt,184415,185507,1092,10,N,N,-,-1,-1
TWOMEN.txt,184543,185537,994,10,N,N,-,-1,-1
TWOMEN.txt,184695,185748,1053,10,N,N,-,-1,-1
TWOMEN.txt,184725,185791,1066,10,N,N,-,-1,-1
TWOMEN.txt,184768,185912,1144,10,N,N,-,-1,-1
TWOMEN.txt,184783,186032,1249,10,N,N,-,-1,-1
TWOMEN.txt,185055,186231,1176,10,N,N,-,-1,-1
TWOMEN.txt,185224,186433,1209,10,N,N,-,-1,-1
TWOMEN.txt,185319,186531,1212,10,N,N,-,-1,-1
TWOMEN.txt,185491,186716,1225,10,N,N,-,-1,-1
TWOMEN.txt,185508,186741,1233,10,N,N,-,-1,-1
TWOMEN.txt,185539,186863,1324,10,N,N,-,-1,-1
TWOMEN.txt,185749,186933,1184,10,N,N,-,-1,-1
TWOMEN.txt,185793,187229,1436,10,N,N,-,-1,-1
TWOMEN.txt,185913,187396,1483,10,N,N,-,-1,-1
TWOMEN.txt,186034,187428,1394,10,N,N,-,-1,-1
TWOMEN.txt,186232,187641,1409,10,N,N,-,-1,-1
TWOMEN.txt,186434,187661,1227,10,N,N,-,-1,-1
TWOMEN.txt,186532,187715,1183,10,N,N,-,-1,-1
TWOMEN.txt,186717,187772,1055,10,N,N,-,-1,-1
TWOMEN.txt,186742,187782,1040,10,N,N,-,-1,-1
TWOMEN.txt,186864,187922,1058,10,N,N,-,-1,-1
TWOMEN.txt,186934,188034,1100,10,N,N,-,-1,-1
TWOMEN.txt,187230,188057,827,10,N,N,-,-1,-1
TWOMEN.txt,187397,188079,682,10,N,N,-,-1,-1
TWOMEN.txt,187429,188112,683,10,N,N,-,-1,-1
TWOMEN.txt,187642,188368,726,10,N,N,-,-1,-1
TWOMEN.txt,187662,188408,746,10,N,N,-,-1,-1
TWOMEN.txt,187716,188496,780,10,N,N,-,-1,-1
TWOMEN.txt,187773,188579,806,10,N,N,-,-1,-1
TWOMEN.txt,187784,188666,882,10,N,N,-,-1,-1
TWOMEN.txt,187923,189022,1099,10,N,N,-,-1,-1
TWOMEN.txt,188035,189138,1103,10,N,N,-,-1,-1
TWOMEN.txt,188060,189273,1213,10,N,N,-,-1,-1
TWOMEN.txt,188080,189392,1312,10,N,N,-,-1,-1
TWOMEN.txt,188114,189545,1431,10,N,N,-,-1,-1
TWOMEN.txt,188369,189726,1357,10,N,N,-,-1,-1
TWOMEN.txt,188409,189743,1334,10,N,N,-,-1,-1
TWOMEN.txt,188497,189769,1272,10,N,N,-,-1,-1
TWOMEN.txt,188581,189947,1366,10,N,N,-,-1,-1
TWOMEN.txt,188667,190050,1383,10,N,N,-,-1,-1
TWOMEN.txt,189023,190131,1108,10,N,N,-,-1,-1
TWOMEN.txt,189139,190174,1035,10,N,N,-,-1,-1
TWOMEN.txt,189278,190253,975,10,N,N,-,-1,-1
TWOMEN.txt,189393,190271,878,10,N,N,-,-1,-1
TWOMEN.txt,189547,190276,729,10,N,N,-,-1,-1
TWOMEN.txt,189729,190322,593,10,N,N,-,-1,-1
TWOMEN.txt,189744,190331,587,10,N,N,-,-1,-1
TWOMEN.txt,189771,190491,720,10,N,N,-,-1,-1
TWOMEN.txt,189949,190674,725,10,N,N,-,-1,-1
TWOMEN.txt,190051,190954,903,10,N,N,-,-1,-1
TWOMEN.txt,190133,190983,850,10,N,N,-,-1,-1
TWOMEN.txt,190175,190987,812,10,N,N,-,-1,-1
TWOMEN.txt,190256,191028,772,10,N,N,-,-1,-1
TWOMEN.txt,190272,191079,807,10,N,N,-,-1,-1
TWOMEN.txt,190278,191424,1146,10,N,N,-,-1,-1
TWOMEN.txt,190324,191626,1302,10,N,N,-,-1,-1
TWOMEN.txt,190332,191656,1324,10,N,N,-,-1,-1
TWOMEN.txt,190492,191710,1218,10,N,N,-,-1,-1
TWOMEN.txt,190675,191908,1233,10,N,N,-,-1,-1
TWOMEN.txt,190957,192125,1168,10,N,N,-,-1,-1
TWOMEN.txt,190984,192165,1181,10,N,N,-,-1,-1
TWOMEN.txt,190988,192335,1347,10,N,N,-,-1,-1
TWOMEN.txt,191030,192414,1384,10,N,N,-,-1,-1
TWOMEN.txt,191081,192784,1703,10,N,N,-,-1,-1
TWOMEN.txt,191424,193113,1689,10,N,N,-,-1,-1
TWOMEN.txt,191627,193142,1515,10,N,N,-,-1,-1
TWOMEN.txt,191657,193157,1500,10,N,N,-,-1,-1
TWOMEN.txt,191712,193181,1469,10,N,N,-,-1,-1
TWOMEN.txt,191909,193258,1349,10,N,N,-,-1,-1
TWOMEN.txt,192127,193280,1153,10,N,N,-,-1,-1
TWOMEN.txt,192166,193300,1134,10,N,N,-,-1,-1
TWOMEN.txt,192338,193310,972,10,N,N,-,-1,-1
TWOMEN.txt,192416,193457,1041,10,N,N,-,-1,-1
TWOMEN.txt,192785,193673,888,10,N,N,-,-1,-1
TWOMEN.txt,193114,193782,668,10,N,N,-,-1,-1
TWOMEN.txt,193143,193809,666,10,N,N,-,-1,-1
TWOMEN.txt,193158,193876,718,10,N,N,-,-1,-1
TWOMEN.txt,193182,194043,861,10,N,N,-,-1,-1
TWOMEN.txt,193261,194065,804,10,N,N,-,-1,-1
TWOMEN.txt,193281,194122,841,10,N,N,-,-1,-1
TWOMEN.txt,193301,194155,854,10,N,N,-,-1,-1
TWOMEN.txt,193312,194252,940,10,N,N,-,-1,-1
TWOMEN.txt,193458,194287,829,10,N,N,-,-1,-1
TWOMEN.txt,193675,194318,643,10,N,N,-,-1,-1
TWOMEN.txt,193783,194339,556,10,N,N,-,-1,-1
TWOMEN.txt,193811,194358,547,10,N,N,-,-1,-1
TWOMEN.txt,193877,194382,505,10,N,N,-,-1,-1
TWOMEN.txt,194045,194402,357,10,N,N,-,-1,-1
TWOMEN.txt,194070,194428,358,10,N,N,-,-1,-1
TWOMEN.txt,194123,194446,323,10,N,N,-,-1,-1
TWOMEN.txt,194157,194459,302,10,N,N,-,-1,-1
TWOMEN.txt,194254,194531,277,10,N,N,-,-1,-1
TWOMEN.txt,194289,194538,249,10,N,N,-,-1,-1
TWOMEN.txt,194319,194560,241,10,N,N,-,-1,-1
TWOMEN.txt,194341,194599,258,10,N,N,-,-1,-1
TWOMEN.txt,194360,194646,286,10,N,N,-,-1,-1
TWOMEN.txt,194383,194666,283,10,N,N,-,-1,-1
TWOMEN.txt,194405,194713,308,10,N,N,-,-1,-1
TWOMEN.txt,194429,194769,340,10,N,N,-,-1,-1
TWOMEN.txt,194448,194778,330,10,N,N,-,-1,-1
TWOMEN.txt,194460,194795,335,10,N,N,-,-1,-1
TWOMEN.txt,194533,194802,269,10,N,N,-,-1,-1
TWOMEN.txt,194539,194808,269,10,N,N,-,-1,-1
TWOMEN.txt,194561,194815,254,10,N,N,-,-1,-1
TWOMEN.txt,194600,194831,231,10,N,N,-,-1,-1
TWOMEN.txt,194648,195006,358,10,N,N,-,-1,-1
TWOMEN.txt,194667,195041,374,10,N,N,-,-1,-1
TWOMEN.txt,194714,195088,374,10,N,N,-,-1,-1
TWOMEN.txt,194770,195250,480,10,N,N,-,-1,-1
TWOMEN.txt,194779,195474,695,10,N,N,-,-1,-1
TWOMEN.txt,194797,195490,693,10,N,N,-,-1,-1
TWOMEN.txt,194804,195593,789,10,N,N,-,-1,-1
TWOMEN.txt,194811,195712,901,10,N,N,-,-1,-1
TWOMEN.txt,194816,195817,1001,10,N,N,-,-1,-1
TWOMEN.txt,194832,195837,1005,10,N,N,-,-1,-1
TWOMEN.txt,195007,195871,864,10,N,N,-,-1,-1
TWOMEN.txt,195042,195937,895,10,N,N,-,-1,-1
TWOMEN.txt,195090,196057,967,10,N,N,-,-1,-1
TWOMEN.txt,195250,196145,895,10,N,N,-,-1,-1
TWOMEN.txt,195476,196191,715,10,N,N,-,-1,-1
TWOMEN.txt,195499,196384,885,10,N,N,-,-1,-1
TWOMEN.txt,195595,196421,826,10,N,N,-,-1,-1
TWOMEN.txt,195714,196502,788,10,N,N,-,-1,-1
TWOMEN.txt,195818,196624,806,10,N,N,-,-1,-1
TWOMEN.txt,195838,196667,829,10,N,N,-,-1,-1
TWOMEN.txt,195872,196781,909,10,N,N,-,-1,-1
TWOMEN.txt,195938,196839,901,10,N,N,-,-1,-1
TWOMEN.txt,196059,196856,797,10,N,N,-,-1,-1
TWOMEN.txt,196147,196873,726,10,N,N,-,-1,-1
TWOMEN.txt,196192,197036,844,10,N,N,-,-1,-1
TWOMEN.txt,196385,197190,805,10,N,N,-,-1,-1
TWOMEN.txt,196422,197514,1092,10,N,N,-,-1,-1
TWOMEN.txt,196503,197685,1182,10,N,N,-,-1,-1
TWOMEN.txt,196625,197706,1081,10,N,N,-,-1,-1
TWOMEN.txt,196668,197712,1044,10,N,N,-,-1,-1
TWOMEN.txt,196783,197734,951,10,N,N,-,-1,-1
TWOMEN.txt,196842,197750,908,10,N,N,-,-1,-1
TWOMEN.txt,196858,197762,904,10,N,N,-,-1,-1
TWOMEN.txt,196875,197799,924,10,N,N,-,-1,-1
TWOMEN.txt,197041,197872,831,10,N,N,-,-1,-1
TWOMEN.txt,197192,197992,800,10,N,N,-,-1,-1
TWOMEN.txt,197515,198276,761,10,N,N,-,-1,-1
TWOMEN.txt,197688,198476,788,10,N,N,-,-1,-1
TWOMEN.txt,197707,198541,834,10,N,N,-,-1,-1
TWOMEN.txt,197712,198635,923,10,N,N,-,-1,-1
TWOMEN.txt,197736,198861,1125,10,N,N,-,-1,-1
TWOMEN.txt,197751,198899,1148,10,N,N,-,-1,-1
TWOMEN.txt,197764,198953,1189,10,N,N,-,-1,-1
TWOMEN.txt,197800,198970,1170,10,N,N,-,-1,-1
TWOMEN.txt,197874,198980,1106,10,N,N,-,-1,-1
TWOMEN.txt,197994,199008,1014,10,N,N,-,-1,-1
TWOMEN.txt,198278,199077,799,10,N,N,-,-1,-1
TWOMEN.txt,198476,199314,838,10,N,N,-,-1,-1
TWOMEN.txt,198542,199391,849,10,N,N,-,-1,-1
TWOMEN.txt,198636,199451,815,10,N,N,-,-1,-1
TWOMEN.txt,198862,199481,619,10,N,N,-,-1,-1
TWOMEN.txt,198904,199488,584,10,N,N,-,-1,-1
TWOMEN.txt,198954,199534,580,10,N,N,-,-1,-1
TWOMEN.txt,198970,199556,586,10,N,N,-,-1,-1
TWOMEN.txt,198982,199570,588,10,N,N,-,-1,-1
TWOMEN.txt,199009,199582,573,10,N,N,-,-1,-1
TWOMEN.txt,199078,199609,531,10,N,N,-,-1,-1
TWOMEN.txt,199316,199645,329,10,N,N,-,-1,-1
TWOMEN.txt,199392,199682,290,10,N,N,-,-1,-1
TWOMEN.txt,199453,199730,277,10,N,N,-,-1,-1
TWOMEN.txt,199482,199774,292,10,N,N,-,-1,-1
TWOMEN.txt,199489,199886,397,10,N,N,-,-1,-1
TWOMEN.txt,199537,200036,499,10,N,N,-,-1,-1
TWOMEN.txt,199557,200073,516,10,N,N,-,-1,-1
TWOMEN.txt,199571,200106,535,10,N,N,-,-1,-1
TWOMEN.txt,199584,200192,608,10,N,N,-,-1,-1
TWOMEN.txt,199610,200244,634,10,N,N,-,-1,-1
TWOMEN.txt,199646,200400,754,10,N,N,-,-1,-1
TWOMEN.txt,199683,200723,1040,10,N,N,-,-1,-1
TWOMEN.txt,199731,200792,1061,10,N,Y,1437471855423,351318,351853
TWOMEN.txt,199776,200948,1172,10,N,Y,1437471855423,351318,351853
TWOMEN.txt,199888,201039,1151,10,N,Y,1437471855423,351318,351853
TWOMEN.txt,200037,201057,1020,10,N,Y,1437471855423,351318,351853
TWOMEN.txt,200074,201090,1016,10,N,Y,1437471855423,351318,351853
TWOMEN.txt,200107,201188,1081,10,N,Y,1437471855423,351318,351853
TWOMEN.txt,200195,201212,1017,10,N,Y,1437471855423,351318,351853
TWOMEN.txt,200244,201235,991,10,N,Y,1437471855423,351318,351853
TWOMEN.txt,200401,201260,859,10,N,Y,1437471855423,351318,351853
TWOMEN.txt,200725,201334,609,10,N,Y,1437471855423,351318,351853
TWOMEN.txt,200793,201439,646,10,N,Y,1437471855423,351318,351853
TWOMEN.txt,200949,201500,551,10,N,Y,1437471855423,351318,351853
TWOMEN.txt,201042,201623,581,10,N,N,-,-1,-1
TWOMEN.txt,201058,201651,593,10,N,N,-,-1,-1
TWOMEN.txt,201092,201752,660,10,N,N,-,-1,-1
TWOMEN.txt,201190,201802,612,10,N,N,-,-1,-1
TWOMEN.txt,201215,201822,607,10,N,N,-,-1,-1
TWOMEN.txt,201236,201837,601,10,N,N,-,-1,-1
TWOMEN.txt,201262,201867,605,10,N,N,-,-1,-1
TWOMEN.txt,201335,202014,679,10,N,N,-,-1,-1
TWOMEN.txt,201441,202020,579,10,N,N,-,-1,-1
TWOMEN.txt,201502,202039,537,10,N,N,-,-1,-1
TWOMEN.txt,201625,202045,420,10,N,N,-,-1,-1
TWOMEN.txt,201653,202102,449,10,N,N,-,-1,-1
TWOMEN.txt,201753,202187,434,10,N,N,-,-1,-1
TWOMEN.txt,201806,202435,629,10,N,N,-,-1,-1
TWOMEN.txt,201828,202499,671,10,N,N,-,-1,-1
TWOMEN.txt,201837,202689,852,10,N,N,-,-1,-1
TWOMEN.txt,201868,202755,887,10,N,N,-,-1,-1
TWOMEN.txt,202015,202913,898,10,N,N,-,-1,-1
TWOMEN.txt,202023,202985,962,10,N,N,-,-1,-1
TWOMEN.txt,202041,203225,1184,10,N,N,-,-1,-1
TWOMEN.txt,202046,203321,1275,10,N,N,-,-1,-1
TWOMEN.txt,202103,203454,1351,10,N,N,-,-1,-1
TWOMEN.txt,202188,203696,1508,10,N,N,-,-1,-1
TWOMEN.txt,202436,203851,1415,10,N,N,-,-1,-1
TWOMEN.txt,202500,203868,1368,10,N,N,-,-1,-1
TWOMEN.txt,202690,203881,1191,10,N,N,-,-1,-1
TWOMEN.txt,202756,203891,1135,10,N,N,-,-1,-1
TWOMEN.txt,202915,203938,1023,10,N,N,-,-1,-1
TWOMEN.txt,202986,204249,1263,10,N,N,-,-1,-1
TWOMEN.txt,203230,204341,1111,10,N,N,-,-1,-1
TWOMEN.txt,203322,204366,1044,10,N,N,-,-1,-1
TWOMEN.txt,203459,204388,929,10,N,N,-,-1,-1
TWOMEN.txt,203698,204402,704,10,N,N,-,-1,-1
TWOMEN.txt,203854,204418,564,10,N,N,-,-1,-1
TWOMEN.txt,203869,204473,604,10,N,N,-,-1,-1
TWOMEN.txt,203882,204582,700,10,N,N,-,-1,-1
TWOMEN.txt,203893,204797,904,10,N,N,-,-1,-1
TWOMEN.txt,203939,204803,864,10,N,N,-,-1,-1
TWOMEN.txt,204250,204907,657,10,N,N,-,-1,-1
TWOMEN.txt,204342,204948,606,10,N,N,-,-1,-1
TWOMEN.txt,204369,205015,646,10,N,N,-,-1,-1
TWOMEN.txt,204389,205308,919,10,N,N,-,-1,-1
TWOMEN.txt,204402,205331,929,10,N,N,-,-1,-1
TWOMEN.txt,204420,205361,941,10,N,N,-,-1,-1
TWOMEN.txt,204474,205383,909,10,N,N,-,-1,-1
TWOMEN.txt,204583,205480,897,10,N,N,-,-1,-1
TWOMEN.txt,204798,205515,717,10,N,N,-,-1,-1
TWOMEN.txt,204804,205569,765,10,N,N,-,-1,-1
TWOMEN.txt,204913,205594,681,10,N,N,-,-1,-1
TWOMEN.txt,204949,205611,662,10,N,N,-,-1,-1
TWOMEN.txt,205016,205638,622,10,N,N,-,-1,-1
TWOMEN.txt,205311,205703,392,10,N,N,-,-1,-1
TWOMEN.txt,205332,205719,387,10,N,N,-,-1,-1
TWOMEN.txt,205363,205781,418,10,N,N,-,-1,-1
TWOMEN.txt,205384,205902,518,10,N,N,-,-1,-1
TWOMEN.txt,205481,205932,451,10,N,N,-,-1,-1
TWOMEN.txt,205516,205969,453,10,N,N,-,-1,-1
TWOMEN.txt,205571,206025,454,10,N,N,-,-1,-1
TWOMEN.txt,205597,206041,444,10,N,N,-,-1,-1
TWOMEN.txt,205612,206059,447,10,N,N,-,-1,-1
TWOMEN.txt,205640,206062,422,10,N,N,-,-1,-1
TWOMEN.txt,205706,206073,367,10,N,N,-,-1,-1
TWOMEN.txt,205720,206372,652,10,N,N,-,-1,-1
TWOMEN.txt,205782,206446,664,10,N,N,-,-1,-1
TWOMEN.txt,205904,206606,702,10,N,N,-,-1,-1
TWOMEN.txt,205935,206636,701,10,N,N,-,-1,-1
TWOMEN.txt,205974,206657,683,10,N,N,-,-1,-1
TWOMEN.txt,206026,206695,669,10,N,N,-,-1,-1
TWOMEN.txt,206041,206714,673,10,N,N,-,-1,-1
TWOMEN.txt,206061,206741,680,10,N,N,-,-1,-1
TWOMEN.txt,206062,206803,741,10,N,N,-,-1,-1
TWOMEN.txt,206073,206857,784,10,N,N,-,-1,-1
TWOMEN.txt,206373,206957,584,10,N,N,-,-1,-1
TWOMEN.txt,206448,206987,539,10,N,N,-,-1,-1
TWOMEN.txt,206607,207144,537,10,N,N,-,-1,-1
TWOMEN.txt,206639,207165,526,10,N,N,-,-1,-1
TWOMEN.txt,206658,207214,556,10,N,N,-,-1,-1
TWOMEN.txt,206698,207378,680,10,N,N,-,-1,-1
TWOMEN.txt,206716,207399,683,10,N,N,-,-1,-1
TWOMEN.txt,206742,207503,761,10,N,N,-,-1,-1
TWOMEN.txt,206804,207669,865,10,N,N,-,-1,-1
TWOMEN.txt,206858,207709,851,10,N,N,-,-1,-1
TWOMEN.txt,206958,207759,801,10,N,N,-,-1,-1
TWOMEN.txt,206988,207900,912,10,N,N,-,-1,-1
TWOMEN.txt,207147,207901,754,10,N,N,-,-1,-1
TWOMEN.txt,207166,207948,782,10,N,N,-,-1,-1
TWOMEN.txt,207217,207969,752,10,N,N,-,-1,-1
TWOMEN.txt,207379,208117,738,10,N,N,-,-1,-1
TWOMEN.txt,207400,208249,849,10,N,N,-,-1,-1
TWOMEN.txt,207508,208434,926,10,N,N,-,-1,-1
TWOMEN.txt,207670,208482,812,10,N,N,-,-1,-1
TWOMEN.txt,207711,208654,943,10,N,N,-,-1,-1
TWOMEN.txt,207760,208746,986,10,N,N,-,-1,-1
TWOMEN.txt,207900,208820,920,10,N,N,-,-1,-1
TWOMEN.txt,207903,208883,980,10,N,N,-,-1,-1
TWOMEN.txt,207950,208971,1021,10,N,N,-,-1,-1
TWOMEN.txt,207970,209089,1119,10,N,N,-,-1,-1
TWOMEN.txt,208120,209271,1151,10,N,N,-,-1,-1
TWOMEN.txt,208250,209301,1051,10,N,N,-,-1,-1
TWOMEN.txt,208436,209487,1051,10,N,N,-,-1,-1
TWOMEN.txt,208483,209534,1051,10,N,N,-,-1,-1
TWOMEN.txt,208655,209706,1051,10,N,N,-,-1,-1
TWOMEN.txt,208748,209910,1162,10,N,N,-,-1,-1
TWOMEN.txt,208821,210056,1235,10,N,N,-,-1,-1
TWOMEN.txt,208884,210288,1404,10,N,N,-,-1,-1
TWOMEN.txt,208972,210369,1397,10,N,N,-,-1,-1
TWOMEN.txt,209090,210428,1338,10,N,N,-,-1,-1
TWOMEN.txt,209272,210766,1494,10,N,N,-,-1,-1
TWOMEN.txt,209302,210802,1500,10,N,N,-,-1,-1
TWOMEN.txt,209488,210942,1454,10,N,N,-,-1,-1
TWOMEN.txt,209535,211027,1492,10,N,N,-,-1,-1
TWOMEN.txt,209708,211044,1336,10,N,N,-,-1,-1
TWOMEN.txt,209911,211051,1140,10,N,N,-,-1,-1
TWOMEN.txt,210057,211078,1021,10,N,N,-,-1,-1
TWOMEN.txt,210291,211137,846,10,N,N,-,-1,-1
TWOMEN.txt,210370,211197,827,10,N,N,-,-1,-1
TWOMEN.txt,210429,211207,778,10,N,N,-,-1,-1
TWOMEN.txt,210768,211222,454,10,N,N,-,-1,-1
TWOMEN.txt,210803,211283,480,10,N,N,-,-1,-1
TWOMEN.txt,210944,211567,623,10,N,N,-,-1,-1
TWOMEN.txt,211029,211717,688,10,N,N,-,-1,-1
TWOMEN.txt,211045,211969,924,10,N,N,-,-1,-1
TWOMEN.txt,211052,212201,1149,10,N,N,-,-1,-1
TWOMEN.txt,211080,212224,1144,10,N,N,-,-1,-1
TWOMEN.txt,211144,212445,1301,10,N,N,-,-1,-1
TWOMEN.txt,211199,212660,1461,10,N,N,-,-1,-1
TWOMEN.txt,211207,212876,1669,10,N,N,-,-1,-1
TWOMEN.txt,211223,213163,1940,10,N,N,-,-1,-1
TWOMEN.txt,211284,213353,2069,10,N,N,-,-1,-1
TWOMEN.txt,211567,213487,1920,10,N,N,-,-1,-1
TWOMEN.txt,211718,213494,1776,10,N,N,-,-1,-1
TWOMEN.txt,211970,213517,1547,10,N,N,-,-1,-1
TWOMEN.txt,212203,213528,1325,10,N,N,-,-1,-1
TWOMEN.txt,212225,213621,1396,10,N,N,-,-1,-1
TWOMEN.txt,212446,213787,1341,10,N,N,-,-1,-1
TWOMEN.txt,212661,213865,1204,10,N,N,-,-1,-1
TWOMEN.txt,212877,213987,1110,10,N,N,-,-1,-1
TWOMEN.txt,213164,214034,870,10,N,N,-,-1,-1
TWOMEN.txt,213355,214073,718,10,N,N,-,-1,-1
TWOMEN.txt,213490,214176,686,10,N,N,-,-1,-1
TWOMEN.txt,213495,214397,902,10,N,N,-,-1,-1
TWOMEN.txt,213520,214454,934,10,N,N,-,-1,-1
TWOMEN.txt,213529,214498,969,10,N,N,-,-1,-1
TWOMEN.txt,213623,214672,1049,10,N,N,-,-1,-1
TWOMEN.txt,213788,214729,941,10,N,N,-,-1,-1
TWOMEN.txt,213866,214857,991,10,N,N,-,-1,-1
TWOMEN.txt,213988,214920,932,10,N,N,-,-1,-1
TWOMEN.txt,214036,214949,913,10,N,N,-,-1,-1
TWOMEN.txt,214074,215253,1179,10,N,N,-,-1,-1
TWOMEN.txt,214177,215260,1083,10,N,N,-,-1,-1
TWOMEN.txt,214399,215371,972,10,N,N,-,-1,-1
TWOMEN.txt,214456,215468,1012,10,N,N,-,-1,-1
TWOMEN.txt,214499,215526,1027,10,N,N,-,-1,-1
TWOMEN.txt,214674,215554,880,10,N,N,-,-1,-1
TWOMEN.txt,214735,215582,847,10,N,N,-,-1,-1
TWOMEN.txt,214858,215817,959,10,N,N,-,-1,-1
TWOMEN.txt,214922,215952,1030,10,N,N,-,-1,-1
TWOMEN.txt,214950,215977,1027,10,N,N,-,-1,-1
TWOMEN.txt,215257,215997,740,10,N,N,-,-1,-1
TWOMEN.txt,215261,216002,741,10,N,N,-,-1,-1
TWOMEN.txt,215372,216013,641,10,N,N,-,-1,-1
TWOMEN.txt,215469,216299,830,10,N,N,-,-1,-1
TWOMEN.txt,215527,216533,1006,10,N,N,-,-1,-1
TWOMEN.txt,215556,216698,1142,10,N,N,-,-1,-1
TWOMEN.txt,215583,216882,1299,10,N,N,-,-1,-1
TWOMEN.txt,215819,217163,1344,10,N,N,-,-1,-1
TWOMEN.txt,215953,217494,1541,10,N,N,-,-1,-1
TWOMEN.txt,215980,217499,1519,10,N,N,-,-1,-1
TWOMEN.txt,215999,217573,1574,10,N,N,-,-1,-1
TWOMEN.txt,216003,217673,1670,10,N,N,-,-1,-1
TWOMEN.txt,216015,217849,1834,10,N,N,-,-1,-1
TWOMEN.txt,216304,217979,1675,10,N,N,-,-1,-1
TWOMEN.txt,216534,218193,1659,10,N,N,-,-1,-1
TWOMEN.txt,216699,218216,1517,10,N,N,-,-1,-1
TWOMEN.txt,216884,218324,1440,10,N,N,-,-1,-1
TWOMEN.txt,217164,218368,1204,10,N,N,-,-1,-1
TWOMEN.txt,217495,218484,989,10,N,N,-,-1,-1
TWOMEN.txt,217500,218599,1099,10,N,N,-,-1,-1
TWOMEN.txt,217574,218664,1090,10,N,N,-,-1,-1
TWOMEN.txt,217674,218679,1005,10,N,N,-,-1,-1
TWOMEN.txt,217850,218683,833,10,N,N,-,-1,-1
TWOMEN.txt,217980,218686,706,10,N,N,-,-1,-1
TWOMEN.txt,218194,218704,510,10,N,N,-,-1,-1
TWOMEN.txt,218218,218850,632,10,N,N,-,-1,-1
TWOMEN.txt,218325,219129,804,10,N,N,-,-1,-1
TWOMEN.txt,218369,219379,1010,10,N,N,-,-1,-1
TWOMEN.txt,218485,219855,1370,10,N,N,-,-1,-1
TWOMEN.txt,218600,219950,1350,10,N,N,-,-1,-1
TWOMEN.txt,218667,219994,1327,10,N,N,-,-1,-1
TWOMEN.txt,218681,220042,1361,10,N,N,-,-1,-1
TWOMEN.txt,218683,220267,1584,10,N,N,-,-1,-1
TWOMEN.txt,218687,220275,1588,10,N,N,-,-1,-1
TWOMEN.txt,218706,220404,1698,10,N,N,-,-1,-1
TWOMEN.txt,218851,220445,1594,10,N,N,-,-1,-1
TWOMEN.txt,219130,220534,1404,10,N,N,-,-1,-1
TWOMEN.txt,219380,220706,1326,10,N,N,-,-1,-1
TWOMEN.txt,219856,220752,896,10,N,N,-,-1,-1
TWOMEN.txt,219954,220766,812,10,N,N,-,-1,-1
TWOMEN.txt,219999,220924,925,10,N,N,-,-1,-1
TWOMEN.txt,220043,221053,1010,10,N,N,-,-1,-1
TWOMEN.txt,220269,221085,816,10,N,N,-,-1,-1
TWOMEN.txt,220276,221115,839,10,N,N,-,-1,-1
TWOMEN.txt,220405,221220,815,10,N,N,-,-1,-1
TWOMEN.txt,220447,221354,907,10,N,N,-,-1,-1
TWOMEN.txt,220535,221417,882,10,N,N,-,-1,-1
TWOMEN.txt,220707,221518,811,10,N,N,-,-1,-1
TWOMEN.txt,220753,221643,890,10,N,N,-,-1,-1
TWOMEN.txt,220767,221742,975,10,N,N,-,-1,-1
TWOMEN.txt,220926,221862,936,10,N,N,-,-1,-1
TWOMEN.txt,221056,221973,917,10,N,N,-,-1,-1
TWOMEN.txt,221086,222030,944,10,N,N,-,-1,-1
TWOMEN.txt,221116,222040,924,10,N,N,-,-1,-1
TWOMEN.txt,221221,222067,846,10,N,N,-,-1,-1
TWOMEN.txt,221355,222150,795,10,N,N,-,-1,-1
TWOMEN.txt,221419,222286,867,10,N,N,-,-1,-1
TWOMEN.txt,221519,222543,1024,10,N,N,-,-1,-1
TWOMEN.txt,221644,222739,1095,10,N,N,-,-1,-1
TWOMEN.txt,221743,222845,1102,10,N,N,-,-1,-1
TWOMEN.txt,221863,222908,1045,10,N,N,-,-1,-1
TWOMEN.txt,221975,223013,1038,10,N,N,-,-1,-1
TWOMEN.txt,222033,223205,1172,10,N,Y,1437472966198,394609,395892
TWOMEN.txt,222041,223254,1213,10,N,Y,1437472966198,394609,395892
TWOMEN.txt,222068,223324,1256,10,N,Y,1437472966198,394609,395892
TWOMEN.txt,222151,223408,1257,10,N,Y,1437472966198,394609,395892
TWOMEN.txt,222288,223447,1159,10,N,Y,1437472966198,394609,395892
TWOMEN.txt,222546,223561,1015,10,N,Y,1437472966198,394609,395892
TWOMEN.txt,222740,223766,1026,10,N,Y,1437472966198,394609,395892
TWOMEN.txt,222847,223858,1011,10,N,Y,1437472966198,394609,395892
TWOMEN.txt,222908,223883,975,10,N,Y,1437472966198,394609,395892
TWOMEN.txt,223015,224046,1031,10,N,Y,1437472966198,394609,395892
TWOMEN.txt,223206,224090,884,10,N,Y,1437472966198,394609,395892
TWOMEN.txt,223255,224132,877,10,N,Y,1437472966198,394609,395892
TWOMEN.txt,223326,224145,819,10,N,N,-,-1,-1
TWOMEN.txt,223409,224240,831,10,N,N,-,-1,-1
TWOMEN.txt,223452,224247,795,10,N,N,-,-1,-1
TWOMEN.txt,223562,224400,838,10,N,N,-,-1,-1
TWOMEN.txt,223768,224420,652,10,N,N,-,-1,-1
TWOMEN.txt,223859,224576,717,10,N,N,-,-1,-1
TWOMEN.txt,223885,224687,802,10,N,N,-,-1,-1
TWOMEN.txt,224047,224793,746,10,N,N,-,-1,-1
TWOMEN.txt,224091,224867,776,10,N,N,-,-1,-1
TWOMEN.txt,224135,224960,825,10,N,N,-,-1,-1
TWOMEN.txt,224146,225023,877,10,N,N,-,-1,-1
TWOMEN.txt,224241,225099,858,10,N,N,-,-1,-1
TWOMEN.txt,224249,225145,896,10,N,N,-,-1,-1
TWOMEN.txt,224401,225173,772,10,N,N,-,-1,-1
TWOMEN.txt,224425,225241,816,10,N,N,-,-1,-1
TWOMEN.txt,224578,225335,757,10,N,N,-,-1,-1
TWOMEN.txt,224688,225390,702,10,N,N,-,-1,-1
TWOMEN.txt,224794,225394,600,10,N,N,-,-1,-1
TWOMEN.txt,224869,225404,535,10,N,N,-,-1,-1
TWOMEN.txt,224961,225470,509,10,N,N,-,-1,-1
TWOMEN.txt,225024,225676,652,10,N,N,-,-1,-1
TWOMEN.txt,225101,225730,629,10,N,N,-,-1,-1
TWOMEN.txt,225146,225734,588,10,N,N,-,-1,-1
TWOMEN.txt,225174,225752,578,10,N,N,-,-1,-1
TWOMEN.txt,225242,225753,511,10,N,N,-,-1,-1
TWOMEN.txt,225335,225762,427,10,N,N,-,-1,-1
TWOMEN.txt,225390,225782,392,10,N,N,-,-1,-1
TWOMEN.txt,225395,225914,519,10,N,N,-,-1,-1
TWOMEN.txt,225406,226016,610,10,N,N,-,-1,-1
TWOMEN.txt,225471,226026,555,10,N,N,-,-1,-1
TWOMEN.txt,225681,226042,361,10,N,N,-,-1,-1
TWOMEN.txt,225731,226094,363,10,N,N,-,-1,-1
TWOMEN.txt,225734,226257,523,10,N,N,-,-1,-1
TWOMEN.txt,225752,226278,526,10,N,N,-,-1,-1
TWOMEN.txt,225754,226287,533,10,N,N,-,-1,-1
TWOMEN.txt,225764,226308,544,10,N,N,-,-1,-1
TWOMEN.txt,225784,226639,855,10,N,N,-,-1,-1
TWOMEN.txt,225916,226829,913,10,N,N,-,-1,-1
TWOMEN.txt,226018,226980,962,10,N,N,-,-1,-1
TWOMEN.txt,226027,227027,1000,10,N,N,-,-1,-1
TWOMEN.txt,226044,227039,995,10,N,N,-,-1,-1
TWOMEN.txt,226096,227145,1049,10,N,N,-,-1,-1
TWOMEN.txt,226260,227319,1059,10,N,N,-,-1,-1
TWOMEN.txt,226279,227435,1156,10,N,N,-,-1,-1
TWOMEN.txt,226289,227455,1166,10,N,N,-,-1,-1
TWOMEN.txt,226310,227478,1168,10,N,N,-,-1,-1
TWOMEN.txt,226640,227493,853,10,N,N,-,-1,-1
TWOMEN.txt,226831,227534,703,10,N,N,-,-1,-1
TWOMEN.txt,226984,227566,582,10,N,N,-,-1,-1
TWOMEN.txt,227028,227608,580,10,N,N,-,-1,-1
TWOMEN.txt,227044,227660,616,10,N,N,-,-1,-1
TWOMEN.txt,227147,227711,564,10,N,N,-,-1,-1
TWOMEN.txt,227321,227772,451,10,N,N,-,-1,-1
TWOMEN.txt,227438,227777,339,10,N,N,-,-1,-1
TWOMEN.txt,227456,227782,326,10,N,N,-,-1,-1
TWOMEN.txt,227480,227814,334,10,N,N,-,-1,-1
TWOMEN.txt,227495,228141,646,10,N,N,-,-1,-1
TWOMEN.txt,227535,228193,658,10,N,N,-,-1,-1
TWOMEN.txt,227567,228215,648,10,N,N,-,-1,-1
TWOMEN.txt,227609,228226,617,10,N,N,-,-1,-1
TWOMEN.txt,227661,228246,585,10,N,N,-,-1,-1
TWOMEN.txt,227713,228352,639,10,N,N,-,-1,-1
TWOMEN.txt,227774,228466,692,10,N,N,-,-1,-1
TWOMEN.txt,227778,228717,939,10,N,N,-,-1,-1
TWOMEN.txt,227783,228970,1187,10,N,N,-,-1,-1
TWOMEN.txt,227816,229015,1199,10,N,N,-,-1,-1
TWOMEN.txt,228142,229039,897,10,N,N,-,-1,-1
TWOMEN.txt,228196,229050,854,10,N,N,-,-1,-1
TWOMEN.txt,228216,229114,898,10,N,N,-,-1,-1
TWOMEN.txt,228228,229144,916,10,N,N,-,-1,-1
TWOMEN.txt,228248,229224,976,10,N,N,-,-1,-1
TWOMEN.txt,228354,229279,925,10,N,N,-,-1,-1
TWOMEN.txt,228467,229323,856,10,N,N,-,-1,-1
TWOMEN.txt,228718,229414,696,10,N,N,-,-1,-1
TWOMEN.txt,228972,229467,495,10,N,N,-,-1,-1
TWOMEN.txt,229018,229524,506,10,N,N,-,-1,-1
TWOMEN.txt,229040,229560,520,10,N,N,-,-1,-1
TWOMEN.txt,229052,229574,522,10,N,N,-,-1,-1
TWOMEN.txt,229117,229789,672,10,N,N,-,-1,-1
TWOMEN.txt,229146,229819,673,10,N,N,-,-1,-1
TWOMEN.txt,229226,229914,688,10,N,N,-,-1,-1
TWOMEN.txt,229281,230001,720,10,N,N,-,-1,-1
TWOMEN.txt,229324,230433,1109,10,N,N,-,-1,-1
TWOMEN.txt,229415,230453,1038,10,N,N,-,-1,-1
TWOMEN.txt,229468,230464,996,10,N,N,-,-1,-1
TWOMEN.txt,229525,230479,954,10,N,N,-,-1,-1
TWOMEN.txt,229561,230607,1046,10,N,N,-,-1,-1
TWOMEN.txt,229576,230624,1048,10,N,N,-,-1,-1
TWOMEN.txt,229790,230654,864,10,N,N,-,-1,-1
TWOMEN.txt,229820,230722,902,10,N,N,-,-1,-1
TWOMEN.txt,229915,230782,867,10,N,N,-,-1,-1
TWOMEN.txt,230002,230823,821,10,N,N,-,-1,-1
TWOMEN.txt,230436,230885,449,10,N,N,-,-1,-1
TWOMEN.txt,230454,230921,467,10,N,N,-,-1,-1
TWOMEN.txt,230466,230990,524,10,N,N,-,-1,-1
TWOMEN.txt,230481,231095,614,10,N,N,-,-1,-1
TWOMEN.txt,230609,231105,496,10,N,N,-,-1,-1
TWOMEN.txt,230626,231329,703,10,N,N,-,-1,-1
TWOMEN.txt,230654,231398,744,10,N,N,-,-1,-1
TWOMEN.txt,230724,231561,837,10,N,N,-,-1,-1
TWOMEN.txt,230783,231582,799,10,N,N,-,-1,-1
TWOMEN.txt,230824,231829,1005,10,N,N,-,-1,-1
TWOMEN.txt,230887,231927,1040,10,N,N,-,-1,-1
TWOMEN.txt,230923,231975,1052,10,N,N,-,-1,-1
TWOMEN.txt,230992,232336,1344,10,N,N,-,-1,-1
TWOMEN.txt,231097,232361,1264,10,N,N,-,-1,-1
TWOMEN.txt,231106,232384,1278,10,N,N,-,-1,-1
TWOMEN.txt,231331,232446,1115,10,N,N,-,-1,-1
TWOMEN.txt,231399,232460,1061,10,N,N,-,-1,-1
TWOMEN.txt,231562,232470,908,10,N,N,-,-1,-1
TWOMEN.txt,231584,232557,973,10,N,N,-,-1,-1
TWOMEN.txt,231832,232589,757,10,N,N,-,-1,-1
TWOMEN.txt,231928,232601,673,10,N,N,-,-1,-1
TWOMEN.txt,231977,232621,644,10,N,N,-,-1,-1
TWOMEN.txt,232338,232681,343,10,N,N,-,-1,-1
TWOMEN.txt,232362,232704,342,10,N,N,-,-1,-1
TWOMEN.txt,232386,232724,338,10,N,N,-,-1,-1
TWOMEN.txt,232448,232744,296,10,N,N,-,-1,-1
TWOMEN.txt,232461,232774,313,10,N,N,-,-1,-1
TWOMEN.txt,232472,232809,337,10,N,N,-,-1,-1
TWOMEN.txt,232560,232862,302,10,N,N,-,-1,-1
TWOMEN.txt,232589,232925,336,10,N,N,-,-1,-1
TWOMEN.txt,232603,232958,355,10,N,N,-,-1,-1
TWOMEN.txt,232623,233020,397,10,N,N,-,-1,-1
TWOMEN.txt,232683,233104,421,10,N,N,-,-1,-1
TWOMEN.txt,232707,233155,448,10,N,N,-,-1,-1
TWOMEN.txt,232725,233269,544,10,N,N,-,-1,-1
TWOMEN.txt,232746,233323,577,10,N,N,-,-1,-1
TWOMEN.txt,232775,233440,665,10,N,N,-,-1,-1
TWOMEN.txt,232810,233492,682,10,N,N,-,-1,-1
TWOMEN.txt,232863,233555,692,10,N,N,-,-1,-1
TWOMEN.txt,232930,233577,647,10,N,N,-,-1,-1
TWOMEN.txt,232960,233588,628,10,N,N,-,-1,-1
TWOMEN.txt,233021,233608,587,10,N,N,-,-1,-1
TWOMEN.txt,233105,233656,551,10,N,N,-,-1,-1
TWOMEN.txt,233156,233786,630,10,N,N,-,-1,-1
TWOMEN.txt,233271,233885,614,10,N,N,-,-1,-1
TWOMEN.txt,233325,234072,747,10,N,N,-,-1,-1
TWOMEN.txt,233442,234134,692,10,N,N,-,-1,-1
TWOMEN.txt,233493,234201,708,10,N,N,-,-1,-1
TWOMEN.txt,233558,234304,746,10,N,N,-,-1,-1
TWOMEN.txt,233578,234366,788,10,N,N,-,-1,-1
TWOMEN.txt,233590,234436,846,10,N,N,-,-1,-1
TWOMEN.txt,233610,234515,905,10,N,N,-,-1,-1
TWOMEN.txt,233657,234555,898,10,N,N,-,-1,-1
TWOMEN.txt,233788,234600,812,10,N,N,-,-1,-1
TWOMEN.txt,233886,234615,729,10,N,N,-,-1,-1
TWOMEN.txt,234077,234676,599,10,N,N,-,-1,-1
TWOMEN.txt,234135,234681,546,10,N,N,-,-1,-1
TWOMEN.txt,234202,234687,485,10,N,N,-,-1,-1
TWOMEN.txt,234305,234878,573,10,N,N,-,-1,-1
TWOMEN.txt,234367,234918,551,10,N,N,-,-1,-1
TWOMEN.txt,234437,235019,582,10,N,N,-,-1,-1
TWOMEN.txt,234516,235091,575,10,N,N,-,-1,-1
TWOMEN.txt,234557,235201,644,10,N,N,-,-1,-1
TWOMEN.txt,234601,235235,634,10,N,N,-,-1,-1
TWOMEN.txt,234616,235275,659,10,N,N,-,-1,-1
TWOMEN.txt,234678,235307,629,10,N,N,-,-1,-1
TWOMEN.txt,234682,235337,655,10,N,N,-,-1,-1
TWOMEN.txt,234688,235396,708,10,N,N,-,-1,-1
TWOMEN.txt,234879,235439,560,10,N,N,-,-1,-1
TWOMEN.txt,234919,235458,539,10,N,N,-,-1,-1
TWOMEN.txt,235021,235459,438,10,N,N,-,-1,-1
TWOMEN.txt,235092,235525,433,10,N,N,-,-1,-1
TWOMEN.txt,235202,235542,340,10,N,N,-,-1,-1
TWOMEN.txt,235236,235713,477,10,N,N,-,-1,-1
TWOMEN.txt,235276,235740,464,10,N,N,-,-1,-1
TWOMEN.txt,235311,235792,481,10,N,N,-,-1,-1
TWOMEN.txt,235339,235822,483,10,N,N,-,-1,-1
TWOMEN.txt,235402,235880,478,10,N,N,-,-1,-1
TWOMEN.txt,235440,236024,584,10,N,N,-,-1,-1
TWOMEN.txt,235458,236369,911,10,N,N,-,-1,-1
TWOMEN.txt,235462,236419,957,10,N,N,-,-1,-1
TWOMEN.txt,235526,236520,994,10,N,N,-,-1,-1
TWOMEN.txt,235543,236531,988,10,N,N,-,-1,-1
TWOMEN.txt,235714,236660,946,10,N,N,-,-1,-1
TWOMEN.txt,235742,236684,942,10,N,N,-,-1,-1
TWOMEN.txt,235793,236765,972,10,N,N,-,-1,-1
TWOMEN.txt,235823,236825,1002,10,N,N,-,-1,-1
TWOMEN.txt,235882,236878,996,10,N,N,-,-1,-1
TWOMEN.txt,236025,236889,864,10,N,N,-,-1,-1
TWOMEN.txt,236371,236939,568,10,N,Y,1437471397525,350644,351290
TWOMEN.txt,236420,237231,811,10,N,Y,1437471397525,350644,351290
TWOMEN.txt,236521,237283,762,10,N,Y,1437471397525,350644,351290
TWOMEN.txt,236533,237373,840,10,N,Y,1437471397525,350644,351290
TWOMEN.txt,236662,237502,840,10,N,Y,1437471397525,350644,351290
TWOMEN.txt,236685,237626,941,10,N,Y,1437471397525,350644,351290
TWOMEN.txt,236767,237802,1035,10,N,Y,1437471397525,350644,351290
TWOMEN.txt,236830,237916,1086,10,N,Y,1437471397525,350644,351290
TWOMEN.txt,236879,237966,1087,10,N,Y,1437471397525,350644,351290
TWOMEN.txt,236891,237977,1086,10,N,Y,1437471397525,350644,351290
TWOMEN.txt,236940,237996,1056,10,N,Y,1437471397525,350644,351290
TWOMEN.txt,237232,238023,791,10,N,Y,1437471397525,350644,351290
TWOMEN.txt,237285,238198,913,10,N,N,-,-1,-1
TWOMEN.txt,237375,238227,852,10,N,N,-,-1,-1
TWOMEN.txt,237506,238261,755,10,N,N,-,-1,-1
TWOMEN.txt,237628,238287,659,10,N,N,-,-1,-1
TWOMEN.txt,237804,238323,519,10,N,N,-,-1,-1
TWOMEN.txt,237921,238334,413,10,N,N,-,-1,-1
TWOMEN.txt,237967,238355,388,10,N,N,-,-1,-1
TWOMEN.txt,237980,238408,428,10,N,N,-,-1,-1
TWOMEN.txt,237998,238824,826,10,N,N,-,-1,-1
TWOMEN.txt,238024,238879,855,10,N,N,-,-1,-1
TWOMEN.txt,238200,238896,696,10,N,N,-,-1,-1
TWOMEN.txt,238228,239099,871,10,N,N,-,-1,-1
TWOMEN.txt,238262,239138,876,10,N,N,-,-1,-1
TWOMEN.txt,238290,239405,1115,10,N,N,-,-1,-1
TWOMEN.txt,238324,239460,1136,10,N,N,-,-1,-1
TWOMEN.txt,238337,239564,1227,10,N,N,-,-1,-1
TWOMEN.txt,238357,239691,1334,10,N,N,-,-1,-1
TWOMEN.txt,238410,239867,1457,10,N,N,-,-1,-1
TWOMEN.txt,238829,239931,1102,10,N,N,-,-1,-1
TWOMEN.txt,238883,240055,1172,10,N,N,-,-1,-1
TWOMEN.txt,238901,240112,1211,10,N,N,-,-1,-1
TWOMEN.txt,239100,240195,1095,10,N,N,-,-1,-1
TWOMEN.txt,239138,240222,1084,10,N,N,-,-1,-1
TWOMEN.txt,239406,240275,869,10,N,N,-,-1,-1
TWOMEN.txt,239462,240439,977,10,N,N,-,-1,-1
TWOMEN.txt,239565,240513,948,10,N,N,-,-1,-1
TWOMEN.txt,239692,240629,937,10,N,N,-,-1,-1
TWOMEN.txt,239869,240767,898,10,N,N,-,-1,-1
TWOMEN.txt,239932,240850,918,10,N,N,-,-1,-1
TWOMEN.txt,240057,241042,985,10,N,N,-,-1,-1
TWOMEN.txt,240113,241157,1044,10,N,N,-,-1,-1
TWOMEN.txt,240196,241223,1027,10,N,N,-,-1,-1
TWOMEN.txt,240223,241290,1067,10,N,N,-,-1,-1
TWOMEN.txt,240276,241305,1029,10,N,N,-,-1,-1
TWOMEN.txt,240441,241308,867,10,N,N,-,-1,-1
TWOMEN.txt,240514,241535,1021,10,N,N,-,-1,-1
TWOMEN.txt,240631,241602,971,10,N,N,-,-1,-1
TWOMEN.txt,240767,241678,911,10,N,N,-,-1,-1
TWOMEN.txt,240851,241832,981,10,N,N,-,-1,-1
TWOMEN.txt,241043,241999,956,10,N,N,-,-1,-1
TWOMEN.txt,241159,242021,862,10,N,N,-,-1,-1
TWOMEN.txt,241225,242093,868,10,N,N,-,-1,-1
TWOMEN.txt,241291,242194,903,10,N,N,-,-1,-1
TWOMEN.txt,241306,242288,982,10,N,Y,1437475017618,98942,100041
TWOMEN.txt,241308,242417,1109,10,N,Y,1437475017618,98942,100041
TWOMEN.txt,241537,242512,975,10,N,Y,1437475017618,98942,100041
TWOMEN.txt,241603,242586,983,10,N,Y,1437475017618,98942,100041
TWOMEN.txt,241679,242661,982,10,N,Y,1437475017618,98942,100041
TWOMEN.txt,241832,242739,907,10,N,Y,1437475017618,98942,100041
TWOMEN.txt,242000,242952,952,10,N,Y,1437475017618,98942,100041
TWOMEN.txt,242022,242972,950,10,N,Y,1437475017618,98942,100041
TWOMEN.txt,242095,242985,890,10,N,Y,1437475017618,98942,100041
TWOMEN.txt,242196,243011,815,10,N,Y,1437475017618,98942,100041
TWOMEN.txt,242289,243052,763,10,N,Y,1437475017618,98942,100041
TWOMEN.txt,242418,243148,730,10,N,Y,1437475017618,98942,100041
TWOMEN.txt,242513,243362,849,10,N,Y,1437475017618,98942,100041
TWOMEN.txt,242588,243375,787,10,N,Y,1437475017618,98942,100041
TWOMEN.txt,242663,243431,768,10,N,Y,1437475017618,98942,100041
TWOMEN.txt,242740,243598,858,10,N,Y,1437475017618,98942,100041
TWOMEN.txt,242953,243656,703,10,N,N,-,-1,-1
TWOMEN.txt,242975,243726,751,10,N,N,-,-1,-1
TWOMEN.txt,242986,243752,766,10,N,N,-,-1,-1
TWOMEN.txt,243013,243761,748,10,N,N,-,-1,-1
TWOMEN.txt,243053,243768,715,10,N,N,-,-1,-1
TWOMEN.txt,243150,243784,634,10,N,N,-,-1,-1
TWOMEN.txt,243364,243790,426,10,N,N,-,-1,-1
TWOMEN.txt,243380,243803,423,10,N,N,-,-1,-1
TWOMEN.txt,243432,244015,583,10,N,N,-,-1,-1
TWOMEN.txt,243599,244064,465,10,N,N,-,-1,-1
TWOMEN.txt,243657,244183,526,10,N,N,-,-1,-1
TWOMEN.txt,243727,244290,563,10,N,N,-,-1,-1
TWOMEN.txt,243753,244424,671,10,N,N,-,-1,-1
TWOMEN.txt,243762,244509,747,10,N,N,-,-1,-1
TWOMEN.txt,243769,244734,965,10,N,N,-,-1,-1
TWOMEN.txt,243785,244748,963,10,N,N,-,-1,-1
TWOMEN.txt,243792,244754,962,10,N,N,-,-1,-1
TWOMEN.txt,243804,244759,955,10,N,N,-,-1,-1
TWOMEN.txt,244016,244805,789,10,N,N,-,-1,-1
TWOMEN.txt,244066,244892,826,10,N,N,-,-1,-1
TWOMEN.txt,244185,245106,921,10,N,N,-,-1,-1
TWOMEN.txt,244291,245278,987,10,N,N,-,-1,-1
TWOMEN.txt,244426,245439,1013,10,N,N,-,-1,-1
TWOMEN.txt,244510,245483,973,10,N,N,-,-1,-1
TWOMEN.txt,244737,245510,773,10,N,N,-,-1,-1
TWOMEN.txt,244749,245553,804,10,N,N,-,-1,-1
TWOMEN.txt,244757,245569,812,10,N,N,-,-1,-1
TWOMEN.txt,244761,245607,846,10,N,N,-,-1,-1
TWOMEN.txt,244807,245702,895,10,N,N,-,-1,-1
TWOMEN.txt,244893,245867,974,10,N,N,-,-1,-1
TWOMEN.txt,245107,245876,769,10,N,N,-,-1,-1
TWOMEN.txt,245279,246152,873,10,N,N,-,-1,-1
TWOMEN.txt,245440,246160,720,10,N,N,-,-1,-1
TWOMEN.txt,245485,246263,778,10,N,N,-,-1,-1
TWOMEN.txt,245511,246296,785,10,N,N,-,-1,-1
TWOMEN.txt,245555,246356,801,10,N,N,-,-1,-1
TWOMEN.txt,245570,246596,1026,10,N,N,-,-1,-1
TWOMEN.txt,245609,246686,1077,10,N,N,-,-1,-1
TWOMEN.txt,245704,246717,1013,10,N,N,-,-1,-1
TWOMEN.txt,245869,246725,856,10,N,N,-,-1,-1
TWOMEN.txt,245877,246882,1005,10,N,N,-,-1,-1
TWOMEN.txt,246154,246947,793,10,N,N,-,-1,-1
TWOMEN.txt,246162,247047,885,10,N,N,-,-1,-1
TWOMEN.txt,246264,247148,884,10,N,N,-,-1,-1
TWOMEN.txt,246297,247227,930,10,N,N,-,-1,-1
TWOMEN.txt,246358,247443,1085,10,N,N,-,-1,-1
TWOMEN.txt,246598,247459,861,10,N,N,-,-1,-1
TWOMEN.txt,246686,247466,780,10,N,N,-,-1,-1
TWOMEN.txt,246719,247478,759,10,N,N,-,-1,-1
TWOMEN.txt,246727,247543,816,10,N,N,-,-1,-1
TWOMEN.txt,246882,247666,784,10,N,N,-,-1,-1
TWOMEN.txt,246949,247759,810,10,N,N,-,-1,-1
TWOMEN.txt,247049,247870,821,10,N,N,-,-1,-1
TWOMEN.txt,247150,247939,789,10,N,N,-,-1,-1
TWOMEN.txt,247228,248051,823,10,N,N,-,-1,-1
TWOMEN.txt,247445,248182,737,10,N,N,-,-1,-1
TWOMEN.txt,247460,248265,805,10,N,N,-,-1,-1
TWOMEN.txt,247469,248404,935,10,N,N,-,-1,-1
TWOMEN.txt,247480,248695,1215,10,N,N,-,-1,-1
TWOMEN.txt,247544,248942,1398,10,N,N,-,-1,-1
TWOMEN.txt,247667,249115,1448,10,N,N,-,-1,-1
TWOMEN.txt,247760,249292,1532,10,N,N,-,-1,-1
TWOMEN.txt,247871,249429,1558,10,N,N,-,-1,-1
TWOMEN.txt,247940,249826,1886,10,N,N,-,-1,-1
TWOMEN.txt,248052,250262,2210,10,N,N,-,-1,-1
TWOMEN.txt,248183,250276,2093,10,N,N,-,-1,-1
TWOMEN.txt,248266,250312,2046,10,N,N,-,-1,-1
TWOMEN.txt,248405,250471,2066,10,N,N,-,-1,-1
TWOMEN.txt,248696,250593,1897,10,N,N,-,-1,-1
TWOMEN.txt,248943,250606,1663,10,N,N,-,-1,-1
TWOMEN.txt,249116,250680,1564,10,N,N,-,-1,-1
TWOMEN.txt,249293,250701,1408,10,N,N,-,-1,-1
TWOMEN.txt,249430,250785,1355,10,N,N,-,-1,-1
TWOMEN.txt,249827,250868,1041,10,N,N,-,-1,-1
TWOMEN.txt,250265,250982,717,10,N,N,-,-1,-1
TWOMEN.txt,250280,251119,839,10,N,N,-,-1,-1
TWOMEN.txt,250313,251185,872,10,N,N,-,-1,-1
TWOMEN.txt,250473,251317,844,10,N,N,-,-1,-1
TWOMEN.txt,250594,251319,725,10,N,N,-,-1,-1
TWOMEN.txt,250608,251391,783,10,N,N,-,-1,-1
TWOMEN.txt,250681,251525,844,10,N,N,-,-1,-1
TWOMEN.txt,250702,251639,937,10,N,N,-,-1,-1
TWOMEN.txt,250786,251687,901,10,N,N,-,-1,-1
TWOMEN.txt,250869,251769,900,10,N,N,-,-1,-1
TWOMEN.txt,250983,251993,1010,10,N,N,-,-1,-1
TWOMEN.txt,251121,252232,1111,10,N,N,-,-1,-1
TWOMEN.txt,251186,252264,1078,10,N,N,-,-1,-1
TWOMEN.txt,251318,252439,1121,10,N,N,-,-1,-1
TWOMEN.txt,251320,252476,1156,10,N,N,-,-1,-1
TWOMEN.txt,251392,252601,1209,10,N,N,-,-1,-1
TWOMEN.txt,251528,252705,1177,10,N,N,-,-1,-1
TWOMEN.txt,251642,252827,1185,10,N,N,-,-1,-1
TWOMEN.txt,251688,252853,1165,10,N,N,-,-1,-1
TWOMEN.txt,251771,252929,1158,10,N,N,-,-1,-1
TWOMEN.txt,251994,253216,1222,10,N,N,-,-1,-1
TWOMEN.txt,252234,253263,1029,10,N,N,-,-1,-1
TWOMEN.txt,252265,253317,1052,10,N,N,-,-1,-1
TWOMEN.txt,252440,253549,1109,10,N,N,-,-1,-1
TWOMEN.txt,252476,253572,1096,10,N,N,-,-1,-1
TWOMEN.txt,252602,253609,1007,10,N,N,-,-1,-1
TWOMEN.txt,252707,253765,1058,10,N,N,-,-1,-1
TWOMEN.txt,252829,253851,1022,10,N,N,-,-1,-1
TWOMEN.txt,252855,253968,1113,10,N,N,-,-1,-1
TWOMEN.txt,252930,253972,1042,10,N,N,-,-1,-1
TWOMEN.txt,253218,253973,755,10,N,N,-,-1,-1
TWOMEN.txt,253264,254027,763,10,N,N,-,-1,-1
TWOMEN.txt,253317,254234,917,10,N,N,-,-1,-1
TWOMEN.txt,253551,254290,739,10,N,N,-,-1,-1
TWOMEN.txt,253574,254393,819,10,N,N,-,-1,-1
TWOMEN.txt,253610,254437,827,10,N,N,-,-1,-1
TWOMEN.txt,253766,254522,756,10,N,N,-,-1,-1
TWOMEN.txt,253853,254635,782,10,N,N,-,-1,-1
TWOMEN.txt,253970,254661,691,10,N,N,-,-1,-1
TWOMEN.txt,253972,254827,855,10,N,N,-,-1,-1
TWOMEN.txt,253974,254922,948,10,N,N,-,-1,-1
TWOMEN.txt,254029,254934,905,10,N,N,-,-1,-1
TWOMEN.txt,254235,254964,729,10,N,N,-,-1,-1
TWOMEN.txt,254291,255083,792,10,N,N,-,-1,-1
TWOMEN.txt,254396,255112,716,10,N,N,-,-1,-1
TWOMEN.txt,254439,255172,733,10,N,N,-,-1,-1
TWOMEN.txt,254523,255202,679,10,N,N,-,-1,-1
TWOMEN.txt,254636,255232,596,10,N,N,-,-1,-1
TWOMEN.txt,254661,255244,583,10,N,N,-,-1,-1
TWOMEN.txt,254829,255396,567,10,N,N,-,-1,-1
TWOMEN.txt,254922,255603,681,10,N,N,-,-1,-1
TWOMEN.txt,254935,255678,743,10,N,N,-,-1,-1
TWOMEN.txt,254966,255838,872,10,N,N,-,-1,-1
TWOMEN.txt,255086,255897,811,10,N,N,-,-1,-1
TWOMEN.txt,255113,256083,970,10,N,N,-,-1,-1
TWOMEN.txt,255173,256153,980,10,N,N,-,-1,-1
TWOMEN.txt,255204,256206,1002,10,N,N,-,-1,-1
TWOMEN.txt,255233,256337,1104,10,N,N,-,-1,-1
TWOMEN.txt,255245,256393,1148,10,N,N,-,-1,-1
TWOMEN.txt,255397,256399,1002,10,N,N,-,-1,-1
TWOMEN.txt,255604,256408,804,10,N,N,-,-1,-1
TWOMEN.txt,255679,256485,806,10,N,N,-,-1,-1
TWOMEN.txt,255845,256632,787,10,N,N,-,-1,-1
TWOMEN.txt,255898,256749,851,10,N,N,-,-1,-1
TWOMEN.txt,256084,256794,710,10,N,N,-,-1,-1
TWOMEN.txt,256156,256976,820,10,N,N,-,-1,-1
TWOMEN.txt,256207,257047,840,10,N,N,-,-1,-1
TWOMEN.txt,256339,257181,842,10,N,N,-,-1,-1
TWOMEN.txt,256394,257296,902,10,N,N,-,-1,-1
TWOMEN.txt,256400,257415,1015,10,N,N,-,-1,-1
TWOMEN.txt,256409,257567,1158,10,N,N,-,-1,-1
TWOMEN.txt,256486,257627,1141,10,N,N,-,-1,-1
TWOMEN.txt,256633,257686,1053,10,N,N,-,-1,-1
TWOMEN.txt,256750,257775,1025,10,N,N,-,-1,-1
TWOMEN.txt,256796,257977,1181,10,N,N,-,-1,-1
TWOMEN.txt,256977,258063,1086,10,N,N,-,-1,-1
TWOMEN.txt,257048,258251,1203,10,N,N,-,-1,-1
TWOMEN.txt,257182,258468,1286,10,N,N,-,-1,-1
TWOMEN.txt,257297,258586,1289,10,N,N,-,-1,-1
TWOMEN.txt,257417,258741,1324,10,N,N,-,-1,-1
TWOMEN.txt,257572,258841,1269,10,N,N,-,-1,-1
TWOMEN.txt,257629,258885,1256,10,N,N,-,-1,-1
TWOMEN.txt,257688,258964,1276,10,N,N,-,-1,-1
TWOMEN.txt,257777,259113,1336,10,N,N,-,-1,-1
TWOMEN.txt,257979,259304,1325,10,N,N,-,-1,-1
TWOMEN.txt,258066,259526,1460,10,N,N,-,-1,-1
TWOMEN.txt,258252,259621,1369,10,N,N,-,-1,-1
TWOMEN.txt,258469,259742,1273,10,N,N,-,-1,-1
TWOMEN.txt,258588,259830,1242,10,N,N,-,-1,-1
TWOMEN.txt,258742,259841,1099,10,N,N,-,-1,-1
TWOMEN.txt,258844,259848,1004,10,N,N,-,-1,-1
TWOMEN.txt,258887,260049,1162,10,N,N,-,-1,-1
TWOMEN.txt,258965,260293,1328,10,N,N,-,-1,-1
TWOMEN.txt,259114,260311,1197,10,N,N,-,-1,-1
TWOMEN.txt,259305,260339,1034,10,N,N,-,-1,-1
TWOMEN.txt,259527,260441,914,10,N,N,-,-1,-1
TWOMEN.txt,259623,260660,1037,10,N,N,-,-1,-1
TWOMEN.txt,259743,260721,978,10,N,N,-,-1,-1
TWOMEN.txt,259832,260745,913,10,N,N,-,-1,-1
TWOMEN.txt,259842,260751,909,10,N,N,-,-1,-1
TWOMEN.txt,259849,260752,903,10,N,N,-,-1,-1
TWOMEN.txt,260050,260936,886,10,N,N,-,-1,-1
TWOMEN.txt,260296,261189,893,10,N,N,-,-1,-1
TWOMEN.txt,260312,261265,953,10,N,N,-,-1,-1
TWOMEN.txt,260341,261418,1077,10,N,N,-,-1,-1
TWOMEN.txt,260442,261515,1073,10,N,N,-,-1,-1
TWOMEN.txt,260661,262058,1397,10,N,N,-,-1,-1
TWOMEN.txt,260722,262101,1379,10,N,N,-,-1,-1
TWOMEN.txt,260750,262220,1470,10,N,N,-,-1,-1
TWOMEN.txt,260751,262237,1486,10,N,N,-,-1,-1
TWOMEN.txt,260753,262258,1505,10,N,N,-,-1,-1
TWOMEN.txt,260937,262278,1341,10,N,N,-,-1,-1
TWOMEN.txt,261190,262392,1202,10,N,N,-,-1,-1
TWOMEN.txt,261266,262530,1264,10,N,N,-,-1,-1
TWOMEN.txt,261419,262657,1238,10,N,N,-,-1,-1
TWOMEN.txt,261516,262681,1165,10,N,N,-,-1,-1
TWOMEN.txt,262059,262688,629,10,N,N,-,-1,-1
TWOMEN.txt,262102,262796,694,10,N,N,-,-1,-1
TWOMEN.txt,262222,262974,752,10,N,N,-,-1,-1
TWOMEN.txt,262238,263095,857,10,N,N,-,-1,-1
TWOMEN.txt,262260,263136,876,10,N,N,-,-1,-1
TWOMEN.txt,262280,263149,869,10,N,N,-,-1,-1
TWOMEN.txt,262393,263193,800,10,N,N,-,-1,-1
TWOMEN.txt,262531,263207,676,10,N,N,-,-1,-1
TWOMEN.txt,262659,263215,556,10,N,N,-,-1,-1
TWOMEN.txt,262682,263418,736,10,N,N,-,-1,-1
TWOMEN.txt,262689,263464,775,10,N,N,-,-1,-1
TWOMEN.txt,262797,263621,824,10,N,N,-,-1,-1
TWOMEN.txt,262975,263758,783,10,N,N,-,-1,-1
TWOMEN.txt,263099,263770,671,10,N,N,-,-1,-1
TWOMEN.txt,263139,263774,635,10,N,N,-,-1,-1
TWOMEN.txt,263151,263797,646,10,N,N,-,-1,-1
TWOMEN.txt,263195,263826,631,10,N,N,-,-1,-1
TWOMEN.txt,263208,264089,881,10,N,N,-,-1,-1
TWOMEN.txt,263216,264191,975,10,N,N,-,-1,-1
TWOMEN.txt,263419,264331,912,10,N,N,-,-1,-1
TWOMEN.txt,263465,264351,886,10,N,N,-,-1,-1
TWOMEN.txt,263622,264447,825,10,N,N,-,-1,-1
TWOMEN.txt,263760,264675,915,10,N,N,-,-1,-1
TWOMEN.txt,263771,264802,1031,10,N,N,-,-1,-1
TWOMEN.txt,263775,264983,1208,10,N,N,-,-1,-1
TWOMEN.txt,263799,265069,1270,10,N,N,-,-1,-1
TWOMEN.txt,263827,265228,1401,10,N,N,-,-1,-1
TWOMEN.txt,264090,265433,1343,10,N,N,-,-1,-1
TWOMEN.txt,264196,265653,1457,10,N,N,-,-1,-1
TWOMEN.txt,264334,265753,1419,10,N,N,-,-1,-1
TWOMEN.txt,264353,265843,1490,10,N,N,-,-1,-1
TWOMEN.txt,264448,265891,1443,10,N,N,-,-1,-1
TWOMEN.txt,264676,265950,1274,10,N,N,-,-1,-1
TWOMEN.txt,264803,265969,1166,10,N,N,-,-1,-1
TWOMEN.txt,264985,265978,993,10,N,N,-,-1,-1
TWOMEN.txt,265070,265979,909,10,N,N,-,-1,-1
TWOMEN.txt,265229,265986,757,10,N,N,-,-1,-1
TWOMEN.txt,265434,266092,658,10,N,N,-,-1,-1
TWOMEN.txt,265655,266176,521,10,N,N,-,-1,-1
TWOMEN.txt,265754,266273,519,10,N,N,-,-1,-1
TWOMEN.txt,265844,266312,468,10,N,N,-,-1,-1
TWOMEN.txt,265896,266762,866,10,N,N,-,-1,-1
TWOMEN.txt,265951,266796,845,10,N,N,-,-1,-1
TWOMEN.txt,265971,266849,878,10,N,N,-,-1,-1
TWOMEN.txt,265978,267001,1023,10,N,N,-,-1,-1
TWOMEN.txt,265979,267068,1089,10,N,N,-,-1,-1
TWOMEN.txt,265988,267107,1119,10,N,N,-,-1,-1
TWOMEN.txt,266093,267225,1132,10,N,N,-,-1,-1
TWOMEN.txt,266177,267308,1131,10,N,N,-,-1,-1
TWOMEN.txt,266274,267333,1059,10,N,N,-,-1,-1
TWOMEN.txt,266313,267395,1082,10,N,N,-,-1,-1
TWOMEN.txt,266763,267420,657,10,N,N,-,-1,-1
TWOMEN.txt,266798,267526,728,10,N,N,-,-1,-1
TWOMEN.txt,266851,267874,1023,10,N,N,-,-1,-1
TWOMEN.txt,267002,268112,1110,10,N,N,-,-1,-1
TWOMEN.txt,267069,268265,1196,10,N,N,-,-1,-1
TWOMEN.txt,267108,268413,1305,10,N,N,-,-1,-1
TWOMEN.txt,267226,268503,1277,10,N,N,-,-1,-1
TWOMEN.txt,267311,268655,1344,10,N,N,-,-1,-1
TWOMEN.txt,267334,268779,1445,10,N,N,-,-1,-1
TWOMEN.txt,267398,268796,1398,10,N,N,-,-1,-1
TWOMEN.txt,267422,268820,1398,10,N,N,-,-1,-1
TWOMEN.txt,267529,268930,1401,10,N,N,-,-1,-1
TWOMEN.txt,267876,269020,1144,10,N,N,-,-1,-1
TWOMEN.txt,268113,269271,1158,10,N,N,-,-1,-1
TWOMEN.txt,268267,269345,1078,10,N,N,-,-1,-1
TWOMEN.txt,268414,269517,1103,10,N,N,-,-1,-1
TWOMEN.txt,268505,269533,1028,10,N,N,-,-1,-1
TWOMEN.txt,268656,269546,890,10,N,N,-,-1,-1
TWOMEN.txt,268782,269556,774,10,N,N,-,-1,-1
TWOMEN.txt,268797,269615,818,10,N,N,-,-1,-1
TWOMEN.txt,268822,269861,1039,10,N,N,-,-1,-1
TWOMEN.txt,268931,269926,995,10,N,N,-,-1,-1
TWOMEN.txt,269021,269941,920,10,N,N,-,-1,-1
TWOMEN.txt,269272,270108,836,10,N,N,-,-1,-1
TWOMEN.txt,269346,270250,904,10,N,N,-,-1,-1
TWOMEN.txt,269519,270280,761,10,N,N,-,-1,-1
TWOMEN.txt,269534,270290,756,10,N,N,-,-1,-1
TWOMEN.txt,269547,270357,810,10,N,N,-,-1,-1
TWOMEN.txt,269558,270543,985,10,N,N,-,-1,-1
TWOMEN.txt,269617,270639,1022,10,N,N,-,-1,-1
TWOMEN.txt,269862,270712,850,10,N,N,-,-1,-1
TWOMEN.txt,269927,271015,1088,10,N,N,-,-1,-1
TWOMEN.txt,269943,271164,1221,10,N,N,-,-1,-1
TWOMEN.txt,270108,271383,1275,10,N,N,-,-1,-1
TWOMEN.txt,270252,271553,1301,10,N,N,-,-1,-1
TWOMEN.txt,270281,271586,1305,10,N,N,-,-1,-1
TWOMEN.txt,270292,271696,1404,10,N,N,-,-1,-1
TWOMEN.txt,270358,271793,1435,10,N,N,-,-1,-1
TWOMEN.txt,270544,271840,1296,10,N,N,-,-1,-1
TWOMEN.txt,270641,272051,1410,10,N,N,-,-1,-1
TWOMEN.txt,270713,272350,1637,10,N,N,-,-1,-1
TWOMEN.txt,271016,272367,1351,10,N,N,-,-1,-1
TWOMEN.txt,271165,272390,1225,10,N,N,-,-1,-1
TWOMEN.txt,271384,272579,1195,10,N,N,-,-1,-1
TWOMEN.txt,271554,272602,1048,10,N,N,-,-1,-1
TWOMEN.txt,271587,272787,1200,10,N,N,-,-1,-1
TWOMEN.txt,271697,272893,1196,10,N,N,-,-1,-1
TWOMEN.txt,271795,273230,1435,10,N,N,-,-1,-1
TWOMEN.txt,271841,273383,1542,10,N,N,-,-1,-1
TWOMEN.txt,272052,273533,1481,10,N,N,-,-1,-1
TWOMEN.txt,272353,273550,1197,10,N,N,-,-1,-1
TWOMEN.txt,272368,273573,1205,10,N,N,-,-1,-1
TWOMEN.txt,272392,273761,1369,10,N,N,-,-1,-1
TWOMEN.txt,272580,273779,1199,10,N,N,-,-1,-1
TWOMEN.txt,272603,273780,1177,10,N,N,-,-1,-1
TWOMEN.txt,272788,273836,1048,10,N,N,-,-1,-1
TWOMEN.txt,272900,274010,1110,10,N,N,-,-1,-1
TWOMEN.txt,273230,274172,942,10,N,N,-,-1,-1
TWOMEN.txt,273384,274313,929,10,N,N,-,-1,-1
TWOMEN.txt,273536,274650,1114,10,N,N,-,-1,-1
TWOMEN.txt,273551,274933,1382,10,N,N,-,-1,-1
TWOMEN.txt,273575,275037,1462,10,N,N,-,-1,-1
TWOMEN.txt,273762,275141,1379,10,N,N,-,-1,-1
TWOMEN.txt,273779,275157,1378,10,N,N,-,-1,-1
TWOMEN.txt,273782,275266,1484,10,N,N,-,-1,-1
TWOMEN.txt,273838,275287,1449,10,N,N,-,-1,-1
TWOMEN.txt,274012,275339,1327,10,N,N,-,-1,-1
TWOMEN.txt,274174,275397,1223,10,N,N,-,-1,-1
TWOMEN.txt,274314,275438,1124,10,N,N,-,-1,-1
TWOMEN.txt,274651,275458,807,10,N,N,-,-1,-1
TWOMEN.txt,274934,275481,547,10,N,N,-,-1,-1
TWOMEN.txt,275038,275501,463,10,N,N,-,-1,-1
TWOMEN.txt,275143,275846,703,10,N,N,-,-1,-1
TWOMEN.txt,275158,275919,761,10,N,N,-,-1,-1
TWOMEN.txt,275267,276175,908,10,N,N,-,-1,-1
TWOMEN.txt,275290,276201,911,10,N,N,-,-1,-1
TWOMEN.txt,275340,276277,937,10,N,N,-,-1,-1
TWOMEN.txt,275399,276295,896,10,N,N,-,-1,-1
TWOMEN.txt,275441,276329,888,10,N,N,-,-1,-1
TWOMEN.txt,275459,276335,876,10,N,N,-,-1,-1
TWOMEN.txt,275483,276343,860,10,N,N,-,-1,-1
TWOMEN.txt,275502,276689,1187,10,N,N,-,-1,-1
TWOMEN.txt,275847,276729,882,10,N,N,-,-1,-1
TWOMEN.txt,275920,276770,850,10,N,N,-,-1,-1
TWOMEN.txt,276177,276834,657,10,N,N,-,-1,-1
TWOMEN.txt,276203,276955,752,10,N,N,-,-1,-1
TWOMEN.txt,276283,277088,805,10,N,N,-,-1,-1
TWOMEN.txt,276296,277131,835,10,N,N,-,-1,-1
TWOMEN.txt,276330,277439,1109,10,N,N,-,-1,-1
TWOMEN.txt,276335,277650,1315,10,N,N,-,-1,-1
TWOMEN.txt,276344,277710,1366,10,N,N,-,-1,-1
TWOMEN.txt,276691,277809,1118,10,N,N,-,-1,-1
TWOMEN.txt,276730,277978,1248,10,N,N,-,-1,-1
TWOMEN.txt,276771,278174,1403,10,N,N,-,-1,-1
TWOMEN.txt,276835,278195,1360,10,N,N,-,-1,-1
TWOMEN.txt,276956,278213,1257,10,N,N,-,-1,-1
TWOMEN.txt,277089,278316,1227,10,N,N,-,-1,-1
TWOMEN.txt,277132,278333,1201,10,N,N,-,-1,-1
TWOMEN.txt,277440,278362,922,10,N,N,-,-1,-1
TWOMEN.txt,277652,278382,730,10,N,N,-,-1,-1
TWOMEN.txt,277712,278630,918,10,N,N,-,-1,-1
TWOMEN.txt,277810,278747,937,10,N,N,-,-1,-1
TWOMEN.txt,277979,279033,1054,10,N,N,-,-1,-1
TWOMEN.txt,278175,279049,874,10,N,N,-,-1,-1
TWOMEN.txt,278196,279087,891,10,N,N,-,-1,-1
TWOMEN.txt,278215,279115,900,10,N,N,-,-1,-1
TWOMEN.txt,278319,279194,875,10,N,N,-,-1,-1
TWOMEN.txt,278334,279238,904,10,N,N,-,-1,-1
TWOMEN.txt,278364,279535,1171,10,N,N,-,-1,-1
TWOMEN.txt,278384,279580,1196,10,N,N,-,-1,-1
TWOMEN.txt,278631,279705,1074,10,N,N,-,-1,-1
TWOMEN.txt,278748,279829,1081,10,N,N,-,-1,-1
TWOMEN.txt,279035,279896,861,10,N,N,-,-1,-1
TWOMEN.txt,279052,279929,877,10,N,N,-,-1,-1
TWOMEN.txt,279090,279935,845,10,N,N,-,-1,-1
TWOMEN.txt,279117,279983,866,10,N,N,-,-1,-1
TWOMEN.txt,279196,280075,879,10,N,N,-,-1,-1
TWOMEN.txt,279239,280130,891,10,N,N,-,-1,-1
TWOMEN.txt,279537,280313,776,10,N,N,-,-1,-1
TWOMEN.txt,279581,280362,781,10,N,N,-,-1,-1
TWOMEN.txt,279706,280377,671,10,N,N,-,-1,-1
TWOMEN.txt,279830,280403,573,10,N,N,-,-1,-1
TWOMEN.txt,279898,280628,730,10,N,N,-,-1,-1
TWOMEN.txt,279930,280785,855,10,N,N,-,-1,-1
TWOMEN.txt,279937,280976,1039,10,N,N,-,-1,-1
TWOMEN.txt,279985,281179,1194,10,N,N,-,-1,-1
TWOMEN.txt,280076,281224,1148,10,N,N,-,-1,-1
TWOMEN.txt,280131,281277,1146,10,N,N,-,-1,-1
TWOMEN.txt,280314,281302,988,10,N,N,-,-1,-1
TWOMEN.txt,280364,281386,1022,10,N,N,-,-1,-1
TWOMEN.txt,280378,281441,1063,10,N,N,-,-1,-1
TWOMEN.txt,280405,281495,1090,10,N,N,-,-1,-1
TWOMEN.txt,280629,281535,906,10,N,N,-,-1,-1
TWOMEN.txt,280786,281633,847,10,N,N,-,-1,-1
TWOMEN.txt,280977,281680,703,10,N,N,-,-1,-1
TWOMEN.txt,281181,281820,639,10,N,N,-,-1,-1
TWOMEN.txt,281229,282017,788,10,N,N,-,-1,-1
TWOMEN.txt,281278,282346,1068,10,N,N,-,-1,-1
TWOMEN.txt,281303,282380,1077,10,N,N,-,-1,-1
TWOMEN.txt,281387,282498,1111,10,N,N,-,-1,-1
TWOMEN.txt,281442,282797,1355,10,N,N,-,-1,-1
TWOMEN.txt,281496,282897,1401,10,N,N,-,-1,-1
TWOMEN.txt,281536,282936,1400,10,N,N,-,-1,-1
TWOMEN.txt,281634,283034,1400,10,N,N,-,-1,-1
TWOMEN.txt,281681,283046,1365,10,N,N,-,-1,-1
TWOMEN.txt,281822,283064,1242,10,N,N,-,-1,-1
TWOMEN.txt,282018,283162,1144,10,N,N,-,-1,-1
TWOMEN.txt,282347,283295,948,10,N,N,-,-1,-1
TWOMEN.txt,282381,283308,927,10,N,N,-,-1,-1
TWOMEN.txt,282500,283425,925,10,N,N,-,-1,-1
TWOMEN.txt,282798,283479,681,10,N,N,-,-1,-1
TWOMEN.txt,282898,283543,645,10,N,N,-,-1,-1
TWOMEN.txt,282937,283550,613,10,N,N,-,-1,-1
TWOMEN.txt,283037,283628,591,10,N,N,-,-1,-1
TWOMEN.txt,283049,283694,645,10,N,N,-,-1,-1
TWOMEN.txt,283065,283729,664,10,N,N,-,-1,-1
TWOMEN.txt,283163,283744,581,10,N,N,-,-1,-1
TWOMEN.txt,283296,283794,498,10,N,N,-,-1,-1
TWOMEN.txt,283309,283856,547,10,N,N,-,-1,-1
TWOMEN.txt,283426,283857,431,10,N,N,-,-1,-1
TWOMEN.txt,283480,283886,406,10,N,N,-,-1,-1
TWOMEN.txt,283544,283887,343,10,N,N,-,-1,-1
TWOMEN.txt,283551,283901,350,10,N,N,-,-1,-1
TWOMEN.txt,283629,283903,274,10,N,N,-,-1,-1
TWOMEN.txt,283695,283945,250,10,N,N,-,-1,-1
TWOMEN.txt,283731,284022,291,10,N,N,-,-1,-1
TWOMEN.txt,283745,284089,344,10,N,N,-,-1,-1
TWOMEN.txt,283795,284159,364,10,N,N,-,-1,-1
TWOMEN.txt,283856,284164,308,10,N,N,-,-1,-1
TWOMEN.txt,283857,284208,351,10,N,N,-,-1,-1
TWOMEN.txt,283886,284217,331,10,N,N,-,-1,-1
TWOMEN.txt,283887,284477,590,10,N,N,-,-1,-1
TWOMEN.txt,283902,284599,697,10,N,N,-,-1,-1
TWOMEN.txt,283904,284776,872,10,N,N,-,-1,-1
TWOMEN.txt,283946,284833,887,10,N,N,-,-1,-1
TWOMEN.txt,284023,284890,867,10,N,N,-,-1,-1
TWOMEN.txt,284091,284996,905,10,N,N,-,-1,-1
TWOMEN.txt,284160,285013,853,10,N,N,-,-1,-1
TWOMEN.txt,284165,285019,854,10,N,N,-,-1,-1
TWOMEN.txt,284209,285038,829,10,N,N,-,-1,-1
TWOMEN.txt,284219,285344,1125,10,N,N,-,-1,-1
TWOMEN.txt,284478,285355,877,10,N,N,-,-1,-1
TWOMEN.txt,284600,285462,862,10,N,N,-,-1,-1
TWOMEN.txt,284777,285589,812,10,N,N,-,-1,-1
TWOMEN.txt,284837,285724,887,10,N,N,-,-1,-1
TWOMEN.txt,284895,285808,913,10,N,N,-,-1,-1
TWOMEN.txt,284999,285829,830,10,N,N,-,-1,-1
TWOMEN.txt,285014,285856,842,10,N,N,-,-1,-1
TWOMEN.txt,285019,285888,869,10,N,N,-,-1,-1
TWOMEN.txt,285040,286010,970,10,N,N,-,-1,-1
TWOMEN.txt,285345,286294,949,10,N,N,-,-1,-1
TWOMEN.txt,285356,286471,1115,10,N,N,-,-1,-1
TWOMEN.txt,285463,286758,1295,10,N,N,-,-1,-1
TWOMEN.txt,285591,286919,1328,10,N,N,-,-1,-1
TWOMEN.txt,285725,287072,1347,10,N,N,-,-1,-1
TWOMEN.txt,285811,287158,1347,10,N,N,-,-1,-1
TWOMEN.txt,285830,287439,1609,10,N,N,-,-1,-1
TWOMEN.txt,285857,287445,1588,10,N,N,-,-1,-1
TWOMEN.txt,285889,287474,1585,10,N,N,-,-1,-1
TWOMEN.txt,286011,287582,1571,10,N,N,-,-1,-1
TWOMEN.txt,286295,287617,1322,10,N,N,-,-1,-1
TWOMEN.txt,286476,287683,1207,10,N,N,-,-1,-1
TWOMEN.txt,286761,287774,1013,10,N,N,-,-1,-1
TWOMEN.txt,286920,287827,907,10,N,N,-,-1,-1
TWOMEN.txt,287074,288038,964,10,N,N,-,-1,-1
TWOMEN.txt,287159,288119,960,10,N,N,-,-1,-1
TWOMEN.txt,287441,288162,721,10,N,N,-,-1,-1
TWOMEN.txt,287446,288210,764,10,N,N,-,-1,-1
TWOMEN.txt,287476,288220,744,10,N,N,-,-1,-1
TWOMEN.txt,287583,288773,1190,10,N,N,-,-1,-1
TWOMEN.txt,287619,288793,1174,10,N,N,-,-1,-1
TWOMEN.txt,287684,288803,1119,10,N,N,-,-1,-1
TWOMEN.txt,287775,288818,1043,10,N,N,-,-1,-1
TWOMEN.txt,287828,288876,1048,10,N,N,-,-1,-1
TWOMEN.txt,288041,289042,1001,10,N,N,-,-1,-1
TWOMEN.txt,288121,289203,1082,10,N,N,-,-1,-1
TWOMEN.txt,288167,289305,1138,10,N,N,-,-1,-1
TWOMEN.txt,288211,289364,1153,10,N,N,-,-1,-1
TWOMEN.txt,288220,289409,1189,10,N,N,-,-1,-1
TWOMEN.txt,288776,289573,797,10,N,N,-,-1,-1
TWOMEN.txt,288794,289618,824,10,N,N,-,-1,-1
TWOMEN.txt,288803,289867,1064,10,N,N,-,-1,-1
TWOMEN.txt,288819,289903,1084,10,N,N,-,-1,-1
TWOMEN.txt,288877,290119,1242,10,N,N,-,-1,-1
TWOMEN.txt,289043,290154,1111,10,N,N,-,-1,-1
TWOMEN.txt,289205,290170,965,10,N,N,-,-1,-1
TWOMEN.txt,289306,290180,874,10,N,N,-,-1,-1
TWOMEN.txt,289365,290196,831,10,N,N,-,-1,-1
TWOMEN.txt,289410,290453,1043,10,N,N,-,-1,-1
TWOMEN.txt,289575,290752,1177,10,N,N,-,-1,-1
TWOMEN.txt,289623,290771,1148,10,N,N,-,-1,-1
TWOMEN.txt,289868,290884,1016,10,N,N,-,-1,-1
TWOMEN.txt,289904,290891,987,10,N,N,-,-1,-1
TWOMEN.txt,290121,291052,931,10,N,N,-,-1,-1
TWOMEN.txt,290157,291064,907,10,N,N,-,-1,-1
TWOMEN.txt,290171,291437,1266,10,N,N,-,-1,-1
TWOMEN.txt,290180,291496,1316,10,N,N,-,-1,-1
TWOMEN.txt,290198,291881,1683,10,N,N,-,-1,-1
TWOMEN.txt,290454,292126,1672,10,N,N,-,-1,-1
TWOMEN.txt,290755,292558,1803,10,N,N,-,-1,-1
TWOMEN.txt,290772,292732,1960,10,N,N,-,-1,-1
TWOMEN.txt,290885,292791,1906,10,N,N,-,-1,-1
TWOMEN.txt,290892,292810,1918,10,N,N,-,-1,-1
TWOMEN.txt,291053,292828,1775,10,N,N,-,-1,-1
TWOMEN.txt,291066,292862,1796,10,N,N,-,-1,-1
TWOMEN.txt,291438,292926,1488,10,N,N,-,-1,-1
TWOMEN.txt,291497,293105,1608,10,N,N,-,-1,-1
TWOMEN.txt,291881,293287,1406,10,N,N,-,-1,-1
TWOMEN.txt,292127,293455,1328,10,N,N,-,-1,-1
TWOMEN.txt,292559,293556,997,10,N,N,-,-1,-1
TWOMEN.txt,292733,293743,1010,10,N,N,-,-1,-1
TWOMEN.txt,292794,293828,1034,10,N,N,-,-1,-1
TWOMEN.txt,292812,293842,1030,10,N,N,-,-1,-1
TWOMEN.txt,292830,293868,1038,10,N,N,-,-1,-1
TWOMEN.txt,292863,294030,1167,10,N,N,-,-1,-1
TWOMEN.txt,292928,294317,1389,10,N,N,-,-1,-1
TWOMEN.txt,293106,294420,1314,10,N,N,-,-1,-1
TWOMEN.txt,293288,294437,1149,10,N,N,-,-1,-1
TWOMEN.txt,293456,294450,994,10,N,N,-,-1,-1
TWOMEN.txt,293558,294463,905,10,N,N,-,-1,-1
TWOMEN.txt,293746,294583,837,10,N,N,-,-1,-1
TWOMEN.txt,293830,294614,784,10,N,N,-,-1,-1
TWOMEN.txt,293843,294680,837,10,N,N,-,-1,-1
TWOMEN.txt,293870,294691,821,10,N,N,-,-1,-1
TWOMEN.txt,294031,294998,967,10,N,N,-,-1,-1
TWOMEN.txt,294318,295070,752,10,N,N,-,-1,-1
TWOMEN.txt,294422,295218,796,10,N,N,-,-1,-1
TWOMEN.txt,294438,295420,982,10,N,N,-,-1,-1
TWOMEN.txt,294450,295564,1114,10,N,N,-,-1,-1
TWOMEN.txt,294465,295588,1123,10,N,N,-,-1,-1
TWOMEN.txt,294585,295590,1005,10,N,N,-,-1,-1
TWOMEN.txt,294614,295607,993,10,N,N,-,-1,-1
TWOMEN.txt,294684,295696,1012,10,N,N,-,-1,-1
TWOMEN.txt,294696,295872,1176,10,N,N,-,-1,-1
TWOMEN.txt,294999,295917,918,10,N,N,-,-1,-1
TWOMEN.txt,295072,296001,929,10,N,N,-,-1,-1
TWOMEN.txt,295219,296108,889,10,N,N,-,-1,-1
TWOMEN.txt,295421,296267,846,10,N,N,-,-1,-1
TWOMEN.txt,295567,296319,752,10,N,N,-,-1,-1
TWOMEN.txt,295589,296357,768,10,N,N,-,-1,-1
TWOMEN.txt,295590,296392,802,10,N,N,-,-1,-1
TWOMEN.txt,295609,296421,812,10,N,N,-,-1,-1
TWOMEN.txt,295698,296536,838,10,N,N,-,-1,-1
TWOMEN.txt,295874,296577,703,10,N,N,-,-1,-1
TWOMEN.txt,295918,296707,789,10,N,N,-,-1,-1
TWOMEN.txt,296002,297110,1108,10,N,N,-,-1,-1
TWOMEN.txt,296110,297343,1233,10,N,N,-,-1,-1
TWOMEN.txt,296268,297464,1196,10,N,N,-,-1,-1
TWOMEN.txt,296325,297598,1273,10,N,N,-,-1,-1
TWOMEN.txt,296358,297626,1268,10,N,N,-,-1,-1
TWOMEN.txt,296394,297642,1248,10,N,N,-,-1,-1
TWOMEN.txt,296422,297678,1256,10,N,N,-,-1,-1
TWOMEN.txt,296538,297738,1200,10,N,N,-,-1,-1
TWOMEN.txt,296578,297825,1247,10,N,N,-,-1,-1
TWOMEN.txt,296709,297946,1237,10,N,N,-,-1,-1
TWOMEN.txt,297111,298101,990,10,N,N,-,-1,-1
TWOMEN.txt,297344,298226,882,10,N,N,-,-1,-1
TWOMEN.txt,297465,298399,934,10,N,N,-,-1,-1
TWOMEN.txt,297599,298575,976,10,N,N,-,-1,-1
TWOMEN.txt,297628,298916,1288,10,N,N,-,-1,-1
TWOMEN.txt,297643,298934,1291,10,N,N,-,-1,-1
TWOMEN.txt,297680,298940,1260,10,N,N,-,-1,-1
TWOMEN.txt,297740,298957,1217,10,N,N,-,-1,-1
TWOMEN.txt,297826,298963,1137,10,N,N,-,-1,-1
TWOMEN.txt,297947,298979,1032,10,N,N,-,-1,-1
TWOMEN.txt,298106,299200,1094,10,N,N,-,-1,-1
TWOMEN.txt,298227,299232,1005,10,N,N,-,-1,-1
TWOMEN.txt,298400,299244,844,10,N,N,-,-1,-1
TWOMEN.txt,298576,299288,712,10,N,N,-,-1,-1
TWOMEN.txt,298919,299385,466,10,N,N,-,-1,-1
TWOMEN.txt,298935,299390,455,10,N,N,-,-1,-1
TWOMEN.txt,298940,299594,654,10,N,N,-,-1,-1
TWOMEN.txt,298959,299673,714,10,N,N,-,-1,-1
TWOMEN.txt,298964,299714,750,10,N,N,-,-1,-1
TWOMEN.txt,298983,299784,801,10,N,N,-,-1,-1
TWOMEN.txt,299202,300099,897,10,N,N,-,-1,-1
TWOMEN.txt,299233,300237,1004,10,N,N,-,-1,-1
TWOMEN.txt,299245,300254,1009,10,N,N,-,-1,-1
TWOMEN.txt,299289,300289,1000,10,N,N,-,-1,-1
TWOMEN.txt,299386,300306,920,10,N,N,-,-1,-1
TWOMEN.txt,299391,300481,1090,10,N,N,-,-1,-1
TWOMEN.txt,299595,300691,1096,10,N,N,-,-1,-1
TWOMEN.txt,299675,300732,1057,10,N,N,-,-1,-1
TWOMEN.txt,299720,300776,1056,10,N,N,-,-1,-1
TWOMEN.txt,299786,300879,1093,10,N,N,-,-1,-1
TWOMEN.txt,300100,300975,875,10,N,N,-,-1,-1
TWOMEN.txt,300240,301055,815,10,N,N,-,-1,-1
TWOMEN.txt,300255,301408,1153,10,N,N,-,-1,-1
TWOMEN.txt,300291,301578,1287,10,N,N,-,-1,-1
TWOMEN.txt,300308,301752,1444,10,N,N,-,-1,-1
TWOMEN.txt,300483,301847,1364,10,N,N,-,-1,-1
TWOMEN.txt,300693,301869,1176,10,N,N,-,-1,-1
TWOMEN.txt,300733,301906,1173,10,N,N,-,-1,-1
TWOMEN.txt,300777,301922,1145,10,N,N,-,-1,-1
TWOMEN.txt,300881,301976,1095,10,N,N,-,-1,-1
TWOMEN.txt,300976,302107,1131,10,N,N,-,-1,-1
TWOMEN.txt,301057,302279,1222,10,N,N,-,-1,-1
TWOMEN.txt,301413,302363,950,10,N,N,-,-1,-1
TWOMEN.txt,301579,302381,802,10,N,N,-,-1,-1
TWOMEN.txt,301753,302414,661,10,N,N,-,-1,-1
TWOMEN.txt,301850,302432,582,10,N,N,-,-1,-1
TWOMEN.txt,301870,302484,614,10,N,N,-,-1,-1
TWOMEN.txt,301909,302550,641,10,N,N,-,-1,-1
TWOMEN.txt,301924,302621,697,10,N,N,-,-1,-1
TWOMEN.txt,301978,302716,738,10,N,N,-,-1,-1
TWOMEN.txt,302109,302815,706,10,N,N,-,-1,-1
TWOMEN.txt,302281,303019,738,10,N,N,-,-1,-1
TWOMEN.txt,302366,303056,690,10,N,N,-,-1,-1
TWOMEN.txt,302382,303163,781,10,N,N,-,-1,-1
TWOMEN.txt,302416,303263,847,10,N,N,-,-1,-1
TWOMEN.txt,302434,303458,1024,10,N,N,-,-1,-1
TWOMEN.txt,302485,303688,1203,10,N,N,-,-1,-1
TWOMEN.txt,302552,303756,1204,10,N,N,-,-1,-1
TWOMEN.txt,302622,303864,1242,10,N,N,-,-1,-1
TWOMEN.txt,302717,304084,1367,10,N,N,-,-1,-1
TWOMEN.txt,302816,304110,1294,10,N,N,-,-1,-1
TWOMEN.txt,303021,304212,1191,10,N,N,-,-1,-1
TWOMEN.txt,303061,304327,1266,10,N,N,-,-1,-1
TWOMEN.txt,303164,304357,1193,10,N,N,-,-1,-1
TWOMEN.txt,303265,304374,1109,10,N,N,-,-1,-1
TWOMEN.txt,303459,304395,936,10,N,N,-,-1,-1
TWOMEN.txt,303690,304427,737,10,N,N,-,-1,-1
TWOMEN.txt,303757,304631,874,10,N,N,-,-1,-1
TWOMEN.txt,303866,304711,845,10,N,N,-,-1,-1
TWOMEN.txt,304085,304772,687,10,N,N,-,-1,-1
TWOMEN.txt,304111,304923,812,10,N,N,-,-1,-1
TWOMEN.txt,304214,304944,730,10,N,N,-,-1,-1
TWOMEN.txt,304329,304956,627,10,N,N,-,-1,-1
TWOMEN.txt,304360,304971,611,10,N,N,-,-1,-1
TWOMEN.txt,304375,305224,849,10,N,N,-,-1,-1
TWOMEN.txt,304397,305364,967,10,N,N,-,-1,-1
TWOMEN.txt,304428,305652,1224,10,N,N,-,-1,-1
TWOMEN.txt,304633,305802,1169,10,N,N,-,-1,-1
TWOMEN.txt,304712,305896,1184,10,N,N,-,-1,-1
TWOMEN.txt,304777,306398,1621,10,N,N,-,-1,-1
TWOMEN.txt,304926,306545,1619,10,N,N,-,-1,-1
TWOMEN.txt,304945,306642,1697,10,N,N,-,-1,-1
TWOMEN.txt,304956,306990,2034,10,N,N,-,-1,-1
TWOMEN.txt,304973,307081,2108,10,N,N,-,-1,-1
TWOMEN.txt,305225,307118,1893,10,N,N,-,-1,-1
TWOMEN.txt,305365,307139,1774,10,N,N,-,-1,-1
TWOMEN.txt,305653,307144,1491,10,N,N,-,-1,-1
TWOMEN.txt,305803,307150,1347,10,N,N,-,-1,-1
TWOMEN.txt,305897,307178,1281,10,N,N,-,-1,-1
TWOMEN.txt,306398,307308,910,10,N,N,-,-1,-1
TWOMEN.txt,306545,307314,769,10,N,N,-,-1,-1
TWOMEN.txt,306648,307339,691,10,N,N,-,-1,-1
TWOMEN.txt,306991,307469,478,10,N,N,-,-1,-1
TWOMEN.txt,307083,307594,511,10,N,N,-,-1,-1
TWOMEN.txt,307120,307706,586,10,N,N,-,-1,-1
TWOMEN.txt,307140,307853,713,10,N,N,-,-1,-1
TWOMEN.txt,307145,308076,931,10,N,N,-,-1,-1
TWOMEN.txt,307150,308135,985,10,N,N,-,-1,-1
TWOMEN.txt,307180,308140,960,10,N,N,-,-1,-1
TWOMEN.txt,307309,308155,846,10,N,N,-,-1,-1
TWOMEN.txt,307315,308281,966,10,N,N,-,-1,-1
TWOMEN.txt,307341,308338,997,10,N,N,-,-1,-1
TWOMEN.txt,307470,308527,1057,10,N,N,-,-1,-1
TWOMEN.txt,307596,308596,1000,10,N,N,-,-1,-1
TWOMEN.txt,307706,308663,957,10,N,N,-,-1,-1
TWOMEN.txt,307855,308733,878,10,N,N,-,-1,-1
TWOMEN.txt,308080,308777,697,10,N,N,-,-1,-1
TWOMEN.txt,308136,308828,692,10,N,N,-,-1,-1
TWOMEN.txt,308141,309168,1027,10,N,N,-,-1,-1
TWOMEN.txt,308156,309267,1111,10,N,N,-,-1,-1
TWOMEN.txt,308285,309357,1072,10,N,N,-,-1,-1
TWOMEN.txt,308343,309572,1229,10,N,N,-,-1,-1
TWOMEN.txt,308528,309714,1186,10,N,N,-,-1,-1
TWOMEN.txt,308596,310060,1464,10,N,N,-,-1,-1
TWOMEN.txt,308665,310119,1454,10,N,N,-,-1,-1
TWOMEN.txt,308736,310574,1838,10,N,N,-,-1,-1
TWOMEN.txt,308778,310620,1842,10,N,N,-,-1,-1
TWOMEN.txt,308829,310792,1963,10,N,N,-,-1,-1
TWOMEN.txt,309169,311027,1858,10,N,N,-,-1,-1
TWOMEN.txt,309269,311043,1774,10,N,N,-,-1,-1
TWOMEN.txt,309358,311065,1707,10,N,N,-,-1,-1
TWOMEN.txt,309574,311151,1577,10,N,N,-,-1,-1
TWOMEN.txt,309715,311283,1568,10,N,N,-,-1,-1
TWOMEN.txt,310061,311325,1264,10,N,N,-,-1,-1
TWOMEN.txt,310124,311328,1204,10,N,N,-,-1,-1
TWOMEN.txt,310577,311334,757,10,N,N,-,-1,-1
TWOMEN.txt,310621,311363,742,10,N,N,-,-1,-1
TWOMEN.txt,310794,311373,579,10,N,N,-,-1,-1
TWOMEN.txt,311029,311406,377,10,N,N,-,-1,-1
TWOMEN.txt,311044,311419,375,10,N,N,-,-1,-1
TWOMEN.txt,311067,311454,387,10,N,N,-,-1,-1
TWOMEN.txt,311152,311462,310,10,N,N,-,-1,-1
TWOMEN.txt,311284,311467,183,10,N,N,-,-1,-1
TWOMEN.txt,311326,311521,195,10,N,N,-,-1,-1
TWOMEN.txt,311328,311525,197,10,N,N,-,-1,-1
TWOMEN.txt,311335,311527,192,10,N,N,-,-1,-1
TWOMEN.txt,311365,311531,166,10,N,N,-,-1,-1
TWOMEN.txt,311374,311543,169,10,N,N,-,-1,-1
TWOMEN.txt,311408,311683,275,10,N,N,-,-1,-1
TWOMEN.txt,311420,311754,334,10,N,N,-,-1,-1
TWOMEN.txt,311457,311796,339,10,N,N,-,-1,-1
TWOMEN.txt,311463,311819,356,10,N,N,-,-1,-1
TWOMEN.txt,311470,311978,508,10,N,N,-,-1,-1
TWOMEN.txt,311522,312129,607,10,N,N,-,-1,-1
TWOMEN.txt,311526,312168,642,10,N,N,-,-1,-1
TWOMEN.txt,311528,312304,776,10,N,N,-,-1,-1
TWOMEN.txt,311532,312406,874,10,N,N,-,-1,-1
TWOMEN.txt,311544,312515,971,10,N,N,-,-1,-1
TWOMEN.txt,311685,312548,863,10,N,N,-,-1,-1
TWOMEN.txt,311759,312584,825,10,N,N,-,-1,-1
TWOMEN.txt,311797,312666,869,10,N,N,-,-1,-1
TWOMEN.txt,311821,312699,878,10,N,N,-,-1,-1
TWOMEN.txt,311979,312970,991,10,N,N,-,-1,-1
TWOMEN.txt,312130,313152,1022,10,N,N,-,-1,-1
TWOMEN.txt,312170,313169,999,10,N,N,-,-1,-1
TWOMEN.txt,312305,313183,878,10,N,N,-,-1,-1
TWOMEN.txt,312409,313377,968,10,N,N,-,-1,-1
TWOMEN.txt,312518,313508,990,10,N,N,-,-1,-1
TWOMEN.txt,312551,313549,998,10,N,N,-,-1,-1
TWOMEN.txt,312588,313608,1020,10,N,N,-,-1,-1
TWOMEN.txt,312668,313684,1016,10,N,N,-,-1,-1
TWOMEN.txt,312701,313811,1110,10,N,N,-,-1,-1
TWOMEN.txt,312972,313938,966,10,N,N,-,-1,-1
TWOMEN.txt,313155,314051,896,10,N,N,-,-1,-1
TWOMEN.txt,313170,314068,898,10,N,N,-,-1,-1
TWOMEN.txt,313184,314109,925,10,N,N,-,-1,-1
TWOMEN.txt,313378,314125,747,10,N,N,-,-1,-1
TWOMEN.txt,313511,314331,820,10,N,N,-,-1,-1
TWOMEN.txt,313550,314456,906,10,N,N,-,-1,-1
TWOMEN.txt,313609,314717,1108,10,N,N,-,-1,-1
TWOMEN.txt,313685,315113,1428,10,N,N,-,-1,-1
TWOMEN.txt,313812,315129,1317,10,N,N,-,-1,-1
TWOMEN.txt,313940,315216,1276,10,N,N,-,-1,-1
TWOMEN.txt,314054,315262,1208,10,N,N,-,-1,-1
TWOMEN.txt,314069,315278,1209,10,N,N,-,-1,-1
TWOMEN.txt,314112,315299,1187,10,N,N,-,-1,-1
TWOMEN.txt,314127,315326,1199,10,N,N,-,-1,-1
TWOMEN.txt,314332,315423,1091,10,N,N,-,-1,-1
TWOMEN.txt,314457,315767,1310,10,N,N,-,-1,-1
TWOMEN.txt,314719,316067,1348,10,N,N,-,-1,-1
TWOMEN.txt,315118,316211,1093,10,N,N,-,-1,-1
TWOMEN.txt,315131,316300,1169,10,N,N,-,-1,-1
TWOMEN.txt,315218,316380,1162,10,N,N,-,-1,-1
TWOMEN.txt,315265,316448,1183,10,N,N,-,-1,-1
TWOMEN.txt,315280,316526,1246,10,N,N,-,-1,-1
TWOMEN.txt,315299,316771,1472,10,N,N,-,-1,-1
TWOMEN.txt,315327,316954,1627,10,N,N,-,-1,-1
TWOMEN.txt,315424,316968,1544,10,N,N,-,-1,-1
TWOMEN.txt,315768,317010,1242,10,N,N,-,-1,-1
TWOMEN.txt,316068,317187,1119,10,N,N,-,-1,-1
TWOMEN.txt,316213,317216,1003,10,N,N,-,-1,-1
TWOMEN.txt,316301,317406,1105,10,N,N,-,-1,-1
TWOMEN.txt,316381,317683,1302,10,N,N,-,-1,-1
TWOMEN.txt,316449,317706,1257,10,N,N,-,-1,-1
TWOMEN.txt,316527,317748,1221,10,N,N,-,-1,-1
TWOMEN.txt,316772,317786,1014,10,N,N,-,-1,-1
TWOMEN.txt,316955,318116,1161,10,N,N,-,-1,-1
TWOMEN.txt,316975,318237,1262,10,N,N,-,-1,-1
TWOMEN.txt,317011,318263,1252,10,N,N,-,-1,-1
TWOMEN.txt,317188,318297,1109,10,N,N,-,-1,-1
TWOMEN.txt,317217,318404,1187,10,N,N,-,-1,-1
TWOMEN.txt,317408,318436,1028,10,N,N,-,-1,-1
TWOMEN.txt,317684,318640,956,10,N,N,-,-1,-1
TWOMEN.txt,317708,318721,1013,10,N,N,-,-1,-1
TWOMEN.txt,317750,318890,1140,10,N,N,-,-1,-1
TWOMEN.txt,317787,318942,1155,10,N,N,-,-1,-1
TWOMEN.txt,318117,319008,891,10,N,N,-,-1,-1
TWOMEN.txt,318240,319017,777,10,N,N,-,-1,-1
TWOMEN.txt,318264,319034,770,10,N,N,-,-1,-1
TWOMEN.txt,318299,319068,769,10,N,N,-,-1,-1
TWOMEN.txt,318406,319230,824,10,N,N,-,-1,-1
TWOMEN.txt,318437,319506,1069,10,N,N,-,-1,-1
TWOMEN.txt,318641,319583,942,10,N,N,-,-1,-1
TWOMEN.txt,318726,319767,1041,10,N,N,-,-1,-1
TWOMEN.txt,318891,319803,912,10,N,N,-,-1,-1
TWOMEN.txt,318945,319914,969,10,N,N,-,-1,-1
TWOMEN.txt,319010,319922,912,10,N,N,-,-1,-1
TWOMEN.txt,319020,320109,1089,10,N,N,-,-1,-1
TWOMEN.txt,319036,320126,1090,10,N,N,-,-1,-1
TWOMEN.txt,319069,320136,1067,10,N,N,-,-1,-1
TWOMEN.txt,319231,320168,937,10,N,N,-,-1,-1
TWOMEN.txt,319507,320439,932,10,N,N,-,-1,-1
TWOMEN.txt,319584,320515,931,10,N,N,-,-1,-1
TWOMEN.txt,319769,320545,776,10,N,N,-,-1,-1
TWOMEN.txt,319804,320684,880,10,N,N,-,-1,-1
TWOMEN.txt,319914,320918,1004,10,N,N,-,-1,-1
TWOMEN.txt,319924,320982,1058,10,N,N,-,-1,-1
TWOMEN.txt,320112,321150,1038,10,N,N,-,-1,-1
TWOMEN.txt,320127,321296,1169,10,N,N,-,-1,-1
TWOMEN.txt,320137,321324,1187,10,N,N,-,-1,-1
TWOMEN.txt,320170,321334,1164,10,N,N,-,-1,-1
TWOMEN.txt,320441,321392,951,10,N,N,-,-1,-1
TWOMEN.txt,320516,321409,893,10,N,N,-,-1,-1
TWOMEN.txt,320546,321433,887,10,N,N,-,-1,-1
TWOMEN.txt,320685,321511,826,10,N,N,-,-1,-1
TWOMEN.txt,320919,321682,763,10,N,N,-,-1,-1
TWOMEN.txt,320983,321783,800,10,N,N,-,-1,-1
TWOMEN.txt,321150,321880,730,10,N,N,-,-1,-1
TWOMEN.txt,321297,322039,742,10,N,N,-,-1,-1
TWOMEN.txt,321326,322076,750,10,N,N,-,-1,-1
TWOMEN.txt,321335,322247,912,10,N,N,-,-1,-1
TWOMEN.txt,321395,322316,921,10,N,N,-,-1,-1
TWOMEN.txt,321410,322551,1141,10,N,N,-,-1,-1
TWOMEN.txt,321435,322659,1224,10,N,N,-,-1,-1
TWOMEN.txt,321512,322862,1350,10,N,N,-,-1,-1
TWOMEN.txt,321683,322879,1196,10,N,N,-,-1,-1
TWOMEN.txt,321784,322905,1121,10,N,N,-,-1,-1
TWOMEN.txt,321881,323078,1197,10,N,N,-,-1,-1
TWOMEN.txt,322044,323205,1161,10,N,N,-,-1,-1
TWOMEN.txt,322077,323231,1154,10,N,N,-,-1,-1
TWOMEN.txt,322248,323234,986,10,N,N,-,-1,-1
TWOMEN.txt,322317,323235,918,10,N,N,-,-1,-1
TWOMEN.txt,322553,323355,802,10,N,N,-,-1,-1
TWOMEN.txt,322660,323383,723,10,N,N,-,-1,-1
TWOMEN.txt,322865,323402,537,10,N,N,-,-1,-1
TWOMEN.txt,322880,323425,545,10,N,N,-,-1,-1
TWOMEN.txt,322907,323432,525,10,N,N,-,-1,-1
TWOMEN.txt,323079,323492,413,10,N,N,-,-1,-1
TWOMEN.txt,323207,323628,421,10,N,N,-,-1,-1
TWOMEN.txt,323232,323761,529,10,N,N,-,-1,-1
TWOMEN.txt,323234,323864,630,10,N,N,-,-1,-1
TWOMEN.txt,323236,323922,686,10,N,N,-,-1,-1
TWOMEN.txt,323356,323987,631,10,N,N,-,-1,-1
TWOMEN.txt,323386,324036,650,10,N,N,-,-1,-1
TWOMEN.txt,323403,324134,731,10,N,N,-,-1,-1
TWOMEN.txt,323427,324232,805,10,N,N,-,-1,-1
TWOMEN.txt,323433,324347,914,10,N,N,-,-1,-1
TWOMEN.txt,323493,324377,884,10,N,N,-,-1,-1
TWOMEN.txt,323633,324406,773,10,N,N,-,-1,-1
TWOMEN.txt,323762,324557,795,10,N,N,-,-1,-1
TWOMEN.txt,323864,324659,795,10,N,N,-,-1,-1
TWOMEN.txt,323924,324702,778,10,N,N,-,-1,-1
TWOMEN.txt,323988,324737,749,10,N,N,-,-1,-1
TWOMEN.txt,324037,324754,717,10,N,N,-,-1,-1
TWOMEN.txt,324136,324756,620,10,N,N,-,-1,-1
TWOMEN.txt,324234,325037,803,10,N,N,-,-1,-1
TWOMEN.txt,324348,325118,770,10,N,N,-,-1,-1
TWOMEN.txt,324380,325164,784,10,N,N,-,-1,-1
TWOMEN.txt,324407,325180,773,10,N,N,-,-1,-1
TWOMEN.txt,324558,325358,800,10,N,N,-,-1,-1
TWOMEN.txt,324660,325532,872,10,N,N,-,-1,-1
TWOMEN.txt,324704,325621,917,10,N,N,-,-1,-1
TWOMEN.txt,324740,325793,1053,10,N,N,-,-1,-1
TWOMEN.txt,324755,325898,1143,10,N,N,-,-1,-1
TWOMEN.txt,324756,325956,1200,10,N,N,-,-1,-1
TWOMEN.txt,325038,325986,948,10,N,N,-,-1,-1
TWOMEN.txt,325120,326010,890,10,N,N,-,-1,-1
TWOMEN.txt,325165,326046,881,10,N,N,-,-1,-1
TWOMEN.txt,325185,326052,867,10,N,N,-,-1,-1
TWOMEN.txt,325359,326069,710,10,N,N,-,-1,-1
TWOMEN.txt,325535,326092,557,10,N,N,-,-1,-1
TWOMEN.txt,325622,326208,586,10,N,N,-,-1,-1
TWOMEN.txt,325794,326387,593,10,N,N,-,-1,-1
TWOMEN.txt,325900,326449,549,10,N,N,-,-1,-1
TWOMEN.txt,325958,326550,592,10,N,N,-,-1,-1
TWOMEN.txt,325988,326717,729,10,N,N,-,-1,-1
TWOMEN.txt,326011,326740,729,10,N,N,-,-1,-1
TWOMEN.txt,326047,326952,905,10,N,N,-,-1,-1
TWOMEN.txt,326055,327004,949,10,N,N,-,-1,-1
TWOMEN.txt,326070,327047,977,10,N,N,-,-1,-1
TWOMEN.txt,326094,327103,1009,10,N,N,-,-1,-1
TWOMEN.txt,326209,327157,948,10,N,N,-,-1,-1
TWOMEN.txt,326388,327201,813,10,N,N,-,-1,-1
TWOMEN.txt,326450,327248,798,10,N,N,-,-1,-1
TWOMEN.txt,326552,327376,824,10,N,N,-,-1,-1
TWOMEN.txt,326719,327490,771,10,N,N,-,-1,-1
TWOMEN.txt,326745,327547,802,10,N,N,-,-1,-1
TWOMEN.txt,326954,327646,692,10,N,N,-,-1,-1
TWOMEN.txt,327006,327707,701,10,N,N,-,-1,-1
TWOMEN.txt,327048,327849,801,10,N,N,-,-1,-1
TWOMEN.txt,327104,327935,831,10,N,N,-,-1,-1
TWOMEN.txt,327158,328050,892,10,N,N,-,-1,-1
TWOMEN.txt,327206,328132,926,10,N,N,-,-1,-1
TWOMEN.txt,327248,328144,896,10,N,N,-,-1,-1
TWOMEN.txt,327377,328235,858,10,N,N,-,-1,-1
TWOMEN.txt,327491,328415,924,10,N,N,-,-1,-1
TWOMEN.txt,327549,328482,933,10,N,N,-,-1,-1
TWOMEN.txt,327647,328623,976,10,N,N,-,-1,-1
TWOMEN.txt,327708,328702,994,10,N,N,-,-1,-1
TWOMEN.txt,327850,328771,921,10,N,N,-,-1,-1
TWOMEN.txt,327937,328782,845,10,N,N,-,-1,-1
TWOMEN.txt,328052,328873,821,10,N,N,-,-1,-1
TWOMEN.txt,328133,329080,947,10,N,N,-,-1,-1
TWOMEN.txt,328144,329114,970,10,N,N,-,-1,-1
TWOMEN.txt,328236,329155,919,10,N,N,-,-1,-1
TWOMEN.txt,328417,329232,815,10,N,N,-,-1,-1
TWOMEN.txt,328483,329330,847,10,N,N,-,-1,-1
TWOMEN.txt,328624,329592,968,10,N,N,-,-1,-1
TWOMEN.txt,328703,329864,1161,10,N,N,-,-1,-1
TWOMEN.txt,328772,329987,1215,10,N,N,-,-1,-1
TWOMEN.txt,328782,330042,1260,10,N,N,-,-1,-1
TWOMEN.txt,328874,330088,1214,10,N,N,-,-1,-1
TWOMEN.txt,329081,330132,1051,10,N,N,-,-1,-1
TWOMEN.txt,329115,330260,1145,10,N,N,-,-1,-1
TWOMEN.txt,329156,330343,1187,10,N,N,-,-1,-1
TWOMEN.txt,329234,330412,1178,10,N,N,-,-1,-1
TWOMEN.txt,329332,330554,1222,10,N,N,-,-1,-1
TWOMEN.txt,329593,330752,1159,10,N,N,-,-1,-1
TWOMEN.txt,329866,330930,1064,10,N,N,-,-1,-1
TWOMEN.txt,329988,331087,1099,10,N,N,-,-1,-1
TWOMEN.txt,330043,331245,1202,10,N,N,-,-1,-1
TWOMEN.txt,330089,331431,1342,10,N,N,-,-1,-1
TWOMEN.txt,330133,331502,1369,10,N,N,-,-1,-1
TWOMEN.txt,330261,331633,1372,10,N,N,-,-1,-1
TWOMEN.txt,330344,331832,1488,10,N,N,-,-1,-1
TWOMEN.txt,330414,331954,1540,10,N,N,-,-1,-1
TWOMEN.txt,330555,332219,1664,10,N,N,-,-1,-1
TWOMEN.txt,330755,332379,1624,10,N,N,-,-1,-1
TWOMEN.txt,330931,332403,1472,10,N,N,-,-1,-1
TWOMEN.txt,331088,332476,1388,10,N,N,-,-1,-1
TWOMEN.txt,331246,332495,1249,10,N,N,-,-1,-1
TWOMEN.txt,331432,332816,1384,10,N,N,-,-1,-1
TWOMEN.txt,331503,332928,1425,10,N,N,-,-1,-1
TWOMEN.txt,331637,332950,1313,10,N,N,-,-1,-1
TWOMEN.txt,331833,333123,1290,10,N,N,-,-1,-1
TWOMEN.txt,331958,333214,1256,10,N,N,-,-1,-1
TWOMEN.txt,332221,333278,1057,10,N,N,-,-1,-1
TWOMEN.txt,332380,333318,938,10,N,N,-,-1,-1
TWOMEN.txt,332404,333388,984,10,N,N,-,-1,-1
TWOMEN.txt,332479,333513,1034,10,N,N,-,-1,-1
TWOMEN.txt,332496,333546,1050,10,N,N,-,-1,-1
TWOMEN.txt,332817,333710,893,10,N,N,-,-1,-1
TWOMEN.txt,332930,333739,809,10,N,N,-,-1,-1
TWOMEN.txt,332951,333795,844,10,N,N,-,-1,-1
TWOMEN.txt,333124,333816,692,10,N,N,-,-1,-1
TWOMEN.txt,333215,333848,633,10,N,N,-,-1,-1
TWOMEN.txt,333281,334049,768,10,N,N,-,-1,-1
TWOMEN.txt,333321,334200,879,10,N,N,-,-1,-1
TWOMEN.txt,333388,334221,833,10,N,N,-,-1,-1
TWOMEN.txt,333514,334248,734,10,N,N,-,-1,-1
TWOMEN.txt,333551,334274,723,10,N,N,-,-1,-1
TWOMEN.txt,333711,334325,614,10,N,N,-,-1,-1
TWOMEN.txt,333740,334342,602,10,N,N,-,-1,-1
TWOMEN.txt,333798,334346,548,10,N,N,-,-1,-1
TWOMEN.txt,333817,334496,679,10,N,N,-,-1,-1
TWOMEN.txt,333850,334564,714,10,N,N,-,-1,-1
TWOMEN.txt,334050,334677,627,10,N,N,-,-1,-1
TWOMEN.txt,334203,334778,575,10,N,N,-,-1,-1
TWOMEN.txt,334222,334825,603,10,N,N,-,-1,-1
TWOMEN.txt,334249,334857,608,10,N,N,-,-1,-1
TWOMEN.txt,334275,334945,670,10,N,N,-,-1,-1
TWOMEN.txt,334328,335203,875,10,N,N,-,-1,-1
TWOMEN.txt,334343,335325,982,10,N,N,-,-1,-1
TWOMEN.txt,334347,335463,1116,10,N,N,-,-1,-1
TWOMEN.txt,334498,335591,1093,10,N,N,-,-1,-1
TWOMEN.txt,334565,335791,1226,10,N,N,-,-1,-1
TWOMEN.txt,334678,336010,1332,10,N,N,-,-1,-1
TWOMEN.txt,334780,336141,1361,10,N,N,-,-1,-1
TWOMEN.txt,334826,336267,1441,10,N,N,-,-1,-1
TWOMEN.txt,334858,336652,1794,10,N,N,-,-1,-1
TWOMEN.txt,334946,336681,1735,10,N,N,-,-1,-1
TWOMEN.txt,335204,336696,1492,10,N,N,-,-1,-1
TWOMEN.txt,335326,336700,1374,10,N,N,-,-1,-1
TWOMEN.txt,335465,336852,1387,10,N,N,-,-1,-1
TWOMEN.txt,335592,337002,1410,10,N,N,-,-1,-1
TWOMEN.txt,335792,337003,1211,10,N,N,-,-1,-1
TWOMEN.txt,336011,337020,1009,10,N,N,-,-1,-1
TWOMEN.txt,336142,337092,950,10,N,N,-,-1,-1
TWOMEN.txt,336268,337116,848,10,N,N,-,-1,-1
TWOMEN.txt,336653,337136,483,10,N,N,-,-1,-1
TWOMEN.txt,336684,337292,608,10,N,N,-,-1,-1
TWOMEN.txt,336697,337408,711,10,N,N,-,-1,-1
TWOMEN.txt,336701,337424,723,10,N,N,-,-1,-1
TWOMEN.txt,336853,337428,575,10,N,N,-,-1,-1
TWOMEN.txt,337002,337476,474,10,N,N,-,-1,-1
TWOMEN.txt,337004,337630,626,10,N,N,-,-1,-1
TWOMEN.txt,337021,337698,677,10,N,N,-,-1,-1
TWOMEN.txt,337093,337718,625,10,N,N,-,-1,-1
TWOMEN.txt,337117,337722,605,10,N,N,-,-1,-1
TWOMEN.txt,337137,337736,599,10,N,N,-,-1,-1
TWOMEN.txt,337293,337914,621,10,N,N,-,-1,-1
TWOMEN.txt,337410,338047,637,10,N,N,-,-1,-1
TWOMEN.txt,337425,338172,747,10,N,N,-,-1,-1
TWOMEN.txt,337429,338274,845,10,N,N,-,-1,-1
TWOMEN.txt,337477,338303,826,10,N,N,-,-1,-1
TWOMEN.txt,337631,338319,688,10,N,N,-,-1,-1
TWOMEN.txt,337701,338413,712,10,N,N,-,-1,-1
TWOMEN.txt,337719,338504,785,10,N,N,-,-1,-1
TWOMEN.txt,337723,338710,987,10,N,N,-,-1,-1
TWOMEN.txt,337737,338881,1144,10,N,N,-,-1,-1
TWOMEN.txt,337915,338909,994,10,N,N,-,-1,-1
TWOMEN.txt,338048,338959,911,10,N,N,-,-1,-1
TWOMEN.txt,338174,339039,865,10,N,N,-,-1,-1
TWOMEN.txt,338275,339054,779,10,N,N,-,-1,-1
TWOMEN.txt,338304,339105,801,10,N,N,-,-1,-1
TWOMEN.txt,338320,339253,933,10,N,N,-,-1,-1
TWOMEN.txt,338414,339331,917,10,N,N,-,-1,-1
TWOMEN.txt,338505,339432,927,10,N,N,-,-1,-1
TWOMEN.txt,338712,339446,734,10,N,N,-,-1,-1
TWOMEN.txt,338882,339497,615,10,N,N,-,-1,-1
TWOMEN.txt,338911,339519,608,10,N,N,-,-1,-1
TWOMEN.txt,338962,339599,637,10,N,N,-,-1,-1
TWOMEN.txt,339040,339637,597,10,N,N,-,-1,-1
TWOMEN.txt,339055,339731,676,10,N,N,-,-1,-1
TWOMEN.txt,339107,339861,754,10,N,N,-,-1,-1
TWOMEN.txt,339254,339978,724,10,N,N,-,-1,-1
TWOMEN.txt,339332,340028,696,10,N,N,-,-1,-1
TWOMEN.txt,339433,340104,671,10,N,N,-,-1,-1
TWOMEN.txt,339447,340126,679,10,N,N,-,-1,-1
TWOMEN.txt,339498,340165,667,10,N,N,-,-1,-1
TWOMEN.txt,339520,340245,725,10,N,N,-,-1,-1
TWOMEN.txt,339600,340333,733,10,N,N,-,-1,-1
TWOMEN.txt,339638,340382,744,10,N,N,-,-1,-1
TWOMEN.txt,339732,340416,684,10,N,N,-,-1,-1
TWOMEN.txt,339862,340481,619,10,N,N,-,-1,-1
TWOMEN.txt,339980,340506,526,10,N,N,-,-1,-1
TWOMEN.txt,340029,340559,530,10,N,N,-,-1,-1
TWOMEN.txt,340105,340573,468,10,N,N,-,-1,-1
TWOMEN.txt,340127,340631,504,10,N,N,-,-1,-1
TWOMEN.txt,340166,340771,605,10,N,N,-,-1,-1
TWOMEN.txt,340246,340800,554,10,N,N,-,-1,-1
TWOMEN.txt,340334,340848,514,10,N,N,-,-1,-1
TWOMEN.txt,340383,340853,470,10,N,N,-,-1,-1
TWOMEN.txt,340417,340882,465,10,N,N,-,-1,-1
TWOMEN.txt,340483,340932,449,10,N,N,-,-1,-1
TWOMEN.txt,340507,340937,430,10,N,N,-,-1,-1
TWOMEN.txt,340560,340975,415,10,N,N,-,-1,-1
TWOMEN.txt,340574,340994,420,10,N,N,-,-1,-1
TWOMEN.txt,340633,341006,373,10,N,N,-,-1,-1
TWOMEN.txt,340772,341049,277,10,N,N,-,-1,-1
TWOMEN.txt,340801,341065,264,10,N,N,-,-1,-1
TWOMEN.txt,340849,341157,308,10,N,N,-,-1,-1
TWOMEN.txt,340854,341207,353,10,N,N,-,-1,-1
TWOMEN.txt,340883,341298,415,10,N,N,-,-1,-1
TWOMEN.txt,340933,341339,406,10,N,N,-,-1,-1
TWOMEN.txt,340938,341393,455,10,N,N,-,-1,-1
TWOMEN.txt,340978,341404,426,10,N,N,-,-1,-1
TWOMEN.txt,340995,341424,429,10,N,N,-,-1,-1
TWOMEN.txt,341007,341453,446,10,N,N,-,-1,-1
TWOMEN.txt,341051,341491,440,10,N,N,-,-1,-1
TWOMEN.txt,341066,341515,449,10,N,N,-,-1,-1
TWOMEN.txt,341158,341562,404,10,N,N,-,-1,-1
TWOMEN.txt,341208,341725,517,10,N,N,-,-1,-1
TWOMEN.txt,341300,341861,561,10,N,N,-,-1,-1
TWOMEN.txt,341342,341946,604,10,N,N,-,-1,-1
TWOMEN.txt,341394,342057,663,10,N,N,-,-1,-1
TWOMEN.txt,341405,342088,683,10,N,N,-,-1,-1
TWOMEN.txt,341425,342426,1001,10,N,N,-,-1,-1
TWOMEN.txt,341454,342632,1178,10,N,N,-,-1,-1
TWOMEN.txt,341492,342648,1156,10,N,N,-,-1,-1
TWOMEN.txt,341516,342652,1136,10,N,N,-,-1,-1
TWOMEN.txt,341563,342971,1408,10,N,N,-,-1,-1
TWOMEN.txt,341728,342985,1257,10,N,N,-,-1,-1
TWOMEN.txt,341863,342989,1126,10,N,N,-,-1,-1
TWOMEN.txt,341948,343061,1113,10,N,N,-,-1,-1
TWOMEN.txt,342059,343099,1040,10,N,N,-,-1,-1
TWOMEN.txt,342089,343154,1065,10,N,N,-,-1,-1
TWOMEN.txt,342427,343225,798,10,N,N,-,-1,-1
TWOMEN.txt,342634,343294,660,10,N,N,-,-1,-1
TWOMEN.txt,342649,343358,709,10,N,N,-,-1,-1
TWOMEN.txt,342653,343375,722,10,N,N,-,-1,-1
TWOMEN.txt,342973,343379,406,10,N,N,-,-1,-1
TWOMEN.txt,342986,343385,399,10,N,N,-,-1,-1
TWOMEN.txt,342990,343439,449,10,N,N,-,-1,-1
TWOMEN.txt,343062,343529,467,10,N,N,-,-1,-1
TWOMEN.txt,343100,343586,486,10,N,N,-,-1,-1
TWOMEN.txt,343155,343680,525,10,N,N,-,-1,-1
TWOMEN.txt,343226,343810,584,10,N,N,-,-1,-1
TWOMEN.txt,343295,343849,554,10,N,N,-,-1,-1
TWOMEN.txt,343360,343860,500,10,N,N,-,-1,-1
TWOMEN.txt,343376,343897,521,10,N,N,-,-1,-1
TWOMEN.txt,343380,343942,562,10,N,N,-,-1,-1
TWOMEN.txt,343386,343970,584,10,N,N,-,-1,-1
TWOMEN.txt,343440,343988,548,10,N,N,-,-1,-1
TWOMEN.txt,343530,343991,461,10,N,N,-,-1,-1
TWOMEN.txt,343587,344003,416,10,N,N,-,-1,-1
TWOMEN.txt,343681,344008,327,10,N,N,-,-1,-1
TWOMEN.txt,343811,344017,206,10,N,N,-,-1,-1
TWOMEN.txt,343850,344033,183,10,N,N,-,-1,-1
TWOMEN.txt,343861,344095,234,10,N,N,-,-1,-1
TWOMEN.txt,343899,344116,217,10,N,N,-,-1,-1
TWOMEN.txt,343943,344178,235,10,N,N,-,-1,-1
TWOMEN.txt,343971,344295,324,10,N,N,-,-1,-1
TWOMEN.txt,343990,344381,391,10,N,N,-,-1,-1
TWOMEN.txt,343991,344395,404,10,N,N,-,-1,-1
TWOMEN.txt,344005,344400,395,10,N,N,-,-1,-1
TWOMEN.txt,344009,344437,428,10,N,N,-,-1,-1
TWOMEN.txt,344018,344472,454,10,N,N,-,-1,-1
TWOMEN.txt,344034,344515,481,10,N,N,-,-1,-1
TWOMEN.txt,344096,344595,499,10,N,N,-,-1,-1
TWOMEN.txt,344117,344673,556,10,N,N,-,-1,-1
TWOMEN.txt,344179,344816,637,10,N,N,-,-1,-1
TWOMEN.txt,344296,344830,534,10,N,N,-,-1,-1
TWOMEN.txt,344383,344840,457,10,N,N,-,-1,-1
TWOMEN.txt,344396,344869,473,10,N,N,-,-1,-1
TWOMEN.txt,344401,345039,638,10,N,N,-,-1,-1
TWOMEN.txt,344439,345213,774,10,N,N,-,-1,-1
TWOMEN.txt,344473,345232,759,10,N,N,-,-1,-1
TWOMEN.txt,344516,345633,1117,10,N,N,-,-1,-1
TWOMEN.txt,344596,345649,1053,10,N,N,-,-1,-1
TWOMEN.txt,344674,345658,984,10,N,N,-,-1,-1
TWOMEN.txt,344819,345729,910,10,N,N,-,-1,-1
TWOMEN.txt,344830,345794,964,10,N,N,-,-1,-1
TWOMEN.txt,344841,345824,983,10,N,N,-,-1,-1
TWOMEN.txt,344870,345911,1041,10,N,N,-,-1,-1
TWOMEN.txt,345040,345990,950,10,N,N,-,-1,-1
TWOMEN.txt,345215,346026,811,10,N,N,-,-1,-1
TWOMEN.txt,345232,346036,804,10,N,N,-,-1,-1
TWOMEN.txt,345635,346131,496,10,N,N,-,-1,-1
TWOMEN.txt,345649,346228,579,10,N,N,-,-1,-1
TWOMEN.txt,345659,346369,710,10,N,N,-,-1,-1
TWOMEN.txt,345730,346392,662,10,N,N,-,-1,-1
TWOMEN.txt,345796,346824,1028,10,N,N,-,-1,-1
TWOMEN.txt,345826,347048,1222,10,N,N,-,-1,-1
TWOMEN.txt,345912,347390,1478,10,N,N,-,-1,-1
TWOMEN.txt,345991,347404,1413,10,N,N,-,-1,-1
TWOMEN.txt,346028,347428,1400,10,N,N,-,-1,-1
TWOMEN.txt,346037,347453,1416,10,N,N,-,-1,-1
TWOMEN.txt,346132,347484,1352,10,N,N,-,-1,-1
TWOMEN.txt,346229,347587,1358,10,N,N,-,-1,-1
TWOMEN.txt,346371,347686,1315,10,N,N,-,-1,-1
TWOMEN.txt,346393,347778,1385,10,N,N,-,-1,-1
TWOMEN.txt,346826,347912,1086,10,N,N,-,-1,-1
TWOMEN.txt,347049,348045,996,10,N,N,-,-1,-1
TWOMEN.txt,347390,348174,784,10,N,N,-,-1,-1
TWOMEN.txt,347405,348186,781,10,N,N,-,-1,-1
TWOMEN.txt,347431,348211,780,10,N,N,-,-1,-1
TWOMEN.txt,347454,348248,794,10,N,N,-,-1,-1
TWOMEN.txt,347486,348423,937,10,N,N,-,-1,-1
TWOMEN.txt,347588,348479,891,10,N,N,-,-1,-1
TWOMEN.txt,347687,348509,822,10,N,N,-,-1,-1
TWOMEN.txt,347780,348521,741,10,N,N,-,-1,-1
TWOMEN.txt,347913,348532,619,10,N,N,-,-1,-1
TWOMEN.txt,348046,348588,542,10,N,N,-,-1,-1
TWOMEN.txt,348177,348892,715,10,N,N,-,-1,-1
TWOMEN.txt,348186,348912,726,10,N,N,-,-1,-1
TWOMEN.txt,348211,348970,759,10,N,N,-,-1,-1
TWOMEN.txt,348249,349054,805,10,N,N,-,-1,-1
TWOMEN.txt,348424,349135,711,10,N,N,-,-1,-1
TWOMEN.txt,348481,349157,676,10,N,N,-,-1,-1
TWOMEN.txt,348512,349208,696,10,N,N,-,-1,-1
TWOMEN.txt,348521,349346,825,10,N,N,-,-1,-1
TWOMEN.txt,348533,349422,889,10,N,N,-,-1,-1
TWOMEN.txt,348589,349532,943,10,N,N,-,-1,-1
TWOMEN.txt,348894,349552,658,10,N,N,-,-1,-1
TWOMEN.txt,348913,349592,679,10,N,N,-,-1,-1
TWOMEN.txt,348971,349780,809,10,N,N,-,-1,-1
TWOMEN.txt,349055,349803,748,10,N,N,-,-1,-1
TWOMEN.txt,349137,350008,871,10,N,N,-,-1,-1
TWOMEN.txt,349158,350054,896,10,N,N,-,-1,-1
TWOMEN.txt,349209,350073,864,10,N,N,-,-1,-1
TWOMEN.txt,349348,350174,826,10,N,N,-,-1,-1
TWOMEN.txt,349423,350218,795,10,N,N,-,-1,-1
TWOMEN.txt,349534,350248,714,10,N,N,-,-1,-1
TWOMEN.txt,349553,350290,737,10,N,N,-,-1,-1
TWOMEN.txt,349594,350329,735,10,N,N,-,-1,-1
TWOMEN.txt,349782,350387,605,10,N,N,-,-1,-1
TWOMEN.txt,349804,350463,659,10,N,N,-,-1,-1
TWOMEN.txt,350010,350473,463,10,N,N,-,-1,-1
TWOMEN.txt,350056,350518,462,10,N,N,-,-1,-1
TWOMEN.txt,350074,350567,493,10,N,N,-,-1,-1
TWOMEN.txt,350175,350691,516,10,N,N,-,-1,-1
TWOMEN.txt,350220,350765,545,10,N,N,-,-1,-1
TWOMEN.txt,350249,350785,536,10,N,N,-,-1,-1
TWOMEN.txt,350291,350884,593,10,N,N,-,-1,-1
TWOMEN.txt,350331,350911,580,10,N,N,-,-1,-1
TWOMEN.txt,350389,350936,547,10,N,N,-,-1,-1
TWOMEN.txt,350465,351168,703,10,N,N,-,-1,-1
TWOMEN.txt,350476,351230,754,10,N,N,-,-1,-1
TWOMEN.txt,350519,351256,737,10,N,N,-,-1,-1
TWOMEN.txt,350568,351280,712,10,N,N,-,-1,-1
TWOMEN.txt,350692,351354,662,10,N,N,-,-1,-1
TWOMEN.txt,350767,351383,616,10,N,N,-,-1,-1
TWOMEN.txt,350786,351482,696,10,N,N,-,-1,-1
TWOMEN.txt,350886,351506,620,10,N,N,-,-1,-1
TWOMEN.txt,350912,351550,638,10,N,N,-,-1,-1
TWOMEN.txt,350937,351919,982,10,N,N,-,-1,-1
TWOMEN.txt,351170,351960,790,10,N,N,-,-1,-1
TWOMEN.txt,351232,352003,771,10,N,N,-,-1,-1
TWOMEN.txt,351257,352004,747,10,N,N,-,-1,-1
TWOMEN.txt,351281,352007,726,10,N,N,-,-1,-1
TWOMEN.txt,351356,352048,692,10,N,N,-,-1,-1
TWOMEN.txt,351385,352228,843,10,N,N,-,-1,-1
TWOMEN.txt,351486,352262,776,10,N,N,-,-1,-1
TWOMEN.txt,351507,352320,813,10,N,N,-,-1,-1
TWOMEN.txt,351551,352323,772,10,N,N,-,-1,-1
TWOMEN.txt,351924,352332,408,10,N,N,-,-1,-1
TWOMEN.txt,351965,352339,374,10,N,N,-,-1,-1
TWOMEN.txt,352003,352406,403,10,N,N,-,-1,-1
TWOMEN.txt,352005,352532,527,10,N,N,-,-1,-1
TWOMEN.txt,352008,352611,603,10,N,N,-,-1,-1
TWOMEN.txt,352050,352707,657,10,N,N,-,-1,-1
TWOMEN.txt,352230,352738,508,10,N,N,-,-1,-1
TWOMEN.txt,352263,352873,610,10,N,N,-,-1,-1
TWOMEN.txt,352322,352885,563,10,N,N,-,-1,-1
TWOMEN.txt,352323,352893,570,10,N,N,-,-1,-1
TWOMEN.txt,352332,352899,567,10,N,N,-,-1,-1
TWOMEN.txt,352340,352983,643,10,N,N,-,-1,-1
TWOMEN.txt,352407,353122,715,10,N,N,-,-1,-1
TWOMEN.txt,352533,353172,639,10,N,N,-,-1,-1
TWOMEN.txt,352613,353195,582,10,N,N,-,-1,-1
TWOMEN.txt,352708,353377,669,10,N,N,-,-1,-1
TWOMEN.txt,352739,353472,733,10,N,N,-,-1,-1
TWOMEN.txt,352875,353730,855,10,N,N,-,-1,-1
TWOMEN.txt,352885,353792,907,10,N,N,-,-1,-1
TWOMEN.txt,352894,353797,903,10,N,N,-,-1,-1
TWOMEN.txt,352899,353840,941,10,N,N,-,-1,-1
TWOMEN.txt,352984,353862,878,10,N,N,-,-1,-1
TWOMEN.txt,353123,353892,769,10,N,N,-,-1,-1
TWOMEN.txt,353173,353961,788,10,N,N,-,-1,-1
TWOMEN.txt,353196,354134,938,10,N,N,-,-1,-1
TWOMEN.txt,353378,354225,847,10,N,N,-,-1,-1
TWOMEN.txt,353473,354245,772,10,N,N,-,-1,-1
TWOMEN.txt,353731,354334,603,10,N,N,-,-1,-1
TWOMEN.txt,353792,354423,631,10,N,N,-,-1,-1
TWOMEN.txt,353800,354488,688,10,N,N,-,-1,-1
TWOMEN.txt,353840,354709,869,10,N,N,-,-1,-1
TWOMEN.txt,353862,354882,1020,10,N,N,-,-1,-1
TWOMEN.txt,353894,354899,1005,10,N,N,-,-1,-1
TWOMEN.txt,353962,354931,969,10,N,N,-,-1,-1
TWOMEN.txt,354136,355031,895,10,N,N,-,-1,-1
TWOMEN.txt,354227,355103,876,10,N,N,-,-1,-1
TWOMEN.txt,354246,355367,1121,10,N,N,-,-1,-1
TWOMEN.txt,354335,355481,1146,10,N,N,-,-1,-1
TWOMEN.txt,354424,355653,1229,10,N,N,-,-1,-1
TWOMEN.txt,354489,355671,1182,10,N,N,-,-1,-1
TWOMEN.txt,354710,355739,1029,10,N,N,-,-1,-1
TWOMEN.txt,354884,355756,872,10,N,N,-,-1,-1
TWOMEN.txt,354900,355800,900,10,N,N,-,-1,-1
TWOMEN.txt,354932,355868,936,10,N,N,-,-1,-1
TWOMEN.txt,355032,355950,918,10,N,N,-,-1,-1
TWOMEN.txt,355103,355971,868,10,N,N,-,-1,-1
TWOMEN.txt,355368,355998,630,10,N,N,-,-1,-1
TWOMEN.txt,355483,356039,556,10,N,N,-,-1,-1
TWOMEN.txt,355655,356068,413,10,N,N,-,-1,-1
TWOMEN.txt,355672,356214,542,10,N,N,-,-1,-1
TWOMEN.txt,355740,356350,610,10,N,N,-,-1,-1
TWOMEN.txt,355758,356376,618,10,N,N,-,-1,-1
TWOMEN.txt,355802,356432,630,10,N,N,-,-1,-1
TWOMEN.txt,355869,356448,579,10,N,N,-,-1,-1
TWOMEN.txt,355951,356524,573,10,N,N,-,-1,-1
TWOMEN.txt,355973,356557,584,10,N,N,-,-1,-1
TWOMEN.txt,356000,356588,588,10,N,N,-,-1,-1
TWOMEN.txt,356040,356740,700,10,N,N,-,-1,-1
TWOMEN.txt,356069,356960,891,10,N,N,-,-1,-1
TWOMEN.txt,356216,356998,782,10,N,N,-,-1,-1
TWOMEN.txt,356352,357029,677,10,N,N,-,-1,-1
TWOMEN.txt,356377,357215,838,10,N,N,-,-1,-1
TWOMEN.txt,356433,357298,865,10,N,N,-,-1,-1
TWOMEN.txt,356448,357317,869,10,N,N,-,-1,-1
TWOMEN.txt,356527,357443,916,10,N,N,-,-1,-1
TWOMEN.txt,356558,357479,921,10,N,N,-,-1,-1
TWOMEN.txt,356589,357517,928,10,N,N,-,-1,-1
TWOMEN.txt,356743,357544,801,10,N,N,-,-1,-1
TWOMEN.txt,356961,357570,609,10,N,N,-,-1,-1
TWOMEN.txt,356999,357596,597,10,N,N,-,-1,-1
TWOMEN.txt,357034,357623,589,10,N,N,-,-1,-1
TWOMEN.txt,357216,357667,451,10,N,N,-,-1,-1
TWOMEN.txt,357299,357710,411,10,N,N,-,-1,-1
TWOMEN.txt,357318,357817,499,10,N,N,-,-1,-1
TWOMEN.txt,357444,357970,526,10,N,N,-,-1,-1
TWOMEN.txt,357481,358025,544,10,N,N,-,-1,-1
TWOMEN.txt,357518,358106,588,10,N,N,-,-1,-1
TWOMEN.txt,357547,358202,655,10,N,N,-,-1,-1
TWOMEN.txt,357571,358221,650,10,N,N,-,-1,-1
TWOMEN.txt,357597,358287,690,10,N,N,-,-1,-1
TWOMEN.txt,357625,358381,756,10,N,N,-,-1,-1
TWOMEN.txt,357668,358499,831,10,N,N,-,-1,-1
TWOMEN.txt,357711,358519,808,10,N,N,-,-1,-1
TWOMEN.txt,357819,358690,871,10,N,N,-,-1,-1
TWOMEN.txt,357970,358734,764,10,N,N,-,-1,-1
TWOMEN.txt,358027,358904,877,10,N,N,-,-1,-1
TWOMEN.txt,358107,359018,911,10,N,N,-,-1,-1
TWOMEN.txt,358204,359136,932,10,N,N,-,-1,-1
TWOMEN.txt,358222,359162,940,10,N,N,-,-1,-1
TWOMEN.txt,358288,359184,896,10,N,N,-,-1,-1
TWOMEN.txt,358383,359326,943,10,N,N,-,-1,-1
TWOMEN.txt,358501,359435,934,10,N,N,-,-1,-1
TWOMEN.txt,358520,359460,940,10,N,N,-,-1,-1
TWOMEN.txt,358691,359626,935,10,N,N,-,-1,-1
TWOMEN.txt,358739,359646,907,10,N,N,-,-1,-1
TWOMEN.txt,358905,359707,802,10,N,N,-,-1,-1
TWOMEN.txt,359019,359857,838,10,N,N,-,-1,-1
TWOMEN.txt,359137,360010,873,10,N,N,-,-1,-1
TWOMEN.txt,359164,360064,900,10,N,N,-,-1,-1
TWOMEN.txt,359185,360233,1048,10,N,N,-,-1,-1
TWOMEN.txt,359327,360315,988,10,N,N,-,-1,-1
TWOMEN.txt,359437,360381,944,10,N,N,-,-1,-1
TWOMEN.txt,359461,360564,1103,10,N,N,-,-1,-1
TWOMEN.txt,359628,360618,990,10,N,N,-,-1,-1
TWOMEN.txt,359647,360634,987,10,N,N,-,-1,-1
TWOMEN.txt,359708,360636,928,10,N,N,-,-1,-1
TWOMEN.txt,359858,360711,853,10,N,N,-,-1,-1
TWOMEN.txt,360012,360835,823,10,N,N,-,-1,-1
TWOMEN.txt,360066,360870,804,10,N,N,-,-1,-1
TWOMEN.txt,360235,360996,761,10,N,N,-,-1,-1
TWOMEN.txt,360316,361218,902,10,N,N,-,-1,-1
TWOMEN.txt,360382,361239,857,10,N,N,-,-1,-1
TWOMEN.txt,360565,361403,838,10,N,N,-,-1,-1
TWOMEN.txt,360620,361634,1014,10,N,N,-,-1,-1
TWOMEN.txt,360635,361717,1082,10,N,N,-,-1,-1
TWOMEN.txt,360637,361853,1216,10,N,N,-,-1,-1
TWOMEN.txt,360712,361923,1211,10,N,N,-,-1,-1
TWOMEN.txt,360837,361962,1125,10,N,N,-,-1,-1
TWOMEN.txt,360871,362006,1135,10,N,N,-,-1,-1
TWOMEN.txt,360998,362025,1027,10,N,N,-,-1,-1
TWOMEN.txt,361220,362082,862,10,N,N,-,-1,-1
TWOMEN.txt,361240,362100,860,10,N,N,-,-1,-1
TWOMEN.txt,361405,362166,761,10,N,N,-,-1,-1
TWOMEN.txt,361635,362246,611,10,N,N,-,-1,-1
TWOMEN.txt,361719,362362,643,10,N,N,-,-1,-1
TWOMEN.txt,361854,362397,543,10,N,N,-,-1,-1
TWOMEN.txt,361925,362542,617,10,N,N,-,-1,-1
TWOMEN.txt,361963,362600,637,10,N,N,-,-1,-1
TWOMEN.txt,362008,362811,803,10,N,N,-,-1,-1
TWOMEN.txt,362026,362969,943,10,N,N,-,-1,-1
TWOMEN.txt,362087,363070,983,10,N,N,-,-1,-1
TWOMEN.txt,362105,363196,1091,10,N,N,-,-1,-1
TWOMEN.txt,362167,363524,1357,10,N,N,-,-1,-1
TWOMEN.txt,362247,363537,1290,10,N,N,-,-1,-1
TWOMEN.txt,362363,363546,1183,10,N,N,-,-1,-1
TWOMEN.txt,362398,363610,1212,10,N,N,-,-1,-1
TWOMEN.txt,362543,363716,1173,10,N,N,-,-1,-1
TWOMEN.txt,362601,363848,1247,10,N,N,-,-1,-1
TWOMEN.txt,362812,363995,1183,10,N,N,-,-1,-1
TWOMEN.txt,362971,364016,1045,10,N,N,-,-1,-1
TWOMEN.txt,363071,364087,1016,10,N,N,-,-1,-1
TWOMEN.txt,363198,364146,948,10,N,N,-,-1,-1
TWOMEN.txt,363527,364166,639,10,N,N,-,-1,-1
TWOMEN.txt,363537,364206,669,10,N,N,-,-1,-1
TWOMEN.txt,363547,364229,682,10,N,N,-,-1,-1
TWOMEN.txt,363611,364365,754,10,N,N,-,-1,-1
TWOMEN.txt,363717,364385,668,10,N,N,-,-1,-1
TWOMEN.txt,363850,364406,556,10,N,N,-,-1,-1
TWOMEN.txt,363996,364505,509,10,N,N,-,-1,-1
TWOMEN.txt,364017,364563,546,10,N,N,-,-1,-1
TWOMEN.txt,364088,364598,510,10,N,N,-,-1,-1
TWOMEN.txt,364148,364606,458,10,N,N,-,-1,-1
TWOMEN.txt,364167,364624,457,10,N,N,-,-1,-1
TWOMEN.txt,364208,364653,445,10,N,N,-,-1,-1
TWOMEN.txt,364230,364684,454,10,N,N,-,-1,-1
TWOMEN.txt,364366,364726,360,10,N,N,-,-1,-1
TWOMEN.txt,364387,364768,381,10,N,N,-,-1,-1
TWOMEN.txt,364407,364831,424,10,N,N,-,-1,-1
TWOMEN.txt,364507,364841,334,10,N,N,-,-1,-1
TWOMEN.txt,364566,364879,313,10,N,N,-,-1,-1
TWOMEN.txt,364599,364930,331,10,N,N,-,-1,-1
TWOMEN.txt,364608,365074,466,10,N,N,-,-1,-1
TWOMEN.txt,364626,365086,460,10,N,N,-,-1,-1
TWOMEN.txt,364654,365113,459,10,N,N,-,-1,-1
TWOMEN.txt,364686,365143,457,10,N,N,-,-1,-1
TWOMEN.txt,364727,365226,499,10,N,N,-,-1,-1
TWOMEN.txt,364769,365314,545,10,N,N,-,-1,-1
TWOMEN.txt,364832,365373,541,10,N,N,-,-1,-1
TWOMEN.txt,364842,365386,544,10,N,N,-,-1,-1
TWOMEN.txt,364880,365392,512,10,N,N,-,-1,-1
TWOMEN.txt,364931,365401,470,10,N,N,-,-1,-1
TWOMEN.txt,365076,365429,353,10,N,N,-,-1,-1
TWOMEN.txt,365087,365771,684,10,N,N,-,-1,-1
TWOMEN.txt,365114,365788,674,10,N,N,-,-1,-1
TWOMEN.txt,365146,365809,663,10,N,N,-,-1,-1
TWOMEN.txt,365227,365928,701,10,N,N,-,-1,-1
TWOMEN.txt,365319,366037,718,10,N,N,-,-1,-1
TWOMEN.txt,365374,366122,748,10,N,N,-,-1,-1
TWOMEN.txt,365388,366227,839,10,N,N,-,-1,-1
TWOMEN.txt,365393,366273,880,10,N,N,-,-1,-1
TWOMEN.txt,365403,366377,974,10,N,N,-,-1,-1
TWOMEN.txt,365430,366432,1002,10,N,N,-,-1,-1
TWOMEN.txt,365774,366449,675,10,N,N,-,-1,-1
TWOMEN.txt,365789,366472,683,10,N,N,-,-1,-1
TWOMEN.txt,365810,366482,672,10,N,N,-,-1,-1
TWOMEN.txt,365930,366556,626,10,N,N,-,-1,-1
TWOMEN.txt,366038,366582,544,10,N,N,-,-1,-1
TWOMEN.txt,366123,366812,689,10,N,N,-,-1,-1
TWOMEN.txt,366228,366987,759,10,N,N,-,-1,-1
TWOMEN.txt,366275,367017,742,10,N,N,-,-1,-1
TWOMEN.txt,366378,367090,712,10,N,N,-,-1,-1
TWOMEN.txt,366435,367132,697,10,N,N,-,-1,-1
TWOMEN.txt,366450,367215,765,10,N,N,-,-1,-1
TWOMEN.txt,366473,367308,835,10,N,N,-,-1,-1
TWOMEN.txt,366484,367507,1023,10,N,N,-,-1,-1
TWOMEN.txt,366556,367528,972,10,N,N,-,-1,-1
TWOMEN.txt,366583,367538,955,10,N,N,-,-1,-1
TWOMEN.txt,366813,367572,759,10,N,N,-,-1,-1
TWOMEN.txt,366989,367582,593,10,N,N,-,-1,-1
TWOMEN.txt,367018,367840,822,10,N,N,-,-1,-1
TWOMEN.txt,367091,367886,795,10,N,N,-,-1,-1
TWOMEN.txt,367133,367973,840,10,N,N,-,-1,-1
TWOMEN.txt,367217,368026,809,10,N,N,-,-1,-1
TWOMEN.txt,367309,368257,948,10,N,N,-,-1,-1
TWOMEN.txt,367510,368309,799,10,N,N,-,-1,-1
TWOMEN.txt,367529,368706,1177,10,N,N,-,-1,-1
TWOMEN.txt,367539,368778,1239,10,N,N,-,-1,-1
TWOMEN.txt,367573,368868,1295,10,N,N,-,-1,-1
TWOMEN.txt,367584,368919,1335,10,N,N,-,-1,-1
TWOMEN.txt,367841,368970,1129,10,N,N,-,-1,-1
TWOMEN.txt,367888,369045,1157,10,N,N,-,-1,-1
TWOMEN.txt,367974,369122,1148,10,N,N,-,-1,-1
TWOMEN.txt,368027,369145,1118,10,N,N,-,-1,-1
TWOMEN.txt,368259,369168,909,10,N,N,-,-1,-1
TWOMEN.txt,368310,369179,869,10,N,N,-,-1,-1
TWOMEN.txt,368707,369288,581,10,N,N,-,-1,-1
TWOMEN.txt,368780,369376,596,10,N,N,-,-1,-1
TWOMEN.txt,368870,369424,554,10,N,N,-,-1,-1
TWOMEN.txt,368920,369466,546,10,N,N,-,-1,-1
TWOMEN.txt,368971,369521,550,10,N,N,-,-1,-1
TWOMEN.txt,369046,369592,546,10,N,N,-,-1,-1
TWOMEN.txt,369125,369623,498,10,N,N,-,-1,-1
TWOMEN.txt,369146,369624,478,10,N,N,-,-1,-1
TWOMEN.txt,369170,369645,475,10,N,N,-,-1,-1
TWOMEN.txt,369181,369651,470,10,N,N,-,-1,-1
TWOMEN.txt,369289,369657,368,10,N,N,-,-1,-1
TWOMEN.txt,369378,369809,431,10,N,N,-,-1,-1
TWOMEN.txt,369425,369882,457,10,N,N,-,-1,-1
TWOMEN.txt,369467,369945,478,10,N,N,-,-1,-1
TWOMEN.txt,369522,370006,484,10,N,N,-,-1,-1
TWOMEN.txt,369595,370111,516,10,N,N,-,-1,-1
TWOMEN.txt,369623,370199,576,10,N,N,-,-1,-1
TWOMEN.txt,369625,370211,586,10,N,N,-,-1,-1
TWOMEN.txt,369647,370234,587,10,N,N,-,-1,-1
TWOMEN.txt,369652,370301,649,10,N,N,-,-1,-1
TWOMEN.txt,369659,370357,698,10,N,N,-,-1,-1
TWOMEN.txt,369810,370397,587,10,N,N,-,-1,-1
TWOMEN.txt,369884,370473,589,10,N,N,-,-1,-1
TWOMEN.txt,369950,370490,540,10,N,N,-,-1,-1
TWOMEN.txt,370011,370522,511,10,N,N,-,-1,-1
TWOMEN.txt,370112,370550,438,10,N,N,-,-1,-1
TWOMEN.txt,370200,370612,412,10,N,N,-,-1,-1
TWOMEN.txt,370213,370668,455,10,N,N,-,-1,-1
TWOMEN.txt,370236,370719,483,10,N,N,-,-1,-1
TWOMEN.txt,370302,370803,501,10,N,N,-,-1,-1
TWOMEN.txt,370358,370946,588,10,N,N,-,-1,-1
TWOMEN.txt,370398,370964,566,10,N,N,-,-1,-1
TWOMEN.txt,370476,370975,499,10,N,N,-,-1,-1
TWOMEN.txt,370492,370998,506,10,N,N,-,-1,-1
TWOMEN.txt,370524,371053,529,10,N,N,-,-1,-1
TWOMEN.txt,370551,371067,516,10,N,N,-,-1,-1
TWOMEN.txt,370613,371267,654,10,N,N,-,-1,-1
TWOMEN.txt,370669,371290,621,10,N,N,-,-1,-1
TWOMEN.txt,370720,371317,597,10,N,N,-,-1,-1
TWOMEN.txt,370804,371401,597,10,N,N,-,-1,-1
TWOMEN.txt,370949,371414,465,10,N,N,-,-1,-1
TWOMEN.txt,370966,371461,495,10,N,N,-,-1,-1
TWOMEN.txt,370976,371566,590,10,N,N,-,-1,-1
TWOMEN.txt,371000,371799,799,10,N,N,-,-1,-1
TWOMEN.txt,371054,371926,872,10,N,N,-,-1,-1
TWOMEN.txt,371070,371935,865,10,N,N,-,-1,-1
TWOMEN.txt,371270,371957,687,10,N,N,-,-1,-1
TWOMEN.txt,371292,371965,673,10,N,N,-,-1,-1
TWOMEN.txt,371318,372004,686,10,N,N,-,-1,-1
TWOMEN.txt,371402,372090,688,10,N,N,-,-1,-1
TWOMEN.txt,371419,372222,803,10,N,N,-,-1,-1
TWOMEN.txt,371462,372243,781,10,N,N,-,-1,-1
TWOMEN.txt,371568,372276,708,10,N,N,-,-1,-1
TWOMEN.txt,371801,372349,548,10,N,N,-,-1,-1
TWOMEN.txt,371927,372401,474,10,N,N,-,-1,-1
TWOMEN.txt,371936,372651,715,10,N,N,-,-1,-1
TWOMEN.txt,371958,372721,763,10,N,N,-,-1,-1
TWOMEN.txt,371966,372741,775,10,N,N,-,-1,-1
TWOMEN.txt,372008,372803,795,10,N,N,-,-1,-1
TWOMEN.txt,372091,373025,934,10,N,N,-,-1,-1
TWOMEN.txt,372225,373065,840,10,N,N,-,-1,-1
TWOMEN.txt,372244,373156,912,10,N,N,-,-1,-1
TWOMEN.txt,372278,373198,920,10,N,N,-,-1,-1
TWOMEN.txt,372350,373281,931,10,N,N,-,-1,-1
TWOMEN.txt,372402,373511,1109,10,N,N,-,-1,-1
TWOMEN.txt,372652,373575,923,10,N,N,-,-1,-1
TWOMEN.txt,372722,373644,922,10,N,N,-,-1,-1
TWOMEN.txt,372742,373720,978,10,N,N,-,-1,-1
TWOMEN.txt,372804,373922,1118,10,N,N,-,-1,-1
TWOMEN.txt,373030,374059,1029,10,N,N,-,-1,-1
TWOMEN.txt,373066,374158,1092,10,N,N,-,-1,-1
TWOMEN.txt,373158,374200,1042,10,N,N,-,-1,-1
TWOMEN.txt,373199,374217,1018,10,N,N,-,-1,-1
TWOMEN.txt,373282,374330,1048,10,N,N,-,-1,-1
TWOMEN.txt,373512,374431,919,10,N,N,-,-1,-1
TWOMEN.txt,373576,374495,919,10,N,N,-,-1,-1
TWOMEN.txt,373646,374566,920,10,N,N,-,-1,-1
TWOMEN.txt,373722,374672,950,10,N,N,-,-1,-1
TWOMEN.txt,373923,374716,793,10,N,N,-,-1,-1
TWOMEN.txt,374060,374816,756,10,N,N,-,-1,-1
TWOMEN.txt,374161,374914,753,10,N,N,-,-1,-1
TWOMEN.txt,374201,375049,848,10,N,N,-,-1,-1
TWOMEN.txt,374219,375197,978,10,N,N,-,-1,-1
TWOMEN.txt,374332,375220,888,10,N,N,-,-1,-1
TWOMEN.txt,374432,375236,804,10,N,N,-,-1,-1
TWOMEN.txt,374496,375253,757,10,N,N,-,-1,-1
TWOMEN.txt,374567,375503,936,10,N,N,-,-1,-1
TWOMEN.txt,374677,375562,885,10,N,N,-,-1,-1
TWOMEN.txt,374717,375592,875,10,N,N,-,-1,-1
TWOMEN.txt,374817,375657,840,10,N,N,-,-1,-1
TWOMEN.txt,374915,375763,848,10,N,N,-,-1,-1
TWOMEN.txt,375050,375798,748,10,N,N,-,-1,-1
TWOMEN.txt,375200,375907,707,10,N,N,-,-1,-1
TWOMEN.txt,375221,376008,787,10,N,N,-,-1,-1
TWOMEN.txt,375239,376209,970,10,N,N,-,-1,-1
TWOMEN.txt,375255,376268,1013,10,N,N,-,-1,-1
TWOMEN.txt,375504,376285,781,10,N,N,-,-1,-1
TWOMEN.txt,375563,376329,766,10,N,N,-,-1,-1
TWOMEN.txt,375593,376341,748,10,N,N,-,-1,-1
TWOMEN.txt,375659,376393,734,10,N,N,-,-1,-1
TWOMEN.txt,375764,376537,773,10,N,N,-,-1,-1
TWOMEN.txt,375799,376622,823,10,N,N,-,-1,-1
TWOMEN.txt,375909,376943,1034,10,N,N,-,-1,-1
TWOMEN.txt,376008,377164,1156,10,N,N,-,-1,-1
TWOMEN.txt,376210,377394,1184,10,N,N,-,-1,-1
TWOMEN.txt,376272,377411,1139,10,N,N,-,-1,-1
TWOMEN.txt,376290,377453,1163,10,N,N,-,-1,-1
TWOMEN.txt,376330,377590,1260,10,N,N,-,-1,-1
TWOMEN.txt,376342,377647,1305,10,N,N,-,-1,-1
TWOMEN.txt,376395,377752,1357,10,N,N,-,-1,-1
TWOMEN.txt,376538,377831,1293,10,N,N,-,-1,-1
TWOMEN.txt,376623,377921,1298,10,N,N,-,-1,-1
TWOMEN.txt,376945,378049,1104,10,N,N,-,-1,-1
TWOMEN.txt,377165,378162,997,10,N,N,-,-1,-1
TWOMEN.txt,377397,378337,940,10,N,N,-,-1,-1
TWOMEN.txt,377412,378431,1019,10,N,N,-,-1,-1
TWOMEN.txt,377455,378452,997,10,N,N,-,-1,-1
TWOMEN.txt,377591,378459,868,10,N,N,-,-1,-1
TWOMEN.txt,377648,378478,830,10,N,N,-,-1,-1
TWOMEN.txt,377753,378529,776,10,N,N,-,-1,-1
TWOMEN.txt,377836,378564,728,10,N,N,-,-1,-1
TWOMEN.txt,377922,378870,948,10,N,N,-,-1,-1
TWOMEN.txt,378050,379030,980,10,N,N,-,-1,-1
TWOMEN.txt,378163,379047,884,10,N,N,-,-1,-1
TWOMEN.txt,378339,379094,755,10,N,N,-,-1,-1
TWOMEN.txt,378434,379111,677,10,N,N,-,-1,-1
TWOMEN.txt,378453,379183,730,10,N,N,-,-1,-1
TWOMEN.txt,378461,379272,811,10,N,N,-,-1,-1
TWOMEN.txt,378480,379286,806,10,N,N,-,-1,-1
TWOMEN.txt,378530,379406,876,10,N,N,-,-1,-1
TWOMEN.txt,378565,379492,927,10,N,N,-,-1,-1
TWOMEN.txt,378872,379562,690,10,N,N,-,-1,-1
TWOMEN.txt,379033,379640,607,10,N,N,-,-1,-1
TWOMEN.txt,379049,379657,608,10,N,N,-,-1,-1
TWOMEN.txt,379096,379707,611,10,N,N,-,-1,-1
TWOMEN.txt,379113,379735,622,10,N,N,-,-1,-1
TWOMEN.txt,379184,379948,764,10,N,N,-,-1,-1
TWOMEN.txt,379273,379988,715,10,N,N,-,-1,-1
TWOMEN.txt,379287,380181,894,10,N,N,-,-1,-1
TWOMEN.txt,379407,380267,860,10,N,N,-,-1,-1
TWOMEN.txt,379494,380350,856,10,N,N,-,-1,-1
TWOMEN.txt,379563,380416,853,10,N,N,-,-1,-1
TWOMEN.txt,379643,380438,795,10,N,N,-,-1,-1
TWOMEN.txt,379659,380459,800,10,N,N,-,-1,-1
TWOMEN.txt,379709,380561,852,10,N,N,-,-1,-1
TWOMEN.txt,379737,380600,863,10,N,N,-,-1,-1
TWOMEN.txt,379950,380788,838,10,N,N,-,-1,-1
TWOMEN.txt,379989,380927,938,10,N,N,-,-1,-1
TWOMEN.txt,380182,380932,750,10,N,N,-,-1,-1
TWOMEN.txt,380268,381032,764,10,N,N,-,-1,-1
TWOMEN.txt,380351,381248,897,10,N,N,-,-1,-1
TWOMEN.txt,380419,381534,1115,10,N,N,-,-1,-1
TWOMEN.txt,380440,381719,1279,10,N,Y,1437490253936,460795,462238
TWOMEN.txt,380461,381867,1406,10,N,Y,1437490253936,460795,462238
TWOMEN.txt,380562,381893,1331,10,N,Y,1437490253936,460795,462238
TWOMEN.txt,380602,382155,1553,10,N,Y,1437490253936,460795,462238
TWOMEN.txt,380789,382317,1528,10,N,Y,1437490253936,460795,462238
TWOMEN.txt,380928,382416,1488,10,N,Y,1437490253936,460795,462238
TWOMEN.txt,380932,382452,1520,10,N,Y,1437490253936,460795,462238
TWOMEN.txt,381034,382476,1442,10,N,Y,1437490253936,460795,462238
TWOMEN.txt,381249,382585,1336,10,N,Y,1437490253936,460795,462238
TWOMEN.txt,381536,382649,1113,10,N,Y,1437490253936,460795,462238
TWOMEN.txt,381719,382698,979,10,N,Y,1437490253936,460795,462238
TWOMEN.txt,381868,382719,851,10,N,N,-,-1,-1
TWOMEN.txt,381893,383031,1138,10,N,N,-,-1,-1
TWOMEN.txt,382157,383075,918,10,N,N,-,-1,-1
TWOMEN.txt,382318,383177,859,10,N,N,-,-1,-1
TWOMEN.txt,382417,383273,856,10,N,N,-,-1,-1
TWOMEN.txt,382454,383321,867,10,N,N,-,-1,-1
TWOMEN.txt,382478,383397,919,10,N,N,-,-1,-1
TWOMEN.txt,382586,383441,855,10,N,N,-,-1,-1
TWOMEN.txt,382654,383590,936,10,N,N,-,-1,-1
TWOMEN.txt,382699,383666,967,10,N,N,-,-1,-1
TWOMEN.txt,382721,383686,965,10,N,N,-,-1,-1
TWOMEN.txt,383032,383709,677,10,N,N,-,-1,-1
TWOMEN.txt,383076,383726,650,10,N,N,-,-1,-1
TWOMEN.txt,383179,383801,622,10,N,N,-,-1,-1
TWOMEN.txt,383275,383827,552,10,N,N,-,-1,-1
TWOMEN.txt,383322,383983,661,10,N,N,-,-1,-1
TWOMEN.txt,383399,384164,765,10,N,N,-,-1,-1
TWOMEN.txt,383442,384257,815,10,N,N,-,-1,-1
TWOMEN.txt,383591,384304,713,10,N,N,-,-1,-1
TWOMEN.txt,383668,384418,750,10,N,N,-,-1,-1
TWOMEN.txt,383688,384515,827,10,N,N,-,-1,-1
TWOMEN.txt,383711,385166,1455,10,N,N,-,-1,-1
TWOMEN.txt,383728,385183,1455,10,N,N,-,-1,-1
TWOMEN.txt,383802,385218,1416,10,N,N,-,-1,-1
TWOMEN.txt,383828,385510,1682,10,N,N,-,-1,-1
TWOMEN.txt,383984,385621,1637,10,N,N,-,-1,-1
TWOMEN.txt,384165,385630,1465,10,N,N,-,-1,-1
TWOMEN.txt,384258,385658,1400,10,N,N,-,-1,-1
TWOMEN.txt,384305,385692,1387,10,N,N,-,-1,-1
TWOMEN.txt,384420,385742,1322,10,N,N,-,-1,-1
TWOMEN.txt,384516,385811,1295,10,N,N,-,-1,-1
TWOMEN.txt,385169,385828,659,10,N,N,-,-1,-1
TWOMEN.txt,385184,385865,681,10,N,N,-,-1,-1
TWOMEN.txt,385220,385942,722,10,N,N,-,-1,-1
TWOMEN.txt,385511,385984,473,10,N,N,-,-1,-1
TWOMEN.txt,385621,386050,429,10,N,N,-,-1,-1
TWOMEN.txt,385630,386188,558,10,N,N,-,-1,-1
TWOMEN.txt,385659,386322,663,10,N,N,-,-1,-1
TWOMEN.txt,385693,386365,672,10,N,N,-,-1,-1
TWOMEN.txt,385743,386390,647,10,N,N,-,-1,-1
TWOMEN.txt,385814,386425,611,10,N,N,-,-1,-1
TWOMEN.txt,385829,386465,636,10,N,N,-,-1,-1
TWOMEN.txt,385867,386537,670,10,N,N,-,-1,-1
TWOMEN.txt,385943,386701,758,10,N,N,-,-1,-1
TWOMEN.txt,385989,386783,794,10,N,N,-,-1,-1
TWOMEN.txt,386051,386854,803,10,N,N,-,-1,-1
TWOMEN.txt,386189,386907,718,10,N,N,-,-1,-1
TWOMEN.txt,386323,387078,755,10,N,N,-,-1,-1
TWOMEN.txt,386368,387126,758,10,N,N,-,-1,-1
TWOMEN.txt,386391,387190,799,10,N,N,-,-1,-1
TWOMEN.txt,386427,387253,826,10,N,N,-,-1,-1
TWOMEN.txt,386466,387399,933,10,N,N,-,-1,-1
TWOMEN.txt,386539,387611,1072,10,N,N,-,-1,-1
TWOMEN.txt,386702,387659,957,10,N,N,-,-1,-1
TWOMEN.txt,386784,387679,895,10,N,N,-,-1,-1
TWOMEN.txt,386855,387699,844,10,N,N,-,-1,-1
TWOMEN.txt,386908,387805,897,10,N,N,-,-1,-1
TWOMEN.txt,387080,388026,946,10,N,N,-,-1,-1
TWOMEN.txt,387127,388376,1249,10,N,N,-,-1,-1
TWOMEN.txt,387191,388470,1279,10,N,N,-,-1,-1
TWOMEN.txt,387255,388516,1261,10,N,N,-,-1,-1
TWOMEN.txt,387401,388650,1249,10,N,N,-,-1,-1
TWOMEN.txt,387616,388750,1134,10,N,N,-,-1,-1
TWOMEN.txt,387660,388826,1166,10,N,N,-,-1,-1
TWOMEN.txt,387682,389167,1485,10,N,N,-,-1,-1
TWOMEN.txt,387701,389194,1493,10,N,N,-,-1,-1
TWOMEN.txt,387806,389278,1472,10,N,N,-,-1,-1
TWOMEN.txt,388027,389330,1303,10,N,N,-,-1,-1
TWOMEN.txt,388377,389385,1008,10,N,N,-,-1,-1
TWOMEN.txt,388472,389520,1048,10,N,N,-,-1,-1
TWOMEN.txt,388517,389683,1166,10,N,N,-,-1,-1
TWOMEN.txt,388651,389747,1096,10,N,N,-,-1,-1
TWOMEN.txt,388751,389792,1041,10,N,N,-,-1,-1
TWOMEN.txt,388827,389839,1012,10,N,N,-,-1,-1
TWOMEN.txt,389168,389991,823,10,N,N,-,-1,-1
TWOMEN.txt,389196,390094,898,10,N,N,-,-1,-1
TWOMEN.txt,389279,390515,1236,10,N,N,-,-1,-1
TWOMEN.txt,389331,390572,1241,10,N,N,-,-1,-1
TWOMEN.txt,389386,390636,1250,10,N,N,-,-1,-1
TWOMEN.txt,389522,390768,1246,10,N,N,-,-1,-1
TWOMEN.txt,389684,390832,1148,10,N,N,-,-1,-1
TWOMEN.txt,389748,390981,1233,10,N,N,-,-1,-1
TWOMEN.txt,389793,391048,1255,10,N,N,-,-1,-1
TWOMEN.txt,389841,391065,1224,10,N,N,-,-1,-1
TWOMEN.txt,389993,391106,1113,10,N,N,-,-1,-1
TWOMEN.txt,390095,391224,1129,10,N,N,-,-1,-1
TWOMEN.txt,390517,391253,736,10,N,N,-,-1,-1
TWOMEN.txt,390574,391393,819,10,N,N,-,-1,-1
TWOMEN.txt,390637,391458,821,10,N,N,-,-1,-1
TWOMEN.txt,390770,391587,817,10,N,N,-,-1,-1
TWOMEN.txt,390837,391646,809,10,N,N,-,-1,-1
TWOMEN.txt,390982,391714,732,10,N,N,-,-1,-1
TWOMEN.txt,391051,391839,788,10,N,N,-,-1,-1
TWOMEN.txt,391066,391930,864,10,N,N,-,-1,-1
TWOMEN.txt,391108,392020,912,10,N,N,-,-1,-1
TWOMEN.txt,391226,392115,889,10,N,N,-,-1,-1
TWOMEN.txt,391255,392303,1048,10,N,N,-,-1,-1
TWOMEN.txt,391394,392350,956,10,N,N,-,-1,-1
TWOMEN.txt,391459,392370,911,10,N,N,-,-1,-1
TWOMEN.txt,391589,392386,797,10,N,N,-,-1,-1
TWOMEN.txt,391648,392633,985,10,N,N,-,-1,-1
TWOMEN.txt,391715,392691,976,10,N,N,-,-1,-1
TWOMEN.txt,391840,392829,989,10,N,N,-,-1,-1
TWOMEN.txt,391932,392863,931,10,N,N,-,-1,-1
TWOMEN.txt,392022,392975,953,10,N,N,-,-1,-1
TWOMEN.txt,392116,393000,884,10,N,N,-,-1,-1
TWOMEN.txt,392308,393060,752,10,N,N,-,-1,-1
TWOMEN.txt,392351,393085,734,10,N,N,-,-1,-1
TWOMEN.txt,392370,393095,725,10,N,N,-,-1,-1
TWOMEN.txt,392388,393126,738,10,N,N,-,-1,-1
TWOMEN.txt,392634,393144,510,10,N,N,-,-1,-1
TWOMEN.txt,392693,393462,769,10,N,N,-,-1,-1
TWOMEN.txt,392830,393527,697,10,N,N,-,-1,-1
TWOMEN.txt,392864,393658,794,10,N,N,-,-1,-1
TWOMEN.txt,392978,393728,750,10,N,N,-,-1,-1
TWOMEN.txt,393003,393764,761,10,N,N,-,-1,-1
TWOMEN.txt,393063,393913,850,10,N,N,-,-1,-1
TWOMEN.txt,393087,393982,895,10,N,N,-,-1,-1
TWOMEN.txt,393097,394010,913,10,N,N,-,-1,-1
TWOMEN.txt,393128,394042,914,10,N,N,-,-1,-1
TWOMEN.txt,393147,394083,936,10,N,N,-,-1,-1
TWOMEN.txt,393464,394103,639,10,N,N,-,-1,-1
TWOMEN.txt,393527,394120,593,10,N,N,-,-1,-1
TWOMEN.txt,393660,394139,479,10,N,N,-,-1,-1
TWOMEN.txt,393729,394155,426,10,N,N,-,-1,-1
TWOMEN.txt,393766,394186,420,10,N,N,-,-1,-1
TWOMEN.txt,393915,394210,295,10,N,N,-,-1,-1
TWOMEN.txt,393983,394445,462,10,N,N,-,-1,-1
TWOMEN.txt,394011,394587,576,10,N,N,-,-1,-1
TWOMEN.txt,394043,394599,556,10,N,N,-,-1,-1
TWOMEN.txt,394085,394601,516,10,N,N,-,-1,-1
TWOMEN.txt,394106,394616,510,10,N,N,-,-1,-1
TWOMEN.txt,394121,394643,522,10,N,N,-,-1,-1
TWOMEN.txt,394141,394878,737,10,N,N,-,-1,-1
TWOMEN.txt,394157,394909,752,10,N,N,-,-1,-1
TWOMEN.txt,394187,394976,789,10,N,N,-,-1,-1
TWOMEN.txt,394211,395015,804,10,N,N,-,-1,-1
TWOMEN.txt,394446,395161,715,10,N,N,-,-1,-1
TWOMEN.txt,394588,395231,643,10,N,N,-,-1,-1
TWOMEN.txt,394600,395265,665,10,N,N,-,-1,-1
TWOMEN.txt,394602,395292,690,10,N,N,-,-1,-1
TWOMEN.txt,394618,395376,758,10,N,N,-,-1,-1
TWOMEN.txt,394645,395401,756,10,N,N,-,-1,-1
TWOMEN.txt,394880,395557,677,10,N,N,-,-1,-1
TWOMEN.txt,394910,395595,685,10,N,N,-,-1,-1
TWOMEN.txt,394977,395703,726,10,N,N,-,-1,-1
TWOMEN.txt,395016,395838,822,10,N,N,-,-1,-1
TWOMEN.txt,395166,395880,714,10,N,N,-,-1,-1
TWOMEN.txt,395232,396103,871,10,N,N,-,-1,-1
TWOMEN.txt,395267,396173,906,10,N,N,-,-1,-1
TWOMEN.txt,395293,396319,1026,10,N,N,-,-1,-1
TWOMEN.txt,395377,396396,1019,10,N,N,-,-1,-1
TWOMEN.txt,395402,396467,1065,10,N,N,-,-1,-1
TWOMEN.txt,395558,396553,995,10,N,N,-,-1,-1
TWOMEN.txt,395596,396786,1190,10,N,N,-,-1,-1
TWOMEN.txt,395704,396827,1123,10,N,N,-,-1,-1
TWOMEN.txt,395840,396988,1148,10,N,N,-,-1,-1
TWOMEN.txt,395881,397041,1160,10,N,N,-,-1,-1
TWOMEN.txt,396104,397051,947,10,N,N,-,-1,-1
TWOMEN.txt,396174,397159,985,10,N,N,-,-1,-1
TWOMEN.txt,396320,397180,860,10,N,N,-,-1,-1
TWOMEN.txt,396398,397560,1162,10,N,N,-,-1,-1
TWOMEN.txt,396468,397657,1189,10,N,N,-,-1,-1
TWOMEN.txt,396555,397778,1223,10,N,N,-,-1,-1
TWOMEN.txt,396787,397912,1125,10,N,N,-,-1,-1
TWOMEN.txt,396829,397943,1114,10,N,N,-,-1,-1
TWOMEN.txt,396990,397963,973,10,N,N,-,-1,-1
TWOMEN.txt,397042,398018,976,10,N,N,-,-1,-1
TWOMEN.txt,397051,398069,1018,10,N,N,-,-1,-1
TWOMEN.txt,397160,398120,960,10,N,N,-,-1,-1
TWOMEN.txt,397182,398226,1044,10,N,N,-,-1,-1
TWOMEN.txt,397562,398412,850,10,N,N,-,-1,-1
TWOMEN.txt,397658,398489,831,10,N,N,-,-1,-1
TWOMEN.txt,397780,398630,850,10,N,N,-,-1,-1
TWOMEN.txt,397913,398675,762,10,N,N,-,-1,-1
TWOMEN.txt,397944,398679,735,10,N,N,-,-1,-1
TWOMEN.txt,397965,398708,743,10,N,N,-,-1,-1
TWOMEN.txt,398019,398716,697,10,N,N,-,-1,-1
TWOMEN.txt,398072,398905,833,10,N,N,-,-1,-1
TWOMEN.txt,398122,398922,800,10,N,N,-,-1,-1
TWOMEN.txt,398227,398938,711,10,N,N,-,-1,-1
TWOMEN.txt,398413,398944,531,10,N,N,-,-1,-1
TWOMEN.txt,398490,398946,456,10,N,N,-,-1,-1
TWOMEN.txt,398635,398953,318,10,N,N,-,-1,-1
TWOMEN.txt,398676,399119,443,10,N,N,-,-1,-1
TWOMEN.txt,398679,399177,498,10,N,N,-,-1,-1
TWOMEN.txt,398709,399344,635,10,N,N,-,-1,-1
TWOMEN.txt,398718,399390,672,10,N,N,-,-1,-1
TWOMEN.txt,398908,399409,501,10,N,N,-,-1,-1
TWOMEN.txt,398923,399554,631,10,N,N,-,-1,-1
TWOMEN.txt,398940,399608,668,10,N,N,-,-1,-1
TWOMEN.txt,398945,399611,666,10,N,N,-,-1,-1
TWOMEN.txt,398946,399616,670,10,N,N,-,-1,-1
TWOMEN.txt,398955,399625,670,10,N,N,-,-1,-1
TWOMEN.txt,399120,399683,563,10,N,N,-,-1,-1
TWOMEN.txt,399178,399707,529,10,N,N,-,-1,-1
TWOMEN.txt,399345,399773,428,10,N,N,-,-1,-1
TWOMEN.txt,399392,399791,399,10,N,N,-,-1,-1
TWOMEN.txt,399411,399871,460,10,N,N,-,-1,-1
TWOMEN.txt,399555,400211,656,10,N,N,-,-1,-1
TWOMEN.txt,399610,400288,678,10,N,N,-,-1,-1
TWOMEN.txt,399611,400346,735,10,N,N,-,-1,-1
TWOMEN.txt,399617,400395,778,10,N,N,-,-1,-1
TWOMEN.txt,399626,400587,961,10,N,N,-,-1,-1
TWOMEN.txt,399685,400597,912,10,N,N,-,-1,-1
TWOMEN.txt,399708,400608,900,10,N,N,-,-1,-1
TWOMEN.txt,399776,400616,840,10,N,N,-,-1,-1
TWOMEN.txt,399792,400635,843,10,N,N,-,-1,-1
TWOMEN.txt,399872,400662,790,10,N,N,-,-1,-1
TWOMEN.txt,400213,400971,758,10,N,N,-,-1,-1
TWOMEN.txt,400289,401193,904,10,N,N,-,-1,-1
TWOMEN.txt,400348,401213,865,10,N,N,-,-1,-1
TWOMEN.txt,400397,401360,963,10,N,N,-,-1,-1
TWOMEN.txt,400590,401440,850,10,N,N,-,-1,-1
TWOMEN.txt,400598,401552,954,10,N,N,-,-1,-1
TWOMEN.txt,400609,401671,1062,10,N,N,-,-1,-1
TWOMEN.txt,400617,401755,1138,10,N,N,-,-1,-1
TWOMEN.txt,400635,401848,1213,10,N,N,-,-1,-1
TWOMEN.txt,400664,401963,1299,10,N,N,-,-1,-1
TWOMEN.txt,400972,402058,1086,10,N,N,-,-1,-1
TWOMEN.txt,401194,402174,980,10,N,N,-,-1,-1
TWOMEN.txt,401215,402264,1049,10,N,N,-,-1,-1
TWOMEN.txt,401361,402352,991,10,N,N,-,-1,-1
TWOMEN.txt,401442,402459,1017,10,N,N,-,-1,-1
TWOMEN.txt,401554,402566,1012,10,N,N,-,-1,-1
TWOMEN.txt,401672,402661,989,10,N,N,-,-1,-1
TWOMEN.txt,401757,402718,961,10,N,N,-,-1,-1
TWOMEN.txt,401849,402814,965,10,N,N,-,-1,-1
TWOMEN.txt,401964,402912,948,10,N,N,-,-1,-1
TWOMEN.txt,402059,402965,906,10,N,N,-,-1,-1
TWOMEN.txt,402175,403080,905,10,N,N,-,-1,-1
TWOMEN.txt,402266,403506,1240,10,N,N,-,-1,-1
TWOMEN.txt,402354,403634,1280,10,N,N,-,-1,-1
TWOMEN.txt,402460,403673,1213,10,N,N,-,-1,-1
TWOMEN.txt,402567,403793,1226,10,N,N,-,-1,-1
TWOMEN.txt,402662,403862,1200,10,N,N,-,-1,-1
TWOMEN.txt,402719,404052,1333,10,N,N,-,-1,-1
TWOMEN.txt,402815,404227,1412,10,N,N,-,-1,-1
TWOMEN.txt,402913,404319,1406,10,N,N,-,-1,-1
TWOMEN.txt,402966,404376,1410,10,N,N,-,-1,-1
TWOMEN.txt,403081,404405,1324,10,N,N,-,-1,-1
TWOMEN.txt,403507,404488,981,10,N,N,-,-1,-1
TWOMEN.txt,403635,404535,900,10,N,N,-,-1,-1
TWOMEN.txt,403675,404662,987,10,N,N,-,-1,-1
TWOMEN.txt,403794,404864,1070,10,N,N,-,-1,-1
TWOMEN.txt,403863,404963,1100,10,N,N,-,-1,-1
TWOMEN.txt,404053,405081,1028,10,N,N,-,-1,-1
TWOMEN.txt,404228,405256,1028,10,N,N,-,-1,-1
TWOMEN.txt,404321,405363,1042,10,N,N,-,-1,-1
TWOMEN.txt,404377,405405,1028,10,N,N,-,-1,-1
TWOMEN.txt,404406,405441,1035,10,N,N,-,-1,-1
TWOMEN.txt,404489,405550,1061,10,N,N,-,-1,-1
TWOMEN.txt,404536,405576,1040,10,N,N,-,-1,-1
TWOMEN.txt,404664,405648,984,10,N,N,-,-1,-1
TWOMEN.txt,404865,405688,823,10,N,N,-,-1,-1
TWOMEN.txt,404965,405781,816,10,N,N,-,-1,-1
TWOMEN.txt,405083,405863,780,10,N,N,-,-1,-1
TWOMEN.txt,405257,405902,645,10,N,N,-,-1,-1
TWOMEN.txt,405368,406016,648,10,N,N,-,-1,-1
TWOMEN.txt,405405,406090,685,10,N,N,-,-1,-1
TWOMEN.txt,405443,406725,1282,10,N,N,-,-1,-1
TWOMEN.txt,405552,406805,1253,10,N,N,-,-1,-1
TWOMEN.txt,405577,406974,1397,10,N,N,-,-1,-1
TWOMEN.txt,405649,407040,1391,10,N,N,-,-1,-1
TWOMEN.txt,405689,407143,1454,10,N,N,-,-1,-1
TWOMEN.txt,405782,407186,1404,10,N,N,-,-1,-1
TWOMEN.txt,405864,407213,1349,10,N,N,-,-1,-1
TWOMEN.txt,405904,407260,1356,10,N,N,-,-1,-1
TWOMEN.txt,406018,407386,1368,10,N,N,-,-1,-1
TWOMEN.txt,406091,407433,1342,10,N,N,-,-1,-1
TWOMEN.txt,406726,407571,845,10,N,N,-,-1,-1
TWOMEN.txt,406807,407655,848,10,N,N,-,-1,-1
TWOMEN.txt,406975,407676,701,10,N,N,-,-1,-1
TWOMEN.txt,407042,407700,658,10,N,N,-,-1,-1
TWOMEN.txt,407148,407819,671,10,N,N,-,-1,-1
TWOMEN.txt,407187,407891,704,10,N,N,-,-1,-1
TWOMEN.txt,407215,407923,708,10,N,N,-,-1,-1
TWOMEN.txt,407261,407956,695,10,N,N,-,-1,-1
TWOMEN.txt,407388,408053,665,10,N,N,-,-1,-1
TWOMEN.txt,407434,408203,769,10,N,N,-,-1,-1
TWOMEN.txt,407572,408305,733,10,N,N,-,-1,-1
TWOMEN.txt,407657,408449,792,10,N,N,-,-1,-1
TWOMEN.txt,407677,408550,873,10,N,N,-,-1,-1
TWOMEN.txt,407702,408728,1026,10,N,N,-,-1,-1
TWOMEN.txt,407819,408758,939,10,N,N,-,-1,-1
TWOMEN.txt,407892,408812,920,10,N,N,-,-1,-1
TWOMEN.txt,407924,408836,912,10,N,N,-,-1,-1
TWOMEN.txt,407957,408979,1022,10,N,N,-,-1,-1
TWOMEN.txt,408055,409075,1020,10,N,N,-,-1,-1
TWOMEN.txt,408205,409100,895,10,N,N,-,-1,-1
TWOMEN.txt,408306,409188,882,10,N,N,-,-1,-1
TWOMEN.txt,408451,409234,783,10,N,N,-,-1,-1
TWOMEN.txt,408552,409241,689,10,N,N,-,-1,-1
TWOMEN.txt,408730,409287,557,10,N,N,-,-1,-1
TWOMEN.txt,408762,409304,542,10,N,N,-,-1,-1
TWOMEN.txt,408814,409325,511,10,N,N,-,-1,-1
TWOMEN.txt,408838,409664,826,10,N,N,-,-1,-1
TWOMEN.txt,408980,409732,752,10,N,N,-,-1,-1
TWOMEN.txt,409077,409836,759,10,N,N,-,-1,-1
TWOMEN.txt,409101,409891,790,10,N,N,-,-1,-1
TWOMEN.txt,409190,409973,783,10,N,N,-,-1,-1
TWOMEN.txt,409235,410041,806,10,N,N,-,-1,-1
TWOMEN.txt,409243,410059,816,10,N,N,-,-1,-1
TWOMEN.txt,409290,410176,886,10,N,N,-,-1,-1
TWOMEN.txt,409305,410254,949,10,N,N,-,-1,-1
TWOMEN.txt,409327,410274,947,10,N,N,-,-1,-1
TWOMEN.txt,409666,410333,667,10,N,N,-,-1,-1
TWOMEN.txt,409733,410341,608,10,N,N,-,-1,-1
TWOMEN.txt,409838,410354,516,10,N,N,-,-1,-1
TWOMEN.txt,409893,410363,470,10,N,N,-,-1,-1
TWOMEN.txt,409976,410376,400,10,N,N,-,-1,-1
TWOMEN.txt,410042,410385,343,10,N,N,-,-1,-1
TWOMEN.txt,410062,410407,345,10,N,N,-,-1,-1
TWOMEN.txt,410178,410423,245,10,N,N,-,-1,-1
TWOMEN.txt,410257,410436,179,10,N,N,-,-1,-1
TWOMEN.txt,410279,410671,392,10,N,N,-,-1,-1
TWOMEN.txt,410338,410704,366,10,N,N,-,-1,-1
TWOMEN.txt,410342,410732,390,10,N,N,-,-1,-1
TWOMEN.txt,410356,410783,427,10,N,N,-,-1,-1
TWOMEN.txt,410364,410856,492,10,N,N,-,-1,-1
TWOMEN.txt,410378,410906,528,10,N,N,-,-1,-1
TWOMEN.txt,410387,410945,558,10,N,N,-,-1,-1
TWOMEN.txt,410410,410966,556,10,N,N,-,-1,-1
TWOMEN.txt,410424,411020,596,10,N,N,-,-1,-1
TWOMEN.txt,410438,411064,626,10,N,N,-,-1,-1
TWOMEN.txt,410672,411086,414,10,N,N,-,-1,-1
TWOMEN.txt,410706,411105,399,10,N,N,-,-1,-1
TWOMEN.txt,410734,411125,391,10,N,N,-,-1,-1
TWOMEN.txt,410784,411157,373,10,N,N,-,-1,-1
TWOMEN.txt,410858,411215,357,10,N,N,-,-1,-1
TWOMEN.txt,410907,411295,388,10,N,N,-,-1,-1
TWOMEN.txt,410946,411296,350,10,N,N,-,-1,-1
TWOMEN.txt,410967,411380,413,10,N,N,-,-1,-1
TWOMEN.txt,411021,411393,372,10,N,N,-,-1,-1
TWOMEN.txt,411065,411462,397,10,N,N,-,-1,-1
TWOMEN.txt,411088,411836,748,10,N,N,-,-1,-1
TWOMEN.txt,411108,412037,929,10,N,N,-,-1,-1
TWOMEN.txt,411126,412155,1029,10,N,N,-,-1,-1
TWOMEN.txt,411159,412399,1240,10,N,N,-,-1,-1
TWOMEN.txt,411217,412666,1449,10,N,N,-,-1,-1
TWOMEN.txt,411295,412738,1443,10,N,N,-,-1,-1
TWOMEN.txt,411296,412819,1523,10,N,N,-,-1,-1
TWOMEN.txt,411381,412864,1483,10,N,N,-,-1,-1
TWOMEN.txt,411398,412888,1490,10,N,N,-,-1,-1
TWOMEN.txt,411463,412931,1468,10,N,N,-,-1,-1
TWOMEN.txt,411838,413086,1248,10,N,N,-,-1,-1
TWOMEN.txt,412038,413180,1142,10,N,N,-,-1,-1
TWOMEN.txt,412157,413236,1079,10,N,N,-,-1,-1
TWOMEN.txt,412400,413526,1126,10,N,N,-,-1,-1
TWOMEN.txt,412667,413578,911,10,N,N,-,-1,-1
TWOMEN.txt,412739,414765,2026,10,N,N,-,-1,-1
TWOMEN.txt,412821,415044,2223,10,N,N,-,-1,-1
TWOMEN.txt,412867,415102,2235,10,N,N,-,-1,-1
TWOMEN.txt,412890,415172,2282,10,N,N,-,-1,-1
TWOMEN.txt,412934,415232,2298,10,N,N,-,-1,-1
TWOMEN.txt,413087,415258,2171,10,N,N,-,-1,-1
TWOMEN.txt,413181,415280,2099,10,N,N,-,-1,-1
TWOMEN.txt,413237,415305,2068,10,N,N,-,-1,-1
TWOMEN.txt,413527,415343,1816,10,N,N,-,-1,-1
TWOMEN.txt,413579,415472,1893,10,N,N,-,-1,-1
TWOMEN.txt,414767,415515,748,10,N,N,-,-1,-1
TWOMEN.txt,415046,415615,569,10,N,N,-,-1,-1
TWOMEN.txt,415104,415645,541,10,N,N,-,-1,-1
TWOMEN.txt,415173,415670,497,10,N,N,-,-1,-1
TWOMEN.txt,415234,415738,504,10,N,N,-,-1,-1
TWOMEN.txt,415261,415823,562,10,N,N,-,-1,-1
TWOMEN.txt,415281,415895,614,10,N,N,-,-1,-1
TWOMEN.txt,415307,415992,685,10,N,N,-,-1,-1
TWOMEN.txt,415344,416041,697,10,N,N,-,-1,-1
TWOMEN.txt,415474,416244,770,10,N,N,-,-1,-1
TWOMEN.txt,415515,416303,788,10,N,N,-,-1,-1
TWOMEN.txt,415618,416320,702,10,N,N,-,-1,-1
TWOMEN.txt,415646,416338,692,10,N,N,-,-1,-1
TWOMEN.txt,415672,416380,708,10,N,N,-,-1,-1
TWOMEN.txt,415739,416461,722,10,N,N,-,-1,-1
TWOMEN.txt,415824,416571,747,10,N,N,-,-1,-1
TWOMEN.txt,415896,416636,740,10,N,N,-,-1,-1
TWOMEN.txt,415993,416691,698,10,N,N,-,-1,-1
TWOMEN.txt,416042,416797,755,10,N,N,-,-1,-1
TWOMEN.txt,416245,417134,889,10,N,N,-,-1,-1
TWOMEN.txt,416308,417282,974,10,N,N,-,-1,-1
TWOMEN.txt,416323,417442,1119,10,N,N,-,-1,-1
TWOMEN.txt,416343,417447,1104,10,N,N,-,-1,-1
TWOMEN.txt,416383,417613,1230,10,N,N,-,-1,-1
TWOMEN.txt,416463,417638,1175,10,N,N,-,-1,-1
TWOMEN.txt,416572,417663,1091,10,N,N,-,-1,-1
TWOMEN.txt,416638,417691,1053,10,N,N,-,-1,-1
TWOMEN.txt,416692,417760,1068,10,N,N,-,-1,-1
TWOMEN.txt,416798,417781,983,10,N,N,-,-1,-1
TWOMEN.txt,417136,417798,662,10,N,N,-,-1,-1
TWOMEN.txt,417283,417854,571,10,N,N,-,-1,-1
TWOMEN.txt,417444,417871,427,10,N,N,-,-1,-1
TWOMEN.txt,417448,417952,504,10,N,N,-,-1,-1
TWOMEN.txt,417616,417977,361,10,N,N,-,-1,-1
TWOMEN.txt,417639,418044,405,10,N,N,-,-1,-1
TWOMEN.txt,417665,418126,461,10,N,N,-,-1,-1
TWOMEN.txt,417692,418213,521,10,N,N,-,-1,-1
TWOMEN.txt,417762,418281,519,10,N,N,-,-1,-1
TWOMEN.txt,417783,418311,528,10,N,N,-,-1,-1
TWOMEN.txt,417799,418364,565,10,N,N,-,-1,-1
TWOMEN.txt,417857,418542,685,10,N,N,-,-1,-1
TWOMEN.txt,417876,418697,821,10,N,N,-,-1,-1
TWOMEN.txt,417954,418773,819,10,N,N,-,-1,-1
TWOMEN.txt,417979,418897,918,10,N,N,-,-1,-1
TWOMEN.txt,418045,418981,936,10,N,N,-,-1,-1
TWOMEN.txt,418127,419099,972,10,N,N,-,-1,-1
TWOMEN.txt,418214,419202,988,10,N,N,-,-1,-1
TWOMEN.txt,418283,419289,1006,10,N,N,-,-1,-1
TWOMEN.txt,418312,419426,1114,10,N,N,-,-1,-1
TWOMEN.txt,418367,419561,1194,10,N,N,-,-1,-1
TWOMEN.txt,418544,419678,1134,10,N,N,-,-1,-1
TWOMEN.txt,418698,419700,1002,10,N,N,-,-1,-1
TWOMEN.txt,418775,419756,981,10,N,N,-,-1,-1
TWOMEN.txt,418899,419817,918,10,N,N,-,-1,-1
TWOMEN.txt,418983,419934,951,10,N,N,-,-1,-1
TWOMEN.txt,419100,419962,862,10,N,N,-,-1,-1
TWOMEN.txt,419203,419979,776,10,N,N,-,-1,-1
TWOMEN.txt,419291,420169,878,10,N,N,-,-1,-1
TWOMEN.txt,419427,420354,927,10,N,N,-,-1,-1
TWOMEN.txt,419566,420536,970,10,N,N,-,-1,-1
TWOMEN.txt,419679,420875,1196,10,N,N,-,-1,-1
TWOMEN.txt,419701,420964,1263,10,N,N,-,-1,-1
TWOMEN.txt,419758,420995,1237,10,N,N,-,-1,-1
TWOMEN.txt,419817,421033,1216,10,N,N,-,-1,-1
TWOMEN.txt,419935,421163,1228,10,N,N,-,-1,-1
TWOMEN.txt,419964,421256,1292,10,N,N,-,-1,-1
TWOMEN.txt,419984,421286,1302,10,N,N,-,-1,-1
TWOMEN.txt,420170,421368,1198,10,N,N,-,-1,-1
TWOMEN.txt,420355,421404,1049,10,N,N,-,-1,-1
TWOMEN.txt,420537,421475,938,10,N,N,-,-1,-1
TWOMEN.txt,420876,421648,772,10,N,N,-,-1,-1
TWOMEN.txt,420965,421758,793,10,N,N,-,-1,-1
TWOMEN.txt,420997,421859,862,10,N,N,-,-1,-1
TWOMEN.txt,421035,422044,1009,10,N,N,-,-1,-1
TWOMEN.txt,421164,422097,933,10,N,N,-,-1,-1
TWOMEN.txt,421257,422125,868,10,N,N,-,-1,-1
TWOMEN.txt,421288,422292,1004,10,N,N,-,-1,-1
TWOMEN.txt,421369,422358,989,10,N,N,-,-1,-1
TWOMEN.txt,421406,422715,1309,10,N,N,-,-1,-1
TWOMEN.txt,421476,422798,1322,10,N,N,-,-1,-1
TWOMEN.txt,421649,422925,1276,10,N,N,-,-1,-1
TWOMEN.txt,421759,423011,1252,10,N,N,-,-1,-1
TWOMEN.txt,421862,423103,1241,10,N,N,-,-1,-1
TWOMEN.txt,422046,423273,1227,10,N,N,-,-1,-1
TWOMEN.txt,422098,423321,1223,10,N,N,-,-1,-1
TWOMEN.txt,422126,423383,1257,10,N,N,-,-1,-1
TWOMEN.txt,422293,423471,1178,10,N,N,-,-1,-1
TWOMEN.txt,422362,423612,1250,10,N,N,-,-1,-1
TWOMEN.txt,422719,423683,964,10,N,N,-,-1,-1
TWOMEN.txt,422799,423788,989,10,N,N,-,-1,-1
TWOMEN.txt,422926,424003,1077,10,N,N,-,-1,-1
TWOMEN.txt,423016,424071,1055,10,N,N,-,-1,-1
TWOMEN.txt,423104,424170,1066,10,N,N,-,-1,-1
TWOMEN.txt,423275,424336,1061,10,N,N,-,-1,-1
TWOMEN.txt,423322,424383,1061,10,N,N,-,-1,-1
TWOMEN.txt,423385,424473,1088,10,N,N,-,-1,-1
TWOMEN.txt,423474,424530,1056,10,N,N,-,-1,-1
TWOMEN.txt,423613,424606,993,10,N,N,-,-1,-1
TWOMEN.txt,423684,424704,1020,10,N,N,-,-1,-1
TWOMEN.txt,423791,424835,1044,10,N,N,-,-1,-1
TWOMEN.txt,424004,424991,987,10,N,N,-,-1,-1
TWOMEN.txt,424072,425294,1222,10,N,N,-,-1,-1
TWOMEN.txt,424171,425463,1292,10,N,N,-,-1,-1
TWOMEN.txt,424337,425513,1176,10,N,N,-,-1,-1
TWOMEN.txt,424384,425666,1282,10,N,N,-,-1,-1
TWOMEN.txt,424474,425705,1231,10,N,N,-,-1,-1
TWOMEN.txt,424531,425848,1317,10,N,N,-,-1,-1
TWOMEN.txt,424607,425942,1335,10,N,N,-,-1,-1
TWOMEN.txt,424709,426067,1358,10,N,N,-,-1,-1
TWOMEN.txt,424836,426137,1301,10,N,N,-,-1,-1
TWOMEN.txt,424992,426270,1278,10,N,N,-,-1,-1
TWOMEN.txt,425295,426568,1273,10,N,N,-,-1,-1
TWOMEN.txt,425464,426856,1392,10,N,N,-,-1,-1
TWOMEN.txt,425514,426945,1431,10,N,N,-,-1,-1
TWOMEN.txt,425670,427007,1337,10,N,N,-,-1,-1
TWOMEN.txt,425706,427033,1327,10,N,N,-,-1,-1
TWOMEN.txt,425850,427062,1212,10,N,N,-,-1,-1
TWOMEN.txt,425943,427198,1255,10,N,N,-,-1,-1
TWOMEN.txt,426070,427199,1129,10,N,N,-,-1,-1
TWOMEN.txt,426140,427217,1077,10,N,N,-,-1,-1
TWOMEN.txt,426275,427430,1155,10,N,N,-,-1,-1
TWOMEN.txt,426571,427480,909,10,N,N,-,-1,-1
TWOMEN.txt,426858,427658,800,10,N,N,-,-1,-1
TWOMEN.txt,426948,427828,880,10,N,N,-,-1,-1
TWOMEN.txt,427008,427962,954,10,N,N,-,-1,-1
TWOMEN.txt,427035,428034,999,10,N,N,-,-1,-1
TWOMEN.txt,427063,428137,1074,10,N,N,-,-1,-1
TWOMEN.txt,427198,428410,1212,10,N,N,-,-1,-1
TWOMEN.txt,427199,428467,1268,10,N,N,-,-1,-1
TWOMEN.txt,427218,428504,1286,10,N,N,-,-1,-1
TWOMEN.txt,427431,428669,1238,10,N,N,-,-1,-1
TWOMEN.txt,427481,428847,1366,10,N,N,-,-1,-1
TWOMEN.txt,427659,428923,1264,10,N,N,-,-1,-1
TWOMEN.txt,427829,428996,1167,10,N,N,-,-1,-1
TWOMEN.txt,427964,429019,1055,10,N,N,-,-1,-1
TWOMEN.txt,428035,429052,1017,10,N,N,-,-1,-1
TWOMEN.txt,428138,429147,1009,10,N,N,-,-1,-1
TWOMEN.txt,428411,429288,877,10,N,N,-,-1,-1
TWOMEN.txt,428468,429426,958,10,N,N,-,-1,-1
TWOMEN.txt,428505,429482,977,10,N,N,-,-1,-1
TWOMEN.txt,428671,429616,945,10,N,N,-,-1,-1
TWOMEN.txt,428848,429635,787,10,N,N,-,-1,-1
TWOMEN.txt,428924,429709,785,10,N,N,-,-1,-1
TWOMEN.txt,428997,429843,846,10,N,N,-,-1,-1
TWOMEN.txt,429021,429869,848,10,N,N,-,-1,-1
TWOMEN.txt,429053,429954,901,10,N,N,-,-1,-1
TWOMEN.txt,429148,430028,880,10,N,N,-,-1,-1
TWOMEN.txt,429289,430393,1104,10,N,N,-,-1,-1
TWOMEN.txt,429428,430489,1061,10,N,N,-,-1,-1
TWOMEN.txt,429484,430931,1447,10,N,N,-,-1,-1
TWOMEN.txt,429619,431030,1411,10,N,N,-,-1,-1
TWOMEN.txt,429638,431140,1502,10,N,N,-,-1,-1
TWOMEN.txt,429710,431363,1653,10,N,N,-,-1,-1
TWOMEN.txt,429844,431467,1623,10,N,N,-,-1,-1
TWOMEN.txt,429870,431545,1675,10,N,N,-,-1,-1
TWOMEN.txt,429955,431562,1607,10,N,N,-,-1,-1
TWOMEN.txt,430029,431568,1539,10,N,N,-,-1,-1
TWOMEN.txt,430395,431720,1325,10,N,N,-,-1,-1
TWOMEN.txt,430490,431769,1279,10,N,N,-,-1,-1
TWOMEN.txt,430933,431921,988,10,N,N,-,-1,-1
TWOMEN.txt,431031,432054,1023,10,N,N,-,-1,-1
TWOMEN.txt,431141,432209,1068,10,N,N,-,-1,-1
TWOMEN.txt,431364,432271,907,10,N,N,-,-1,-1
TWOMEN.txt,431468,432450,982,10,N,N,-,-1,-1
TWOMEN.txt,431546,432595,1049,10,N,N,-,-1,-1
TWOMEN.txt,431563,432620,1057,10,N,N,-,-1,-1
TWOMEN.txt,431570,432815,1245,10,N,N,-,-1,-1
TWOMEN.txt,431721,432905,1184,10,N,N,-,-1,-1
TWOMEN.txt,431770,433138,1368,10,N,N,-,-1,-1
TWOMEN.txt,431922,433316,1394,10,N,N,-,-1,-1
TWOMEN.txt,432055,433530,1475,10,N,N,-,-1,-1
TWOMEN.txt,432210,433562,1352,10,N,N,-,-1,-1
TWOMEN.txt,432272,433830,1558,10,N,N,-,-1,-1
TWOMEN.txt,432451,434070,1619,10,N,N,-,-1,-1
TWOMEN.txt,432596,434087,1491,10,N,N,-,-1,-1
TWOMEN.txt,432622,434099,1477,10,N,N,-,-1,-1
TWOMEN.txt,432816,434112,1296,10,N,N,-,-1,-1
TWOMEN.txt,432906,434170,1264,10,N,N,-,-1,-1
TWOMEN.txt,433139,434405,1266,10,N,N,-,-1,-1
TWOMEN.txt,433317,434498,1181,10,N,N,-,-1,-1
TWOMEN.txt,433530,434972,1442,10,N,N,-,-1,-1
TWOMEN.txt,433564,435081,1517,10,N,N,-,-1,-1
TWOMEN.txt,433831,435150,1319,10,N,N,-,-1,-1
TWOMEN.txt,434073,435231,1158,10,N,N,-,-1,-1
TWOMEN.txt,434088,435308,1220,10,N,N,-,-1,-1
TWOMEN.txt,434100,435330,1230,10,N,N,-,-1,-1
TWOMEN.txt,434114,435354,1240,10,N,N,-,-1,-1
TWOMEN.txt,434172,435495,1323,10,N,N,-,-1,-1
TWOMEN.txt,434410,435856,1446,10,N,N,-,-1,-1
TWOMEN.txt,434499,435897,1398,10,N,N,-,-1,-1
TWOMEN.txt,434973,435911,938,10,N,N,-,-1,-1
TWOMEN.txt,435082,435953,871,10,N,N,-,-1,-1
TWOMEN.txt,435151,436066,915,10,N,N,-,-1,-1
TWOMEN.txt,435232,436151,919,10,N,N,-,-1,-1
TWOMEN.txt,435311,436191,880,10,N,N,-,-1,-1
TWOMEN.txt,435331,436408,1077,10,N,N,-,-1,-1
TWOMEN.txt,435356,436461,1105,10,N,N,-,-1,-1
TWOMEN.txt,435496,436500,1004,10,N,N,-,-1,-1
TWOMEN.txt,435858,436578,720,10,N,N,-,-1,-1
TWOMEN.txt,435898,436703,805,10,N,N,-,-1,-1
TWOMEN.txt,435915,436898,983,10,N,N,-,-1,-1
TWOMEN.txt,435954,437067,1113,10,N,N,-,-1,-1
TWOMEN.txt,436067,437333,1266,10,N,N,-,-1,-1
TWOMEN.txt,436152,437722,1570,10,N,N,-,-1,-1
TWOMEN.txt,436192,437897,1705,10,N,N,-,-1,-1
TWOMEN.txt,436412,437964,1552,10,N,N,-,-1,-1
TWOMEN.txt,436463,438052,1589,10,N,N,-,-1,-1
TWOMEN.txt,436501,438090,1589,10,N,N,-,-1,-1
TWOMEN.txt,436580,438115,1535,10,N,N,-,-1,-1
TWOMEN.txt,436705,438161,1456,10,N,N,-,-1,-1
TWOMEN.txt,436899,438171,1272,10,N,N,-,-1,-1
TWOMEN.txt,437069,438186,1117,10,N,N,-,-1,-1
TWOMEN.txt,437334,438215,881,10,N,N,-,-1,-1
TWOMEN.txt,437723,438254,531,10,N,N,-,-1,-1
TWOMEN.txt,437898,438465,567,10,N,N,-,-1,-1
TWOMEN.txt,437965,438518,553,10,N,N,-,-1,-1
TWOMEN.txt,438053,439094,1041,10,N,N,-,-1,-1
TWOMEN.txt,438091,439150,1059,10,N,N,-,-1,-1
TWOMEN.txt,438120,439442,1322,10,N,N,-,-1,-1
TWOMEN.txt,438162,439465,1303,10,N,N,-,-1,-1
TWOMEN.txt,438171,439655,1484,10,N,N,-,-1,-1
TWOMEN.txt,438188,439752,1564,10,N,N,-,-1,-1
TWOMEN.txt,438216,439897,1681,10,N,N,-,-1,-1
TWOMEN.txt,438255,439992,1737,10,N,N,-,-1,-1
TWOMEN.txt,438467,440125,1658,10,N,N,-,-1,-1
TWOMEN.txt,438520,440210,1690,10,N,N,-,-1,-1
TWOMEN.txt,439095,440240,1145,10,N,N,-,-1,-1
TWOMEN.txt,439152,440247,1095,10,N,N,-,-1,-1
TWOMEN.txt,439443,440260,817,10,N,N,-,-1,-1
TWOMEN.txt,439467,440333,866,10,N,N,-,-1,-1
TWOMEN.txt,439660,440388,728,10,N,N,-,-1,-1
TWOMEN.txt,439753,440582,829,10,N,N,-,-1,-1
TWOMEN.txt,439898,440737,839,10,N,N,-,-1,-1
TWOMEN.txt,439994,440801,807,10,N,N,-,-1,-1
TWOMEN.txt,440126,441086,960,10,N,N,-,-1,-1
TWOMEN.txt,440213,441309,1096,10,N,N,-,-1,-1
TWOMEN.txt,440243,441425,1182,10,N,N,-,-1,-1
TWOMEN.txt,440248,441444,1196,10,N,N,-,-1,-1
TWOMEN.txt,440262,441472,1210,10,N,N,-,-1,-1
TWOMEN.txt,440334,441479,1145,10,N,N,-,-1,-1
TWOMEN.txt,440389,441501,1112,10,N,N,-,-1,-1
TWOMEN.txt,440583,441640,1057,10,N,N,-,-1,-1
TWOMEN.txt,440738,441841,1103,10,N,N,-,-1,-1
TWOMEN.txt,440801,441868,1067,10,N,N,-,-1,-1
TWOMEN.txt,441087,442096,1009,10,N,N,-,-1,-1
TWOMEN.txt,441310,442147,837,10,N,N,-,-1,-1
TWOMEN.txt,441430,442183,753,10,N,N,-,-1,-1
TWOMEN.txt,441445,442985,1540,10,N,N,-,-1,-1
TWOMEN.txt,441473,443063,1590,10,N,N,-,-1,-1
TWOMEN.txt,441480,443160,1680,10,N,N,-,-1,-1
TWOMEN.txt,441503,443202,1699,10,N,N,-,-1,-1
TWOMEN.txt,441641,443302,1661,10,N,N,-,-1,-1
TWOMEN.txt,441842,443339,1497,10,N,N,-,-1,-1
TWOMEN.txt,441870,443388,1518,10,N,N,-,-1,-1
TWOMEN.txt,442098,443457,1359,10,N,N,-,-1,-1
TWOMEN.txt,442148,443666,1518,10,N,N,-,-1,-1
TWOMEN.txt,442184,443756,1572,10,N,N,-,-1,-1
TWOMEN.txt,442987,443922,935,10,N,N,-,-1,-1
TWOMEN.txt,443064,443977,913,10,N,N,-,-1,-1
TWOMEN.txt,443164,444000,836,10,N,N,-,-1,-1
TWOMEN.txt,443207,444025,818,10,N,N,-,-1,-1
TWOMEN.txt,443304,444077,773,10,N,Y,1437028092146,121457,123204
TWOMEN.txt,443340,444316,976,10,N,Y,1437028092146,121457,123204
TWOMEN.txt,443389,444480,1091,10,N,Y,1437028092146,121457,123204
TWOMEN.txt,443458,444615,1157,10,N,Y,1437028092146,121457,123204
TWOMEN.txt,443667,444654,987,10,N,Y,1437028092146,121457,123204
TWOMEN.txt,443757,444795,1038,10,N,Y,1437028092146,121457,123204
TWOMEN.txt,443923,444903,980,10,N,Y,1437028092146,121457,123204
TWOMEN.txt,443980,444988,1008,10,N,Y,1437028092146,121457,123204
TWOMEN.txt,444001,445026,1025,10,N,Y,1437028092146,121457,123204
TWOMEN.txt,444027,445159,1132,10,N,Y,1437028092146,121457,123204
TWOMEN.txt,444078,445227,1149,10,N,Y,1437028092146,121457,123204
TWOMEN.txt,444317,445473,1156,10,N,Y,1437028092146,121457,123204
TWOMEN.txt,444481,445512,1031,10,N,Y,1437028092146,121457,123204
TWOMEN.txt,444616,445531,915,10,N,Y,1437028092146,121457,123204
TWOMEN.txt,444656,445546,890,10,N,N,-,-1,-1
TWOMEN.txt,444795,445555,760,10,N,N,-,-1,-1
TWOMEN.txt,444904,445596,692,10,N,N,-,-1,-1
TWOMEN.txt,444988,445769,781,10,N,N,-,-1,-1
TWOMEN.txt,445027,445836,809,10,N,N,-,-1,-1
TWOMEN.txt,445161,446027,866,10,N,N,-,-1,-1
TWOMEN.txt,445228,446074,846,10,N,N,-,-1,-1
TWOMEN.txt,445474,446077,603,10,N,N,-,-1,-1
TWOMEN.txt,445515,446148,633,10,N,N,-,-1,-1
TWOMEN.txt,445532,446460,928,10,N,N,-,-1,-1
TWOMEN.txt,445547,446564,1017,10,N,N,-,-1,-1
TWOMEN.txt,445557,446695,1138,10,N,N,-,-1,-1
TWOMEN.txt,445597,446703,1106,10,N,N,-,-1,-1
TWOMEN.txt,445770,446954,1184,10,N,N,-,-1,-1
TWOMEN.txt,445837,446971,1134,10,N,N,-,-1,-1
TWOMEN.txt,446029,446981,952,10,N,N,-,-1,-1
TWOMEN.txt,446074,446986,912,10,N,N,-,-1,-1
TWOMEN.txt,446078,446996,918,10,N,N,-,-1,-1
TWOMEN.txt,446149,447028,879,10,N,N,-,-1,-1
TWOMEN.txt,446462,447164,702,10,N,N,-,-1,-1
TWOMEN.txt,446565,447178,613,10,N,N,-,-1,-1
TWOMEN.txt,446696,447334,638,10,N,N,-,-1,-1
TWOMEN.txt,446704,447388,684,10,N,N,-,-1,-1
TWOMEN.txt,446957,447513,556,10,N,N,-,-1,-1
TWOMEN.txt,446972,447525,553,10,N,N,-,-1,-1
TWOMEN.txt,446981,447542,561,10,N,N,-,-1,-1
TWOMEN.txt,446987,447613,626,10,N,N,-,-1,-1
TWOMEN.txt,446998,447705,707,10,N,N,-,-1,-1
TWOMEN.txt,447029,447750,721,10,N,N,-,-1,-1
TWOMEN.txt,447165,447843,678,10,N,N,-,-1,-1
TWOMEN.txt,447179,448249,1070,10,N,N,-,-1,-1
TWOMEN.txt,447335,448266,931,10,N,N,-,-1,-1
TWOMEN.txt,447389,448321,932,10,N,N,-,-1,-1
TWOMEN.txt,447513,448403,890,10,N,N,-,-1,-1
TWOMEN.txt,447527,448548,1021,10,N,N,-,-1,-1
TWOMEN.txt,447543,448814,1271,10,N,N,-,-1,-1
TWOMEN.txt,447614,448906,1292,10,N,N,-,-1,-1
TWOMEN.txt,447707,448962,1255,10,N,N,-,-1,-1
TWOMEN.txt,447751,448980,1229,10,N,N,-,-1,-1
TWOMEN.txt,447844,448990,1146,10,N,N,-,-1,-1
TWOMEN.txt,448249,448996,747,10,N,N,-,-1,-1
TWOMEN.txt,448268,449010,742,10,N,N,-,-1,-1
TWOMEN.txt,448323,449204,881,10,N,N,-,-1,-1
TWOMEN.txt,448404,449407,1003,10,N,N,-,-1,-1
TWOMEN.txt,448549,449470,921,10,N,N,-,-1,-1
TWOMEN.txt,448815,449706,891,10,N,N,-,-1,-1
TWOMEN.txt,448907,449894,987,10,N,N,-,-1,-1
TWOMEN.txt,448965,450112,1147,10,N,N,-,-1,-1
TWOMEN.txt,448981,450285,1304,10,N,N,-,-1,-1
TWOMEN.txt,448990,450378,1388,10,N,N,-,-1,-1
TWOMEN.txt,448997,450397,1400,10,N,N,-,-1,-1
TWOMEN.txt,449012,450450,1438,10,N,N,-,-1,-1
TWOMEN.txt,449205,450589,1384,10,N,N,-,-1,-1
TWOMEN.txt,449408,450603,1195,10,N,N,-,-1,-1
TWOMEN.txt,449471,450705,1234,10,N,N,-,-1,-1
TWOMEN.txt,449708,450839,1131,10,N,N,-,-1,-1
TWOMEN.txt,449895,450900,1005,10,N,N,-,-1,-1
TWOMEN.txt,450114,451063,949,10,N,N,-,-1,-1
TWOMEN.txt,450286,451080,794,10,N,N,-,-1,-1
TWOMEN.txt,450379,451094,715,10,N,N,-,-1,-1
TWOMEN.txt,450399,451104,705,10,N,N,-,-1,-1
TWOMEN.txt,450450,451167,717,10,N,N,-,-1,-1
TWOMEN.txt,450591,451228,637,10,N,N,-,-1,-1
TWOMEN.txt,450605,451347,742,10,N,N,-,-1,-1
TWOMEN.txt,450706,451505,799,10,N,N,-,-1,-1
TWOMEN.txt,450840,451758,918,10,N,N,-,-1,-1
TWOMEN.txt,450901,451794,893,10,N,N,-,-1,-1
TWOMEN.txt,451066,451848,782,10,N,N,-,-1,-1
TWOMEN.txt,451081,451923,842,10,N,N,-,-1,-1
TWOMEN.txt,451095,451994,899,10,N,N,-,-1,-1
TWOMEN.txt,451106,451999,893,10,N,N,-,-1,-1
TWOMEN.txt,451168,452001,833,10,N,N,-,-1,-1
TWOMEN.txt,451229,452045,816,10,N,N,-,-1,-1
TWOMEN.txt,451349,452162,813,10,N,N,-,-1,-1
TWOMEN.txt,451506,452214,708,10,N,N,-,-1,-1
TWOMEN.txt,451760,452231,471,10,N,N,-,-1,-1
TWOMEN.txt,451795,452241,446,10,N,N,-,-1,-1
TWOMEN.txt,451848,452242,394,10,N,N,-,-1,-1
TWOMEN.txt,451924,452248,324,10,N,N,-,-1,-1
TWOMEN.txt,451996,452254,258,10,N,N,-,-1,-1
TWOMEN.txt,452000,452262,262,10,N,N,-,-1,-1
TWOMEN.txt,452002,452563,561,10,N,N,-,-1,-1
TWOMEN.txt,452046,452632,586,10,N,N,-,-1,-1
TWOMEN.txt,452162,452891,729,10,N,N,-,-1,-1
TWOMEN.txt,452217,453147,930,10,N,N,-,-1,-1
TWOMEN.txt,452232,453242,1010,10,N,N,-,-1,-1
TWOMEN.txt,452241,453284,1043,10,N,N,-,-1,-1
TWOMEN.txt,452242,453345,1103,10,N,N,-,-1,-1
TWOMEN.txt,452249,453445,1196,10,N,N,-,-1,-1
TWOMEN.txt,452257,453584,1327,10,N,N,-,-1,-1
TWOMEN.txt,452264,453837,1573,10,N,N,-,-1,-1
TWOMEN.txt,452565,453955,1390,10,N,N,-,-1,-1
TWOMEN.txt,452634,454100,1466,10,N,N,-,-1,-1
TWOMEN.txt,452892,454243,1351,10,N,N,-,-1,-1
TWOMEN.txt,453148,454319,1171,10,N,N,-,-1,-1
TWOMEN.txt,453242,454473,1231,10,N,N,-,-1,-1
TWOMEN.txt,453286,454668,1382,10,N,N,-,-1,-1
TWOMEN.txt,453347,454801,1454,10,N,N,-,-1,-1
TWOMEN.txt,453446,454849,1403,10,N,N,-,-1,-1
TWOMEN.txt,453586,454951,1365,10,N,N,-,-1,-1
TWOMEN.txt,453838,455031,1193,10,N,N,-,-1,-1
TWOMEN.txt,453956,455105,1149,10,N,N,-,-1,-1
TWOMEN.txt,454101,455127,1026,10,N,N,-,-1,-1
TWOMEN.txt,454244,455130,886,10,N,N,-,-1,-1
TWOMEN.txt,454321,455136,815,10,N,N,-,-1,-1
TWOMEN.txt,454475,455146,671,10,N,N,-,-1,-1
TWOMEN.txt,454669,455226,557,10,N,N,-,-1,-1
TWOMEN.txt,454802,455346,544,10,N,N,-,-1,-1
TWOMEN.txt,454849,455396,547,10,N,N,-,-1,-1
TWOMEN.txt,454952,455557,605,10,N,N,-,-1,-1
TWOMEN.txt,455032,455647,615,10,N,N,-,-1,-1
TWOMEN.txt,455108,455677,569,10,N,N,-,-1,-1
TWOMEN.txt,455129,455687,558,10,N,N,-,-1,-1
TWOMEN.txt,455130,455859,729,10,N,N,-,-1,-1
TWOMEN.txt,455138,455976,838,10,N,N,-,-1,-1
TWOMEN.txt,455148,456216,1068,10,N,N,-,-1,-1
TWOMEN.txt,455227,456236,1009,10,N,N,-,-1,-1
TWOMEN.txt,455347,456316,969,10,N,N,-,-1,-1
TWOMEN.txt,455397,456428,1031,10,N,N,-,-1,-1
TWOMEN.txt,455558,456754,1196,10,N,N,-,-1,-1
TWOMEN.txt,455649,456824,1175,10,N,N,-,-1,-1
TWOMEN.txt,455678,456839,1161,10,N,N,-,-1,-1
TWOMEN.txt,455689,456843,1154,10,N,N,-,-1,-1
TWOMEN.txt,455860,456863,1003,10,N,N,-,-1,-1
TWOMEN.txt,455978,456912,934,10,N,N,-,-1,-1
TWOMEN.txt,456218,457064,846,10,N,N,-,-1,-1
TWOMEN.txt,456237,457119,882,10,N,N,-,-1,-1
TWOMEN.txt,456317,457418,1101,10,N,N,-,-1,-1
TWOMEN.txt,456428,457422,994,10,N,N,-,-1,-1
TWOMEN.txt,456755,457440,685,10,N,N,-,-1,-1
TWOMEN.txt,456826,457461,635,10,N,N,-,-1,-1
TWOMEN.txt,456840,457520,680,10,N,N,-,-1,-1
TWOMEN.txt,456843,457762,919,10,N,N,-,-1,-1
TWOMEN.txt,456865,457809,944,10,N,N,-,-1,-1
TWOMEN.txt,456913,457826,913,10,N,N,-,-1,-1
TWOMEN.txt,457069,457849,780,10,N,N,-,-1,-1
TWOMEN.txt,457120,457868,748,10,N,N,-,-1,-1
TWOMEN.txt,457419,457899,480,10,N,N,-,-1,-1
TWOMEN.txt,457423,458076,653,10,N,N,-,-1,-1
TWOMEN.txt,457442,458240,798,10,N,N,-,-1,-1
TWOMEN.txt,457462,458265,803,10,N,N,-,-1,-1
TWOMEN.txt,457521,458303,782,10,N,N,-,-1,-1
TWOMEN.txt,457763,458407,644,10,N,N,-,-1,-1
TWOMEN.txt,457811,458492,681,10,N,N,-,-1,-1
TWOMEN.txt,457828,458604,776,10,N,N,-,-1,-1
TWOMEN.txt,457852,458768,916,10,N,N,-,-1,-1
TWOMEN.txt,457869,459107,1238,10,N,N,-,-1,-1
TWOMEN.txt,457901,459186,1285,10,N,N,-,-1,-1
TWOMEN.txt,458076,459325,1249,10,N,N,-,-1,-1
TWOMEN.txt,458242,459346,1104,10,N,N,-,-1,-1
TWOMEN.txt,458266,459362,1096,10,N,N,-,-1,-1
TWOMEN.txt,458303,459510,1207,10,N,N,-,-1,-1
TWOMEN.txt,458409,459739,1330,10,N,N,-,-1,-1
TWOMEN.txt,458493,459980,1487,10,N,N,-,-1,-1
TWOMEN.txt,458605,459992,1387,10,N,N,-,-1,-1
TWOMEN.txt,458768,460135,1367,10,N,N,-,-1,-1
TWOMEN.txt,459109,460505,1396,10,N,N,-,-1,-1
TWOMEN.txt,459187,460805,1618,10,N,N,-,-1,-1
TWOMEN.txt,459328,460814,1486,10,N,N,-,-1,-1
TWOMEN.txt,459347,461046,1699,10,N,N,-,-1,-1
TWOMEN.txt,459364,461192,1828,10,N,N,-,-1,-1
TWOMEN.txt,459511,461355,1844,10,N,N,-,-1,-1
TWOMEN.txt,459740,461463,1723,10,N,N,-,-1,-1
TWOMEN.txt,459981,461578,1597,10,N,N,-,-1,-1
TWOMEN.txt,459994,461654,1660,10,N,N,-,-1,-1
TWOMEN.txt,460136,461700,1564,10,N,N,-,-1,-1
TWOMEN.txt,460510,462057,1547,10,N,N,-,-1,-1
TWOMEN.txt,460806,462086,1280,10,N,N,-,-1,-1
TWOMEN.txt,460815,462183,1368,10,N,N,-,-1,-1
TWOMEN.txt,461047,462267,1220,10,N,N,-,-1,-1
TWOMEN.txt,461194,462451,1257,10,N,N,-,-1,-1
TWOMEN.txt,461356,462696,1340,10,N,N,-,-1,-1
TWOMEN.txt,461464,462776,1312,10,N,N,-,-1,-1
TWOMEN.txt,461579,462829,1250,10,N,N,-,-1,-1
TWOMEN.txt,461655,462886,1231,10,N,N,-,-1,-1
TWOMEN.txt,461701,463059,1358,10,N,N,-,-1,-1
TWOMEN.txt,462058,463208,1150,10,N,N,-,-1,-1
TWOMEN.txt,462087,463213,1126,10,N,N,-,-1,-1
TWOMEN.txt,462185,463272,1087,10,N,N,-,-1,-1
TWOMEN.txt,462268,463351,1083,10,N,N,-,-1,-1
TWOMEN.txt,462452,463379,927,10,N,N,-,-1,-1
TWOMEN.txt,462697,463503,806,10,N,N,-,-1,-1
TWOMEN.txt,462778,463505,727,10,N,N,-,-1,-1
TWOMEN.txt,462830,463593,763,10,N,N,-,-1,-1
TWOMEN.txt,462887,463775,888,10,N,N,-,-1,-1
TWOMEN.txt,463060,464275,1215,10,N,N,-,-1,-1
TWOMEN.txt,463210,464372,1162,10,N,N,-,-1,-1
TWOMEN.txt,463214,464442,1228,10,N,N,-,-1,-1
TWOMEN.txt,463273,464521,1248,10,N,N,-,-1,-1
TWOMEN.txt,463352,464705,1353,10,N,N,-,-1,-1
TWOMEN.txt,463381,465064,1683,10,N,N,-,-1,-1
TWOMEN.txt,463504,465152,1648,10,N,N,-,-1,-1
TWOMEN.txt,463507,465311,1804,10,N,N,-,-1,-1
TWOMEN.txt,463594,465588,1994,10,N,N,-,-1,-1
TWOMEN.txt,463777,465593,1816,10,N,N,-,-1,-1
TWOMEN.txt,464278,465619,1341,10,N,N,-,-1,-1
TWOMEN.txt,464374,465646,1272,10,N,N,-,-1,-1
TWOMEN.txt,464443,465694,1251,10,N,N,-,-1,-1
TWOMEN.txt,464522,465769,1247,10,N,N,-,-1,-1
TWOMEN.txt,464706,465808,1102,10,N,N,-,-1,-1
TWOMEN.txt,465065,465929,864,10,N,N,-,-1,-1
TWOMEN.txt,465153,466001,848,10,N,N,-,-1,-1
TWOMEN.txt,465312,466216,904,10,N,N,-,-1,-1
TWOMEN.txt,465590,466231,641,10,N,N,-,-1,-1
TWOMEN.txt,465594,466349,755,10,N,N,-,-1,-1
TWOMEN.txt,465620,466453,833,10,N,N,-,-1,-1
TWOMEN.txt,465651,466467,816,10,N,N,-,-1,-1
TWOMEN.txt,465695,466564,869,10,N,N,-,-1,-1
TWOMEN.txt,465770,466611,841,10,N,N,-,-1,-1
TWOMEN.txt,465809,466782,973,10,N,N,-,-1,-1
TWOMEN.txt,465929,466940,1011,10,N,N,-,-1,-1
TWOMEN.txt,466002,467458,1456,10,N,N,-,-1,-1
TWOMEN.txt,466216,467585,1369,10,N,N,-,-1,-1
TWOMEN.txt,466232,467613,1381,10,N,N,-,-1,-1
TWOMEN.txt,466351,467716,1365,10,N,N,-,-1,-1
TWOMEN.txt,466454,467799,1345,10,N,N,-,-1,-1
TWOMEN.txt,466467,468004,1537,10,N,N,-,-1,-1
TWOMEN.txt,466565,468169,1604,10,N,N,-,-1,-1
TWOMEN.txt,466612,468302,1690,10,N,N,-,-1,-1
TWOMEN.txt,466783,468451,1668,10,N,N,-,-1,-1
TWOMEN.txt,466942,468508,1566,10,N,N,-,-1,-1
TWOMEN.txt,467459,468569,1110,10,N,N,-,-1,-1
TWOMEN.txt,467587,468616,1029,10,N,N,-,-1,-1
TWOMEN.txt,467614,468655,1041,10,N,N,-,-1,-1
TWOMEN.txt,467717,468841,1124,10,N,N,-,-1,-1
TWOMEN.txt,467800,468957,1157,10,N,N,-,-1,-1
TWOMEN.txt,468005,469138,1133,10,N,N,-,-1,-1
TWOMEN.txt,468171,469356,1185,10,N,N,-,-1,-1
TWOMEN.txt,468302,469484,1182,10,N,N,-,-1,-1
TWOMEN.txt,468452,469552,1100,10,N,N,-,-1,-1
TWOMEN.txt,468510,469596,1086,10,N,N,-,-1,-1
TWOMEN.txt,468570,469613,1043,10,N,N,-,-1,-1
TWOMEN.txt,468618,469637,1019,10,N,N,-,-1,-1
TWOMEN.txt,468656,469685,1029,10,N,N,-,-1,-1
TWOMEN.txt,468842,469698,856,10,N,N,-,-1,-1
TWOMEN.txt,468959,469896,937,10,N,N,-,-1,-1
TWOMEN.txt,469140,469988,848,10,N,N,-,-1,-1
TWOMEN.txt,469357,470005,648,10,N,N,-,-1,-1
TWOMEN.txt,469485,470008,523,10,N,N,-,-1,-1
TWOMEN.txt,469553,470022,469,10,N,N,-,-1,-1
TWOMEN.txt,469599,470028,429,10,N,N,-,-1,-1
TWOMEN.txt,469614,470036,422,10,N,N,-,-1,-1
TWOMEN.txt,469639,470105,466,10,N,N,-,-1,-1
TWOMEN.txt,469685,470150,465,10,N,N,-,-1,-1
TWOMEN.txt,469700,470228,528,10,N,N,-,-1,-1
TWOMEN.txt,469897,470320,423,10,N,N,-,-1,-1
TWOMEN.txt,469991,470498,507,10,N,N,-,-1,-1
TWOMEN.txt,470005,470515,510,10,N,N,-,-1,-1
TWOMEN.txt,470009,470608,599,10,N,N,-,-1,-1
TWOMEN.txt,470023,470876,853,10,N,N,-,-1,-1
TWOMEN.txt,470030,471196,1166,10,N,N,-,-1,-1
TWOMEN.txt,470037,471354,1317,10,N,N,-,-1,-1
TWOMEN.txt,470106,471494,1388,10,N,N,-,-1,-1
TWOMEN.txt,470151,471535,1384,10,N,N,-,-1,-1
TWOMEN.txt,470229,471598,1369,10,N,N,-,-1,-1
TWOMEN.txt,470321,471618,1297,10,N,N,-,-1,-1
TWOMEN.txt,470499,471886,1387,10,N,N,-,-1,-1
TWOMEN.txt,470516,472296,1780,10,N,N,-,-1,-1
TWOMEN.txt,470609,472590,1981,10,N,N,-,-1,-1
TWOMEN.txt,470877,472744,1867,10,N,N,-,-1,-1
TWOMEN.txt,471198,472821,1623,10,N,N,-,-1,-1
TWOMEN.txt,471355,473022,1667,10,N,N,-,-1,-1
TWOMEN.txt,471496,473140,1644,10,N,N,-,-1,-1
TWOMEN.txt,471538,473281,1743,10,N,N,-,-1,-1
TWOMEN.txt,471600,473338,1738,10,N,N,-,-1,-1
TWOMEN.txt,471620,473471,1851,10,N,N,-,-1,-1
TWOMEN.txt,471887,473668,1781,10,N,N,-,-1,-1
TWOMEN.txt,472297,474017,1720,10,N,N,-,-1,-1
TWOMEN.txt,472592,474191,1599,10,N,N,-,-1,-1
TWOMEN.txt,472745,474263,1518,10,N,N,-,-1,-1
TWOMEN.txt,472822,474353,1531,10,N,N,-,-1,-1
TWOMEN.txt,473023,474436,1413,10,N,N,-,-1,-1
TWOMEN.txt,473141,474730,1589,10,N,N,-,-1,-1
TWOMEN.txt,473283,474818,1535,10,N,N,-,-1,-1
TWOMEN.txt,473340,474841,1501,10,N,N,-,-1,-1
TWOMEN.txt,473472,474867,1395,10,N,N,-,-1,-1
TWOMEN.txt,473669,474935,1266,10,N,N,-,-1,-1
TWOMEN.txt,474017,475105,1088,10,N,N,-,-1,-1
TWOMEN.txt,474193,475341,1148,10,N,N,-,-1,-1
TWOMEN.txt,474265,475484,1219,10,N,N,-,-1,-1
TWOMEN.txt,474354,475715,1361,10,N,N,-,-1,-1
TWOMEN.txt,474437,476028,1591,10,N,N,-,-1,-1
TWOMEN.txt,474731,476094,1363,10,N,N,-,-1,-1
TWOMEN.txt,474821,476142,1321,10,N,N,-,-1,-1
TWOMEN.txt,474842,476261,1419,10,N,N,-,-1,-1
TWOMEN.txt,474869,476340,1471,10,N,N,-,-1,-1
TWOMEN.txt,474936,476499,1563,10,N,N,-,-1,-1
TWOMEN.txt,475106,476567,1461,10,N,N,-,-1,-1
TWOMEN.txt,475342,476782,1440,10,N,N,-,-1,-1
TWOMEN.txt,475486,476921,1435,10,N,N,-,-1,-1
TWOMEN.txt,475717,477032,1315,10,N,N,-,-1,-1
TWOMEN.txt,476029,477091,1062,10,N,N,-,-1,-1
TWOMEN.txt,476095,477246,1151,10,N,N,-,-1,-1
TWOMEN.txt,476143,477510,1367,10,N,N,-,-1,-1
TWOMEN.txt,476262,477827,1565,10,N,N,-,-1,-1
TWOMEN.txt,476342,478019,1677,10,N,N,-,-1,-1
TWOMEN.txt,476500,478052,1552,10,N,N,-,-1,-1
TWOMEN.txt,476569,478088,1519,10,N,N,-,-1,-1
TWOMEN.txt,476783,478187,1404,10,N,N,-,-1,-1
TWOMEN.txt,476922,478190,1268,10,N,N,-,-1,-1
TWOMEN.txt,477032,478313,1281,10,N,N,-,-1,-1
TWOMEN.txt,477092,478354,1262,10,N,N,-,-1,-1
TWOMEN.txt,477247,478498,1251,10,N,N,-,-1,-1
TWOMEN.txt,477511,478500,989,10,N,N,-,-1,-1
TWOMEN.txt,477828,478502,674,10,N,N,-,-1,-1
TWOMEN.txt,478020,478504,484,10,N,N,-,-1,-1
TWOMEN.txt,478057,478505,448,10,N,N,-,-1,-1
TWOMEN.txt,478089,478526,437,10,N,N,-,-1,-1
TWOMEN.txt,478187,478559,372,10,N,N,-,-1,-1
TWOMEN.txt,478191,478576,385,10,N,N,-,-1,-1
TWOMEN.txt,478314,478633,319,10,N,N,-,-1,-1
TWOMEN.txt,478355,478664,309,10,N,N,-,-1,-1
TWOMEN.txt,478499,478806,307,10,N,N,-,-1,-1
TWOMEN.txt,478501,478897,396,10,N,N,-,-1,-1
TWOMEN.txt,478503,478920,417,10,N,N,-,-1,-1
TWOMEN.txt,478504,478929,425,10,N,N,-,-1,-1
TWOMEN.txt,478508,478946,438,10,N,N,-,-1,-1
TWOMEN.txt,478527,478983,456,10,N,N,-,-1,-1
TWOMEN.txt,478561,479139,578,10,N,N,-,-1,-1
TWOMEN.txt,478578,479279,701,10,N,N,-,-1,-1
TWOMEN.txt,478635,479463,828,10,N,N,-,-1,-1
TWOMEN.txt,478664,479472,808,10,N,N,-,-1,-1
TWOMEN.txt,478807,479530,723,10,N,N,-,-1,-1
TWOMEN.txt,478900,479556,656,10,N,N,-,-1,-1
TWOMEN.txt,478922,479618,696,10,N,N,-,-1,-1
TWOMEN.txt,478931,479717,786,10,N,N,-,-1,-1
TWOMEN.txt,478948,479796,848,10,N,N,-,-1,-1
TWOMEN.txt,478984,479945,961,10,N,N,-,-1,-1
TWOMEN.txt,479141,479950,809,10,N,N,-,-1,-1
TWOMEN.txt,479280,480082,802,10,N,N,-,-1,-1
TWOMEN.txt,479464,480198,734,10,N,N,-,-1,-1
TWOMEN.txt,479474,480272,798,10,N,N,-,-1,-1
TWOMEN.txt,479534,480326,792,10,N,N,-,-1,-1
TWOMEN.txt,479558,480416,858,10,N,N,-,-1,-1
TWOMEN.txt,479623,480506,883,10,N,N,-,-1,-1
TWOMEN.txt,479719,480733,1014,10,N,N,-,-1,-1
TWOMEN.txt,479797,480871,1074,10,N,N,-,-1,-1
TWOMEN.txt,479947,480908,961,10,N,N,-,-1,-1
TWOMEN.txt,479950,480925,975,10,N,N,-,-1,-1
TWOMEN.txt,480083,480940,857,10,N,N,-,-1,-1
TWOMEN.txt,480199,480951,752,10,N,N,-,-1,-1
TWOMEN.txt,480273,481019,746,10,N,N,-,-1,-1
TWOMEN.txt,480327,481206,879,10,N,N,-,-1,-1
TWOMEN.txt,480417,481232,815,10,N,N,-,-1,-1
TWOMEN.txt,480508,481287,779,10,N,N,-,-1,-1
TWOMEN.txt,480734,481413,679,10,N,N,-,-1,-1
TWOMEN.txt,480873,481598,725,10,N,N,-,-1,-1
TWOMEN.txt,480911,481736,825,10,N,N,-,-1,-1
TWOMEN.txt,480926,481754,828,10,N,N,-,-1,-1
TWOMEN.txt,480941,481823,882,10,N,N,-,-1,-1
TWOMEN.txt,480953,481922,969,10,N,N,-,-1,-1
TWOMEN.txt,481020,481951,931,10,N,N,-,-1,-1
TWOMEN.txt,481207,481994,787,10,N,N,-,-1,-1
TWOMEN.txt,481237,482046,809,10,N,N,-,-1,-1
TWOMEN.txt,481289,482238,949,10,N,N,-,-1,-1
TWOMEN.txt,481414,482455,1041,10,N,N,-,-1,-1
TWOMEN.txt,481599,482489,890,10,N,N,-,-1,-1
TWOMEN.txt,481736,482490,754,10,N,N,-,-1,-1
TWOMEN.txt,481755,482554,799,10,N,N,-,-1,-1
TWOMEN.txt,481824,482773,949,10,N,N,-,-1,-1
TWOMEN.txt,481923,482846,923,10,N,N,-,-1,-1
TWOMEN.txt,481952,482938,986,10,N,N,-,-1,-1
TWOMEN.txt,481996,483027,1031,10,N,N,-,-1,-1
TWOMEN.txt,482047,483196,1149,10,N,N,-,-1,-1
TWOMEN.txt,482239,483293,1054,10,N,N,-,-1,-1
TWOMEN.txt,482457,483339,882,10,N,N,-,-1,-1
TWOMEN.txt,482489,483440,951,10,N,N,-,-1,-1
TWOMEN.txt,482490,483441,951,10,N,N,-,-1,-1
TWOMEN.txt,482555,483543,988,10,N,N,-,-1,-1
TWOMEN.txt,482774,483895,1121,10,N,N,-,-1,-1
TWOMEN.txt,482846,483918,1072,10,N,N,-,-1,-1
TWOMEN.txt,482943,483925,982,10,N,N,-,-1,-1
TWOMEN.txt,483028,484018,990,10,N,N,-,-1,-1
TWOMEN.txt,483198,484120,922,10,N,N,-,-1,-1
TWOMEN.txt,483294,484236,942,10,N,N,-,-1,-1
TWOMEN.txt,483340,484289,949,10,N,N,-,-1,-1
TWOMEN.txt,483440,484415,975,10,N,N,-,-1,-1
TWOMEN.txt,483442,484530,1088,10,N,N,-,-1,-1
TWOMEN.txt,483544,484639,1095,10,N,N,-,-1,-1
TWOMEN.txt,483898,484745,847,10,N,N,-,-1,-1
TWOMEN.txt,483920,484761,841,10,N,N,-,-1,-1
TWOMEN.txt,483927,484794,867,10,N,N,-,-1,-1
TWOMEN.txt,484019,484816,797,10,N,N,-,-1,-1
TWOMEN.txt,484121,484892,771,10,N,N,-,-1,-1
TWOMEN.txt,484237,484923,686,10,N,N,-,-1,-1
TWOMEN.txt,484289,485045,756,10,N,N,-,-1,-1
TWOMEN.txt,484416,485182,766,10,N,N,-,-1,-1
TWOMEN.txt,484531,485365,834,10,N,N,-,-1,-1
TWOMEN.txt,484640,485725,1085,10,N,N,-,-1,-1
TWOMEN.txt,484750,485759,1009,10,N,N,-,-1,-1
TWOMEN.txt,484763,485777,1014,10,N,N,-,-1,-1
TWOMEN.txt,484795,485783,988,10,N,N,-,-1,-1
TWOMEN.txt,484819,485792,973,10,N,N,-,-1,-1
TWOMEN.txt,484894,486006,1112,10,N,N,-,-1,-1
TWOMEN.txt,484924,486195,1271,10,N,N,-,-1,-1
TWOMEN.txt,485046,486258,1212,10,N,N,-,-1,-1
TWOMEN.txt,485184,486575,1391,10,N,N,-,-1,-1
TWOMEN.txt,485366,486757,1391,10,N,N,-,-1,-1
TWOMEN.txt,485728,486974,1246,10,N,N,-,-1,-1
TWOMEN.txt,485761,487159,1398,10,N,N,-,-1,-1
TWOMEN.txt,485779,487354,1575,10,N,N,-,-1,-1
TWOMEN.txt,485784,487487,1703,10,N,N,-,-1,-1
TWOMEN.txt,485794,487613,1819,10,N,N,-,-1,-1
TWOMEN.txt,486007,487928,1921,10,N,N,-,-1,-1
TWOMEN.txt,486197,487978,1781,10,N,N,-,-1,-1
TWOMEN.txt,486260,488057,1797,10,N,N,-,-1,-1
TWOMEN.txt,486577,488131,1554,10,N,N,-,-1,-1
TWOMEN.txt,486758,488249,1491,10,N,N,-,-1,-1
TWOMEN.txt,486975,488292,1317,10,N,N,-,-1,-1
TWOMEN.txt,487160,488296,1136,10,N,N,-,-1,-1
TWOMEN.txt,487355,488519,1164,10,N,N,-,-1,-1
TWOMEN.txt,487488,488667,1179,10,N,N,-,-1,-1
TWOMEN.txt,487614,488745,1131,10,N,N,-,-1,-1
TWOMEN.txt,487930,488830,900,10,N,N,-,-1,-1
TWOMEN.txt,487979,488969,990,10,N,N,-,-1,-1
TWOMEN.txt,488058,489077,1019,10,N,N,-,-1,-1
TWOMEN.txt,488132,489294,1162,10,N,N,-,-1,-1
TWOMEN.txt,488254,489325,1071,10,N,N,-,-1,-1
TWOMEN.txt,488293,489601,1308,10,N,N,-,-1,-1
TWOMEN.txt,488298,489749,1451,10,N,N,-,-1,-1
TWOMEN.txt,488519,489908,1389,10,N,N,-,-1,-1
TWOMEN.txt,488668,489945,1277,10,N,N,-,-1,-1
TWOMEN.txt,488746,489962,1216,10,N,N,-,-1,-1
TWOMEN.txt,488832,490003,1171,10,N,N,-,-1,-1
TWOMEN.txt,488970,490030,1060,10,N,N,-,-1,-1
TWOMEN.txt,489078,490052,974,10,N,N,-,-1,-1
TWOMEN.txt,489294,490170,876,10,N,N,-,-1,-1
TWOMEN.txt,489326,490280,954,10,N,N,-,-1,-1
TWOMEN.txt,489603,491219,1616,10,N,N,-,-1,-1
TWOMEN.txt,489750,491249,1499,10,N,N,-,-1,-1
TWOMEN.txt,489909,491345,1436,10,N,N,-,-1,-1
TWOMEN.txt,489947,491372,1425,10,N,N,-,-1,-1
TWOMEN.txt,489963,491456,1493,10,N,N,-,-1,-1
TWOMEN.txt,490005,491553,1548,10,N,N,-,-1,-1
TWOMEN.txt,490034,491753,1719,10,N,N,-,-1,-1
TWOMEN.txt,490057,491911,1854,10,N,N,-,-1,-1
TWOMEN.txt,490170,492056,1886,10,N,N,-,-1,-1
TWOMEN.txt,490281,492132,1851,10,N,N,-,-1,-1
TWOMEN.txt,491222,492223,1001,10,N,N,-,-1,-1
TWOMEN.txt,491251,492294,1043,10,N,N,-,-1,-1
TWOMEN.txt,491347,492352,1005,10,N,N,-,-1,-1
TWOMEN.txt,491373,492501,1128,10,N,N,-,-1,-1
TWOMEN.txt,491457,492809,1352,10,N,N,-,-1,-1
TWOMEN.txt,491554,492994,1440,10,N,N,-,-1,-1
TWOMEN.txt,491754,493222,1468,10,N,N,-,-1,-1
TWOMEN.txt,491912,493457,1545,10,N,N,-,-1,-1
TWOMEN.txt,492058,493589,1531,10,N,N,-,-1,-1
TWOMEN.txt,492133,493702,1569,10,N,N,-,-1,-1
TWOMEN.txt,492224,493830,1606,10,N,N,-,-1,-1
TWOMEN.txt,492296,493892,1596,10,N,N,-,-1,-1
TWOMEN.txt,492354,494032,1678,10,N,N,-,-1,-1
WESLEY.txt,1,3981,3980,10,N,N,-,-1,-1
WESLEY.txt,356,4549,4193,10,N,N,-,-1,-1
WESLEY.txt,461,5112,4651,10,N,N,-,-1,-1
WESLEY.txt,537,5510,4973,10,N,N,-,-1,-1
WESLEY.txt,751,5767,5016,10,N,N,-,-1,-1
WESLEY.txt,1045,6281,5236,10,N,N,-,-1,-1
WESLEY.txt,1398,6924,5526,10,N,N,-,-1,-1
WESLEY.txt,1974,7111,5137,10,N,N,-,-1,-1
WESLEY.txt,2486,7696,5210,10,N,N,-,-1,-1
WESLEY.txt,3385,8461,5076,10,N,N,-,-1,-1
WESLEY.txt,3982,9161,5179,10,N,N,-,-1,-1
WESLEY.txt,4550,9849,5299,10,N,N,-,-1,-1
WESLEY.txt,5113,10311,5198,10,N,N,-,-1,-1
WESLEY.txt,5511,10525,5014,10,N,N,-,-1,-1
WESLEY.txt,5768,11007,5239,10,N,N,-,-1,-1
WESLEY.txt,6282,11330,5048,10,N,N,-,-1,-1
WESLEY.txt,6924,11849,4925,10,N,N,-,-1,-1
WESLEY.txt,7112,12095,4983,10,N,N,-,-1,-1
WESLEY.txt,7697,12479,4782,10,N,N,-,-1,-1
WESLEY.txt,8462,13222,4760,10,N,N,-,-1,-1
WESLEY.txt,9162,14013,4851,10,N,N,-,-1,-1
WESLEY.txt,9850,14329,4479,10,N,N,-,-1,-1
WESLEY.txt,10312,14412,4100,10,N,N,-,-1,-1
WESLEY.txt,10526,14476,3950,10,N,N,-,-1,-1
WESLEY.txt,11008,14526,3518,10,N,N,-,-1,-1
WESLEY.txt,11331,14612,3281,10,N,N,-,-1,-1
WESLEY.txt,11850,14673,2823,10,N,N,-,-1,-1
WESLEY.txt,12096,14784,2688,10,N,N,-,-1,-1
WESLEY.txt,12480,14856,2376,10,N,N,-,-1,-1
WESLEY.txt,13223,14983,1760,10,N,N,-,-1,-1
WESLEY.txt,14014,15087,1073,10,N,N,-,-1,-1
WESLEY.txt,14330,15189,859,10,N,N,-,-1,-1
WESLEY.txt,14413,15262,849,10,N,N,-,-1,-1
WESLEY.txt,14477,15345,868,10,N,N,-,-1,-1
WESLEY.txt,14527,15376,849,10,N,N,-,-1,-1
WESLEY.txt,14613,15427,814,10,N,N,-,-1,-1
WESLEY.txt,14674,16083,1409,10,N,N,-,-1,-1
WESLEY.txt,14785,16173,1388,10,N,N,-,-1,-1
WESLEY.txt,14857,16375,1518,10,N,N,-,-1,-1
WESLEY.txt,14984,16630,1646,10,N,N,-,-1,-1
WESLEY.txt,15088,16895,1807,10,N,N,-,-1,-1
WESLEY.txt,15190,16988,1798,10,N,N,-,-1,-1
WESLEY.txt,15263,17140,1877,10,N,N,-,-1,-1
WESLEY.txt,15346,17223,1877,10,N,N,-,-1,-1
WESLEY.txt,15377,17384,2007,10,N,N,-,-1,-1
WESLEY.txt,15428,17593,2165,10,N,N,-,-1,-1
WESLEY.txt,16084,17641,1557,10,N,N,-,-1,-1
WESLEY.txt,16174,17811,1637,10,N,N,-,-1,-1
WESLEY.txt,16376,17913,1537,10,N,N,-,-1,-1
WESLEY.txt,16631,18103,1472,10,N,N,-,-1,-1
WESLEY.txt,16896,18249,1353,10,N,N,-,-1,-1
WESLEY.txt,16989,18301,1312,10,N,N,-,-1,-1
WESLEY.txt,17141,18680,1539,10,N,N,-,-1,-1
WESLEY.txt,17224,18839,1615,10,N,N,-,-1,-1
WESLEY.txt,17385,18914,1529,10,N,N,-,-1,-1
WESLEY.txt,17594,18979,1385,10,N,N,-,-1,-1
WESLEY.txt,17643,19239,1596,10,N,N,-,-1,-1
WESLEY.txt,17812,19341,1529,10,N,N,-,-1,-1
WESLEY.txt,17914,19407,1493,10,N,N,-,-1,-1
WESLEY.txt,18104,19467,1363,10,N,N,-,-1,-1
WESLEY.txt,18250,19695,1445,10,N,N,-,-1,-1
WESLEY.txt,18302,19816,1514,10,N,N,-,-1,-1
WESLEY.txt,18681,19921,1240,10,N,N,-,-1,-1
WESLEY.txt,18840,20065,1225,10,N,N,-,-1,-1
WESLEY.txt,18915,20201,1286,10,N,N,-,-1,-1
WESLEY.txt,18980,20243,1263,10,N,N,-,-1,-1
WESLEY.txt,19240,20370,1130,10,N,N,-,-1,-1
WESLEY.txt,19342,20483,1141,10,N,N,-,-1,-1
WESLEY.txt,19409,20550,1141,10,N,N,-,-1,-1
WESLEY.txt,19468,20581,1113,10,N,N,-,-1,-1
WESLEY.txt,19696,20832,1136,10,N,N,-,-1,-1
WESLEY.txt,19817,20991,1174,10,N,N,-,-1,-1
WESLEY.txt,19922,21147,1225,10,N,N,-,-1,-1
WESLEY.txt,20066,21226,1160,10,N,N,-,-1,-1
WESLEY.txt,20203,21291,1088,10,N,N,-,-1,-1
WESLEY.txt,20244,21355,1111,10,N,N,-,-1,-1
WESLEY.txt,20371,21422,1051,10,N,N,-,-1,-1
WESLEY.txt,20484,21566,1082,10,N,N,-,-1,-1
WESLEY.txt,20551,21749,1198,10,N,N,-,-1,-1
WESLEY.txt,20582,21893,1311,10,N,N,-,-1,-1
WESLEY.txt,20833,22037,1204,10,N,N,-,-1,-1
WESLEY.txt,20992,22213,1221,10,N,N,-,-1,-1
WESLEY.txt,21149,22335,1186,10,N,N,-,-1,-1
WESLEY.txt,21227,22433,1206,10,N,N,-,-1,-1
WESLEY.txt,21292,22482,1190,10,N,N,-,-1,-1
WESLEY.txt,21356,22537,1181,10,N,N,-,-1,-1
WESLEY.txt,21423,22620,1197,10,N,N,-,-1,-1
WESLEY.txt,21567,22670,1103,10,N,N,-,-1,-1
WESLEY.txt,21751,22809,1058,10,N,N,-,-1,-1
WESLEY.txt,21894,22919,1025,10,N,N,-,-1,-1
WESLEY.txt,22038,23027,989,10,N,N,-,-1,-1
WESLEY.txt,22214,23088,874,10,N,N,-,-1,-1
WESLEY.txt,22336,23269,933,10,N,N,-,-1,-1
WESLEY.txt,22434,23412,978,10,N,N,-,-1,-1
WESLEY.txt,22483,23636,1153,10,N,N,-,-1,-1
WESLEY.txt,22538,23730,1192,10,N,N,-,-1,-1
WESLEY.txt,22621,23981,1360,10,N,N,-,-1,-1
WESLEY.txt,22671,24279,1608,10,N,N,-,-1,-1
WESLEY.txt,22810,24353,1543,10,N,N,-,-1,-1
WESLEY.txt,22920,24424,1504,10,N,N,-,-1,-1
WESLEY.txt,23028,24691,1663,10,N,N,-,-1,-1
WESLEY.txt,23089,24811,1722,10,N,N,-,-1,-1
WESLEY.txt,23270,25142,1872,10,N,N,-,-1,-1
WESLEY.txt,23413,25581,2168,10,N,N,-,-1,-1
WESLEY.txt,23637,25685,2048,10,N,N,-,-1,-1
WESLEY.txt,23731,25858,2127,10,N,N,-,-1,-1
WESLEY.txt,23982,26213,2231,10,N,N,-,-1,-1
WESLEY.txt,24280,26357,2077,10,N,N,-,-1,-1
WESLEY.txt,24354,26399,2045,10,N,N,-,-1,-1
WESLEY.txt,24424,26462,2038,10,N,N,-,-1,-1
WESLEY.txt,24692,26608,1916,10,N,N,-,-1,-1
WESLEY.txt,24812,26729,1917,10,N,N,-,-1,-1
WESLEY.txt,25143,26868,1725,10,N,N,-,-1,-1
WESLEY.txt,25582,27088,1506,10,N,N,-,-1,-1
WESLEY.txt,25686,27431,1745,10,N,N,-,-1,-1
WESLEY.txt,25859,27796,1937,10,N,N,-,-1,-1
WESLEY.txt,26214,27851,1637,10,N,N,-,-1,-1
WESLEY.txt,26358,27883,1525,10,N,N,-,-1,-1
WESLEY.txt,26400,27934,1534,10,N,N,-,-1,-1
WESLEY.txt,26463,28013,1550,10,N,N,-,-1,-1
WESLEY.txt,26609,28627,2018,10,N,N,-,-1,-1
WESLEY.txt,26731,28831,2100,10,N,N,-,-1,-1
WESLEY.txt,26869,28890,2021,10,N,N,-,-1,-1
WESLEY.txt,27089,28962,1873,10,N,N,-,-1,-1
WESLEY.txt,27432,29040,1608,10,N,N,-,-1,-1
WESLEY.txt,27797,29124,1327,10,N,N,-,-1,-1
WESLEY.txt,27852,29186,1334,10,N,N,-,-1,-1
WESLEY.txt,27884,29273,1389,10,N,N,-,-1,-1
WESLEY.txt,27936,29401,1465,10,N,N,-,-1,-1
WESLEY.txt,28014,29534,1520,10,N,N,-,-1,-1
WESLEY.txt,28628,29636,1008,10,N,N,-,-1,-1
WESLEY.txt,28832,29677,845,10,N,N,-,-1,-1
WESLEY.txt,28891,29874,983,10,N,N,-,-1,-1
WESLEY.txt,28963,30000,1037,10,N,N,-,-1,-1
WESLEY.txt,29041,30167,1126,10,N,N,-,-1,-1
WESLEY.txt,29125,30463,1338,10,N,N,-,-1,-1
WESLEY.txt,29188,30652,1464,10,N,N,-,-1,-1
WESLEY.txt,29274,30714,1440,10,N,N,-,-1,-1
WESLEY.txt,29402,30828,1426,10,N,N,-,-1,-1
WESLEY.txt,29536,30847,1311,10,N,N,-,-1,-1
WESLEY.txt,29637,30892,1255,10,N,N,-,-1,-1
WESLEY.txt,29678,30913,1235,10,N,N,-,-1,-1
WESLEY.txt,29875,31128,1253,10,N,N,-,-1,-1
WESLEY.txt,30001,31224,1223,10,N,N,-,-1,-1
WESLEY.txt,30168,31394,1226,10,N,N,-,-1,-1
WESLEY.txt,30464,31617,1153,10,N,N,-,-1,-1
WESLEY.txt,30653,31642,989,10,N,N,-,-1,-1
WESLEY.txt,30715,31723,1008,10,N,N,-,-1,-1
WESLEY.txt,30829,31929,1100,10,N,N,-,-1,-1
WESLEY.txt,30848,32049,1201,10,N,N,-,-1,-1
WESLEY.txt,30893,32192,1299,10,N,N,-,-1,-1
WESLEY.txt,30914,32207,1293,10,N,N,-,-1,-1
WESLEY.txt,31129,32294,1165,10,N,N,-,-1,-1
WESLEY.txt,31226,32512,1286,10,N,N,-,-1,-1
WESLEY.txt,31395,32563,1168,10,N,N,-,-1,-1
WESLEY.txt,31618,32697,1079,10,N,N,-,-1,-1
WESLEY.txt,31643,32782,1139,10,N,N,-,-1,-1
WESLEY.txt,31724,32901,1177,10,N,N,-,-1,-1
WESLEY.txt,31930,33295,1365,10,N,N,-,-1,-1
WESLEY.txt,32050,33433,1383,10,N,N,-,-1,-1
WESLEY.txt,32193,33516,1323,10,N,N,-,-1,-1
WESLEY.txt,32208,33710,1502,10,N,N,-,-1,-1
WESLEY.txt,32295,33780,1485,10,N,N,-,-1,-1
WESLEY.txt,32513,33989,1476,10,N,N,-,-1,-1
WESLEY.txt,32564,34140,1576,10,N,N,-,-1,-1
WESLEY.txt,32698,34436,1738,10,N,N,-,-1,-1
WESLEY.txt,32783,34736,1953,10,N,N,-,-1,-1
WESLEY.txt,32903,34949,2046,10,N,N,-,-1,-1
WESLEY.txt,33296,35047,1751,10,N,N,-,-1,-1
WESLEY.txt,33434,35119,1685,10,N,N,-,-1,-1
WESLEY.txt,33517,35212,1695,10,N,N,-,-1,-1
WESLEY.txt,33711,35468,1757,10,N,N,-,-1,-1
WESLEY.txt,33781,35505,1724,10,N,N,-,-1,-1
WESLEY.txt,33990,35554,1564,10,N,N,-,-1,-1
WESLEY.txt,34141,35601,1460,10,N,N,-,-1,-1
WESLEY.txt,34437,35679,1242,10,N,N,-,-1,-1
WESLEY.txt,34737,35719,982,10,N,N,-,-1,-1
WESLEY.txt,34950,35766,816,10,N,N,-,-1,-1
WESLEY.txt,35048,35981,933,10,N,N,-,-1,-1
WESLEY.txt,35120,36038,918,10,N,N,-,-1,-1
WESLEY.txt,35213,36269,1056,10,N,N,-,-1,-1
WESLEY.txt,35469,36567,1098,10,N,N,-,-1,-1
WESLEY.txt,35506,36708,1202,10,N,N,-,-1,-1
WESLEY.txt,35555,36941,1386,10,N,N,-,-1,-1
WESLEY.txt,35602,37191,1589,10,N,N,-,-1,-1
WESLEY.txt,35680,37279,1599,10,N,N,-,-1,-1
WESLEY.txt,35720,37334,1614,10,N,N,-,-1,-1
WESLEY.txt,35767,37487,1720,10,N,N,-,-1,-1
WESLEY.txt,35982,37585,1603,10,N,N,-,-1,-1
WESLEY.txt,36039,37615,1576,10,N,N,-,-1,-1
WESLEY.txt,36270,37810,1540,10,N,N,-,-1,-1
WESLEY.txt,36568,37924,1356,10,N,N,-,-1,-1
WESLEY.txt,36709,38037,1328,10,N,N,-,-1,-1
WESLEY.txt,36942,38053,1111,10,N,N,-,-1,-1
WESLEY.txt,37192,38080,888,10,N,N,-,-1,-1
WESLEY.txt,37280,38241,961,10,N,N,-,-1,-1
WESLEY.txt,37335,38389,1054,10,N,N,-,-1,-1
WESLEY.txt,37488,38511,1023,10,N,N,-,-1,-1
WESLEY.txt,37586,38532,946,10,N,N,-,-1,-1
WESLEY.txt,37616,38625,1009,10,N,N,-,-1,-1
WESLEY.txt,37811,38778,967,10,N,N,-,-1,-1
WESLEY.txt,37925,38975,1050,10,N,N,-,-1,-1
WESLEY.txt,38038,39124,1086,10,N,N,-,-1,-1
WESLEY.txt,38054,39218,1164,10,N,N,-,-1,-1
WESLEY.txt,38081,39411,1330,10,N,N,-,-1,-1
WESLEY.txt,38242,39452,1210,10,N,N,-,-1,-1
WESLEY.txt,38390,39521,1131,10,N,N,-,-1,-1
WESLEY.txt,38512,39682,1170,10,N,N,-,-1,-1
WESLEY.txt,38533,40144,1611,10,N,N,-,-1,-1
WESLEY.txt,38626,40325,1699,10,N,N,-,-1,-1
WESLEY.txt,38779,40591,1812,10,N,N,-,-1,-1
WESLEY.txt,38976,40679,1703,10,N,N,-,-1,-1
WESLEY.txt,39125,40774,1649,10,N,N,-,-1,-1
WESLEY.txt,39219,40825,1606,10,N,N,-,-1,-1
WESLEY.txt,39413,40975,1562,10,N,N,-,-1,-1
WESLEY.txt,39453,41030,1577,10,N,N,-,-1,-1
WESLEY.txt,39522,41080,1558,10,N,N,-,-1,-1
WESLEY.txt,39683,41484,1801,10,N,N,-,-1,-1
WESLEY.txt,40145,41579,1434,10,N,N,-,-1,-1
WESLEY.txt,40326,41636,1310,10,N,N,-,-1,-1
WESLEY.txt,40592,41696,1104,10,N,N,-,-1,-1
WESLEY.txt,40680,41838,1158,10,N,N,-,-1,-1
WESLEY.txt,40775,41928,1153,10,N,N,-,-1,-1
WESLEY.txt,40826,42041,1215,10,N,N,-,-1,-1
WESLEY.txt,40976,42083,1107,10,N,N,-,-1,-1
WESLEY.txt,41031,42163,1132,10,N,N,-,-1,-1
WESLEY.txt,41081,42705,1624,10,N,N,-,-1,-1
WESLEY.txt,41485,42754,1269,10,N,N,-,-1,-1
WESLEY.txt,41580,42810,1230,10,N,N,-,-1,-1
WESLEY.txt,41637,42855,1218,10,N,N,-,-1,-1
WESLEY.txt,41697,42938,1241,10,N,N,-,-1,-1
WESLEY.txt,41839,42987,1148,10,N,N,-,-1,-1
WESLEY.txt,41929,43354,1425,10,N,N,-,-1,-1
WESLEY.txt,42042,43485,1443,10,N,N,-,-1,-1
WESLEY.txt,42084,43544,1460,10,N,N,-,-1,-1
WESLEY.txt,42164,43626,1462,10,N,N,-,-1,-1
WESLEY.txt,42706,43731,1025,10,N,N,-,-1,-1
WESLEY.txt,42756,43837,1081,10,N,N,-,-1,-1
WESLEY.txt,42811,43966,1155,10,N,N,-,-1,-1
WESLEY.txt,42856,44075,1219,10,N,N,-,-1,-1
WESLEY.txt,42939,44248,1309,10,N,N,-,-1,-1
WESLEY.txt,42988,44322,1334,10,N,N,-,-1,-1
WESLEY.txt,43371,44407,1036,10,N,N,-,-1,-1
WESLEY.txt,43486,44499,1013,10,N,N,-,-1,-1
WESLEY.txt,43545,44571,1026,10,N,N,-,-1,-1
WESLEY.txt,43626,44718,1092,10,N,N,-,-1,-1
WESLEY.txt,43732,44867,1135,10,N,N,-,-1,-1
WESLEY.txt,43838,44951,1113,10,N,N,-,-1,-1
WESLEY.txt,43967,45013,1046,10,N,N,-,-1,-1
WESLEY.txt,44076,45115,1039,10,N,N,-,-1,-1
WESLEY.txt,44249,45312,1063,10,N,N,-,-1,-1
WESLEY.txt,44323,45378,1055,10,N,N,-,-1,-1
WESLEY.txt,44408,45555,1147,10,N,N,-,-1,-1
WESLEY.txt,44499,45727,1228,10,N,N,-,-1,-1
WESLEY.txt,44572,45946,1374,10,N,N,-,-1,-1
WESLEY.txt,44719,46015,1296,10,N,N,-,-1,-1
WESLEY.txt,44868,46086,1218,10,N,N,-,-1,-1
WESLEY.txt,44952,46256,1304,10,N,N,-,-1,-1
WESLEY.txt,45014,46410,1396,10,N,N,-,-1,-1
WESLEY.txt,45116,46503,1387,10,N,N,-,-1,-1
WESLEY.txt,45314,46761,1447,10,N,N,-,-1,-1
WESLEY.txt,45379,46824,1445,10,N,N,-,-1,-1
WESLEY.txt,45556,46961,1405,10,N,N,-,-1,-1
WESLEY.txt,45728,47055,1327,10,N,N,-,-1,-1
WESLEY.txt,45947,47145,1198,10,N,N,-,-1,-1
WESLEY.txt,46017,47192,1175,10,N,N,-,-1,-1
WESLEY.txt,46087,47412,1325,10,N,N,-,-1,-1
WESLEY.txt,46256,47583,1327,10,N,N,-,-1,-1
WESLEY.txt,46411,47700,1289,10,N,N,-,-1,-1
WESLEY.txt,46505,47780,1275,10,N,N,-,-1,-1
WESLEY.txt,46762,47975,1213,10,N,N,-,-1,-1
WESLEY.txt,46825,48096,1271,10,N,N,-,-1,-1
WESLEY.txt,46962,48168,1206,10,N,N,-,-1,-1
WESLEY.txt,47056,48266,1210,10,N,N,-,-1,-1
WESLEY.txt,47146,48382,1236,10,N,N,-,-1,-1
WESLEY.txt,47193,48449,1256,10,N,N,-,-1,-1
WESLEY.txt,47414,48647,1233,10,N,N,-,-1,-1
WESLEY.txt,47584,48713,1129,10,N,N,-,-1,-1
WESLEY.txt,47702,48915,1213,10,N,N,-,-1,-1
WESLEY.txt,47781,48990,1209,10,N,N,-,-1,-1
WESLEY.txt,47976,49191,1215,10,N,N,-,-1,-1
WESLEY.txt,48097,49247,1150,10,N,N,-,-1,-1
WESLEY.txt,48169,49321,1152,10,N,N,-,-1,-1
WESLEY.txt,48267,49415,1148,10,N,N,-,-1,-1
WESLEY.txt,48383,49528,1145,10,N,N,-,-1,-1
WESLEY.txt,48450,49655,1205,10,N,N,-,-1,-1
WESLEY.txt,48648,50164,1516,10,N,N,-,-1,-1
WESLEY.txt,48714,50289,1575,10,N,N,-,-1,-1
WESLEY.txt,48916,50340,1424,10,N,N,-,-1,-1
WESLEY.txt,48991,50523,1532,10,N,N,-,-1,-1
WESLEY.txt,49192,50588,1396,10,N,N,-,-1,-1
WESLEY.txt,49248,50710,1462,10,N,N,-,-1,-1
WESLEY.txt,49322,50937,1615,10,N,N,-,-1,-1
WESLEY.txt,49416,51041,1625,10,N,N,-,-1,-1
WESLEY.txt,49529,51136,1607,10,N,N,-,-1,-1
WESLEY.txt,49656,51242,1586,10,N,N,-,-1,-1
WESLEY.txt,50165,51406,1241,10,N,N,-,-1,-1
WESLEY.txt,50290,51549,1259,10,N,N,-,-1,-1
WESLEY.txt,50341,51787,1446,10,N,N,-,-1,-1
WESLEY.txt,50524,51873,1349,10,N,N,-,-1,-1
WESLEY.txt,50589,51967,1378,10,N,N,-,-1,-1
WESLEY.txt,50711,52059,1348,10,N,N,-,-1,-1
WESLEY.txt,50938,52194,1256,10,N,N,-,-1,-1
WESLEY.txt,51042,52225,1183,10,N,N,-,-1,-1
WESLEY.txt,51137,52288,1151,10,N,N,-,-1,-1
WESLEY.txt,51243,52459,1216,10,N,N,-,-1,-1
WESLEY.txt,51407,52557,1150,10,N,N,-,-1,-1
WESLEY.txt,51550,52683,1133,10,N,N,-,-1,-1
WESLEY.txt,51788,52735,947,10,N,N,-,-1,-1
WESLEY.txt,51874,52877,1003,10,N,N,-,-1,-1
WESLEY.txt,51968,52903,935,10,N,N,-,-1,-1
WESLEY.txt,52060,52952,892,10,N,N,-,-1,-1
WESLEY.txt,52195,53065,870,10,N,N,-,-1,-1
WESLEY.txt,52226,53138,912,10,N,N,-,-1,-1
WESLEY.txt,52289,53305,1016,10,N,N,-,-1,-1
WESLEY.txt,52460,53364,904,10,N,N,-,-1,-1
WESLEY.txt,52558,53436,878,10,N,N,-,-1,-1
WESLEY.txt,52684,53474,790,10,N,N,-,-1,-1
WESLEY.txt,52736,53552,816,10,N,N,-,-1,-1
WESLEY.txt,52878,53712,834,10,N,N,-,-1,-1
WESLEY.txt,52904,53824,920,10,N,N,-,-1,-1
WESLEY.txt,52953,53925,972,10,N,N,-,-1,-1
WESLEY.txt,53066,54105,1039,10,N,N,-,-1,-1
WESLEY.txt,53139,54308,1169,10,N,N,-,-1,-1
WESLEY.txt,53306,54425,1119,10,N,N,-,-1,-1
WESLEY.txt,53365,54590,1225,10,N,N,-,-1,-1
WESLEY.txt,53437,54728,1291,10,N,N,-,-1,-1
WESLEY.txt,53475,54892,1417,10,N,N,-,-1,-1
WESLEY.txt,53591,54989,1398,10,N,N,-,-1,-1
WESLEY.txt,53713,55155,1442,10,N,N,-,-1,-1
WESLEY.txt,53825,55157,1332,10,N,N,-,-1,-1
WESLEY.txt,53926,55513,1587,10,N,N,-,-1,-1
WESLEY.txt,54106,55609,1503,10,N,N,-,-1,-1
WESLEY.txt,54309,55767,1458,10,N,N,-,-1,-1
WESLEY.txt,54426,55930,1504,10,N,N,-,-1,-1
WESLEY.txt,54591,56031,1440,10,N,N,-,-1,-1
WESLEY.txt,54729,56103,1374,10,N,N,-,-1,-1
WESLEY.txt,54893,56271,1378,10,N,N,-,-1,-1
WESLEY.txt,54990,56354,1364,10,N,N,-,-1,-1
WESLEY.txt,55155,56561,1406,10,N,N,-,-1,-1
WESLEY.txt,55158,56800,1642,10,N,N,-,-1,-1
WESLEY.txt,55514,56918,1404,10,N,N,-,-1,-1
WESLEY.txt,55610,57017,1407,10,N,N,-,-1,-1
WESLEY.txt,55768,57278,1510,10,N,N,-,-1,-1
WESLEY.txt,55931,57360,1429,10,N,N,-,-1,-1
WESLEY.txt,56032,57385,1353,10,N,N,-,-1,-1
WESLEY.txt,56104,57433,1329,10,N,N,-,-1,-1
WESLEY.txt,56272,57666,1394,10,N,N,-,-1,-1
WESLEY.txt,56355,57800,1445,10,N,N,-,-1,-1
WESLEY.txt,56561,58085,1524,10,N,N,-,-1,-1
WESLEY.txt,56801,58189,1388,10,N,N,-,-1,-1
WESLEY.txt,56919,58404,1485,10,N,N,-,-1,-1
WESLEY.txt,57018,58620,1602,10,N,N,-,-1,-1
WESLEY.txt,57279,58956,1677,10,N,N,-,-1,-1
WESLEY.txt,57361,59417,2056,10,N,N,-,-1,-1
WESLEY.txt,57386,59563,2177,10,N,N,-,-1,-1
WESLEY.txt,57434,59758,2324,10,N,N,-,-1,-1
WESLEY.txt,57667,60125,2458,10,N,N,-,-1,-1
WESLEY.txt,57802,60164,2362,10,N,N,-,-1,-1
WESLEY.txt,58086,60547,2461,10,N,N,-,-1,-1
WESLEY.txt,58190,60689,2499,10,N,N,-,-1,-1
WESLEY.txt,58405,60710,2305,10,N,N,-,-1,-1
WESLEY.txt,58621,60949,2328,10,N,N,-,-1,-1
WESLEY.txt,58957,61181,2224,10,N,N,-,-1,-1
WESLEY.txt,59418,61267,1849,10,N,N,-,-1,-1
WESLEY.txt,59564,61279,1715,10,N,N,-,-1,-1
WESLEY.txt,59759,61381,1622,10,N,N,-,-1,-1
WESLEY.txt,60126,61468,1342,10,N,N,-,-1,-1
WESLEY.txt,60165,61569,1404,10,N,N,-,-1,-1
WESLEY.txt,60548,61581,1033,10,N,N,-,-1,-1
WESLEY.txt,60690,61808,1118,10,N,N,-,-1,-1
WESLEY.txt,60710,61821,1111,10,N,N,-,-1,-1
WESLEY.txt,60950,61847,897,10,N,N,-,-1,-1
WESLEY.txt,61182,61921,739,10,N,N,-,-1,-1
WESLEY.txt,61268,61988,720,10,N,N,-,-1,-1
WESLEY.txt,61279,62061,782,10,N,N,-,-1,-1
WESLEY.txt,61382,62098,716,10,N,N,-,-1,-1
WESLEY.txt,61469,62200,731,10,N,N,-,-1,-1
WESLEY.txt,61570,62361,791,10,N,N,-,-1,-1
WESLEY.txt,61581,62386,805,10,N,N,-,-1,-1
WESLEY.txt,61809,62420,611,10,N,N,-,-1,-1
WESLEY.txt,61821,62492,671,10,N,N,-,-1,-1
WESLEY.txt,61848,62558,710,10,N,N,-,-1,-1
WESLEY.txt,61923,62694,771,10,N,N,-,-1,-1
WESLEY.txt,61990,62714,724,10,N,N,-,-1,-1
WESLEY.txt,62062,62928,866,10,N,N,-,-1,-1
WESLEY.txt,62099,63113,1014,10,N,N,-,-1,-1
WESLEY.txt,62201,63160,959,10,N,N,-,-1,-1
WESLEY.txt,62362,63333,971,10,N,N,-,-1,-1
WESLEY.txt,62387,63471,1084,10,N,N,-,-1,-1
WESLEY.txt,62421,63529,1108,10,N,N,-,-1,-1
WESLEY.txt,62493,63686,1193,10,N,N,-,-1,-1
WESLEY.txt,62559,63698,1139,10,N,N,-,-1,-1
WESLEY.txt,62695,63726,1031,10,N,N,-,-1,-1
WESLEY.txt,62715,63775,1060,10,N,N,-,-1,-1
WESLEY.txt,62929,63809,880,10,N,N,-,-1,-1
WESLEY.txt,63114,63953,839,10,N,N,-,-1,-1
WESLEY.txt,63161,63975,814,10,N,N,-,-1,-1
WESLEY.txt,63334,64040,706,10,N,N,-,-1,-1
WESLEY.txt,63472,64119,647,10,N,N,-,-1,-1
WESLEY.txt,63530,64185,655,10,N,N,-,-1,-1
WESLEY.txt,63687,64197,510,10,N,N,-,-1,-1
WESLEY.txt,63698,64334,636,10,N,N,-,-1,-1
WESLEY.txt,63727,64358,631,10,N,N,-,-1,-1
WESLEY.txt,63776,64421,645,10,N,N,-,-1,-1
WESLEY.txt,63810,64693,883,10,N,N,-,-1,-1
WESLEY.txt,63954,64699,745,10,N,N,-,-1,-1
WESLEY.txt,63975,64721,746,10,N,N,-,-1,-1
WESLEY.txt,64041,64871,830,10,N,N,-,-1,-1
WESLEY.txt,64120,64980,860,10,N,N,-,-1,-1
WESLEY.txt,64186,64994,808,10,N,N,-,-1,-1
WESLEY.txt,64197,65048,851,10,N,N,-,-1,-1
WESLEY.txt,64335,65102,767,10,N,N,-,-1,-1
WESLEY.txt,64358,65139,781,10,N,N,-,-1,-1
WESLEY.txt,64422,65345,923,10,N,N,-,-1,-1
WESLEY.txt,64694,65516,822,10,N,N,-,-1,-1
WESLEY.txt,64700,65643,943,10,N,N,-,-1,-1
WESLEY.txt,64721,65729,1008,10,N,N,-,-1,-1
WESLEY.txt,64873,65736,863,10,N,N,-,-1,-1
WESLEY.txt,64981,65791,810,10,N,N,-,-1,-1
WESLEY.txt,64994,65827,833,10,N,N,-,-1,-1
WESLEY.txt,65049,65903,854,10,N,N,-,-1,-1
WESLEY.txt,65103,65971,868,10,N,N,-,-1,-1
WESLEY.txt,65140,66001,861,10,N,N,-,-1,-1
WESLEY.txt,65346,66183,837,10,N,N,-,-1,-1
WESLEY.txt,65517,66329,812,10,N,N,-,-1,-1
WESLEY.txt,65644,66378,734,10,N,N,-,-1,-1
WESLEY.txt,65730,66411,681,10,N,N,-,-1,-1
WESLEY.txt,65737,66423,686,10,N,N,-,-1,-1
WESLEY.txt,65791,66454,663,10,N,N,-,-1,-1
WESLEY.txt,65828,66495,667,10,N,N,-,-1,-1
WESLEY.txt,65904,66527,623,10,N,N,-,-1,-1
WESLEY.txt,65972,66595,623,10,N,N,-,-1,-1
WESLEY.txt,66002,66897,895,10,N,N,-,-1,-1
WESLEY.txt,66184,66989,805,10,N,N,-,-1,-1
WESLEY.txt,66330,67108,778,10,N,N,-,-1,-1
WESLEY.txt,66379,67250,871,10,N,N,-,-1,-1
WESLEY.txt,66412,67458,1046,10,N,N,-,-1,-1
WESLEY.txt,66423,67504,1081,10,N,N,-,-1,-1
WESLEY.txt,66455,67532,1077,10,N,N,-,-1,-1
WESLEY.txt,66496,67586,1090,10,N,N,-,-1,-1
WESLEY.txt,66528,67618,1090,10,N,N,-,-1,-1
WESLEY.txt,66596,67674,1078,10,N,N,-,-1,-1
WESLEY.txt,66899,67746,847,10,N,N,-,-1,-1
WESLEY.txt,66990,67758,768,10,N,N,-,-1,-1
WESLEY.txt,67109,67836,727,10,N,N,-,-1,-1
WESLEY.txt,67251,67915,664,10,N,N,-,-1,-1
WESLEY.txt,67459,68000,541,10,N,N,-,-1,-1
WESLEY.txt,67505,68020,515,10,N,N,-,-1,-1
WESLEY.txt,67533,68095,562,10,N,N,-,-1,-1
WESLEY.txt,67587,68186,599,10,N,N,-,-1,-1
WESLEY.txt,67619,68268,649,10,N,N,-,-1,-1
WESLEY.txt,67675,68292,617,10,N,N,-,-1,-1
WESLEY.txt,67747,68305,558,10,N,N,-,-1,-1
WESLEY.txt,67758,68394,636,10,N,N,-,-1,-1
WESLEY.txt,67837,68573,736,10,N,N,-,-1,-1
WESLEY.txt,67916,68665,749,10,N,N,-,-1,-1
WESLEY.txt,68001,68731,730,10,N,N,-,-1,-1
WESLEY.txt,68020,68786,766,10,N,N,-,-1,-1
WESLEY.txt,68096,68869,773,10,N,N,-,-1,-1
WESLEY.txt,68187,68901,714,10,N,N,-,-1,-1
WESLEY.txt,68269,68997,728,10,N,N,-,-1,-1
WESLEY.txt,68293,69010,717,10,N,N,-,-1,-1
WESLEY.txt,68305,69105,800,10,N,N,-,-1,-1
WESLEY.txt,68395,69192,797,10,N,N,-,-1,-1
WESLEY.txt,68574,69257,683,10,N,N,-,-1,-1
WESLEY.txt,68665,69295,630,10,N,N,-,-1,-1
WESLEY.txt,68732,69378,646,10,N,N,-,-1,-1
WESLEY.txt,68787,69424,637,10,N,N,-,-1,-1
WESLEY.txt,68870,69478,608,10,N,N,-,-1,-1
WESLEY.txt,68902,69538,636,10,N,N,-,-1,-1
WESLEY.txt,68998,69595,597,10,N,N,-,-1,-1
WESLEY.txt,69010,69640,630,10,N,N,-,-1,-1
WESLEY.txt,69106,69679,573,10,N,N,-,-1,-1
WESLEY.txt,69193,69695,502,10,N,N,-,-1,-1
WESLEY.txt,69258,69728,470,10,N,N,-,-1,-1
WESLEY.txt,69296,69742,446,10,N,N,-,-1,-1
WESLEY.txt,69379,69880,501,10,N,N,-,-1,-1
WESLEY.txt,69425,70033,608,10,N,N,-,-1,-1
WESLEY.txt,69479,70181,702,10,N,N,-,-1,-1
WESLEY.txt,69540,70209,669,10,N,N,-,-1,-1
WESLEY.txt,69596,70290,694,10,N,N,-,-1,-1
WESLEY.txt,69641,70405,764,10,N,N,-,-1,-1
WESLEY.txt,69680,70496,816,10,N,N,-,-1,-1
WESLEY.txt,69696,70584,888,10,N,N,-,-1,-1
WESLEY.txt,69729,70651,922,10,N,N,-,-1,-1
WESLEY.txt,69742,70669,927,10,N,N,-,-1,-1
WESLEY.txt,69881,70683,802,10,N,N,-,-1,-1
WESLEY.txt,70034,70797,763,10,N,N,-,-1,-1
WESLEY.txt,70182,70901,719,10,N,N,-,-1,-1
WESLEY.txt,70210,71025,815,10,N,N,-,-1,-1
WESLEY.txt,70291,71184,893,10,N,N,-,-1,-1
WESLEY.txt,70406,71427,1021,10,N,N,-,-1,-1
WESLEY.txt,70497,72112,1615,10,N,N,-,-1,-1
WESLEY.txt,70586,72310,1724,10,N,N,-,-1,-1
WESLEY.txt,70652,72322,1670,10,N,N,-,-1,-1
WESLEY.txt,70670,72390,1720,10,N,N,-,-1,-1
WESLEY.txt,70683,72489,1806,10,N,N,-,-1,-1
WESLEY.txt,70798,72502,1704,10,N,N,-,-1,-1
WESLEY.txt,70901,72584,1683,10,N,N,-,-1,-1
WESLEY.txt,71026,72709,1683,10,N,N,-,-1,-1
WESLEY.txt,71186,72829,1643,10,N,N,-,-1,-1
WESLEY.txt,71428,72935,1507,10,N,N,-,-1,-1
WESLEY.txt,72113,73033,920,10,N,N,-,-1,-1
WESLEY.txt,72311,73145,834,10,N,N,-,-1,-1
WESLEY.txt,72322,73261,939,10,N,N,-,-1,-1
WESLEY.txt,72391,73385,994,10,N,N,-,-1,-1
WESLEY.txt,72490,73582,1092,10,N,N,-,-1,-1
WESLEY.txt,72502,73596,1094,10,N,N,-,-1,-1
WESLEY.txt,72585,73749,1164,10,N,N,-,-1,-1
WESLEY.txt,72710,74225,1515,10,N,N,-,-1,-1
WESLEY.txt,72830,74241,1411,10,N,N,-,-1,-1
WESLEY.txt,72935,74428,1493,10,N,N,-,-1,-1
WESLEY.txt,73034,74447,1413,10,N,N,-,-1,-1
WESLEY.txt,73146,74637,1491,10,N,N,-,-1,-1
WESLEY.txt,73262,74650,1388,10,N,N,-,-1,-1
WESLEY.txt,73386,74727,1341,10,N,N,-,-1,-1
WESLEY.txt,73583,74764,1181,10,N,N,-,-1,-1
WESLEY.txt,73596,74927,1331,10,N,N,-,-1,-1
WESLEY.txt,73750,74969,1219,10,N,N,-,-1,-1
WESLEY.txt,74226,75028,802,10,N,N,-,-1,-1
WESLEY.txt,74241,75072,831,10,N,N,-,-1,-1
WESLEY.txt,74429,75109,680,10,N,N,-,-1,-1
WESLEY.txt,74447,75219,772,10,N,N,-,-1,-1
WESLEY.txt,74638,75295,657,10,N,N,-,-1,-1
WESLEY.txt,74650,75366,716,10,N,N,-,-1,-1
WESLEY.txt,74728,75405,677,10,N,N,-,-1,-1
WESLEY.txt,74765,75479,714,10,N,N,-,-1,-1
WESLEY.txt,74928,75560,632,10,N,N,-,-1,-1
WESLEY.txt,74970,75705,735,10,N,N,-,-1,-1
WESLEY.txt,75029,75919,890,10,N,N,-,-1,-1
WESLEY.txt,75073,76029,956,10,N,N,-,-1,-1
WESLEY.txt,75110,76047,937,10,N,N,-,-1,-1
WESLEY.txt,75220,76158,938,10,N,N,-,-1,-1
WESLEY.txt,75297,76237,940,10,N,N,-,-1,-1
WESLEY.txt,75367,76291,924,10,N,N,-,-1,-1
WESLEY.txt,75406,76308,902,10,N,N,-,-1,-1
WESLEY.txt,75479,76328,849,10,N,N,-,-1,-1
WESLEY.txt,75560,76353,793,10,N,N,-,-1,-1
WESLEY.txt,75706,76424,718,10,N,N,-,-1,-1
WESLEY.txt,75920,76459,539,10,N,N,-,-1,-1
WESLEY.txt,76030,76602,572,10,N,N,-,-1,-1
WESLEY.txt,76047,76772,725,10,N,N,-,-1,-1
WESLEY.txt,76159,76802,643,10,N,N,-,-1,-1
WESLEY.txt,76238,76855,617,10,N,N,-,-1,-1
WESLEY.txt,76292,76928,636,10,N,N,-,-1,-1
WESLEY.txt,76309,77012,703,10,N,N,-,-1,-1
WESLEY.txt,76329,77072,743,10,N,N,-,-1,-1
WESLEY.txt,76354,77084,730,10,N,N,-,-1,-1
WESLEY.txt,76425,77273,848,10,N,N,-,-1,-1
WESLEY.txt,76461,77302,841,10,N,N,-,-1,-1
WESLEY.txt,76603,77473,870,10,N,N,-,-1,-1
WESLEY.txt,76773,77518,745,10,N,N,-,-1,-1
WESLEY.txt,76803,77574,771,10,N,N,-,-1,-1
WESLEY.txt,76856,77749,893,10,N,N,-,-1,-1
WESLEY.txt,76929,77791,862,10,N,N,-,-1,-1
WESLEY.txt,77013,77994,981,10,N,N,-,-1,-1
WESLEY.txt,77073,78084,1011,10,N,N,-,-1,-1
WESLEY.txt,77084,78203,1119,10,N,N,-,-1,-1
WESLEY.txt,77274,78355,1081,10,N,N,-,-1,-1
WESLEY.txt,77303,78439,1136,10,N,N,-,-1,-1
WESLEY.txt,77474,78516,1042,10,N,N,-,-1,-1
WESLEY.txt,77519,78619,1100,10,N,N,-,-1,-1
WESLEY.txt,77575,78711,1136,10,N,N,-,-1,-1
WESLEY.txt,77750,78952,1202,10,N,N,-,-1,-1
WESLEY.txt,77792,79080,1288,10,N,N,-,-1,-1
WESLEY.txt,77995,79232,1237,10,N,N,-,-1,-1
WESLEY.txt,78084,79353,1269,10,N,N,-,-1,-1
WESLEY.txt,78204,79471,1267,10,N,N,-,-1,-1
WESLEY.txt,78356,79560,1204,10,N,N,-,-1,-1
WESLEY.txt,78440,79751,1311,10,N,N,-,-1,-1
WESLEY.txt,78517,79862,1345,10,N,N,-,-1,-1
WESLEY.txt,78620,80053,1433,10,N,N,-,-1,-1
WESLEY.txt,78712,80154,1442,10,N,N,-,-1,-1
WESLEY.txt,78954,80250,1296,10,N,N,-,-1,-1
WESLEY.txt,79081,80291,1210,10,N,N,-,-1,-1
WESLEY.txt,79233,80469,1236,10,N,N,-,-1,-1
WESLEY.txt,79354,80563,1209,10,N,N,-,-1,-1
WESLEY.txt,79472,80676,1204,10,N,N,-,-1,-1
WESLEY.txt,79561,80914,1353,10,N,N,-,-1,-1
WESLEY.txt,79752,81194,1442,10,N,N,-,-1,-1
WESLEY.txt,79862,81583,1721,10,N,N,-,-1,-1
WESLEY.txt,80054,81607,1553,10,N,N,-,-1,-1
WESLEY.txt,80155,81673,1518,10,N,N,-,-1,-1
WESLEY.txt,80251,81769,1518,10,N,N,-,-1,-1
WESLEY.txt,80292,81842,1550,10,N,N,-,-1,-1
WESLEY.txt,80470,82041,1571,10,N,N,-,-1,-1
WESLEY.txt,80564,82256,1692,10,N,N,-,-1,-1
WESLEY.txt,80677,82528,1851,10,N,N,-,-1,-1
WESLEY.txt,80915,82604,1689,10,N,N,-,-1,-1
WESLEY.txt,81195,82710,1515,10,N,N,-,-1,-1
WESLEY.txt,81584,82788,1204,10,N,N,-,-1,-1
WESLEY.txt,81607,82888,1281,10,N,N,-,-1,-1
WESLEY.txt,81674,82991,1317,10,N,N,-,-1,-1
WESLEY.txt,81770,83084,1314,10,N,N,-,-1,-1
WESLEY.txt,81843,83101,1258,10,N,N,-,-1,-1
WESLEY.txt,82042,83360,1318,10,N,N,-,-1,-1
WESLEY.txt,82257,83364,1107,10,N,N,-,-1,-1
WESLEY.txt,82529,83381,852,10,N,N,-,-1,-1
WESLEY.txt,82605,83549,944,10,N,N,-,-1,-1
WESLEY.txt,82711,83562,851,10,N,N,-,-1,-1
WESLEY.txt,82789,83793,1004,10,N,N,-,-1,-1
WESLEY.txt,82889,83983,1094,10,N,N,-,-1,-1
WESLEY.txt,82992,83999,1007,10,N,N,-,-1,-1
WESLEY.txt,83085,84146,1061,10,N,N,-,-1,-1
WESLEY.txt,83101,84315,1214,10,N,N,-,-1,-1
WESLEY.txt,83361,84536,1175,10,N,N,-,-1,-1
WESLEY.txt,83365,84683,1318,10,N,N,-,-1,-1
WESLEY.txt,83381,84785,1404,10,N,N,-,-1,-1
WESLEY.txt,83550,84977,1427,10,N,N,-,-1,-1
WESLEY.txt,83562,85161,1599,10,N,N,-,-1,-1
WESLEY.txt,83794,85278,1484,10,N,N,-,-1,-1
WESLEY.txt,83984,85294,1310,10,N,N,-,-1,-1
WESLEY.txt,83999,85308,1309,10,N,N,-,-1,-1
WESLEY.txt,84147,85489,1342,10,N,N,-,-1,-1
WESLEY.txt,84316,85611,1295,10,N,N,-,-1,-1
WESLEY.txt,84537,85735,1198,10,N,N,-,-1,-1
WESLEY.txt,84684,85779,1095,10,N,N,-,-1,-1
WESLEY.txt,84786,85809,1023,10,N,N,-,-1,-1
WESLEY.txt,84978,85882,904,10,N,N,-,-1,-1
WESLEY.txt,85162,85934,772,10,N,N,-,-1,-1
WESLEY.txt,85279,86027,748,10,N,N,-,-1,-1
WESLEY.txt,85295,86040,745,10,N,N,-,-1,-1
WESLEY.txt,85308,86621,1313,10,N,N,-,-1,-1
WESLEY.txt,85490,86679,1189,10,N,N,-,-1,-1
WESLEY.txt,85612,86684,1072,10,N,N,-,-1,-1
WESLEY.txt,85736,86690,954,10,N,N,-,-1,-1
WESLEY.txt,85780,86695,915,10,N,N,-,-1,-1
WESLEY.txt,85810,86706,896,10,N,N,-,-1,-1
WESLEY.txt,85882,86718,836,10,N,N,-,-1,-1
WESLEY.txt,85935,86823,888,10,N,N,-,-1,-1
WESLEY.txt,86028,86992,964,10,N,N,-,-1,-1
WESLEY.txt,86041,87079,1038,10,N,N,-,-1,-1
WESLEY.txt,86622,87183,561,10,N,N,-,-1,-1
WESLEY.txt,86680,87259,579,10,N,N,-,-1,-1
WESLEY.txt,86685,87273,588,10,N,N,-,-1,-1
WESLEY.txt,86691,87389,698,10,N,N,-,-1,-1
WESLEY.txt,86696,87415,719,10,N,N,-,-1,-1
WESLEY.txt,86707,87492,785,10,N,N,-,-1,-1
WESLEY.txt,86718,87586,868,10,N,N,-,-1,-1
WESLEY.txt,86824,87676,852,10,N,N,-,-1,-1
WESLEY.txt,86993,87727,734,10,N,N,-,-1,-1
WESLEY.txt,87080,87856,776,10,N,N,-,-1,-1
WESLEY.txt,87184,88031,847,10,N,N,-,-1,-1
WESLEY.txt,87260,88052,792,10,N,N,-,-1,-1
WESLEY.txt,87273,88329,1056,10,N,N,-,-1,-1
WESLEY.txt,87390,88465,1075,10,N,N,-,-1,-1
WESLEY.txt,87416,88579,1163,10,N,N,-,-1,-1
WESLEY.txt,87493,88785,1292,10,N,N,-,-1,-1
WESLEY.txt,87587,88858,1271,10,N,N,-,-1,-1
WESLEY.txt,87677,88937,1260,10,N,N,-,-1,-1
WESLEY.txt,87728,89269,1541,10,N,N,-,-1,-1
WESLEY.txt,87857,89346,1489,10,N,N,-,-1,-1
WESLEY.txt,88032,89540,1508,10,N,N,-,-1,-1
WESLEY.txt,88053,89565,1512,10,N,N,-,-1,-1
WESLEY.txt,88330,89649,1319,10,N,N,-,-1,-1
WESLEY.txt,88466,89779,1313,10,N,N,-,-1,-1
WESLEY.txt,88580,89856,1276,10,N,N,-,-1,-1
WESLEY.txt,88787,90139,1352,10,N,N,-,-1,-1
WESLEY.txt,88859,90334,1475,10,N,N,-,-1,-1
WESLEY.txt,88938,90542,1604,10,N,N,-,-1,-1
WESLEY.txt,89270,90764,1494,10,N,N,-,-1,-1
WESLEY.txt,89346,90934,1588,10,N,N,-,-1,-1
WESLEY.txt,89541,90938,1397,10,N,N,-,-1,-1
WESLEY.txt,89566,91012,1446,10,N,N,-,-1,-1
WESLEY.txt,89650,91016,1366,10,N,N,-,-1,-1
WESLEY.txt,89780,91058,1278,10,N,N,-,-1,-1
WESLEY.txt,89857,91062,1205,10,N,N,-,-1,-1
WESLEY.txt,90140,91119,979,10,N,N,-,-1,-1
WESLEY.txt,90335,91123,788,10,N,N,-,-1,-1
WESLEY.txt,90543,91167,624,10,N,N,-,-1,-1
WESLEY.txt,90765,91171,406,10,N,N,-,-1,-1
WESLEY.txt,90935,91311,376,10,N,N,-,-1,-1
WESLEY.txt,90939,91315,376,10,N,N,-,-1,-1
WESLEY.txt,91013,91367,354,10,N,N,-,-1,-1
WESLEY.txt,91017,91371,354,10,N,N,-,-1,-1
WESLEY.txt,91059,91446,387,10,N,N,-,-1,-1
WESLEY.txt,91063,91450,387,10,N,N,-,-1,-1
WESLEY.txt,91120,91501,381,10,N,N,-,-1,-1
WESLEY.txt,91124,91505,381,10,N,N,-,-1,-1
WESLEY.txt,91168,91600,432,10,N,N,-,-1,-1
WESLEY.txt,91172,91605,433,10,N,N,-,-1,-1
WESLEY.txt,91312,91717,405,10,N,N,-,-1,-1
WESLEY.txt,91316,91831,515,10,N,N,-,-1,-1
WESLEY.txt,91368,91852,484,10,N,N,-,-1,-1
WESLEY.txt,91372,91947,575,10,N,N,-,-1,-1
WESLEY.txt,91447,92130,683,10,N,N,-,-1,-1
WESLEY.txt,91461,92212,751,10,N,N,-,-1,-1
WESLEY.txt,91502,92375,873,10,N,N,-,-1,-1
WESLEY.txt,91506,92620,1114,10,N,N,-,-1,-1
WESLEY.txt,91601,92803,1202,10,N,N,-,-1,-1
WESLEY.txt,91606,93248,1642,10,N,N,-,-1,-1
WESLEY.txt,91718,93411,1693,10,N,N,-,-1,-1
WESLEY.txt,91832,93413,1581,10,N,N,-,-1,-1
WESLEY.txt,91852,93432,1580,10,N,N,-,-1,-1
WESLEY.txt,91948,93511,1563,10,N,N,-,-1,-1
WESLEY.txt,92131,93749,1618,10,N,N,-,-1,-1
WESLEY.txt,92213,94059,1846,10,N,N,-,-1,-1
WESLEY.txt,92376,94267,1891,10,N,N,-,-1,-1
WESLEY.txt,92621,94359,1738,10,N,N,-,-1,-1
WESLEY.txt,92804,94503,1699,10,N,N,-,-1,-1
WESLEY.txt,93249,94585,1336,10,N,N,-,-1,-1
WESLEY.txt,93411,94687,1276,10,N,N,-,-1,-1
WESLEY.txt,93414,94738,1324,10,N,N,-,-1,-1
WESLEY.txt,93432,94934,1502,10,N,N,-,-1,-1
WESLEY.txt,93512,95117,1605,10,N,N,-,-1,-1
WESLEY.txt,93750,95207,1457,10,N,N,-,-1,-1
WESLEY.txt,94060,95311,1251,10,N,N,-,-1,-1
WESLEY.txt,94268,95413,1145,10,N,N,-,-1,-1
WESLEY.txt,94360,95433,1073,10,N,N,-,-1,-1
WESLEY.txt,94504,95503,999,10,N,N,-,-1,-1
WESLEY.txt,94585,95649,1064,10,N,N,-,-1,-1
WESLEY.txt,94688,95740,1052,10,N,N,-,-1,-1
WESLEY.txt,94739,95809,1070,10,N,N,-,-1,-1
WESLEY.txt,94936,95922,986,10,N,N,-,-1,-1
WESLEY.txt,95118,95948,830,10,N,N,-,-1,-1
WESLEY.txt,95208,96128,920,10,N,N,-,-1,-1
WESLEY.txt,95312,96229,917,10,N,N,-,-1,-1
WESLEY.txt,95414,96309,895,10,N,N,-,-1,-1
WESLEY.txt,95433,96359,926,10,N,N,-,-1,-1
WESLEY.txt,95504,96401,897,10,N,N,-,-1,-1
WESLEY.txt,95651,96585,934,10,N,N,-,-1,-1
WESLEY.txt,95741,97071,1330,10,N,N,-,-1,-1
WESLEY.txt,95810,97084,1274,10,N,N,-,-1,-1
WESLEY.txt,95923,97250,1327,10,N,N,-,-1,-1
WESLEY.txt,95949,97512,1563,10,N,N,-,-1,-1
WESLEY.txt,96129,97678,1549,10,N,N,-,-1,-1
WESLEY.txt,96230,97758,1528,10,N,N,-,-1,-1
WESLEY.txt,96310,97921,1611,10,N,N,-,-1,-1
WESLEY.txt,96360,98004,1644,10,N,N,-,-1,-1
WESLEY.txt,96402,98151,1749,10,N,N,-,-1,-1
WESLEY.txt,96587,98307,1720,10,N,N,-,-1,-1
WESLEY.txt,97072,98472,1400,10,N,N,-,-1,-1
WESLEY.txt,97084,98515,1431,10,N,N,-,-1,-1
WESLEY.txt,97252,98705,1453,10,N,N,-,-1,-1
WESLEY.txt,97513,98716,1203,10,N,N,-,-1,-1
WESLEY.txt,97679,98847,1168,10,N,N,-,-1,-1
WESLEY.txt,97760,99029,1269,10,N,N,-,-1,-1
WESLEY.txt,97922,99329,1407,10,N,N,-,-1,-1
WESLEY.txt,98005,99458,1453,10,N,N,-,-1,-1
WESLEY.txt,98152,99485,1333,10,N,N,-,-1,-1
WESLEY.txt,98308,99571,1263,10,N,N,-,-1,-1
WESLEY.txt,98473,99728,1255,10,N,N,-,-1,-1
WESLEY.txt,98516,99742,1226,10,N,N,-,-1,-1
WESLEY.txt,98706,99907,1201,10,N,N,-,-1,-1
WESLEY.txt,98716,99993,1277,10,N,N,-,-1,-1
WESLEY.txt,98848,100175,1327,10,N,N,-,-1,-1
WESLEY.txt,99030,100248,1218,10,N,N,-,-1,-1
WESLEY.txt,99330,100545,1215,10,N,N,-,-1,-1
WESLEY.txt,99459,100625,1166,10,N,N,-,-1,-1
WESLEY.txt,99486,100786,1300,10,N,N,-,-1,-1
WESLEY.txt,99573,100875,1302,10,N,N,-,-1,-1
WESLEY.txt,99729,100887,1158,10,N,N,-,-1,-1
WESLEY.txt,99742,100955,1213,10,N,N,-,-1,-1
WESLEY.txt,99909,101145,1236,10,N,N,-,-1,-1
WESLEY.txt,99994,101151,1157,10,N,N,-,-1,-1
WESLEY.txt,100176,101170,994,10,N,N,-,-1,-1
WESLEY.txt,100248,101396,1148,10,N,N,-,-1,-1
WESLEY.txt,100546,101482,936,10,N,N,-,-1,-1
WESLEY.txt,100626,101493,867,10,N,N,-,-1,-1
WESLEY.txt,100787,101744,957,10,N,N,-,-1,-1
WESLEY.txt,100876,101837,961,10,N,N,-,-1,-1
WESLEY.txt,100887,101932,1045,10,N,N,-,-1,-1
WESLEY.txt,100956,102058,1102,10,N,N,-,-1,-1
WESLEY.txt,101146,102118,972,10,N,N,-,-1,-1
WESLEY.txt,101152,102169,1017,10,N,N,-,-1,-1
WESLEY.txt,101170,102211,1041,10,N,N,-,-1,-1
WESLEY.txt,101397,102257,860,10,N,N,-,-1,-1
WESLEY.txt,101483,102270,787,10,N,N,-,-1,-1
WESLEY.txt,101493,102346,853,10,N,N,-,-1,-1
WESLEY.txt,101745,102423,678,10,N,N,-,-1,-1
WESLEY.txt,101838,102549,711,10,N,N,-,-1,-1
WESLEY.txt,101933,102639,706,10,N,N,-,-1,-1
WESLEY.txt,102059,102716,657,10,N,N,-,-1,-1
WESLEY.txt,102120,102822,702,10,N,N,-,-1,-1
WESLEY.txt,102170,102883,713,10,N,N,-,-1,-1
WESLEY.txt,102212,102934,722,10,N,N,-,-1,-1
WESLEY.txt,102258,103064,806,10,N,N,-,-1,-1
WESLEY.txt,102270,103199,929,10,N,N,-,-1,-1
WESLEY.txt,102347,103298,951,10,N,N,-,-1,-1
WESLEY.txt,102424,103339,915,10,N,N,-,-1,-1
WESLEY.txt,102550,103380,830,10,N,N,-,-1,-1
WESLEY.txt,102640,103550,910,10,N,N,-,-1,-1
WESLEY.txt,102716,103770,1054,10,N,N,-,-1,-1
WESLEY.txt,102823,103873,1050,10,N,N,-,-1,-1
WESLEY.txt,102884,103886,1002,10,N,N,-,-1,-1
WESLEY.txt,102935,104029,1094,10,N,N,-,-1,-1
WESLEY.txt,103065,104153,1088,10,N,N,-,-1,-1
WESLEY.txt,103200,104175,975,10,N,N,-,-1,-1
WESLEY.txt,103299,104246,947,10,N,N,-,-1,-1
WESLEY.txt,103340,104277,937,10,N,N,-,-1,-1
WESLEY.txt,103381,104406,1025,10,N,N,-,-1,-1
WESLEY.txt,103551,104439,888,10,N,N,-,-1,-1
WESLEY.txt,103771,104526,755,10,N,N,-,-1,-1
WESLEY.txt,103874,104827,953,10,N,N,-,-1,-1
WESLEY.txt,103886,104861,975,10,N,N,-,-1,-1
WESLEY.txt,104030,104918,888,10,N,N,-,-1,-1
WESLEY.txt,104154,105000,846,10,N,N,-,-1,-1
WESLEY.txt,104176,105047,871,10,N,N,-,-1,-1
WESLEY.txt,104247,105099,852,10,N,N,-,-1,-1
WESLEY.txt,104278,105184,906,10,N,N,-,-1,-1
WESLEY.txt,104407,105242,835,10,N,N,-,-1,-1
WESLEY.txt,104440,105281,841,10,N,N,-,-1,-1
WESLEY.txt,104527,105381,854,10,N,N,-,-1,-1
WESLEY.txt,104828,105437,609,10,N,N,-,-1,-1
WESLEY.txt,104862,105447,585,10,N,N,-,-1,-1
WESLEY.txt,104919,105475,556,10,N,N,-,-1,-1
WESLEY.txt,105001,105480,479,10,N,N,-,-1,-1
WESLEY.txt,105049,105525,476,10,N,N,-,-1,-1
WESLEY.txt,105100,105543,443,10,N,N,-,-1,-1
WESLEY.txt,105185,105570,385,10,N,N,-,-1,-1
WESLEY.txt,105243,105635,392,10,N,N,-,-1,-1
WESLEY.txt,105282,105743,461,10,N,N,-,-1,-1
WESLEY.txt,105382,106004,622,10,N,N,-,-1,-1
WESLEY.txt,105437,106367,930,10,N,N,-,-1,-1
WESLEY.txt,105448,106382,934,10,N,N,-,-1,-1
WESLEY.txt,105476,106712,1236,10,N,N,-,-1,-1
WESLEY.txt,105481,106724,1243,10,N,N,-,-1,-1
WESLEY.txt,105527,106808,1281,10,N,N,-,-1,-1
WESLEY.txt,105544,106904,1360,10,N,N,-,-1,-1
WESLEY.txt,105571,107201,1630,10,N,N,-,-1,-1
WESLEY.txt,105636,107297,1661,10,N,N,-,-1,-1
WESLEY.txt,105744,107394,1650,10,N,N,-,-1,-1
WESLEY.txt,106004,107569,1565,10,N,N,-,-1,-1
WESLEY.txt,106369,107711,1342,10,N,N,-,-1,-1
WESLEY.txt,106382,107759,1377,10,N,N,-,-1,-1
WESLEY.txt,106713,107880,1167,10,N,N,-,-1,-1
WESLEY.txt,106724,108051,1327,10,N,N,-,-1,-1
WESLEY.txt,106809,108076,1267,10,N,N,-,-1,-1
WESLEY.txt,106905,108146,1241,10,N,N,-,-1,-1
WESLEY.txt,107202,108287,1085,10,N,N,-,-1,-1
WESLEY.txt,107298,108477,1179,10,N,N,-,-1,-1
WESLEY.txt,107395,108488,1093,10,N,N,-,-1,-1
WESLEY.txt,107571,108562,991,10,N,N,-,-1,-1
WESLEY.txt,107712,108748,1036,10,N,N,-,-1,-1
WESLEY.txt,107760,108775,1015,10,N,N,-,-1,-1
WESLEY.txt,107881,108845,964,10,N,N,-,-1,-1
WESLEY.txt,108052,108947,895,10,N,N,-,-1,-1
WESLEY.txt,108077,109125,1048,10,N,N,-,-1,-1
WESLEY.txt,108146,109233,1087,10,N,N,-,-1,-1
WESLEY.txt,108288,109239,951,10,N,N,-,-1,-1
WESLEY.txt,108478,109285,807,10,N,N,-,-1,-1
WESLEY.txt,108488,109460,972,10,N,N,-,-1,-1
WESLEY.txt,108563,109561,998,10,N,N,-,-1,-1
WESLEY.txt,108749,109677,928,10,N,N,-,-1,-1
WESLEY.txt,108776,109779,1003,10,N,N,-,-1,-1
WESLEY.txt,108846,109829,983,10,N,N,-,-1,-1
WESLEY.txt,108948,109872,924,10,N,N,-,-1,-1
WESLEY.txt,109126,109919,793,10,N,N,-,-1,-1
WESLEY.txt,109234,110025,791,10,N,N,-,-1,-1
WESLEY.txt,109240,110118,878,10,N,N,-,-1,-1
WESLEY.txt,109286,110295,1009,10,N,N,-,-1,-1
WESLEY.txt,109461,110308,847,10,N,N,-,-1,-1
WESLEY.txt,109562,110392,830,10,N,N,-,-1,-1
WESLEY.txt,109679,110470,791,10,N,N,-,-1,-1
WESLEY.txt,109780,110567,787,10,N,N,-,-1,-1
WESLEY.txt,109830,110638,808,10,N,N,-,-1,-1
WESLEY.txt,109873,110728,855,10,N,N,-,-1,-1
WESLEY.txt,109920,110735,815,10,N,N,-,-1,-1
WESLEY.txt,110026,110849,823,10,N,N,-,-1,-1
WESLEY.txt,110120,110895,775,10,N,N,-,-1,-1
WESLEY.txt,110296,110962,666,10,N,N,-,-1,-1
WESLEY.txt,110308,111030,722,10,N,N,-,-1,-1
WESLEY.txt,110393,111066,673,10,N,N,-,-1,-1
WESLEY.txt,110471,111123,652,10,N,N,-,-1,-1
WESLEY.txt,110568,111154,586,10,N,N,-,-1,-1
WESLEY.txt,110640,111290,650,10,N,N,-,-1,-1
WESLEY.txt,110729,111419,690,10,N,N,-,-1,-1
WESLEY.txt,110736,111529,793,10,N,N,-,-1,-1
WESLEY.txt,110850,111543,693,10,N,N,-,-1,-1
WESLEY.txt,110895,111624,729,10,N,N,-,-1,-1
WESLEY.txt,110963,111919,956,10,N,N,-,-1,-1
WESLEY.txt,111031,111931,900,10,N,N,-,-1,-1
WESLEY.txt,111067,112111,1044,10,N,N,-,-1,-1
WESLEY.txt,111123,112118,995,10,N,N,-,-1,-1
WESLEY.txt,111155,112136,981,10,N,N,-,-1,-1
WESLEY.txt,111291,112155,864,10,N,N,-,-1,-1
WESLEY.txt,111420,112200,780,10,N,N,-,-1,-1
WESLEY.txt,111530,112212,682,10,N,N,-,-1,-1
WESLEY.txt,111543,112464,921,10,N,N,-,-1,-1
WESLEY.txt,111625,112478,853,10,N,N,-,-1,-1
WESLEY.txt,111920,112507,587,10,N,N,-,-1,-1
WESLEY.txt,111931,112606,675,10,N,N,-,-1,-1
WESLEY.txt,112112,112785,673,10,N,N,-,-1,-1
WESLEY.txt,112119,112797,678,10,N,N,-,-1,-1
WESLEY.txt,112137,112819,682,10,N,N,-,-1,-1
WESLEY.txt,112156,112976,820,10,N,N,-,-1,-1
WESLEY.txt,112201,112988,787,10,N,N,-,-1,-1
WESLEY.txt,112212,113112,900,10,N,N,-,-1,-1
WESLEY.txt,112465,113510,1045,10,N,N,-,-1,-1
WESLEY.txt,112478,113517,1039,10,N,N,-,-1,-1
WESLEY.txt,112508,113529,1021,10,N,N,-,-1,-1
WESLEY.txt,112607,113636,1029,10,N,N,-,-1,-1
WESLEY.txt,112786,113649,863,10,N,N,-,-1,-1
WESLEY.txt,112797,113676,879,10,N,N,-,-1,-1
WESLEY.txt,112820,113742,922,10,N,N,-,-1,-1
WESLEY.txt,112977,113880,903,10,N,N,-,-1,-1
WESLEY.txt,112988,114140,1152,10,N,N,-,-1,-1
WESLEY.txt,113113,114279,1166,10,N,N,-,-1,-1
WESLEY.txt,113511,114282,771,10,N,N,-,-1,-1
WESLEY.txt,113518,114354,836,10,N,N,-,-1,-1
WESLEY.txt,113529,114357,828,10,N,N,-,-1,-1
WESLEY.txt,113637,114501,864,10,N,N,-,-1,-1
WESLEY.txt,113649,114504,855,10,N,N,-,-1,-1
WESLEY.txt,113677,114608,931,10,N,N,-,-1,-1
WESLEY.txt,113743,114631,888,10,N,N,-,-1,-1
WESLEY.txt,113882,114657,775,10,N,N,-,-1,-1
WESLEY.txt,114141,114665,524,10,N,N,-,-1,-1
WESLEY.txt,114280,114870,590,10,N,N,-,-1,-1
WESLEY.txt,114283,114889,606,10,N,N,-,-1,-1
WESLEY.txt,114355,115129,774,10,N,N,-,-1,-1
WESLEY.txt,114358,115187,829,10,N,N,-,-1,-1
WESLEY.txt,114502,115247,745,10,N,N,-,-1,-1
WESLEY.txt,114505,115311,806,10,N,N,-,-1,-1
WESLEY.txt,114609,115339,730,10,N,N,-,-1,-1
WESLEY.txt,114632,115373,741,10,N,N,-,-1,-1
WESLEY.txt,114658,115469,811,10,N,N,-,-1,-1
WESLEY.txt,114666,115573,907,10,N,N,-,-1,-1
WESLEY.txt,114871,115673,802,10,N,N,-,-1,-1
WESLEY.txt,114889,115696,807,10,N,N,-,-1,-1
WESLEY.txt,115130,115759,629,10,N,N,-,-1,-1
WESLEY.txt,115188,115908,720,10,N,N,-,-1,-1
WESLEY.txt,115248,116009,761,10,N,N,-,-1,-1
WESLEY.txt,115312,116127,815,10,N,N,-,-1,-1
WESLEY.txt,115340,116325,985,10,N,N,-,-1,-1
WESLEY.txt,115374,116431,1057,10,N,N,-,-1,-1
WESLEY.txt,115470,116643,1173,10,N,N,-,-1,-1
WESLEY.txt,115574,116679,1105,10,N,N,-,-1,-1
WESLEY.txt,115674,116738,1064,10,N,N,-,-1,-1
WESLEY.txt,115697,116837,1140,10,N,N,-,-1,-1
WESLEY.txt,115760,116930,1170,10,N,N,-,-1,-1
WESLEY.txt,115909,117146,1237,10,N,N,-,-1,-1
WESLEY.txt,116009,117253,1244,10,N,N,-,-1,-1
WESLEY.txt,116129,117425,1296,10,N,N,-,-1,-1
WESLEY.txt,116326,117575,1249,10,N,N,-,-1,-1
WESLEY.txt,116432,117692,1260,10,N,N,-,-1,-1
WESLEY.txt,116644,117817,1173,10,N,N,-,-1,-1
WESLEY.txt,116680,117916,1236,10,N,N,-,-1,-1
WESLEY.txt,116739,118007,1268,10,N,N,-,-1,-1
WESLEY.txt,116838,118284,1446,10,N,N,-,-1,-1
WESLEY.txt,116931,118432,1501,10,N,N,-,-1,-1
WESLEY.txt,117147,118469,1322,10,N,N,-,-1,-1
WESLEY.txt,117254,118575,1321,10,N,N,-,-1,-1
WESLEY.txt,117426,118697,1271,10,N,N,-,-1,-1
WESLEY.txt,117576,118829,1253,10,N,N,-,-1,-1
WESLEY.txt,117694,118928,1234,10,N,N,-,-1,-1
WESLEY.txt,117818,119076,1258,10,N,N,-,-1,-1
WESLEY.txt,117917,119098,1181,10,N,N,-,-1,-1
WESLEY.txt,118008,119161,1153,10,N,N,-,-1,-1
WESLEY.txt,118285,119193,908,10,N,N,-,-1,-1
WESLEY.txt,118433,119305,872,10,N,N,-,-1,-1
WESLEY.txt,118471,119499,1028,10,N,N,-,-1,-1
WESLEY.txt,118575,119620,1045,10,N,N,-,-1,-1
WESLEY.txt,118698,119747,1049,10,N,N,-,-1,-1
WESLEY.txt,118830,119819,989,10,N,N,-,-1,-1
WESLEY.txt,118929,120057,1128,10,N,N,-,-1,-1
WESLEY.txt,119077,120070,993,10,N,N,-,-1,-1
WESLEY.txt,119099,120113,1014,10,N,N,-,-1,-1
WESLEY.txt,119162,120202,1040,10,N,N,-,-1,-1
WESLEY.txt,119194,120236,1042,10,N,N,-,-1,-1
WESLEY.txt,119306,120470,1164,10,N,N,-,-1,-1
WESLEY.txt,119500,120656,1156,10,N,N,-,-1,-1
WESLEY.txt,119621,120762,1141,10,N,N,-,-1,-1
WESLEY.txt,119748,120791,1043,10,N,N,-,-1,-1
WESLEY.txt,119820,120886,1066,10,N,N,-,-1,-1
WESLEY.txt,120058,121040,982,10,N,N,-,-1,-1
WESLEY.txt,120070,121224,1154,10,N,N,-,-1,-1
WESLEY.txt,120114,121230,1116,10,N,N,-,-1,-1
WESLEY.txt,120203,121321,1118,10,N,N,-,-1,-1
WESLEY.txt,120237,121491,1254,10,N,N,-,-1,-1
WESLEY.txt,120471,121674,1203,10,N,N,-,-1,-1
WESLEY.txt,120657,121686,1029,10,N,N,-,-1,-1
WESLEY.txt,120763,121933,1170,10,N,N,-,-1,-1
WESLEY.txt,120792,122040,1248,10,N,N,-,-1,-1
WESLEY.txt,120887,122108,1221,10,N,N,-,-1,-1
WESLEY.txt,121041,122189,1148,10,N,N,-,-1,-1
WESLEY.txt,121225,122384,1159,10,N,N,-,-1,-1
WESLEY.txt,121231,122401,1170,10,N,N,-,-1,-1
WESLEY.txt,121321,122583,1262,10,N,N,-,-1,-1
WESLEY.txt,121492,122672,1180,10,N,N,-,-1,-1
WESLEY.txt,121675,122711,1036,10,N,N,-,-1,-1
WESLEY.txt,121686,122903,1217,10,N,N,-,-1,-1
WESLEY.txt,121934,123023,1089,10,N,N,-,-1,-1
WESLEY.txt,122041,123071,1030,10,N,N,-,-1,-1
WESLEY.txt,122109,123221,1112,10,N,N,-,-1,-1
WESLEY.txt,122190,123292,1102,10,N,N,-,-1,-1
WESLEY.txt,122385,123419,1034,10,N,N,-,-1,-1
WESLEY.txt,122401,123460,1059,10,N,N,-,-1,-1
WESLEY.txt,122584,123578,994,10,N,N,-,-1,-1
WESLEY.txt,122673,123673,1000,10,N,N,-,-1,-1
WESLEY.txt,122712,123770,1058,10,N,N,-,-1,-1
WESLEY.txt,122904,124000,1096,10,N,N,-,-1,-1
WESLEY.txt,123024,124171,1147,10,N,N,-,-1,-1
WESLEY.txt,123072,124263,1191,10,N,N,-,-1,-1
WESLEY.txt,123222,124467,1245,10,N,N,-,-1,-1
WESLEY.txt,123293,124651,1358,10,N,N,-,-1,-1
WESLEY.txt,123420,124975,1555,10,N,N,-,-1,-1
WESLEY.txt,123461,124990,1529,10,N,N,-,-1,-1
WESLEY.txt,123579,125063,1484,10,N,N,-,-1,-1
WESLEY.txt,123674,125205,1531,10,N,N,-,-1,-1
WESLEY.txt,123771,125280,1509,10,N,N,-,-1,-1
WESLEY.txt,124001,125294,1293,10,N,N,-,-1,-1
WESLEY.txt,124172,125363,1191,10,N,N,-,-1,-1
WESLEY.txt,124264,125528,1264,10,N,N,-,-1,-1
WESLEY.txt,124468,125541,1073,10,N,N,-,-1,-1
WESLEY.txt,124652,125599,947,10,N,N,-,-1,-1
WESLEY.txt,124976,125661,685,10,N,N,-,-1,-1
WESLEY.txt,124990,125735,745,10,N,N,-,-1,-1
WESLEY.txt,125064,125746,682,10,N,N,-,-1,-1
WESLEY.txt,125206,125837,631,10,N,N,-,-1,-1
WESLEY.txt,125281,126000,719,10,N,N,-,-1,-1
WESLEY.txt,125294,126051,757,10,N,N,-,-1,-1
WESLEY.txt,125364,126193,829,10,N,N,-,-1,-1
WESLEY.txt,125529,126269,740,10,N,N,-,-1,-1
WESLEY.txt,125541,126281,740,10,N,N,-,-1,-1
WESLEY.txt,125600,126329,729,10,N,N,-,-1,-1
WESLEY.txt,125662,126373,711,10,N,N,-,-1,-1
WESLEY.txt,125736,126510,774,10,N,N,-,-1,-1
WESLEY.txt,125746,126736,990,10,N,N,-,-1,-1
WESLEY.txt,125838,126786,948,10,N,N,-,-1,-1
WESLEY.txt,126001,126822,821,10,N,N,-,-1,-1
WESLEY.txt,126051,126917,866,10,N,N,-,-1,-1
WESLEY.txt,126194,126970,776,10,N,N,-,-1,-1
WESLEY.txt,126270,127026,756,10,N,N,-,-1,-1
WESLEY.txt,126281,127108,827,10,N,N,-,-1,-1
WESLEY.txt,126330,127127,797,10,N,N,-,-1,-1
WESLEY.txt,126374,127344,970,10,N,N,-,-1,-1
WESLEY.txt,126511,127455,944,10,N,N,-,-1,-1
WESLEY.txt,126737,127505,768,10,N,N,-,-1,-1
WESLEY.txt,126787,127592,805,10,N,N,-,-1,-1
WESLEY.txt,126823,127652,829,10,N,N,-,-1,-1
WESLEY.txt,126918,127737,819,10,N,N,-,-1,-1
WESLEY.txt,126971,127799,828,10,N,N,-,-1,-1
WESLEY.txt,127027,127900,873,10,N,N,-,-1,-1
WESLEY.txt,127109,127947,838,10,N,N,-,-1,-1
WESLEY.txt,127127,128146,1019,10,N,N,-,-1,-1
WESLEY.txt,127345,128298,953,10,N,N,-,-1,-1
WESLEY.txt,127456,128474,1018,10,N,N,-,-1,-1
WESLEY.txt,127506,128592,1086,10,N,N,-,-1,-1
WESLEY.txt,127593,128664,1071,10,N,N,-,-1,-1
WESLEY.txt,127653,128758,1105,10,N,N,-,-1,-1
WESLEY.txt,127738,129081,1343,10,N,N,-,-1,-1
WESLEY.txt,127800,129178,1378,10,N,N,-,-1,-1
WESLEY.txt,127901,129209,1308,10,N,N,-,-1,-1
WESLEY.txt,127948,129282,1334,10,N,N,-,-1,-1
WESLEY.txt,128147,129368,1221,10,N,N,-,-1,-1
WESLEY.txt,128299,129455,1156,10,N,N,-,-1,-1
WESLEY.txt,128475,129535,1060,10,N,N,-,-1,-1
WESLEY.txt,128593,129549,956,10,N,N,-,-1,-1
WESLEY.txt,128665,129727,1062,10,N,N,-,-1,-1
WESLEY.txt,128759,129980,1221,10,N,N,-,-1,-1
WESLEY.txt,129082,130075,993,10,N,N,-,-1,-1
WESLEY.txt,129179,130117,938,10,N,N,-,-1,-1
WESLEY.txt,129210,130164,954,10,N,N,-,-1,-1
WESLEY.txt,129283,130255,972,10,N,N,-,-1,-1
WESLEY.txt,129369,130274,905,10,N,N,-,-1,-1
WESLEY.txt,129456,130351,895,10,N,N,-,-1,-1
WESLEY.txt,129536,130457,921,10,N,N,-,-1,-1
WESLEY.txt,129549,130498,949,10,N,N,-,-1,-1
WESLEY.txt,129728,130551,823,10,N,N,-,-1,-1
WESLEY.txt,129981,130839,858,10,N,N,-,-1,-1
WESLEY.txt,130076,130913,837,10,N,N,-,-1,-1
WESLEY.txt,130118,131038,920,10,N,N,-,-1,-1
WESLEY.txt,130165,131048,883,10,N,N,-,-1,-1
WESLEY.txt,130256,131225,969,10,N,N,-,-1,-1
WESLEY.txt,130274,131322,1048,10,N,N,-,-1,-1
WESLEY.txt,130352,131410,1058,10,N,N,-,-1,-1
WESLEY.txt,130458,131505,1047,10,N,N,-,-1,-1
WESLEY.txt,130499,131667,1168,10,N,N,-,-1,-1
WESLEY.txt,130552,131687,1135,10,N,N,-,-1,-1
WESLEY.txt,130840,131906,1066,10,N,N,-,-1,-1
WESLEY.txt,130913,131987,1074,10,N,N,-,-1,-1
WESLEY.txt,131039,132016,977,10,N,N,-,-1,-1
WESLEY.txt,131048,132115,1067,10,N,N,-,-1,-1
WESLEY.txt,131226,132303,1077,10,N,N,-,-1,-1
WESLEY.txt,131323,132473,1150,10,N,N,-,-1,-1
WESLEY.txt,131411,132479,1068,10,N,N,-,-1,-1
WESLEY.txt,131506,132491,985,10,N,N,-,-1,-1
WESLEY.txt,131668,132619,951,10,N,N,-,-1,-1
WESLEY.txt,131687,132658,971,10,N,N,-,-1,-1
WESLEY.txt,131907,132752,845,10,N,N,-,-1,-1
WESLEY.txt,131988,132791,803,10,N,N,-,-1,-1
WESLEY.txt,132016,132825,809,10,N,N,-,-1,-1
WESLEY.txt,132116,132943,827,10,N,N,-,-1,-1
WESLEY.txt,132304,132955,651,10,N,N,-,-1,-1
WESLEY.txt,132474,133113,639,10,N,N,-,-1,-1
WESLEY.txt,132480,133191,711,10,N,N,-,-1,-1
WESLEY.txt,132491,133288,797,10,N,N,-,-1,-1
WESLEY.txt,132620,133388,768,10,N,N,-,-1,-1
WESLEY.txt,132660,133488,828,10,N,N,-,-1,-1
WESLEY.txt,132753,133498,745,10,N,N,-,-1,-1
WESLEY.txt,132792,133856,1064,10,N,N,-,-1,-1
WESLEY.txt,132826,133893,1067,10,N,N,-,-1,-1
WESLEY.txt,132944,133908,964,10,N,N,-,-1,-1
WESLEY.txt,132955,133963,1008,10,N,N,-,-1,-1
WESLEY.txt,133114,134286,1172,10,N,N,-,-1,-1
WESLEY.txt,133192,134294,1102,10,N,N,-,-1,-1
WESLEY.txt,133289,134451,1162,10,N,N,-,-1,-1
WESLEY.txt,133389,134494,1105,10,N,N,-,-1,-1
WESLEY.txt,133489,134508,1019,10,N,N,-,-1,-1
WESLEY.txt,133498,134600,1102,10,N,N,-,-1,-1
WESLEY.txt,133857,134663,806,10,N,N,-,-1,-1
WESLEY.txt,133894,134992,1098,10,N,N,-,-1,-1
WESLEY.txt,133908,135001,1093,10,N,N,-,-1,-1
WESLEY.txt,133964,135294,1330,10,N,N,-,-1,-1
WESLEY.txt,134287,135305,1018,10,N,N,-,-1,-1
WESLEY.txt,134295,135520,1225,10,N,N,-,-1,-1
WESLEY.txt,134452,135658,1206,10,N,N,-,-1,-1
WESLEY.txt,134495,135974,1479,10,N,N,-,-1,-1
WESLEY.txt,134508,135999,1491,10,N,N,-,-1,-1
WESLEY.txt,134601,136010,1409,10,N,N,-,-1,-1
WESLEY.txt,134664,136165,1501,10,N,N,-,-1,-1
WESLEY.txt,134993,136229,1236,10,N,N,-,-1,-1
WESLEY.txt,135001,136279,1278,10,N,N,-,-1,-1
WESLEY.txt,135295,136346,1051,10,N,N,-,-1,-1
WESLEY.txt,135305,136353,1048,10,N,N,-,-1,-1
WESLEY.txt,135521,136612,1091,10,N,N,-,-1,-1
WESLEY.txt,135658,136730,1072,10,N,N,-,-1,-1
WESLEY.txt,135975,136743,768,10,N,N,-,-1,-1
WESLEY.txt,136000,136812,812,10,N,N,-,-1,-1
WESLEY.txt,136010,137005,995,10,N,N,-,-1,-1
WESLEY.txt,136166,137133,967,10,N,N,-,-1,-1
WESLEY.txt,136230,137148,918,10,N,N,-,-1,-1
WESLEY.txt,136279,137400,1121,10,N,N,-,-1,-1
WESLEY.txt,136347,137546,1199,10,N,N,-,-1,-1
WESLEY.txt,136354,137558,1204,10,N,N,-,-1,-1
WESLEY.txt,136613,137746,1133,10,N,N,-,-1,-1
WESLEY.txt,136731,137760,1029,10,N,N,-,-1,-1
WESLEY.txt,136743,138087,1344,10,N,N,-,-1,-1
WESLEY.txt,136813,138176,1363,10,N,N,-,-1,-1
WESLEY.txt,137006,138501,1495,10,N,N,-,-1,-1
WESLEY.txt,137134,138756,1622,10,N,N,-,-1,-1
WESLEY.txt,137148,138873,1725,10,N,N,-,-1,-1
WESLEY.txt,137400,139239,1839,10,N,N,-,-1,-1
WESLEY.txt,137547,139450,1903,10,N,N,-,-1,-1
WESLEY.txt,137558,139631,2073,10,N,N,-,-1,-1
WESLEY.txt,137747,139823,2076,10,N,N,-,-1,-1
WESLEY.txt,137760,139835,2075,10,N,N,-,-1,-1
WESLEY.txt,138088,139942,1854,10,N,N,-,-1,-1
WESLEY.txt,138177,140024,1847,10,N,N,-,-1,-1
WESLEY.txt,138502,140458,1956,10,N,N,-,-1,-1
WESLEY.txt,138757,140509,1752,10,N,N,-,-1,-1
WESLEY.txt,138874,140608,1734,10,N,N,-,-1,-1
WESLEY.txt,139240,140779,1539,10,N,N,-,-1,-1
WESLEY.txt,139451,141167,1716,10,N,N,-,-1,-1
WESLEY.txt,139632,141276,1644,10,N,N,-,-1,-1
WESLEY.txt,139824,141345,1521,10,N,N,-,-1,-1
WESLEY.txt,139835,141443,1608,10,N,N,-,-1,-1
WESLEY.txt,139943,141453,1510,10,N,N,-,-1,-1
WESLEY.txt,140025,141566,1541,10,N,N,-,-1,-1
WESLEY.txt,140459,141771,1312,10,N,N,-,-1,-1
WESLEY.txt,140510,142006,1496,10,N,N,-,-1,-1
WESLEY.txt,140608,142171,1563,10,N,N,-,-1,-1
WESLEY.txt,140780,142263,1483,10,N,N,-,-1,-1
WESLEY.txt,141168,142357,1189,10,N,N,-,-1,-1
WESLEY.txt,141278,142629,1351,10,N,N,-,-1,-1
WESLEY.txt,141346,142721,1375,10,N,N,-,-1,-1
WESLEY.txt,141444,142958,1514,10,N,N,-,-1,-1
WESLEY.txt,141454,143012,1558,10,N,N,-,-1,-1
WESLEY.txt,141567,143306,1739,10,N,N,-,-1,-1
WESLEY.txt,141772,143507,1735,10,N,N,-,-1,-1
WESLEY.txt,142007,143840,1833,10,N,N,-,-1,-1
WESLEY.txt,142172,143896,1724,10,N,N,-,-1,-1
WESLEY.txt,142264,143952,1688,10,N,N,-,-1,-1
WESLEY.txt,142358,144027,1669,10,N,N,-,-1,-1
WESLEY.txt,142630,144184,1554,10,N,N,-,-1,-1
WESLEY.txt,142722,144281,1559,10,N,N,-,-1,-1
WESLEY.txt,142959,144395,1436,10,N,N,-,-1,-1
WESLEY.txt,143013,144579,1566,10,N,N,-,-1,-1
WESLEY.txt,143307,144759,1452,10,N,N,-,-1,-1
WESLEY.txt,143508,144834,1326,10,N,N,-,-1,-1
WESLEY.txt,143841,145035,1194,10,N,N,-,-1,-1
WESLEY.txt,143897,145125,1228,10,N,N,-,-1,-1
WESLEY.txt,143953,145161,1208,10,N,N,-,-1,-1
WESLEY.txt,144027,145167,1140,10,N,N,-,-1,-1
WESLEY.txt,144185,145220,1035,10,N,N,-,-1,-1
WESLEY.txt,144282,145245,963,10,N,N,-,-1,-1
WESLEY.txt,144396,145275,879,10,N,N,-,-1,-1
WESLEY.txt,144580,145327,747,10,N,N,-,-1,-1
WESLEY.txt,144759,145346,587,10,N,N,-,-1,-1
WESLEY.txt,144835,145430,595,10,N,N,-,-1,-1
WESLEY.txt,145036,145615,579,10,N,N,-,-1,-1
WESLEY.txt,145126,145726,600,10,N,N,-,-1,-1
WESLEY.txt,145162,145766,604,10,N,N,-,-1,-1
WESLEY.txt,145169,145859,690,10,N,N,-,-1,-1
WESLEY.txt,145221,145902,681,10,N,N,-,-1,-1
WESLEY.txt,145246,145958,712,10,N,N,-,-1,-1
WESLEY.txt,145276,146072,796,10,N,N,-,-1,-1
WESLEY.txt,145328,146167,839,10,N,N,-,-1,-1
WESLEY.txt,145347,146351,1004,10,N,N,-,-1,-1
WESLEY.txt,145431,146402,971,10,N,N,-,-1,-1
WESLEY.txt,145616,146413,797,10,N,N,-,-1,-1
WESLEY.txt,145727,146614,887,10,N,N,-,-1,-1
WESLEY.txt,145767,146742,975,10,N,N,-,-1,-1
WESLEY.txt,145860,146828,968,10,N,N,-,-1,-1
WESLEY.txt,145903,146907,1004,10,N,N,-,-1,-1
WESLEY.txt,145959,146955,996,10,N,N,-,-1,-1
WESLEY.txt,146073,147083,1010,10,N,N,-,-1,-1
WESLEY.txt,146168,147251,1083,10,N,N,-,-1,-1
WESLEY.txt,146352,147484,1132,10,N,N,-,-1,-1
WESLEY.txt,146403,147573,1170,10,N,N,-,-1,-1
WESLEY.txt,146413,147730,1317,10,N,N,-,-1,-1
WESLEY.txt,146615,147749,1134,10,N,N,-,-1,-1
WESLEY.txt,146743,147820,1077,10,N,N,-,-1,-1
WESLEY.txt,146830,147992,1162,10,N,N,-,-1,-1
WESLEY.txt,146908,148288,1380,10,N,N,-,-1,-1
WESLEY.txt,146956,148520,1564,10,N,N,-,-1,-1
WESLEY.txt,147084,148634,1550,10,N,N,-,-1,-1
WESLEY.txt,147252,148803,1551,10,N,N,-,-1,-1
WESLEY.txt,147485,149010,1525,10,N,N,-,-1,-1
WESLEY.txt,147574,149158,1584,10,N,N,-,-1,-1
WESLEY.txt,147731,149249,1518,10,N,N,-,-1,-1
WESLEY.txt,147750,149278,1528,10,N,N,-,-1,-1
WESLEY.txt,147821,149447,1626,10,N,N,-,-1,-1
WESLEY.txt,147993,149526,1533,10,N,N,-,-1,-1
WESLEY.txt,148289,149646,1357,10,N,N,-,-1,-1
WESLEY.txt,148521,149794,1273,10,N,N,-,-1,-1
WESLEY.txt,148635,149830,1195,10,N,N,-,-1,-1
WESLEY.txt,148804,150104,1300,10,N,N,-,-1,-1
WESLEY.txt,149011,150200,1189,10,N,N,-,-1,-1
WESLEY.txt,149159,150302,1143,10,N,N,-,-1,-1
WESLEY.txt,149250,150611,1361,10,N,N,-,-1,-1
WESLEY.txt,149279,150770,1491,10,N,N,-,-1,-1
WESLEY.txt,149448,150921,1473,10,N,N,-,-1,-1
WESLEY.txt,149527,150968,1441,10,N,N,-,-1,-1
WESLEY.txt,149647,151109,1462,10,N,N,-,-1,-1
WESLEY.txt,149795,151218,1423,10,N,N,-,-1,-1
WESLEY.txt,149831,151318,1487,10,N,N,-,-1,-1
WESLEY.txt,150105,151514,1409,10,N,N,-,-1,-1
WESLEY.txt,150202,151624,1422,10,N,N,-,-1,-1
WESLEY.txt,150303,151729,1426,10,N,N,-,-1,-1
WESLEY.txt,150611,151836,1225,10,N,N,-,-1,-1
WESLEY.txt,150770,152040,1270,10,N,N,-,-1,-1
WESLEY.txt,150922,152054,1132,10,N,N,-,-1,-1
WESLEY.txt,150969,152155,1186,10,N,N,-,-1,-1
WESLEY.txt,151110,152378,1268,10,N,N,-,-1,-1
WESLEY.txt,151219,152485,1266,10,N,N,-,-1,-1
WESLEY.txt,151319,152582,1263,10,N,N,-,-1,-1
WESLEY.txt,151515,152594,1079,10,N,N,-,-1,-1
WESLEY.txt,151626,152739,1113,10,N,N,-,-1,-1
WESLEY.txt,151730,152893,1163,10,N,N,-,-1,-1
WESLEY.txt,151837,152901,1064,10,N,N,-,-1,-1
WESLEY.txt,152041,152913,872,10,N,N,-,-1,-1
WESLEY.txt,152054,153069,1015,10,N,N,-,-1,-1
WESLEY.txt,152156,153155,999,10,N,N,-,-1,-1
WESLEY.txt,152379,153163,784,10,N,N,-,-1,-1
WESLEY.txt,152486,153214,728,10,N,N,-,-1,-1
WESLEY.txt,152583,153325,742,10,N,N,-,-1,-1
WESLEY.txt,152594,153415,821,10,N,N,-,-1,-1
WESLEY.txt,152740,153514,774,10,N,N,-,-1,-1
WESLEY.txt,152894,153526,632,10,N,N,-,-1,-1
WESLEY.txt,152902,153661,759,10,N,N,-,-1,-1
WESLEY.txt,152913,153984,1071,10,N,N,-,-1,-1
WESLEY.txt,153070,153992,922,10,N,N,-,-1,-1
WESLEY.txt,153156,154060,904,10,N,N,-,-1,-1
WESLEY.txt,153164,154342,1178,10,N,N,-,-1,-1
WESLEY.txt,153215,154355,1140,10,N,N,-,-1,-1
WESLEY.txt,153327,154471,1144,10,N,N,-,-1,-1
WESLEY.txt,153416,154563,1147,10,N,N,-,-1,-1
WESLEY.txt,153515,154806,1291,10,N,N,-,-1,-1
WESLEY.txt,153526,154854,1328,10,N,N,-,-1,-1
WESLEY.txt,153662,154885,1223,10,N,N,-,-1,-1
WESLEY.txt,153985,154973,988,10,N,N,-,-1,-1
WESLEY.txt,153993,155049,1056,10,N,N,-,-1,-1
WESLEY.txt,154060,155153,1093,10,N,N,-,-1,-1
WESLEY.txt,154343,155165,822,10,N,N,-,-1,-1
WESLEY.txt,154355,155258,903,10,N,N,-,-1,-1
WESLEY.txt,154472,155365,893,10,N,N,-,-1,-1
WESLEY.txt,154564,155378,814,10,N,N,-,-1,-1
WESLEY.txt,154807,155461,654,10,N,N,-,-1,-1
WESLEY.txt,154855,155529,674,10,N,N,-,-1,-1
WESLEY.txt,154886,155658,772,10,N,N,-,-1,-1
WESLEY.txt,154974,155847,873,10,N,N,-,-1,-1
WESLEY.txt,155050,155864,814,10,N,N,-,-1,-1
WESLEY.txt,155154,155892,738,10,N,N,-,-1,-1
WESLEY.txt,155165,156061,896,10,N,N,-,-1,-1
WESLEY.txt,155259,156344,1085,10,N,N,-,-1,-1
WESLEY.txt,155366,156416,1050,10,N,N,-,-1,-1
WESLEY.txt,155378,156455,1077,10,N,N,-,-1,-1
WESLEY.txt,155462,156636,1174,10,N,N,-,-1,-1
WESLEY.txt,155530,156724,1194,10,N,N,-,-1,-1
WESLEY.txt,155659,156834,1175,10,N,N,-,-1,-1
WESLEY.txt,155848,156849,1001,10,N,N,-,-1,-1
WESLEY.txt,155865,156926,1061,10,N,N,-,-1,-1
WESLEY.txt,155893,156973,1080,10,N,N,-,-1,-1
WESLEY.txt,156062,157138,1076,10,N,N,-,-1,-1
WESLEY.txt,156345,157208,863,10,N,N,-,-1,-1
WESLEY.txt,156417,157275,858,10,N,N,-,-1,-1
WESLEY.txt,156456,157645,1189,10,N,N,-,-1,-1
WESLEY.txt,156637,157756,1119,10,N,N,-,-1,-1
WESLEY.txt,156725,157851,1126,10,N,N,-,-1,-1
WESLEY.txt,156835,157881,1046,10,N,N,-,-1,-1
WESLEY.txt,156850,158175,1325,10,N,N,-,-1,-1
WESLEY.txt,156927,158232,1305,10,N,N,-,-1,-1
WESLEY.txt,156974,158497,1523,10,N,N,-,-1,-1
WESLEY.txt,157139,158617,1478,10,N,N,-,-1,-1
WESLEY.txt,157208,158824,1616,10,N,N,-,-1,-1
WESLEY.txt,157276,159049,1773,10,N,N,-,-1,-1
WESLEY.txt,157646,159151,1505,10,N,N,-,-1,-1
WESLEY.txt,157756,159231,1475,10,N,N,-,-1,-1
WESLEY.txt,157852,159332,1480,10,N,N,-,-1,-1
WESLEY.txt,157881,159439,1558,10,N,N,-,-1,-1
WESLEY.txt,158176,159488,1312,10,N,N,-,-1,-1
WESLEY.txt,158233,159542,1309,10,N,N,-,-1,-1
WESLEY.txt,158498,159638,1140,10,N,N,-,-1,-1
WESLEY.txt,158619,159650,1031,10,N,N,-,-1,-1
WESLEY.txt,158825,159945,1120,10,N,N,-,-1,-1
WESLEY.txt,159050,160148,1098,10,N,N,-,-1,-1
WESLEY.txt,159151,160160,1009,10,N,N,-,-1,-1
WESLEY.txt,159232,160349,1117,10,N,N,-,-1,-1
WESLEY.txt,159333,160357,1024,10,N,N,-,-1,-1
WESLEY.txt,159441,160449,1008,10,N,N,-,-1,-1
WESLEY.txt,159489,160605,1116,10,N,N,-,-1,-1
WESLEY.txt,159543,160617,1074,10,N,N,-,-1,-1
WESLEY.txt,159639,160697,1058,10,N,N,-,-1,-1
WESLEY.txt,159650,160825,1175,10,N,N,-,-1,-1
WESLEY.txt,159946,160871,925,10,N,N,-,-1,-1
WESLEY.txt,160149,160970,821,10,N,N,-,-1,-1
WESLEY.txt,160160,161113,953,10,N,N,-,-1,-1
WESLEY.txt,160350,161163,813,10,N,N,-,-1,-1
WESLEY.txt,160358,161281,923,10,N,N,-,-1,-1
WESLEY.txt,160451,161375,924,10,N,N,-,-1,-1
WESLEY.txt,160606,161459,853,10,N,N,-,-1,-1
WESLEY.txt,160617,161561,944,10,N,N,-,-1,-1
WESLEY.txt,160698,161580,882,10,N,N,-,-1,-1
WESLEY.txt,160826,161645,819,10,N,N,-,-1,-1
WESLEY.txt,160872,161729,857,10,N,N,-,-1,-1
WESLEY.txt,160970,161813,843,10,N,N,-,-1,-1
WESLEY.txt,161114,161892,778,10,N,N,-,-1,-1
WESLEY.txt,161164,162105,941,10,N,N,-,-1,-1
WESLEY.txt,161282,162320,1038,10,N,N,-,-1,-1
WESLEY.txt,161376,162430,1054,10,N,N,-,-1,-1
WESLEY.txt,161460,162521,1061,10,N,N,-,-1,-1
WESLEY.txt,161562,162596,1034,10,N,N,-,-1,-1
WESLEY.txt,161580,162840,1260,10,N,N,-,-1,-1
WESLEY.txt,161646,163052,1406,10,N,N,-,-1,-1
WESLEY.txt,161731,163242,1511,10,N,N,-,-1,-1
WESLEY.txt,161814,163296,1482,10,N,N,-,-1,-1
WESLEY.txt,161893,163402,1509,10,N,N,-,-1,-1
WESLEY.txt,162106,163589,1483,10,N,N,-,-1,-1
WESLEY.txt,162321,163854,1533,10,N,N,-,-1,-1
WESLEY.txt,162431,163866,1435,10,N,N,-,-1,-1
WESLEY.txt,162521,163936,1415,10,N,N,-,-1,-1
WESLEY.txt,162597,164006,1409,10,N,N,-,-1,-1
WESLEY.txt,162841,164186,1345,10,N,N,-,-1,-1
WESLEY.txt,163054,164212,1158,10,N,N,-,-1,-1
WESLEY.txt,163243,164271,1028,10,N,N,-,-1,-1
WESLEY.txt,163297,164368,1071,10,N,N,-,-1,-1
WESLEY.txt,163403,164553,1150,10,N,N,-,-1,-1
WESLEY.txt,163590,164659,1069,10,N,N,-,-1,-1
WESLEY.txt,163855,164751,896,10,N,N,-,-1,-1
WESLEY.txt,163866,164765,899,10,N,N,-,-1,-1
WESLEY.txt,163937,164788,851,10,N,N,-,-1,-1
WESLEY.txt,164007,164907,900,10,N,N,-,-1,-1
WESLEY.txt,164187,164967,780,10,N,N,-,-1,-1
WESLEY.txt,164212,165034,822,10,N,N,-,-1,-1
WESLEY.txt,164272,165101,829,10,N,N,-,-1,-1
WESLEY.txt,164369,165167,798,10,N,N,-,-1,-1
WESLEY.txt,164554,165193,639,10,N,N,-,-1,-1
WESLEY.txt,164660,165306,646,10,N,N,-,-1,-1
WESLEY.txt,164752,165400,648,10,N,N,-,-1,-1
WESLEY.txt,164765,165475,710,10,N,N,-,-1,-1
WESLEY.txt,164789,165483,694,10,N,N,-,-1,-1
WESLEY.txt,164908,165561,653,10,N,N,-,-1,-1
WESLEY.txt,164968,165619,651,10,N,N,-,-1,-1
WESLEY.txt,165034,165645,611,10,N,N,-,-1,-1
WESLEY.txt,165102,165723,621,10,N,N,-,-1,-1
WESLEY.txt,165168,165818,650,10,N,N,-,-1,-1
WESLEY.txt,165194,165870,676,10,N,N,-,-1,-1
WESLEY.txt,165307,165905,598,10,N,N,-,-1,-1
WESLEY.txt,165401,165998,597,10,N,N,-,-1,-1
WESLEY.txt,165476,166037,561,10,N,N,-,-1,-1
WESLEY.txt,165484,166053,569,10,N,N,-,-1,-1
WESLEY.txt,165562,166075,513,10,N,N,-,-1,-1
WESLEY.txt,165621,166103,482,10,N,N,-,-1,-1
WESLEY.txt,165646,166113,467,10,N,N,-,-1,-1
WESLEY.txt,165724,166131,407,10,N,N,-,-1,-1
WESLEY.txt,165819,166159,340,10,N,N,-,-1,-1
WESLEY.txt,165871,166174,303,10,N,N,-,-1,-1
WESLEY.txt,165906,166192,286,10,N,N,-,-1,-1
WESLEY.txt,165999,166220,221,10,N,N,-,-1,-1
WESLEY.txt,166038,166239,201,10,N,N,-,-1,-1
WESLEY.txt,166054,166260,206,10,N,N,-,-1,-1
WESLEY.txt,166076,166295,219,10,N,N,-,-1,-1
WESLEY.txt,166104,166332,228,10,N,N,-,-1,-1
WESLEY.txt,166114,166373,259,10,N,N,-,-1,-1
WESLEY.txt,166132,166507,375,10,N,N,-,-1,-1
WESLEY.txt,166160,166530,370,10,N,N,-,-1,-1
WESLEY.txt,166175,166563,388,10,N,N,-,-1,-1
WESLEY.txt,166193,166583,390,10,N,N,-,-1,-1
WESLEY.txt,166221,166623,402,10,N,N,-,-1,-1
WESLEY.txt,166240,166658,418,10,N,N,-,-1,-1
WESLEY.txt,166261,166699,438,10,N,N,-,-1,-1
WESLEY.txt,166296,166739,443,10,N,N,-,-1,-1
WESLEY.txt,166333,166833,500,10,N,N,-,-1,-1
WESLEY.txt,166374,166857,483,10,N,N,-,-1,-1
WESLEY.txt,166508,166871,363,10,N,N,-,-1,-1
WESLEY.txt,166531,166932,401,10,N,N,-,-1,-1
WESLEY.txt,166564,166944,380,10,N,N,-,-1,-1
WESLEY.txt,166584,166961,377,10,N,N,-,-1,-1
WESLEY.txt,166624,166976,352,10,N,N,-,-1,-1
WESLEY.txt,166659,166991,332,10,N,N,-,-1,-1
WESLEY.txt,166700,167138,438,10,N,N,-,-1,-1
WESLEY.txt,166740,167191,451,10,N,N,-,-1,-1
WESLEY.txt,166834,167333,499,10,N,N,-,-1,-1
WESLEY.txt,166858,167426,568,10,N,N,-,-1,-1
WESLEY.txt,166872,167512,640,10,N,N,-,-1,-1
WESLEY.txt,166933,167591,658,10,N,N,-,-1,-1
WESLEY.txt,166945,167678,733,10,N,N,-,-1,-1
WESLEY.txt,166962,167793,831,10,N,N,-,-1,-1
WESLEY.txt,166977,167870,893,10,N,N,-,-1,-1
WESLEY.txt,166992,167958,966,10,N,N,-,-1,-1
WESLEY.txt,167139,167989,850,10,N,N,-,-1,-1
WESLEY.txt,167192,168026,834,10,N,N,-,-1,-1
WESLEY.txt,167334,168066,732,10,N,N,-,-1,-1
WESLEY.txt,167426,168219,793,10,N,N,-,-1,-1
WESLEY.txt,167512,168313,801,10,N,N,-,-1,-1
WESLEY.txt,167592,168344,752,10,N,N,-,-1,-1
WESLEY.txt,167680,168462,782,10,N,N,-,-1,-1
WESLEY.txt,167794,168500,706,10,N,N,-,-1,-1
WESLEY.txt,167871,168597,726,10,N,N,-,-1,-1
WESLEY.txt,167959,168773,814,10,N,N,-,-1,-1
WESLEY.txt,167990,168785,795,10,N,N,-,-1,-1
WESLEY.txt,168027,168844,817,10,N,N,-,-1,-1
WESLEY.txt,168067,169049,982,10,N,N,-,-1,-1
WESLEY.txt,168220,169117,897,10,N,N,-,-1,-1
WESLEY.txt,168314,169182,868,10,N,N,-,-1,-1
WESLEY.txt,168345,169221,876,10,N,N,-,-1,-1
WESLEY.txt,168463,169338,875,10,N,N,-,-1,-1
WESLEY.txt,168501,169420,919,10,N,N,-,-1,-1
WESLEY.txt,168598,169553,955,10,N,N,-,-1,-1
WESLEY.txt,168774,169574,800,10,N,N,-,-1,-1
WESLEY.txt,168785,169596,811,10,N,N,-,-1,-1
WESLEY.txt,168845,169631,786,10,N,N,-,-1,-1
WESLEY.txt,169050,169801,751,10,N,N,-,-1,-1
WESLEY.txt,169118,169888,770,10,N,N,-,-1,-1
WESLEY.txt,169183,170011,828,10,N,N,-,-1,-1
WESLEY.txt,169222,170060,838,10,N,N,-,-1,-1
WESLEY.txt,169339,170142,803,10,N,N,-,-1,-1
WESLEY.txt,169421,170150,729,10,N,N,-,-1,-1
WESLEY.txt,169554,170171,617,10,N,N,-,-1,-1
WESLEY.txt,169575,170196,621,10,N,N,-,-1,-1
WESLEY.txt,169598,170214,616,10,N,N,-,-1,-1
WESLEY.txt,169631,170226,595,10,N,N,-,-1,-1
WESLEY.txt,169802,170234,432,10,N,N,-,-1,-1
WESLEY.txt,169889,170252,363,10,N,N,-,-1,-1
WESLEY.txt,170012,170275,263,10,N,N,-,-1,-1
WESLEY.txt,170061,170297,236,10,N,N,-,-1,-1
WESLEY.txt,170143,170428,285,10,N,N,-,-1,-1
WESLEY.txt,170151,170895,744,10,N,N,-,-1,-1
WESLEY.txt,170172,171097,925,10,N,N,-,-1,-1
WESLEY.txt,170197,171118,921,10,N,N,-,-1,-1
WESLEY.txt,170215,171276,1061,10,N,N,-,-1,-1
WESLEY.txt,170228,171371,1143,10,N,N,-,-1,-1
WESLEY.txt,170234,171426,1192,10,N,N,-,-1,-1
WESLEY.txt,170253,171456,1203,10,N,N,-,-1,-1
WESLEY.txt,170276,171531,1255,10,N,N,-,-1,-1
WESLEY.txt,170297,171638,1341,10,N,N,-,-1,-1
WESLEY.txt,170429,171731,1302,10,N,N,-,-1,-1
WESLEY.txt,170896,171757,861,10,N,N,-,-1,-1
WESLEY.txt,171098,171829,731,10,N,N,-,-1,-1
WESLEY.txt,171119,172038,919,10,N,N,-,-1,-1
WESLEY.txt,171277,172267,990,10,N,N,-,-1,-1
WESLEY.txt,171372,172440,1068,10,N,N,-,-1,-1
WESLEY.txt,171427,172618,1191,10,N,N,-,-1,-1
WESLEY.txt,171457,172816,1359,10,N,N,-,-1,-1
WESLEY.txt,171532,172920,1388,10,N,N,-,-1,-1
WESLEY.txt,171639,172986,1347,10,N,N,-,-1,-1
WESLEY.txt,171732,173115,1383,10,N,N,-,-1,-1
WESLEY.txt,171758,173247,1489,10,N,N,-,-1,-1
WESLEY.txt,171830,173347,1517,10,N,N,-,-1,-1
WESLEY.txt,172039,173368,1329,10,N,N,-,-1,-1
WESLEY.txt,172268,173550,1282,10,N,N,-,-1,-1
WESLEY.txt,172441,173594,1153,10,N,N,-,-1,-1
WESLEY.txt,172619,173829,1210,10,N,N,-,-1,-1
WESLEY.txt,172817,173858,1041,10,N,N,-,-1,-1
WESLEY.txt,172921,173927,1006,10,N,N,-,-1,-1
WESLEY.txt,172987,174134,1147,10,N,N,-,-1,-1
WESLEY.txt,173116,174146,1030,10,N,N,-,-1,-1
WESLEY.txt,173248,174193,945,10,N,N,-,-1,-1
WESLEY.txt,173348,174440,1092,10,N,N,-,-1,-1
WESLEY.txt,173368,174623,1255,10,N,N,-,-1,-1
WESLEY.txt,173551,174722,1171,10,N,N,-,-1,-1
WESLEY.txt,173595,174842,1247,10,N,N,-,-1,-1
WESLEY.txt,173830,174909,1079,10,N,N,-,-1,-1
WESLEY.txt,173859,175085,1226,10,N,N,-,-1,-1
WESLEY.txt,173928,175277,1349,10,N,N,-,-1,-1
WESLEY.txt,174135,175325,1190,10,N,N,-,-1,-1
WESLEY.txt,174146,175353,1207,10,N,N,-,-1,-1
WESLEY.txt,174194,175450,1256,10,N,N,-,-1,-1
WESLEY.txt,174441,175534,1093,10,N,N,-,-1,-1
WESLEY.txt,174624,175670,1046,10,N,N,-,-1,-1
WESLEY.txt,174722,175728,1006,10,N,N,-,-1,-1
WESLEY.txt,174843,175742,899,10,N,N,-,-1,-1
WESLEY.txt,174910,175826,916,10,N,N,-,-1,-1
WESLEY.txt,175086,175887,801,10,N,N,-,-1,-1
WESLEY.txt,175278,175969,691,10,N,N,-,-1,-1
WESLEY.txt,175326,176031,705,10,N,N,-,-1,-1
WESLEY.txt,175354,176276,922,10,N,N,-,-1,-1
WESLEY.txt,175451,176358,907,10,N,N,-,-1,-1
WESLEY.txt,175535,176389,854,10,N,N,-,-1,-1
WESLEY.txt,175671,176549,878,10,N,N,-,-1,-1
WESLEY.txt,175729,176723,994,10,N,N,-,-1,-1
WESLEY.txt,175742,176798,1056,10,N,N,-,-1,-1
WESLEY.txt,175827,176972,1145,10,N,N,-,-1,-1
WESLEY.txt,175888,177047,1159,10,N,N,-,-1,-1
WESLEY.txt,175971,177102,1131,10,N,N,-,-1,-1
WESLEY.txt,176032,177202,1170,10,N,N,-,-1,-1
WESLEY.txt,176277,177394,1117,10,N,N,-,-1,-1
WESLEY.txt,176359,177441,1082,10,N,N,-,-1,-1
WESLEY.txt,176389,177553,1164,10,N,N,-,-1,-1
WESLEY.txt,176550,177733,1183,10,N,N,-,-1,-1
WESLEY.txt,176724,177768,1044,10,N,N,-,-1,-1
WESLEY.txt,176800,177920,1120,10,N,N,-,-1,-1
WESLEY.txt,176973,178035,1062,10,N,N,-,-1,-1
WESLEY.txt,177047,178048,1001,10,N,N,-,-1,-1
WESLEY.txt,177103,178235,1132,10,N,N,-,-1,-1
WESLEY.txt,177203,178325,1122,10,N,N,-,-1,-1
WESLEY.txt,177395,178501,1106,10,N,N,-,-1,-1
WESLEY.txt,177442,178595,1153,10,N,N,-,-1,-1
WESLEY.txt,177554,178691,1137,10,N,N,-,-1,-1
WESLEY.txt,177734,178854,1120,10,N,N,-,-1,-1
WESLEY.txt,177769,179139,1370,10,N,N,-,-1,-1
WESLEY.txt,177921,179257,1336,10,N,N,-,-1,-1
WESLEY.txt,178036,179269,1233,10,N,N,-,-1,-1
WESLEY.txt,178048,179494,1446,10,N,N,-,-1,-1
WESLEY.txt,178236,179533,1297,10,N,N,-,-1,-1
WESLEY.txt,178326,179586,1260,10,N,N,-,-1,-1
WESLEY.txt,178502,179633,1131,10,N,N,-,-1,-1
WESLEY.txt,178596,179736,1140,10,N,N,-,-1,-1
WESLEY.txt,178691,179741,1050,10,N,N,-,-1,-1
WESLEY.txt,178855,179775,920,10,N,N,-,-1,-1
WESLEY.txt,179140,179816,676,10,N,N,-,-1,-1
WESLEY.txt,179258,179862,604,10,N,N,-,-1,-1
WESLEY.txt,179269,179966,697,10,N,N,-,-1,-1
WESLEY.txt,179496,179986,490,10,N,N,-,-1,-1
WESLEY.txt,179534,180183,649,10,N,N,-,-1,-1
WESLEY.txt,179587,180366,779,10,N,N,-,-1,-1
WESLEY.txt,179634,180414,780,10,N,N,-,-1,-1
WESLEY.txt,179737,180458,721,10,N,N,-,-1,-1
WESLEY.txt,179742,180514,772,10,N,N,-,-1,-1
WESLEY.txt,179777,180534,757,10,N,N,-,-1,-1
WESLEY.txt,179817,180696,879,10,N,N,-,-1,-1
WESLEY.txt,179863,180740,877,10,N,N,-,-1,-1
WESLEY.txt,179967,180979,1012,10,N,N,-,-1,-1
WESLEY.txt,179986,181156,1170,10,N,N,-,-1,-1
WESLEY.txt,180184,181247,1063,10,N,N,-,-1,-1
WESLEY.txt,180367,181264,897,10,N,N,-,-1,-1
WESLEY.txt,180415,181309,894,10,N,N,-,-1,-1
WESLEY.txt,180459,181356,897,10,N,N,-,-1,-1
WESLEY.txt,180515,181418,903,10,N,N,-,-1,-1
WESLEY.txt,180534,181471,937,10,N,N,-,-1,-1
WESLEY.txt,180697,181488,791,10,N,N,-,-1,-1
WESLEY.txt,180741,181943,1202,10,N,N,-,-1,-1
WESLEY.txt,180980,182030,1050,10,N,N,-,-1,-1
WESLEY.txt,181157,182033,876,10,N,N,-,-1,-1
WESLEY.txt,181248,182121,873,10,N,N,-,-1,-1
WESLEY.txt,181264,182241,977,10,N,N,-,-1,-1
WESLEY.txt,181310,182347,1037,10,N,N,-,-1,-1
WESLEY.txt,181357,182447,1090,10,N,N,-,-1,-1
WESLEY.txt,181419,182632,1213,10,N,N,-,-1,-1
WESLEY.txt,181472,182694,1222,10,N,N,-,-1,-1
WESLEY.txt,181488,182728,1240,10,N,N,-,-1,-1
WESLEY.txt,181944,182885,941,10,N,N,-,-1,-1
WESLEY.txt,182031,182897,866,10,N,N,-,-1,-1
WESLEY.txt,182034,182978,944,10,N,N,-,-1,-1
WESLEY.txt,182122,183066,944,10,N,N,-,-1,-1
WESLEY.txt,182242,183267,1025,10,N,N,-,-1,-1
WESLEY.txt,182348,183371,1023,10,N,N,-,-1,-1
WESLEY.txt,182448,183458,1010,10,N,N,-,-1,-1
WESLEY.txt,182633,183603,970,10,N,N,-,-1,-1
WESLEY.txt,182694,183642,948,10,N,N,-,-1,-1
WESLEY.txt,182730,183722,992,10,N,N,-,-1,-1
WESLEY.txt,182886,183771,885,10,N,N,-,-1,-1
WESLEY.txt,182898,183898,1000,10,N,N,-,-1,-1
WESLEY.txt,182979,184074,1095,10,N,N,-,-1,-1
WESLEY.txt,183067,184098,1031,10,N,N,-,-1,-1
WESLEY.txt,183268,184107,839,10,N,N,-,-1,-1
WESLEY.txt,183372,184267,895,10,N,N,-,-1,-1
WESLEY.txt,183459,184372,913,10,N,N,-,-1,-1
WESLEY.txt,183604,184485,881,10,N,N,-,-1,-1
WESLEY.txt,183643,184534,891,10,N,N,-,-1,-1
WESLEY.txt,183722,184595,873,10,N,N,-,-1,-1
WESLEY.txt,183772,184607,835,10,N,N,-,-1,-1
WESLEY.txt,183899,184802,903,10,N,N,-,-1,-1
WESLEY.txt,184075,184899,824,10,N,N,-,-1,-1
WESLEY.txt,184099,185063,964,10,N,N,-,-1,-1
WESLEY.txt,184108,185106,998,10,N,N,-,-1,-1
WESLEY.txt,184268,185237,969,10,N,N,-,-1,-1
WESLEY.txt,184373,185479,1106,10,N,N,-,-1,-1
WESLEY.txt,184486,185486,1000,10,N,N,-,-1,-1
WESLEY.txt,184535,185583,1048,10,N,N,-,-1,-1
WESLEY.txt,184596,185595,999,10,N,N,-,-1,-1
WESLEY.txt,184607,185721,1114,10,N,N,-,-1,-1
WESLEY.txt,184803,185744,941,10,N,N,-,-1,-1
WESLEY.txt,184901,185909,1008,10,N,N,-,-1,-1
WESLEY.txt,185064,185955,891,10,N,N,-,-1,-1
WESLEY.txt,185107,185983,876,10,N,N,-,-1,-1
WESLEY.txt,185238,186264,1026,10,N,N,-,-1,-1
WESLEY.txt,185480,186384,904,10,N,N,-,-1,-1
WESLEY.txt,185487,186487,1000,10,N,N,-,-1,-1
WESLEY.txt,185584,186499,915,10,N,N,-,-1,-1
WESLEY.txt,185595,186652,1057,10,N,N,-,-1,-1
WESLEY.txt,185722,186753,1031,10,N,N,-,-1,-1
WESLEY.txt,185745,186959,1214,10,N,N,-,-1,-1
WESLEY.txt,185910,186982,1072,10,N,N,-,-1,-1
WESLEY.txt,185956,187089,1133,10,N,N,-,-1,-1
WESLEY.txt,185984,187121,1137,10,N,N,-,-1,-1
WESLEY.txt,186265,187212,947,10,N,N,-,-1,-1
WESLEY.txt,186384,187316,932,10,N,N,-,-1,-1
WESLEY.txt,186488,187356,868,10,N,N,-,-1,-1
WESLEY.txt,186500,187396,896,10,N,N,-,-1,-1
WESLEY.txt,186653,187405,752,10,N,N,-,-1,-1
WESLEY.txt,186754,187412,658,10,N,N,-,-1,-1
WESLEY.txt,186960,187443,483,10,N,N,-,-1,-1
WESLEY.txt,186982,187812,830,10,N,N,-,-1,-1
WESLEY.txt,187090,188124,1034,10,N,N,-,-1,-1
WESLEY.txt,187122,188171,1049,10,N,N,-,-1,-1
WESLEY.txt,187213,188265,1052,10,N,N,-,-1,-1
WESLEY.txt,187317,188389,1072,10,N,N,-,-1,-1
WESLEY.txt,187357,188474,1117,10,N,N,-,-1,-1
WESLEY.txt,187397,188621,1224,10,N,N,-,-1,-1
WESLEY.txt,187406,188852,1446,10,N,N,-,-1,-1
WESLEY.txt,187413,188916,1503,10,N,N,-,-1,-1
WESLEY.txt,187443,188927,1484,10,N,N,-,-1,-1
WESLEY.txt,187813,188953,1140,10,N,N,-,-1,-1
WESLEY.txt,188125,189100,975,10,N,N,-,-1,-1
WESLEY.txt,188172,189271,1099,10,N,N,-,-1,-1
WESLEY.txt,188265,189570,1305,10,N,N,-,-1,-1
WESLEY.txt,188390,189652,1262,10,N,N,-,-1,-1
WESLEY.txt,188475,189683,1208,10,N,N,-,-1,-1
WESLEY.txt,188622,189774,1152,10,N,N,-,-1,-1
WESLEY.txt,188853,189862,1009,10,N,N,-,-1,-1
WESLEY.txt,188917,189952,1035,10,N,N,-,-1,-1
WESLEY.txt,188927,190116,1189,10,N,N,-,-1,-1
WESLEY.txt,188954,190198,1244,10,N,N,-,-1,-1
WESLEY.txt,189101,190211,1110,10,N,N,-,-1,-1
WESLEY.txt,189272,190281,1009,10,N,N,-,-1,-1
WESLEY.txt,189571,190293,722,10,N,N,-,-1,-1
WESLEY.txt,189653,190332,679,10,N,N,-,-1,-1
WESLEY.txt,189683,190471,788,10,N,N,-,-1,-1
WESLEY.txt,189775,190521,746,10,N,N,-,-1,-1
WESLEY.txt,189863,190635,772,10,N,N,-,-1,-1
WESLEY.txt,189953,190717,764,10,N,N,-,-1,-1
WESLEY.txt,190117,190809,692,10,N,N,-,-1,-1
WESLEY.txt,190199,190816,617,10,N,N,-,-1,-1
WESLEY.txt,190212,190998,786,10,N,N,-,-1,-1
WESLEY.txt,190282,191050,768,10,N,N,-,-1,-1
WESLEY.txt,190294,191154,860,10,N,N,-,-1,-1
WESLEY.txt,190333,191213,880,10,N,N,-,-1,-1
WESLEY.txt,190472,191326,854,10,N,N,-,-1,-1
WESLEY.txt,190522,191340,818,10,N,N,-,-1,-1
WESLEY.txt,190636,191385,749,10,N,N,-,-1,-1
WESLEY.txt,190717,191470,753,10,N,N,-,-1,-1
WESLEY.txt,190810,191548,738,10,N,N,-,-1,-1
WESLEY.txt,190817,191629,812,10,N,N,-,-1,-1
WESLEY.txt,190999,191718,719,10,N,N,-,-1,-1
WESLEY.txt,191051,191802,751,10,N,N,-,-1,-1
WESLEY.txt,191155,191831,676,10,N,N,-,-1,-1
WESLEY.txt,191214,192190,976,10,N,N,-,-1,-1
WESLEY.txt,191327,192392,1065,10,N,N,-,-1,-1
WESLEY.txt,191340,192663,1323,10,N,N,-,-1,-1
WESLEY.txt,191386,192725,1339,10,N,N,-,-1,-1
WESLEY.txt,191471,192865,1394,10,N,N,-,-1,-1
WESLEY.txt,191549,192955,1406,10,N,N,-,-1,-1
WESLEY.txt,191630,193052,1422,10,N,N,-,-1,-1
WESLEY.txt,191719,193126,1407,10,N,N,-,-1,-1
WESLEY.txt,191803,193261,1458,10,N,N,-,-1,-1
WESLEY.txt,191831,193330,1499,10,N,N,-,-1,-1
WESLEY.txt,192191,193416,1225,10,N,N,-,-1,-1
WESLEY.txt,192393,193582,1189,10,N,N,-,-1,-1
WESLEY.txt,192664,193766,1102,10,N,N,-,-1,-1
WESLEY.txt,192726,193953,1227,10,N,N,-,-1,-1
WESLEY.txt,192866,193966,1100,10,N,N,-,-1,-1
WESLEY.txt,192956,194022,1066,10,N,N,-,-1,-1
WESLEY.txt,193053,194287,1234,10,N,N,-,-1,-1
WESLEY.txt,193127,194497,1370,10,N,N,-,-1,-1
WESLEY.txt,193262,194598,1336,10,N,N,-,-1,-1
WESLEY.txt,193331,194619,1288,10,N,N,-,-1,-1
WESLEY.txt,193417,195096,1679,10,N,N,-,-1,-1
WESLEY.txt,193583,195114,1531,10,N,N,-,-1,-1
WESLEY.txt,193767,195185,1418,10,N,N,-,-1,-1
WESLEY.txt,193954,195266,1312,10,N,N,-,-1,-1
WESLEY.txt,193966,195488,1522,10,N,N,-,-1,-1
WESLEY.txt,194023,195654,1631,10,N,N,-,-1,-1
WESLEY.txt,194288,195905,1617,10,N,N,-,-1,-1
WESLEY.txt,194498,196173,1675,10,N,N,-,-1,-1
WESLEY.txt,194599,196324,1725,10,N,N,-,-1,-1
WESLEY.txt,194619,196528,1909,10,N,N,-,-1,-1
WESLEY.txt,195097,196619,1522,10,N,N,-,-1,-1
WESLEY.txt,195114,196631,1517,10,N,N,-,-1,-1
WESLEY.txt,195186,196717,1531,10,N,N,-,-1,-1
WESLEY.txt,195267,196732,1465,10,N,N,-,-1,-1
WESLEY.txt,195489,196869,1380,10,N,N,-,-1,-1
WESLEY.txt,195656,196883,1227,10,N,N,-,-1,-1
WESLEY.txt,195906,197050,1144,10,N,N,-,-1,-1
WESLEY.txt,196174,197287,1113,10,N,N,-,-1,-1
WESLEY.txt,196325,197473,1148,10,N,N,-,-1,-1
WESLEY.txt,196529,197490,961,10,N,N,-,-1,-1
WESLEY.txt,196620,197530,910,10,N,N,-,-1,-1
WESLEY.txt,196631,197730,1099,10,N,N,-,-1,-1
WESLEY.txt,196718,197820,1102,10,N,N,-,-1,-1
WESLEY.txt,196733,197878,1145,10,N,N,-,-1,-1
WESLEY.txt,196870,198109,1239,10,N,N,-,-1,-1
WESLEY.txt,196883,198172,1289,10,N,N,-,-1,-1
WESLEY.txt,197051,198187,1136,10,N,N,-,-1,-1
WESLEY.txt,197288,198268,980,10,N,N,-,-1,-1
WESLEY.txt,197474,198371,897,10,N,N,-,-1,-1
WESLEY.txt,197490,198459,969,10,N,N,-,-1,-1
WESLEY.txt,197531,198561,1030,10,N,N,-,-1,-1
WESLEY.txt,197731,198633,902,10,N,N,-,-1,-1
WESLEY.txt,197821,198705,884,10,N,N,-,-1,-1
WESLEY.txt,197879,198821,942,10,N,N,-,-1,-1
WESLEY.txt,198110,198904,794,10,N,N,-,-1,-1
WESLEY.txt,198173,198978,805,10,N,N,-,-1,-1
WESLEY.txt,198187,199061,874,10,N,N,-,-1,-1
WESLEY.txt,198269,199239,970,10,N,N,-,-1,-1
WESLEY.txt,198372,199267,895,10,N,N,-,-1,-1
WESLEY.txt,198460,199420,960,10,N,N,-,-1,-1
WESLEY.txt,198562,199520,958,10,N,N,-,-1,-1
WESLEY.txt,198634,199744,1110,10,N,N,-,-1,-1
WESLEY.txt,198705,199860,1155,10,N,N,-,-1,-1
WESLEY.txt,198822,199973,1151,10,N,N,-,-1,-1
WESLEY.txt,198905,200017,1112,10,N,N,-,-1,-1
WESLEY.txt,198978,200068,1090,10,N,N,-,-1,-1
WESLEY.txt,199062,200217,1155,10,N,N,-,-1,-1
WESLEY.txt,199240,200482,1242,10,N,N,-,-1,-1
WESLEY.txt,199268,200555,1287,10,N,N,-,-1,-1
WESLEY.txt,199422,200643,1221,10,N,N,-,-1,-1
WESLEY.txt,199521,200739,1218,10,N,N,-,-1,-1
WESLEY.txt,199745,200927,1182,10,N,N,-,-1,-1
WESLEY.txt,199861,201035,1174,10,N,N,-,-1,-1
WESLEY.txt,199974,201042,1068,10,N,N,-,-1,-1
WESLEY.txt,200018,201141,1123,10,N,N,-,-1,-1
WESLEY.txt,200069,201204,1135,10,N,N,-,-1,-1
WESLEY.txt,200218,201386,1168,10,N,N,-,-1,-1
WESLEY.txt,200483,201486,1003,10,N,N,-,-1,-1
WESLEY.txt,200556,201590,1034,10,N,N,-,-1,-1
WESLEY.txt,200644,201785,1141,10,N,N,-,-1,-1
WESLEY.txt,200741,201874,1133,10,N,N,-,-1,-1
WESLEY.txt,200928,201948,1020,10,N,N,-,-1,-1
WESLEY.txt,201036,202028,992,10,N,N,-,-1,-1
WESLEY.txt,201043,202070,1027,10,N,N,-,-1,-1
WESLEY.txt,201142,202115,973,10,N,N,-,-1,-1
WESLEY.txt,201205,202158,953,10,N,N,-,-1,-1
WESLEY.txt,201387,202197,810,10,N,N,-,-1,-1
WESLEY.txt,201487,202208,721,10,N,N,-,-1,-1
WESLEY.txt,201590,202343,753,10,N,N,-,-1,-1
WESLEY.txt,201786,202391,605,10,N,N,-,-1,-1
WESLEY.txt,201875,202484,609,10,N,N,-,-1,-1
WESLEY.txt,201949,202536,587,10,N,N,-,-1,-1
WESLEY.txt,202029,202602,573,10,N,N,-,-1,-1
WESLEY.txt,202071,202784,713,10,N,N,-,-1,-1
WESLEY.txt,202116,202978,862,10,N,N,-,-1,-1
WESLEY.txt,202159,203073,914,10,N,N,-,-1,-1
WESLEY.txt,202198,203262,1064,10,N,N,-,-1,-1
WESLEY.txt,202208,203270,1062,10,N,N,-,-1,-1
WESLEY.txt,202344,203383,1039,10,N,N,-,-1,-1
WESLEY.txt,202392,203589,1197,10,N,N,-,-1,-1
WESLEY.txt,202485,203706,1221,10,N,N,-,-1,-1
WESLEY.txt,202537,203827,1290,10,N,N,-,-1,-1
WESLEY.txt,202603,203879,1276,10,N,N,-,-1,-1
WESLEY.txt,202785,203968,1183,10,N,N,-,-1,-1
WESLEY.txt,202979,204017,1038,10,N,N,-,-1,-1
WESLEY.txt,203074,204053,979,10,N,N,-,-1,-1
WESLEY.txt,203263,204161,898,10,N,N,-,-1,-1
WESLEY.txt,203271,204175,904,10,N,N,-,-1,-1
WESLEY.txt,203383,204250,867,10,N,N,-,-1,-1
WESLEY.txt,203590,204420,830,10,N,N,-,-1,-1
WESLEY.txt,203707,204590,883,10,N,N,-,-1,-1
WESLEY.txt,203828,204687,859,10,N,N,-,-1,-1
WESLEY.txt,203880,204777,897,10,N,N,-,-1,-1
WESLEY.txt,203969,204868,899,10,N,N,-,-1,-1
WESLEY.txt,204018,205064,1046,10,N,N,-,-1,-1
WESLEY.txt,204054,205076,1022,10,N,N,-,-1,-1
WESLEY.txt,204162,205138,976,10,N,N,-,-1,-1
WESLEY.txt,204175,205233,1058,10,N,N,-,-1,-1
WESLEY.txt,204251,205439,1188,10,N,N,-,-1,-1
WESLEY.txt,204421,205538,1117,10,N,N,-,-1,-1
WESLEY.txt,204591,205748,1157,10,N,N,-,-1,-1
WESLEY.txt,204688,205833,1145,10,N,N,-,-1,-1
WESLEY.txt,204778,205925,1147,10,N,N,-,-1,-1
WESLEY.txt,204869,206012,1143,10,N,N,-,-1,-1
WESLEY.txt,205065,206124,1059,10,N,N,-,-1,-1
WESLEY.txt,205076,206418,1342,10,N,N,-,-1,-1
WESLEY.txt,205139,206557,1418,10,N,N,-,-1,-1
WESLEY.txt,205234,206603,1369,10,N,N,-,-1,-1
WESLEY.txt,205440,206712,1272,10,N,N,-,-1,-1
WESLEY.txt,205539,206724,1185,10,N,N,-,-1,-1
WESLEY.txt,205749,206804,1055,10,N,N,-,-1,-1
WESLEY.txt,205834,206831,997,10,N,N,-,-1,-1
WESLEY.txt,205926,206907,981,10,N,N,-,-1,-1
WESLEY.txt,206013,206999,986,10,N,N,-,-1,-1
WESLEY.txt,206125,207165,1040,10,N,N,-,-1,-1
WESLEY.txt,206419,207335,916,10,N,N,-,-1,-1
WESLEY.txt,206558,207353,795,10,N,N,-,-1,-1
WESLEY.txt,206604,207522,918,10,N,N,-,-1,-1
WESLEY.txt,206713,207725,1012,10,N,N,-,-1,-1
WESLEY.txt,206724,207985,1261,10,N,N,-,-1,-1
WESLEY.txt,206805,208077,1272,10,N,N,-,-1,-1
WESLEY.txt,206832,208272,1440,10,N,N,-,-1,-1
WESLEY.txt,206908,208424,1516,10,N,N,-,-1,-1
WESLEY.txt,207000,208559,1559,10,N,N,-,-1,-1
WESLEY.txt,207166,208756,1590,10,N,N,-,-1,-1
WESLEY.txt,207336,208825,1489,10,N,N,-,-1,-1
WESLEY.txt,207353,208897,1544,10,N,N,-,-1,-1
WESLEY.txt,207523,209132,1609,10,N,N,-,-1,-1
WESLEY.txt,207726,209315,1589,10,N,N,-,-1,-1
WESLEY.txt,207986,209576,1590,10,N,N,-,-1,-1
WESLEY.txt,208078,209747,1669,10,N,N,-,-1,-1
WESLEY.txt,208273,210331,2058,10,N,N,-,-1,-1
WESLEY.txt,208425,210379,1954,10,N,N,-,-1,-1
WESLEY.txt,208560,210445,1885,10,N,N,-,-1,-1
WESLEY.txt,208757,210642,1885,10,N,N,-,-1,-1
WESLEY.txt,208826,210732,1906,10,N,N,-,-1,-1
WESLEY.txt,208898,210942,2044,10,N,N,-,-1,-1
WESLEY.txt,209134,210999,1865,10,N,N,-,-1,-1
WESLEY.txt,209316,211200,1884,10,N,N,-,-1,-1
WESLEY.txt,209577,211314,1737,10,N,N,-,-1,-1
WESLEY.txt,209748,211493,1745,10,N,N,-,-1,-1
WESLEY.txt,210332,211680,1348,10,N,N,-,-1,-1
WESLEY.txt,210381,211851,1470,10,N,N,-,-1,-1
WESLEY.txt,210446,211904,1458,10,N,N,-,-1,-1
WESLEY.txt,210643,212023,1380,10,N,N,-,-1,-1
WESLEY.txt,210733,212112,1379,10,N,N,-,-1,-1
WESLEY.txt,210944,212161,1217,10,N,N,-,-1,-1
WESLEY.txt,211000,212212,1212,10,N,N,-,-1,-1
WESLEY.txt,211201,212263,1062,10,N,N,-,-1,-1
WESLEY.txt,211315,212345,1030,10,N,N,-,-1,-1
WESLEY.txt,211494,212421,927,10,N,N,-,-1,-1
WESLEY.txt,211681,212620,939,10,N,N,-,-1,-1
WESLEY.txt,211852,212671,819,10,N,N,-,-1,-1
WESLEY.txt,211905,212718,813,10,N,N,-,-1,-1
WESLEY.txt,212024,212794,770,10,N,N,-,-1,-1
WESLEY.txt,212113,212842,729,10,N,N,-,-1,-1
WESLEY.txt,212163,212960,797,10,N,N,-,-1,-1
WESLEY.txt,212213,213023,810,10,N,N,-,-1,-1
WESLEY.txt,212265,213068,803,10,N,N,-,-1,-1
WESLEY.txt,212346,213159,813,10,N,N,-,-1,-1
WESLEY.txt,212422,213247,825,10,N,N,-,-1,-1
WESLEY.txt,212621,213355,734,10,N,N,-,-1,-1
WESLEY.txt,212672,213576,904,10,N,N,-,-1,-1
WESLEY.txt,212719,213652,933,10,N,N,-,-1,-1
WESLEY.txt,212795,213774,979,10,N,N,-,-1,-1
WESLEY.txt,212844,214105,1261,10,N,N,-,-1,-1
WESLEY.txt,212961,214360,1399,10,N,N,-,-1,-1
WESLEY.txt,213024,214542,1518,10,N,N,-,-1,-1
WESLEY.txt,213069,214586,1517,10,N,N,-,-1,-1
WESLEY.txt,213160,214738,1578,10,N,N,-,-1,-1
WESLEY.txt,213248,214924,1676,10,N,N,-,-1,-1
WESLEY.txt,213356,215281,1925,10,N,N,-,-1,-1
WESLEY.txt,213577,215365,1788,10,N,N,-,-1,-1
WESLEY.txt,213653,215545,1892,10,N,N,-,-1,-1
WESLEY.txt,213775,215726,1951,10,N,N,-,-1,-1
WESLEY.txt,214106,215841,1735,10,N,N,-,-1,-1
WESLEY.txt,214361,215900,1539,10,N,N,-,-1,-1
WESLEY.txt,214543,216027,1484,10,N,N,-,-1,-1
WESLEY.txt,214587,216130,1543,10,N,N,-,-1,-1
WESLEY.txt,214739,216326,1587,10,N,N,-,-1,-1
WESLEY.txt,214925,216660,1735,10,N,N,-,-1,-1
WESLEY.txt,215282,216978,1696,10,N,N,-,-1,-1
WESLEY.txt,215366,217095,1729,10,N,N,-,-1,-1
WESLEY.txt,215546,217289,1743,10,N,N,-,-1,-1
WESLEY.txt,215727,217505,1778,10,N,N,-,-1,-1
WESLEY.txt,215842,217713,1871,10,N,N,-,-1,-1
WESLEY.txt,215901,217884,1983,10,N,N,-,-1,-1
WESLEY.txt,216028,218031,2003,10,N,N,-,-1,-1
WESLEY.txt,216131,218178,2047,10,N,N,-,-1,-1
WESLEY.txt,216327,218362,2035,10,N,N,-,-1,-1
WESLEY.txt,216661,218596,1935,10,N,N,-,-1,-1
WESLEY.txt,216979,218794,1815,10,N,N,-,-1,-1
WESLEY.txt,217096,219015,1919,10,N,N,-,-1,-1
WESLEY.txt,217290,219051,1761,10,N,N,-,-1,-1
WESLEY.txt,217506,219263,1757,10,N,N,-,-1,-1
WESLEY.txt,217714,219542,1828,10,N,N,-,-1,-1
WESLEY.txt,217885,219580,1695,10,N,N,-,-1,-1
WESLEY.txt,218032,219696,1664,10,N,N,-,-1,-1
WESLEY.txt,218179,219872,1693,10,N,N,-,-1,-1
WESLEY.txt,218363,220287,1924,10,N,N,-,-1,-1
WESLEY.txt,218597,220394,1797,10,N,N,-,-1,-1
WESLEY.txt,218795,220556,1761,10,N,N,-,-1,-1
WESLEY.txt,219016,220690,1674,10,N,N,-,-1,-1
WESLEY.txt,219052,220863,1811,10,N,N,-,-1,-1
WESLEY.txt,219264,220986,1722,10,N,N,-,-1,-1
WESLEY.txt,219543,221099,1556,10,N,N,-,-1,-1
WESLEY.txt,219581,221269,1688,10,N,N,-,-1,-1
WESLEY.txt,219697,221539,1842,10,N,N,-,-1,-1
WESLEY.txt,219873,221899,2026,10,N,N,-,-1,-1
WESLEY.txt,220288,222084,1796,10,N,N,-,-1,-1
WESLEY.txt,220395,222229,1834,10,N,N,-,-1,-1
WESLEY.txt,220557,222446,1889,10,N,N,-,-1,-1
WESLEY.txt,220691,222650,1959,10,N,N,-,-1,-1
WESLEY.txt,220864,222962,2098,10,N,N,-,-1,-1
WESLEY.txt,220987,223007,2020,10,N,N,-,-1,-1
WESLEY.txt,221100,223175,2075,10,N,N,-,-1,-1
WESLEY.txt,221270,223395,2125,10,N,N,-,-1,-1
WESLEY.txt,221540,223690,2150,10,N,N,-,-1,-1
WESLEY.txt,221900,223809,1909,10,N,N,-,-1,-1
WESLEY.txt,222085,224002,1917,10,N,N,-,-1,-1
WESLEY.txt,222230,224040,1810,10,N,N,-,-1,-1
WESLEY.txt,222447,224077,1630,10,N,N,-,-1,-1
WESLEY.txt,222651,224236,1585,10,N,N,-,-1,-1
WESLEY.txt,222963,224418,1455,10,N,N,-,-1,-1
WESLEY.txt,223008,224570,1562,10,N,N,-,-1,-1
WESLEY.txt,223176,224781,1605,10,N,N,-,-1,-1
WESLEY.txt,223396,224980,1584,10,N,N,-,-1,-1
WESLEY.txt,223691,225397,1706,10,N,N,-,-1,-1
WESLEY.txt,223810,225455,1645,10,N,N,-,-1,-1
WESLEY.txt,224003,225739,1736,10,N,N,-,-1,-1
WESLEY.txt,224041,225743,1702,10,N,N,-,-1,-1
WESLEY.txt,224078,225886,1808,10,N,N,-,-1,-1
WESLEY.txt,224237,226064,1827,10,N,N,-,-1,-1
WESLEY.txt,224419,226176,1757,10,N,N,-,-1,-1
WESLEY.txt,224571,226353,1782,10,N,N,-,-1,-1
WESLEY.txt,224782,226414,1632,10,N,N,-,-1,-1
WESLEY.txt,224981,226418,1437,10,N,N,-,-1,-1
WESLEY.txt,225398,226572,1174,10,N,N,-,-1,-1
WESLEY.txt,225456,226576,1120,10,N,N,-,-1,-1
WESLEY.txt,225740,226723,983,10,N,N,-,-1,-1
WESLEY.txt,225744,226727,983,10,N,N,-,-1,-1
WESLEY.txt,225887,226908,1021,10,N,N,-,-1,-1
WESLEY.txt,226065,226912,847,10,N,N,-,-1,-1
WESLEY.txt,226177,227177,1000,10,N,N,-,-1,-1
WESLEY.txt,226354,227181,827,10,N,N,-,-1,-1
WESLEY.txt,226415,227434,1019,10,N,N,-,-1,-1
WESLEY.txt,226419,227645,1226,10,N,N,-,-1,-1
WESLEY.txt,226573,227649,1076,10,N,N,-,-1,-1
WESLEY.txt,226577,227903,1326,10,N,N,-,-1,-1
WESLEY.txt,226724,227907,1183,10,N,N,-,-1,-1
WESLEY.txt,226728,228088,1360,10,N,N,-,-1,-1
WESLEY.txt,226909,228294,1385,10,N,N,-,-1,-1
WESLEY.txt,226913,228402,1489,10,N,N,-,-1,-1
WESLEY.txt,227178,228506,1328,10,N,N,-,-1,-1
WESLEY.txt,227182,228638,1456,10,N,N,-,-1,-1
WESLEY.txt,227435,228651,1216,10,N,N,-,-1,-1
WESLEY.txt,227646,228721,1075,10,N,N,-,-1,-1
WESLEY.txt,227650,229004,1354,10,N,N,-,-1,-1
WESLEY.txt,227904,229172,1268,10,N,N,-,-1,-1
WESLEY.txt,227908,229288,1380,10,N,N,-,-1,-1
WESLEY.txt,228089,229407,1318,10,N,N,-,-1,-1
WESLEY.txt,228295,229419,1124,10,N,N,-,-1,-1
WESLEY.txt,228402,229500,1098,10,N,N,-,-1,-1
WESLEY.txt,228507,229618,1111,10,N,N,-,-1,-1
WESLEY.txt,228639,229648,1009,10,N,N,-,-1,-1
WESLEY.txt,228651,229803,1152,10,N,N,-,-1,-1
WESLEY.txt,228722,229819,1097,10,N,N,-,-1,-1
WESLEY.txt,229005,229898,893,10,N,N,-,-1,-1
WESLEY.txt,229173,229912,739,10,N,N,-,-1,-1
WESLEY.txt,229289,229989,700,10,N,N,-,-1,-1
WESLEY.txt,229408,230100,692,10,N,N,-,-1,-1
WESLEY.txt,229419,230284,865,10,N,N,-,-1,-1
WESLEY.txt,229501,230296,795,10,N,N,-,-1,-1
WESLEY.txt,229619,230431,812,10,N,N,-,-1,-1
WESLEY.txt,229650,230468,818,10,N,N,-,-1,-1
WESLEY.txt,229804,230656,852,10,N,N,-,-1,-1
WESLEY.txt,229820,230757,937,10,N,N,-,-1,-1
WESLEY.txt,229899,230795,896,10,N,N,-,-1,-1
WESLEY.txt,229912,230958,1046,10,N,N,-,-1,-1
WESLEY.txt,229990,231073,1083,10,N,N,-,-1,-1
WESLEY.txt,230101,231087,986,10,N,N,-,-1,-1
WESLEY.txt,230285,231278,993,10,N,N,-,-1,-1
WESLEY.txt,230296,231411,1115,10,N,N,-,-1,-1
WESLEY.txt,230432,231492,1060,10,N,N,-,-1,-1
WESLEY.txt,230469,231617,1148,10,N,N,-,-1,-1
WESLEY.txt,230657,231638,981,10,N,N,-,-1,-1
WESLEY.txt,230757,231778,1021,10,N,N,-,-1,-1
WESLEY.txt,230797,231963,1166,10,N,N,-,-1,-1
WESLEY.txt,230959,232002,1043,10,N,N,-,-1,-1
WESLEY.txt,231074,232014,940,10,N,N,-,-1,-1
WESLEY.txt,231087,232036,949,10,N,N,-,-1,-1
WESLEY.txt,231279,232061,782,10,N,N,-,-1,-1
WESLEY.txt,231412,232072,660,10,N,N,-,-1,-1
WESLEY.txt,231493,232089,596,10,N,N,-,-1,-1
WESLEY.txt,231618,232137,519,10,N,N,-,-1,-1
WESLEY.txt,231638,232172,534,10,N,N,-,-1,-1
WESLEY.txt,231779,232259,480,10,N,N,-,-1,-1
WESLEY.txt,231964,232277,313,10,N,N,-,-1,-1
WESLEY.txt,232003,232295,292,10,N,N,-,-1,-1
WESLEY.txt,232015,232313,298,10,N,N,-,-1,-1
WESLEY.txt,232037,232426,389,10,N,N,-,-1,-1
WESLEY.txt,232062,232577,515,10,N,N,-,-1,-1
WESLEY.txt,232073,232588,515,10,N,N,-,-1,-1
WESLEY.txt,232090,232722,632,10,N,N,-,-1,-1
WESLEY.txt,232138,232859,721,10,N,N,-,-1,-1
WESLEY.txt,232173,232870,697,10,N,N,-,-1,-1
WESLEY.txt,232260,232937,677,10,N,N,-,-1,-1
WESLEY.txt,232278,232999,721,10,N,N,-,-1,-1
WESLEY.txt,232296,233114,818,10,N,N,-,-1,-1
WESLEY.txt,232314,233221,907,10,N,N,-,-1,-1
WESLEY.txt,232427,233354,927,10,N,N,-,-1,-1
WESLEY.txt,232578,233381,803,10,N,N,-,-1,-1
WESLEY.txt,232589,233628,1039,10,N,N,-,-1,-1
WESLEY.txt,232723,233905,1182,10,N,N,-,-1,-1
WESLEY.txt,232860,233918,1058,10,N,N,-,-1,-1
WESLEY.txt,232871,234001,1130,10,N,N,-,-1,-1
WESLEY.txt,232938,234156,1218,10,N,N,-,-1,-1
WESLEY.txt,233000,234246,1246,10,N,N,-,-1,-1
WESLEY.txt,233116,234253,1137,10,N,N,-,-1,-1
WESLEY.txt,233222,234260,1038,10,N,N,-,-1,-1
WESLEY.txt,233355,234357,1002,10,N,N,-,-1,-1
WESLEY.txt,233382,234484,1102,10,N,N,-,-1,-1
WESLEY.txt,233629,234593,964,10,N,N,-,-1,-1
WESLEY.txt,233906,234766,860,10,N,N,-,-1,-1
WESLEY.txt,233918,234775,857,10,N,N,-,-1,-1
WESLEY.txt,234002,234796,794,10,N,N,-,-1,-1
WESLEY.txt,234157,234903,746,10,N,N,-,-1,-1
WESLEY.txt,234247,235034,787,10,N,N,-,-1,-1
WESLEY.txt,234254,235235,981,10,N,N,-,-1,-1
WESLEY.txt,234261,235378,1117,10,N,N,-,-1,-1
WESLEY.txt,234358,235439,1081,10,N,N,-,-1,-1
WESLEY.txt,234484,235558,1074,10,N,N,-,-1,-1
WESLEY.txt,234594,235611,1017,10,N,N,-,-1,-1
WESLEY.txt,234767,235764,997,10,N,N,-,-1,-1
WESLEY.txt,234776,235867,1091,10,N,N,-,-1,-1
WESLEY.txt,234796,236026,1230,10,N,N,-,-1,-1
WESLEY.txt,234904,236124,1220,10,N,N,-,-1,-1
WESLEY.txt,235035,236275,1240,10,N,N,-,-1,-1
WESLEY.txt,235236,236432,1196,10,N,N,-,-1,-1
WESLEY.txt,235379,236624,1245,10,N,N,-,-1,-1
WESLEY.txt,235440,236708,1268,10,N,N,-,-1,-1
WESLEY.txt,235560,236814,1254,10,N,N,-,-1,-1
WESLEY.txt,235612,236923,1311,10,N,N,-,-1,-1
WESLEY.txt,235765,236984,1219,10,N,N,-,-1,-1
WESLEY.txt,235868,237013,1145,10,N,N,-,-1,-1
WESLEY.txt,236027,237090,1063,10,N,N,-,-1,-1
WESLEY.txt,236124,237097,973,10,N,N,-,-1,-1
WESLEY.txt,236276,237105,829,10,N,N,-,-1,-1
WESLEY.txt,236433,237296,863,10,N,N,-,-1,-1
WESLEY.txt,236625,237483,858,10,N,N,-,-1,-1
WESLEY.txt,236709,237567,858,10,N,N,-,-1,-1
WESLEY.txt,236815,237661,846,10,N,N,-,-1,-1
WESLEY.txt,236924,237763,839,10,N,N,-,-1,-1
WESLEY.txt,236985,238082,1097,10,N,N,-,-1,-1
WESLEY.txt,237013,238171,1158,10,N,N,-,-1,-1
WESLEY.txt,237091,238226,1135,10,N,N,-,-1,-1
WESLEY.txt,237098,238296,1198,10,N,N,-,-1,-1
WESLEY.txt,237106,238384,1278,10,N,N,-,-1,-1
WESLEY.txt,237297,238508,1211,10,N,N,-,-1,-1
WESLEY.txt,237485,238670,1185,10,N,N,-,-1,-1
WESLEY.txt,237568,238748,1180,10,N,N,-,-1,-1
WESLEY.txt,237662,238827,1165,10,N,N,-,-1,-1
WESLEY.txt,237764,238861,1097,10,N,N,-,-1,-1
WESLEY.txt,238083,239063,980,10,N,N,-,-1,-1
WESLEY.txt,238171,239147,976,10,N,N,-,-1,-1
WESLEY.txt,238227,239200,973,10,N,N,-,-1,-1
WESLEY.txt,238297,239279,982,10,N,N,-,-1,-1
WESLEY.txt,238385,239375,990,10,N,N,-,-1,-1
WESLEY.txt,238509,239422,913,10,N,N,-,-1,-1
WESLEY.txt,238671,239465,794,10,N,N,-,-1,-1
WESLEY.txt,238749,239548,799,10,N,N,-,-1,-1
WESLEY.txt,238828,239610,782,10,N,N,-,-1,-1
WESLEY.txt,238861,239718,857,10,N,N,-,-1,-1
WESLEY.txt,239064,239892,828,10,N,N,-,-1,-1
WESLEY.txt,239148,239990,842,10,N,N,-,-1,-1
WESLEY.txt,239201,240014,813,10,N,N,-,-1,-1
WESLEY.txt,239280,240170,890,10,N,N,-,-1,-1
WESLEY.txt,239376,240362,986,10,N,N,-,-1,-1
WESLEY.txt,239423,240546,1123,10,N,N,-,-1,-1
WESLEY.txt,239466,240560,1094,10,N,N,-,-1,-1
WESLEY.txt,239549,240966,1417,10,N,N,-,-1,-1
WESLEY.txt,239611,241042,1431,10,N,N,-,-1,-1
WESLEY.txt,239719,241054,1335,10,N,N,-,-1,-1
WESLEY.txt,239893,241098,1205,10,N,N,-,-1,-1
WESLEY.txt,239990,241243,1253,10,N,N,-,-1,-1
WESLEY.txt,240015,241361,1346,10,N,N,-,-1,-1
WESLEY.txt,240171,241385,1214,10,N,N,-,-1,-1
WESLEY.txt,240363,241437,1074,10,N,N,-,-1,-1
WESLEY.txt,240547,241607,1060,10,N,N,-,-1,-1
WESLEY.txt,240560,241614,1054,10,N,N,-,-1,-1
WESLEY.txt,240967,241626,659,10,N,N,-,-1,-1
WESLEY.txt,241043,241643,600,10,N,N,-,-1,-1
WESLEY.txt,241054,241730,676,10,N,N,-,-1,-1
WESLEY.txt,241099,241829,730,10,N,N,-,-1,-1
WESLEY.txt,241244,241903,659,10,N,N,-,-1,-1
WESLEY.txt,241363,241916,553,10,N,N,-,-1,-1
WESLEY.txt,241386,241952,566,10,N,N,-,-1,-1
WESLEY.txt,241438,242077,639,10,N,N,-,-1,-1
WESLEY.txt,241608,242157,549,10,N,N,-,-1,-1
WESLEY.txt,241615,242172,557,10,N,Y,1437471855423,351318,351853
WESLEY.txt,241626,242256,630,10,N,Y,1437471855423,351318,351853
WESLEY.txt,241644,242374,730,10,N,Y,1437471855423,351318,351853
WESLEY.txt,241732,242666,934,10,N,Y,1437471855423,351318,351853
WESLEY.txt,241831,242774,943,10,N,Y,1437471855423,351318,351853
WESLEY.txt,241904,242941,1037,10,N,Y,1437471855423,351318,351853
WESLEY.txt,241916,243012,1096,10,N,Y,1437471855423,351318,351853
WESLEY.txt,241954,243179,1225,10,N,Y,1437471855423,351318,351853
WESLEY.txt,242078,243353,1275,10,N,Y,1437471855423,351318,351853
WESLEY.txt,242158,243470,1312,10,N,Y,1437471855423,351318,351853
WESLEY.txt,242172,243573,1401,10,N,Y,1437471855423,351318,351853
WESLEY.txt,242257,243613,1356,10,N,Y,1437471855423,351318,351853
WESLEY.txt,242375,243752,1377,10,N,Y,1437471855423,351318,351853
WESLEY.txt,242667,243940,1273,10,N,N,-,-1,-1
WESLEY.txt,242775,244058,1283,10,N,N,-,-1,-1
WESLEY.txt,242942,244213,1271,10,N,N,-,-1,-1
WESLEY.txt,243012,244224,1212,10,N,N,-,-1,-1
WESLEY.txt,243180,244303,1123,10,N,N,-,-1,-1
WESLEY.txt,243354,244377,1023,10,N,N,-,-1,-1
WESLEY.txt,243471,244529,1058,10,N,N,-,-1,-1
WESLEY.txt,243574,244579,1005,10,N,N,-,-1,-1
WESLEY.txt,243614,244593,979,10,N,N,-,-1,-1
WESLEY.txt,243753,244671,918,10,N,N,-,-1,-1
WESLEY.txt,243941,244781,840,10,N,N,-,-1,-1
WESLEY.txt,244059,244955,896,10,N,N,-,-1,-1
WESLEY.txt,244214,245189,975,10,N,N,-,-1,-1
WESLEY.txt,244224,245293,1069,10,N,N,-,-1,-1
WESLEY.txt,244304,245316,1012,10,N,N,-,-1,-1
WESLEY.txt,244378,245379,1001,10,N,N,-,-1,-1
WESLEY.txt,244530,245426,896,10,N,N,-,-1,-1
WESLEY.txt,244580,245467,887,10,N,N,-,-1,-1
WESLEY.txt,244593,245517,924,10,N,N,-,-1,-1
WESLEY.txt,244672,245576,904,10,N,N,-,-1,-1
WESLEY.txt,244782,245584,802,10,N,N,-,-1,-1
WESLEY.txt,244956,245750,794,10,N,N,-,-1,-1
WESLEY.txt,245190,245833,643,10,N,N,-,-1,-1
WESLEY.txt,245294,245869,575,10,N,N,-,-1,-1
WESLEY.txt,245317,245918,601,10,N,N,-,-1,-1
WESLEY.txt,245380,245994,614,10,N,Y,1437477480340,424837,425856
WESLEY.txt,245428,246180,752,10,N,Y,1437477480340,424837,425856
WESLEY.txt,245468,246349,881,10,N,Y,1437477480340,424837,425856
WESLEY.txt,245518,246388,870,10,N,Y,1437477480340,424837,425856
WESLEY.txt,245577,246506,929,10,N,Y,1437477480340,424837,425856
WESLEY.txt,245585,246668,1083,10,N,Y,1437477480340,424837,425856
WESLEY.txt,245751,246971,1220,10,N,Y,1437477480340,424837,425856
WESLEY.txt,245834,247062,1228,10,N,Y,1437477480340,424837,425856
WESLEY.txt,245870,247148,1278,10,N,Y,1437477480340,424837,425856
WESLEY.txt,245919,247207,1288,10,N,Y,1437477480340,424837,425856
WESLEY.txt,245994,247409,1415,10,N,Y,1437477480340,424837,425856
WESLEY.txt,246181,247472,1291,10,N,Y,1437477480340,424837,425856
WESLEY.txt,246350,247623,1273,10,N,Y,1437477480340,424837,425856
WESLEY.txt,246389,247911,1522,10,N,Y,1437477480340,424837,425856
WESLEY.txt,246507,248018,1511,10,N,Y,1437477480340,424837,425856
WESLEY.txt,246669,248120,1451,10,N,Y,1437477480340,424837,425856
WESLEY.txt,246972,248395,1423,10,N,N,-,-1,-1
WESLEY.txt,247063,248494,1431,10,N,N,-,-1,-1
WESLEY.txt,247149,248576,1427,10,N,N,-,-1,-1
WESLEY.txt,247208,248663,1455,10,N,N,-,-1,-1
WESLEY.txt,247410,248730,1320,10,N,N,-,-1,-1
WESLEY.txt,247473,248843,1370,10,N,N,-,-1,-1
WESLEY.txt,247624,248927,1303,10,N,N,-,-1,-1
WESLEY.txt,247912,249062,1150,10,N,N,-,-1,-1
WESLEY.txt,248019,249138,1119,10,N,N,-,-1,-1
WESLEY.txt,248121,249241,1120,10,N,N,-,-1,-1
WESLEY.txt,248396,249343,947,10,N,N,-,-1,-1
WESLEY.txt,248495,249358,863,10,N,N,-,-1,-1
WESLEY.txt,248577,249528,951,10,N,N,-,-1,-1
WESLEY.txt,248664,249622,958,10,N,N,-,-1,-1
WESLEY.txt,248730,249650,920,10,N,N,-,-1,-1
WESLEY.txt,248844,249715,871,10,N,N,-,-1,-1
WESLEY.txt,248928,249747,819,10,N,N,-,-1,-1
WESLEY.txt,249063,249761,698,10,N,N,-,-1,-1
WESLEY.txt,249140,249897,757,10,N,N,-,-1,-1
WESLEY.txt,249242,249966,724,10,N,N,-,-1,-1
WESLEY.txt,249344,250058,714,10,N,N,-,-1,-1
WESLEY.txt,249358,250158,800,10,N,N,-,-1,-1
WESLEY.txt,249530,250181,651,10,N,N,-,-1,-1
WESLEY.txt,249623,250284,661,10,N,N,-,-1,-1
WESLEY.txt,249652,250374,722,10,N,N,-,-1,-1
WESLEY.txt,249716,250552,836,10,N,N,-,-1,-1
WESLEY.txt,249748,250559,811,10,N,N,-,-1,-1
WESLEY.txt,249762,250722,960,10,N,N,-,-1,-1
WESLEY.txt,249898,250826,928,10,N,N,-,-1,-1
WESLEY.txt,249967,250964,997,10,N,N,-,-1,-1
WESLEY.txt,250059,251058,999,10,N,N,-,-1,-1
WESLEY.txt,250159,251140,981,10,N,N,-,-1,-1
WESLEY.txt,250182,251217,1035,10,N,N,-,-1,-1
WESLEY.txt,250284,251297,1013,10,N,N,-,-1,-1
WESLEY.txt,250375,251375,1000,10,N,N,-,-1,-1
WESLEY.txt,250553,251446,893,10,N,N,-,-1,-1
WESLEY.txt,250560,251529,969,10,N,N,-,-1,-1
WESLEY.txt,250723,251639,916,10,N,N,-,-1,-1
WESLEY.txt,250827,251703,876,10,N,N,-,-1,-1
WESLEY.txt,250965,251823,858,10,N,N,-,-1,-1
WESLEY.txt,251059,251878,819,10,N,N,-,-1,-1
WESLEY.txt,251141,251923,782,10,N,N,-,-1,-1
WESLEY.txt,251218,252097,879,10,N,N,-,-1,-1
WESLEY.txt,251298,252163,865,10,N,N,-,-1,-1
WESLEY.txt,251376,252299,923,10,N,N,-,-1,-1
WESLEY.txt,251447,252372,925,10,N,N,-,-1,-1
WESLEY.txt,251530,252436,906,10,N,N,-,-1,-1
WESLEY.txt,251640,252523,883,10,N,N,-,-1,-1
WESLEY.txt,251704,252577,873,10,N,N,-,-1,-1
WESLEY.txt,251824,252607,783,10,N,N,-,-1,-1
WESLEY.txt,251879,252674,795,10,N,N,-,-1,-1
WESLEY.txt,251924,252715,791,10,N,N,-,-1,-1
WESLEY.txt,252098,252763,665,10,N,N,-,-1,-1
WESLEY.txt,252164,252877,713,10,N,N,-,-1,-1
WESLEY.txt,252300,252923,623,10,N,N,-,-1,-1
WESLEY.txt,252373,252968,595,10,N,N,-,-1,-1
WESLEY.txt,252437,252992,555,10,N,N,-,-1,-1
WESLEY.txt,252524,253144,620,10,N,N,-,-1,-1
WESLEY.txt,252578,253217,639,10,N,N,-,-1,-1
WESLEY.txt,252608,253269,661,10,N,N,-,-1,-1
WESLEY.txt,252675,253387,712,10,N,N,-,-1,-1
WESLEY.txt,252716,253431,715,10,N,N,-,-1,-1
WESLEY.txt,252764,253552,788,10,N,N,-,-1,-1
WESLEY.txt,252878,253740,862,10,N,N,-,-1,-1
WESLEY.txt,252924,253831,907,10,N,N,-,-1,-1
WESLEY.txt,252969,254028,1059,10,N,N,-,-1,-1
WESLEY.txt,252993,254140,1147,10,N,N,-,-1,-1
WESLEY.txt,253145,254229,1084,10,N,N,-,-1,-1
WESLEY.txt,253218,254426,1208,10,N,N,-,-1,-1
WESLEY.txt,253270,254503,1233,10,N,N,-,-1,-1
WESLEY.txt,253388,254528,1140,10,N,N,-,-1,-1
WESLEY.txt,253432,254584,1152,10,N,N,-,-1,-1
WESLEY.txt,253553,254632,1079,10,N,N,-,-1,-1
WESLEY.txt,253741,254672,931,10,N,N,-,-1,-1
WESLEY.txt,253832,254723,891,10,N,N,-,-1,-1
WESLEY.txt,254029,254895,866,10,N,N,-,-1,-1
WESLEY.txt,254141,254912,771,10,N,N,-,-1,-1
WESLEY.txt,254230,254996,766,10,N,N,-,-1,-1
WESLEY.txt,254427,255163,736,10,N,N,-,-1,-1
WESLEY.txt,254504,255244,740,10,N,N,-,-1,-1
WESLEY.txt,254529,255322,793,10,N,N,-,-1,-1
WESLEY.txt,254585,255335,750,10,N,N,-,-1,-1
WESLEY.txt,254633,255516,883,10,N,N,-,-1,-1
WESLEY.txt,254674,255688,1014,10,N,N,-,-1,-1
WESLEY.txt,254724,255956,1232,10,N,N,-,-1,-1
WESLEY.txt,254896,256182,1286,10,N,N,-,-1,-1
WESLEY.txt,254913,256402,1489,10,N,N,-,-1,-1
WESLEY.txt,254997,256628,1631,10,N,N,-,-1,-1
WESLEY.txt,255164,256644,1480,10,N,N,-,-1,-1
WESLEY.txt,255245,256677,1432,10,N,N,-,-1,-1
WESLEY.txt,255323,256702,1379,10,N,N,-,-1,-1
WESLEY.txt,255336,256782,1446,10,N,N,-,-1,-1
WESLEY.txt,255518,256888,1370,10,N,N,-,-1,-1
WESLEY.txt,255689,257067,1378,10,N,N,-,-1,-1
WESLEY.txt,255957,257171,1214,10,N,N,-,-1,-1
WESLEY.txt,256183,257427,1244,10,N,N,-,-1,-1
WESLEY.txt,256403,257516,1113,10,N,N,-,-1,-1
WESLEY.txt,256629,257793,1164,10,N,N,-,-1,-1
WESLEY.txt,256645,257988,1343,10,N,N,-,-1,-1
WESLEY.txt,256679,258094,1415,10,N,N,-,-1,-1
WESLEY.txt,256703,258326,1623,10,N,N,-,-1,-1
WESLEY.txt,256783,258538,1755,10,N,N,-,-1,-1
WESLEY.txt,256889,258723,1834,10,N,N,-,-1,-1
WESLEY.txt,257068,258877,1809,10,N,N,-,-1,-1
WESLEY.txt,257172,258891,1719,10,N,N,-,-1,-1
WESLEY.txt,257428,258903,1475,10,N,N,-,-1,-1
WESLEY.txt,257517,258918,1401,10,N,N,-,-1,-1
WESLEY.txt,257794,259108,1314,10,N,N,-,-1,-1
WESLEY.txt,257989,259244,1255,10,N,N,-,-1,-1
WESLEY.txt,258095,259263,1168,10,N,N,-,-1,-1
WESLEY.txt,258327,259319,992,10,N,N,-,-1,-1
WESLEY.txt,258539,259371,832,10,N,N,-,-1,-1
WESLEY.txt,258724,259434,710,10,N,N,-,-1,-1
WESLEY.txt,258878,259810,932,10,N,N,-,-1,-1
WESLEY.txt,258892,260174,1282,10,N,N,-,-1,-1
WESLEY.txt,258904,260255,1351,10,N,N,-,-1,-1
WESLEY.txt,258919,260321,1402,10,N,N,-,-1,-1
WESLEY.txt,259109,260456,1347,10,N,N,-,-1,-1
WESLEY.txt,259245,260594,1349,10,N,N,-,-1,-1
WESLEY.txt,259264,260632,1368,10,N,N,-,-1,-1
WESLEY.txt,259320,260682,1362,10,N,N,-,-1,-1
WESLEY.txt,259372,260753,1381,10,N,N,-,-1,-1
WESLEY.txt,259435,260838,1403,10,N,N,-,-1,-1
WESLEY.txt,259811,260897,1086,10,N,N,-,-1,-1
WESLEY.txt,260175,260954,779,10,N,N,-,-1,-1
WESLEY.txt,260256,260996,740,10,N,N,-,-1,-1
WESLEY.txt,260322,261078,756,10,N,N,-,-1,-1
WESLEY.txt,260457,261142,685,10,N,N,-,-1,-1
WESLEY.txt,260595,261318,723,10,N,N,-,-1,-1
WESLEY.txt,260633,261602,969,10,N,N,-,-1,-1
WESLEY.txt,260683,262407,1724,10,N,N,-,-1,-1
WESLEY.txt,260754,262589,1835,10,N,N,-,-1,-1
WESLEY.txt,260839,262603,1764,10,N,N,-,-1,-1
WESLEY.txt,260898,262844,1946,10,N,N,-,-1,-1
WESLEY.txt,260955,263032,2077,10,N,N,-,-1,-1
WESLEY.txt,260997,263125,2128,10,N,N,-,-1,-1
WESLEY.txt,261079,263197,2118,10,N,N,-,-1,-1
WESLEY.txt,261143,263486,2343,10,N,N,-,-1,-1
WESLEY.txt,261319,263579,2260,10,N,N,-,-1,-1
WESLEY.txt,261603,263671,2068,10,N,N,-,-1,-1
WESLEY.txt,262408,263774,1366,10,N,N,-,-1,-1
WESLEY.txt,262590,264081,1491,10,N,N,-,-1,-1
WESLEY.txt,262603,264161,1558,10,N,N,-,-1,-1
WESLEY.txt,262845,264378,1533,10,N,N,-,-1,-1
WESLEY.txt,263033,264456,1423,10,N,N,-,-1,-1
WESLEY.txt,263126,264488,1362,10,N,N,-,-1,-1
WESLEY.txt,263198,264571,1373,10,N,N,-,-1,-1
WESLEY.txt,263487,264642,1155,10,N,N,-,-1,-1
WESLEY.txt,263580,264665,1085,10,N,N,-,-1,-1
WESLEY.txt,263673,264737,1064,10,N,N,-,-1,-1
WESLEY.txt,263775,265021,1246,10,N,N,-,-1,-1
WESLEY.txt,264082,265155,1073,10,N,N,-,-1,-1
WESLEY.txt,264162,265317,1155,10,N,N,-,-1,-1
WESLEY.txt,264379,265409,1030,10,N,N,-,-1,-1
WESLEY.txt,264457,265491,1034,10,N,N,-,-1,-1
WESLEY.txt,264489,265591,1102,10,N,N,-,-1,-1
WESLEY.txt,264571,265706,1135,10,N,N,-,-1,-1
WESLEY.txt,264643,265787,1144,10,N,N,-,-1,-1
WESLEY.txt,264665,265949,1284,10,N,N,-,-1,-1
WESLEY.txt,264738,266057,1319,10,N,N,-,-1,-1
WESLEY.txt,265022,266144,1122,10,N,N,-,-1,-1
WESLEY.txt,265156,266211,1055,10,N,N,-,-1,-1
WESLEY.txt,265318,266250,932,10,N,N,-,-1,-1
WESLEY.txt,265410,266435,1025,10,N,N,-,-1,-1
WESLEY.txt,265492,266619,1127,10,N,N,-,-1,-1
WESLEY.txt,265592,266748,1156,10,N,N,-,-1,-1
WESLEY.txt,265707,266809,1102,10,N,N,-,-1,-1
WESLEY.txt,265788,266906,1118,10,N,N,-,-1,-1
WESLEY.txt,265950,267007,1057,10,N,N,-,-1,-1
WESLEY.txt,266058,267101,1043,10,N,N,-,-1,-1
WESLEY.txt,266145,267118,973,10,N,N,-,-1,-1
WESLEY.txt,266212,267200,988,10,N,N,-,-1,-1
WESLEY.txt,266251,267388,1137,10,N,N,-,-1,-1
WESLEY.txt,266436,267484,1048,10,N,N,-,-1,-1
WESLEY.txt,266620,267582,962,10,N,N,-,-1,-1
WESLEY.txt,266749,267660,911,10,N,N,-,-1,-1
WESLEY.txt,266810,267706,896,10,N,N,-,-1,-1
WESLEY.txt,266907,267747,840,10,N,N,-,-1,-1
WESLEY.txt,267008,267766,758,10,N,N,-,-1,-1
WESLEY.txt,267102,267791,689,10,N,N,-,-1,-1
WESLEY.txt,267118,267852,734,10,N,N,-,-1,-1
WESLEY.txt,267201,267862,661,10,N,N,-,-1,-1
WESLEY.txt,267389,267904,515,10,N,N,-,-1,-1
WESLEY.txt,267485,267940,455,10,N,N,-,-1,-1
WESLEY.txt,267583,268032,449,10,N,N,-,-1,-1
WESLEY.txt,267661,268108,447,10,N,N,-,-1,-1
WESLEY.txt,267707,268319,612,10,N,N,-,-1,-1
WESLEY.txt,267748,268411,663,10,N,N,-,-1,-1
WESLEY.txt,267766,268556,790,10,N,N,-,-1,-1
WESLEY.txt,267792,268671,879,10,N,N,-,-1,-1
WESLEY.txt,267853,268878,1025,10,N,N,-,-1,-1
WESLEY.txt,267863,268921,1058,10,N,N,-,-1,-1
WESLEY.txt,267905,268980,1075,10,N,N,-,-1,-1
WESLEY.txt,267941,268986,1045,10,N,N,-,-1,-1
WESLEY.txt,268033,269007,974,10,N,N,-,-1,-1
WESLEY.txt,268109,269203,1094,10,N,N,-,-1,-1
WESLEY.txt,268320,269268,948,10,N,N,-,-1,-1
WESLEY.txt,268411,269396,985,10,N,N,-,-1,-1
WESLEY.txt,268557,269557,1000,10,N,N,-,-1,-1
WESLEY.txt,268672,269627,955,10,N,N,-,-1,-1
WESLEY.txt,268879,269745,866,10,N,N,-,-1,-1
WESLEY.txt,268922,269836,914,10,N,N,-,-1,-1
WESLEY.txt,268981,269943,962,10,N,N,-,-1,-1
WESLEY.txt,268987,270025,1038,10,N,N,-,-1,-1
WESLEY.txt,269007,270195,1188,10,N,N,-,-1,-1
WESLEY.txt,269204,270311,1107,10,N,N,-,-1,-1
WESLEY.txt,269269,270426,1157,10,N,N,-,-1,-1
WESLEY.txt,269397,270447,1050,10,N,N,-,-1,-1
WESLEY.txt,269558,270502,944,10,N,N,-,-1,-1
WESLEY.txt,269628,270595,967,10,N,N,-,-1,-1
WESLEY.txt,269747,270675,928,10,N,N,-,-1,-1
WESLEY.txt,269837,270757,920,10,N,N,-,-1,-1
WESLEY.txt,269944,270863,919,10,N,N,-,-1,-1
WESLEY.txt,270026,271002,976,10,N,N,-,-1,-1
WESLEY.txt,270196,271337,1141,10,N,N,-,-1,-1
WESLEY.txt,270312,271595,1283,10,N,N,-,-1,-1
WESLEY.txt,270427,271687,1260,10,N,N,-,-1,-1
WESLEY.txt,270447,271706,1259,10,N,N,-,-1,-1
WESLEY.txt,270503,271861,1358,10,N,N,-,-1,-1
WESLEY.txt,270595,271895,1300,10,N,N,-,-1,-1
WESLEY.txt,270676,271945,1269,10,N,N,-,-1,-1
WESLEY.txt,270759,272057,1298,10,N,N,-,-1,-1
WESLEY.txt,270864,272154,1290,10,N,N,-,-1,-1
WESLEY.txt,271003,272248,1245,10,N,N,-,-1,-1
WESLEY.txt,271376,272505,1129,10,N,N,-,-1,-1
WESLEY.txt,271596,272562,966,10,N,N,-,-1,-1
WESLEY.txt,271688,272610,922,10,N,N,-,-1,-1
WESLEY.txt,271706,273001,1295,10,N,N,-,-1,-1
WESLEY.txt,271862,273187,1325,10,N,N,-,-1,-1
WESLEY.txt,271896,273274,1378,10,N,N,-,-1,-1
WESLEY.txt,271946,273364,1418,10,N,N,-,-1,-1
WESLEY.txt,272057,273384,1327,10,N,N,-,-1,-1
WESLEY.txt,272155,273610,1455,10,N,N,-,-1,-1
WESLEY.txt,272249,273693,1444,10,N,N,-,-1,-1
WESLEY.txt,272506,273799,1293,10,N,N,-,-1,-1
WESLEY.txt,272563,273897,1334,10,N,N,-,-1,-1
WESLEY.txt,272611,273909,1298,10,N,N,-,-1,-1
WESLEY.txt,273002,273930,928,10,N,N,-,-1,-1
WESLEY.txt,273188,273960,772,10,N,N,-,-1,-1
WESLEY.txt,273275,274029,754,10,N,N,-,-1,-1
WESLEY.txt,273365,274086,721,10,N,N,-,-1,-1
WESLEY.txt,273385,274256,871,10,N,N,-,-1,-1
WESLEY.txt,273611,274348,737,10,N,N,-,-1,-1
WESLEY.txt,273694,274429,735,10,N,N,-,-1,-1
WESLEY.txt,273800,274452,652,10,N,N,-,-1,-1
WESLEY.txt,273898,274528,630,10,N,N,-,-1,-1
WESLEY.txt,273909,274594,685,10,N,N,-,-1,-1
WESLEY.txt,273931,274631,700,10,N,N,-,-1,-1
WESLEY.txt,273961,274698,737,10,N,N,-,-1,-1
WESLEY.txt,274030,274784,754,10,N,N,-,-1,-1
WESLEY.txt,274087,274810,723,10,N,N,-,-1,-1
WESLEY.txt,274257,274887,630,10,N,N,-,-1,-1
WESLEY.txt,274349,275029,680,10,N,N,-,-1,-1
WESLEY.txt,274430,275087,657,10,N,N,-,-1,-1
WESLEY.txt,274453,275126,673,10,N,N,-,-1,-1
WESLEY.txt,274529,275220,691,10,N,N,-,-1,-1
WESLEY.txt,274595,275334,739,10,N,N,-,-1,-1
WESLEY.txt,274632,275482,850,10,N,N,-,-1,-1
WESLEY.txt,274699,275547,848,10,N,N,-,-1,-1
WESLEY.txt,274785,275593,808,10,N,N,-,-1,-1
WESLEY.txt,274811,275740,929,10,N,N,-,-1,-1
WESLEY.txt,274888,276036,1148,10,N,N,-,-1,-1
WESLEY.txt,275030,276050,1020,10,N,N,-,-1,-1
WESLEY.txt,275088,276118,1030,10,N,N,-,-1,-1
WESLEY.txt,275127,276214,1087,10,N,N,-,-1,-1
WESLEY.txt,275221,276374,1153,10,N,N,-,-1,-1
WESLEY.txt,275335,276502,1167,10,N,N,-,-1,-1
WESLEY.txt,275483,276612,1129,10,N,N,-,-1,-1
WESLEY.txt,275547,276724,1177,10,N,N,-,-1,-1
WESLEY.txt,275594,276903,1309,10,N,N,-,-1,-1
WESLEY.txt,275741,276920,1179,10,N,N,-,-1,-1
WESLEY.txt,276037,276959,922,10,N,N,-,-1,-1
WESLEY.txt,276050,277205,1155,10,N,N,-,-1,-1
WESLEY.txt,276119,277274,1155,10,N,N,-,-1,-1
WESLEY.txt,276215,277329,1114,10,N,N,-,-1,-1
WESLEY.txt,276375,277452,1077,10,N,N,-,-1,-1
WESLEY.txt,276503,277525,1022,10,N,N,-,-1,-1
WESLEY.txt,276613,277634,1021,10,N,N,-,-1,-1
WESLEY.txt,276726,277718,992,10,N,N,-,-1,-1
WESLEY.txt,276904,277797,893,10,N,N,-,-1,-1
WESLEY.txt,276920,277933,1013,10,N,N,-,-1,-1
WESLEY.txt,276960,277992,1032,10,N,N,-,-1,-1
WESLEY.txt,277207,278037,830,10,N,N,-,-1,-1
WESLEY.txt,277275,278072,797,10,N,N,-,-1,-1
WESLEY.txt,277331,278135,804,10,N,N,-,-1,-1
WESLEY.txt,277453,278199,746,10,N,N,-,-1,-1
WESLEY.txt,277527,278237,710,10,N,N,-,-1,-1
WESLEY.txt,277635,278375,740,10,N,N,-,-1,-1
WESLEY.txt,277719,278419,700,10,N,N,-,-1,-1
WESLEY.txt,277798,278507,709,10,N,N,-,-1,-1
WESLEY.txt,277934,278552,618,10,N,N,-,-1,-1
WESLEY.txt,277993,278689,696,10,N,N,-,-1,-1
WESLEY.txt,278038,278798,760,10,N,N,-,-1,-1
WESLEY.txt,278073,278847,774,10,N,N,-,-1,-1
WESLEY.txt,278136,278913,777,10,N,N,-,-1,-1
WESLEY.txt,278200,279003,803,10,N,N,-,-1,-1
WESLEY.txt,278238,279047,809,10,N,N,-,-1,-1
WESLEY.txt,278376,279070,694,10,N,N,-,-1,-1
WESLEY.txt,278420,279089,669,10,N,N,-,-1,-1
WESLEY.txt,278507,279117,610,10,N,N,-,-1,-1
WESLEY.txt,278553,279187,634,10,N,N,-,-1,-1
WESLEY.txt,278690,279223,533,10,N,N,-,-1,-1
WESLEY.txt,278799,279467,668,10,N,N,-,-1,-1
WESLEY.txt,278848,279545,697,10,N,N,-,-1,-1
WESLEY.txt,278914,279662,748,10,N,N,-,-1,-1
WESLEY.txt,279004,279704,700,10,N,N,-,-1,-1
WESLEY.txt,279049,279752,703,10,N,N,-,-1,-1
WESLEY.txt,279071,279798,727,10,N,N,-,-1,-1
WESLEY.txt,279090,279885,795,10,N,N,-,-1,-1
WESLEY.txt,279118,280096,978,10,N,N,-,-1,-1
WESLEY.txt,279188,280252,1064,10,N,N,-,-1,-1
WESLEY.txt,279224,280339,1115,10,N,N,-,-1,-1
WESLEY.txt,279468,280431,963,10,N,N,-,-1,-1
WESLEY.txt,279546,280485,939,10,N,N,-,-1,-1
WESLEY.txt,279663,280612,949,10,N,N,-,-1,-1
WESLEY.txt,279705,280783,1078,10,N,N,-,-1,-1
WESLEY.txt,279754,280895,1141,10,N,N,-,-1,-1
WESLEY.txt,279799,280989,1190,10,N,N,-,-1,-1
WESLEY.txt,279886,281187,1301,10,N,N,-,-1,-1
WESLEY.txt,280097,281213,1116,10,N,N,-,-1,-1
WESLEY.txt,280253,281243,990,10,N,N,-,-1,-1
WESLEY.txt,280340,281256,916,10,N,N,-,-1,-1
WESLEY.txt,280432,281273,841,10,N,N,-,-1,-1
WESLEY.txt,280486,281424,938,10,N,N,-,-1,-1
WESLEY.txt,280613,281513,900,10,N,N,-,-1,-1
WESLEY.txt,280784,281618,834,10,N,N,-,-1,-1
WESLEY.txt,280896,281727,831,10,N,N,-,-1,-1
WESLEY.txt,280990,281800,810,10,N,N,-,-1,-1
WESLEY.txt,281188,281820,632,10,N,N,-,-1,-1
WESLEY.txt,281214,281907,693,10,N,N,-,-1,-1
WESLEY.txt,281244,282009,765,10,N,N,-,-1,-1
WESLEY.txt,281257,282091,834,10,N,N,-,-1,-1
WESLEY.txt,281274,282152,878,10,N,N,-,-1,-1
WESLEY.txt,281425,282175,750,10,N,N,-,-1,-1
WESLEY.txt,281514,282241,727,10,N,N,-,-1,-1
WESLEY.txt,281619,282335,716,10,N,N,-,-1,-1
WESLEY.txt,281728,282401,673,10,N,N,-,-1,-1
WESLEY.txt,281800,282424,624,10,N,N,-,-1,-1
WESLEY.txt,281821,282498,677,10,N,N,-,-1,-1
WESLEY.txt,281908,282585,677,10,N,N,-,-1,-1
WESLEY.txt,282010,282663,653,10,N,N,-,-1,-1
WESLEY.txt,282093,282780,687,10,N,N,-,-1,-1
WESLEY.txt,282153,282921,768,10,N,N,-,-1,-1
WESLEY.txt,282176,282945,769,10,N,N,-,-1,-1
WESLEY.txt,282242,283030,788,10,N,N,-,-1,-1
WESLEY.txt,282336,283095,759,10,N,N,-,-1,-1
WESLEY.txt,282402,283120,718,10,N,N,-,-1,-1
WESLEY.txt,282425,283137,712,10,N,N,-,-1,-1
WESLEY.txt,282499,283182,683,10,N,N,-,-1,-1
WESLEY.txt,282586,283272,686,10,N,N,-,-1,-1
WESLEY.txt,282664,283449,785,10,N,N,-,-1,-1
WESLEY.txt,282781,283521,740,10,N,N,-,-1,-1
WESLEY.txt,282922,283592,670,10,N,N,-,-1,-1
WESLEY.txt,282946,283632,686,10,N,N,-,-1,-1
WESLEY.txt,283031,283671,640,10,N,N,-,-1,-1
WESLEY.txt,283096,283679,583,10,N,N,-,-1,-1
WESLEY.txt,283121,283687,566,10,N,N,-,-1,-1
WESLEY.txt,283138,283696,558,10,N,N,-,-1,-1
WESLEY.txt,283183,283898,715,10,N,N,-,-1,-1
WESLEY.txt,283273,283930,657,10,N,N,-,-1,-1
WESLEY.txt,283450,283969,519,10,N,N,-,-1,-1
WESLEY.txt,283522,283985,463,10,N,N,-,-1,-1
WESLEY.txt,283593,283995,402,10,N,N,-,-1,-1
WESLEY.txt,283633,284022,389,10,N,N,-,-1,-1
WESLEY.txt,283672,284111,439,10,N,N,-,-1,-1
WESLEY.txt,283680,284295,615,10,N,N,-,-1,-1
WESLEY.txt,283688,284390,702,10,N,N,-,-1,-1
WESLEY.txt,283697,284568,871,10,N,N,-,-1,-1
WESLEY.txt,283899,284673,774,10,N,N,-,-1,-1
WESLEY.txt,283930,284842,912,10,N,N,-,-1,-1
WESLEY.txt,283970,285005,1035,10,N,N,-,-1,-1
WESLEY.txt,283986,285093,1107,10,N,N,-,-1,-1
WESLEY.txt,283997,285294,1297,10,N,N,-,-1,-1
WESLEY.txt,284023,285680,1657,10,N,N,-,-1,-1
WESLEY.txt,284112,285765,1653,10,N,N,-,-1,-1
WESLEY.txt,284296,285861,1565,10,N,N,-,-1,-1
WESLEY.txt,284391,286001,1610,10,N,N,-,-1,-1
WESLEY.txt,284569,286078,1509,10,N,N,-,-1,-1
WESLEY.txt,284674,286173,1499,10,N,N,-,-1,-1
WESLEY.txt,284843,286235,1392,10,N,N,-,-1,-1
WESLEY.txt,285006,286296,1290,10,N,N,-,-1,-1
WESLEY.txt,285094,286372,1278,10,N,N,-,-1,-1
WESLEY.txt,285295,286560,1265,10,N,N,-,-1,-1
WESLEY.txt,285681,286580,899,10,N,N,-,-1,-1
WESLEY.txt,285766,286836,1070,10,N,N,-,-1,-1
WESLEY.txt,285862,286997,1135,10,N,N,-,-1,-1
WESLEY.txt,286003,287017,1014,10,N,N,-,-1,-1
WESLEY.txt,286079,287117,1038,10,N,N,-,-1,-1
WESLEY.txt,286174,287273,1099,10,N,N,-,-1,-1
WESLEY.txt,286236,287439,1203,10,N,N,-,-1,-1
WESLEY.txt,286297,287469,1172,10,N,N,-,-1,-1
WESLEY.txt,286373,287621,1248,10,N,N,-,-1,-1
WESLEY.txt,286561,287729,1168,10,N,N,-,-1,-1
WESLEY.txt,286581,287795,1214,10,N,N,-,-1,-1
WESLEY.txt,286837,287968,1131,10,N,N,-,-1,-1
WESLEY.txt,286997,288058,1061,10,N,N,-,-1,-1
WESLEY.txt,287018,288156,1138,10,N,N,-,-1,-1
WESLEY.txt,287118,288498,1380,10,N,N,-,-1,-1
WESLEY.txt,287274,288511,1237,10,N,N,-,-1,-1
WESLEY.txt,287440,288548,1108,10,N,N,-,-1,-1
WESLEY.txt,287470,288608,1138,10,N,N,-,-1,-1
WESLEY.txt,287622,288716,1094,10,N,N,-,-1,-1
WESLEY.txt,287730,288779,1049,10,N,N,-,-1,-1
WESLEY.txt,287796,288887,1091,10,N,N,-,-1,-1
WESLEY.txt,287969,288934,965,10,N,N,-,-1,-1
WESLEY.txt,288059,289050,991,10,N,N,-,-1,-1
WESLEY.txt,288157,289115,958,10,N,N,-,-1,-1
WESLEY.txt,288499,289192,693,10,N,N,-,-1,-1
WESLEY.txt,288511,289249,738,10,N,N,-,-1,-1
WESLEY.txt,288550,289314,764,10,N,N,-,-1,-1
WESLEY.txt,288609,289378,769,10,N,N,-,-1,-1
WESLEY.txt,288717,289488,771,10,N,N,-,-1,-1
WESLEY.txt,288779,289675,896,10,N,N,-,-1,-1
WESLEY.txt,288888,289835,947,10,N,N,-,-1,-1
WESLEY.txt,288935,289961,1026,10,N,N,-,-1,-1
WESLEY.txt,289051,289972,921,10,N,N,-,-1,-1
WESLEY.txt,289115,290049,934,10,N,N,-,-1,-1
WESLEY.txt,289193,290166,973,10,N,N,-,-1,-1
WESLEY.txt,289250,290178,928,10,N,N,-,-1,-1
WESLEY.txt,289315,290296,981,10,N,N,-,-1,-1
WESLEY.txt,289379,290330,951,10,N,N,-,-1,-1
WESLEY.txt,289489,290406,917,10,N,N,-,-1,-1
WESLEY.txt,289676,290460,784,10,N,N,-,-1,-1
WESLEY.txt,289836,290515,679,10,N,N,-,-1,-1
WESLEY.txt,289962,290618,656,10,N,N,-,-1,-1
WESLEY.txt,289972,290682,710,10,N,N,-,-1,-1
WESLEY.txt,290050,290733,683,10,N,N,-,-1,-1
WESLEY.txt,290167,290847,680,10,N,N,-,-1,-1
WESLEY.txt,290178,290968,790,10,N,N,-,-1,-1
WESLEY.txt,290297,291027,730,10,N,N,-,-1,-1
WESLEY.txt,290331,291182,851,10,N,N,-,-1,-1
WESLEY.txt,290407,291209,802,10,N,N,-,-1,-1
WESLEY.txt,290461,291223,762,10,N,N,-,-1,-1
WESLEY.txt,290516,291269,753,10,N,N,-,-1,-1
WESLEY.txt,290618,291338,720,10,N,N,-,-1,-1
WESLEY.txt,290683,291485,802,10,N,N,-,-1,-1
WESLEY.txt,290734,291581,847,10,N,N,-,-1,-1
WESLEY.txt,290849,291657,808,10,N,N,-,-1,-1
WESLEY.txt,290969,291771,802,10,N,N,-,-1,-1
WESLEY.txt,291028,291804,776,10,N,N,-,-1,-1
WESLEY.txt,291183,291856,673,10,N,N,-,-1,-1
WESLEY.txt,291210,291870,660,10,N,N,-,-1,-1
WESLEY.txt,291223,292016,793,10,N,N,-,-1,-1
WESLEY.txt,291270,292215,945,10,N,N,-,-1,-1
WESLEY.txt,291339,292256,917,10,N,N,-,-1,-1
WESLEY.txt,291486,292391,905,10,N,N,-,-1,-1
WESLEY.txt,291581,292618,1037,10,N,N,-,-1,-1
WESLEY.txt,291658,292721,1063,10,N,N,-,-1,-1
WESLEY.txt,291772,292777,1005,10,N,N,-,-1,-1
WESLEY.txt,291805,292952,1147,10,N,N,-,-1,-1
WESLEY.txt,291857,293200,1343,10,N,N,-,-1,-1
WESLEY.txt,291870,293214,1344,10,N,N,-,-1,-1
WESLEY.txt,292017,293494,1477,10,N,N,-,-1,-1
WESLEY.txt,292216,293598,1382,10,N,N,-,-1,-1
WESLEY.txt,292257,293770,1513,10,N,N,-,-1,-1
WESLEY.txt,292392,293777,1385,10,N,N,-,-1,-1
WESLEY.txt,292619,293789,1170,10,N,N,-,-1,-1
WESLEY.txt,292721,293983,1262,10,N,N,-,-1,-1
WESLEY.txt,292778,294041,1263,10,N,N,-,-1,-1
WESLEY.txt,292953,294124,1171,10,N,N,-,-1,-1
WESLEY.txt,293201,294188,987,10,N,N,-,-1,-1
WESLEY.txt,293214,294282,1068,10,N,N,-,-1,-1
WESLEY.txt,293495,294387,892,10,N,N,-,-1,-1
WESLEY.txt,293599,294411,812,10,N,N,-,-1,-1
WESLEY.txt,293771,294518,747,10,N,N,-,-1,-1
WESLEY.txt,293778,294587,809,10,N,N,-,-1,-1
WESLEY.txt,293789,294687,898,10,N,N,-,-1,-1
WESLEY.txt,293984,294777,793,10,N,N,-,-1,-1
WESLEY.txt,294042,294863,821,10,N,N,-,-1,-1
WESLEY.txt,294125,294958,833,10,N,N,-,-1,-1
WESLEY.txt,294189,295036,847,10,N,N,-,-1,-1
WESLEY.txt,294283,295107,824,10,N,N,-,-1,-1
WESLEY.txt,294388,295207,819,10,N,N,-,-1,-1
WESLEY.txt,294412,295325,913,10,N,N,-,-1,-1
WESLEY.txt,294518,295694,1176,10,N,N,-,-1,-1
WESLEY.txt,294588,295769,1181,10,N,N,-,-1,-1
WESLEY.txt,294688,295853,1165,10,N,N,-,-1,-1
WESLEY.txt,294778,295972,1194,10,N,N,-,-1,-1
WESLEY.txt,294864,296054,1190,10,N,N,-,-1,-1
WESLEY.txt,294959,296157,1198,10,N,N,-,-1,-1
WESLEY.txt,295037,296192,1155,10,N,N,-,-1,-1
WESLEY.txt,295108,296255,1147,10,N,N,-,-1,-1
WESLEY.txt,295208,296443,1235,10,N,N,-,-1,-1
WESLEY.txt,295326,296530,1204,10,N,N,-,-1,-1
WESLEY.txt,295695,296610,915,10,N,N,-,-1,-1
WESLEY.txt,295770,296703,933,10,N,N,-,-1,-1
WESLEY.txt,295854,296872,1018,10,N,N,-,-1,-1
WESLEY.txt,295973,297005,1032,10,N,N,-,-1,-1
WESLEY.txt,296055,297062,1007,10,N,N,-,-1,-1
WESLEY.txt,296158,297152,994,10,N,N,-,-1,-1
WESLEY.txt,296194,297349,1155,10,N,N,-,-1,-1
WESLEY.txt,296257,297737,1480,10,N,N,-,-1,-1
WESLEY.txt,296443,297877,1434,10,N,N,-,-1,-1
WESLEY.txt,296531,297996,1465,10,N,N,-,-1,-1
WESLEY.txt,296611,298114,1503,10,N,N,-,-1,-1
WESLEY.txt,296704,298317,1613,10,N,N,-,-1,-1
WESLEY.txt,296873,298329,1456,10,N,N,-,-1,-1
WESLEY.txt,297006,298451,1445,10,N,N,-,-1,-1
WESLEY.txt,297063,298550,1487,10,N,N,-,-1,-1
WESLEY.txt,297153,298646,1493,10,N,N,-,-1,-1
WESLEY.txt,297350,298738,1388,10,N,N,-,-1,-1
WESLEY.txt,297738,298827,1089,10,N,N,-,-1,-1
WESLEY.txt,297878,299015,1137,10,N,N,-,-1,-1
WESLEY.txt,297997,299120,1123,10,N,N,-,-1,-1
WESLEY.txt,298115,299216,1101,10,N,N,-,-1,-1
WESLEY.txt,298318,299497,1179,10,N,N,-,-1,-1
WESLEY.txt,298329,299526,1197,10,N,N,-,-1,-1
WESLEY.txt,298452,299698,1246,10,N,N,-,-1,-1
WESLEY.txt,298551,299880,1329,10,N,N,-,-1,-1
WESLEY.txt,298647,299894,1247,10,N,N,-,-1,-1
WESLEY.txt,298739,300135,1396,10,N,N,-,-1,-1
WESLEY.txt,298828,300329,1501,10,N,N,-,-1,-1
WESLEY.txt,299016,300501,1485,10,N,N,-,-1,-1
WESLEY.txt,299120,300582,1462,10,N,N,-,-1,-1
WESLEY.txt,299217,300683,1466,10,N,N,-,-1,-1
WESLEY.txt,299498,300781,1283,10,N,N,-,-1,-1
WESLEY.txt,299527,300882,1355,10,N,N,-,-1,-1
WESLEY.txt,299699,300928,1229,10,N,N,-,-1,-1
WESLEY.txt,299881,300974,1093,10,N,N,-,-1,-1
WESLEY.txt,299894,301058,1164,10,N,N,-,-1,-1
WESLEY.txt,300136,301143,1007,10,N,N,-,-1,-1
WESLEY.txt,300330,301301,971,10,N,N,-,-1,-1
WESLEY.txt,300502,301394,892,10,N,N,-,-1,-1
WESLEY.txt,300583,301543,960,10,N,N,-,-1,-1
WESLEY.txt,300684,301636,952,10,N,N,-,-1,-1
WESLEY.txt,300782,301729,947,10,N,N,-,-1,-1
WESLEY.txt,300883,301946,1063,10,N,N,-,-1,-1
WESLEY.txt,300930,302008,1078,10,N,N,-,-1,-1
WESLEY.txt,300975,302144,1169,10,N,N,-,-1,-1
WESLEY.txt,301059,302219,1160,10,N,N,-,-1,-1
WESLEY.txt,301144,302399,1255,10,N,N,-,-1,-1
WESLEY.txt,301303,302458,1155,10,N,N,-,-1,-1
WESLEY.txt,301395,302628,1233,10,N,N,-,-1,-1
WESLEY.txt,301544,302712,1168,10,N,N,-,-1,-1
WESLEY.txt,301637,302802,1165,10,N,N,-,-1,-1
WESLEY.txt,301730,302972,1242,10,N,N,-,-1,-1
WESLEY.txt,301947,302985,1038,10,N,N,-,-1,-1
WESLEY.txt,302008,303158,1150,10,N,N,-,-1,-1
WESLEY.txt,302145,303220,1075,10,N,N,-,-1,-1
WESLEY.txt,302220,303231,1011,10,N,N,-,-1,-1
WESLEY.txt,302400,303389,989,10,N,N,-,-1,-1
WESLEY.txt,302458,303475,1017,10,N,N,-,-1,-1
WESLEY.txt,302629,303530,901,10,N,N,-,-1,-1
WESLEY.txt,302713,303603,890,10,N,N,-,-1,-1
WESLEY.txt,302804,303680,876,10,N,N,-,-1,-1
WESLEY.txt,302973,303772,799,10,N,N,-,-1,-1
WESLEY.txt,302985,303790,805,10,N,N,-,-1,-1
WESLEY.txt,303159,303865,706,10,N,N,-,-1,-1
WESLEY.txt,303221,303944,723,10,N,N,-,-1,-1
WESLEY.txt,303231,304057,826,10,N,N,-,-1,-1
WESLEY.txt,303390,304160,770,10,N,N,-,-1,-1
WESLEY.txt,303476,304269,793,10,N,N,-,-1,-1
WESLEY.txt,303531,304353,822,10,N,N,-,-1,-1
WESLEY.txt,303604,304438,834,10,N,N,-,-1,-1
WESLEY.txt,303681,304530,849,10,N,N,-,-1,-1
WESLEY.txt,303773,304584,811,10,N,N,-,-1,-1
WESLEY.txt,303790,304615,825,10,N,N,-,-1,-1
WESLEY.txt,303866,304641,775,10,N,N,-,-1,-1
WESLEY.txt,303945,304754,809,10,N,N,-,-1,-1
WESLEY.txt,304058,304868,810,10,N,N,-,-1,-1
WESLEY.txt,304161,304982,821,10,N,N,-,-1,-1
WESLEY.txt,304270,305007,737,10,N,N,-,-1,-1
WESLEY.txt,304354,305236,882,10,N,N,-,-1,-1
WESLEY.txt,304440,305288,848,10,N,N,-,-1,-1
WESLEY.txt,304531,305375,844,10,N,N,-,-1,-1
WESLEY.txt,304585,305502,917,10,N,N,-,-1,-1
WESLEY.txt,304616,305583,967,10,N,N,-,-1,-1
WESLEY.txt,304641,305628,987,10,N,N,-,-1,-1
WESLEY.txt,304755,305670,915,10,N,N,-,-1,-1
WESLEY.txt,304869,305703,834,10,N,N,-,-1,-1
WESLEY.txt,304983,305810,827,10,N,N,-,-1,-1
WESLEY.txt,305007,305824,817,10,N,N,-,-1,-1
WESLEY.txt,305237,305994,757,10,N,N,-,-1,-1
WESLEY.txt,305289,306090,801,10,N,N,-,-1,-1
WESLEY.txt,305376,306183,807,10,N,N,-,-1,-1
WESLEY.txt,305503,306214,711,10,N,N,-,-1,-1
WESLEY.txt,305584,306292,708,10,N,N,-,-1,-1
WESLEY.txt,305629,306304,675,10,N,N,-,-1,-1
WESLEY.txt,305671,306451,780,10,N,N,-,-1,-1
WESLEY.txt,305704,306558,854,10,N,N,-,-1,-1
WESLEY.txt,305811,306747,936,10,N,N,-,-1,-1
WESLEY.txt,305824,306845,1021,10,N,N,-,-1,-1
WESLEY.txt,305996,306873,877,10,N,N,-,-1,-1
WESLEY.txt,306091,306918,827,10,N,N,-,-1,-1
WESLEY.txt,306184,307009,825,10,N,N,-,-1,-1
WESLEY.txt,306214,307103,889,10,N,N,-,-1,-1
WESLEY.txt,306293,307151,858,10,N,N,-,-1,-1
WESLEY.txt,306305,307165,860,10,N,N,-,-1,-1
WESLEY.txt,306452,307392,940,10,N,N,-,-1,-1
WESLEY.txt,306559,307483,924,10,N,N,-,-1,-1
WESLEY.txt,306748,307646,898,10,N,N,-,-1,-1
WESLEY.txt,306846,307858,1012,10,N,N,-,-1,-1
WESLEY.txt,306874,307941,1067,10,N,N,-,-1,-1
WESLEY.txt,306919,308047,1128,10,N,N,-,-1,-1
WESLEY.txt,307010,308117,1107,10,N,N,-,-1,-1
WESLEY.txt,307104,308170,1066,10,N,N,-,-1,-1
WESLEY.txt,307153,308229,1076,10,N,N,-,-1,-1
WESLEY.txt,307167,308391,1224,10,N,N,-,-1,-1
WESLEY.txt,307393,308406,1013,10,N,N,-,-1,-1
WESLEY.txt,307484,308471,987,10,N,N,-,-1,-1
WESLEY.txt,307647,308556,909,10,N,N,-,-1,-1
WESLEY.txt,307859,308641,782,10,N,N,-,-1,-1
WESLEY.txt,307942,308675,733,10,N,N,-,-1,-1
WESLEY.txt,308048,308800,752,10,N,N,-,-1,-1
WESLEY.txt,308118,308888,770,10,N,N,-,-1,-1
WESLEY.txt,308171,309070,899,10,N,N,-,-1,-1
WESLEY.txt,308231,309163,932,10,N,N,-,-1,-1
WESLEY.txt,308392,309193,801,10,N,N,-,-1,-1
WESLEY.txt,308406,309311,905,10,N,N,-,-1,-1
WESLEY.txt,308472,309368,896,10,N,N,-,-1,-1
WESLEY.txt,308557,309428,871,10,N,N,-,-1,-1
WESLEY.txt,308642,309508,866,10,N,N,-,-1,-1
WESLEY.txt,308676,309602,926,10,N,N,-,-1,-1
WESLEY.txt,308801,309691,890,10,N,N,-,-1,-1
WESLEY.txt,308889,309859,970,10,N,N,-,-1,-1
WESLEY.txt,309072,309952,880,10,N,N,-,-1,-1
WESLEY.txt,309164,310027,863,10,N,N,-,-1,-1
WESLEY.txt,309194,310177,983,10,N,N,-,-1,-1
WESLEY.txt,309311,310197,886,10,N,N,-,-1,-1
WESLEY.txt,309369,310276,907,10,N,N,-,-1,-1
WESLEY.txt,309429,310300,871,10,N,N,-,-1,-1
WESLEY.txt,309509,310324,815,10,N,N,-,-1,-1
WESLEY.txt,309603,310374,771,10,N,N,-,-1,-1
WESLEY.txt,309692,310486,794,10,N,N,-,-1,-1
WESLEY.txt,309860,310588,728,10,N,N,-,-1,-1
WESLEY.txt,309953,310673,720,10,N,N,-,-1,-1
WESLEY.txt,310028,310685,657,10,N,N,-,-1,-1
WESLEY.txt,310178,310787,609,10,N,N,-,-1,-1
WESLEY.txt,310197,310870,673,10,N,N,-,-1,-1
WESLEY.txt,310277,310945,668,10,N,N,-,-1,-1
WESLEY.txt,310301,311221,920,10,N,N,-,-1,-1
WESLEY.txt,310325,311379,1054,10,N,N,-,-1,-1
WESLEY.txt,310375,311423,1048,10,N,N,-,-1,-1
WESLEY.txt,310488,311544,1056,10,N,N,-,-1,-1
WESLEY.txt,310589,311649,1060,10,N,N,-,-1,-1
WESLEY.txt,310674,311735,1061,10,N,N,-,-1,-1
WESLEY.txt,310685,311887,1202,10,N,N,-,-1,-1
WESLEY.txt,310788,311901,1113,10,N,N,-,-1,-1
WESLEY.txt,310871,311969,1098,10,N,N,-,-1,-1
WESLEY.txt,310946,312066,1120,10,N,N,-,-1,-1
WESLEY.txt,311222,312129,907,10,N,N,-,-1,-1
WESLEY.txt,311380,312207,827,10,N,N,-,-1,-1
WESLEY.txt,311424,312330,906,10,N,N,-,-1,-1
WESLEY.txt,311545,312511,966,10,N,N,-,-1,-1
WESLEY.txt,311650,312694,1044,10,N,N,-,-1,-1
WESLEY.txt,311736,312747,1011,10,N,N,-,-1,-1
WESLEY.txt,311888,312776,888,10,N,N,-,-1,-1
WESLEY.txt,311901,312809,908,10,N,N,-,-1,-1
WESLEY.txt,311970,312860,890,10,N,N,-,-1,-1
WESLEY.txt,312067,313051,984,10,N,N,-,-1,-1
WESLEY.txt,312130,313080,950,10,N,N,-,-1,-1
WESLEY.txt,312208,313235,1027,10,N,N,-,-1,-1
WESLEY.txt,312331,313247,916,10,N,N,-,-1,-1
WESLEY.txt,312512,313401,889,10,N,N,-,-1,-1
WESLEY.txt,312695,313408,713,10,N,N,-,-1,-1
WESLEY.txt,312748,313488,740,10,N,N,-,-1,-1
WESLEY.txt,312777,313513,736,10,N,N,-,-1,-1
WESLEY.txt,312810,313713,903,10,N,N,-,-1,-1
WESLEY.txt,312861,313725,864,10,N,N,-,-1,-1
WESLEY.txt,313052,313822,770,10,N,N,-,-1,-1
WESLEY.txt,313081,313921,840,10,N,N,-,-1,-1
WESLEY.txt,313236,313934,698,10,N,N,-,-1,-1
WESLEY.txt,313247,314029,782,10,N,N,-,-1,-1
WESLEY.txt,313402,314087,685,10,N,N,-,-1,-1
WESLEY.txt,313409,314196,787,10,N,N,-,-1,-1
WESLEY.txt,313489,314243,754,10,N,N,-,-1,-1
WESLEY.txt,313514,314302,788,10,N,N,-,-1,-1
WESLEY.txt,313714,314321,607,10,N,N,-,-1,-1
WESLEY.txt,313725,314391,666,10,N,N,-,-1,-1
WESLEY.txt,313823,314423,600,10,N,N,-,-1,-1
WESLEY.txt,313922,314496,574,10,N,N,-,-1,-1
WESLEY.txt,313934,314568,634,10,N,N,-,-1,-1
WESLEY.txt,314030,314613,583,10,N,N,-,-1,-1
WESLEY.txt,314088,314762,674,10,N,N,-,-1,-1
WESLEY.txt,314197,314818,621,10,N,N,-,-1,-1
WESLEY.txt,314244,314867,623,10,N,N,-,-1,-1
WESLEY.txt,314303,315071,768,10,N,N,-,-1,-1
WESLEY.txt,314321,315101,780,10,N,N,-,-1,-1
WESLEY.txt,314392,315181,789,10,N,N,-,-1,-1
WESLEY.txt,314424,315281,857,10,N,N,-,-1,-1
WESLEY.txt,314497,315509,1012,10,N,N,-,-1,-1
WESLEY.txt,314569,315675,1106,10,N,N,-,-1,-1
WESLEY.txt,314614,315706,1092,10,N,N,-,-1,-1
WESLEY.txt,314763,315791,1028,10,N,N,-,-1,-1
WESLEY.txt,314819,315891,1072,10,N,N,-,-1,-1
WESLEY.txt,314868,315903,1035,10,N,Y,1437472380836,351899,352666
WESLEY.txt,315072,316075,1003,10,N,Y,1437472380836,351899,352666
WESLEY.txt,315101,316159,1058,10,N,Y,1437472380836,351899,352666
WESLEY.txt,315183,316233,1050,10,N,Y,1437472380836,351899,352666
WESLEY.txt,315282,316321,1039,10,N,Y,1437472380836,351899,352666
WESLEY.txt,315510,316402,892,10,N,Y,1437472380836,351899,352666
WESLEY.txt,315676,316470,794,10,N,Y,1437472380836,351899,352666
WESLEY.txt,315706,316580,874,10,N,Y,1437472380836,351899,352666
WESLEY.txt,315792,316824,1032,10,N,Y,1437472380836,351899,352666
WESLEY.txt,315892,316872,980,10,N,Y,1437472380836,351899,352666
WESLEY.txt,315903,316957,1054,10,N,Y,1437472380836,351899,352666
WESLEY.txt,316076,317011,935,10,N,Y,1437472380836,351899,352666
WESLEY.txt,316160,317105,945,10,N,Y,1437472380836,351899,352666
WESLEY.txt,316234,317389,1155,10,N,Y,1437472380836,351899,352666
WESLEY.txt,316322,317510,1188,10,N,N,-,-1,-1
WESLEY.txt,316402,317532,1130,10,N,N,-,-1,-1
WESLEY.txt,316471,317566,1095,10,N,N,-,-1,-1
WESLEY.txt,316581,317638,1057,10,N,N,-,-1,-1
WESLEY.txt,316826,317745,919,10,N,N,-,-1,-1
WESLEY.txt,316873,317832,959,10,N,N,-,-1,-1
WESLEY.txt,316958,318038,1080,10,N,N,-,-1,-1
WESLEY.txt,317012,318160,1148,10,N,N,-,-1,-1
WESLEY.txt,317106,318304,1198,10,N,N,-,-1,-1
WESLEY.txt,317390,318326,936,10,N,N,-,-1,-1
WESLEY.txt,317511,318401,890,10,N,N,-,-1,-1
WESLEY.txt,317532,318490,958,10,N,N,-,-1,-1
WESLEY.txt,317567,318502,935,10,N,N,-,-1,-1
WESLEY.txt,317639,318668,1029,10,N,N,-,-1,-1
WESLEY.txt,317747,318738,991,10,N,N,-,-1,-1
WESLEY.txt,317833,318905,1072,10,N,N,-,-1,-1
WESLEY.txt,318039,318917,878,10,N,N,-,-1,-1
WESLEY.txt,318161,319024,863,10,N,N,-,-1,-1
WESLEY.txt,318305,319132,827,10,N,N,-,-1,-1
WESLEY.txt,318326,319210,884,10,N,N,-,-1,-1
WESLEY.txt,318402,319291,889,10,N,N,-,-1,-1
WESLEY.txt,318491,319330,839,10,N,N,-,-1,-1
WESLEY.txt,318502,319748,1246,10,N,N,-,-1,-1
WESLEY.txt,318670,319894,1224,10,N,N,-,-1,-1
WESLEY.txt,318739,319974,1235,10,N,N,-,-1,-1
WESLEY.txt,318906,320154,1248,10,N,N,-,-1,-1
WESLEY.txt,318917,320241,1324,10,N,N,-,-1,-1
WESLEY.txt,319026,320357,1331,10,N,N,-,-1,-1
WESLEY.txt,319133,320459,1326,10,N,N,-,-1,-1
WESLEY.txt,319211,320824,1613,10,N,N,-,-1,-1
WESLEY.txt,319292,320869,1577,10,N,N,-,-1,-1
WESLEY.txt,319331,320885,1554,10,N,N,-,-1,-1
WESLEY.txt,319749,320902,1153,10,N,N,-,-1,-1
WESLEY.txt,319895,320924,1029,10,N,N,-,-1,-1
WESLEY.txt,319975,320968,993,10,N,N,-,-1,-1
WESLEY.txt,320155,321069,914,10,N,N,-,-1,-1
WESLEY.txt,320242,321188,946,10,N,N,-,-1,-1
WESLEY.txt,320358,321254,896,10,N,N,-,-1,-1
WESLEY.txt,320460,321363,903,10,N,N,-,-1,-1
WESLEY.txt,320825,321509,684,10,N,N,-,-1,-1
WESLEY.txt,320870,321596,726,10,N,N,-,-1,-1
WESLEY.txt,320886,321724,838,10,N,N,-,-1,-1
WESLEY.txt,320903,321835,932,10,N,N,-,-1,-1
WESLEY.txt,320925,322056,1131,10,N,N,-,-1,-1
WESLEY.txt,320969,322171,1202,10,N,N,-,-1,-1
WESLEY.txt,321070,322326,1256,10,N,N,-,-1,-1
WESLEY.txt,321189,322351,1162,10,N,N,-,-1,-1
WESLEY.txt,321255,322370,1115,10,N,N,-,-1,-1
WESLEY.txt,321365,322421,1056,10,N,N,-,-1,-1
WESLEY.txt,321510,322461,951,10,N,N,-,-1,-1
WESLEY.txt,321597,322524,927,10,N,N,-,-1,-1
WESLEY.txt,321725,322665,940,10,N,N,-,-1,-1
WESLEY.txt,321837,322741,904,10,N,N,-,-1,-1
WESLEY.txt,322057,322830,773,10,N,N,-,-1,-1
WESLEY.txt,322172,322916,744,10,N,N,-,-1,-1
WESLEY.txt,322327,323012,685,10,N,N,-,-1,-1
WESLEY.txt,322352,323083,731,10,N,N,-,-1,-1
WESLEY.txt,322370,323104,734,10,N,N,-,-1,-1
WESLEY.txt,322422,323272,850,10,N,N,-,-1,-1
WESLEY.txt,322462,323285,823,10,N,N,-,-1,-1
WESLEY.txt,322525,323453,928,10,N,N,-,-1,-1
WESLEY.txt,322666,323562,896,10,N,N,-,-1,-1
WESLEY.txt,322742,323667,925,10,N,N,-,-1,-1
WESLEY.txt,322831,323779,948,10,N,N,-,-1,-1
WESLEY.txt,322917,323854,937,10,N,N,-,-1,-1
WESLEY.txt,323012,323991,979,10,N,N,-,-1,-1
WESLEY.txt,323084,324003,919,10,N,N,-,-1,-1
WESLEY.txt,323105,324024,919,10,N,N,-,-1,-1
WESLEY.txt,323273,324076,803,10,N,N,-,-1,-1
WESLEY.txt,323285,324508,1223,10,N,N,-,-1,-1
WESLEY.txt,323454,324522,1068,10,N,N,-,-1,-1
WESLEY.txt,323563,324607,1044,10,N,N,-,-1,-1
WESLEY.txt,323668,324882,1214,10,N,N,-,-1,-1
WESLEY.txt,323781,324967,1186,10,N,N,-,-1,-1
WESLEY.txt,323855,325014,1159,10,N,N,-,-1,-1
WESLEY.txt,323992,325068,1076,10,N,N,-,-1,-1
WESLEY.txt,324003,325150,1147,10,N,N,-,-1,-1
WESLEY.txt,324025,325234,1209,10,N,N,-,-1,-1
WESLEY.txt,324077,325306,1229,10,N,N,-,-1,-1
WESLEY.txt,324509,325406,897,10,N,N,-,-1,-1
WESLEY.txt,324522,325573,1051,10,N,N,-,-1,-1
WESLEY.txt,324608,325651,1043,10,N,N,-,-1,-1
WESLEY.txt,324883,325721,838,10,N,N,-,-1,-1
WESLEY.txt,324968,325756,788,10,N,N,-,-1,-1
WESLEY.txt,325015,325806,791,10,N,N,-,-1,-1
WESLEY.txt,325069,325897,828,10,N,N,-,-1,-1
WESLEY.txt,325151,325909,758,10,N,N,-,-1,-1
WESLEY.txt,325234,326030,796,10,N,N,-,-1,-1
WESLEY.txt,325307,326166,859,10,N,N,-,-1,-1
WESLEY.txt,325407,326372,965,10,N,N,-,-1,-1
WESLEY.txt,325574,326414,840,10,N,N,-,-1,-1
WESLEY.txt,325652,326620,968,10,N,N,-,-1,-1
WESLEY.txt,325722,326650,928,10,N,N,-,-1,-1
WESLEY.txt,325757,326699,942,10,N,N,-,-1,-1
WESLEY.txt,325807,326813,1006,10,N,N,-,-1,-1
WESLEY.txt,325898,326858,960,10,N,N,-,-1,-1
WESLEY.txt,325909,326886,977,10,N,N,-,-1,-1
WESLEY.txt,326031,326919,888,10,N,N,-,-1,-1
WESLEY.txt,326167,326960,793,10,N,N,-,-1,-1
WESLEY.txt,326373,327103,730,10,N,N,-,-1,-1
WESLEY.txt,326415,327193,778,10,N,N,-,-1,-1
WESLEY.txt,326621,327271,650,10,N,N,-,-1,-1
WESLEY.txt,326651,327439,788,10,N,N,-,-1,-1
WESLEY.txt,326700,327451,751,10,N,N,-,-1,-1
WESLEY.txt,326814,327505,691,10,N,N,-,-1,-1
WESLEY.txt,326860,327555,695,10,N,N,-,-1,-1
WESLEY.txt,326887,327605,718,10,N,N,-,-1,-1
WESLEY.txt,326920,327841,921,10,N,N,-,-1,-1
WESLEY.txt,326961,327925,964,10,N,N,-,-1,-1
WESLEY.txt,327104,328122,1018,10,N,N,-,-1,-1
WESLEY.txt,327194,328165,971,10,N,N,-,-1,-1
WESLEY.txt,327272,328214,942,10,N,N,-,-1,-1
WESLEY.txt,327440,328293,853,10,N,N,-,-1,-1
WESLEY.txt,327451,328303,852,10,N,N,-,-1,-1
WESLEY.txt,327506,328394,888,10,N,N,-,-1,-1
WESLEY.txt,327556,328472,916,10,N,N,-,-1,-1
WESLEY.txt,327606,328508,902,10,N,N,-,-1,-1
WESLEY.txt,327842,328602,760,10,N,N,-,-1,-1
WESLEY.txt,327925,328779,854,10,N,N,-,-1,-1
WESLEY.txt,328123,328800,677,10,N,N,-,-1,-1
WESLEY.txt,328166,328890,724,10,N,N,-,-1,-1
WESLEY.txt,328215,329089,874,10,N,N,-,-1,-1
WESLEY.txt,328294,329195,901,10,N,N,-,-1,-1
WESLEY.txt,328304,329299,995,10,N,N,-,-1,-1
WESLEY.txt,328395,329311,916,10,N,N,-,-1,-1
WESLEY.txt,328473,329552,1079,10,N,N,-,-1,-1
WESLEY.txt,328509,329579,1070,10,N,N,-,-1,-1
WESLEY.txt,328603,329593,990,10,N,N,-,-1,-1
WESLEY.txt,328780,329665,885,10,N,N,-,-1,-1
WESLEY.txt,328800,329712,912,10,N,N,-,-1,-1
WESLEY.txt,328891,329773,882,10,N,N,-,-1,-1
WESLEY.txt,329091,329859,768,10,N,N,-,-1,-1
WESLEY.txt,329196,329878,682,10,N,N,-,-1,-1
WESLEY.txt,329300,329939,639,10,N,N,-,-1,-1
WESLEY.txt,329311,329976,665,10,N,N,-,-1,-1
WESLEY.txt,329553,330075,522,10,N,N,-,-1,-1
WESLEY.txt,329579,330163,584,10,N,N,-,-1,-1
WESLEY.txt,329594,330256,662,10,N,N,-,-1,-1
WESLEY.txt,329666,330350,684,10,N,N,-,-1,-1
WESLEY.txt,329713,330388,675,10,N,N,-,-1,-1
WESLEY.txt,329774,330433,659,10,N,N,-,-1,-1
WESLEY.txt,329860,330529,669,10,N,N,-,-1,-1
WESLEY.txt,329878,330633,755,10,N,N,-,-1,-1
WESLEY.txt,329940,330791,851,10,N,N,-,-1,-1
WESLEY.txt,329977,330920,943,10,N,N,-,-1,-1
WESLEY.txt,330076,331064,988,10,N,N,-,-1,-1
WESLEY.txt,330164,331489,1325,10,N,N,-,-1,-1
WESLEY.txt,330257,331850,1593,10,N,N,-,-1,-1
WESLEY.txt,330350,332003,1653,10,N,N,-,-1,-1
WESLEY.txt,330389,332197,1808,10,N,N,-,-1,-1
WESLEY.txt,330435,332298,1863,10,N,N,-,-1,-1
WESLEY.txt,330530,332429,1899,10,N,N,-,-1,-1
WESLEY.txt,330635,332767,2132,10,N,N,-,-1,-1
WESLEY.txt,330792,332878,2086,10,N,N,-,-1,-1
WESLEY.txt,330921,332923,2002,10,N,N,-,-1,-1
WESLEY.txt,331065,333367,2302,10,N,N,-,-1,-1
WESLEY.txt,331490,333458,1968,10,N,N,-,-1,-1
WESLEY.txt,331851,333704,1853,10,N,N,-,-1,-1
WESLEY.txt,332004,333895,1891,10,N,N,-,-1,-1
WESLEY.txt,332198,334000,1802,10,N,N,-,-1,-1
WESLEY.txt,332299,334126,1827,10,N,N,-,-1,-1
WESLEY.txt,332430,334173,1743,10,N,N,-,-1,-1
WESLEY.txt,332768,334297,1529,10,N,N,-,-1,-1
WESLEY.txt,332879,334425,1546,10,N,N,-,-1,-1
WESLEY.txt,332924,334524,1600,10,N,N,-,-1,-1
WESLEY.txt,333368,334580,1212,10,N,N,-,-1,-1
WESLEY.txt,333459,334724,1265,10,N,N,-,-1,-1
WESLEY.txt,333705,334894,1189,10,N,N,-,-1,-1
WESLEY.txt,333896,334988,1092,10,N,N,-,-1,-1
WESLEY.txt,334001,335102,1101,10,N,N,-,-1,-1
WESLEY.txt,334127,335252,1125,10,N,N,-,-1,-1
WESLEY.txt,334174,335318,1144,10,N,N,-,-1,-1
WESLEY.txt,334298,335409,1111,10,N,N,-,-1,-1
WESLEY.txt,334426,335441,1015,10,N,N,-,-1,-1
WESLEY.txt,334525,335504,979,10,N,N,-,-1,-1
WESLEY.txt,334581,335681,1100,10,N,N,-,-1,-1
WESLEY.txt,334725,335757,1032,10,N,N,-,-1,-1
WESLEY.txt,334896,335769,873,10,N,N,-,-1,-1
WESLEY.txt,334989,335845,856,10,N,N,-,-1,-1
WESLEY.txt,335103,336166,1063,10,N,N,-,-1,-1
WESLEY.txt,335253,336244,991,10,N,N,-,-1,-1
WESLEY.txt,335319,336416,1097,10,N,N,-,-1,-1
WESLEY.txt,335410,336602,1192,10,N,N,-,-1,-1
WESLEY.txt,335442,336731,1289,10,N,N,-,-1,-1
WESLEY.txt,335505,336797,1292,10,N,N,-,-1,-1
WESLEY.txt,335682,336921,1239,10,N,N,-,-1,-1
WESLEY.txt,335758,336996,1238,10,N,N,-,-1,-1
WESLEY.txt,335769,337181,1412,10,N,N,-,-1,-1
WESLEY.txt,335846,337272,1426,10,N,N,-,-1,-1
WESLEY.txt,336167,337417,1250,10,N,N,-,-1,-1
WESLEY.txt,336245,337540,1295,10,N,N,-,-1,-1
WESLEY.txt,336417,337622,1205,10,N,N,-,-1,-1
WESLEY.txt,336603,337644,1041,10,N,N,-,-1,-1
WESLEY.txt,336732,337731,999,10,N,N,-,-1,-1
WESLEY.txt,336798,338005,1207,10,N,N,-,-1,-1
WESLEY.txt,336922,338026,1104,10,N,N,-,-1,-1
WESLEY.txt,336997,338057,1060,10,N,N,-,-1,-1
WESLEY.txt,337182,338230,1048,10,N,N,-,-1,-1
WESLEY.txt,337273,338282,1009,10,N,N,-,-1,-1
WESLEY.txt,337418,338424,1006,10,N,N,-,-1,-1
WESLEY.txt,337541,338545,1004,10,N,N,-,-1,-1
WESLEY.txt,337623,338630,1007,10,N,N,-,-1,-1
WESLEY.txt,337644,338739,1095,10,N,N,-,-1,-1
WESLEY.txt,337732,338852,1120,10,N,N,-,-1,-1
WESLEY.txt,338006,338942,936,10,N,N,-,-1,-1
WESLEY.txt,338026,338959,933,10,N,N,-,-1,-1
WESLEY.txt,338058,338983,925,10,N,N,-,-1,-1
WESLEY.txt,338231,339106,875,10,N,N,-,-1,-1
WESLEY.txt,338283,339152,869,10,N,N,-,-1,-1
WESLEY.txt,338425,339274,849,10,N,N,-,-1,-1
WESLEY.txt,338546,339342,796,10,N,N,-,-1,-1
WESLEY.txt,338631,339392,761,10,N,N,-,-1,-1
WESLEY.txt,338740,339393,653,10,N,N,-,-1,-1
WESLEY.txt,338853,339577,724,10,N,N,-,-1,-1
WESLEY.txt,338943,339683,740,10,N,N,-,-1,-1
WESLEY.txt,338959,339751,792,10,N,N,-,-1,-1
WESLEY.txt,338984,339868,884,10,N,N,-,-1,-1
WESLEY.txt,339107,339972,865,10,N,N,-,-1,-1
WESLEY.txt,339153,340014,861,10,N,N,-,-1,-1
WESLEY.txt,339275,340027,752,10,N,N,-,-1,-1
WESLEY.txt,339343,340084,741,10,N,N,-,-1,-1
WESLEY.txt,339392,340184,792,10,N,N,-,-1,-1
WESLEY.txt,339394,340292,898,10,N,N,-,-1,-1
WESLEY.txt,339578,340372,794,10,N,N,-,-1,-1
WESLEY.txt,339684,340503,819,10,N,N,-,-1,-1
WESLEY.txt,339752,340598,846,10,N,N,-,-1,-1
WESLEY.txt,339869,340780,911,10,N,N,-,-1,-1
WESLEY.txt,339973,340847,874,10,N,N,-,-1,-1
WESLEY.txt,340015,340858,843,10,N,N,-,-1,-1
WESLEY.txt,340027,340877,850,10,N,N,-,-1,-1
WESLEY.txt,340085,340890,805,10,N,N,-,-1,-1
WESLEY.txt,340185,340929,744,10,N,N,-,-1,-1
WESLEY.txt,340293,341003,710,10,N,N,-,-1,-1
WESLEY.txt,340373,341018,645,10,N,N,-,-1,-1
WESLEY.txt,340504,341060,556,10,N,N,-,-1,-1
WESLEY.txt,340599,341102,503,10,N,N,-,-1,-1
WESLEY.txt,340781,341181,400,10,N,N,-,-1,-1
WESLEY.txt,340848,341228,380,10,N,N,-,-1,-1
WESLEY.txt,340858,341278,420,10,N,N,-,-1,-1
WESLEY.txt,340878,341370,492,10,N,N,-,-1,-1
WESLEY.txt,340891,341425,534,10,N,N,-,-1,-1
WESLEY.txt,340930,341433,503,10,N,N,-,-1,-1
WESLEY.txt,341004,341563,559,10,N,N,-,-1,-1
WESLEY.txt,341018,341636,618,10,N,N,-,-1,-1
WESLEY.txt,341061,341719,658,10,N,N,-,-1,-1
WESLEY.txt,341103,341804,701,10,N,N,-,-1,-1
WESLEY.txt,341182,341914,732,10,N,N,-,-1,-1
WESLEY.txt,341229,342015,786,10,N,N,-,-1,-1
WESLEY.txt,341279,342116,837,10,N,N,-,-1,-1
WESLEY.txt,341371,342243,872,10,N,N,-,-1,-1
WESLEY.txt,341426,342382,956,10,N,N,-,-1,-1
WESLEY.txt,341434,342476,1042,10,N,N,-,-1,-1
WESLEY.txt,341564,342671,1107,10,N,N,-,-1,-1
WESLEY.txt,341637,342678,1041,10,N,N,-,-1,-1
WESLEY.txt,341720,342759,1039,10,N,N,-,-1,-1
WESLEY.txt,341805,342891,1086,10,N,N,-,-1,-1
WESLEY.txt,341915,342903,988,10,N,N,-,-1,-1
WESLEY.txt,342016,343071,1055,10,N,N,-,-1,-1
WESLEY.txt,342117,343158,1041,10,N,N,-,-1,-1
WESLEY.txt,342244,343265,1021,10,N,N,-,-1,-1
WESLEY.txt,342383,343313,930,10,N,N,-,-1,-1
WESLEY.txt,342477,343477,1000,10,N,N,-,-1,-1
WESLEY.txt,342672,343543,871,10,N,N,-,-1,-1
WESLEY.txt,342679,343575,896,10,N,N,-,-1,-1
WESLEY.txt,342760,343734,974,10,N,N,-,-1,-1
WESLEY.txt,342892,343826,934,10,N,N,-,-1,-1
WESLEY.txt,342903,343926,1023,10,N,N,-,-1,-1
WESLEY.txt,343073,344132,1059,10,N,N,-,-1,-1
WESLEY.txt,343159,344227,1068,10,N,N,-,-1,-1
WESLEY.txt,343267,344287,1020,10,N,N,-,-1,-1
WESLEY.txt,343314,344342,1028,10,N,N,-,-1,-1
WESLEY.txt,343478,344420,942,10,N,N,-,-1,-1
WESLEY.txt,343543,344493,950,10,N,N,-,-1,-1
WESLEY.txt,343576,344590,1014,10,N,N,-,-1,-1
WESLEY.txt,343735,344686,951,10,N,N,-,-1,-1
WESLEY.txt,343827,344690,863,10,N,N,-,-1,-1
WESLEY.txt,343927,344712,785,10,N,N,-,-1,-1
WESLEY.txt,344133,344795,662,10,N,N,-,-1,-1
WESLEY.txt,344228,344876,648,10,N,N,-,-1,-1
WESLEY.txt,344288,344911,623,10,N,N,-,-1,-1
WESLEY.txt,344343,345055,712,10,N,N,-,-1,-1
WESLEY.txt,344421,345129,708,10,N,N,-,-1,-1
WESLEY.txt,344494,345250,756,10,N,N,-,-1,-1
WESLEY.txt,344591,345280,689,10,N,N,-,-1,-1
WESLEY.txt,344687,345341,654,10,N,N,-,-1,-1
WESLEY.txt,344690,345353,663,10,N,N,-,-1,-1
WESLEY.txt,344713,345463,750,10,N,N,-,-1,-1
WESLEY.txt,344796,345529,733,10,N,N,-,-1,-1
WESLEY.txt,344877,345593,716,10,N,N,-,-1,-1
WESLEY.txt,344912,345695,783,10,N,N,-,-1,-1
WESLEY.txt,345057,345764,707,10,N,N,-,-1,-1
WESLEY.txt,345130,345852,722,10,N,N,-,-1,-1
WESLEY.txt,345251,345944,693,10,N,N,-,-1,-1
WESLEY.txt,345281,346028,747,10,N,N,-,-1,-1
WESLEY.txt,345342,346040,698,10,N,N,-,-1,-1
WESLEY.txt,345353,346101,748,10,N,N,-,-1,-1
WESLEY.txt,345464,346293,829,10,N,N,-,-1,-1
WESLEY.txt,345530,346400,870,10,N,N,-,-1,-1
WESLEY.txt,345594,346415,821,10,N,N,-,-1,-1
WESLEY.txt,345695,346491,796,10,N,N,-,-1,-1
WESLEY.txt,345765,346537,772,10,N,N,-,-1,-1
WESLEY.txt,345853,346566,713,10,N,N,-,-1,-1
WESLEY.txt,345945,346653,708,10,N,N,-,-1,-1
WESLEY.txt,346029,346888,859,10,N,N,-,-1,-1
WESLEY.txt,346040,346999,959,10,N,N,-,-1,-1
WESLEY.txt,346102,347077,975,10,N,N,-,-1,-1
WESLEY.txt,346294,347162,868,10,N,N,-,-1,-1
WESLEY.txt,346401,347266,865,10,N,N,-,-1,-1
WESLEY.txt,346415,347346,931,10,N,N,-,-1,-1
WESLEY.txt,346492,347434,942,10,N,N,-,-1,-1
WESLEY.txt,346538,347737,1199,10,N,N,-,-1,-1
WESLEY.txt,346567,348011,1444,10,N,N,-,-1,-1
WESLEY.txt,346654,348176,1522,10,N,N,-,-1,-1
WESLEY.txt,346889,348274,1385,10,N,N,-,-1,-1
WESLEY.txt,347000,348289,1289,10,N,N,-,-1,-1
WESLEY.txt,347078,348352,1274,10,N,N,-,-1,-1
WESLEY.txt,347163,348547,1384,10,N,N,-,-1,-1
WESLEY.txt,347266,348582,1316,10,N,N,-,-1,-1
WESLEY.txt,347347,348677,1330,10,N,N,-,-1,-1
WESLEY.txt,347435,348719,1284,10,N,N,-,-1,-1
WESLEY.txt,347738,348789,1051,10,N,N,-,-1,-1
WESLEY.txt,348012,348867,855,10,N,N,-,-1,-1
WESLEY.txt,348177,348887,710,10,N,N,-,-1,-1
WESLEY.txt,348275,348940,665,10,N,N,-,-1,-1
WESLEY.txt,348289,349023,734,10,N,N,-,-1,-1
WESLEY.txt,348353,349031,678,10,N,N,-,-1,-1
WESLEY.txt,348548,349073,525,10,N,N,-,-1,-1
WESLEY.txt,348583,349246,663,10,N,N,-,-1,-1
WESLEY.txt,348678,349323,645,10,N,N,-,-1,-1
WESLEY.txt,348720,349400,680,10,N,N,-,-1,-1
WESLEY.txt,348791,349420,629,10,N,N,-,-1,-1
WESLEY.txt,348868,349510,642,10,N,N,-,-1,-1
WESLEY.txt,348887,349586,699,10,N,N,-,-1,-1
WESLEY.txt,348941,349816,875,10,N,N,-,-1,-1
WESLEY.txt,349024,349910,886,10,N,N,-,-1,-1
WESLEY.txt,349032,350061,1029,10,N,N,-,-1,-1
WESLEY.txt,349074,350178,1104,10,N,N,-,-1,-1
WESLEY.txt,349247,350230,983,10,N,N,-,-1,-1
WESLEY.txt,349323,350243,920,10,N,N,-,-1,-1
WESLEY.txt,349401,350331,930,10,N,N,-,-1,-1
WESLEY.txt,349421,350412,991,10,N,N,-,-1,-1
WESLEY.txt,349511,350579,1068,10,N,N,-,-1,-1
WESLEY.txt,349587,350603,1016,10,N,N,-,-1,-1
WESLEY.txt,349817,350795,978,10,N,N,-,-1,-1
WESLEY.txt,349911,350886,975,10,N,N,-,-1,-1
WESLEY.txt,350062,351073,1011,10,N,N,-,-1,-1
WESLEY.txt,350179,351229,1050,10,N,N,-,-1,-1
WESLEY.txt,350231,351413,1182,10,N,N,-,-1,-1
WESLEY.txt,350243,351426,1183,10,N,N,-,-1,-1
WESLEY.txt,350332,351461,1129,10,N,N,-,-1,-1
WESLEY.txt,350414,351641,1227,10,N,N,-,-1,-1
WESLEY.txt,350580,351654,1074,10,N,N,-,-1,-1
WESLEY.txt,350603,351732,1129,10,N,N,-,-1,-1
WESLEY.txt,350796,351747,951,10,N,N,-,-1,-1
WESLEY.txt,350887,351789,902,10,N,N,-,-1,-1
WESLEY.txt,351074,351936,862,10,N,N,-,-1,-1
WESLEY.txt,351230,352072,842,10,N,N,-,-1,-1
WESLEY.txt,351414,352175,761,10,N,N,-,-1,-1
WESLEY.txt,351426,352197,771,10,N,N,-,-1,-1
WESLEY.txt,351462,352259,797,10,N,N,-,-1,-1
WESLEY.txt,351642,352479,837,10,N,N,-,-1,-1
WESLEY.txt,351654,352520,866,10,N,N,-,-1,-1
WESLEY.txt,351733,352581,848,10,N,N,-,-1,-1
WESLEY.txt,351747,352611,864,10,N,N,-,-1,-1
WESLEY.txt,351790,352686,896,10,N,N,-,-1,-1
WESLEY.txt,351937,352783,846,10,N,N,-,-1,-1
WESLEY.txt,352073,352865,792,10,N,N,-,-1,-1
WESLEY.txt,352176,352953,777,10,N,N,-,-1,-1
WESLEY.txt,352198,352976,778,10,N,N,-,-1,-1
WESLEY.txt,352260,353043,783,10,N,N,-,-1,-1
WESLEY.txt,352480,353219,739,10,N,N,-,-1,-1
WESLEY.txt,352521,353412,891,10,N,N,-,-1,-1
WESLEY.txt,352582,353466,884,10,N,N,-,-1,-1
WESLEY.txt,352612,353604,992,10,N,N,-,-1,-1
WESLEY.txt,352687,353696,1009,10,N,N,-,-1,-1
WESLEY.txt,352784,353822,1038,10,N,N,-,-1,-1
WESLEY.txt,352866,353918,1052,10,N,N,-,-1,-1
WESLEY.txt,352954,354096,1142,10,N,N,-,-1,-1
WESLEY.txt,352976,354150,1174,10,N,N,-,-1,-1
WESLEY.txt,353044,354194,1150,10,N,N,-,-1,-1
WESLEY.txt,353220,354375,1155,10,N,N,-,-1,-1
WESLEY.txt,353413,354551,1138,10,N,N,-,-1,-1
WESLEY.txt,353467,354740,1273,10,N,N,-,-1,-1
WESLEY.txt,353605,354829,1224,10,N,N,-,-1,-1
WESLEY.txt,353697,354909,1212,10,N,N,-,-1,-1
WESLEY.txt,353823,354983,1160,10,N,N,-,-1,-1
WESLEY.txt,353919,355024,1105,10,N,N,-,-1,-1
WESLEY.txt,354097,355046,949,10,N,N,-,-1,-1
WESLEY.txt,354151,355097,946,10,N,N,-,-1,-1
WESLEY.txt,354195,355177,982,10,N,N,-,-1,-1
WESLEY.txt,354376,355263,887,10,N,N,-,-1,-1
WESLEY.txt,354552,355285,733,10,N,N,-,-1,-1
WESLEY.txt,354741,355484,743,10,N,N,-,-1,-1
WESLEY.txt,354830,355498,668,10,N,N,-,-1,-1
WESLEY.txt,354910,355663,753,10,N,N,-,-1,-1
WESLEY.txt,354984,355764,780,10,N,N,-,-1,-1
WESLEY.txt,355025,355876,851,10,N,N,-,-1,-1
WESLEY.txt,355047,355883,836,10,N,N,-,-1,-1
WESLEY.txt,355098,355927,829,10,N,N,-,-1,-1
WESLEY.txt,355178,356047,869,10,N,N,-,-1,-1
WESLEY.txt,355264,356186,922,10,N,N,-,-1,-1
WESLEY.txt,355286,356387,1101,10,N,N,-,-1,-1
WESLEY.txt,355485,356567,1082,10,N,N,-,-1,-1
WESLEY.txt,355498,356614,1116,10,N,N,-,-1,-1
WESLEY.txt,355664,356721,1057,10,N,N,-,-1,-1
WESLEY.txt,355765,356862,1097,10,N,N,-,-1,-1
WESLEY.txt,355877,356919,1042,10,N,N,-,-1,-1
WESLEY.txt,355884,356971,1087,10,N,N,-,-1,-1
WESLEY.txt,355928,357051,1123,10,N,N,-,-1,-1
WESLEY.txt,356048,357083,1035,10,N,N,-,-1,-1
WESLEY.txt,356187,357318,1131,10,N,N,-,-1,-1
WESLEY.txt,356388,357410,1022,10,N,N,-,-1,-1
WESLEY.txt,356568,357500,932,10,N,N,-,-1,-1
WESLEY.txt,356615,357524,909,10,N,N,-,-1,-1
WESLEY.txt,356722,357614,892,10,N,N,-,-1,-1
WESLEY.txt,356863,357634,771,10,N,N,-,-1,-1
WESLEY.txt,356920,357692,772,10,N,N,-,-1,-1
WESLEY.txt,356973,357760,787,10,N,N,-,-1,-1
WESLEY.txt,357052,357962,910,10,N,N,-,-1,-1
WESLEY.txt,357084,357990,906,10,N,N,-,-1,-1
WESLEY.txt,357319,358031,712,10,N,N,-,-1,-1
WESLEY.txt,357411,358089,678,10,N,N,-,-1,-1
WESLEY.txt,357501,358101,600,10,N,N,-,-1,-1
WESLEY.txt,357525,358387,862,10,N,N,-,-1,-1
WESLEY.txt,357615,358588,973,10,N,N,-,-1,-1
WESLEY.txt,357634,358601,967,10,N,N,-,-1,-1
WESLEY.txt,357693,358704,1011,10,N,N,-,-1,-1
WESLEY.txt,357761,358796,1035,10,N,N,-,-1,-1
WESLEY.txt,357963,358862,899,10,N,N,-,-1,-1
WESLEY.txt,357990,358960,970,10,N,N,-,-1,-1
WESLEY.txt,358032,358975,943,10,N,N,-,-1,-1
WESLEY.txt,358090,359073,983,10,N,N,-,-1,-1
WESLEY.txt,358101,359182,1081,10,N,N,-,-1,-1
WESLEY.txt,358388,359246,858,10,N,N,-,-1,-1
WESLEY.txt,358589,359338,749,10,N,N,-,-1,-1
WESLEY.txt,358601,359407,806,10,N,N,-,-1,-1
WESLEY.txt,358705,359482,777,10,N,N,-,-1,-1
WESLEY.txt,358797,359590,793,10,N,N,-,-1,-1
WESLEY.txt,358863,359770,907,10,N,N,-,-1,-1
WESLEY.txt,358961,359782,821,10,N,N,-,-1,-1
WESLEY.txt,358975,359867,892,10,N,N,-,-1,-1
WESLEY.txt,359074,359890,816,10,N,N,-,-1,-1
WESLEY.txt,359183,359933,750,10,N,N,-,-1,-1
WESLEY.txt,359247,360263,1016,10,N,N,-,-1,-1
WESLEY.txt,359340,360458,1118,10,N,N,-,-1,-1
WESLEY.txt,359408,360516,1108,10,N,N,-,-1,-1
WESLEY.txt,359483,360619,1136,10,N,N,-,-1,-1
WESLEY.txt,359592,360680,1088,10,N,N,-,-1,-1
WESLEY.txt,359771,360731,960,10,N,N,-,-1,-1
WESLEY.txt,359782,360869,1087,10,N,N,-,-1,-1
WESLEY.txt,359868,361060,1192,10,N,N,-,-1,-1
WESLEY.txt,359891,361297,1406,10,N,N,-,-1,-1
WESLEY.txt,359934,361395,1461,10,N,N,-,-1,-1
WESLEY.txt,360264,361407,1143,10,N,N,-,-1,-1
WESLEY.txt,360459,361494,1035,10,N,N,-,-1,-1
WESLEY.txt,360517,361626,1109,10,N,N,-,-1,-1
WESLEY.txt,360620,361728,1108,10,N,N,-,-1,-1
WESLEY.txt,360680,361821,1141,10,N,N,-,-1,-1
WESLEY.txt,360732,361920,1188,10,N,N,-,-1,-1
WESLEY.txt,360870,362021,1151,10,N,N,-,-1,-1
WESLEY.txt,361061,362111,1050,10,N,N,-,-1,-1
WESLEY.txt,361299,362201,902,10,N,N,-,-1,-1
WESLEY.txt,361396,362249,853,10,N,N,-,-1,-1
WESLEY.txt,361407,362292,885,10,N,N,-,-1,-1
WESLEY.txt,361495,362393,898,10,N,N,-,-1,-1
WESLEY.txt,361627,362521,894,10,N,N,-,-1,-1
WESLEY.txt,361729,362559,830,10,N,N,-,-1,-1
WESLEY.txt,361822,362664,842,10,N,N,-,-1,-1
WESLEY.txt,361921,362926,1005,10,N,N,-,-1,-1
WESLEY.txt,362022,363123,1101,10,N,N,-,-1,-1
WESLEY.txt,362112,363218,1106,10,N,N,-,-1,-1
WESLEY.txt,362202,363306,1104,10,N,N,-,-1,-1
WESLEY.txt,362250,363320,1070,10,N,N,-,-1,-1
WESLEY.txt,362293,363448,1155,10,N,N,-,-1,-1
WESLEY.txt,362394,363574,1180,10,N,N,-,-1,-1
WESLEY.txt,362522,363718,1196,10,N,N,-,-1,-1
WESLEY.txt,362560,363901,1341,10,N,N,-,-1,-1
WESLEY.txt,362665,363992,1327,10,N,N,-,-1,-1
WESLEY.txt,362927,364102,1175,10,N,N,-,-1,-1
WESLEY.txt,363124,364161,1037,10,N,N,-,-1,-1
WESLEY.txt,363219,364208,989,10,N,N,-,-1,-1
WESLEY.txt,363307,364316,1009,10,N,N,-,-1,-1
WESLEY.txt,363320,364402,1082,10,N,N,-,-1,-1
WESLEY.txt,363449,364474,1025,10,N,N,-,-1,-1
WESLEY.txt,363575,364528,953,10,N,N,-,-1,-1
WESLEY.txt,363719,364569,850,10,N,N,-,-1,-1
WESLEY.txt,363902,364612,710,10,N,N,-,-1,-1
WESLEY.txt,363993,364626,633,10,N,N,-,-1,-1
WESLEY.txt,364103,364733,630,10,N,N,-,-1,-1
WESLEY.txt,364162,364862,700,10,N,N,-,-1,-1
WESLEY.txt,364210,364983,773,10,N,N,-,-1,-1
WESLEY.txt,364317,365190,873,10,N,N,-,-1,-1
WESLEY.txt,364403,365277,874,10,N,N,-,-1,-1
WESLEY.txt,364475,365489,1014,10,N,N,-,-1,-1
WESLEY.txt,364529,365555,1026,10,N,N,-,-1,-1
WESLEY.txt,364570,365654,1084,10,N,N,-,-1,-1
WESLEY.txt,364613,365728,1115,10,N,N,-,-1,-1
WESLEY.txt,364627,365756,1129,10,N,N,-,-1,-1
WESLEY.txt,364734,365930,1196,10,N,N,-,-1,-1
WESLEY.txt,364863,365970,1107,10,N,N,-,-1,-1
WESLEY.txt,364984,365979,995,10,N,N,-,-1,-1
WESLEY.txt,365191,366018,827,10,N,N,-,-1,-1
WESLEY.txt,365278,366086,808,10,N,N,-,-1,-1
WESLEY.txt,365490,366160,670,10,N,N,-,-1,-1
WESLEY.txt,365556,366173,617,10,N,N,-,-1,-1
WESLEY.txt,365655,366297,642,10,N,N,-,-1,-1
WESLEY.txt,365729,366320,591,10,N,N,-,-1,-1
WESLEY.txt,365757,366347,590,10,N,N,-,-1,-1
WESLEY.txt,365931,366410,479,10,N,N,-,-1,-1
WESLEY.txt,365971,366497,526,10,N,N,-,-1,-1
WESLEY.txt,365980,366583,603,10,N,N,-,-1,-1
WESLEY.txt,366019,366658,639,10,N,N,-,-1,-1
WESLEY.txt,366087,366741,654,10,N,N,-,-1,-1
WESLEY.txt,366161,366764,603,10,N,N,-,-1,-1
WESLEY.txt,366175,366900,725,10,N,N,-,-1,-1
WESLEY.txt,366298,366949,651,10,N,N,-,-1,-1
WESLEY.txt,366321,367156,835,10,N,Y,1437470299748,152207,152889
WESLEY.txt,366348,367359,1011,10,N,Y,1437470299748,152207,152889
WESLEY.txt,366410,367484,1074,10,N,Y,1437470299748,152207,152889
WESLEY.txt,366498,367532,1034,10,N,Y,1437470299748,152207,152889
WESLEY.txt,366584,367590,1006,10,N,Y,1437470299748,152207,152889
WESLEY.txt,366659,367615,956,10,N,Y,1437470299748,152207,152889
WESLEY.txt,366742,367664,922,10,N,Y,1437470299748,152207,152889
WESLEY.txt,366764,367700,936,10,N,Y,1437470299748,152207,152889
WESLEY.txt,366901,367798,897,10,N,Y,1437470299748,152207,152889
WESLEY.txt,366950,367912,962,10,N,Y,1437470299748,152207,152889
WESLEY.txt,367157,367964,807,10,N,Y,1437470299748,152207,152889
WESLEY.txt,367360,368113,753,10,N,Y,1437470299748,152207,152889
WESLEY.txt,367485,368194,709,10,N,Y,1437470299748,152207,152889
WESLEY.txt,367534,368279,745,10,N,Y,1437470299748,152207,152889
WESLEY.txt,367591,368330,739,10,N,Y,1437470299748,152207,152889
WESLEY.txt,367616,368466,850,10,N,Y,1437470299748,152207,152889
WESLEY.txt,367665,368627,962,10,N,Y,1437470299748,152207,152889
WESLEY.txt,367701,368793,1092,10,N,Y,1437470299748,152207,152889
WESLEY.txt,367799,368893,1094,10,N,Y,1437470299748,152207,152889
WESLEY.txt,367913,369141,1228,10,N,Y,1437470299748,152207,152889
WESLEY.txt,367965,369232,1267,10,N,Y,1437470299748,152207,152889
WESLEY.txt,368114,369383,1269,10,N,Y,1437470299748,152207,152889
WESLEY.txt,368195,369730,1535,10,N,Y,1437470299748,152207,152889
WESLEY.txt,368280,369982,1702,10,N,Y,1437470299748,152207,152889
WESLEY.txt,368331,370056,1725,10,N,Y,1437470299748,152207,152889
WESLEY.txt,368467,370078,1611,10,N,Y,1437470299748,152207,152889
WESLEY.txt,368628,370216,1588,10,N,Y,1437470299748,152207,152889
WESLEY.txt,368794,370231,1437,10,N,Y,1437470299748,152207,152889
WESLEY.txt,368894,370405,1511,10,N,Y,1437470299748,152207,152889
WESLEY.txt,369142,370419,1277,10,N,Y,1437470299748,152207,152889
WESLEY.txt,369233,370635,1402,10,N,Y,1437470299748,152207,152889
WESLEY.txt,369384,370647,1263,10,N,Y,1437470299748,152207,152889
WESLEY.txt,369731,370824,1093,10,N,N,-,-1,-1
WESLEY.txt,369983,371039,1056,10,N,N,-,-1,-1
WESLEY.txt,370056,371192,1136,10,N,N,-,-1,-1
WESLEY.txt,370079,371286,1207,10,N,N,-,-1,-1
WESLEY.txt,370217,371389,1172,10,N,N,-,-1,-1
WESLEY.txt,370231,371559,1328,10,N,N,-,-1,-1
WESLEY.txt,370406,371638,1232,10,N,N,-,-1,-1
WESLEY.txt,370419,371818,1399,10,N,N,-,-1,-1
WESLEY.txt,370636,371899,1263,10,N,N,-,-1,-1
WESLEY.txt,370647,371958,1311,10,N,N,-,-1,-1
WESLEY.txt,370825,372077,1252,10,N,N,-,-1,-1
WESLEY.txt,371040,372272,1232,10,N,N,-,-1,-1
WESLEY.txt,371193,372331,1138,10,N,N,-,-1,-1
WESLEY.txt,371287,372367,1080,10,N,N,-,-1,-1
WESLEY.txt,371390,372458,1068,10,N,N,-,-1,-1
WESLEY.txt,371560,372537,977,10,N,N,-,-1,-1
WESLEY.txt,371639,372636,997,10,N,N,-,-1,-1
WESLEY.txt,371819,372674,855,10,N,N,-,-1,-1
WESLEY.txt,371900,373181,1281,10,N,N,-,-1,-1
WESLEY.txt,371959,373222,1263,10,N,N,-,-1,-1
WESLEY.txt,372078,373260,1182,10,N,N,-,-1,-1
WESLEY.txt,372273,373275,1002,10,N,N,-,-1,-1
WESLEY.txt,372332,373292,960,10,N,N,-,-1,-1
WESLEY.txt,372368,373388,1020,10,N,N,-,-1,-1
WESLEY.txt,372458,373573,1115,10,N,N,-,-1,-1
WESLEY.txt,372538,373593,1055,10,N,N,-,-1,-1
WESLEY.txt,372637,373663,1026,10,N,N,-,-1,-1
WESLEY.txt,372675,373715,1040,10,N,N,-,-1,-1
WESLEY.txt,373182,373777,595,10,N,N,-,-1,-1
WESLEY.txt,373223,373808,585,10,N,N,-,-1,-1
WESLEY.txt,373261,373974,713,10,N,N,-,-1,-1
WESLEY.txt,373275,374178,903,10,N,N,-,-1,-1
WESLEY.txt,373293,374265,972,10,N,N,-,-1,-1
WESLEY.txt,373389,374522,1133,10,N,N,-,-1,-1
WESLEY.txt,373575,374573,998,10,N,N,-,-1,-1
WESLEY.txt,373594,374742,1148,10,N,N,-,-1,-1
WESLEY.txt,373664,374834,1170,10,N,N,-,-1,-1
WESLEY.txt,373717,374858,1141,10,N,N,-,-1,-1
WESLEY.txt,373778,375059,1281,10,N,N,-,-1,-1
WESLEY.txt,373809,375153,1344,10,N,N,-,-1,-1
WESLEY.txt,373975,375317,1342,10,N,N,-,-1,-1
WESLEY.txt,374179,375399,1220,10,N,N,-,-1,-1
WESLEY.txt,374266,375419,1153,10,N,N,-,-1,-1
WESLEY.txt,374523,375493,970,10,N,N,-,-1,-1
WESLEY.txt,374574,375629,1055,10,N,N,-,-1,-1
WESLEY.txt,374743,375738,995,10,N,N,-,-1,-1
WESLEY.txt,374834,375860,1026,10,N,N,-,-1,-1
WESLEY.txt,374859,375902,1043,10,N,N,-,-1,-1
WESLEY.txt,375060,376006,946,10,N,N,-,-1,-1
WESLEY.txt,375154,376115,961,10,N,N,-,-1,-1
WESLEY.txt,375318,376199,881,10,N,N,-,-1,-1
WESLEY.txt,375400,376293,893,10,N,N,-,-1,-1
WESLEY.txt,375419,376528,1109,10,N,N,-,-1,-1
WESLEY.txt,375494,376575,1081,10,N,N,-,-1,-1
WESLEY.txt,375630,376705,1075,10,N,N,-,-1,-1
WESLEY.txt,375739,376717,978,10,N,N,-,-1,-1
WESLEY.txt,375861,376806,945,10,N,N,-,-1,-1
WESLEY.txt,375903,376966,1063,10,N,N,-,-1,-1
WESLEY.txt,376007,377086,1079,10,N,N,-,-1,-1
WESLEY.txt,376116,377174,1058,10,N,N,-,-1,-1
WESLEY.txt,376200,377276,1076,10,N,N,-,-1,-1
WESLEY.txt,376294,377350,1056,10,N,N,-,-1,-1
WESLEY.txt,376529,377433,904,10,N,N,-,-1,-1
WESLEY.txt,376576,377508,932,10,N,N,-,-1,-1
WESLEY.txt,376706,377686,980,10,N,N,-,-1,-1
WESLEY.txt,376717,377738,1021,10,N,N,-,-1,-1
WESLEY.txt,376807,377779,972,10,N,N,-,-1,-1
WESLEY.txt,376967,377938,971,10,N,N,-,-1,-1
WESLEY.txt,377087,378092,1005,10,N,N,-,-1,-1
WESLEY.txt,377175,378203,1028,10,N,N,-,-1,-1
WESLEY.txt,377277,378314,1037,10,N,N,-,-1,-1
WESLEY.txt,377351,378372,1021,10,N,N,-,-1,-1
WESLEY.txt,377434,378401,967,10,N,N,-,-1,-1
WESLEY.txt,377509,378517,1008,10,N,N,-,-1,-1
WESLEY.txt,377687,378531,844,10,N,N,-,-1,-1
WESLEY.txt,377739,378614,875,10,N,N,-,-1,-1
WESLEY.txt,377780,378698,918,10,N,N,-,-1,-1
WESLEY.txt,377939,378780,841,10,N,N,-,-1,-1
WESLEY.txt,378093,378803,710,10,N,N,-,-1,-1
WESLEY.txt,378204,378926,722,10,N,N,-,-1,-1
WESLEY.txt,378315,379117,802,10,N,N,-,-1,-1
WESLEY.txt,378373,379202,829,10,N,N,-,-1,-1
WESLEY.txt,378402,379295,893,10,N,N,-,-1,-1
WESLEY.txt,378518,379431,913,10,N,N,-,-1,-1
WESLEY.txt,378531,379589,1058,10,N,N,-,-1,-1
WESLEY.txt,378615,379729,1114,10,N,N,-,-1,-1
WESLEY.txt,378699,379792,1093,10,N,N,-,-1,-1
WESLEY.txt,378781,379816,1035,10,N,N,-,-1,-1
WESLEY.txt,378803,380088,1285,10,N,N,-,-1,-1
WESLEY.txt,378927,380164,1237,10,N,N,-,-1,-1
WESLEY.txt,379118,380176,1058,10,N,N,-,-1,-1
WESLEY.txt,379203,380256,1053,10,N,N,-,-1,-1
WESLEY.txt,379296,380299,1003,10,N,N,-,-1,-1
WESLEY.txt,379432,380343,911,10,N,N,-,-1,-1
WESLEY.txt,379590,380358,768,10,N,N,-,-1,-1
WESLEY.txt,379730,380429,699,10,N,N,-,-1,-1
WESLEY.txt,379793,380509,716,10,N,N,-,-1,-1
WESLEY.txt,379817,380582,765,10,N,N,-,-1,-1
WESLEY.txt,380090,380663,573,10,N,N,-,-1,-1
WESLEY.txt,380165,380675,510,10,N,N,-,-1,-1
WESLEY.txt,380176,380714,538,10,N,N,-,-1,-1
WESLEY.txt,380257,380783,526,10,N,N,-,-1,-1
WESLEY.txt,380300,380953,653,10,N,N,-,-1,-1
WESLEY.txt,380344,380965,621,10,N,N,-,-1,-1
WESLEY.txt,380358,381052,694,10,N,N,-,-1,-1
WESLEY.txt,380430,381165,735,10,N,N,-,-1,-1
WESLEY.txt,380510,381222,712,10,N,N,-,-1,-1
WESLEY.txt,380584,381280,696,10,N,N,-,-1,-1
WESLEY.txt,380664,381381,717,10,N,N,-,-1,-1
WESLEY.txt,380675,381484,809,10,N,N,-,-1,-1
WESLEY.txt,380715,381566,851,10,N,N,-,-1,-1
WESLEY.txt,380784,381665,881,10,N,N,-,-1,-1
WESLEY.txt,380954,381715,761,10,N,N,-,-1,-1
WESLEY.txt,380965,381753,788,10,N,N,-,-1,-1
WESLEY.txt,381053,381836,783,10,N,N,-,-1,-1
WESLEY.txt,381166,381875,709,10,N,N,-,-1,-1
WESLEY.txt,381223,381906,683,10,N,N,-,-1,-1
WESLEY.txt,381281,382044,763,10,N,N,-,-1,-1
WESLEY.txt,381382,382058,676,10,N,N,-,-1,-1
WESLEY.txt,381484,382182,698,10,N,N,-,-1,-1
WESLEY.txt,381567,382194,627,10,N,N,-,-1,-1
WESLEY.txt,381666,382234,568,10,N,N,-,-1,-1
WESLEY.txt,381716,382248,532,10,N,N,-,-1,-1
WESLEY.txt,381754,382298,544,10,N,N,-,-1,-1
WESLEY.txt,381837,382406,569,10,N,N,-,-1,-1
WESLEY.txt,381876,382428,552,10,N,N,-,-1,-1
WESLEY.txt,381907,382535,628,10,N,N,-,-1,-1
WESLEY.txt,382045,382548,503,10,N,N,-,-1,-1
WESLEY.txt,382058,382666,608,10,N,N,-,-1,-1
WESLEY.txt,382183,382679,496,10,N,N,-,-1,-1
WESLEY.txt,382195,382972,777,10,N,N,-,-1,-1
WESLEY.txt,382235,382986,751,10,N,N,-,-1,-1
WESLEY.txt,382249,383148,899,10,N,N,-,-1,-1
WESLEY.txt,382299,383160,861,10,N,N,-,-1,-1
WESLEY.txt,382407,383259,852,10,N,N,-,-1,-1
WESLEY.txt,382428,383341,913,10,N,N,-,-1,-1
WESLEY.txt,382536,383394,858,10,N,N,-,-1,-1
WESLEY.txt,382549,383476,927,10,N,N,-,-1,-1
WESLEY.txt,382667,383567,900,10,N,N,-,-1,-1
WESLEY.txt,382679,383645,966,10,N,N,-,-1,-1
WESLEY.txt,382973,383659,686,10,N,N,-,-1,-1
WESLEY.txt,382986,383745,759,10,N,N,-,-1,-1
WESLEY.txt,383149,383821,672,10,N,N,-,-1,-1
WESLEY.txt,383160,383869,709,10,N,N,-,-1,-1
WESLEY.txt,383260,383914,654,10,N,N,-,-1,-1
WESLEY.txt,383341,383954,613,10,N,N,-,-1,-1
WESLEY.txt,383395,384002,607,10,N,N,-,-1,-1
WESLEY.txt,383477,384014,537,10,N,N,-,-1,-1
WESLEY.txt,383569,384169,600,10,N,N,-,-1,-1
WESLEY.txt,383646,384181,535,10,N,N,-,-1,-1
WESLEY.txt,383659,384453,794,10,N,N,-,-1,-1
WESLEY.txt,383746,384516,770,10,N,N,-,-1,-1
WESLEY.txt,383823,384600,777,10,N,N,-,-1,-1
WESLEY.txt,383870,384623,753,10,N,N,-,-1,-1
WESLEY.txt,383915,384874,959,10,N,N,-,-1,-1
WESLEY.txt,383955,385040,1085,10,N,N,-,-1,-1
WESLEY.txt,384003,385113,1110,10,N,N,-,-1,-1
WESLEY.txt,384014,385296,1282,10,N,N,-,-1,-1
WESLEY.txt,384170,385310,1140,10,N,N,-,-1,-1
WESLEY.txt,384181,385422,1241,10,N,N,-,-1,-1
WESLEY.txt,384454,385601,1147,10,N,N,-,-1,-1
WESLEY.txt,384517,385697,1180,10,N,N,-,-1,-1
WESLEY.txt,384601,385774,1173,10,N,N,-,-1,-1
WESLEY.txt,384623,385794,1171,10,N,N,-,-1,-1
WESLEY.txt,384875,385824,949,10,N,N,-,-1,-1
WESLEY.txt,385041,385864,823,10,N,N,-,-1,-1
WESLEY.txt,385114,385875,761,10,N,N,-,-1,-1
WESLEY.txt,385297,385968,671,10,N,N,-,-1,-1
WESLEY.txt,385310,386078,768,10,N,N,-,-1,-1
WESLEY.txt,385423,386221,798,10,N,N,-,-1,-1
WESLEY.txt,385602,386286,684,10,N,N,-,-1,-1
WESLEY.txt,385699,386503,804,10,N,N,-,-1,-1
WESLEY.txt,385775,386516,741,10,N,N,-,-1,-1
WESLEY.txt,385795,386608,813,10,N,N,-,-1,-1
WESLEY.txt,385826,386721,895,10,N,N,-,-1,-1
WESLEY.txt,385865,386764,899,10,N,N,-,-1,-1
WESLEY.txt,385876,386967,1091,10,N,N,-,-1,-1
WESLEY.txt,385969,386981,1012,10,N,N,-,-1,-1
WESLEY.txt,386078,387225,1147,10,N,N,-,-1,-1
WESLEY.txt,386222,387237,1015,10,N,N,-,-1,-1
WESLEY.txt,386287,387534,1247,10,N,N,-,-1,-1
WESLEY.txt,386504,387630,1126,10,N,N,-,-1,-1
WESLEY.txt,386516,387727,1211,10,N,N,-,-1,-1
WESLEY.txt,386609,387829,1220,10,N,N,-,-1,-1
WESLEY.txt,386722,387964,1242,10,N,N,-,-1,-1
WESLEY.txt,386765,388146,1381,10,N,N,-,-1,-1
WESLEY.txt,386968,388158,1190,10,N,N,-,-1,-1
WESLEY.txt,386981,388350,1369,10,N,N,-,-1,-1
WESLEY.txt,387226,388568,1342,10,N,N,-,-1,-1
WESLEY.txt,387237,388641,1404,10,N,N,-,-1,-1
WESLEY.txt,387536,388653,1117,10,N,N,-,-1,-1
WESLEY.txt,387631,388703,1072,10,N,N,-,-1,-1
WESLEY.txt,387728,388720,992,10,N,N,-,-1,-1
WESLEY.txt,387830,388793,963,10,N,N,-,-1,-1
WESLEY.txt,387965,388893,928,10,N,N,-,-1,-1
WESLEY.txt,388147,388906,759,10,N,N,-,-1,-1
WESLEY.txt,388158,389083,925,10,N,N,-,-1,-1
WESLEY.txt,388352,389176,824,10,N,N,-,-1,-1
WESLEY.txt,388569,389323,754,10,N,N,-,-1,-1
WESLEY.txt,388642,389416,774,10,N,N,-,-1,-1
WESLEY.txt,388653,389517,864,10,N,N,-,-1,-1
WESLEY.txt,388704,389583,879,10,N,N,-,-1,-1
WESLEY.txt,388720,389738,1018,10,N,N,-,-1,-1
WESLEY.txt,388794,389861,1067,10,N,N,-,-1,-1
WESLEY.txt,388894,389946,1052,10,N,N,-,-1,-1
WESLEY.txt,388906,390038,1132,10,N,N,-,-1,-1
WESLEY.txt,389084,390079,995,10,N,N,-,-1,-1
WESLEY.txt,389177,390216,1039,10,N,N,-,-1,-1
WESLEY.txt,389324,390228,904,10,N,N,-,-1,-1
WESLEY.txt,389417,390299,882,10,N,N,-,-1,-1
WESLEY.txt,389517,390423,906,10,N,N,-,-1,-1
WESLEY.txt,389584,390521,937,10,N,N,-,-1,-1
WESLEY.txt,389739,390534,795,10,N,N,-,-1,-1
WESLEY.txt,389862,390568,706,10,N,N,-,-1,-1
WESLEY.txt,389947,390583,636,10,N,N,-,-1,-1
WESLEY.txt,390039,390669,630,10,N,N,-,-1,-1
WESLEY.txt,390080,390756,676,10,N,N,-,-1,-1
WESLEY.txt,390217,390947,730,10,N,N,-,-1,-1
WESLEY.txt,390228,391060,832,10,N,N,-,-1,-1
WESLEY.txt,390300,391140,840,10,N,N,-,-1,-1
WESLEY.txt,390424,391240,816,10,N,N,-,-1,-1
WESLEY.txt,390522,391339,817,10,N,N,-,-1,-1
WESLEY.txt,390534,391453,919,10,N,N,-,-1,-1
WESLEY.txt,390569,391580,1011,10,N,N,-,-1,-1
WESLEY.txt,390583,391678,1095,10,N,N,-,-1,-1
WESLEY.txt,390670,391698,1028,10,N,N,-,-1,-1
WESLEY.txt,390757,391779,1022,10,N,N,-,-1,-1
WESLEY.txt,390948,392009,1061,10,N,N,-,-1,-1
WESLEY.txt,391061,392023,962,10,N,N,-,-1,-1
WESLEY.txt,391141,392131,990,10,N,N,-,-1,-1
WESLEY.txt,391241,392258,1017,10,N,N,-,-1,-1
WESLEY.txt,391340,392339,999,10,N,N,-,-1,-1
WESLEY.txt,391454,392520,1066,10,N,N,-,-1,-1
WESLEY.txt,391581,392590,1009,10,N,N,-,-1,-1
WESLEY.txt,391679,392778,1099,10,N,N,-,-1,-1
WESLEY.txt,391699,393052,1353,10,N,N,-,-1,-1
WESLEY.txt,391780,393111,1331,10,N,N,-,-1,-1
WESLEY.txt,392010,393216,1206,10,N,N,-,-1,-1
WESLEY.txt,392023,393243,1220,10,N,N,-,-1,-1
WESLEY.txt,392132,393356,1224,10,N,N,-,-1,-1
WESLEY.txt,392259,393446,1187,10,N,N,-,-1,-1
WESLEY.txt,392340,393607,1267,10,N,N,-,-1,-1
WESLEY.txt,392521,393670,1149,10,N,N,-,-1,-1
WESLEY.txt,392591,393747,1156,10,N,N,-,-1,-1
WESLEY.txt,392779,393817,1038,10,N,N,-,-1,-1
WESLEY.txt,393053,393837,784,10,N,N,-,-1,-1
WESLEY.txt,393112,393863,751,10,N,N,-,-1,-1
WESLEY.txt,393217,394021,804,10,N,N,-,-1,-1
WESLEY.txt,393243,394078,835,10,N,N,-,-1,-1
WESLEY.txt,393357,394129,772,10,N,N,-,-1,-1
WESLEY.txt,393447,394286,839,10,N,N,-,-1,-1
WESLEY.txt,393608,394300,692,10,N,N,-,-1,-1
WESLEY.txt,393671,394319,648,10,N,N,-,-1,-1
WESLEY.txt,393748,394389,641,10,N,N,-,-1,-1
WESLEY.txt,393818,394607,789,10,N,N,-,-1,-1
WESLEY.txt,393837,394632,795,10,N,N,-,-1,-1
WESLEY.txt,393864,394872,1008,10,N,N,-,-1,-1
WESLEY.txt,394022,394967,945,10,N,N,-,-1,-1
WESLEY.txt,394079,395067,988,10,N,N,-,-1,-1
WESLEY.txt,394130,395081,951,10,N,N,-,-1,-1
WESLEY.txt,394287,395161,874,10,N,N,-,-1,-1
WESLEY.txt,394300,395314,1014,10,N,N,-,-1,-1
WESLEY.txt,394320,395349,1029,10,N,N,-,-1,-1
WESLEY.txt,394390,395505,1115,10,N,N,-,-1,-1
WESLEY.txt,394608,395604,996,10,N,N,-,-1,-1
WESLEY.txt,394632,395848,1216,10,N,N,-,-1,-1
WESLEY.txt,394873,395941,1068,10,N,N,-,-1,-1
WESLEY.txt,394968,396027,1059,10,N,N,-,-1,-1
WESLEY.txt,395068,396123,1055,10,N,N,-,-1,-1
WESLEY.txt,395082,396208,1126,10,N,N,-,-1,-1
WESLEY.txt,395162,396494,1332,10,N,N,-,-1,-1
WESLEY.txt,395315,396579,1264,10,N,N,-,-1,-1
WESLEY.txt,395350,396657,1307,10,N,N,-,-1,-1
WESLEY.txt,395506,396753,1247,10,N,N,-,-1,-1
WESLEY.txt,395605,396795,1190,10,N,N,-,-1,-1
WESLEY.txt,395849,396955,1106,10,N,N,-,-1,-1
WESLEY.txt,395942,397035,1093,10,N,N,-,-1,-1
WESLEY.txt,396028,397169,1141,10,N,N,-,-1,-1
WESLEY.txt,396124,397235,1111,10,N,N,-,-1,-1
WESLEY.txt,396210,397252,1042,10,N,N,-,-1,-1
WESLEY.txt,396495,397345,850,10,N,N,-,-1,-1
WESLEY.txt,396580,397436,856,10,N,N,-,-1,-1
WESLEY.txt,396657,397637,980,10,N,N,-,-1,-1
WESLEY.txt,396755,397649,894,10,N,N,-,-1,-1
WESLEY.txt,396796,397725,929,10,N,N,-,-1,-1
WESLEY.txt,396956,397793,837,10,N,N,-,-1,-1
WESLEY.txt,397036,397836,800,10,N,N,-,-1,-1
WESLEY.txt,397170,397911,741,10,N,N,-,-1,-1
WESLEY.txt,397236,397996,760,10,N,N,-,-1,-1
WESLEY.txt,397252,398126,874,10,N,N,-,-1,-1
WESLEY.txt,397346,398215,869,10,N,N,-,-1,-1
WESLEY.txt,397437,398305,868,10,N,N,-,-1,-1
WESLEY.txt,397638,398319,681,10,N,N,-,-1,-1
WESLEY.txt,397649,398434,785,10,N,N,-,-1,-1
WESLEY.txt,397726,398543,817,10,N,N,-,-1,-1
WESLEY.txt,397794,398648,854,10,N,N,-,-1,-1
WESLEY.txt,397837,398736,899,10,N,N,-,-1,-1
WESLEY.txt,397912,398849,937,10,N,N,-,-1,-1
WESLEY.txt,397997,399050,1053,10,N,N,-,-1,-1
WESLEY.txt,398127,399330,1203,10,N,N,-,-1,-1
WESLEY.txt,398216,399413,1197,10,N,N,-,-1,-1
WESLEY.txt,398306,399582,1276,10,N,N,-,-1,-1
WESLEY.txt,398319,399675,1356,10,N,N,-,-1,-1
WESLEY.txt,398435,399695,1260,10,N,N,-,-1,-1
WESLEY.txt,398545,399738,1193,10,N,N,-,-1,-1
WESLEY.txt,398649,399788,1139,10,N,N,-,-1,-1
WESLEY.txt,398736,399893,1157,10,N,N,-,-1,-1
WESLEY.txt,398850,400079,1229,10,N,N,-,-1,-1
WESLEY.txt,399051,400195,1144,10,N,N,-,-1,-1
WESLEY.txt,399331,400219,888,10,N,N,-,-1,-1
WESLEY.txt,399414,400236,822,10,N,N,-,-1,-1
WESLEY.txt,399583,400248,665,10,N,N,-,-1,-1
WESLEY.txt,399676,400321,645,10,N,N,-,-1,-1
WESLEY.txt,399695,400458,763,10,N,N,-,-1,-1
WESLEY.txt,399739,400518,779,10,N,N,-,-1,-1
WESLEY.txt,399790,400624,834,10,N,N,-,-1,-1
WESLEY.txt,399894,400712,818,10,N,N,-,-1,-1
WESLEY.txt,400080,400793,713,10,N,N,-,-1,-1
WESLEY.txt,400196,401046,850,10,N,N,-,-1,-1
WESLEY.txt,400219,401071,852,10,N,N,-,-1,-1
WESLEY.txt,400237,401158,921,10,N,N,-,-1,-1
WESLEY.txt,400249,401405,1156,10,N,N,-,-1,-1
WESLEY.txt,400322,401473,1151,10,N,N,-,-1,-1
WESLEY.txt,400459,401542,1083,10,N,N,-,-1,-1
WESLEY.txt,400519,401615,1096,10,N,N,-,-1,-1
WESLEY.txt,400625,401715,1090,10,N,N,-,-1,-1
WESLEY.txt,400713,401761,1048,10,N,N,-,-1,-1
WESLEY.txt,400794,401864,1070,10,N,N,-,-1,-1
WESLEY.txt,401047,401875,828,10,N,N,-,-1,-1
WESLEY.txt,401072,401966,894,10,N,N,-,-1,-1
WESLEY.txt,401159,402048,889,10,N,N,-,-1,-1
WESLEY.txt,401406,402125,719,10,N,N,-,-1,-1
WESLEY.txt,401474,402138,664,10,N,N,-,-1,-1
WESLEY.txt,401542,402305,763,10,N,N,-,-1,-1
WESLEY.txt,401616,402367,751,10,N,N,-,-1,-1
WESLEY.txt,401716,402487,771,10,N,N,-,-1,-1
WESLEY.txt,401762,402501,739,10,N,N,-,-1,-1
WESLEY.txt,401865,402502,637,10,N,N,-,-1,-1
WESLEY.txt,401875,402568,693,10,N,N,-,-1,-1
WESLEY.txt,401967,402643,676,10,N,N,-,-1,-1
WESLEY.txt,402049,402729,680,10,N,N,-,-1,-1
WESLEY.txt,402126,402810,684,10,N,N,-,-1,-1
WESLEY.txt,402138,402888,750,10,N,N,-,-1,-1
WESLEY.txt,402306,402900,594,10,N,N,-,-1,-1
WESLEY.txt,402368,402931,563,10,N,N,-,-1,-1
WESLEY.txt,402488,403073,585,10,N,N,-,-1,-1
WESLEY.txt,402501,403145,644,10,N,N,-,-1,-1
WESLEY.txt,402502,403159,657,10,N,N,-,-1,-1
WESLEY.txt,402569,403236,667,10,N,N,-,-1,-1
WESLEY.txt,402644,403318,674,10,N,N,-,-1,-1
WESLEY.txt,402730,403412,682,10,N,N,-,-1,-1
WESLEY.txt,402811,403598,787,10,N,N,-,-1,-1
WESLEY.txt,402889,403648,759,10,N,N,-,-1,-1
WESLEY.txt,402900,403916,1016,10,N,N,-,-1,-1
WESLEY.txt,402932,403993,1061,10,N,N,-,-1,-1
WESLEY.txt,403074,404178,1104,10,N,N,-,-1,-1
WESLEY.txt,403146,404236,1090,10,N,N,-,-1,-1
WESLEY.txt,403159,404242,1083,10,N,N,-,-1,-1
WESLEY.txt,403237,404264,1027,10,N,N,-,-1,-1
WESLEY.txt,403319,404367,1048,10,N,N,-,-1,-1
WESLEY.txt,403413,404426,1013,10,N,N,-,-1,-1
WESLEY.txt,403599,404591,992,10,N,N,-,-1,-1
WESLEY.txt,403649,404799,1150,10,N,N,-,-1,-1
WESLEY.txt,403917,404821,904,10,N,N,-,-1,-1
WESLEY.txt,403994,404900,906,10,N,N,-,-1,-1
WESLEY.txt,404179,404988,809,10,N,N,-,-1,-1
WESLEY.txt,404237,405092,855,10,N,N,-,-1,-1
WESLEY.txt,404243,405105,862,10,N,N,-,-1,-1
WESLEY.txt,404264,405310,1046,10,N,N,-,-1,-1
WESLEY.txt,404368,405337,969,10,N,N,-,-1,-1
WESLEY.txt,404427,405352,925,10,N,N,-,-1,-1
WESLEY.txt,404592,405437,845,10,N,N,-,-1,-1
WESLEY.txt,404800,405489,689,10,N,N,-,-1,-1
WESLEY.txt,404821,405691,870,10,N,N,-,-1,-1
WESLEY.txt,404901,405746,845,10,N,N,-,-1,-1
WESLEY.txt,404989,405804,815,10,N,N,-,-1,-1
WESLEY.txt,405093,405939,846,10,N,N,-,-1,-1
WESLEY.txt,405105,406015,910,10,N,N,-,-1,-1
WESLEY.txt,405311,406172,861,10,N,N,-,-1,-1
WESLEY.txt,405338,406272,934,10,N,N,-,-1,-1
WESLEY.txt,405353,406286,933,10,N,N,-,-1,-1
WESLEY.txt,405438,406347,909,10,N,N,-,-1,-1
WESLEY.txt,405490,406538,1048,10,N,N,-,-1,-1
WESLEY.txt,405692,406633,941,10,N,N,-,-1,-1
WESLEY.txt,405747,406651,904,10,N,N,-,-1,-1
WESLEY.txt,405805,406729,924,10,N,N,-,-1,-1
WESLEY.txt,405940,406743,803,10,N,N,-,-1,-1
WESLEY.txt,406016,406825,809,10,N,N,-,-1,-1
WESLEY.txt,406174,406846,672,10,N,N,-,-1,-1
WESLEY.txt,406273,407020,747,10,N,N,-,-1,-1
WESLEY.txt,406286,407038,752,10,N,N,-,-1,-1
WESLEY.txt,406348,407127,779,10,N,N,-,-1,-1
WESLEY.txt,406539,407376,837,10,N,N,-,-1,-1
WESLEY.txt,406634,407465,831,10,N,N,-,-1,-1
WESLEY.txt,406651,407552,901,10,N,N,-,-1,-1
WESLEY.txt,406730,407644,914,10,N,N,-,-1,-1
WESLEY.txt,406743,407732,989,10,N,N,-,-1,-1
WESLEY.txt,406826,407893,1067,10,N,N,-,-1,-1
WESLEY.txt,406847,408000,1153,10,N,N,-,-1,-1
WESLEY.txt,407021,408092,1071,10,N,N,-,-1,-1
WESLEY.txt,407038,408192,1154,10,N,N,-,-1,-1
WESLEY.txt,407129,408456,1327,10,N,N,-,-1,-1
WESLEY.txt,407377,408592,1215,10,N,N,-,-1,-1
WESLEY.txt,407466,408631,1165,10,N,N,-,-1,-1
WESLEY.txt,407553,408704,1151,10,N,N,-,-1,-1
WESLEY.txt,407645,408877,1232,10,N,N,-,-1,-1
WESLEY.txt,407733,408890,1157,10,N,N,-,-1,-1
WESLEY.txt,407895,408988,1093,10,N,N,-,-1,-1
WESLEY.txt,408001,409054,1053,10,N,N,-,-1,-1
WESLEY.txt,408093,409144,1051,10,N,N,-,-1,-1
WESLEY.txt,408193,409230,1037,10,N,N,-,-1,-1
WESLEY.txt,408457,409309,852,10,N,N,-,-1,-1
WESLEY.txt,408593,409384,791,10,N,N,-,-1,-1
WESLEY.txt,408632,409559,927,10,N,N,-,-1,-1
WESLEY.txt,408705,409603,898,10,N,N,-,-1,-1
WESLEY.txt,408878,409659,781,10,N,N,-,-1,-1
WESLEY.txt,408890,409735,845,10,N,N,-,-1,-1
WESLEY.txt,408990,409772,782,10,N,N,-,-1,-1
WESLEY.txt,409056,409910,854,10,N,N,-,-1,-1
WESLEY.txt,409145,409992,847,10,N,N,-,-1,-1
WESLEY.txt,409231,410080,849,10,N,N,-,-1,-1
WESLEY.txt,409309,410094,785,10,N,N,-,-1,-1
WESLEY.txt,409385,410348,963,10,N,N,-,-1,-1
WESLEY.txt,409560,410499,939,10,N,N,-,-1,-1
WESLEY.txt,409605,410706,1101,10,N,N,-,-1,-1
WESLEY.txt,409660,410718,1058,10,N,N,-,-1,-1
WESLEY.txt,409737,410798,1061,10,N,N,-,-1,-1
WESLEY.txt,409773,410877,1104,10,N,N,-,-1,-1
WESLEY.txt,409911,410916,1005,10,N,N,-,-1,-1
WESLEY.txt,409993,411073,1080,10,N,N,-,-1,-1
WESLEY.txt,410081,411151,1070,10,N,N,-,-1,-1
WESLEY.txt,410094,411272,1178,10,N,N,-,-1,-1
WESLEY.txt,410349,411352,1003,10,N,N,-,-1,-1
WESLEY.txt,410500,411662,1162,10,N,N,-,-1,-1
WESLEY.txt,410707,411678,971,10,N,N,-,-1,-1
WESLEY.txt,410718,411734,1016,10,N,N,-,-1,-1
WESLEY.txt,410799,411904,1105,10,N,N,-,-1,-1
WESLEY.txt,410878,411991,1113,10,N,N,-,-1,-1
WESLEY.txt,410917,412152,1235,10,N,N,-,-1,-1
WESLEY.txt,411074,412251,1177,10,N,N,-,-1,-1
WESLEY.txt,411151,412356,1205,10,N,N,-,-1,-1
WESLEY.txt,411273,412381,1108,10,N,N,-,-1,-1
WESLEY.txt,411353,412463,1110,10,N,N,-,-1,-1
WESLEY.txt,411663,412556,893,10,N,N,-,-1,-1
WESLEY.txt,411678,412638,960,10,N,N,-,-1,-1
WESLEY.txt,411735,412802,1067,10,N,N,-,-1,-1
WESLEY.txt,411905,412882,977,10,N,N,-,-1,-1
WESLEY.txt,411992,413043,1051,10,N,N,-,-1,-1
WESLEY.txt,412154,413244,1090,10,N,N,-,-1,-1
WESLEY.txt,412252,413341,1089,10,N,N,-,-1,-1
WESLEY.txt,412357,413430,1073,10,N,N,-,-1,-1
WESLEY.txt,412381,413654,1273,10,N,N,-,-1,-1
WESLEY.txt,412464,413758,1294,10,N,N,-,-1,-1
WESLEY.txt,412557,413800,1243,10,N,N,-,-1,-1
WESLEY.txt,412639,413938,1299,10,N,N,-,-1,-1
WESLEY.txt,412803,414048,1245,10,N,N,-,-1,-1
WESLEY.txt,412883,414095,1212,10,N,N,-,-1,-1
WESLEY.txt,413044,414237,1193,10,N,N,-,-1,-1
WESLEY.txt,413245,414370,1125,10,N,N,-,-1,-1
WESLEY.txt,413342,414454,1112,10,N,N,-,-1,-1
WESLEY.txt,413431,414586,1155,10,N,N,-,-1,-1
WESLEY.txt,413655,414663,1008,10,N,N,-,-1,-1
WESLEY.txt,413759,414708,949,10,N,N,-,-1,-1
WESLEY.txt,413801,414851,1050,10,N,N,-,-1,-1
WESLEY.txt,413939,414979,1040,10,N,N,-,-1,-1
WESLEY.txt,414049,415061,1012,10,N,N,-,-1,-1
WESLEY.txt,414096,415155,1059,10,N,N,-,-1,-1
WESLEY.txt,414238,415230,992,10,N,N,-,-1,-1
WESLEY.txt,414371,415356,985,10,N,N,-,-1,-1
WESLEY.txt,414455,415368,913,10,N,N,-,-1,-1
WESLEY.txt,414587,415402,815,10,N,N,-,-1,-1
WESLEY.txt,414664,415436,772,10,N,N,-,-1,-1
WESLEY.txt,414709,415457,748,10,N,N,-,-1,-1
WESLEY.txt,414852,415536,684,10,N,N,-,-1,-1
WESLEY.txt,414980,415720,740,10,N,N,-,-1,-1
WESLEY.txt,415062,415733,671,10,N,N,-,-1,-1
WESLEY.txt,415156,415905,749,10,N,N,-,-1,-1
WESLEY.txt,415231,416075,844,10,N,N,-,-1,-1
WESLEY.txt,415357,416376,1019,10,N,N,-,-1,-1
WESLEY.txt,415369,416454,1085,10,N,N,-,-1,-1
WESLEY.txt,415403,416689,1286,10,N,N,-,-1,-1
WESLEY.txt,415437,416770,1333,10,N,N,-,-1,-1
WESLEY.txt,415457,416784,1327,10,N,N,-,-1,-1
WESLEY.txt,415537,416866,1329,10,N,N,-,-1,-1
WESLEY.txt,415721,417133,1412,10,N,N,-,-1,-1
WESLEY.txt,415733,417265,1532,10,N,N,-,-1,-1
WESLEY.txt,415907,417353,1446,10,N,N,-,-1,-1
WESLEY.txt,416076,417403,1327,10,N,N,-,-1,-1
WESLEY.txt,416377,417439,1062,10,N,N,-,-1,-1
WESLEY.txt,416454,417628,1174,10,N,N,-,-1,-1
WESLEY.txt,416690,417640,950,10,N,N,-,-1,-1
WESLEY.txt,416771,417817,1046,10,N,N,-,-1,-1
WESLEY.txt,416784,417890,1106,10,N,N,-,-1,-1
WESLEY.txt,416867,418261,1394,10,N,N,-,-1,-1
WESLEY.txt,417134,418338,1204,10,N,N,-,-1,-1
WESLEY.txt,417266,418431,1165,10,N,N,-,-1,-1
WESLEY.txt,417354,418528,1174,10,N,N,-,-1,-1
WESLEY.txt,417405,418673,1268,10,N,N,-,-1,-1
WESLEY.txt,417440,418810,1370,10,N,N,-,-1,-1
WESLEY.txt,417629,418918,1289,10,N,N,-,-1,-1
WESLEY.txt,417640,419001,1361,10,N,N,-,-1,-1
WESLEY.txt,417818,419124,1306,10,N,N,-,-1,-1
WESLEY.txt,417891,419145,1254,10,N,N,-,-1,-1
WESLEY.txt,418262,419415,1153,10,N,N,-,-1,-1
WESLEY.txt,418339,419429,1090,10,N,N,-,-1,-1
WESLEY.txt,418431,419610,1179,10,N,N,-,-1,-1
WESLEY.txt,418529,419761,1232,10,N,N,-,-1,-1
WESLEY.txt,418674,419821,1147,10,N,N,-,-1,-1
WESLEY.txt,418811,419893,1082,10,N,N,-,-1,-1
WESLEY.txt,418919,419913,994,10,N,N,-,-1,-1
WESLEY.txt,419002,419945,943,10,N,N,-,-1,-1
WESLEY.txt,419125,420030,905,10,N,N,-,-1,-1
WESLEY.txt,419145,420112,967,10,N,N,-,-1,-1
WESLEY.txt,419416,420123,707,10,N,N,-,-1,-1
WESLEY.txt,419429,420436,1007,10,N,N,-,-1,-1
WESLEY.txt,419611,420447,836,10,N,N,-,-1,-1
WESLEY.txt,419762,420645,883,10,N,N,-,-1,-1
WESLEY.txt,419822,420659,837,10,N,N,-,-1,-1
WESLEY.txt,419894,420812,918,10,N,N,-,-1,-1
WESLEY.txt,419913,420841,928,10,N,N,-,-1,-1
WESLEY.txt,419946,420923,977,10,N,N,-,-1,-1
WESLEY.txt,420031,420936,905,10,N,N,-,-1,-1
WESLEY.txt,420113,421005,892,10,N,N,-,-1,-1
WESLEY.txt,420123,421107,984,10,N,N,-,-1,-1
WESLEY.txt,420437,421119,682,10,N,N,-,-1,-1
WESLEY.txt,420447,421201,754,10,N,N,-,-1,-1
WESLEY.txt,420646,421308,662,10,N,N,-,-1,-1
WESLEY.txt,420659,421377,718,10,N,N,-,-1,-1
WESLEY.txt,420813,421391,578,10,N,N,-,-1,-1
WESLEY.txt,420841,421470,629,10,N,N,-,-1,-1
WESLEY.txt,420924,421587,663,10,N,N,-,-1,-1
WESLEY.txt,420936,421663,727,10,N,N,-,-1,-1
WESLEY.txt,421006,421692,686,10,N,N,-,-1,-1
WESLEY.txt,421108,421968,860,10,N,N,-,-1,-1
WESLEY.txt,421120,421980,860,10,N,N,-,-1,-1
WESLEY.txt,421202,422043,841,10,N,N,-,-1,-1
WESLEY.txt,421308,422131,823,10,N,N,-,-1,-1
WESLEY.txt,421378,422217,839,10,N,N,-,-1,-1
WESLEY.txt,421391,422236,845,10,N,N,-,-1,-1
WESLEY.txt,421471,422315,844,10,N,N,-,-1,-1
WESLEY.txt,421588,422493,905,10,N,N,-,-1,-1
WESLEY.txt,421664,422501,837,10,N,N,-,-1,-1
WESLEY.txt,421693,422521,828,10,N,N,-,-1,-1
WESLEY.txt,421969,422696,727,10,N,N,-,-1,-1
WESLEY.txt,421980,422722,742,10,N,N,-,-1,-1
WESLEY.txt,422044,422832,788,10,N,N,-,-1,-1
WESLEY.txt,422132,422972,840,10,N,N,-,-1,-1
WESLEY.txt,422218,423142,924,10,N,N,-,-1,-1
WESLEY.txt,422236,423184,948,10,N,N,-,-1,-1
WESLEY.txt,422316,423314,998,10,N,N,-,-1,-1
WESLEY.txt,422494,423409,915,10,N,N,-,-1,-1
WESLEY.txt,422501,423498,997,10,N,N,-,-1,-1
WESLEY.txt,422522,423520,998,10,N,N,-,-1,-1
WESLEY.txt,422697,423650,953,10,N,N,-,-1,-1
WESLEY.txt,422723,423760,1037,10,N,N,-,-1,-1
WESLEY.txt,422832,423917,1085,10,N,N,-,-1,-1
WESLEY.txt,422973,423985,1012,10,N,N,-,-1,-1
WESLEY.txt,423143,424071,928,10,N,N,-,-1,-1
WESLEY.txt,423186,424084,898,10,N,N,-,-1,-1
WESLEY.txt,423315,424131,816,10,N,N,-,-1,-1
WESLEY.txt,423410,424245,835,10,N,N,-,-1,-1
WESLEY.txt,423499,424302,803,10,N,N,-,-1,-1
WESLEY.txt,423520,424395,875,10,N,N,-,-1,-1
WESLEY.txt,423651,424446,795,10,N,N,-,-1,-1
WESLEY.txt,423761,424527,766,10,N,N,-,-1,-1
WESLEY.txt,423918,424538,620,10,N,N,-,-1,-1
WESLEY.txt,423986,424556,570,10,N,N,-,-1,-1
WESLEY.txt,424072,424676,604,10,N,N,-,-1,-1
WESLEY.txt,424084,424704,620,10,N,N,-,-1,-1
WESLEY.txt,424132,424732,600,10,N,N,-,-1,-1
WESLEY.txt,424246,424765,519,10,N,N,-,-1,-1
WESLEY.txt,424303,424898,595,10,N,N,-,-1,-1
WESLEY.txt,424396,424985,589,10,N,N,-,-1,-1
WESLEY.txt,424448,425015,567,10,N,N,-,-1,-1
WESLEY.txt,424528,425072,544,10,N,N,-,-1,-1
WESLEY.txt,424538,425121,583,10,N,N,-,-1,-1
WESLEY.txt,424557,425192,635,10,N,N,-,-1,-1
WESLEY.txt,424677,425303,626,10,N,N,-,-1,-1
WESLEY.txt,424705,425447,742,10,N,N,-,-1,-1
WESLEY.txt,424733,425522,789,10,N,N,-,-1,-1
WESLEY.txt,424766,425685,919,10,N,N,-,-1,-1
WESLEY.txt,424899,425766,867,10,N,N,-,-1,-1
WESLEY.txt,424986,425871,885,10,N,N,-,-1,-1
WESLEY.txt,425015,425883,868,10,N,N,-,-1,-1
WESLEY.txt,425073,425951,878,10,N,N,-,-1,-1
WESLEY.txt,425122,426127,1005,10,N,N,-,-1,-1
WESLEY.txt,425193,426214,1021,10,N,N,-,-1,-1
WESLEY.txt,425304,426298,994,10,N,N,-,-1,-1
WESLEY.txt,425448,426400,952,10,N,N,-,-1,-1
WESLEY.txt,425523,426624,1101,10,N,N,-,-1,-1
WESLEY.txt,425686,426687,1001,10,N,N,-,-1,-1
WESLEY.txt,425767,426851,1084,10,N,N,-,-1,-1
WESLEY.txt,425872,426939,1067,10,N,N,-,-1,-1
WESLEY.txt,425883,427028,1145,10,N,N,-,-1,-1
WESLEY.txt,425952,427122,1170,10,N,N,-,-1,-1
WESLEY.txt,426128,427219,1091,10,N,N,-,-1,-1
WESLEY.txt,426215,427309,1094,10,N,N,-,-1,-1
WESLEY.txt,426299,427378,1079,10,N,N,-,-1,-1
WESLEY.txt,426401,427390,989,10,N,N,-,-1,-1
WESLEY.txt,426625,427427,802,10,N,N,-,-1,-1
WESLEY.txt,426688,427490,802,10,N,N,-,-1,-1
WESLEY.txt,426852,427575,723,10,N,N,-,-1,-1
WESLEY.txt,426939,427672,733,10,N,N,-,-1,-1
WESLEY.txt,427029,427726,697,10,N,N,-,-1,-1
WESLEY.txt,427123,427776,653,10,N,N,-,-1,-1
WESLEY.txt,427220,427858,638,10,N,N,-,-1,-1
WESLEY.txt,427310,427909,599,10,N,N,-,-1,-1
WESLEY.txt,427379,427991,612,10,N,N,-,-1,-1
WESLEY.txt,427390,428024,634,10,N,N,-,-1,-1
WESLEY.txt,427429,428064,635,10,N,N,-,-1,-1
WESLEY.txt,427492,428080,588,10,N,N,-,-1,-1
WESLEY.txt,427576,428111,535,10,N,N,-,-1,-1
WESLEY.txt,427673,428239,566,10,N,N,-,-1,-1
WESLEY.txt,427727,428458,731,10,N,N,-,-1,-1
WESLEY.txt,427777,428470,693,10,N,N,-,-1,-1
WESLEY.txt,427859,428512,653,10,N,N,-,-1,-1
WESLEY.txt,427910,428527,617,10,N,N,-,-1,-1
WESLEY.txt,427992,428603,611,10,N,N,-,-1,-1
WESLEY.txt,428025,428678,653,10,N,N,-,-1,-1
WESLEY.txt,428065,428831,766,10,N,N,-,-1,-1
WESLEY.txt,428080,428918,838,10,N,N,-,-1,-1
WESLEY.txt,428112,428938,826,10,N,N,-,-1,-1
WESLEY.txt,428240,429008,768,10,N,N,-,-1,-1
WESLEY.txt,428459,429016,557,10,N,N,-,-1,-1
WESLEY.txt,428470,429093,623,10,N,N,-,-1,-1
WESLEY.txt,428513,429136,623,10,N,N,-,-1,-1
WESLEY.txt,428527,429268,741,10,N,N,-,-1,-1
WESLEY.txt,428604,429281,677,10,N,N,-,-1,-1
WESLEY.txt,428679,429482,803,10,N,N,-,-1,-1
WESLEY.txt,428832,429526,694,10,N,N,-,-1,-1
WESLEY.txt,428919,429570,651,10,N,N,-,-1,-1
WESLEY.txt,428939,429686,747,10,N,N,-,-1,-1
WESLEY.txt,429009,429776,767,10,N,N,-,-1,-1
WESLEY.txt,429016,429860,844,10,N,N,-,-1,-1
WESLEY.txt,429094,429976,882,10,N,N,-,-1,-1
WESLEY.txt,429137,430063,926,10,N,N,-,-1,-1
WESLEY.txt,429269,430140,871,10,N,N,-,-1,-1
WESLEY.txt,429281,430187,906,10,N,N,-,-1,-1
WESLEY.txt,429483,430344,861,10,N,N,-,-1,-1
WESLEY.txt,429527,430356,829,10,N,N,-,-1,-1
WESLEY.txt,429571,430438,867,10,N,N,-,-1,-1
WESLEY.txt,429687,430664,977,10,N,N,-,-1,-1
WESLEY.txt,429776,430760,984,10,N,N,-,-1,-1
WESLEY.txt,429861,431172,1311,10,N,N,-,-1,-1
WESLEY.txt,429977,431194,1217,10,N,N,-,-1,-1
WESLEY.txt,430064,431538,1474,10,N,N,-,-1,-1
WESLEY.txt,430141,431562,1421,10,N,N,-,-1,-1
WESLEY.txt,430188,431662,1474,10,N,N,-,-1,-1
WESLEY.txt,430345,431756,1411,10,N,N,-,-1,-1
WESLEY.txt,430356,431932,1576,10,N,N,-,-1,-1
WESLEY.txt,430439,431953,1514,10,N,N,-,-1,-1
WESLEY.txt,430665,432024,1359,10,N,N,-,-1,-1
WESLEY.txt,430761,432036,1275,10,N,N,-,-1,-1
WESLEY.txt,431173,432057,884,10,N,N,-,-1,-1
WESLEY.txt,431194,432146,952,10,N,N,-,-1,-1
WESLEY.txt,431539,432289,750,10,N,N,-,-1,-1
WESLEY.txt,431563,432389,826,10,N,N,-,-1,-1
WESLEY.txt,431662,432413,751,10,N,N,-,-1,-1
WESLEY.txt,431758,432640,882,10,N,N,-,-1,-1
WESLEY.txt,431933,432723,790,10,N,N,-,-1,-1
WESLEY.txt,431953,432809,856,10,N,N,-,-1,-1
WESLEY.txt,432025,432882,857,10,N,N,-,-1,-1
WESLEY.txt,432036,433008,972,10,N,N,-,-1,-1
WESLEY.txt,432058,433083,1025,10,N,N,-,-1,-1
WESLEY.txt,432147,433175,1028,10,N,N,-,-1,-1
WESLEY.txt,432290,433248,958,10,N,N,-,-1,-1
WESLEY.txt,432390,433286,896,10,N,N,-,-1,-1
WESLEY.txt,432413,433432,1019,10,N,N,-,-1,-1
WESLEY.txt,432641,433639,998,10,N,N,-,-1,-1
WESLEY.txt,432724,433788,1064,10,N,N,-,-1,-1
WESLEY.txt,432810,433878,1068,10,N,N,-,-1,-1
WESLEY.txt,432883,434254,1371,10,N,N,-,-1,-1
WESLEY.txt,433009,434416,1407,10,N,N,-,-1,-1
WESLEY.txt,433084,434429,1345,10,N,N,-,-1,-1
WESLEY.txt,433176,434468,1292,10,N,N,-,-1,-1
WESLEY.txt,433250,434533,1283,10,N,N,-,-1,-1
WESLEY.txt,433287,434706,1419,10,N,N,-,-1,-1
WESLEY.txt,433433,434791,1358,10,N,N,-,-1,-1
WESLEY.txt,433640,434802,1162,10,N,N,-,-1,-1
WESLEY.txt,433789,434887,1098,10,N,N,-,-1,-1
WESLEY.txt,433879,434948,1069,10,N,N,-,-1,-1
WESLEY.txt,434255,435010,755,10,N,N,-,-1,-1
WESLEY.txt,434417,435079,662,10,N,N,-,-1,-1
WESLEY.txt,434429,435191,762,10,N,N,-,-1,-1
WESLEY.txt,434469,435357,888,10,N,N,-,-1,-1
WESLEY.txt,434534,435383,849,10,N,N,-,-1,-1
WESLEY.txt,434707,435572,865,10,N,N,-,-1,-1
WESLEY.txt,434792,435643,851,10,N,N,-,-1,-1
WESLEY.txt,434802,435735,933,10,N,N,-,-1,-1
WESLEY.txt,434888,435827,939,10,N,N,-,-1,-1
WESLEY.txt,434949,435908,959,10,N,N,-,-1,-1
WESLEY.txt,435011,436016,1005,10,N,N,-,-1,-1
WESLEY.txt,435080,436097,1017,10,N,N,-,-1,-1
WESLEY.txt,435192,436411,1219,10,N,N,-,-1,-1
WESLEY.txt,435358,436485,1127,10,N,N,-,-1,-1
WESLEY.txt,435384,436610,1226,10,N,N,-,-1,-1
WESLEY.txt,435573,436699,1126,10,N,N,-,-1,-1
WESLEY.txt,435644,436711,1067,10,N,N,-,-1,-1
WESLEY.txt,435737,436876,1139,10,N,N,-,-1,-1
WESLEY.txt,435828,437279,1451,10,N,N,-,-1,-1
WESLEY.txt,435909,437292,1383,10,N,N,-,-1,-1
WESLEY.txt,436016,437363,1347,10,N,N,-,-1,-1
WESLEY.txt,436098,437440,1342,10,N,N,-,-1,-1
WESLEY.txt,436412,437545,1133,10,N,N,-,-1,-1
WESLEY.txt,436486,437697,1211,10,N,N,-,-1,-1
WESLEY.txt,436611,437877,1266,10,N,N,-,-1,-1
WESLEY.txt,436700,437900,1200,10,N,N,-,-1,-1
WESLEY.txt,436711,437931,1220,10,N,N,-,-1,-1
WESLEY.txt,436877,438044,1167,10,N,N,-,-1,-1
WESLEY.txt,437280,438146,866,10,N,N,-,-1,-1
WESLEY.txt,437292,438274,982,10,N,N,-,-1,-1
WESLEY.txt,437364,438359,995,10,N,N,-,-1,-1
WESLEY.txt,437441,438439,998,10,N,N,-,-1,-1
WESLEY.txt,437546,438514,968,10,N,N,-,-1,-1
WESLEY.txt,437698,438594,896,10,N,N,-,-1,-1
WESLEY.txt,437878,438759,881,10,N,N,-,-1,-1
WESLEY.txt,437900,438875,975,10,N,N,-,-1,-1
WESLEY.txt,437932,439159,1227,10,N,N,-,-1,-1
WESLEY.txt,438045,439167,1122,10,N,N,-,-1,-1
WESLEY.txt,438146,439256,1110,10,N,N,-,-1,-1
WESLEY.txt,438275,439415,1140,10,N,N,-,-1,-1
WESLEY.txt,438360,439491,1131,10,N,N,-,-1,-1
WESLEY.txt,438440,439585,1145,10,N,N,-,-1,-1
WESLEY.txt,438515,439606,1091,10,N,N,-,-1,-1
WESLEY.txt,438595,439799,1204,10,N,N,-,-1,-1
WESLEY.txt,438761,439967,1206,10,N,N,-,-1,-1
WESLEY.txt,438876,440041,1165,10,N,N,-,-1,-1
WESLEY.txt,439160,440054,894,10,N,N,-,-1,-1
WESLEY.txt,439168,440143,975,10,N,N,-,-1,-1
WESLEY.txt,439257,440208,951,10,N,N,-,-1,-1
WESLEY.txt,439416,440259,843,10,N,N,-,-1,-1
WESLEY.txt,439493,440291,798,10,N,N,-,-1,-1
WESLEY.txt,439586,440387,801,10,N,N,-,-1,-1
WESLEY.txt,439606,440480,874,10,N,N,-,-1,-1
WESLEY.txt,439800,440520,720,10,N,N,-,-1,-1
WESLEY.txt,439968,440551,583,10,N,N,-,-1,-1
WESLEY.txt,440042,440645,603,10,N,N,-,-1,-1
WESLEY.txt,440054,440665,611,10,N,N,-,-1,-1
WESLEY.txt,440144,440839,695,10,N,N,-,-1,-1
WESLEY.txt,440209,440854,645,10,N,N,-,-1,-1
WESLEY.txt,440260,440927,667,10,N,N,-,-1,-1
WESLEY.txt,440292,440992,700,10,N,N,-,-1,-1
WESLEY.txt,440388,441167,779,10,N,N,-,-1,-1
WESLEY.txt,440481,441179,698,10,N,N,-,-1,-1
WESLEY.txt,440521,441254,733,10,N,N,-,-1,-1
WESLEY.txt,440552,441338,786,10,N,N,-,-1,-1
WESLEY.txt,440645,441373,728,10,N,N,-,-1,-1
WESLEY.txt,440665,441451,786,10,N,N,-,-1,-1
WESLEY.txt,440840,441471,631,10,N,N,-,-1,-1
WESLEY.txt,440854,441560,706,10,N,N,-,-1,-1
WESLEY.txt,440928,441649,721,10,N,N,-,-1,-1
WESLEY.txt,440993,441737,744,10,N,N,-,-1,-1
WESLEY.txt,441168,441815,647,10,N,N,-,-1,-1
WESLEY.txt,441179,441883,704,10,N,N,-,-1,-1
WESLEY.txt,441255,441896,641,10,N,N,-,-1,-1
WESLEY.txt,441339,441959,620,10,N,N,-,-1,-1
WESLEY.txt,441374,442046,672,10,N,N,-,-1,-1
WESLEY.txt,441452,442061,609,10,N,N,-,-1,-1
WESLEY.txt,441471,442218,747,10,N,N,-,-1,-1
WESLEY.txt,441561,442238,677,10,N,N,-,-1,-1
WESLEY.txt,441650,442305,655,10,N,N,-,-1,-1
WESLEY.txt,441738,442346,608,10,N,N,-,-1,-1
WESLEY.txt,441815,442520,705,10,N,N,-,-1,-1
WESLEY.txt,441884,442532,648,10,N,N,-,-1,-1
WESLEY.txt,441896,442658,762,10,N,N,-,-1,-1
WESLEY.txt,441960,442791,831,10,N,N,-,-1,-1
WESLEY.txt,442047,442889,842,10,N,N,-,-1,-1
WESLEY.txt,442061,443004,943,10,N,N,-,-1,-1
WESLEY.txt,442219,443016,797,10,N,N,-,-1,-1
WESLEY.txt,442238,443101,863,10,N,N,-,-1,-1
WESLEY.txt,442306,443310,1004,10,N,N,-,-1,-1
WESLEY.txt,442347,443324,977,10,N,N,-,-1,-1
WESLEY.txt,442521,443508,987,10,N,N,-,-1,-1
WESLEY.txt,442532,443653,1121,10,N,N,-,-1,-1
WESLEY.txt,442659,443693,1034,10,N,N,-,-1,-1
WESLEY.txt,442792,443705,913,10,N,N,-,-1,-1
WESLEY.txt,442890,443791,901,10,N,N,-,-1,-1
WESLEY.txt,443005,443861,856,10,N,N,-,-1,-1
WESLEY.txt,443016,443936,920,10,N,N,-,-1,-1
WESLEY.txt,443102,443949,847,10,N,N,-,-1,-1
WESLEY.txt,443311,444059,748,10,N,N,-,-1,-1
WESLEY.txt,443324,444156,832,10,N,N,-,-1,-1
WESLEY.txt,443509,444317,808,10,N,N,-,-1,-1
WESLEY.txt,443654,444417,763,10,N,N,-,-1,-1
WESLEY.txt,443694,444489,795,10,N,N,-,-1,-1
WESLEY.txt,443705,444560,855,10,N,N,-,-1,-1
WESLEY.txt,443792,444837,1045,10,N,N,-,-1,-1
WESLEY.txt,443863,444973,1110,10,N,N,-,-1,-1
WESLEY.txt,443937,445047,1110,10,N,N,-,-1,-1
WESLEY.txt,443949,445155,1206,10,N,N,-,-1,-1
WESLEY.txt,444060,445232,1172,10,N,N,-,-1,-1
WESLEY.txt,444157,445319,1162,10,N,N,-,-1,-1
WESLEY.txt,444318,445506,1188,10,N,N,-,-1,-1
WESLEY.txt,444418,445581,1163,10,N,N,-,-1,-1
WESLEY.txt,444491,445669,1178,10,N,N,-,-1,-1
WESLEY.txt,444561,445805,1244,10,N,N,-,-1,-1
WESLEY.txt,444838,445857,1019,10,N,N,-,-1,-1
WESLEY.txt,444974,445899,925,10,N,N,-,-1,-1
WESLEY.txt,445048,445933,885,10,N,N,-,-1,-1
WESLEY.txt,445156,445937,781,10,N,N,-,-1,-1
WESLEY.txt,445233,445970,737,10,N,N,-,-1,-1
WESLEY.txt,445320,446007,687,10,N,N,-,-1,-1
WESLEY.txt,445507,446129,622,10,N,N,-,-1,-1
WESLEY.txt,445582,446222,640,10,N,N,-,-1,-1
WESLEY.txt,445670,446270,600,10,N,N,-,-1,-1
WESLEY.txt,445806,446321,515,10,N,N,-,-1,-1
WESLEY.txt,445858,446391,533,10,N,N,-,-1,-1
WESLEY.txt,445900,446487,587,10,N,N,-,-1,-1
WESLEY.txt,445934,446559,625,10,N,N,-,-1,-1
WESLEY.txt,445938,446601,663,10,N,N,-,-1,-1
WESLEY.txt,445971,446675,704,10,N,N,-,-1,-1
WESLEY.txt,446008,446775,767,10,N,N,-,-1,-1
WESLEY.txt,446130,446850,720,10,N,N,-,-1,-1
WESLEY.txt,446223,446992,769,10,N,N,-,-1,-1
WESLEY.txt,446271,447040,769,10,N,N,-,-1,-1
WESLEY.txt,446322,447083,761,10,N,N,-,-1,-1
WESLEY.txt,446393,447152,759,10,N,N,-,-1,-1
WESLEY.txt,446488,447217,729,10,N,N,-,-1,-1
WESLEY.txt,446560,447286,726,10,N,N,-,-1,-1
WESLEY.txt,446602,447324,722,10,N,N,-,-1,-1
WESLEY.txt,446675,447339,664,10,N,N,-,-1,-1
WESLEY.txt,446776,447427,651,10,N,N,-,-1,-1
WESLEY.txt,446851,447600,749,10,N,N,-,-1,-1
WESLEY.txt,446993,447619,626,10,N,N,-,-1,-1
WESLEY.txt,447041,447680,639,10,N,N,-,-1,-1
WESLEY.txt,447085,447779,694,10,N,N,-,-1,-1
WESLEY.txt,447153,447884,731,10,N,N,-,-1,-1
WESLEY.txt,447218,447965,747,10,N,N,-,-1,-1
WESLEY.txt,447287,448047,760,10,N,N,-,-1,-1
WESLEY.txt,447325,448234,909,10,N,N,-,-1,-1
WESLEY.txt,447339,448338,999,10,N,N,-,-1,-1
WESLEY.txt,447428,448417,989,10,N,N,-,-1,-1
WESLEY.txt,447601,448482,881,10,N,N,-,-1,-1
WESLEY.txt,447619,448553,934,10,N,N,-,-1,-1
WESLEY.txt,447681,448642,961,10,N,N,-,-1,-1
WESLEY.txt,447781,448719,938,10,N,N,-,-1,-1
WESLEY.txt,447885,448823,938,10,N,N,-,-1,-1
WESLEY.txt,447966,448910,944,10,N,N,-,-1,-1
WESLEY.txt,448047,449023,976,10,N,N,-,-1,-1
WESLEY.txt,448235,449104,869,10,N,N,-,-1,-1
WESLEY.txt,448340,449302,962,10,N,N,-,-1,-1
WESLEY.txt,448418,449351,933,10,N,N,-,-1,-1
WESLEY.txt,448483,449383,900,10,N,N,-,-1,-1
WESLEY.txt,448554,449520,966,10,N,N,-,-1,-1
WESLEY.txt,448643,449611,968,10,N,N,-,-1,-1
WESLEY.txt,448720,449681,961,10,N,N,-,-1,-1
WESLEY.txt,448824,449818,994,10,N,N,-,-1,-1
WESLEY.txt,448911,449887,976,10,N,N,-,-1,-1
WESLEY.txt,449024,449997,973,10,N,N,-,-1,-1
WESLEY.txt,449105,450104,999,10,N,N,-,-1,-1
WESLEY.txt,449303,450212,909,10,N,N,-,-1,-1
WESLEY.txt,449352,450278,926,10,N,N,-,-1,-1
WESLEY.txt,449384,450353,969,10,N,N,-,-1,-1
WESLEY.txt,449521,450433,912,10,N,N,-,-1,-1
WESLEY.txt,449612,450519,907,10,N,N,-,-1,-1
WESLEY.txt,449682,450704,1022,10,N,N,-,-1,-1
WESLEY.txt,449820,450717,897,10,N,N,-,-1,-1
WESLEY.txt,449888,450840,952,10,N,N,-,-1,-1
WESLEY.txt,449997,450949,952,10,N,N,-,-1,-1
WESLEY.txt,450105,451008,903,10,N,N,-,-1,-1
WESLEY.txt,450213,451059,846,10,N,N,-,-1,-1
WESLEY.txt,450280,451154,874,10,N,N,-,-1,-1
WESLEY.txt,450354,451441,1087,10,N,N,-,-1,-1
WESLEY.txt,450434,451542,1108,10,N,N,-,-1,-1
WESLEY.txt,450520,451677,1157,10,N,N,-,-1,-1
WESLEY.txt,450705,451733,1028,10,N,N,-,-1,-1
WESLEY.txt,450717,451816,1099,10,N,N,-,-1,-1
WESLEY.txt,450841,451984,1143,10,N,N,-,-1,-1
WESLEY.txt,450951,452070,1119,10,N,N,-,-1,-1
WESLEY.txt,451009,452162,1153,10,N,N,-,-1,-1
WESLEY.txt,451060,452241,1181,10,N,N,-,-1,-1
WESLEY.txt,451155,452327,1172,10,N,N,-,-1,-1
WESLEY.txt,451442,452439,997,10,N,N,-,-1,-1
WESLEY.txt,451543,452499,956,10,N,N,-,-1,-1
WESLEY.txt,451678,452614,936,10,N,N,-,-1,-1
WESLEY.txt,451734,452786,1052,10,N,N,-,-1,-1
WESLEY.txt,451817,452869,1052,10,N,N,-,-1,-1
WESLEY.txt,451985,453156,1171,10,N,N,-,-1,-1
WESLEY.txt,452071,453422,1351,10,N,N,-,-1,-1
WESLEY.txt,452163,453511,1348,10,N,N,-,-1,-1
WESLEY.txt,452241,453675,1434,10,N,N,-,-1,-1
WESLEY.txt,452328,453710,1382,10,N,N,-,-1,-1
WESLEY.txt,452440,453820,1380,10,N,N,-,-1,-1
WESLEY.txt,452500,453888,1388,10,N,N,-,-1,-1
WESLEY.txt,452616,453987,1371,10,N,N,-,-1,-1
WESLEY.txt,452787,454029,1242,10,N,N,-,-1,-1
WESLEY.txt,452870,454078,1208,10,N,N,-,-1,-1
WESLEY.txt,453157,454474,1317,10,N,N,-,-1,-1
WESLEY.txt,453423,454547,1124,10,N,N,-,-1,-1
WESLEY.txt,453512,454565,1053,10,N,N,-,-1,-1
WESLEY.txt,453676,454715,1039,10,N,N,-,-1,-1
WESLEY.txt,453711,454789,1078,10,N,N,-,-1,-1
WESLEY.txt,453821,454966,1145,10,N,N,-,-1,-1
WESLEY.txt,453889,455067,1178,10,N,N,-,-1,-1
WESLEY.txt,453988,455216,1228,10,N,N,-,-1,-1
WESLEY.txt,454030,455243,1213,10,N,N,-,-1,-1
WESLEY.txt,454079,455327,1248,10,N,N,-,-1,-1
WESLEY.txt,454475,455435,960,10,N,N,-,-1,-1
WESLEY.txt,454547,455446,899,10,N,N,-,-1,-1
WESLEY.txt,454565,455534,969,10,N,N,-,-1,-1
WESLEY.txt,454716,455623,907,10,N,N,-,-1,-1
WESLEY.txt,454790,455703,913,10,N,N,-,-1,-1
WESLEY.txt,454967,455753,786,10,N,N,-,-1,-1
WESLEY.txt,455068,455793,725,10,N,N,-,-1,-1
WESLEY.txt,455217,455821,604,10,N,N,-,-1,-1
WESLEY.txt,455244,456036,792,10,N,N,-,-1,-1
WESLEY.txt,455327,456118,791,10,N,N,-,-1,-1
WESLEY.txt,455436,456176,740,10,N,N,-,-1,-1
WESLEY.txt,455446,456195,749,10,N,N,-,-1,-1
WESLEY.txt,455535,456268,733,10,N,N,-,-1,-1
WESLEY.txt,455624,456357,733,10,N,N,-,-1,-1
WESLEY.txt,455704,456371,667,10,N,N,-,-1,-1
WESLEY.txt,455755,456520,765,10,N,N,-,-1,-1
WESLEY.txt,455794,456553,759,10,N,N,-,-1,-1
WESLEY.txt,455822,456588,766,10,N,N,-,-1,-1
WESLEY.txt,456037,456667,630,10,N,N,-,-1,-1
WESLEY.txt,456119,456749,630,10,N,N,-,-1,-1
WESLEY.txt,456177,456761,584,10,N,N,-,-1,-1
WESLEY.txt,456196,456818,622,10,N,N,-,-1,-1
WESLEY.txt,456269,456904,635,10,N,N,-,-1,-1
WESLEY.txt,456358,457067,709,10,N,N,-,-1,-1
WESLEY.txt,456371,457140,769,10,N,N,-,-1,-1
WESLEY.txt,456521,457323,802,10,N,N,-,-1,-1
WESLEY.txt,456554,457406,852,10,N,N,-,-1,-1
WESLEY.txt,456589,457572,983,10,N,N,-,-1,-1
WESLEY.txt,456668,457655,987,10,N,N,-,-1,-1
WESLEY.txt,456750,457738,988,10,N,N,-,-1,-1
WESLEY.txt,456761,457802,1041,10,N,N,-,-1,-1
WESLEY.txt,456819,457845,1026,10,N,N,-,-1,-1
WESLEY.txt,456905,457966,1061,10,N,N,-,-1,-1
WESLEY.txt,457068,458069,1001,10,N,N,-,-1,-1
WESLEY.txt,457141,458237,1096,10,N,N,-,-1,-1
WESLEY.txt,457324,458336,1012,10,N,N,-,-1,-1
WESLEY.txt,457407,458359,952,10,N,N,-,-1,-1
WESLEY.txt,457573,458373,800,10,N,N,-,-1,-1
WESLEY.txt,457656,458525,869,10,N,N,-,-1,-1
WESLEY.txt,457739,458601,862,10,N,N,-,-1,-1
WESLEY.txt,457803,458740,937,10,N,N,-,-1,-1
WESLEY.txt,457846,458782,936,10,N,N,-,-1,-1
WESLEY.txt,457967,458794,827,10,N,N,-,-1,-1
WESLEY.txt,458070,458942,872,10,N,N,-,-1,-1
WESLEY.txt,458238,458956,718,10,N,N,-,-1,-1
WESLEY.txt,458336,459109,773,10,N,N,-,-1,-1
WESLEY.txt,458360,459130,770,10,N,N,-,-1,-1
WESLEY.txt,458373,459195,822,10,N,N,-,-1,-1
WESLEY.txt,458526,459251,725,10,N,N,-,-1,-1
WESLEY.txt,458602,459377,775,10,N,N,-,-1,-1
WESLEY.txt,458741,459565,824,10,N,N,-,-1,-1
WESLEY.txt,458783,459585,802,10,N,N,-,-1,-1
WESLEY.txt,458794,459671,877,10,N,N,-,-1,-1
WESLEY.txt,458943,459772,829,10,N,N,-,-1,-1
WESLEY.txt,458956,459877,921,10,N,N,-,-1,-1
WESLEY.txt,459110,460052,942,10,N,N,-,-1,-1
WESLEY.txt,459130,460226,1096,10,N,N,-,-1,-1
WESLEY.txt,459196,460438,1242,10,N,N,-,-1,-1
WESLEY.txt,459252,460821,1569,10,N,N,-,-1,-1
WESLEY.txt,459378,460901,1523,10,N,N,-,-1,-1
WESLEY.txt,459566,461002,1436,10,N,N,-,-1,-1
WESLEY.txt,459585,461019,1434,10,N,N,-,-1,-1
WESLEY.txt,459672,461141,1469,10,N,N,-,-1,-1
WESLEY.txt,459773,461421,1648,10,N,N,-,-1,-1
WESLEY.txt,459877,461506,1629,10,N,N,-,-1,-1
WESLEY.txt,460053,461589,1536,10,N,N,-,-1,-1
WESLEY.txt,460227,461777,1550,10,N,N,-,-1,-1
WESLEY.txt,460439,461887,1448,10,N,N,-,-1,-1
WESLEY.txt,460822,461901,1079,10,N,N,-,-1,-1
WESLEY.txt,460902,462012,1110,10,N,N,-,-1,-1
WESLEY.txt,461003,462114,1111,10,N,N,-,-1,-1
WESLEY.txt,461019,462203,1184,10,N,N,-,-1,-1
WESLEY.txt,461142,462335,1193,10,N,N,-,-1,-1
WESLEY.txt,461422,462414,992,10,N,N,-,-1,-1
WESLEY.txt,461507,462453,946,10,N,N,-,-1,-1
WESLEY.txt,461590,462464,874,10,N,N,-,-1,-1
WESLEY.txt,461778,462547,769,10,N,N,-,-1,-1
WESLEY.txt,461888,462647,759,10,N,N,-,-1,-1
WESLEY.txt,461901,462809,908,10,N,N,-,-1,-1
WESLEY.txt,462012,462998,986,10,N,N,-,-1,-1
WESLEY.txt,462114,463105,991,10,N,N,-,-1,-1
WESLEY.txt,462204,463184,980,10,N,N,-,-1,-1
WESLEY.txt,462336,463351,1015,10,N,N,-,-1,-1
WESLEY.txt,462415,463466,1051,10,N,N,-,-1,-1
WESLEY.txt,462454,463577,1123,10,N,N,-,-1,-1
WESLEY.txt,462464,463664,1200,10,N,N,-,-1,-1
WESLEY.txt,462548,463743,1195,10,N,N,-,-1,-1
WESLEY.txt,462648,463820,1172,10,N,N,-,-1,-1
WESLEY.txt,462810,463919,1109,10,N,N,-,-1,-1
WESLEY.txt,462999,464007,1008,10,N,N,-,-1,-1
WESLEY.txt,463106,464120,1014,10,N,N,-,-1,-1
WESLEY.txt,463185,464131,946,10,N,N,-,-1,-1
WESLEY.txt,463352,464161,809,10,N,N,-,-1,-1
WESLEY.txt,463467,464337,870,10,N,N,-,-1,-1
WESLEY.txt,463578,464392,814,10,N,N,-,-1,-1
WESLEY.txt,463664,464461,797,10,N,N,-,-1,-1
WESLEY.txt,463744,464650,906,10,N,N,-,-1,-1
WESLEY.txt,463821,464758,937,10,N,N,-,-1,-1
WESLEY.txt,463919,464842,923,10,N,N,-,-1,-1
WESLEY.txt,464008,465018,1010,10,N,N,-,-1,-1
WESLEY.txt,464121,465106,985,10,N,N,-,-1,-1
WESLEY.txt,464132,465132,1000,10,N,N,-,-1,-1
WESLEY.txt,464162,465211,1049,10,N,N,-,-1,-1
WESLEY.txt,464338,465373,1035,10,N,N,-,-1,-1
WESLEY.txt,464393,465531,1138,10,N,N,-,-1,-1
WESLEY.txt,464462,465629,1167,10,N,N,-,-1,-1
WESLEY.txt,464651,465643,992,10,N,N,-,-1,-1
WESLEY.txt,464759,465685,926,10,N,N,-,-1,-1
WESLEY.txt,464843,465913,1070,10,N,N,-,-1,-1
WESLEY.txt,465019,465959,940,10,N,N,-,-1,-1
WESLEY.txt,465107,466029,922,10,N,N,-,-1,-1
WESLEY.txt,465133,466080,947,10,N,N,-,-1,-1
WESLEY.txt,465212,466095,883,10,N,N,-,-1,-1
WESLEY.txt,465374,466173,799,10,N,N,-,-1,-1
WESLEY.txt,465532,466352,820,10,N,N,-,-1,-1
WESLEY.txt,465630,466435,805,10,N,N,-,-1,-1
WESLEY.txt,465643,466528,885,10,N,N,-,-1,-1
WESLEY.txt,465686,466559,873,10,N,N,-,-1,-1
WESLEY.txt,465914,466911,997,10,N,N,-,-1,-1
WESLEY.txt,465960,466958,998,10,N,N,-,-1,-1
WESLEY.txt,466030,467129,1099,10,N,N,-,-1,-1
WESLEY.txt,466081,467158,1077,10,N,N,-,-1,-1
WESLEY.txt,466095,467291,1196,10,N,N,-,-1,-1
WESLEY.txt,466174,467485,1311,10,N,N,-,-1,-1
WESLEY.txt,466353,467617,1264,10,N,N,-,-1,-1
WESLEY.txt,466436,467641,1205,10,N,N,-,-1,-1
WESLEY.txt,466529,467778,1249,10,N,N,-,-1,-1
WESLEY.txt,466559,467884,1325,10,N,N,-,-1,-1
WESLEY.txt,466912,467924,1012,10,N,N,-,-1,-1
WESLEY.txt,466959,467981,1022,10,N,N,-,-1,-1
WESLEY.txt,467130,468097,967,10,N,N,-,-1,-1
WESLEY.txt,467159,468162,1003,10,N,N,-,-1,-1
WESLEY.txt,467292,468193,901,10,N,N,-,-1,-1
WESLEY.txt,467486,468270,784,10,N,N,-,-1,-1
WESLEY.txt,467618,468351,733,10,N,N,-,-1,-1
WESLEY.txt,467642,468476,834,10,N,N,-,-1,-1
WESLEY.txt,467779,468544,765,10,N,N,-,-1,-1
WESLEY.txt,467885,468757,872,10,N,N,-,-1,-1
WESLEY.txt,467925,468804,879,10,N,N,-,-1,-1
WESLEY.txt,467982,468942,960,10,N,N,-,-1,-1
WESLEY.txt,468098,468984,886,10,N,N,-,-1,-1
WESLEY.txt,468163,469015,852,10,N,N,-,-1,-1
WESLEY.txt,468194,469052,858,10,N,N,-,-1,-1
WESLEY.txt,468271,469102,831,10,N,N,-,-1,-1
WESLEY.txt,468352,469138,786,10,N,N,-,-1,-1
WESLEY.txt,468477,469234,757,10,N,N,-,-1,-1
WESLEY.txt,468545,469268,723,10,N,N,-,-1,-1
WESLEY.txt,468758,469346,588,10,N,N,-,-1,-1
WESLEY.txt,468805,469514,709,10,N,N,-,-1,-1
WESLEY.txt,468943,469728,785,10,N,N,-,-1,-1
WESLEY.txt,468984,469874,890,10,N,N,-,-1,-1
WESLEY.txt,469016,469895,879,10,N,N,-,-1,-1
WESLEY.txt,469053,469917,864,10,N,N,-,-1,-1
WESLEY.txt,469102,469951,849,10,N,N,-,-1,-1
WESLEY.txt,469139,470089,950,10,N,N,-,-1,-1
WESLEY.txt,469235,470188,953,10,N,N,-,-1,-1
WESLEY.txt,469269,470199,930,10,N,N,-,-1,-1
WESLEY.txt,469347,470392,1045,10,N,N,-,-1,-1
WESLEY.txt,469515,470566,1051,10,N,N,-,-1,-1
WESLEY.txt,469729,470649,920,10,N,N,-,-1,-1
WESLEY.txt,469875,470663,788,10,N,N,-,-1,-1
WESLEY.txt,469895,470691,796,10,N,N,-,-1,-1
WESLEY.txt,469918,470730,812,10,N,N,-,-1,-1
WESLEY.txt,469952,470887,935,10,N,N,-,-1,-1
WESLEY.txt,470090,470993,903,10,N,N,-,-1,-1
WESLEY.txt,470189,471005,816,10,N,N,-,-1,-1
WESLEY.txt,470199,471038,839,10,N,N,-,-1,-1
WESLEY.txt,470393,471133,740,10,N,N,-,-1,-1
WESLEY.txt,470567,471210,643,10,N,N,-,-1,-1
WESLEY.txt,470650,471460,810,10,N,N,-,-1,-1
WESLEY.txt,470663,471562,899,10,N,N,-,-1,-1
WESLEY.txt,470692,471674,982,10,N,N,-,-1,-1
WESLEY.txt,470731,471787,1056,10,N,N,-,-1,-1
WESLEY.txt,470888,471922,1034,10,N,N,-,-1,-1
WESLEY.txt,470994,472020,1026,10,N,N,-,-1,-1
WESLEY.txt,471005,472051,1046,10,N,N,-,-1,-1
WESLEY.txt,471039,472127,1088,10,N,N,-,-1,-1
WESLEY.txt,471134,472232,1098,10,N,N,-,-1,-1
WESLEY.txt,471211,472286,1075,10,N,N,-,-1,-1
WESLEY.txt,471461,472327,866,10,N,N,-,-1,-1
WESLEY.txt,471562,472411,849,10,N,N,-,-1,-1
WESLEY.txt,471675,472425,750,10,N,N,-,-1,-1
WESLEY.txt,471788,472519,731,10,N,N,-,-1,-1
WESLEY.txt,471923,472617,694,10,N,N,-,-1,-1
WESLEY.txt,472021,472736,715,10,N,N,-,-1,-1
WESLEY.txt,472052,472794,742,10,N,N,-,-1,-1
WESLEY.txt,472128,472886,758,10,N,N,-,-1,-1
WESLEY.txt,472233,472974,741,10,N,N,-,-1,-1
WESLEY.txt,472287,473055,768,10,N,N,-,-1,-1
WESLEY.txt,472328,473152,824,10,N,N,-,-1,-1
WESLEY.txt,472412,473236,824,10,N,N,-,-1,-1
WESLEY.txt,472425,473248,823,10,N,N,-,-1,-1
WESLEY.txt,472520,473514,994,10,N,N,-,-1,-1
WESLEY.txt,472618,473566,948,10,N,N,-,-1,-1
WESLEY.txt,472737,473613,876,10,N,N,-,-1,-1
WESLEY.txt,472795,473812,1017,10,N,N,-,-1,-1
WESLEY.txt,472887,473825,938,10,N,N,-,-1,-1
WESLEY.txt,472975,473923,948,10,N,N,-,-1,-1
WESLEY.txt,473056,473992,936,10,N,N,-,-1,-1
WESLEY.txt,473153,474137,984,10,N,N,-,-1,-1
WESLEY.txt,473237,474194,957,10,N,N,-,-1,-1
WESLEY.txt,473248,474294,1046,10,N,N,-,-1,-1
WESLEY.txt,473515,474373,858,10,N,N,-,-1,-1
WESLEY.txt,473567,474502,935,10,N,N,-,-1,-1
WESLEY.txt,473614,474673,1059,10,N,N,-,-1,-1
WESLEY.txt,473813,474755,942,10,N,N,-,-1,-1
WESLEY.txt,473825,474922,1097,10,N,N,-,-1,-1
WESLEY.txt,473924,475015,1091,10,N,N,-,-1,-1
WESLEY.txt,473993,475114,1121,10,N,N,-,-1,-1
WESLEY.txt,474138,475202,1064,10,N,N,-,-1,-1
WESLEY.txt,474195,475333,1138,10,N,N,-,-1,-1
WESLEY.txt,474295,475505,1210,10,N,N,-,-1,-1
WESLEY.txt,474374,475679,1305,10,N,N,-,-1,-1
WESLEY.txt,474503,475846,1343,10,N,N,-,-1,-1
WESLEY.txt,474674,475957,1283,10,N,N,-,-1,-1
WESLEY.txt,474756,476041,1285,10,N,N,-,-1,-1
WESLEY.txt,474923,476207,1284,10,N,N,-,-1,-1
WESLEY.txt,475016,476293,1277,10,N,N,-,-1,-1
WESLEY.txt,475115,476385,1270,10,N,N,-,-1,-1
WESLEY.txt,475203,476463,1260,10,N,N,-,-1,-1
WESLEY.txt,475334,476477,1143,10,N,N,-,-1,-1
WESLEY.txt,475506,476617,1111,10,N,N,-,-1,-1
WESLEY.txt,475680,476673,993,10,N,N,-,-1,-1
WESLEY.txt,475847,476770,923,10,N,N,-,-1,-1
WESLEY.txt,475957,476837,880,10,N,N,-,-1,-1
WESLEY.txt,476042,476980,938,10,N,N,-,-1,-1
WESLEY.txt,476208,477076,868,10,N,N,-,-1,-1
WESLEY.txt,476294,477141,847,10,N,N,-,-1,-1
WESLEY.txt,476386,477147,761,10,N,N,-,-1,-1
WESLEY.txt,476464,477169,705,10,N,N,-,-1,-1
WESLEY.txt,476477,477358,881,10,N,N,-,-1,-1
WESLEY.txt,476618,477463,845,10,N,N,-,-1,-1
WESLEY.txt,476674,477498,824,10,N,N,-,-1,-1
WESLEY.txt,476771,477760,989,10,N,N,-,-1,-1
WESLEY.txt,476838,477906,1068,10,N,N,-,-1,-1
WESLEY.txt,476981,477947,966,10,N,N,-,-1,-1
WESLEY.txt,477077,478045,968,10,N,N,-,-1,-1
WESLEY.txt,477142,478161,1019,10,N,N,-,-1,-1
WESLEY.txt,477148,478173,1025,10,N,N,-,-1,-1
WESLEY.txt,477169,478240,1071,10,N,N,-,-1,-1
WESLEY.txt,477359,478321,962,10,N,N,-,-1,-1
WESLEY.txt,477463,478406,943,10,N,N,-,-1,-1
WESLEY.txt,477499,478553,1054,10,N,N,-,-1,-1
WESLEY.txt,477761,478624,863,10,N,N,-,-1,-1
WESLEY.txt,477907,478688,781,10,N,N,-,-1,-1
WESLEY.txt,477948,478921,973,10,N,N,-,-1,-1
WESLEY.txt,478046,479027,981,10,N,N,-,-1,-1
WESLEY.txt,478162,479055,893,10,N,N,-,-1,-1
WESLEY.txt,478173,479136,963,10,N,N,-,-1,-1
WESLEY.txt,478241,479232,991,10,N,N,-,-1,-1
WESLEY.txt,478322,479478,1156,10,N,N,-,-1,-1
WESLEY.txt,478407,479580,1173,10,N,N,-,-1,-1
WESLEY.txt,478554,479651,1097,10,N,N,-,-1,-1
WESLEY.txt,478625,479682,1057,10,N,N,-,-1,-1
WESLEY.txt,478689,479764,1075,10,N,N,-,-1,-1
WESLEY.txt,478922,479848,926,10,N,N,-,-1,-1
WESLEY.txt,479028,480047,1019,10,N,N,-,-1,-1
WESLEY.txt,479056,480155,1099,10,N,N,-,-1,-1
WESLEY.txt,479137,480299,1162,10,N,N,-,-1,-1
WESLEY.txt,479233,480457,1224,10,N,N,-,-1,-1
WESLEY.txt,479479,480692,1213,10,N,N,-,-1,-1
WESLEY.txt,479581,480768,1187,10,N,Y,1437471397525,350644,351290
WESLEY.txt,479652,480867,1215,10,N,Y,1437471397525,350644,351290
WESLEY.txt,479683,480946,1263,10,N,Y,1437471397525,350644,351290
WESLEY.txt,479765,480966,1201,10,N,Y,1437471397525,350644,351290
WESLEY.txt,479849,480989,1140,10,N,Y,1437471397525,350644,351290
WESLEY.txt,480048,481130,1082,10,N,Y,1437471397525,350644,351290
WESLEY.txt,480155,481210,1055,10,N,Y,1437471397525,350644,351290
WESLEY.txt,480300,481298,998,10,N,Y,1437471397525,350644,351290
WESLEY.txt,480458,481372,914,10,N,Y,1437471397525,350644,351290
WESLEY.txt,480693,481461,768,10,N,Y,1437471397525,350644,351290
WESLEY.txt,480769,481550,781,10,N,Y,1437471397525,350644,351290
WESLEY.txt,480868,481594,726,10,N,Y,1437471397525,350644,351290
WESLEY.txt,480947,481704,757,10,N,N,-,-1,-1
WESLEY.txt,480966,481861,895,10,N,N,-,-1,-1
WESLEY.txt,480990,482095,1105,10,N,N,-,-1,-1
WESLEY.txt,481131,482182,1051,10,N,N,-,-1,-1
WESLEY.txt,481211,482253,1042,10,N,N,-,-1,-1
WESLEY.txt,481299,482339,1040,10,N,N,-,-1,-1
WESLEY.txt,481373,482464,1091,10,N,N,-,-1,-1
WESLEY.txt,481462,482540,1078,10,N,N,-,-1,-1
WESLEY.txt,481551,482722,1171,10,N,N,-,-1,-1
WESLEY.txt,481595,482892,1297,10,N,N,-,-1,-1
WESLEY.txt,481705,483024,1319,10,N,N,-,-1,-1
WESLEY.txt,481862,483085,1223,10,N,N,-,-1,-1
WESLEY.txt,482096,483240,1144,10,N,N,-,-1,-1
WESLEY.txt,482183,483294,1111,10,N,N,-,-1,-1
WESLEY.txt,482254,483306,1052,10,N,N,-,-1,-1
WESLEY.txt,482340,483409,1069,10,N,N,-,-1,-1
WESLEY.txt,482464,483496,1032,10,N,N,-,-1,-1
WESLEY.txt,482541,483620,1079,10,N,N,-,-1,-1
WESLEY.txt,482723,483689,966,10,N,N,-,-1,-1
WESLEY.txt,482893,483712,819,10,N,N,-,-1,-1
WESLEY.txt,483025,483759,734,10,N,N,-,-1,-1
WESLEY.txt,483086,483849,763,10,N,N,-,-1,-1
WESLEY.txt,483241,483982,741,10,N,N,-,-1,-1
WESLEY.txt,483295,483997,702,10,N,N,-,-1,-1
WESLEY.txt,483306,484104,798,10,N,N,-,-1,-1
WESLEY.txt,483410,484156,746,10,N,N,-,-1,-1
WESLEY.txt,483497,484201,704,10,N,N,-,-1,-1
WESLEY.txt,483621,484286,665,10,N,N,-,-1,-1
WESLEY.txt,483690,484394,704,10,N,N,-,-1,-1
WESLEY.txt,483713,484568,855,10,N,N,-,-1,-1
WESLEY.txt,483760,484738,978,10,N,N,-,-1,-1
WESLEY.txt,483850,484840,990,10,N,N,-,-1,-1
WESLEY.txt,483983,484927,944,10,N,N,-,-1,-1
WESLEY.txt,483997,484972,975,10,N,N,-,-1,-1
WESLEY.txt,484105,485017,912,10,N,N,-,-1,-1
WESLEY.txt,484157,485061,904,10,N,N,-,-1,-1
WESLEY.txt,484202,485120,918,10,N,N,-,-1,-1
WESLEY.txt,484287,485394,1107,10,N,N,-,-1,-1
WESLEY.txt,484394,485555,1161,10,N,N,-,-1,-1
WESLEY.txt,484569,485801,1232,10,N,N,-,-1,-1
WESLEY.txt,484739,485904,1165,10,N,N,-,-1,-1
WESLEY.txt,484841,485985,1144,10,N,N,-,-1,-1
WESLEY.txt,484928,486016,1088,10,N,N,-,-1,-1
WESLEY.txt,484973,486130,1157,10,N,N,-,-1,-1
WESLEY.txt,485018,486188,1170,10,N,N,-,-1,-1
WESLEY.txt,485062,486489,1427,10,N,N,-,-1,-1
WESLEY.txt,485121,486534,1413,10,N,N,-,-1,-1
WESLEY.txt,485395,486561,1166,10,N,N,-,-1,-1
WESLEY.txt,485556,486648,1092,10,N,N,-,-1,-1
WESLEY.txt,485802,486662,860,10,N,N,-,-1,-1
WESLEY.txt,485905,486712,807,10,N,N,-,-1,-1
WESLEY.txt,485986,487005,1019,10,N,N,-,-1,-1
WESLEY.txt,486017,487164,1147,10,N,N,-,-1,-1
WESLEY.txt,486131,487202,1071,10,N,N,-,-1,-1
WESLEY.txt,486189,487283,1094,10,N,N,-,-1,-1
WESLEY.txt,486490,487425,935,10,N,N,-,-1,-1
WESLEY.txt,486535,487576,1041,10,N,N,-,-1,-1
WESLEY.txt,486562,487667,1105,10,N,N,-,-1,-1
WESLEY.txt,486649,487716,1067,10,N,N,-,-1,-1
WESLEY.txt,486662,487848,1186,10,N,N,-,-1,-1
WESLEY.txt,486713,487938,1225,10,N,N,-,-1,-1
WESLEY.txt,487006,488041,1035,10,N,N,-,-1,-1
WESLEY.txt,487165,488242,1077,10,N,N,-,-1,-1
WESLEY.txt,487203,488324,1121,10,N,N,-,-1,-1
WESLEY.txt,487284,488336,1052,10,N,N,-,-1,-1
WESLEY.txt,487426,488443,1017,10,N,N,-,-1,-1
WESLEY.txt,487577,488517,940,10,N,N,-,-1,-1
WESLEY.txt,487668,488596,928,10,N,N,-,-1,-1
WESLEY.txt,487717,488694,977,10,N,N,-,-1,-1
WESLEY.txt,487849,488814,965,10,N,N,-,-1,-1
WESLEY.txt,487939,488850,911,10,N,N,-,-1,-1
WESLEY.txt,488042,488900,858,10,N,N,-,-1,-1
WESLEY.txt,488243,488941,698,10,N,N,-,-1,-1
WESLEY.txt,488325,488985,660,10,N,N,-,-1,-1
WESLEY.txt,488336,489129,793,10,N,N,-,-1,-1
WESLEY.txt,488444,489142,698,10,N,N,-,-1,-1
WESLEY.txt,488518,489253,735,10,N,N,-,-1,-1
WESLEY.txt,488597,489359,762,10,N,N,-,-1,-1
WESLEY.txt,488695,489374,679,10,N,N,-,-1,-1
WESLEY.txt,488815,489454,639,10,N,N,-,-1,-1
WESLEY.txt,488851,489630,779,10,N,N,-,-1,-1
WESLEY.txt,488901,489685,784,10,N,N,-,-1,-1
WESLEY.txt,488942,489730,788,10,N,N,-,-1,-1
WESLEY.txt,488986,489815,829,10,N,N,-,-1,-1
WESLEY.txt,489130,489870,740,10,N,N,-,-1,-1
WESLEY.txt,489142,490030,888,10,N,N,-,-1,-1
WESLEY.txt,489254,490115,861,10,N,N,-,-1,-1
WESLEY.txt,489360,490161,801,10,N,N,-,-1,-1
WESLEY.txt,489375,490330,955,10,N,N,-,-1,-1
WESLEY.txt,489455,490347,892,10,N,N,-,-1,-1
WESLEY.txt,489631,490416,785,10,N,N,-,-1,-1
WESLEY.txt,489686,490588,902,10,N,N,-,-1,-1
WESLEY.txt,489731,490690,959,10,N,N,-,-1,-1
WESLEY.txt,489815,490795,980,10,N,N,-,-1,-1
WESLEY.txt,489871,490986,1115,10,N,N,-,-1,-1
WESLEY.txt,490031,491075,1044,10,N,N,-,-1,-1
WESLEY.txt,490116,491089,973,10,N,N,-,-1,-1
WESLEY.txt,490162,491136,974,10,N,N,-,-1,-1
WESLEY.txt,490331,491279,948,10,N,N,-,-1,-1
WESLEY.txt,490348,491380,1032,10,N,N,-,-1,-1
WESLEY.txt,490417,491511,1094,10,N,N,-,-1,-1
WESLEY.txt,490589,491564,975,10,N,N,-,-1,-1
WESLEY.txt,490690,491639,949,10,N,N,-,-1,-1
WESLEY.txt,490796,491733,937,10,N,N,-,-1,-1
WESLEY.txt,490987,491765,778,10,N,N,-,-1,-1
WESLEY.txt,491076,491806,730,10,N,N,-,-1,-1
WESLEY.txt,491089,491941,852,10,N,N,-,-1,-1
WESLEY.txt,491137,492153,1016,10,N,N,-,-1,-1
WESLEY.txt,491280,492232,952,10,N,N,-,-1,-1
WESLEY.txt,491381,492262,881,10,N,N,-,-1,-1
WESLEY.txt,491512,492368,856,10,N,N,-,-1,-1
WESLEY.txt,491565,492375,810,10,N,N,-,-1,-1
WESLEY.txt,491640,492390,750,10,N,N,-,-1,-1
WESLEY.txt,491734,492436,702,10,N,N,-,-1,-1
WESLEY.txt,491765,492465,700,10,N,N,-,-1,-1
WESLEY.txt,491807,492580,773,10,N,N,-,-1,-1
WESLEY.txt,491942,492725,783,10,N,N,-,-1,-1
WESLEY.txt,492154,492963,809,10,N,N,-,-1,-1
WESLEY.txt,492233,493017,784,10,N,N,-,-1,-1
WESLEY.txt,492263,493147,884,10,N,N,-,-1,-1
WESLEY.txt,492369,493240,871,10,N,N,-,-1,-1
WESLEY.txt,492376,493348,972,10,N,N,-,-1,-1
WESLEY.txt,492391,493366,975,10,N,N,-,-1,-1
WESLEY.txt,492437,493429,992,10,N,N,-,-1,-1
WESLEY.txt,492466,493483,1017,10,N,N,-,-1,-1
WESLEY.txt,492581,493569,988,10,N,N,-,-1,-1
WESLEY.txt,492726,493741,1015,10,N,N,-,-1,-1
WESLEY.txt,492964,493931,967,10,N,N,-,-1,-1
WESLEY.txt,493018,494028,1010,10,N,Y,1437028092146,121457,123204
WESLEY.txt,493148,494116,968,10,N,Y,1437028092146,121457,123204
WESLEY.txt,493241,494542,1301,10,N,Y,1437028092146,121457,123204
WESLEY.txt,493349,494598,1249,10,N,Y,1437028092146,121457,123204
WESLEY.txt,493366,494696,1330,10,N,Y,1437028092146,121457,123204
WESLEY.txt,493430,494820,1390,10,N,Y,1437028092146,121457,123204
WESLEY.txt,493484,494889,1405,10,N,Y,1437028092146,121457,123204
WESLEY.txt,493570,494993,1423,10,N,Y,1437028092146,121457,123204
WESLEY.txt,493742,495078,1336,10,N,Y,1437028092146,121457,123204
WESLEY.txt,493932,495272,1340,10,N,Y,1437028092146,121457,123204
WESLEY.txt,494028,495301,1273,10,N,Y,1437028092146,121457,123204
WESLEY.txt,494117,495485,1368,10,N,Y,1437028092146,121457,123204
WESLEY.txt,494543,495602,1059,10,N,Y,1437028092146,121457,123204
WESLEY.txt,494599,495752,1153,10,N,Y,1437028092146,121457,123204
WESLEY.txt,494697,495780,1083,10,N,Y,1437028092146,121457,123204
WESLEY.txt,494821,495814,993,10,N,Y,1437028092146,121457,123204
WESLEY.txt,494890,495826,936,10,N,Y,1437028092146,121457,123204
WESLEY.txt,494994,495924,930,10,N,Y,1437028092146,121457,123204
WESLEY.txt,495079,495967,888,10,N,Y,1437028092146,121457,123204
WESLEY.txt,495273,496000,727,10,N,Y,1437028092146,121457,123204
WESLEY.txt,495302,496032,730,10,N,Y,1437028092146,121457,123204
WESLEY.txt,495486,496064,578,10,N,Y,1437028092146,121457,123204
WESLEY.txt,495603,496090,487,10,N,Y,1437028092146,121457,123204
WESLEY.txt,495753,496128,375,10,N,Y,1437028092146,121457,123204
WESLEY.txt,495781,496152,371,10,N,Y,1437028092146,121457,123204
WESLEY.txt,495815,496232,417,10,N,Y,1437028092146,121457,123204
WESLEY.txt,495827,496280,453,10,N,Y,1437028092146,121457,123204
WESLEY.txt,495925,496413,488,10,N,Y,1437028092146,121457,123204
WESLEY.txt,495968,496528,560,10,N,Y,1437028092146,121457,123204
WESLEY.txt,496001,496618,617,10,N,Y,1437028092146,121457,123204
WESLEY.txt,496032,496717,685,10,N,Y,1437028092146,121457,123204
WESLEY.txt,496065,496813,748,10,N,Y,1437028092146,121457,123204
WESLEY.txt,496090,496973,883,10,N,Y,1437028092146,121457,123204
WESLEY.txt,496129,497026,897,10,N,Y,1437028092146,121457,123204
WESLEY.txt,496152,497272,1120,10,N,Y,1437028092146,121457,123204
WESLEY.txt,496233,497419,1186,10,N,Y,1437028092146,121457,123204
WESLEY.txt,496280,497427,1147,10,N,Y,1437028092146,121457,123204
WESLEY.txt,496414,497522,1108,10,N,N,-,-1,-1
WESLEY.txt,496528,497725,1197,10,N,N,-,-1,-1
WESLEY.txt,496619,497813,1194,10,N,N,-,-1,-1
WESLEY.txt,496718,497946,1228,10,N,N,-,-1,-1
WESLEY.txt,496814,497994,1180,10,N,N,-,-1,-1
WESLEY.txt,496974,498080,1106,10,N,N,-,-1,-1
WESLEY.txt,497027,498138,1111,10,N,N,-,-1,-1
WESLEY.txt,497273,498230,957,10,N,N,-,-1,-1
WESLEY.txt,497420,498341,921,10,N,N,-,-1,-1
WESLEY.txt,497428,498546,1118,10,N,N,-,-1,-1
WESLEY.txt,497523,498668,1145,10,N,N,-,-1,-1
WESLEY.txt,497726,498760,1034,10,N,N,-,-1,-1
WESLEY.txt,497814,498899,1085,10,N,N,-,-1,-1
WESLEY.txt,497947,498920,973,10,N,N,-,-1,-1
WESLEY.txt,497995,499127,1132,10,N,N,-,-1,-1
WESLEY.txt,498081,499231,1150,10,N,N,-,-1,-1
WESLEY.txt,498139,499382,1243,10,N,N,-,-1,-1
WESLEY.txt,498231,499405,1174,10,N,N,-,-1,-1
WESLEY.txt,498342,499419,1077,10,N,N,-,-1,-1
WESLEY.txt,498547,499565,1018,10,N,N,-,-1,-1
WESLEY.txt,498669,499657,988,10,N,N,-,-1,-1
WESLEY.txt,498761,499754,993,10,N,N,-,-1,-1
WESLEY.txt,498900,499766,866,10,N,N,-,-1,-1
WESLEY.txt,498920,499789,869,10,N,N,-,-1,-1
WESLEY.txt,499128,499875,747,10,N,N,-,-1,-1
WESLEY.txt,499232,499956,724,10,N,N,-,-1,-1
WESLEY.txt,499382,500032,650,10,N,N,-,-1,-1
WESLEY.txt,499406,500119,713,10,N,N,-,-1,-1
WESLEY.txt,499420,500133,713,10,N,N,-,-1,-1
WESLEY.txt,499566,500296,730,10,N,N,-,-1,-1
WESLEY.txt,499658,500391,733,10,N,N,-,-1,-1
WESLEY.txt,499755,500408,653,10,N,N,-,-1,-1
WESLEY.txt,499766,500693,927,10,N,N,-,-1,-1
WESLEY.txt,499790,500733,943,10,N,N,-,-1,-1
WESLEY.txt,499876,500754,878,10,N,N,-,-1,-1
WESLEY.txt,499957,500782,825,10,N,N,-,-1,-1
WESLEY.txt,500033,500794,761,10,N,N,-,-1,-1
WESLEY.txt,500120,500874,754,10,N,N,-,-1,-1
WESLEY.txt,500134,500958,824,10,N,N,-,-1,-1
WESLEY.txt,500297,501034,737,10,N,N,-,-1,-1
WESLEY.txt,500392,501099,707,10,N,N,-,-1,-1
WESLEY.txt,500409,501204,795,10,N,N,-,-1,-1
WESLEY.txt,500694,501387,693,10,N,N,-,-1,-1
WESLEY.txt,500734,501505,771,10,N,N,-,-1,-1
WESLEY.txt,500755,501654,899,10,N,N,-,-1,-1
WESLEY.txt,500783,501739,956,10,N,N,-,-1,-1
WESLEY.txt,500794,501988,1194,10,N,N,-,-1,-1
WESLEY.txt,500875,502175,1300,10,N,N,-,-1,-1
WESLEY.txt,500959,502270,1311,10,N,N,-,-1,-1
WESLEY.txt,501035,502372,1337,10,N,N,-,-1,-1
WESLEY.txt,501100,502480,1380,10,N,N,-,-1,-1
WESLEY.txt,501205,502569,1364,10,N,N,-,-1,-1
WESLEY.txt,501388,502772,1384,10,N,N,-,-1,-1
WESLEY.txt,501505,502897,1392,10,N,N,-,-1,-1
WESLEY.txt,501655,502975,1320,10,N,N,-,-1,-1
WESLEY.txt,501740,503026,1286,10,N,N,-,-1,-1
WESLEY.txt,501989,503068,1079,10,N,N,-,-1,-1
WESLEY.txt,502176,503159,983,10,N,N,-,-1,-1
WESLEY.txt,502271,503250,979,10,N,N,-,-1,-1
WESLEY.txt,502373,503262,889,10,N,N,-,-1,-1
WESLEY.txt,502481,503353,872,10,N,N,-,-1,-1
WESLEY.txt,502570,503460,890,10,N,N,-,-1,-1
WESLEY.txt,502773,503509,736,10,N,N,-,-1,-1
WESLEY.txt,502897,503574,677,10,N,N,-,-1,-1
WESLEY.txt,502976,503678,702,10,N,N,-,-1,-1
WESLEY.txt,503027,503783,756,10,N,N,-,-1,-1
WESLEY.txt,503069,503968,899,10,N,N,-,-1,-1
WESLEY.txt,503160,504168,1008,10,N,N,-,-1,-1
WESLEY.txt,503251,504324,1073,10,N,N,-,-1,-1
WESLEY.txt,503262,504901,1639,10,N,N,-,-1,-1
WESLEY.txt,503354,504947,1593,10,N,N,-,-1,-1
WESLEY.txt,503461,505085,1624,10,N,N,-,-1,-1
WESLEY.txt,503510,505100,1590,10,N,N,-,-1,-1
WESLEY.txt,503575,505269,1694,10,N,N,-,-1,-1
WESLEY.txt,503679,505358,1679,10,N,N,-,-1,-1
WESLEY.txt,503784,505400,1616,10,N,N,-,-1,-1
WESLEY.txt,503969,505591,1622,10,N,N,-,-1,-1
WESLEY.txt,504169,505714,1545,10,N,N,-,-1,-1
WESLEY.txt,504325,505803,1478,10,N,N,-,-1,-1
WESLEY.txt,504902,505868,966,10,N,N,-,-1,-1
WESLEY.txt,504948,505949,1001,10,N,N,-,-1,-1
WESLEY.txt,505086,506021,935,10,N,N,-,-1,-1
WESLEY.txt,505100,506085,985,10,N,N,-,-1,-1
WESLEY.txt,505270,506100,830,10,N,N,-,-1,-1
WESLEY.txt,505359,506304,945,10,N,N,-,-1,-1
WESLEY.txt,505401,506370,969,10,N,N,-,-1,-1
WESLEY.txt,505592,506673,1081,10,N,N,-,-1,-1
WESLEY.txt,505715,506713,998,10,N,N,-,-1,-1
WESLEY.txt,505804,506825,1021,10,N,N,-,-1,-1
WESLEY.txt,505869,506941,1072,10,N,N,-,-1,-1
WESLEY.txt,505950,507039,1089,10,N,N,-,-1,-1
WESLEY.txt,506021,507062,1041,10,N,N,-,-1,-1
WESLEY.txt,506086,507231,1145,10,N,N,-,-1,-1
WESLEY.txt,506101,507337,1236,10,N,N,-,-1,-1
WESLEY.txt,506305,507355,1050,10,N,N,-,-1,-1
WESLEY.txt,506371,507442,1071,10,N,N,-,-1,-1
WESLEY.txt,506674,507765,1091,10,N,N,-,-1,-1
WESLEY.txt,506714,507810,1096,10,N,N,-,-1,-1
WESLEY.txt,506826,507875,1049,10,N,N,-,-1,-1
WESLEY.txt,506942,508041,1099,10,N,N,-,-1,-1
WESLEY.txt,507040,508283,1243,10,N,N,-,-1,-1
WESLEY.txt,507062,508376,1314,10,N,N,-,-1,-1
WESLEY.txt,507232,508568,1336,10,N,N,-,-1,-1
WESLEY.txt,507338,508753,1415,10,N,N,-,-1,-1
WESLEY.txt,507355,508858,1503,10,N,N,-,-1,-1
WESLEY.txt,507443,508915,1472,10,N,N,-,-1,-1
WESLEY.txt,507766,508990,1224,10,N,N,-,-1,-1
WESLEY.txt,507811,509100,1289,10,N,N,-,-1,-1
WESLEY.txt,507876,509207,1331,10,N,N,-,-1,-1
WESLEY.txt,508042,509418,1376,10,N,N,-,-1,-1
WESLEY.txt,508284,509498,1214,10,N,N,-,-1,-1
WESLEY.txt,508377,509546,1169,10,N,N,-,-1,-1
WESLEY.txt,508569,509633,1064,10,N,N,-,-1,-1
WESLEY.txt,508754,509846,1092,10,N,N,-,-1,-1
WESLEY.txt,508858,509914,1056,10,N,N,-,-1,-1
WESLEY.txt,508916,509954,1038,10,N,N,-,-1,-1
WESLEY.txt,508991,510017,1026,10,N,N,-,-1,-1
WESLEY.txt,509101,510260,1159,10,N,N,-,-1,-1
WESLEY.txt,509208,510285,1077,10,N,N,-,-1,-1
WESLEY.txt,509419,510412,993,10,N,N,-,-1,-1
WESLEY.txt,509499,510577,1078,10,N,N,-,-1,-1
WESLEY.txt,509547,510671,1124,10,N,N,-,-1,-1
WESLEY.txt,509634,510751,1117,10,N,N,-,-1,-1
WESLEY.txt,509847,510849,1002,10,N,N,-,-1,-1
WESLEY.txt,509915,510900,985,10,N,N,-,-1,-1
WESLEY.txt,509955,511023,1068,10,N,N,-,-1,-1
WESLEY.txt,510018,511110,1092,10,N,N,-,-1,-1
WESLEY.txt,510261,511122,861,10,N,N,-,-1,-1
WESLEY.txt,510285,511270,985,10,N,N,-,-1,-1
WESLEY.txt,510413,511296,883,10,N,N,-,-1,-1
WESLEY.txt,510578,511348,770,10,N,N,-,-1,-1
WESLEY.txt,510672,511399,727,10,N,N,-,-1,-1
WESLEY.txt,510752,511455,703,10,N,N,-,-1,-1
WESLEY.txt,510850,511553,703,10,N,N,-,-1,-1
WESLEY.txt,510901,511715,814,10,N,N,-,-1,-1
WESLEY.txt,511024,511808,784,10,N,N,-,-1,-1
WESLEY.txt,511111,511908,797,10,N,N,-,-1,-1
WESLEY.txt,511122,511996,874,10,N,N,-,-1,-1
WESLEY.txt,511271,512078,807,10,N,N,-,-1,-1
WESLEY.txt,511297,512165,868,10,N,N,-,-1,-1
WESLEY.txt,511349,512264,915,10,N,N,-,-1,-1
WESLEY.txt,511400,512380,980,10,N,N,-,-1,-1
WESLEY.txt,511456,512575,1119,10,N,N,-,-1,-1
WESLEY.txt,511554,512609,1055,10,N,N,-,-1,-1
WESLEY.txt,511716,512766,1050,10,N,N,-,-1,-1
WESLEY.txt,511809,512858,1049,10,N,N,-,-1,-1
WESLEY.txt,511909,512870,961,10,N,N,-,-1,-1
WESLEY.txt,511996,512890,894,10,N,N,-,-1,-1
WESLEY.txt,512079,512964,885,10,N,N,-,-1,-1
WESLEY.txt,512166,513032,866,10,N,N,-,-1,-1
WESLEY.txt,512265,513082,817,10,N,N,-,-1,-1
WESLEY.txt,512381,513173,792,10,N,N,-,-1,-1
WESLEY.txt,512576,513412,836,10,N,N,-,-1,-1
WESLEY.txt,512610,513621,1011,10,N,N,-,-1,-1
WESLEY.txt,512767,513635,868,10,N,N,-,-1,-1
WESLEY.txt,512859,513702,843,10,N,N,-,-1,-1
WESLEY.txt,512870,513757,887,10,N,N,-,-1,-1
WESLEY.txt,512891,513823,932,10,N,N,-,-1,-1
WESLEY.txt,512965,513900,935,10,N,N,-,-1,-1
WESLEY.txt,513033,513940,907,10,N,N,-,-1,-1
WESLEY.txt,513083,514056,973,10,N,N,-,-1,-1
WESLEY.txt,513174,514133,959,10,N,N,-,-1,-1
WESLEY.txt,513413,514188,775,10,N,N,-,-1,-1
WESLEY.txt,513622,514315,693,10,N,N,-,-1,-1
WESLEY.txt,513635,514523,888,10,N,N,-,-1,-1
WESLEY.txt,513703,514620,917,10,N,N,-,-1,-1
WESLEY.txt,513758,514674,916,10,N,N,-,-1,-1
WESLEY.txt,513823,514725,902,10,N,N,-,-1,-1
WESLEY.txt,513900,514902,1002,10,N,N,-,-1,-1
WESLEY.txt,513941,514975,1034,10,N,N,-,-1,-1
WESLEY.txt,514057,515195,1138,10,N,N,-,-1,-1
WESLEY.txt,514134,515202,1068,10,N,N,-,-1,-1
WESLEY.txt,514189,515284,1095,10,N,N,-,-1,-1
WESLEY.txt,514316,515307,991,10,N,N,-,-1,-1
WESLEY.txt,514524,515486,962,10,N,N,-,-1,-1
WESLEY.txt,514621,515548,927,10,N,N,-,-1,-1
WESLEY.txt,514675,515628,953,10,N,N,-,-1,-1
WESLEY.txt,514726,515724,998,10,N,N,-,-1,-1
WESLEY.txt,514903,515913,1010,10,N,N,-,-1,-1
WESLEY.txt,514976,515927,951,10,N,N,-,-1,-1
WESLEY.txt,515196,515969,773,10,N,N,-,-1,-1
WESLEY.txt,515203,516009,806,10,N,N,-,-1,-1
WESLEY.txt,515285,516164,879,10,N,N,-,-1,-1
WESLEY.txt,515307,516221,914,10,N,N,-,-1,-1
WESLEY.txt,515487,516330,843,10,N,N,-,-1,-1
WESLEY.txt,515549,516412,863,10,N,N,-,-1,-1
WESLEY.txt,515629,516431,802,10,N,N,-,-1,-1
WESLEY.txt,515725,516502,777,10,N,N,-,-1,-1
WESLEY.txt,515914,516598,684,10,N,N,-,-1,-1
WESLEY.txt,515927,516794,867,10,N,N,-,-1,-1
WESLEY.txt,515970,516854,884,10,N,N,-,-1,-1
WESLEY.txt,516010,517093,1083,10,N,N,-,-1,-1
WESLEY.txt,516165,517129,964,10,N,N,-,-1,-1
WESLEY.txt,516222,517288,1066,10,N,N,-,-1,-1
WESLEY.txt,516331,517336,1005,10,N,N,-,-1,-1
WESLEY.txt,516413,517492,1079,10,N,N,-,-1,-1
WESLEY.txt,516431,517600,1169,10,N,N,-,-1,-1
WESLEY.txt,516503,517762,1259,10,N,N,-,-1,-1
WESLEY.txt,516599,518071,1472,10,N,N,-,-1,-1
WESLEY.txt,516795,518200,1405,10,N,N,-,-1,-1
WESLEY.txt,516855,518390,1535,10,N,N,-,-1,-1
WESLEY.txt,517094,518490,1396,10,N,N,-,-1,-1
WESLEY.txt,517130,518697,1567,10,N,N,-,-1,-1
WESLEY.txt,517289,518872,1583,10,N,N,-,-1,-1
WESLEY.txt,517337,518965,1628,10,N,N,-,-1,-1
WESLEY.txt,517493,519004,1511,10,N,N,-,-1,-1
WESLEY.txt,517601,519046,1445,10,N,N,-,-1,-1
WESLEY.txt,517763,519094,1331,10,N,N,-,-1,-1
WESLEY.txt,518072,519114,1042,10,N,N,-,-1,-1
WESLEY.txt,518201,519155,954,10,N,N,-,-1,-1
WESLEY.txt,518391,519167,776,10,N,N,-,-1,-1
WESLEY.txt,518491,519312,821,10,N,N,-,-1,-1
WESLEY.txt,518698,519361,663,10,N,N,-,-1,-1
WESLEY.txt,518873,519552,679,10,N,N,-,-1,-1
WESLEY.txt,518966,519664,698,10,N,N,-,-1,-1
WESLEY.txt,519005,519670,665,10,N,N,-,-1,-1
WESLEY.txt,519047,519721,674,10,N,N,-,-1,-1
WESLEY.txt,519095,519733,638,10,N,N,-,-1,-1
WESLEY.txt,519114,519887,773,10,N,N,-,-1,-1
WESLEY.txt,519156,519934,778,10,N,N,-,-1,-1
WESLEY.txt,519168,520017,849,10,N,N,-,-1,-1
WESLEY.txt,519313,520053,740,10,N,N,-,-1,-1
WESLEY.txt,519362,520147,785,10,N,N,-,-1,-1
WESLEY.txt,519553,520228,675,10,N,N,-,-1,-1
WESLEY.txt,519665,520300,635,10,N,N,-,-1,-1
WESLEY.txt,519671,520388,717,10,N,N,-,-1,-1
WESLEY.txt,519722,520419,697,10,N,N,-,-1,-1
WESLEY.txt,519733,520550,817,10,N,N,-,-1,-1
WESLEY.txt,519888,520704,816,10,N,N,-,-1,-1
WESLEY.txt,519935,520862,927,10,N,N,-,-1,-1
WESLEY.txt,520018,520955,937,10,N,N,-,-1,-1
WESLEY.txt,520054,521051,997,10,N,N,-,-1,-1
WESLEY.txt,520148,521079,931,10,N,N,-,-1,-1
WESLEY.txt,520228,521180,952,10,N,N,-,-1,-1
WESLEY.txt,520301,521266,965,10,N,N,-,-1,-1
WESLEY.txt,520389,521334,945,10,N,N,-,-1,-1
WESLEY.txt,520420,521431,1011,10,N,N,-,-1,-1
WESLEY.txt,520551,521526,975,10,N,N,-,-1,-1
WESLEY.txt,520705,521592,887,10,N,N,-,-1,-1
WESLEY.txt,520863,521680,817,10,N,N,-,-1,-1
WESLEY.txt,520956,521766,810,10,N,N,-,-1,-1
WESLEY.txt,521052,522015,963,10,N,N,-,-1,-1
WESLEY.txt,521079,522148,1069,10,N,N,-,-1,-1
WESLEY.txt,521181,522155,974,10,N,N,-,-1,-1
WESLEY.txt,521267,522224,957,10,N,N,-,-1,-1
WESLEY.txt,521335,522437,1102,10,N,N,-,-1,-1
WESLEY.txt,521432,522531,1099,10,N,N,-,-1,-1
WESLEY.txt,521526,522622,1096,10,N,N,-,-1,-1
WESLEY.txt,521593,522727,1134,10,N,N,-,-1,-1
WESLEY.txt,521681,522821,1140,10,N,N,-,-1,-1
WESLEY.txt,521767,522833,1066,10,N,N,-,-1,-1
WESLEY.txt,522016,522914,898,10,N,N,-,-1,-1
WESLEY.txt,522149,523005,856,10,N,N,-,-1,-1
WESLEY.txt,522156,523102,946,10,N,N,-,-1,-1
WESLEY.txt,522225,523185,960,10,N,N,-,-1,-1
WESLEY.txt,522438,523203,765,10,N,N,-,-1,-1
WESLEY.txt,522532,523289,757,10,N,N,-,-1,-1
WESLEY.txt,522623,523373,750,10,N,N,-,-1,-1
WESLEY.txt,522728,523478,750,10,N,N,-,-1,-1
WESLEY.txt,522822,523525,703,10,N,N,-,-1,-1
WESLEY.txt,522833,523694,861,10,N,N,-,-1,-1
WESLEY.txt,522915,523859,944,10,N,N,-,-1,-1
WESLEY.txt,523006,523969,963,10,N,N,-,-1,-1
WESLEY.txt,523103,524033,930,10,N,N,-,-1,-1
WESLEY.txt,523186,524085,899,10,N,N,-,-1,-1
WESLEY.txt,523203,524196,993,10,N,N,-,-1,-1
WESLEY.txt,523290,524282,992,10,N,N,-,-1,-1
WESLEY.txt,523374,524392,1018,10,N,N,-,-1,-1
WESLEY.txt,523478,524449,971,10,N,N,-,-1,-1
WESLEY.txt,523526,524583,1057,10,N,N,-,-1,-1
WESLEY.txt,523695,524788,1093,10,N,N,-,-1,-1
WESLEY.txt,523860,524885,1025,10,N,N,-,-1,-1
WESLEY.txt,523970,524946,976,10,N,N,-,-1,-1
WESLEY.txt,524034,525062,1028,10,N,N,-,-1,-1
WESLEY.txt,524086,525101,1015,10,N,N,-,-1,-1
WESLEY.txt,524197,525213,1016,10,N,N,-,-1,-1
WESLEY.txt,524283,525370,1087,10,N,N,-,-1,-1
WESLEY.txt,524393,525420,1027,10,N,N,-,-1,-1
WESLEY.txt,524450,525543,1093,10,N,N,-,-1,-1
WESLEY.txt,524584,525558,974,10,N,N,-,-1,-1
WESLEY.txt,524789,525669,880,10,N,N,-,-1,-1
WESLEY.txt,524885,525826,941,10,N,N,-,-1,-1
WESLEY.txt,524947,525838,891,10,N,N,-,-1,-1
WESLEY.txt,525063,525983,920,10,N,N,-,-1,-1
WESLEY.txt,525102,526078,976,10,N,N,-,-1,-1
WESLEY.txt,525214,526108,894,10,N,N,-,-1,-1
WESLEY.txt,525371,526225,854,10,N,N,-,-1,-1
WESLEY.txt,525421,526401,980,10,N,N,-,-1,-1
WESLEY.txt,525544,526485,941,10,N,N,-,-1,-1
WESLEY.txt,525559,526583,1024,10,N,N,-,-1,-1
WESLEY.txt,525670,526646,976,10,N,N,-,-1,-1
WESLEY.txt,525827,526742,915,10,N,N,-,-1,-1
WESLEY.txt,525838,526831,993,10,N,N,-,-1,-1
WESLEY.txt,525984,526904,920,10,N,N,-,-1,-1
WESLEY.txt,526079,527017,938,10,N,N,-,-1,-1
WESLEY.txt,526109,527179,1070,10,N,N,-,-1,-1
WESLEY.txt,526226,527210,984,10,N,N,-,-1,-1
WESLEY.txt,526402,527240,838,10,N,N,-,-1,-1
WESLEY.txt,526486,527284,798,10,N,N,-,-1,-1
WESLEY.txt,526584,527296,712,10,N,N,-,-1,-1
WESLEY.txt,526646,527350,704,10,N,N,-,-1,-1
WESLEY.txt,526743,527459,716,10,N,N,-,-1,-1
WESLEY.txt,526832,527550,718,10,N,N,-,-1,-1
WESLEY.txt,526905,527651,746,10,N,N,-,-1,-1
WESLEY.txt,527018,527925,907,10,N,N,-,-1,-1
WESLEY.txt,527180,528164,984,10,N,N,-,-1,-1
WESLEY.txt,527211,528171,960,10,N,N,-,-1,-1
WESLEY.txt,527241,528184,943,10,N,N,-,-1,-1
WESLEY.txt,527285,528297,1012,10,N,N,-,-1,-1
WESLEY.txt,527296,528351,1055,10,N,N,-,-1,-1
WESLEY.txt,527351,528526,1175,10,N,N,-,-1,-1
WESLEY.txt,527460,528627,1167,10,N,N,-,-1,-1
WESLEY.txt,527551,528712,1161,10,N,N,-,-1,-1
WESLEY.txt,527652,528812,1160,10,N,N,-,-1,-1
WESLEY.txt,527926,528827,901,10,N,N,-,-1,-1
WESLEY.txt,528165,529022,857,10,N,N,-,-1,-1
WESLEY.txt,528172,529117,945,10,N,N,-,-1,-1
WESLEY.txt,528184,529347,1163,10,N,N,-,-1,-1
WESLEY.txt,528298,529361,1063,10,N,N,-,-1,-1
WESLEY.txt,528352,529440,1088,10,N,N,-,-1,-1
WESLEY.txt,528527,529536,1009,10,N,N,-,-1,-1
WESLEY.txt,528628,529681,1053,10,N,N,-,-1,-1
WESLEY.txt,528713,529747,1034,10,N,N,-,-1,-1
WESLEY.txt,528813,529833,1020,10,N,N,-,-1,-1
WESLEY.txt,528827,529968,1141,10,N,N,-,-1,-1
WESLEY.txt,529023,530075,1052,10,N,N,-,-1,-1
WESLEY.txt,529118,530109,991,10,N,N,-,-1,-1
WESLEY.txt,529348,530303,955,10,N,N,-,-1,-1
WESLEY.txt,529361,530494,1133,10,N,N,-,-1,-1
WESLEY.txt,529441,530598,1157,10,N,N,-,-1,-1
WESLEY.txt,529537,530676,1139,10,N,N,-,-1,-1
WESLEY.txt,529682,530727,1045,10,N,N,-,-1,-1
WESLEY.txt,529747,530810,1063,10,N,N,-,-1,-1
WESLEY.txt,529834,530906,1072,10,N,N,-,-1,-1
WESLEY.txt,529969,530941,972,10,N,N,-,-1,-1
WESLEY.txt,530076,531072,996,10,N,N,-,-1,-1
WESLEY.txt,530110,531147,1037,10,N,N,-,-1,-1
WESLEY.txt,530304,531232,928,10,N,N,-,-1,-1
WESLEY.txt,530495,531337,842,10,N,N,-,-1,-1
WESLEY.txt,530599,531398,799,10,N,N,-,-1,-1
WESLEY.txt,530677,531451,774,10,N,N,-,-1,-1
WESLEY.txt,530728,531651,923,10,N,N,-,-1,-1
WESLEY.txt,530811,531662,851,10,N,N,-,-1,-1
WESLEY.txt,530907,531821,914,10,N,N,-,-1,-1
WESLEY.txt,530942,531891,949,10,N,N,-,-1,-1
WESLEY.txt,531073,531989,916,10,N,N,-,-1,-1
WESLEY.txt,531148,532001,853,10,N,N,-,-1,-1
WESLEY.txt,531233,532112,879,10,N,N,-,-1,-1
WESLEY.txt,531338,532309,971,10,N,N,-,-1,-1
WESLEY.txt,531399,532354,955,10,N,N,-,-1,-1
WESLEY.txt,531452,532414,962,10,N,N,-,-1,-1
WESLEY.txt,531652,532512,860,10,N,N,-,-1,-1
WESLEY.txt,531662,532600,938,10,N,N,-,-1,-1
WESLEY.txt,531822,532679,857,10,N,N,-,-1,-1
WESLEY.txt,531892,532884,992,10,N,N,-,-1,-1
WESLEY.txt,531990,532896,906,10,N,N,-,-1,-1
WESLEY.txt,532001,533252,1251,10,N,N,-,-1,-1
WESLEY.txt,532113,533294,1181,10,N,N,-,-1,-1
WESLEY.txt,532310,533443,1133,10,N,N,-,-1,-1
WESLEY.txt,532355,533511,1156,10,N,N,-,-1,-1
WESLEY.txt,532415,533647,1232,10,N,N,-,-1,-1
WESLEY.txt,532512,533733,1221,10,N,N,-,-1,-1
WESLEY.txt,532601,533896,1295,10,N,N,-,-1,-1
WESLEY.txt,532680,534133,1453,10,N,N,-,-1,-1
WESLEY.txt,532885,534186,1301,10,N,N,-,-1,-1
WESLEY.txt,532896,534234,1338,10,N,N,-,-1,-1
WESLEY.txt,533253,534433,1180,10,N,N,-,-1,-1
WESLEY.txt,533295,534538,1243,10,N,N,-,-1,-1
WESLEY.txt,533444,534664,1220,10,N,N,-,-1,-1
WESLEY.txt,533512,534735,1223,10,N,N,-,-1,-1
WESLEY.txt,533648,534752,1104,10,N,N,-,-1,-1
WESLEY.txt,533734,534851,1117,10,N,N,-,-1,-1
WESLEY.txt,533897,534895,998,10,N,N,-,-1,-1
WESLEY.txt,534134,534977,843,10,N,N,-,-1,-1
WESLEY.txt,534187,535160,973,10,N,N,-,-1,-1
WESLEY.txt,534235,535244,1009,10,N,N,-,-1,-1
WESLEY.txt,534434,535323,889,10,N,N,-,-1,-1
WESLEY.txt,534539,535459,920,10,N,N,-,-1,-1
WESLEY.txt,534665,535592,927,10,N,N,-,-1,-1
WESLEY.txt,534736,535688,952,10,N,N,-,-1,-1
WESLEY.txt,534752,535773,1021,10,N,N,-,-1,-1
WESLEY.txt,534852,535838,986,10,N,N,-,-1,-1
WESLEY.txt,534896,535894,998,10,N,N,-,-1,-1
WESLEY.txt,534978,535915,937,10,N,N,-,-1,-1
WESLEY.txt,535161,535946,785,10,N,N,-,-1,-1
WESLEY.txt,535245,536030,785,10,N,N,-,-1,-1
WESLEY.txt,535324,536068,744,10,N,N,-,-1,-1
WESLEY.txt,535460,536276,816,10,N,N,-,-1,-1
WESLEY.txt,535593,536299,706,10,N,N,-,-1,-1
WESLEY.txt,535689,536361,672,10,N,N,-,-1,-1
WESLEY.txt,535774,536441,667,10,N,N,-,-1,-1
WESLEY.txt,535839,536523,684,10,N,N,-,-1,-1
WESLEY.txt,535895,536626,731,10,N,N,-,-1,-1
WESLEY.txt,535915,536687,772,10,N,N,-,-1,-1
WESLEY.txt,535947,536862,915,10,N,N,-,-1,-1
WESLEY.txt,536031,536940,909,10,N,Y,1437472966198,394609,395892
WESLEY.txt,536069,536961,892,10,N,Y,1437472966198,394609,395892
WESLEY.txt,536277,536991,714,10,N,Y,1437472966198,394609,395892
WESLEY.txt,536299,537109,810,10,N,Y,1437472966198,394609,395892
WESLEY.txt,536362,537191,829,10,N,Y,1437472966198,394609,395892
WESLEY.txt,536442,537208,766,10,N,Y,1437472966198,394609,395892
WESLEY.txt,536524,537305,781,10,N,Y,1437472966198,394609,395892
WESLEY.txt,536627,537395,768,10,N,Y,1437472966198,394609,395892
WESLEY.txt,536688,537406,718,10,N,Y,1437472966198,394609,395892
WESLEY.txt,536863,537493,630,10,N,Y,1437472966198,394609,395892
WESLEY.txt,536941,537666,725,10,N,Y,1437472966198,394609,395892
WESLEY.txt,536961,537685,724,10,N,Y,1437472966198,394609,395892
WESLEY.txt,536992,537768,776,10,N,Y,1437472966198,394609,395892
WESLEY.txt,537110,537821,711,10,N,Y,1437472966198,394609,395892
WESLEY.txt,537192,537920,728,10,N,Y,1437472966198,394609,395892
WESLEY.txt,537209,537938,729,10,N,Y,1437472966198,394609,395892
WESLEY.txt,537306,537992,686,10,N,Y,1437472966198,394609,395892
WESLEY.txt,537396,538192,796,10,N,Y,1437472966198,394609,395892
WESLEY.txt,537407,538300,893,10,N,Y,1437472966198,394609,395892
WESLEY.txt,537494,538389,895,10,N,Y,1437472966198,394609,395892
WESLEY.txt,537667,538540,873,10,N,N,-,-1,-1
WESLEY.txt,537685,538614,929,10,N,N,-,-1,-1
WESLEY.txt,537769,538674,905,10,N,N,-,-1,-1
WESLEY.txt,537822,538883,1061,10,N,N,-,-1,-1
WESLEY.txt,537921,538960,1039,10,N,N,-,-1,-1
WESLEY.txt,537938,539003,1065,10,N,N,-,-1,-1
WESLEY.txt,537993,539122,1129,10,N,N,-,-1,-1
WESLEY.txt,538193,539207,1014,10,N,N,-,-1,-1
WESLEY.txt,538301,539417,1116,10,N,N,-,-1,-1
WESLEY.txt,538390,539551,1161,10,N,N,-,-1,-1
WESLEY.txt,538541,539726,1185,10,N,N,-,-1,-1
WESLEY.txt,538615,539815,1200,10,N,N,-,-1,-1
WESLEY.txt,538675,539885,1210,10,N,N,-,-1,-1
WESLEY.txt,538884,539968,1084,10,N,N,-,-1,-1
WESLEY.txt,538961,540154,1193,10,N,N,-,-1,-1
WESLEY.txt,539004,540336,1332,10,N,N,-,-1,-1
WESLEY.txt,539123,540513,1390,10,N,N,-,-1,-1
WESLEY.txt,539207,540671,1464,10,N,N,-,-1,-1
WESLEY.txt,539418,540698,1280,10,N,N,-,-1,-1
WESLEY.txt,539552,540715,1163,10,N,N,-,-1,-1
WESLEY.txt,539727,540788,1061,10,N,N,-,-1,-1
WESLEY.txt,539816,540889,1073,10,N,N,-,-1,-1
WESLEY.txt,539886,540940,1054,10,N,N,-,-1,-1
WESLEY.txt,539969,541069,1100,10,N,N,-,-1,-1
WESLEY.txt,540155,541142,987,10,N,N,-,-1,-1
WESLEY.txt,540337,541372,1035,10,N,N,-,-1,-1
WESLEY.txt,540514,541418,904,10,N,N,-,-1,-1
WESLEY.txt,540672,541520,848,10,N,N,-,-1,-1
WESLEY.txt,540699,541639,940,10,N,N,-,-1,-1
WESLEY.txt,540715,541771,1056,10,N,N,-,-1,-1
WESLEY.txt,540789,541857,1068,10,N,N,-,-1,-1
WESLEY.txt,540890,541924,1034,10,N,N,-,-1,-1
WESLEY.txt,540941,542024,1083,10,N,N,-,-1,-1
WESLEY.txt,541070,542106,1036,10,N,N,-,-1,-1
WESLEY.txt,541143,542264,1121,10,N,N,-,-1,-1
WESLEY.txt,541373,542413,1040,10,N,N,-,-1,-1
WESLEY.txt,541419,542654,1235,10,N,N,-,-1,-1
WESLEY.txt,541521,543002,1481,10,N,N,-,-1,-1
WESLEY.txt,541640,543017,1377,10,N,N,-,-1,-1
WESLEY.txt,541772,543053,1281,10,N,N,-,-1,-1
WESLEY.txt,541858,543241,1383,10,N,N,-,-1,-1
WESLEY.txt,541925,543340,1415,10,N,N,-,-1,-1
WESLEY.txt,542024,543406,1382,10,N,N,-,-1,-1
WESLEY.txt,542107,543625,1518,10,N,N,-,-1,-1
WESLEY.txt,542265,543723,1458,10,N,N,-,-1,-1
WESLEY.txt,542414,543813,1399,10,N,N,-,-1,-1
WESLEY.txt,542655,543904,1249,10,N,N,-,-1,-1
WESLEY.txt,543003,543983,980,10,N,N,-,-1,-1
WESLEY.txt,543017,544045,1028,10,N,N,-,-1,-1
WESLEY.txt,543054,544213,1159,10,N,N,-,-1,-1
WESLEY.txt,543242,544325,1083,10,N,N,-,-1,-1
WESLEY.txt,543341,544453,1112,10,N,N,-,-1,-1
WESLEY.txt,543407,544486,1079,10,N,N,-,-1,-1
WESLEY.txt,543626,544658,1032,10,N,N,-,-1,-1
WESLEY.txt,543724,544846,1122,10,N,N,-,-1,-1
WESLEY.txt,543814,544858,1044,10,N,N,-,-1,-1
WESLEY.txt,543905,545049,1144,10,N,N,-,-1,-1
WESLEY.txt,543984,545232,1248,10,N,N,-,-1,-1
WESLEY.txt,544046,545402,1356,10,N,N,-,-1,-1
WESLEY.txt,544214,545500,1286,10,N,N,-,-1,-1
WESLEY.txt,544325,545623,1298,10,N,N,-,-1,-1
WESLEY.txt,544454,545672,1218,10,N,N,-,-1,-1
WESLEY.txt,544487,545719,1232,10,N,N,-,-1,-1
WESLEY.txt,544659,545814,1155,10,N,N,-,-1,-1
WESLEY.txt,544847,545890,1043,10,N,N,-,-1,-1
WESLEY.txt,544858,546027,1169,10,N,N,-,-1,-1
WESLEY.txt,545050,546096,1046,10,N,N,-,-1,-1
WESLEY.txt,545233,546177,944,10,N,N,-,-1,-1
WESLEY.txt,545403,546266,863,10,N,N,-,-1,-1
WESLEY.txt,545500,546346,846,10,N,N,-,-1,-1
WESLEY.txt,545624,546363,739,10,N,N,-,-1,-1
WESLEY.txt,545673,546380,707,10,N,N,-,-1,-1
WESLEY.txt,545720,546437,717,10,N,N,-,-1,-1
WESLEY.txt,545815,546613,798,10,N,N,-,-1,-1
WESLEY.txt,545891,546702,811,10,N,N,-,-1,-1
WESLEY.txt,546028,546865,837,10,N,N,-,-1,-1
WESLEY.txt,546097,547030,933,10,N,N,-,-1,-1
WESLEY.txt,546178,547141,963,10,N,N,-,-1,-1
WESLEY.txt,546267,547227,960,10,N,N,-,-1,-1
WESLEY.txt,546347,547310,963,10,N,N,-,-1,-1
WESLEY.txt,546363,547393,1030,10,N,N,-,-1,-1
WESLEY.txt,546381,547572,1191,10,N,N,-,-1,-1
WESLEY.txt,546438,547750,1312,10,N,N,-,-1,-1
WESLEY.txt,546614,547809,1195,10,N,N,-,-1,-1
WESLEY.txt,546703,547955,1252,10,N,N,-,-1,-1
WESLEY.txt,546866,548043,1177,10,N,N,-,-1,-1
WESLEY.txt,547031,548118,1087,10,N,N,-,-1,-1
WESLEY.txt,547142,548190,1048,10,N,N,-,-1,-1
WESLEY.txt,547228,548282,1054,10,N,N,-,-1,-1
WESLEY.txt,547311,548442,1131,10,N,N,-,-1,-1
WESLEY.txt,547394,548563,1169,10,N,N,-,-1,-1
WESLEY.txt,547573,548575,1002,10,N,N,-,-1,-1
WESLEY.txt,547751,548652,901,10,N,N,-,-1,-1
WESLEY.txt,547810,548741,931,10,N,N,-,-1,-1
WESLEY.txt,547956,548828,872,10,N,N,-,-1,-1
WESLEY.txt,548044,548840,796,10,N,N,-,-1,-1
WESLEY.txt,548119,548900,781,10,N,N,-,-1,-1
WESLEY.txt,548191,548969,778,10,N,N,-,-1,-1
WESLEY.txt,548282,549051,769,10,N,N,-,-1,-1
WESLEY.txt,548443,549125,682,10,N,N,-,-1,-1
WESLEY.txt,548564,549224,660,10,N,N,-,-1,-1
WESLEY.txt,548576,549306,730,10,N,N,-,-1,-1
WESLEY.txt,548653,549478,825,10,N,N,-,-1,-1
WESLEY.txt,548742,549636,894,10,N,N,-,-1,-1
WESLEY.txt,548829,549648,819,10,N,N,-,-1,-1
WESLEY.txt,548840,549738,898,10,N,N,-,-1,-1
WESLEY.txt,548901,549815,914,10,N,N,-,-1,-1
WESLEY.txt,548970,549909,939,10,N,N,-,-1,-1
WESLEY.txt,549052,550007,955,10,N,N,-,-1,-1
WESLEY.txt,549126,550066,940,10,N,N,-,-1,-1
WESLEY.txt,549225,550070,845,10,N,N,-,-1,-1
WESLEY.txt,549307,550094,787,10,N,N,-,-1,-1
WESLEY.txt,549479,550407,928,10,N,N,-,-1,-1
WESLEY.txt,549637,550507,870,10,N,N,-,-1,-1
WESLEY.txt,549648,550616,968,10,N,N,-,-1,-1
WESLEY.txt,549739,550712,973,10,N,N,-,-1,-1
WESLEY.txt,549816,550761,945,10,N,N,-,-1,-1
WESLEY.txt,549910,550801,891,10,N,N,-,-1,-1
WESLEY.txt,550008,550813,805,10,N,N,-,-1,-1
WESLEY.txt,550067,550891,824,10,N,N,-,-1,-1
WESLEY.txt,550071,551004,933,10,N,N,-,-1,-1
WESLEY.txt,550095,551176,1081,10,N,N,-,-1,-1
WESLEY.txt,550408,551267,859,10,N,N,-,-1,-1
WESLEY.txt,550507,551528,1021,10,N,N,-,-1,-1
WESLEY.txt,550617,551726,1109,10,N,N,-,-1,-1
WESLEY.txt,550713,551749,1036,10,N,N,-,-1,-1
WESLEY.txt,550762,551800,1038,10,N,N,-,-1,-1
WESLEY.txt,550802,551936,1134,10,N,N,-,-1,-1
WESLEY.txt,550813,551955,1142,10,N,N,-,-1,-1
WESLEY.txt,550892,552032,1140,10,N,N,-,-1,-1
WESLEY.txt,551005,552043,1038,10,N,N,-,-1,-1
WESLEY.txt,551177,552186,1009,10,N,N,-,-1,-1
WESLEY.txt,551268,552280,1012,10,N,N,-,-1,-1
WESLEY.txt,551529,552317,788,10,N,N,-,-1,-1
WESLEY.txt,551727,552410,683,10,N,N,-,-1,-1
WESLEY.txt,551749,552493,744,10,N,N,-,-1,-1
WESLEY.txt,551801,552575,774,10,N,N,-,-1,-1
WESLEY.txt,551937,552843,906,10,N,N,-,-1,-1
WESLEY.txt,551956,552858,902,10,N,N,-,-1,-1
WESLEY.txt,552033,553059,1026,10,N,N,-,-1,-1
WESLEY.txt,552043,553131,1088,10,N,N,-,-1,-1
WESLEY.txt,552187,553233,1046,10,N,N,-,-1,-1
WESLEY.txt,552281,553354,1073,10,N,N,-,-1,-1
WESLEY.txt,552318,553447,1129,10,N,N,-,-1,-1
WESLEY.txt,552411,553538,1127,10,N,N,-,-1,-1
WESLEY.txt,552494,553600,1106,10,N,N,-,-1,-1
WESLEY.txt,552576,553669,1093,10,N,N,-,-1,-1
WESLEY.txt,552844,553771,927,10,N,N,-,-1,-1
WESLEY.txt,552858,553785,927,10,N,N,-,-1,-1
WESLEY.txt,553060,553972,912,10,N,N,-,-1,-1
WESLEY.txt,553132,554077,945,10,N,N,-,-1,-1
WESLEY.txt,553234,554179,945,10,N,N,-,-1,-1
WESLEY.txt,553355,554254,899,10,N,N,-,-1,-1
WESLEY.txt,553448,554509,1061,10,N,N,-,-1,-1
WESLEY.txt,553539,554573,1034,10,N,N,-,-1,-1
WESLEY.txt,553600,554853,1253,10,N,N,-,-1,-1
WESLEY.txt,553670,554943,1273,10,N,N,-,-1,-1
WESLEY.txt,553772,555016,1244,10,N,N,-,-1,-1
WESLEY.txt,553785,555340,1555,10,N,N,-,-1,-1
WESLEY.txt,553973,555353,1380,10,N,N,-,-1,-1
WESLEY.txt,554078,555363,1285,10,N,N,-,-1,-1
WESLEY.txt,554180,555431,1251,10,N,N,-,-1,-1
WESLEY.txt,554255,555542,1287,10,N,N,-,-1,-1
WESLEY.txt,554510,555657,1147,10,N,N,-,-1,-1
WESLEY.txt,554574,555760,1186,10,N,N,-,-1,-1
WESLEY.txt,554854,555776,922,10,N,N,-,-1,-1
WESLEY.txt,554944,555943,999,10,N,N,-,-1,-1
WESLEY.txt,555017,556011,994,10,N,N,-,-1,-1
WESLEY.txt,555341,556094,753,10,N,N,-,-1,-1
WESLEY.txt,555354,556195,841,10,N,N,-,-1,-1
WESLEY.txt,555364,556207,843,10,N,N,-,-1,-1
WESLEY.txt,555432,556266,834,10,N,N,-,-1,-1
WESLEY.txt,555543,556281,738,10,N,N,-,-1,-1
WESLEY.txt,555658,556324,666,10,N,N,-,-1,-1
WESLEY.txt,555761,556365,604,10,N,N,-,-1,-1
WESLEY.txt,555776,556566,790,10,N,N,-,-1,-1
WESLEY.txt,555944,556668,724,10,N,N,-,-1,-1
WESLEY.txt,556012,556757,745,10,N,N,-,-1,-1
WESLEY.txt,556095,556836,741,10,N,N,-,-1,-1
WESLEY.txt,556196,556924,728,10,N,N,-,-1,-1
WESLEY.txt,556207,557089,882,10,N,N,-,-1,-1
WESLEY.txt,556267,557254,987,10,N,N,-,-1,-1
WESLEY.txt,556281,557261,980,10,N,N,-,-1,-1
WESLEY.txt,556325,557347,1022,10,N,N,-,-1,-1
WESLEY.txt,556366,557416,1050,10,N,N,-,-1,-1
WESLEY.txt,556567,557587,1020,10,N,N,-,-1,-1
WESLEY.txt,556669,557702,1033,10,N,N,-,-1,-1
WESLEY.txt,556758,557734,976,10,N,N,-,-1,-1
WESLEY.txt,556837,557767,930,10,N,N,-,-1,-1
WESLEY.txt,556925,557794,869,10,N,N,-,-1,-1
WESLEY.txt,557090,557838,748,10,N,N,-,-1,-1
WESLEY.txt,557255,557912,657,10,N,N,-,-1,-1
WESLEY.txt,557262,558060,798,10,N,N,-,-1,-1
WESLEY.txt,557348,558134,786,10,N,N,-,-1,-1
WESLEY.txt,557417,558252,835,10,N,N,-,-1,-1
WESLEY.txt,557588,558361,773,10,N,N,-,-1,-1
WESLEY.txt,557702,558598,896,10,N,N,-,-1,-1
WESLEY.txt,557735,558715,980,10,N,N,-,-1,-1
WESLEY.txt,557768,558727,959,10,N,N,-,-1,-1
WESLEY.txt,557795,558784,989,10,N,N,-,-1,-1
WESLEY.txt,557839,558992,1153,10,N,N,-,-1,-1
WESLEY.txt,557913,559037,1124,10,N,N,-,-1,-1
WESLEY.txt,558061,559097,1036,10,N,N,-,-1,-1
WESLEY.txt,558135,559161,1026,10,N,N,-,-1,-1
WESLEY.txt,558253,559178,925,10,N,N,-,-1,-1
WESLEY.txt,558362,559268,906,10,N,N,-,-1,-1
WESLEY.txt,558599,559353,754,10,N,N,-,-1,-1
WESLEY.txt,558716,559472,756,10,N,N,-,-1,-1
WESLEY.txt,558727,559615,888,10,N,N,-,-1,-1
WESLEY.txt,558785,559728,943,10,N,N,-,-1,-1
WESLEY.txt,558993,559881,888,10,N,N,-,-1,-1
WESLEY.txt,559038,559931,893,10,N,N,-,-1,-1
WESLEY.txt,559098,560050,952,10,N,Y,1436867017136,105674,106651
WESLEY.txt,559162,560136,974,10,N,Y,1436867017136,105674,106651
WESLEY.txt,559178,560366,1188,10,N,Y,1436867017136,105674,106651
WESLEY.txt,559269,560438,1169,10,N,Y,1436867017136,105674,106651
WESLEY.txt,559354,560510,1156,10,N,Y,1436867017136,105674,106651
WESLEY.txt,559473,560702,1229,10,N,Y,1436867017136,105674,106651
WESLEY.txt,559616,560754,1138,10,N,Y,1436867017136,105674,106651
WESLEY.txt,559729,560760,1031,10,N,Y,1436867017136,105674,106651
WESLEY.txt,559882,560799,917,10,N,Y,1436867017136,105674,106651
WESLEY.txt,559932,560846,914,10,N,Y,1436867017136,105674,106651
WESLEY.txt,560050,560873,823,10,N,Y,1436867017136,105674,106651
WESLEY.txt,560137,560983,846,10,N,Y,1436867017136,105674,106651
WESLEY.txt,560367,561182,815,10,N,Y,1436867017136,105674,106651
WESLEY.txt,560439,561237,798,10,N,Y,1436867017136,105674,106651
WESLEY.txt,560511,561500,989,10,N,Y,1436867017136,105674,106651
WESLEY.txt,560703,561588,885,10,N,Y,1436867017136,105674,106651
WESLEY.txt,560755,561679,924,10,N,Y,1436867017136,105674,106651
WESLEY.txt,560761,561725,964,10,N,Y,1436867017136,105674,106651
WESLEY.txt,560800,561832,1032,10,N,Y,1436867017136,105674,106651
WESLEY.txt,560847,561914,1067,10,N,Y,1436867017136,105674,106651
WESLEY.txt,560874,561950,1076,10,N,Y,1436867017136,105674,106651
WESLEY.txt,560984,562108,1124,10,N,Y,1436867017136,105674,106651
WESLEY.txt,561183,562188,1005,10,N,Y,1436867017136,105674,106651
WESLEY.txt,561238,562265,1027,10,N,Y,1436867017136,105674,106651
WESLEY.txt,561501,562277,776,10,N,Y,1436867017136,105674,106651
WESLEY.txt,561589,562313,724,10,N,Y,1436867017136,105674,106651
WESLEY.txt,561680,562425,745,10,N,Y,1436867017136,105674,106651
WESLEY.txt,561726,562487,761,10,N,Y,1436867017136,105674,106651
WESLEY.txt,561833,562649,816,10,N,Y,1436867017136,105674,106651
WESLEY.txt,561915,562807,892,10,N,Y,1436867017136,105674,106651
WESLEY.txt,561951,562904,953,10,N,Y,1436867017136,105674,106651
WESLEY.txt,562109,562991,882,10,N,Y,1436867017136,105674,106651
WESLEY.txt,562189,563319,1130,10,N,N,-,-1,-1
WESLEY.txt,562266,563498,1232,10,N,N,-,-1,-1
WESLEY.txt,562277,563593,1316,10,N,N,-,-1,-1
WESLEY.txt,562314,563692,1378,10,N,N,-,-1,-1
WESLEY.txt,562426,563806,1380,10,N,N,-,-1,-1
WESLEY.txt,562488,563897,1409,10,N,N,-,-1,-1
WESLEY.txt,562650,564113,1463,10,N,N,-,-1,-1
WESLEY.txt,562808,564353,1545,10,N,N,-,-1,-1
WESLEY.txt,562904,564365,1461,10,N,N,-,-1,-1
WESLEY.txt,562992,564484,1492,10,N,N,-,-1,-1
WESLEY.txt,563320,564557,1237,10,N,N,-,-1,-1
WESLEY.txt,563499,564731,1232,10,N,N,-,-1,-1
WESLEY.txt,563594,564896,1302,10,N,N,-,-1,-1
WESLEY.txt,563693,565021,1328,10,N,N,-,-1,-1
WESLEY.txt,563807,565133,1326,10,N,N,-,-1,-1
WESLEY.txt,563898,565315,1417,10,N,N,-,-1,-1
WESLEY.txt,564114,565486,1372,10,N,N,-,-1,-1
WESLEY.txt,564354,565584,1230,10,N,N,-,-1,-1
WESLEY.txt,564365,565676,1311,10,N,N,-,-1,-1
WESLEY.txt,564485,565716,1231,10,N,N,-,-1,-1
WESLEY.txt,564558,565825,1267,10,N,N,-,-1,-1
WESLEY.txt,564732,565882,1150,10,N,N,-,-1,-1
WESLEY.txt,564897,565941,1044,10,N,N,-,-1,-1
WESLEY.txt,565022,565953,931,10,N,N,-,-1,-1
WESLEY.txt,565134,566028,894,10,N,N,-,-1,-1
WESLEY.txt,565316,566136,820,10,N,N,-,-1,-1
WESLEY.txt,565487,566249,762,10,N,N,-,-1,-1
WESLEY.txt,565585,566353,768,10,N,N,-,-1,-1
WESLEY.txt,565676,566533,857,10,N,N,-,-1,-1
WESLEY.txt,565717,566631,914,10,N,N,-,-1,-1
WESLEY.txt,565826,566643,817,10,N,N,-,-1,-1
WESLEY.txt,565883,566664,781,10,N,N,-,-1,-1
WESLEY.txt,565942,566765,823,10,N,N,-,-1,-1
WESLEY.txt,565953,566983,1030,10,N,N,-,-1,-1
WESLEY.txt,566029,566994,965,10,N,N,-,-1,-1
WESLEY.txt,566137,567169,1032,10,N,N,-,-1,-1
WESLEY.txt,566250,567262,1012,10,N,N,-,-1,-1
WESLEY.txt,566354,567283,929,10,N,N,-,-1,-1
WESLEY.txt,566534,567405,871,10,N,N,-,-1,-1
WESLEY.txt,566632,567487,855,10,N,N,-,-1,-1
WESLEY.txt,566643,567510,867,10,N,N,-,-1,-1
WESLEY.txt,566665,567719,1054,10,N,N,-,-1,-1
WESLEY.txt,566766,567762,996,10,N,N,-,-1,-1
WESLEY.txt,566984,567782,798,10,N,N,-,-1,-1
WESLEY.txt,566994,567894,900,10,N,N,-,-1,-1
WESLEY.txt,567170,567964,794,10,N,N,-,-1,-1
WESLEY.txt,567263,568074,811,10,N,N,-,-1,-1
WESLEY.txt,567283,568144,861,10,N,N,-,-1,-1
WESLEY.txt,567406,568302,896,10,N,N,-,-1,-1
WESLEY.txt,567488,568326,838,10,N,N,-,-1,-1
WESLEY.txt,567510,568455,945,10,N,N,-,-1,-1
WESLEY.txt,567720,568495,775,10,N,N,-,-1,-1
WESLEY.txt,567763,568545,782,10,N,N,-,-1,-1
WESLEY.txt,567782,568593,811,10,N,N,-,-1,-1
WESLEY.txt,567895,568692,797,10,N,N,-,-1,-1
WESLEY.txt,567965,568782,817,10,N,N,-,-1,-1
WESLEY.txt,568075,568965,890,10,N,N,-,-1,-1
WESLEY.txt,568145,569046,901,10,N,N,-,-1,-1
WESLEY.txt,568303,569066,763,10,N,N,-,-1,-1
WESLEY.txt,568327,569103,776,10,N,N,-,-1,-1
WESLEY.txt,568456,569117,661,10,N,N,-,-1,-1
WESLEY.txt,568496,569190,694,10,N,N,-,-1,-1
WESLEY.txt,568546,569232,686,10,N,N,-,-1,-1
WESLEY.txt,568594,569373,779,10,N,N,-,-1,-1
WESLEY.txt,568693,569451,758,10,N,N,-,-1,-1
WESLEY.txt,568783,569463,680,10,N,N,-,-1,-1
WESLEY.txt,568966,569486,520,10,N,N,-,-1,-1
WESLEY.txt,569047,569501,454,10,N,N,-,-1,-1
WESLEY.txt,569066,569553,487,10,N,N,-,-1,-1
WESLEY.txt,569104,569694,590,10,N,N,-,-1,-1
WESLEY.txt,569117,569822,705,10,N,N,-,-1,-1
WESLEY.txt,569191,569914,723,10,N,N,-,-1,-1
WESLEY.txt,569233,570006,773,10,N,N,-,-1,-1
WESLEY.txt,569374,570113,739,10,N,N,-,-1,-1
WESLEY.txt,569452,570206,754,10,N,N,-,-1,-1
WESLEY.txt,569463,570294,831,10,N,N,-,-1,-1
WESLEY.txt,569487,570385,898,10,N,N,-,-1,-1
WESLEY.txt,569502,570467,965,10,N,N,-,-1,-1
WESLEY.txt,569554,570664,1110,10,N,N,-,-1,-1
WESLEY.txt,569695,570676,981,10,N,N,-,-1,-1
WESLEY.txt,569823,570748,925,10,N,N,-,-1,-1
WESLEY.txt,569915,570823,908,10,N,N,-,-1,-1
WESLEY.txt,570007,570860,853,10,N,N,-,-1,-1
WESLEY.txt,570113,570872,759,10,N,N,-,-1,-1
WESLEY.txt,570207,570908,701,10,N,N,-,-1,-1
WESLEY.txt,570295,570993,698,10,N,N,-,-1,-1
WESLEY.txt,570386,571034,648,10,N,N,-,-1,-1
WESLEY.txt,570468,571086,618,10,N,N,-,-1,-1
WESLEY.txt,570665,571371,706,10,N,N,-,-1,-1
WESLEY.txt,570676,571476,800,10,N,N,-,-1,-1
WESLEY.txt,570749,571520,771,10,N,N,-,-1,-1
WESLEY.txt,570824,571668,844,10,N,N,-,-1,-1
WESLEY.txt,570861,571706,845,10,N,N,-,-1,-1
WESLEY.txt,570872,571729,857,10,N,N,-,-1,-1
WESLEY.txt,570909,571790,881,10,N,N,-,-1,-1
WESLEY.txt,570994,571803,809,10,N,N,-,-1,-1
WESLEY.txt,571035,571822,787,10,N,N,-,-1,-1
WESLEY.txt,571087,571998,911,10,N,N,-,-1,-1
WESLEY.txt,571372,572180,808,10,N,N,-,-1,-1
WESLEY.txt,571477,572272,795,10,N,N,-,-1,-1
WESLEY.txt,571521,572365,844,10,N,N,-,-1,-1
WESLEY.txt,571669,572422,753,10,N,N,-,-1,-1
WESLEY.txt,571707,572524,817,10,N,N,-,-1,-1
WESLEY.txt,571730,572693,963,10,N,N,-,-1,-1
WESLEY.txt,571791,572719,928,10,N,N,-,-1,-1
WESLEY.txt,571803,572779,976,10,N,N,-,-1,-1
WESLEY.txt,571823,572831,1008,10,N,N,-,-1,-1
WESLEY.txt,571999,572975,976,10,N,N,-,-1,-1
WESLEY.txt,572181,573086,905,10,N,N,-,-1,-1
WESLEY.txt,572273,573185,912,10,N,N,-,-1,-1
WESLEY.txt,572366,573363,997,10,N,N,-,-1,-1
WESLEY.txt,572423,573450,1027,10,N,N,-,-1,-1
WESLEY.txt,572525,573622,1097,10,N,N,-,-1,-1
WESLEY.txt,572694,573786,1092,10,N,N,-,-1,-1
WESLEY.txt,572719,573971,1252,10,N,N,-,-1,-1
WESLEY.txt,572780,573988,1208,10,N,N,-,-1,-1
WESLEY.txt,572832,574010,1178,10,N,N,-,-1,-1
WESLEY.txt,572976,574201,1225,10,N,N,-,-1,-1
WESLEY.txt,573087,574306,1219,10,N,N,-,-1,-1
WESLEY.txt,573186,574512,1326,10,N,N,-,-1,-1
WESLEY.txt,573364,574525,1161,10,N,N,-,-1,-1
WESLEY.txt,573451,574561,1110,10,N,N,-,-1,-1
WESLEY.txt,573623,574743,1120,10,N,N,-,-1,-1
WESLEY.txt,573787,574909,1122,10,N,N,-,-1,-1
WESLEY.txt,573972,574999,1027,10,N,N,-,-1,-1
WESLEY.txt,573988,575010,1022,10,N,N,-,-1,-1
WESLEY.txt,574011,575129,1118,10,N,N,-,-1,-1
WESLEY.txt,574202,575299,1097,10,N,N,-,-1,-1
WESLEY.txt,574307,575378,1071,10,N,N,-,-1,-1
WESLEY.txt,574513,575501,988,10,N,N,-,-1,-1
WESLEY.txt,574525,575560,1035,10,N,N,-,-1,-1
WESLEY.txt,574562,575723,1161,10,N,N,-,-1,-1
WESLEY.txt,574744,575801,1057,10,N,N,-,-1,-1
WESLEY.txt,574910,575814,904,10,N,N,-,-1,-1
WESLEY.txt,575000,575900,900,10,N,N,-,-1,-1
WESLEY.txt,575010,575974,964,10,N,N,-,-1,-1
WESLEY.txt,575130,576027,897,10,N,N,-,-1,-1
WESLEY.txt,575300,576154,854,10,N,N,-,-1,-1
WESLEY.txt,575378,576332,954,10,N,N,-,-1,-1
WESLEY.txt,575502,576344,842,10,N,N,-,-1,-1
WESLEY.txt,575561,576395,834,10,N,N,-,-1,-1
WESLEY.txt,575724,576435,711,10,N,N,-,-1,-1
WESLEY.txt,575802,576542,740,10,N,N,-,-1,-1
WESLEY.txt,575814,576634,820,10,N,N,-,-1,-1
WESLEY.txt,575901,576731,830,10,N,N,-,-1,-1
WESLEY.txt,575975,576805,830,10,N,N,-,-1,-1
WESLEY.txt,576028,576892,864,10,N,N,-,-1,-1
WESLEY.txt,576155,576984,829,10,N,N,-,-1,-1
WESLEY.txt,576333,577069,736,10,N,N,-,-1,-1
WESLEY.txt,576344,577084,740,10,N,N,-,-1,-1
WESLEY.txt,576396,577227,831,10,N,N,-,-1,-1
WESLEY.txt,576436,577310,874,10,N,N,-,-1,-1
WESLEY.txt,576543,577402,859,10,N,N,-,-1,-1
WESLEY.txt,576635,577580,945,10,N,N,-,-1,-1
WESLEY.txt,576732,577756,1024,10,N,N,-,-1,-1
WESLEY.txt,576805,577924,1119,10,N,N,-,-1,-1
WESLEY.txt,576893,578014,1121,10,N,N,-,-1,-1
WESLEY.txt,576985,578091,1106,10,N,N,-,-1,-1
WESLEY.txt,577070,578155,1085,10,N,N,-,-1,-1
WESLEY.txt,577084,578219,1135,10,N,N,-,-1,-1
WESLEY.txt,577228,578231,1003,10,N,N,-,-1,-1
WESLEY.txt,577311,578308,997,10,N,N,-,-1,-1
WESLEY.txt,577403,578340,937,10,N,N,-,-1,-1
WESLEY.txt,577581,578372,791,10,N,N,-,-1,-1
WESLEY.txt,577757,578463,706,10,N,N,-,-1,-1
WESLEY.txt,577925,578530,605,10,N,N,-,-1,-1
WESLEY.txt,578015,578616,601,10,N,N,-,-1,-1
WESLEY.txt,578092,578707,615,10,N,N,-,-1,-1
WESLEY.txt,578156,578801,645,10,N,N,-,-1,-1
WESLEY.txt,578220,579157,937,10,N,N,-,-1,-1
WESLEY.txt,578231,579252,1021,10,N,N,-,-1,-1
WESLEY.txt,578309,579360,1051,10,N,N,-,-1,-1
WESLEY.txt,578341,579545,1204,10,N,N,-,-1,-1
WESLEY.txt,578373,579616,1243,10,N,N,-,-1,-1
WESLEY.txt,578464,579630,1166,10,N,N,-,-1,-1
WESLEY.txt,578531,579732,1201,10,N,N,-,-1,-1
WESLEY.txt,578617,579756,1139,10,N,N,-,-1,-1
WESLEY.txt,578707,579824,1117,10,N,N,-,-1,-1
WESLEY.txt,578802,579892,1090,10,N,N,-,-1,-1
WESLEY.txt,579158,579989,831,10,N,N,-,-1,-1
WESLEY.txt,579253,580065,812,10,N,N,-,-1,-1
WESLEY.txt,579361,580156,795,10,N,N,-,-1,-1
WESLEY.txt,579546,580239,693,10,N,N,-,-1,-1
WESLEY.txt,579617,580333,716,10,N,N,-,-1,-1
WESLEY.txt,579630,580357,727,10,N,N,-,-1,-1
WESLEY.txt,579733,580416,683,10,N,N,-,-1,-1
WESLEY.txt,579757,580507,750,10,N,N,-,-1,-1
WESLEY.txt,579825,580519,694,10,N,N,-,-1,-1
WESLEY.txt,579893,580554,661,10,N,N,-,-1,-1
WESLEY.txt,579989,580732,743,10,N,N,-,-1,-1
WESLEY.txt,580066,580759,693,10,N,N,-,-1,-1
WESLEY.txt,580157,580852,695,10,N,N,-,-1,-1
WESLEY.txt,580240,580925,685,10,N,N,-,-1,-1
WESLEY.txt,580334,580959,625,10,N,N,-,-1,-1
WESLEY.txt,580358,581057,699,10,N,N,-,-1,-1
WESLEY.txt,580417,581141,724,10,N,N,-,-1,-1
WESLEY.txt,580508,581224,716,10,N,N,-,-1,-1
WESLEY.txt,580519,581236,717,10,N,N,-,-1,-1
WESLEY.txt,580555,581474,919,10,N,N,-,-1,-1
WESLEY.txt,580733,581527,794,10,N,N,-,-1,-1
WESLEY.txt,580760,581667,907,10,N,N,-,-1,-1
WESLEY.txt,580853,581746,893,10,N,N,-,-1,-1
WESLEY.txt,580926,581960,1034,10,N,N,-,-1,-1
WESLEY.txt,580960,582063,1103,10,N,N,-,-1,-1
WESLEY.txt,581058,582159,1101,10,N,N,-,-1,-1
WESLEY.txt,581142,582255,1113,10,N,N,-,-1,-1
WESLEY.txt,581225,582349,1124,10,N,N,-,-1,-1
WESLEY.txt,581236,582442,1206,10,N,N,-,-1,-1
WESLEY.txt,581475,582638,1163,10,N,N,-,-1,-1
WESLEY.txt,581528,582735,1207,10,N,N,-,-1,-1
WESLEY.txt,581668,582799,1131,10,N,N,-,-1,-1
WESLEY.txt,581747,582955,1208,10,N,N,-,-1,-1
WESLEY.txt,581961,583072,1111,10,N,N,-,-1,-1
WESLEY.txt,582064,583103,1039,10,N,N,-,-1,-1
WESLEY.txt,582160,583146,986,10,N,N,-,-1,-1
WESLEY.txt,582256,583330,1074,10,N,N,-,-1,-1
WESLEY.txt,582350,583423,1073,10,N,N,-,-1,-1
WESLEY.txt,582443,583505,1062,10,N,N,-,-1,-1
WESLEY.txt,582639,583707,1068,10,N,N,-,-1,-1
WESLEY.txt,582736,583782,1046,10,N,N,-,-1,-1
WESLEY.txt,582800,583796,996,10,N,N,-,-1,-1
WESLEY.txt,582956,583865,909,10,N,N,-,-1,-1
WESLEY.txt,583073,584091,1018,10,N,N,-,-1,-1
WESLEY.txt,583104,584193,1089,10,N,N,-,-1,-1
WESLEY.txt,583147,584276,1129,10,N,N,-,-1,-1
WESLEY.txt,583331,584368,1037,10,N,N,-,-1,-1
WESLEY.txt,583424,584454,1030,10,N,N,-,-1,-1
WESLEY.txt,583506,584632,1126,10,N,N,-,-1,-1
WESLEY.txt,583708,584724,1016,10,N,N,-,-1,-1
WESLEY.txt,583784,584823,1039,10,N,N,-,-1,-1
WESLEY.txt,583796,585020,1224,10,N,N,-,-1,-1
WESLEY.txt,583866,585035,1169,10,N,N,-,-1,-1
WESLEY.txt,584092,585067,975,10,N,N,-,-1,-1
WESLEY.txt,584194,585204,1010,10,N,N,-,-1,-1
WESLEY.txt,584277,585216,939,10,N,N,-,-1,-1
WESLEY.txt,584369,585284,915,10,N,N,-,-1,-1
WESLEY.txt,584455,585433,978,10,N,N,-,-1,-1
WESLEY.txt,584633,585603,970,10,N,N,-,-1,-1
WESLEY.txt,584725,585647,922,10,N,N,-,-1,-1
WESLEY.txt,584824,585730,906,10,N,N,-,-1,-1
WESLEY.txt,585021,585927,906,10,N,N,-,-1,-1
WESLEY.txt,585035,586152,1117,10,N,N,-,-1,-1
WESLEY.txt,585068,586264,1196,10,N,N,-,-1,-1
WESLEY.txt,585205,586342,1137,10,N,N,-,-1,-1
WESLEY.txt,585217,586398,1181,10,N,N,-,-1,-1
WESLEY.txt,585285,586439,1154,10,N,N,-,-1,-1
WESLEY.txt,585434,586637,1203,10,N,N,-,-1,-1
WESLEY.txt,585604,586719,1115,10,N,N,-,-1,-1
WESLEY.txt,585648,586832,1184,10,N,N,-,-1,-1
WESLEY.txt,585730,586914,1184,10,N,N,-,-1,-1
WESLEY.txt,585928,587084,1156,10,N,N,-,-1,-1
WESLEY.txt,586153,587142,989,10,N,N,-,-1,-1
WESLEY.txt,586265,587210,945,10,N,N,-,-1,-1
WESLEY.txt,586343,587297,954,10,N,N,-,-1,-1
WESLEY.txt,586399,587412,1013,10,N,N,-,-1,-1
WESLEY.txt,586440,587462,1022,10,N,N,-,-1,-1
WESLEY.txt,586638,587507,869,10,N,N,-,-1,-1
WESLEY.txt,586720,587553,833,10,N,N,-,-1,-1
WESLEY.txt,586833,587661,828,10,N,N,-,-1,-1
WESLEY.txt,586915,587733,818,10,N,N,-,-1,-1
WESLEY.txt,587085,587832,747,10,N,N,-,-1,-1
WESLEY.txt,587143,588092,949,10,N,N,-,-1,-1
WESLEY.txt,587211,588192,981,10,N,N,-,-1,-1
WESLEY.txt,587298,588212,914,10,N,N,-,-1,-1
WESLEY.txt,587413,588282,869,10,N,N,-,-1,-1
WESLEY.txt,587463,588434,971,10,N,N,-,-1,-1
WESLEY.txt,587508,588513,1005,10,N,N,-,-1,-1
WESLEY.txt,587554,588717,1163,10,N,N,-,-1,-1
WESLEY.txt,587661,588928,1267,10,N,N,-,-1,-1
WESLEY.txt,587734,589007,1273,10,N,N,-,-1,-1
WESLEY.txt,587833,589020,1187,10,N,N,-,-1,-1
WESLEY.txt,588093,589098,1005,10,N,N,-,-1,-1
WESLEY.txt,588193,589145,952,10,N,N,-,-1,-1
WESLEY.txt,588212,589276,1064,10,N,N,-,-1,-1
WESLEY.txt,588283,589373,1090,10,N,N,-,-1,-1
WESLEY.txt,588435,589465,1030,10,N,N,-,-1,-1
WESLEY.txt,588514,589509,995,10,N,N,-,-1,-1
WESLEY.txt,588718,589603,885,10,N,N,-,-1,-1
WESLEY.txt,588929,589681,752,10,N,N,-,-1,-1
WESLEY.txt,589008,589695,687,10,N,N,-,-1,-1
WESLEY.txt,589020,589793,773,10,N,N,-,-1,-1
WESLEY.txt,589099,589863,764,10,N,N,-,-1,-1
WESLEY.txt,589146,589968,822,10,N,N,-,-1,-1
WESLEY.txt,589277,590072,795,10,N,N,-,-1,-1
WESLEY.txt,589374,590146,772,10,N,N,-,-1,-1
WESLEY.txt,589466,590232,766,10,N,N,-,-1,-1
WESLEY.txt,589510,590283,773,10,N,N,-,-1,-1
WESLEY.txt,589604,590295,691,10,N,N,-,-1,-1
WESLEY.txt,589682,590338,656,10,N,N,-,-1,-1
WESLEY.txt,589695,590350,655,10,N,N,-,-1,-1
WESLEY.txt,589794,590420,626,10,N,N,-,-1,-1
WESLEY.txt,589864,590504,640,10,N,N,-,-1,-1
WESLEY.txt,589969,590594,625,10,N,N,-,-1,-1
WESLEY.txt,590072,590671,599,10,N,N,-,-1,-1
WESLEY.txt,590147,590758,611,10,N,N,-,-1,-1
WESLEY.txt,590233,590844,611,10,N,N,-,-1,-1
WESLEY.txt,590284,590928,644,10,N,N,-,-1,-1
WESLEY.txt,590296,591030,734,10,N,N,-,-1,-1
WESLEY.txt,590339,591126,787,10,N,N,-,-1,-1
WESLEY.txt,590350,591140,790,10,N,N,-,-1,-1
WESLEY.txt,590421,591216,795,10,N,N,-,-1,-1
WESLEY.txt,590505,591313,808,10,N,N,-,-1,-1
WESLEY.txt,590595,591482,887,10,N,N,-,-1,-1
WESLEY.txt,590672,591494,822,10,N,N,-,-1,-1
WESLEY.txt,590759,591667,908,10,N,N,-,-1,-1
WESLEY.txt,590845,591853,1008,10,N,N,-,-1,-1
WESLEY.txt,590929,592023,1094,10,N,N,-,-1,-1
WESLEY.txt,591031,592193,1162,10,N,N,-,-1,-1
WESLEY.txt,591127,592294,1167,10,N,N,-,-1,-1
WESLEY.txt,591140,592434,1294,10,N,N,-,-1,-1
WESLEY.txt,591217,592502,1285,10,N,N,-,-1,-1
WESLEY.txt,591314,592592,1278,10,N,N,-,-1,-1
WESLEY.txt,591483,592705,1222,10,N,N,-,-1,-1
WESLEY.txt,591494,592796,1302,10,N,N,-,-1,-1
WESLEY.txt,591668,593001,1333,10,N,N,-,-1,-1
WESLEY.txt,591854,593079,1225,10,N,N,-,-1,-1
WESLEY.txt,592024,593155,1131,10,N,N,-,-1,-1
WESLEY.txt,592194,593324,1130,10,N,N,-,-1,-1
WESLEY.txt,592294,593489,1195,10,N,N,-,-1,-1
WESLEY.txt,592435,593669,1234,10,N,N,-,-1,-1
WESLEY.txt,592503,593839,1336,10,N,N,-,-1,-1
WESLEY.txt,592593,593924,1331,10,N,N,-,-1,-1
WESLEY.txt,592706,594006,1300,10,N,N,-,-1,-1
WESLEY.txt,592797,594083,1286,10,N,N,-,-1,-1
WESLEY.txt,593002,594245,1243,10,N,N,-,-1,-1
WESLEY.txt,593080,594391,1311,10,N,N,-,-1,-1
WESLEY.txt,593156,594482,1326,10,N,N,-,-1,-1
WESLEY.txt,593325,594582,1257,10,N,N,-,-1,-1
WESLEY.txt,593490,594684,1194,10,N,N,-,-1,-1
WESLEY.txt,593670,594781,1111,10,N,N,-,-1,-1
WESLEY.txt,593840,594793,953,10,N,N,-,-1,-1
WESLEY.txt,593925,594876,951,10,N,N,-,-1,-1
WESLEY.txt,594007,595051,1044,10,N,N,-,-1,-1
WESLEY.txt,594084,595063,979,10,N,N,-,-1,-1
WESLEY.txt,594246,595256,1010,10,N,N,-,-1,-1
WESLEY.txt,594392,595470,1078,10,N,N,-,-1,-1
WESLEY.txt,594483,595570,1087,10,N,N,-,-1,-1
WESLEY.txt,594583,595629,1046,10,N,N,-,-1,-1
WESLEY.txt,594685,595728,1043,10,N,N,-,-1,-1
WESLEY.txt,594782,595813,1031,10,N,N,-,-1,-1
WESLEY.txt,594793,595866,1073,10,N,N,-,-1,-1
WESLEY.txt,594877,595956,1079,10,N,N,-,-1,-1
WESLEY.txt,595052,596059,1007,10,N,N,-,-1,-1
WESLEY.txt,595063,596103,1040,10,N,N,-,-1,-1
WESLEY.txt,595257,596116,859,10,N,N,-,-1,-1
WESLEY.txt,595471,596226,755,10,N,N,-,-1,-1
WESLEY.txt,595571,596399,828,10,N,N,-,-1,-1
WESLEY.txt,595629,596581,952,10,N,N,-,-1,-1
WESLEY.txt,595729,596782,1053,10,N,N,-,-1,-1
WESLEY.txt,595814,596931,1117,10,N,N,-,-1,-1
WESLEY.txt,595867,597113,1246,10,N,N,-,-1,-1
WESLEY.txt,595957,597255,1298,10,N,N,-,-1,-1
WESLEY.txt,596060,597344,1284,10,N,N,-,-1,-1
WESLEY.txt,596104,597431,1327,10,N,N,-,-1,-1
WESLEY.txt,596116,597505,1389,10,N,N,-,-1,-1
WESLEY.txt,596227,597699,1472,10,N,N,-,-1,-1
WESLEY.txt,596400,597850,1450,10,N,N,-,-1,-1
WESLEY.txt,596582,597957,1375,10,N,N,-,-1,-1
WESLEY.txt,596783,598105,1322,10,N,N,-,-1,-1
WESLEY.txt,596932,598190,1258,10,N,N,-,-1,-1
WESLEY.txt,597114,598260,1146,10,N,N,-,-1,-1
WESLEY.txt,597256,598363,1107,10,N,N,-,-1,-1
WESLEY.txt,597345,598383,1038,10,N,N,-,-1,-1
WESLEY.txt,597432,598500,1068,10,N,N,-,-1,-1
WESLEY.txt,597506,598561,1055,10,N,N,-,-1,-1
WESLEY.txt,597700,598616,916,10,N,N,-,-1,-1
WESLEY.txt,597851,598790,939,10,N,N,-,-1,-1
WESLEY.txt,597958,599009,1051,10,N,N,-,-1,-1
WESLEY.txt,598106,599029,923,10,N,N,-,-1,-1
WESLEY.txt,598191,599245,1054,10,N,N,-,-1,-1
WESLEY.txt,598261,599370,1109,10,N,N,-,-1,-1
WESLEY.txt,598364,599432,1068,10,N,N,-,-1,-1
WESLEY.txt,598383,599583,1200,10,N,N,-,-1,-1
WESLEY.txt,598501,599655,1154,10,N,N,-,-1,-1
WESLEY.txt,598562,599829,1267,10,N,N,-,-1,-1
WESLEY.txt,598617,599990,1373,10,N,N,-,-1,-1
WESLEY.txt,598791,600045,1254,10,N,N,-,-1,-1
WESLEY.txt,599010,600075,1065,10,N,N,-,-1,-1
WESLEY.txt,599029,600155,1126,10,N,N,-,-1,-1
WESLEY.txt,599246,600271,1025,10,N,N,-,-1,-1
WESLEY.txt,599370,600291,921,10,N,N,-,-1,-1
WESLEY.txt,599433,600459,1026,10,N,N,-,-1,-1
WESLEY.txt,599584,600477,893,10,N,N,-,-1,-1
WESLEY.txt,599656,600709,1053,10,N,N,-,-1,-1
WESLEY.txt,599830,600721,891,10,N,N,-,-1,-1
WESLEY.txt,599991,600799,808,10,N,N,-,-1,-1
WESLEY.txt,600046,600844,798,10,N,N,-,-1,-1
WESLEY.txt,600076,600903,827,10,N,N,-,-1,-1
WESLEY.txt,600156,600915,759,10,N,N,-,-1,-1
WESLEY.txt,600272,601041,769,10,N,N,-,-1,-1
WESLEY.txt,600291,601153,862,10,N,N,-,-1,-1
WESLEY.txt,600460,601237,777,10,N,N,-,-1,-1
WESLEY.txt,600478,601249,771,10,N,N,-,-1,-1
WESLEY.txt,600710,601612,902,10,N,N,-,-1,-1
WESLEY.txt,600721,601633,912,10,N,N,-,-1,-1
WESLEY.txt,600800,601722,922,10,N,N,-,-1,-1
WESLEY.txt,600845,601729,884,10,N,N,-,-1,-1
WESLEY.txt,600904,601818,914,10,N,N,-,-1,-1
WESLEY.txt,600916,601958,1042,10,N,N,-,-1,-1
WESLEY.txt,601042,601986,944,10,N,N,-,-1,-1
WESLEY.txt,601153,602086,933,10,N,N,-,-1,-1
WESLEY.txt,601238,602107,869,10,N,N,-,-1,-1
WESLEY.txt,601249,602208,959,10,N,N,-,-1,-1
WESLEY.txt,601613,602388,775,10,N,N,-,-1,-1
WESLEY.txt,601633,602401,768,10,N,N,-,-1,-1
WESLEY.txt,601723,602428,705,10,N,N,-,-1,-1
WESLEY.txt,601730,602557,827,10,N,N,-,-1,-1
WESLEY.txt,601819,602937,1118,10,N,N,-,-1,-1
WESLEY.txt,601959,602952,993,10,N,N,-,-1,-1
WESLEY.txt,601987,603045,1058,10,N,N,-,-1,-1
WESLEY.txt,602087,603114,1027,10,N,N,-,-1,-1
WESLEY.txt,602107,603197,1090,10,N,N,-,-1,-1
WESLEY.txt,602209,603382,1173,10,N,N,-,-1,-1
WESLEY.txt,602389,603564,1175,10,N,N,-,-1,-1
WESLEY.txt,602401,603663,1262,10,N,N,-,-1,-1
WESLEY.txt,602429,603677,1248,10,N,N,-,-1,-1
WESLEY.txt,602558,603740,1182,10,N,N,-,-1,-1
WESLEY.txt,602938,603752,814,10,N,N,-,-1,-1
WESLEY.txt,602952,603842,890,10,N,N,-,-1,-1
WESLEY.txt,603046,603942,896,10,N,N,-,-1,-1
WESLEY.txt,603115,604020,905,10,N,N,-,-1,-1
WESLEY.txt,603198,604107,909,10,N,N,-,-1,-1
WESLEY.txt,603383,604194,811,10,N,N,-,-1,-1
WESLEY.txt,603565,604200,635,10,N,N,-,-1,-1
WESLEY.txt,603664,604220,556,10,N,N,-,-1,-1
WESLEY.txt,603678,604252,574,10,N,N,-,-1,-1
WESLEY.txt,603741,604292,551,10,N,N,-,-1,-1
WESLEY.txt,603752,604362,610,10,N,N,-,-1,-1
WESLEY.txt,603843,604438,595,10,N,N,-,-1,-1
WESLEY.txt,603943,604543,600,10,N,N,-,-1,-1
WESLEY.txt,604020,604634,614,10,N,N,-,-1,-1
WESLEY.txt,604108,604685,577,10,N,N,-,-1,-1
WESLEY.txt,604195,604875,680,10,N,N,-,-1,-1
WESLEY.txt,604201,604892,691,10,N,N,-,-1,-1
WESLEY.txt,604220,604994,774,10,N,N,-,-1,-1
WESLEY.txt,604253,605086,833,10,N,N,-,-1,-1
WESLEY.txt,604293,605179,886,10,N,N,-,-1,-1
WESLEY.txt,604363,605193,830,10,N,N,-,-1,-1
WESLEY.txt,604438,605272,834,10,N,N,-,-1,-1
WESLEY.txt,604544,605354,810,10,N,N,-,-1,-1
WESLEY.txt,604635,605429,794,10,N,N,-,-1,-1
WESLEY.txt,604686,605443,757,10,N,N,-,-1,-1
WESLEY.txt,604876,606142,1266,10,N,N,-,-1,-1
WESLEY.txt,604892,606374,1482,10,N,N,-,-1,-1
WESLEY.txt,604995,606502,1507,10,N,N,-,-1,-1
WESLEY.txt,605087,606568,1481,10,N,N,-,-1,-1
WESLEY.txt,605180,606693,1513,10,N,N,-,-1,-1
WESLEY.txt,605194,606854,1660,10,N,N,-,-1,-1
WESLEY.txt,605273,606947,1674,10,N,N,-,-1,-1
WESLEY.txt,605355,607088,1733,10,N,N,-,-1,-1
WESLEY.txt,605430,607160,1730,10,N,N,-,-1,-1
WESLEY.txt,605443,607245,1802,10,N,N,-,-1,-1
WESLEY.txt,606143,607355,1212,10,N,N,-,-1,-1
WESLEY.txt,606375,607416,1041,10,N,N,-,-1,-1
WESLEY.txt,606503,607594,1091,10,N,N,-,-1,-1
WESLEY.txt,606568,607613,1045,10,N,N,-,-1,-1
WESLEY.txt,606694,607709,1015,10,N,N,-,-1,-1
WESLEY.txt,606855,607959,1104,10,N,N,-,-1,-1
WESLEY.txt,606948,608064,1116,10,N,N,-,-1,-1
WESLEY.txt,607089,608076,987,10,N,N,-,-1,-1
WESLEY.txt,607161,608228,1067,10,N,N,-,-1,-1
WESLEY.txt,607246,608333,1087,10,N,N,-,-1,-1
WESLEY.txt,607356,608478,1122,10,N,N,-,-1,-1
WESLEY.txt,607417,608764,1347,10,N,N,-,-1,-1
WESLEY.txt,607595,608800,1205,10,N,N,-,-1,-1
WESLEY.txt,607613,608864,1251,10,N,N,-,-1,-1
WESLEY.txt,607710,608877,1167,10,N,N,-,-1,-1
WESLEY.txt,607960,609027,1067,10,N,N,-,-1,-1
WESLEY.txt,608065,609146,1081,10,N,N,-,-1,-1
WESLEY.txt,608076,609276,1200,10,N,N,-,-1,-1
WESLEY.txt,608229,609323,1094,10,N,N,-,-1,-1
WESLEY.txt,608334,609347,1013,10,N,N,-,-1,-1
WESLEY.txt,608479,609458,979,10,N,N,-,-1,-1
WESLEY.txt,608765,609607,842,10,N,N,-,-1,-1
WESLEY.txt,608801,609617,816,10,N,N,-,-1,-1
WESLEY.txt,608865,609659,794,10,N,N,-,-1,-1
WESLEY.txt,608877,609728,851,10,N,N,-,-1,-1
WESLEY.txt,609028,609915,887,10,N,N,-,-1,-1
WESLEY.txt,609147,610007,860,10,N,N,-,-1,-1
WESLEY.txt,609277,610035,758,10,N,N,-,-1,-1
WESLEY.txt,609324,610079,755,10,N,N,-,-1,-1
WESLEY.txt,609348,610118,770,10,N,N,-,-1,-1
WESLEY.txt,609458,610159,701,10,N,N,-,-1,-1
WESLEY.txt,609608,610259,651,10,N,N,-,-1,-1
WESLEY.txt,609618,610433,815,10,N,N,-,-1,-1
WESLEY.txt,609660,610536,876,10,N,N,-,-1,-1
WESLEY.txt,609729,610616,887,10,N,N,-,-1,-1
WESLEY.txt,609916,610802,886,10,N,N,-,-1,-1
WESLEY.txt,610008,610856,848,10,N,N,-,-1,-1
WESLEY.txt,610036,610984,948,10,N,N,-,-1,-1
WESLEY.txt,610080,611005,925,10,N,N,-,-1,-1
WESLEY.txt,610119,611079,960,10,N,N,-,-1,-1
WESLEY.txt,610160,611163,1003,10,N,N,-,-1,-1
WESLEY.txt,610260,611272,1012,10,N,N,-,-1,-1
WESLEY.txt,610434,611284,850,10,N,N,-,-1,-1
WESLEY.txt,610537,611376,839,10,N,N,-,-1,-1
WESLEY.txt,610617,611511,894,10,N,N,-,-1,-1
WESLEY.txt,610803,611680,877,10,N,N,-,-1,-1
WESLEY.txt,610857,611755,898,10,N,N,-,-1,-1
WESLEY.txt,610985,611876,891,10,N,N,-,-1,-1
WESLEY.txt,611005,611950,945,10,N,N,-,-1,-1
WESLEY.txt,611080,612078,998,10,N,N,-,-1,-1
WESLEY.txt,611164,612186,1022,10,N,N,-,-1,-1
WESLEY.txt,611273,612247,974,10,N,N,-,-1,-1
WESLEY.txt,611284,612321,1037,10,N,N,-,-1,-1
WESLEY.txt,611377,612333,956,10,N,N,-,-1,-1
WESLEY.txt,611512,612439,927,10,N,N,-,-1,-1
WESLEY.txt,611681,612446,765,10,N,N,-,-1,-1
WESLEY.txt,611756,612609,853,10,N,N,-,-1,-1
WESLEY.txt,611876,612621,745,10,N,N,-,-1,-1
WESLEY.txt,611951,612656,705,10,N,N,-,-1,-1
WESLEY.txt,612079,612863,784,10,N,N,-,-1,-1
WESLEY.txt,612187,613019,832,10,N,N,-,-1,-1
WESLEY.txt,612248,613115,867,10,N,N,-,-1,-1
WESLEY.txt,612322,613127,805,10,N,N,-,-1,-1
WESLEY.txt,612333,613189,856,10,N,N,-,-1,-1
WESLEY.txt,612440,613312,872,10,N,N,-,-1,-1
WESLEY.txt,612447,613365,918,10,N,N,-,-1,-1
WESLEY.txt,612610,613448,838,10,N,N,-,-1,-1
WESLEY.txt,612621,613505,884,10,N,N,-,-1,-1
WESLEY.txt,612657,613578,921,10,N,N,-,-1,-1
WESLEY.txt,612864,613634,770,10,N,N,-,-1,-1
WESLEY.txt,613020,613736,716,10,N,N,-,-1,-1
WESLEY.txt,613116,613847,731,10,N,N,-,-1,-1
WESLEY.txt,613127,614030,903,10,N,N,-,-1,-1
WESLEY.txt,613190,614045,855,10,N,N,-,-1,-1
WESLEY.txt,613313,614118,805,10,N,N,-,-1,-1
WESLEY.txt,613366,614461,1095,10,N,N,-,-1,-1
WESLEY.txt,613449,614558,1109,10,N,N,-,-1,-1
WESLEY.txt,613506,614570,1064,10,N,N,-,-1,-1
WESLEY.txt,613579,614664,1085,10,N,N,-,-1,-1
WESLEY.txt,613635,614678,1043,10,N,N,-,-1,-1
WESLEY.txt,613737,614711,974,10,N,N,-,-1,-1
WESLEY.txt,613848,614859,1011,10,N,N,-,-1,-1
WESLEY.txt,614031,615025,994,10,N,N,-,-1,-1
WESLEY.txt,614045,615082,1037,10,N,N,-,-1,-1
WESLEY.txt,614119,615117,998,10,N,N,-,-1,-1
WESLEY.txt,614461,615164,703,10,N,N,-,-1,-1
WESLEY.txt,614559,615203,644,10,N,N,-,-1,-1
WESLEY.txt,614571,615318,747,10,N,N,-,-1,-1
WESLEY.txt,614665,615390,725,10,N,N,-,-1,-1
WESLEY.txt,614679,615463,784,10,N,N,-,-1,-1
WESLEY.txt,614712,615507,795,10,N,N,-,-1,-1
WESLEY.txt,614860,615546,686,10,N,N,-,-1,-1
WESLEY.txt,615026,615629,603,10,N,N,-,-1,-1
WESLEY.txt,615083,615716,633,10,N,N,-,-1,-1
WESLEY.txt,615118,615780,662,10,N,N,-,-1,-1
WESLEY.txt,615165,615890,725,10,N,N,-,-1,-1
WESLEY.txt,615204,616003,799,10,N,N,-,-1,-1
WESLEY.txt,615319,616075,756,10,N,N,-,-1,-1
WESLEY.txt,615391,616177,786,10,N,N,-,-1,-1
WESLEY.txt,615464,616277,813,10,N,N,-,-1,-1
WESLEY.txt,615508,616296,788,10,N,N,-,-1,-1
WESLEY.txt,615547,616361,814,10,N,N,-,-1,-1
WESLEY.txt,615630,616489,859,10,N,N,-,-1,-1
WESLEY.txt,615717,616771,1054,10,N,N,-,-1,-1
WESLEY.txt,615781,616871,1090,10,N,N,-,-1,-1
WESLEY.txt,615891,617030,1139,10,N,N,-,-1,-1
WESLEY.txt,616004,617387,1383,10,N,N,-,-1,-1
WESLEY.txt,616076,617630,1554,10,N,N,-,-1,-1
WESLEY.txt,616178,617941,1763,10,N,N,-,-1,-1
WESLEY.txt,616278,617950,1672,10,N,N,-,-1,-1
WESLEY.txt,616296,618079,1783,10,N,N,-,-1,-1
WESLEY.txt,616362,618088,1726,10,N,N,-,-1,-1
WESLEY.txt,616490,618236,1746,10,N,N,-,-1,-1
WESLEY.txt,616772,618259,1487,10,N,N,-,-1,-1
WESLEY.txt,616872,618298,1426,10,N,N,-,-1,-1
WESLEY.txt,617031,618382,1351,10,N,N,-,-1,-1
WESLEY.txt,617388,618443,1055,10,N,N,-,-1,-1
WESLEY.txt,617631,618491,860,10,N,N,-,-1,-1
WESLEY.txt,617942,618540,598,10,N,N,-,-1,-1
WESLEY.txt,617951,618561,610,10,N,N,-,-1,-1
WESLEY.txt,618080,618765,685,10,N,N,-,-1,-1
WESLEY.txt,618089,618833,744,10,N,N,-,-1,-1
WESLEY.txt,618237,618948,711,10,N,N,-,-1,-1
WESLEY.txt,618260,618972,712,10,N,N,-,-1,-1
WESLEY.txt,618299,619000,701,10,N,N,-,-1,-1
WESLEY.txt,618383,619105,722,10,N,N,-,-1,-1
WESLEY.txt,618444,619516,1072,10,N,N,-,-1,-1
WESLEY.txt,618491,619550,1059,10,N,N,-,-1,-1
WESLEY.txt,618541,619646,1105,10,N,N,-,-1,-1
WESLEY.txt,618562,619750,1188,10,N,N,-,-1,-1
WESLEY.txt,618766,619833,1067,10,N,N,-,-1,-1
WESLEY.txt,618834,620084,1250,10,N,N,-,-1,-1
WESLEY.txt,618949,620111,1162,10,N,N,-,-1,-1
WESLEY.txt,618973,620182,1209,10,N,N,-,-1,-1
WESLEY.txt,619001,620341,1340,10,N,N,-,-1,-1
WESLEY.txt,619106,620418,1312,10,N,N,-,-1,-1
WESLEY.txt,619517,620528,1011,10,N,N,-,-1,-1
WESLEY.txt,619551,620550,999,10,N,N,-,-1,-1
WESLEY.txt,619646,620728,1082,10,N,N,-,-1,-1
WESLEY.txt,619751,620772,1021,10,N,N,-,-1,-1
WESLEY.txt,619834,620884,1050,10,N,N,-,-1,-1
WESLEY.txt,620085,620972,887,10,N,N,-,-1,-1
WESLEY.txt,620112,621164,1052,10,N,N,-,-1,-1
WESLEY.txt,620183,621280,1097,10,N,N,-,-1,-1
WESLEY.txt,620342,621303,961,10,N,N,-,-1,-1
WESLEY.txt,620419,621392,973,10,N,N,-,-1,-1
WESLEY.txt,620529,621555,1026,10,N,N,-,-1,-1
WESLEY.txt,620550,621743,1193,10,N,N,-,-1,-1
WESLEY.txt,620729,621840,1111,10,N,N,-,-1,-1
WESLEY.txt,620773,621908,1135,10,N,N,-,-1,-1
WESLEY.txt,620885,621985,1100,10,N,N,-,-1,-1
WESLEY.txt,620973,622034,1061,10,N,N,-,-1,-1
WESLEY.txt,621165,622085,920,10,N,N,-,-1,-1
WESLEY.txt,621280,622106,826,10,N,N,-,-1,-1
WESLEY.txt,621304,622288,984,10,N,N,-,-1,-1
WESLEY.txt,621393,622369,976,10,N,N,-,-1,-1
WESLEY.txt,621556,622409,853,10,N,N,-,-1,-1
WESLEY.txt,621744,622446,702,10,N,N,-,-1,-1
WESLEY.txt,621841,622542,701,10,N,N,-,-1,-1
WESLEY.txt,621909,622643,734,10,N,N,-,-1,-1
WESLEY.txt,621986,622852,866,10,N,N,-,-1,-1
WESLEY.txt,622035,622942,907,10,N,N,-,-1,-1
WESLEY.txt,622086,623124,1038,10,N,N,-,-1,-1
WESLEY.txt,622106,623227,1121,10,N,N,-,-1,-1
WESLEY.txt,622289,623402,1113,10,N,N,-,-1,-1
WESLEY.txt,622370,623481,1111,10,N,N,-,-1,-1
WESLEY.txt,622410,623542,1132,10,N,N,-,-1,-1
WESLEY.txt,622447,623687,1240,10,N,N,-,-1,-1
WESLEY.txt,622543,623771,1228,10,N,N,-,-1,-1
WESLEY.txt,622644,623871,1227,10,N,N,-,-1,-1
WESLEY.txt,622853,623885,1032,10,N,N,-,-1,-1
WESLEY.txt,622943,623907,964,10,N,N,-,-1,-1
WESLEY.txt,623125,624001,876,10,N,N,-,-1,-1
WESLEY.txt,623228,624022,794,10,N,N,-,-1,-1
WESLEY.txt,623403,624101,698,10,N,N,-,-1,-1
WESLEY.txt,623482,624154,672,10,N,N,-,-1,-1
WESLEY.txt,623543,624269,726,10,N,N,-,-1,-1
WESLEY.txt,623688,624497,809,10,N,N,-,-1,-1
WESLEY.txt,623772,624656,884,10,N,N,-,-1,-1
WESLEY.txt,623872,624738,866,10,N,N,-,-1,-1
WESLEY.txt,623886,624749,863,10,N,N,-,-1,-1
WESLEY.txt,623908,624835,927,10,N,N,-,-1,-1
WESLEY.txt,624002,624934,932,10,N,N,-,-1,-1
WESLEY.txt,624022,624962,940,10,N,N,-,-1,-1
WESLEY.txt,624102,625023,921,10,N,N,-,-1,-1
WESLEY.txt,624155,625193,1038,10,N,N,-,-1,-1
WESLEY.txt,624270,625235,965,10,N,N,-,-1,-1
WESLEY.txt,624498,625292,794,10,N,N,-,-1,-1
WESLEY.txt,624657,625304,647,10,N,N,-,-1,-1
WESLEY.txt,624739,625418,679,10,N,N,-,-1,-1
WESLEY.txt,624749,625511,762,10,N,N,-,-1,-1
WESLEY.txt,624836,625602,766,10,N,N,-,-1,-1
WESLEY.txt,624935,625667,732,10,N,N,-,-1,-1
WESLEY.txt,624963,625687,724,10,N,N,-,-1,-1
WESLEY.txt,625024,625757,733,10,N,N,-,-1,-1
WESLEY.txt,625194,625826,632,10,N,N,-,-1,-1
WESLEY.txt,625236,626025,789,10,N,N,-,-1,-1
WESLEY.txt,625293,626120,827,10,N,N,-,-1,-1
WESLEY.txt,625304,626204,900,10,N,N,-,-1,-1
WESLEY.txt,625419,626307,888,10,N,N,-,-1,-1
WESLEY.txt,625512,626414,902,10,N,N,-,-1,-1
WESLEY.txt,625603,626488,885,10,N,N,-,-1,-1
WESLEY.txt,625668,626501,833,10,N,N,-,-1,-1
WESLEY.txt,625687,626570,883,10,N,N,-,-1,-1
WESLEY.txt,625758,626639,881,10,N,N,-,-1,-1
WESLEY.txt,625827,626732,905,10,N,N,-,-1,-1
WESLEY.txt,626026,626885,859,10,N,N,-,-1,-1
WESLEY.txt,626121,626900,779,10,N,N,-,-1,-1
WESLEY.txt,626205,627073,868,10,N,N,-,-1,-1
WESLEY.txt,626308,627161,853,10,N,N,-,-1,-1
WESLEY.txt,626414,627229,815,10,N,N,-,-1,-1
WESLEY.txt,626489,627269,780,10,N,N,-,-1,-1
WESLEY.txt,626502,627363,861,10,N,N,-,-1,-1
WESLEY.txt,626571,627452,881,10,N,N,-,-1,-1
WESLEY.txt,626640,627542,902,10,N,N,-,-1,-1
WESLEY.txt,626733,627626,893,10,N,N,-,-1,-1
WESLEY.txt,626886,627638,752,10,N,N,-,-1,-1
WESLEY.txt,626900,627740,840,10,N,N,-,-1,-1
WESLEY.txt,627074,627820,746,10,N,N,-,-1,-1
WESLEY.txt,627162,627842,680,10,N,N,-,-1,-1
WESLEY.txt,627230,627928,698,10,N,N,-,-1,-1
WESLEY.txt,627270,627993,723,10,N,N,-,-1,-1
WESLEY.txt,627364,628067,703,10,N,N,-,-1,-1
WESLEY.txt,627453,628140,687,10,N,N,-,-1,-1
WESLEY.txt,627543,628154,611,10,N,N,-,-1,-1
WESLEY.txt,627627,628178,551,10,N,N,-,-1,-1
WESLEY.txt,627638,628277,639,10,N,N,-,-1,-1
WESLEY.txt,627741,628415,674,10,N,N,-,-1,-1
WESLEY.txt,627821,628507,686,10,N,N,-,-1,-1
WESLEY.txt,627843,628608,765,10,N,N,-,-1,-1
WESLEY.txt,627929,628692,763,10,N,N,-,-1,-1
WESLEY.txt,627994,628794,800,10,N,N,-,-1,-1
WESLEY.txt,628068,628896,828,10,N,N,-,-1,-1
WESLEY.txt,628141,628909,768,10,N,N,-,-1,-1
WESLEY.txt,628154,628981,827,10,N,N,-,-1,-1
WESLEY.txt,628179,629049,870,10,N,N,-,-1,-1
WESLEY.txt,628278,629104,826,10,N,N,-,-1,-1
WESLEY.txt,628416,629247,831,10,N,N,-,-1,-1
WESLEY.txt,628508,629262,754,10,N,N,-,-1,-1
WESLEY.txt,628609,629337,728,10,N,N,-,-1,-1
WESLEY.txt,628692,629500,808,10,N,N,-,-1,-1
WESLEY.txt,628795,629535,740,10,N,N,-,-1,-1
WESLEY.txt,628897,629798,901,10,N,N,-,-1,-1
WESLEY.txt,628909,629879,970,10,N,N,-,-1,-1
WESLEY.txt,628982,629941,959,10,N,N,-,-1,-1
WESLEY.txt,629050,629952,902,10,N,N,-,-1,-1
WESLEY.txt,629105,630000,895,10,N,N,-,-1,-1
WESLEY.txt,629248,630008,760,10,N,N,-,-1,-1
WESLEY.txt,629262,630073,811,10,N,N,-,-1,-1
WESLEY.txt,629338,630093,755,10,N,N,-,-1,-1
WESLEY.txt,629501,630208,707,10,N,N,-,-1,-1
WESLEY.txt,629536,630240,704,10,N,N,-,-1,-1
WESLEY.txt,629799,630330,531,10,N,N,-,-1,-1
WESLEY.txt,629880,630427,547,10,N,N,-,-1,-1
WESLEY.txt,629942,630585,643,10,N,N,-,-1,-1
WESLEY.txt,629953,630767,814,10,N,N,-,-1,-1
WESLEY.txt,630001,630779,778,10,N,N,-,-1,-1
WESLEY.txt,630009,630823,814,10,N,N,-,-1,-1
WESLEY.txt,630074,631015,941,10,N,N,-,-1,-1
WESLEY.txt,630093,631029,936,10,N,N,-,-1,-1
WESLEY.txt,630209,631078,869,10,N,N,-,-1,-1
WESLEY.txt,630241,631290,1049,10,N,N,-,-1,-1
WESLEY.txt,630331,631519,1188,10,N,N,-,-1,-1
WESLEY.txt,630428,631618,1190,10,N,N,-,-1,-1
WESLEY.txt,630586,631639,1053,10,N,N,-,-1,-1
WESLEY.txt,630768,631708,940,10,N,N,-,-1,-1
WESLEY.txt,630779,631800,1021,10,N,N,-,-1,-1
WESLEY.txt,630824,631918,1094,10,N,N,-,-1,-1
WESLEY.txt,631016,631933,917,10,N,N,-,-1,-1
WESLEY.txt,631029,631948,919,10,N,N,-,-1,-1
WESLEY.txt,631079,632021,942,10,N,N,-,-1,-1
WESLEY.txt,631291,632033,742,10,N,N,-,-1,-1
WESLEY.txt,631520,632201,681,10,N,N,-,-1,-1
WESLEY.txt,631618,632820,1202,10,N,N,-,-1,-1
WESLEY.txt,631640,632924,1284,10,N,N,-,-1,-1
WESLEY.txt,631709,632937,1228,10,N,N,-,-1,-1
WESLEY.txt,631801,633145,1344,10,N,N,-,-1,-1
WESLEY.txt,631919,633191,1272,10,N,N,-,-1,-1
WESLEY.txt,631934,633228,1294,10,N,N,-,-1,-1
WESLEY.txt,631949,633294,1345,10,N,N,-,-1,-1
WESLEY.txt,632022,633309,1287,10,N,N,-,-1,-1
WESLEY.txt,632033,633402,1369,10,N,N,-,-1,-1
WESLEY.txt,632202,633516,1314,10,N,N,-,-1,-1
WESLEY.txt,632821,633710,889,10,N,N,-,-1,-1
WESLEY.txt,632925,633801,876,10,N,N,-,-1,-1
WESLEY.txt,632938,633907,969,10,N,N,-,-1,-1
WESLEY.txt,633146,633974,828,10,N,N,-,-1,-1
WESLEY.txt,633192,634163,971,10,N,N,-,-1,-1
WESLEY.txt,633229,634212,983,10,N,N,-,-1,-1
WESLEY.txt,633295,634339,1044,10,N,N,-,-1,-1
WESLEY.txt,633309,634436,1127,10,N,N,-,-1,-1
WESLEY.txt,633403,634449,1046,10,N,N,-,-1,-1
WESLEY.txt,633517,634623,1106,10,N,N,-,-1,-1
WESLEY.txt,633711,634685,974,10,N,N,-,-1,-1
WESLEY.txt,633802,634762,960,10,N,N,-,-1,-1
WESLEY.txt,633907,634880,973,10,N,N,-,-1,-1
WESLEY.txt,633975,635068,1093,10,N,N,-,-1,-1
WESLEY.txt,634164,635189,1025,10,N,N,-,-1,-1
WESLEY.txt,634213,635203,990,10,N,N,-,-1,-1
WESLEY.txt,634340,635375,1035,10,N,N,-,-1,-1
WESLEY.txt,634437,635508,1071,10,N,N,-,-1,-1
WESLEY.txt,634449,635586,1137,10,N,N,-,-1,-1
WESLEY.txt,634624,635694,1070,10,N,N,-,-1,-1
WESLEY.txt,634686,635802,1116,10,N,N,-,-1,-1
WESLEY.txt,634763,635881,1118,10,N,N,-,-1,-1
WESLEY.txt,634881,636032,1151,10,N,N,-,-1,-1
WESLEY.txt,635069,636117,1048,10,N,N,-,-1,-1
WESLEY.txt,635190,636175,985,10,N,N,-,-1,-1
WESLEY.txt,635203,636182,979,10,N,N,-,-1,-1
WESLEY.txt,635376,636188,812,10,N,N,-,-1,-1
WESLEY.txt,635509,636244,735,10,N,N,-,-1,-1
WESLEY.txt,635586,636351,765,10,N,N,-,-1,-1
WESLEY.txt,635694,636443,749,10,N,N,-,-1,-1
WESLEY.txt,635803,636537,734,10,N,N,-,-1,-1
WESLEY.txt,635882,636637,755,10,N,N,-,-1,-1
WESLEY.txt,636033,636650,617,10,N,N,-,-1,-1
WESLEY.txt,636118,636720,602,10,N,N,-,-1,-1
WESLEY.txt,636176,636811,635,10,N,N,-,-1,-1
WESLEY.txt,636183,636928,745,10,N,N,-,-1,-1
WESLEY.txt,636189,637012,823,10,N,N,-,-1,-1
WESLEY.txt,636245,637023,778,10,N,N,-,-1,-1
WESLEY.txt,636351,637100,749,10,N,N,-,-1,-1
WESLEY.txt,636444,637232,788,10,N,N,-,-1,-1
WESLEY.txt,636538,637357,819,10,N,N,-,-1,-1
WESLEY.txt,636638,637402,764,10,N,N,-,-1,-1
WESLEY.txt,636650,637491,841,10,N,N,-,-1,-1
WESLEY.txt,636721,637551,830,10,N,N,-,-1,-1
WESLEY.txt,636812,637563,751,10,N,N,-,-1,-1
WESLEY.txt,636929,637652,723,10,N,N,-,-1,-1
WESLEY.txt,637013,637725,712,10,N,N,-,-1,-1
WESLEY.txt,637023,637833,810,10,N,N,-,-1,-1
WESLEY.txt,637101,637950,849,10,N,N,-,-1,-1
WESLEY.txt,637233,638043,810,10,N,N,-,-1,-1
WESLEY.txt,637358,638158,800,10,N,N,-,-1,-1
WESLEY.txt,637403,638292,889,10,N,N,-,-1,-1
WESLEY.txt,637492,638327,835,10,N,N,-,-1,-1
WESLEY.txt,637552,638476,924,10,N,N,-,-1,-1
WESLEY.txt,637563,638679,1116,10,N,N,-,-1,-1
WESLEY.txt,637653,638755,1102,10,N,N,-,-1,-1
WESLEY.txt,637726,638767,1041,10,N,N,-,-1,-1
WESLEY.txt,637834,638834,1000,10,N,N,-,-1,-1
WESLEY.txt,637951,638904,953,10,N,N,-,-1,-1
WESLEY.txt,638043,639085,1042,10,N,N,-,-1,-1
WESLEY.txt,638159,639097,938,10,N,N,-,-1,-1
WESLEY.txt,638293,639164,871,10,N,N,-,-1,-1
WESLEY.txt,638327,639251,924,10,N,N,-,-1,-1
WESLEY.txt,638477,639327,850,10,N,N,-,-1,-1
WESLEY.txt,638680,639391,711,10,N,N,-,-1,-1
WESLEY.txt,638756,639438,682,10,N,N,-,-1,-1
WESLEY.txt,638767,639474,707,10,N,N,-,-1,-1
WESLEY.txt,638835,639486,651,10,N,N,-,-1,-1
WESLEY.txt,638905,639527,622,10,N,N,-,-1,-1
WESLEY.txt,639086,639723,637,10,N,N,-,-1,-1
WESLEY.txt,639097,639824,727,10,N,N,-,-1,-1
WESLEY.txt,639165,639838,673,10,N,N,-,-1,-1
WESLEY.txt,639252,639896,644,10,N,N,-,-1,-1
WESLEY.txt,639328,640071,743,10,N,N,-,-1,-1
WESLEY.txt,639392,640083,691,10,N,N,-,-1,-1
WESLEY.txt,639439,640156,717,10,N,N,-,-1,-1
WESLEY.txt,639475,640219,744,10,N,N,-,-1,-1
WESLEY.txt,639486,640280,794,10,N,N,-,-1,-1
WESLEY.txt,639528,640412,884,10,N,N,-,-1,-1
WESLEY.txt,639724,640425,701,10,N,N,-,-1,-1
WESLEY.txt,639825,640470,645,10,N,N,-,-1,-1
WESLEY.txt,639838,640559,721,10,N,N,-,-1,-1
WESLEY.txt,639897,640623,726,10,N,N,-,-1,-1
WESLEY.txt,640072,640653,581,10,N,N,-,-1,-1
WESLEY.txt,640083,640710,627,10,N,N,-,-1,-1
WESLEY.txt,640157,640785,628,10,N,N,-,-1,-1
WESLEY.txt,640220,640860,640,10,N,N,-,-1,-1
WESLEY.txt,640281,640884,603,10,N,N,-,-1,-1
WESLEY.txt,640413,640990,577,10,N,N,-,-1,-1
WESLEY.txt,640426,641026,600,10,N,N,-,-1,-1
WESLEY.txt,640471,641209,738,10,N,N,-,-1,-1
WESLEY.txt,640559,641275,716,10,N,N,-,-1,-1
WESLEY.txt,640624,641420,796,10,N,N,-,-1,-1
WESLEY.txt,640654,641439,785,10,N,N,-,-1,-1
WESLEY.txt,640711,641648,937,10,N,N,-,-1,-1
WESLEY.txt,640786,641680,894,10,N,N,-,-1,-1
WESLEY.txt,640861,641737,876,10,N,N,-,-1,-1
WESLEY.txt,640884,641818,934,10,N,N,-,-1,-1
WESLEY.txt,640991,641898,907,10,N,N,-,-1,-1
WESLEY.txt,641027,641974,947,10,N,N,-,-1,-1
WESLEY.txt,641210,642036,826,10,N,N,-,-1,-1
WESLEY.txt,641276,642056,780,10,N,N,-,-1,-1
WESLEY.txt,641421,642158,737,10,N,N,-,-1,-1
WESLEY.txt,641439,642285,846,10,N,N,-,-1,-1
WESLEY.txt,641649,642320,671,10,N,N,-,-1,-1
WESLEY.txt,641680,642475,795,10,N,N,-,-1,-1
WESLEY.txt,641738,642595,857,10,N,N,-,-1,-1
WESLEY.txt,641819,642717,898,10,N,N,-,-1,-1
WESLEY.txt,641899,642761,862,10,N,N,-,-1,-1
WESLEY.txt,641975,642786,811,10,N,N,-,-1,-1
WESLEY.txt,642037,642846,809,10,N,N,-,-1,-1
WESLEY.txt,642057,642900,843,10,N,N,-,-1,-1
WESLEY.txt,642159,642984,825,10,N,N,-,-1,-1
WESLEY.txt,642286,643057,771,10,N,N,-,-1,-1
WESLEY.txt,642321,643148,827,10,N,N,-,-1,-1
WESLEY.txt,642476,643178,702,10,N,N,-,-1,-1
WESLEY.txt,642595,643349,754,10,N,N,-,-1,-1
WESLEY.txt,642718,643542,824,10,N,N,-,-1,-1
WESLEY.txt,642762,643630,868,10,N,N,-,-1,-1
WESLEY.txt,642787,643898,1111,10,N,N,-,-1,-1
WESLEY.txt,642847,644024,1177,10,N,N,-,-1,-1
WESLEY.txt,642900,644104,1204,10,N,N,-,-1,-1
WESLEY.txt,642985,644220,1235,10,N,N,-,-1,-1
WESLEY.txt,643058,644424,1366,10,N,N,-,-1,-1
WESLEY.txt,643149,644438,1289,10,N,N,-,-1,-1
WESLEY.txt,643178,644603,1425,10,N,N,-,-1,-1
WESLEY.txt,643350,644714,1364,10,N,N,-,-1,-1
WESLEY.txt,643543,644807,1264,10,N,N,-,-1,-1
WESLEY.txt,643631,644847,1216,10,N,N,-,-1,-1
WESLEY.txt,643899,644898,999,10,N,N,-,-1,-1
WESLEY.txt,644025,644932,907,10,N,N,-,-1,-1
WESLEY.txt,644105,644954,849,10,N,N,-,-1,-1
WESLEY.txt,644221,644983,762,10,N,N,-,-1,-1
WESLEY.txt,644425,645015,590,10,N,N,-,-1,-1
WESLEY.txt,644438,645100,662,10,N,N,-,-1,-1
WESLEY.txt,644604,645199,595,10,N,N,-,-1,-1
WESLEY.txt,644715,645249,534,10,N,N,-,-1,-1
WESLEY.txt,644808,645381,573,10,N,N,-,-1,-1
WESLEY.txt,644848,645469,621,10,N,N,-,-1,-1
WESLEY.txt,644899,645560,661,10,N,N,-,-1,-1
WESLEY.txt,644933,645587,654,10,N,N,-,-1,-1
WESLEY.txt,644955,645644,689,10,N,N,-,-1,-1
WESLEY.txt,644984,645690,706,10,N,N,-,-1,-1
WESLEY.txt,645016,645730,714,10,N,N,-,-1,-1
WESLEY.txt,645101,645812,711,10,N,N,-,-1,-1
WESLEY.txt,645200,645904,704,10,N,N,-,-1,-1
WESLEY.txt,645250,645923,673,10,N,N,-,-1,-1
WESLEY.txt,645382,646142,760,10,N,N,-,-1,-1
WESLEY.txt,645470,646150,680,10,N,N,-,-1,-1
WESLEY.txt,645561,646318,757,10,N,N,-,-1,-1
WESLEY.txt,645588,646512,924,10,N,N,-,-1,-1
WESLEY.txt,645645,646603,958,10,N,N,-,-1,-1
WESLEY.txt,645691,646621,930,10,N,N,-,-1,-1
WESLEY.txt,645731,646737,1006,10,N,N,-,-1,-1
WESLEY.txt,645813,646760,947,10,N,N,-,-1,-1
WESLEY.txt,645904,646807,903,10,N,N,-,-1,-1
WESLEY.txt,645924,646827,903,10,N,N,-,-1,-1
WESLEY.txt,646143,646871,728,10,N,N,-,-1,-1
WESLEY.txt,646151,646895,744,10,N,N,-,-1,-1
WESLEY.txt,646319,646945,626,10,N,N,-,-1,-1
WESLEY.txt,646513,646968,455,10,N,N,-,-1,-1
WESLEY.txt,646604,647014,410,10,N,N,-,-1,-1
WESLEY.txt,646621,647059,438,10,N,N,-,-1,-1
WESLEY.txt,646738,647148,410,10,N,N,-,-1,-1
WESLEY.txt,646761,647357,596,10,N,N,-,-1,-1
WESLEY.txt,646808,647373,565,10,N,N,-,-1,-1
WESLEY.txt,646828,647472,644,10,N,N,-,-1,-1
WESLEY.txt,646872,647578,706,10,N,N,-,-1,-1
WESLEY.txt,646896,647658,762,10,N,N,-,-1,-1
WESLEY.txt,646946,647670,724,10,N,N,-,-1,-1
WESLEY.txt,646969,647767,798,10,N,N,-,-1,-1
WESLEY.txt,647015,647832,817,10,N,N,-,-1,-1
WESLEY.txt,647060,648015,955,10,N,N,-,-1,-1
WESLEY.txt,647149,648204,1055,10,N,N,-,-1,-1
WESLEY.txt,647358,648305,947,10,N,N,-,-1,-1
WESLEY.txt,647373,648329,956,10,N,N,-,-1,-1
WESLEY.txt,647473,648532,1059,10,N,N,-,-1,-1
WESLEY.txt,647579,648703,1124,10,N,N,-,-1,-1
WESLEY.txt,647659,648782,1123,10,N,N,-,-1,-1
WESLEY.txt,647670,648851,1181,10,N,N,-,-1,-1
WESLEY.txt,647768,648865,1097,10,N,N,-,-1,-1
WESLEY.txt,647833,648914,1081,10,N,N,-,-1,-1
WESLEY.txt,648016,648947,931,10,N,N,-,-1,-1
WESLEY.txt,648205,649044,839,10,N,N,-,-1,-1
WESLEY.txt,648305,649129,824,10,N,N,-,-1,-1
WESLEY.txt,648330,649146,816,10,N,N,-,-1,-1
WESLEY.txt,648533,649241,708,10,N,N,-,-1,-1
WESLEY.txt,648704,649338,634,10,N,N,-,-1,-1
WESLEY.txt,648783,649423,640,10,N,N,-,-1,-1
WESLEY.txt,648852,649538,686,10,N,N,-,-1,-1
WESLEY.txt,648865,649647,782,10,N,N,-,-1,-1
WESLEY.txt,648915,649843,928,10,N,N,-,-1,-1
WESLEY.txt,648948,649855,907,10,N,N,-,-1,-1
WESLEY.txt,649045,649902,857,10,N,N,-,-1,-1
WESLEY.txt,649130,650017,887,10,N,N,-,-1,-1
WESLEY.txt,649147,650069,922,10,N,N,-,-1,-1
WESLEY.txt,649242,650122,880,10,N,N,-,-1,-1
WESLEY.txt,649339,650230,891,10,N,N,-,-1,-1
WESLEY.txt,649424,650427,1003,10,N,N,-,-1,-1
WESLEY.txt,649539,650460,921,10,N,N,-,-1,-1
WESLEY.txt,649648,650521,873,10,N,N,-,-1,-1
WESLEY.txt,649844,650655,811,10,N,N,-,-1,-1
WESLEY.txt,649855,650722,867,10,N,N,-,-1,-1
WESLEY.txt,649903,650770,867,10,N,N,-,-1,-1
WESLEY.txt,650018,650821,803,10,N,N,-,-1,-1
WESLEY.txt,650070,650934,864,10,N,N,-,-1,-1
WESLEY.txt,650123,651107,984,10,N,N,-,-1,-1
WESLEY.txt,650231,651120,889,10,N,N,-,-1,-1
WESLEY.txt,650428,651218,790,10,N,N,-,-1,-1
WESLEY.txt,650461,651304,843,10,N,N,-,-1,-1
WESLEY.txt,650522,651421,899,10,N,N,-,-1,-1
WESLEY.txt,650655,651505,850,10,N,N,-,-1,-1
WESLEY.txt,650723,651619,896,10,N,N,-,-1,-1
WESLEY.txt,650771,651712,941,10,N,N,-,-1,-1
WESLEY.txt,650822,651789,967,10,N,N,-,-1,-1
WESLEY.txt,650935,651810,875,10,N,N,-,-1,-1
WESLEY.txt,651108,651978,870,10,N,N,-,-1,-1
WESLEY.txt,651120,652055,935,10,N,N,-,-1,-1
WESLEY.txt,651219,652226,1007,10,N,N,-,-1,-1
WESLEY.txt,651305,652322,1017,10,N,N,-,-1,-1
WESLEY.txt,651422,652441,1019,10,N,N,-,-1,-1
WESLEY.txt,651506,652728,1222,10,N,N,-,-1,-1
WESLEY.txt,651620,652923,1303,10,N,N,-,-1,-1
WESLEY.txt,651713,652929,1216,10,N,N,-,-1,-1
WESLEY.txt,651790,652948,1158,10,N,N,-,-1,-1
WESLEY.txt,651810,653021,1211,10,N,N,-,-1,-1
WESLEY.txt,651979,653117,1138,10,N,N,-,-1,-1
WESLEY.txt,652056,653129,1073,10,N,N,-,-1,-1
WESLEY.txt,652227,653144,917,10,N,N,-,-1,-1
WESLEY.txt,652323,653242,919,10,N,N,-,-1,-1
WESLEY.txt,652441,653385,944,10,N,N,-,-1,-1
WESLEY.txt,652729,653470,741,10,N,N,-,-1,-1
WESLEY.txt,652924,653931,1007,10,N,N,-,-1,-1
WESLEY.txt,652930,654010,1080,10,N,N,-,-1,-1
WESLEY.txt,652948,654169,1221,10,N,N,-,-1,-1
WESLEY.txt,653022,654255,1233,10,N,N,-,-1,-1
WESLEY.txt,653118,654295,1177,10,N,N,-,-1,-1
WESLEY.txt,653130,654449,1319,10,N,N,-,-1,-1
WESLEY.txt,653144,654477,1333,10,N,N,-,-1,-1
WESLEY.txt,653243,654527,1284,10,N,N,-,-1,-1
WESLEY.txt,653386,654558,1172,10,N,N,-,-1,-1
WESLEY.txt,653471,654606,1135,10,N,N,-,-1,-1
WESLEY.txt,653932,654701,769,10,N,N,-,-1,-1
WESLEY.txt,654011,654705,694,10,N,N,-,-1,-1
WESLEY.txt,654170,654755,585,10,N,N,-,-1,-1
WESLEY.txt,654256,654803,547,10,N,N,-,-1,-1
WESLEY.txt,654296,654916,620,10,N,N,-,-1,-1
WESLEY.txt,654450,655015,565,10,N,N,-,-1,-1
WESLEY.txt,654478,655093,615,10,N,N,-,-1,-1
WESLEY.txt,654528,655282,754,10,N,N,-,-1,-1
WESLEY.txt,654559,655379,820,10,N,N,-,-1,-1
WESLEY.txt,654607,655561,954,10,N,N,-,-1,-1
WESLEY.txt,654702,655644,942,10,N,N,-,-1,-1
WESLEY.txt,654706,655730,1024,10,N,N,-,-1,-1
WESLEY.txt,654756,655814,1058,10,N,N,-,-1,-1
WESLEY.txt,654804,655898,1094,10,N,N,-,-1,-1
WESLEY.txt,654917,656061,1144,10,N,N,-,-1,-1
WESLEY.txt,655016,656092,1076,10,N,N,-,-1,-1
WESLEY.txt,655094,656153,1059,10,N,N,-,-1,-1
WESLEY.txt,655283,656242,959,10,N,N,-,-1,-1
WESLEY.txt,655380,656418,1038,10,N,N,-,-1,-1
WESLEY.txt,655562,656435,873,10,N,N,-,-1,-1
WESLEY.txt,655645,656499,854,10,N,N,-,-1,-1
WESLEY.txt,655731,656510,779,10,N,N,-,-1,-1
WESLEY.txt,655814,656579,765,10,N,N,-,-1,-1
WESLEY.txt,655899,656688,789,10,N,N,-,-1,-1
WESLEY.txt,656062,656744,682,10,N,N,-,-1,-1
WESLEY.txt,656093,656795,702,10,N,N,-,-1,-1
WESLEY.txt,656154,656892,738,10,N,N,-,-1,-1
WESLEY.txt,656243,656970,727,10,N,N,-,-1,-1
WESLEY.txt,656419,657079,660,10,N,N,-,-1,-1
WESLEY.txt,656435,657170,735,10,N,N,-,-1,-1
WESLEY.txt,656500,657370,870,10,N,N,-,-1,-1
WESLEY.txt,656511,657470,959,10,N,N,-,-1,-1
WESLEY.txt,656580,657574,994,10,N,N,-,-1,-1
WESLEY.txt,656689,657661,972,10,N,N,-,-1,-1
WESLEY.txt,656745,657910,1165,10,N,N,-,-1,-1
WESLEY.txt,656796,657990,1194,10,N,N,-,-1,-1
WESLEY.txt,656893,658069,1176,10,N,N,-,-1,-1
WESLEY.txt,656971,658123,1152,10,N,N,-,-1,-1
WESLEY.txt,657079,658155,1076,10,N,N,-,-1,-1
WESLEY.txt,657171,658176,1005,10,N,N,-,-1,-1
WESLEY.txt,657371,658265,894,10,N,N,-,-1,-1
WESLEY.txt,657471,658344,873,10,N,N,-,-1,-1
WESLEY.txt,657575,658504,929,10,N,N,-,-1,-1
WESLEY.txt,657662,658586,924,10,N,N,-,-1,-1
WESLEY.txt,657911,658673,762,10,N,N,-,-1,-1
WESLEY.txt,657991,658777,786,10,N,N,-,-1,-1
WESLEY.txt,658070,658882,812,10,N,N,-,-1,-1
WESLEY.txt,658124,658947,823,10,N,N,-,-1,-1
WESLEY.txt,658156,659074,918,10,N,N,-,-1,-1
WESLEY.txt,658176,659261,1085,10,N,N,-,-1,-1
WESLEY.txt,658266,659273,1007,10,N,N,-,-1,-1
WESLEY.txt,658345,659355,1010,10,N,N,-,-1,-1
WESLEY.txt,658505,659451,946,10,N,N,-,-1,-1
WESLEY.txt,658587,659604,1017,10,N,N,-,-1,-1
WESLEY.txt,658674,659713,1039,10,N,N,-,-1,-1
WESLEY.txt,658778,659804,1026,10,N,N,-,-1,-1
WESLEY.txt,658883,659886,1003,10,N,N,-,-1,-1
WESLEY.txt,658948,659983,1035,10,N,N,-,-1,-1
WESLEY.txt,659075,660014,939,10,N,N,-,-1,-1
WESLEY.txt,659262,660187,925,10,N,N,-,-1,-1
WESLEY.txt,659273,660267,994,10,N,N,-,-1,-1
WESLEY.txt,659356,660389,1033,10,N,N,-,-1,-1
WESLEY.txt,659452,660481,1029,10,N,N,-,-1,-1
WESLEY.txt,659605,660531,926,10,N,N,-,-1,-1
WESLEY.txt,659714,660649,935,10,N,N,-,-1,-1
WESLEY.txt,659805,660735,930,10,N,N,-,-1,-1
WESLEY.txt,659887,660771,884,10,N,N,-,-1,-1
WESLEY.txt,659983,660836,853,10,N,N,-,-1,-1
WESLEY.txt,660015,660851,836,10,N,N,-,-1,-1
WESLEY.txt,660188,660956,768,10,N,N,-,-1,-1
WESLEY.txt,660268,661060,792,10,N,N,-,-1,-1
WESLEY.txt,660390,661092,702,10,N,N,-,-1,-1
WESLEY.txt,660482,661159,677,10,N,N,-,-1,-1
WESLEY.txt,660532,661210,678,10,N,N,-,-1,-1
WESLEY.txt,660650,661324,674,10,N,N,-,-1,-1
WESLEY.txt,660736,661396,660,10,N,N,-,-1,-1
WESLEY.txt,660772,661494,722,10,N,N,-,-1,-1
WESLEY.txt,660837,661602,765,10,N,N,-,-1,-1
WESLEY.txt,660851,661614,763,10,N,N,-,-1,-1
WESLEY.txt,660957,661664,707,10,N,N,-,-1,-1
WESLEY.txt,661061,661709,648,10,N,N,-,-1,-1
WESLEY.txt,661093,661755,662,10,N,N,-,-1,-1
WESLEY.txt,661160,661786,626,10,N,N,-,-1,-1
WESLEY.txt,661211,661882,671,10,N,N,-,-1,-1
WESLEY.txt,661325,661987,662,10,N,N,-,-1,-1
WESLEY.txt,661397,662041,644,10,N,N,-,-1,-1
WESLEY.txt,661495,662077,582,10,N,N,-,-1,-1
WESLEY.txt,661603,662188,585,10,N,N,-,-1,-1
WESLEY.txt,661614,662273,659,10,N,N,-,-1,-1
WESLEY.txt,661665,662347,682,10,N,N,-,-1,-1
WESLEY.txt,661710,662433,723,10,N,N,-,-1,-1
WESLEY.txt,661756,662536,780,10,N,N,-,-1,-1
WESLEY.txt,661787,662548,761,10,N,N,-,-1,-1
WESLEY.txt,661883,662626,743,10,N,N,-,-1,-1
WESLEY.txt,661988,662771,783,10,N,N,-,-1,-1
WESLEY.txt,662042,662804,762,10,N,N,-,-1,-1
WESLEY.txt,662078,662968,890,10,N,N,-,-1,-1
WESLEY.txt,662189,663134,945,10,N,N,-,-1,-1
WESLEY.txt,662274,663225,951,10,N,N,-,-1,-1
WESLEY.txt,662348,663327,979,10,N,N,-,-1,-1
WESLEY.txt,662434,663513,1079,10,N,N,-,-1,-1
WESLEY.txt,662537,663608,1071,10,N,N,-,-1,-1
WESLEY.txt,662548,663725,1177,10,N,N,-,-1,-1
WESLEY.txt,662627,663737,1110,10,N,N,-,-1,-1
WESLEY.txt,662772,663820,1048,10,N,N,-,-1,-1
WESLEY.txt,662805,664020,1215,10,N,N,-,-1,-1
WESLEY.txt,662969,664108,1139,10,N,N,-,-1,-1
WESLEY.txt,663135,664196,1061,10,N,N,-,-1,-1
WESLEY.txt,663226,664221,995,10,N,N,-,-1,-1
WESLEY.txt,663328,664250,922,10,N,N,-,-1,-1
WESLEY.txt,663514,664292,778,10,N,N,-,-1,-1
WESLEY.txt,663609,664428,819,10,N,N,-,-1,-1
WESLEY.txt,663726,664513,787,10,N,N,-,-1,-1
WESLEY.txt,663737,664748,1011,10,N,N,-,-1,-1
WESLEY.txt,663821,664783,962,10,N,N,-,-1,-1
WESLEY.txt,664021,665002,981,10,N,N,-,-1,-1
WESLEY.txt,664109,665014,905,10,N,N,-,-1,-1
WESLEY.txt,664197,665047,850,10,N,N,-,-1,-1
WESLEY.txt,664222,665202,980,10,N,N,-,-1,-1
WESLEY.txt,664251,665216,965,10,N,N,-,-1,-1
WESLEY.txt,664292,665303,1011,10,N,N,-,-1,-1
WESLEY.txt,664429,665338,909,10,N,N,-,-1,-1
WESLEY.txt,664514,665376,862,10,N,N,-,-1,-1
WESLEY.txt,664749,665471,722,10,N,N,-,-1,-1
WESLEY.txt,664784,665560,776,10,N,N,-,-1,-1
WESLEY.txt,665003,665659,656,10,N,N,-,-1,-1
WESLEY.txt,665014,665746,732,10,N,N,-,-1,-1
WESLEY.txt,665048,665809,761,10,N,N,-,-1,-1
WESLEY.txt,665203,665836,633,10,N,N,-,-1,-1
WESLEY.txt,665216,665932,716,10,N,N,-,-1,-1
WESLEY.txt,665304,666047,743,10,N,N,-,-1,-1
WESLEY.txt,665339,666152,813,10,N,N,-,-1,-1
WESLEY.txt,665377,666175,798,10,N,N,-,-1,-1
WESLEY.txt,665472,666273,801,10,N,N,-,-1,-1
WESLEY.txt,665561,666324,763,10,N,N,-,-1,-1
WESLEY.txt,665660,666380,720,10,N,N,-,-1,-1
WESLEY.txt,665747,666496,749,10,N,N,-,-1,-1
WESLEY.txt,665810,666604,794,10,N,N,-,-1,-1
WESLEY.txt,665837,666698,861,10,N,N,-,-1,-1
WESLEY.txt,665933,666711,778,10,N,N,-,-1,-1
WESLEY.txt,666048,666842,794,10,N,N,-,-1,-1
WESLEY.txt,666153,666870,717,10,N,N,-,-1,-1
WESLEY.txt,666176,666930,754,10,N,N,-,-1,-1
WESLEY.txt,666273,667038,765,10,N,N,-,-1,-1
WESLEY.txt,666325,667140,815,10,N,N,-,-1,-1
WESLEY.txt,666381,667185,804,10,N,N,-,-1,-1
WESLEY.txt,666497,667325,828,10,N,N,-,-1,-1
WESLEY.txt,666605,667346,741,10,N,N,-,-1,-1
WESLEY.txt,666699,667370,671,10,N,N,-,-1,-1
WESLEY.txt,666711,667596,885,10,N,N,-,-1,-1
WESLEY.txt,666843,667609,766,10,N,N,-,-1,-1
WESLEY.txt,666871,667657,786,10,N,N,-,-1,-1
WESLEY.txt,666931,667925,994,10,N,N,-,-1,-1
WESLEY.txt,667039,667988,949,10,N,N,-,-1,-1
WESLEY.txt,667141,668040,899,10,N,N,-,-1,-1
WESLEY.txt,667186,668221,1035,10,N,N,-,-1,-1
WESLEY.txt,667326,668258,932,10,N,N,-,-1,-1
WESLEY.txt,667346,668302,956,10,N,N,-,-1,-1
WESLEY.txt,667371,668404,1033,10,N,N,-,-1,-1
WESLEY.txt,667597,668527,930,10,N,N,-,-1,-1
WESLEY.txt,667609,668640,1031,10,N,N,-,-1,-1
WESLEY.txt,667658,668826,1168,10,N,N,-,-1,-1
WESLEY.txt,667926,668917,991,10,N,N,-,-1,-1
WESLEY.txt,667989,668940,951,10,N,N,-,-1,-1
WESLEY.txt,668041,669002,961,10,N,N,-,-1,-1
WESLEY.txt,668222,669288,1066,10,N,N,-,-1,-1
WESLEY.txt,668259,669387,1128,10,N,N,-,-1,-1
WESLEY.txt,668303,669426,1123,10,N,N,-,-1,-1
WESLEY.txt,668404,669575,1171,10,N,N,-,-1,-1
WESLEY.txt,668528,669675,1147,10,N,N,-,-1,-1
WESLEY.txt,668641,669750,1109,10,N,N,-,-1,-1
WESLEY.txt,668827,669858,1031,10,N,N,-,-1,-1
WESLEY.txt,668918,669949,1031,10,N,N,-,-1,-1
WESLEY.txt,668940,670031,1091,10,N,N,-,-1,-1
WESLEY.txt,669003,670073,1070,10,N,N,-,-1,-1
WESLEY.txt,669289,670187,898,10,N,N,-,-1,-1
WESLEY.txt,669388,670258,870,10,N,N,-,-1,-1
WESLEY.txt,669427,670357,930,10,N,N,-,-1,-1
WESLEY.txt,669576,670368,792,10,N,N,-,-1,-1
WESLEY.txt,669675,670437,762,10,N,N,-,-1,-1
WESLEY.txt,669751,670632,881,10,N,N,-,-1,-1
WESLEY.txt,669859,670654,795,10,N,N,-,-1,-1
WESLEY.txt,669950,670737,787,10,N,N,-,-1,-1
WESLEY.txt,670032,670842,810,10,N,N,-,-1,-1
WESLEY.txt,670074,670926,852,10,N,N,-,-1,-1
WESLEY.txt,670188,671039,851,10,N,N,-,-1,-1
WESLEY.txt,670259,671125,866,10,N,N,-,-1,-1
WESLEY.txt,670358,671193,835,10,N,N,-,-1,-1
WESLEY.txt,670368,671304,936,10,N,N,-,-1,-1
WESLEY.txt,670438,671345,907,10,N,N,-,-1,-1
WESLEY.txt,670633,671474,841,10,N,N,-,-1,-1
WESLEY.txt,670654,671561,907,10,N,N,-,-1,-1
WESLEY.txt,670738,671592,854,10,N,N,-,-1,-1
WESLEY.txt,670843,671742,899,10,N,N,-,-1,-1
WESLEY.txt,670927,671834,907,10,N,N,-,-1,-1
WESLEY.txt,671040,671896,856,10,N,N,-,-1,-1
WESLEY.txt,671125,672015,890,10,N,N,-,-1,-1
WESLEY.txt,671194,672191,997,10,N,N,-,-1,-1
WESLEY.txt,671305,672317,1012,10,N,N,-,-1,-1
WESLEY.txt,671346,672390,1044,10,N,N,-,-1,-1
WESLEY.txt,671475,672568,1093,10,N,N,-,-1,-1
WESLEY.txt,671562,672741,1179,10,N,N,-,-1,-1
WESLEY.txt,671593,672875,1282,10,N,N,-,-1,-1
WESLEY.txt,671743,673099,1356,10,N,N,-,-1,-1
WESLEY.txt,671835,673272,1437,10,N,N,-,-1,-1
WESLEY.txt,671897,673284,1387,10,N,N,-,-1,-1
WESLEY.txt,672015,673486,1471,10,N,N,-,-1,-1
WESLEY.txt,672192,673578,1386,10,N,N,-,-1,-1
WESLEY.txt,672318,673675,1357,10,N,N,-,-1,-1
WESLEY.txt,672391,673695,1304,10,N,N,-,-1,-1
WESLEY.txt,672569,673731,1162,10,N,N,-,-1,-1
WESLEY.txt,672742,673842,1100,10,N,N,-,-1,-1
WESLEY.txt,672876,673854,978,10,N,N,-,-1,-1
WESLEY.txt,673100,673881,781,10,N,N,-,-1,-1
WESLEY.txt,673273,673895,622,10,N,N,-,-1,-1
WESLEY.txt,673284,673988,704,10,N,N,-,-1,-1
WESLEY.txt,673487,674131,644,10,N,N,-,-1,-1
WESLEY.txt,673579,674215,636,10,N,N,-,-1,-1
WESLEY.txt,673676,674305,629,10,N,N,-,-1,-1
WESLEY.txt,673695,674316,621,10,N,N,-,-1,-1
WESLEY.txt,673732,674380,648,10,N,N,-,-1,-1
WESLEY.txt,673843,674481,638,10,N,N,-,-1,-1
WESLEY.txt,673854,674496,642,10,N,N,-,-1,-1
WESLEY.txt,673882,674531,649,10,N,N,-,-1,-1
WESLEY.txt,673895,674579,684,10,N,N,-,-1,-1
WESLEY.txt,673989,674700,711,10,N,N,-,-1,-1
WESLEY.txt,674132,674804,672,10,N,N,-,-1,-1
WESLEY.txt,674216,674905,689,10,N,N,-,-1,-1
WESLEY.txt,674306,674927,621,10,N,N,-,-1,-1
WESLEY.txt,674316,675013,697,10,N,N,-,-1,-1
WESLEY.txt,674381,675106,725,10,N,N,-,-1,-1
WESLEY.txt,674482,675121,639,10,N,N,-,-1,-1
WESLEY.txt,674496,675231,735,10,N,N,-,-1,-1
WESLEY.txt,674532,675346,814,10,N,N,-,-1,-1
WESLEY.txt,674580,675358,778,10,N,N,-,-1,-1
WESLEY.txt,674701,675562,861,10,N,N,-,-1,-1
WESLEY.txt,674805,675581,776,10,N,N,-,-1,-1
WESLEY.txt,674906,675653,747,10,N,N,-,-1,-1
WESLEY.txt,674927,675739,812,10,N,N,-,-1,-1
WESLEY.txt,675014,675821,807,10,N,N,-,-1,-1
WESLEY.txt,675107,675908,801,10,N,N,-,-1,-1
WESLEY.txt,675121,675998,877,10,N,N,-,-1,-1
WESLEY.txt,675232,676010,778,10,N,N,-,-1,-1
WESLEY.txt,675347,676089,742,10,N,N,-,-1,-1
WESLEY.txt,675358,676261,903,10,N,N,-,-1,-1
WESLEY.txt,675563,676426,863,10,N,N,-,-1,-1
WESLEY.txt,675581,676504,923,10,N,N,-,-1,-1
WESLEY.txt,675654,676516,862,10,N,N,-,-1,-1
WESLEY.txt,675740,676627,887,10,N,N,-,-1,-1
WESLEY.txt,675822,676748,926,10,N,N,-,-1,-1
WESLEY.txt,675909,676802,893,10,N,N,-,-1,-1
WESLEY.txt,675999,676885,886,10,N,N,-,-1,-1
WESLEY.txt,676010,676966,956,10,N,N,-,-1,-1
WESLEY.txt,676090,677073,983,10,N,N,-,-1,-1
WESLEY.txt,676262,677224,962,10,N,N,-,-1,-1
WESLEY.txt,676427,677327,900,10,N,N,-,-1,-1
WESLEY.txt,676505,677438,933,10,N,N,-,-1,-1
WESLEY.txt,676517,677545,1028,10,N,N,-,-1,-1
WESLEY.txt,676628,677605,977,10,N,N,-,-1,-1
WESLEY.txt,676748,677651,903,10,N,N,-,-1,-1
WESLEY.txt,676803,677735,932,10,N,N,-,-1,-1
WESLEY.txt,676886,677817,931,10,N,N,-,-1,-1
WESLEY.txt,676967,677939,972,10,N,N,-,-1,-1
WESLEY.txt,677074,678041,967,10,N,N,-,-1,-1
WESLEY.txt,677225,678137,912,10,N,N,-,-1,-1
WESLEY.txt,677328,678221,893,10,N,N,-,-1,-1
WESLEY.txt,677439,678437,998,10,N,N,-,-1,-1
WESLEY.txt,677546,678516,970,10,N,N,-,-1,-1
WESLEY.txt,677606,678526,920,10,N,N,-,-1,-1
WESLEY.txt,677652,678543,891,10,N,N,-,-1,-1
WESLEY.txt,677736,678595,859,10,N,N,-,-1,-1
WESLEY.txt,677818,678626,808,10,N,N,-,-1,-1
WESLEY.txt,677940,678684,744,10,N,N,-,-1,-1
WESLEY.txt,678042,678712,670,10,N,N,-,-1,-1
WESLEY.txt,678138,678836,698,10,N,N,-,-1,-1
WESLEY.txt,678222,678861,639,10,N,N,-,-1,-1
WESLEY.txt,678438,678875,437,10,N,N,-,-1,-1
WESLEY.txt,678517,678929,412,10,N,N,-,-1,-1
WESLEY.txt,678527,678979,452,10,N,N,-,-1,-1
WESLEY.txt,678543,679253,710,10,N,N,-,-1,-1
WESLEY.txt,678596,679281,685,10,N,N,-,-1,-1
WESLEY.txt,678627,679345,718,10,N,N,-,-1,-1
WESLEY.txt,678685,679358,673,10,N,N,-,-1,-1
WESLEY.txt,678713,679376,663,10,N,N,-,-1,-1
WESLEY.txt,678836,679589,753,10,N,N,-,-1,-1
WESLEY.txt,678862,679700,838,10,N,N,-,-1,-1
WESLEY.txt,678876,679772,896,10,N,N,-,-1,-1
WESLEY.txt,678930,679787,857,10,N,N,-,-1,-1
WESLEY.txt,678980,679813,833,10,N,N,-,-1,-1
WESLEY.txt,679254,679883,629,10,N,N,-,-1,-1
WESLEY.txt,679282,679932,650,10,N,N,-,-1,-1
WESLEY.txt,679346,679978,632,10,N,N,-,-1,-1
WESLEY.txt,679359,679993,634,10,N,N,-,-1,-1
WESLEY.txt,679377,680169,792,10,N,N,-,-1,-1
WESLEY.txt,679590,680248,658,10,N,N,-,-1,-1
WESLEY.txt,679701,680332,631,10,N,N,-,-1,-1
WESLEY.txt,679773,680501,728,10,N,N,-,-1,-1
WESLEY.txt,679787,680522,735,10,N,N,-,-1,-1
WESLEY.txt,679814,680613,799,10,N,N,-,-1,-1
WESLEY.txt,679884,680690,806,10,N,N,-,-1,-1
WESLEY.txt,679933,680783,850,10,N,N,-,-1,-1
WESLEY.txt,679979,680830,851,10,N,N,-,-1,-1
WESLEY.txt,679993,680955,962,10,N,N,-,-1,-1
WESLEY.txt,680170,681159,989,10,N,N,-,-1,-1
WESLEY.txt,680249,681285,1036,10,N,N,-,-1,-1
WESLEY.txt,680333,681446,1113,10,N,N,-,-1,-1
WESLEY.txt,680502,681547,1045,10,N,N,-,-1,-1
WESLEY.txt,680522,681635,1113,10,N,N,-,-1,-1
WESLEY.txt,680614,681728,1114,10,N,N,-,-1,-1
WESLEY.txt,680691,681916,1225,10,N,N,-,-1,-1
WESLEY.txt,680784,682001,1217,10,N,N,-,-1,-1
WESLEY.txt,680831,682172,1341,10,N,N,-,-1,-1
WESLEY.txt,680956,682271,1315,10,N,N,-,-1,-1
WESLEY.txt,681160,682452,1292,10,N,N,-,-1,-1
WESLEY.txt,681286,682526,1240,10,N,N,-,-1,-1
WESLEY.txt,681447,682728,1281,10,N,N,-,-1,-1
WESLEY.txt,681547,682909,1362,10,N,N,-,-1,-1
WESLEY.txt,681636,682930,1294,10,N,N,-,-1,-1
WESLEY.txt,681729,683008,1279,10,N,N,-,-1,-1
WESLEY.txt,681917,683021,1104,10,N,N,-,-1,-1
WESLEY.txt,682002,683049,1047,10,N,N,-,-1,-1
WESLEY.txt,682173,683113,940,10,N,N,-,-1,-1
WESLEY.txt,682272,683211,939,10,N,N,-,-1,-1
WESLEY.txt,682453,683289,836,10,N,N,-,-1,-1
WESLEY.txt,682527,683441,914,10,N,N,-,-1,-1
WESLEY.txt,682729,683532,803,10,N,N,-,-1,-1
WESLEY.txt,682910,683642,732,10,N,N,-,-1,-1
WESLEY.txt,682930,683747,817,10,N,N,-,-1,-1
WESLEY.txt,683009,683761,752,10,N,N,-,-1,-1
WESLEY.txt,683022,683832,810,10,N,N,-,-1,-1
WESLEY.txt,683050,683924,874,10,N,N,-,-1,-1
WESLEY.txt,683114,683938,824,10,N,N,-,-1,-1
WESLEY.txt,683212,684020,808,10,N,N,-,-1,-1
WESLEY.txt,683290,684173,883,10,N,N,-,-1,-1
WESLEY.txt,683442,684345,903,10,N,N,-,-1,-1
WESLEY.txt,683533,684360,827,10,N,N,-,-1,-1
WESLEY.txt,683643,684431,788,10,N,N,-,-1,-1
WESLEY.txt,683748,684551,803,10,N,N,-,-1,-1
WESLEY.txt,683762,684637,875,10,N,N,-,-1,-1
WESLEY.txt,683833,684699,866,10,N,N,-,-1,-1
WESLEY.txt,683925,684753,828,10,N,N,-,-1,-1
WESLEY.txt,683938,684909,971,10,N,N,-,-1,-1
WESLEY.txt,684021,684915,894,10,N,N,-,-1,-1
WESLEY.txt,684174,684937,763,10,N,N,-,-1,-1
WESLEY.txt,684346,685014,668,10,N,N,-,-1,-1
WESLEY.txt,684361,685089,728,10,N,N,-,-1,-1
WESLEY.txt,684432,685170,738,10,N,N,-,-1,-1
WESLEY.txt,684552,685251,699,10,N,N,-,-1,-1
WESLEY.txt,684638,685367,729,10,N,N,-,-1,-1
WESLEY.txt,684699,685429,730,10,N,N,-,-1,-1
WESLEY.txt,684754,685451,697,10,N,N,-,-1,-1
WESLEY.txt,684910,685574,664,10,N,N,-,-1,-1
WESLEY.txt,684915,685611,696,10,N,N,-,-1,-1
WESLEY.txt,684937,685688,751,10,N,N,-,-1,-1
WESLEY.txt,685015,685806,791,10,N,N,-,-1,-1
WESLEY.txt,685090,685923,833,10,N,N,-,-1,-1
WESLEY.txt,685171,685975,804,10,N,N,-,-1,-1
WESLEY.txt,685252,685995,743,10,N,N,-,-1,-1
WESLEY.txt,685368,686071,703,10,N,N,-,-1,-1
WESLEY.txt,685429,686172,743,10,N,N,-,-1,-1
WESLEY.txt,685452,686339,887,10,N,N,-,-1,-1
WESLEY.txt,685575,686459,884,10,N,N,-,-1,-1
WESLEY.txt,685612,686613,1001,10,N,N,-,-1,-1
WESLEY.txt,685689,686749,1060,10,N,N,-,-1,-1
WESLEY.txt,685807,686897,1090,10,N,N,-,-1,-1
WESLEY.txt,685924,686989,1065,10,N,N,-,-1,-1
WESLEY.txt,685976,687066,1090,10,N,N,-,-1,-1
WESLEY.txt,685995,687157,1162,10,N,N,-,-1,-1
WESLEY.txt,686072,687250,1178,10,N,N,-,-1,-1
WESLEY.txt,686173,687263,1090,10,N,N,-,-1,-1
WESLEY.txt,686340,687277,937,10,N,N,-,-1,-1
WESLEY.txt,686460,687330,870,10,N,N,-,-1,-1
WESLEY.txt,686614,687347,733,10,N,N,-,-1,-1
WESLEY.txt,686750,687404,654,10,N,N,-,-1,-1
WESLEY.txt,686898,687454,556,10,N,N,-,-1,-1
WESLEY.txt,686990,687570,580,10,N,N,-,-1,-1
WESLEY.txt,687067,687677,610,10,N,N,-,-1,-1
WESLEY.txt,687157,687692,535,10,N,N,-,-1,-1
WESLEY.txt,687251,687841,590,10,N,N,-,-1,-1
WESLEY.txt,687264,688033,769,10,N,N,-,-1,-1
WESLEY.txt,687278,688045,767,10,N,N,-,-1,-1
WESLEY.txt,687331,688182,851,10,N,N,-,-1,-1
WESLEY.txt,687348,688254,906,10,N,N,-,-1,-1
WESLEY.txt,687405,688266,861,10,N,N,-,-1,-1
WESLEY.txt,687455,688350,895,10,N,N,-,-1,-1
WESLEY.txt,687571,688414,843,10,N,N,-,-1,-1
WESLEY.txt,687678,688496,818,10,N,N,-,-1,-1
WESLEY.txt,687692,688686,994,10,N,N,-,-1,-1
WESLEY.txt,687842,688779,937,10,N,N,-,-1,-1
WESLEY.txt,688034,688882,848,10,N,N,-,-1,-1
WESLEY.txt,688045,688998,953,10,N,N,-,-1,-1
WESLEY.txt,688183,689028,845,10,N,N,-,-1,-1
WESLEY.txt,688255,689045,790,10,N,N,-,-1,-1
WESLEY.txt,688266,689082,816,10,N,N,-,-1,-1
WESLEY.txt,688351,689182,831,10,N,N,-,-1,-1
WESLEY.txt,688415,689264,849,10,N,N,-,-1,-1
WESLEY.txt,688497,689285,788,10,N,N,-,-1,-1
WESLEY.txt,688687,689332,645,10,N,N,-,-1,-1
WESLEY.txt,688780,689381,601,10,N,N,-,-1,-1
WESLEY.txt,688883,689492,609,10,N,N,-,-1,-1
WESLEY.txt,688999,689661,662,10,N,N,-,-1,-1
WESLEY.txt,689029,689740,711,10,N,N,-,-1,-1
WESLEY.txt,689046,689770,724,10,N,N,-,-1,-1
WESLEY.txt,689083,689807,724,10,N,N,-,-1,-1
WESLEY.txt,689183,689810,627,10,N,N,-,-1,-1
WESLEY.txt,689265,689833,568,10,N,N,-,-1,-1
WESLEY.txt,689286,689929,643,10,N,N,-,-1,-1
WESLEY.txt,689333,690100,767,10,N,N,-,-1,-1
WESLEY.txt,689382,690206,824,10,N,N,-,-1,-1
WESLEY.txt,689492,690219,727,10,N,N,-,-1,-1
WESLEY.txt,689662,690244,582,10,N,N,-,-1,-1
WESLEY.txt,689741,690288,547,10,N,N,-,-1,-1
WESLEY.txt,689770,690379,609,10,N,N,-,-1,-1
WESLEY.txt,689808,690500,692,10,N,N,-,-1,-1
WESLEY.txt,689811,690687,876,10,N,N,-,-1,-1
WESLEY.txt,689834,690764,930,10,N,N,-,-1,-1
WESLEY.txt,689930,690779,849,10,N,N,-,-1,-1
WESLEY.txt,690101,690860,759,10,N,N,-,-1,-1
WESLEY.txt,690207,691026,819,10,N,N,-,-1,-1
WESLEY.txt,690219,691118,899,10,N,N,-,-1,-1
WESLEY.txt,690245,691294,1049,10,N,N,-,-1,-1
WESLEY.txt,690289,691325,1036,10,N,N,-,-1,-1
WESLEY.txt,690380,691392,1012,10,N,N,-,-1,-1
WESLEY.txt,690501,691406,905,10,N,N,-,-1,-1
WESLEY.txt,690688,691474,786,10,N,N,-,-1,-1
WESLEY.txt,690765,691488,723,10,N,N,-,-1,-1
WESLEY.txt,690779,691511,732,10,N,N,-,-1,-1
WESLEY.txt,690861,691597,736,10,N,N,-,-1,-1
WESLEY.txt,691027,691744,717,10,N,N,-,-1,-1
WESLEY.txt,691119,691816,697,10,N,N,-,-1,-1
WESLEY.txt,691295,691894,599,10,N,N,-,-1,-1
WESLEY.txt,691326,691988,662,10,N,N,-,-1,-1
WESLEY.txt,691393,692073,680,10,N,N,-,-1,-1
WESLEY.txt,691406,692182,776,10,N,N,-,-1,-1
WESLEY.txt,691475,692252,777,10,N,N,-,-1,-1
WESLEY.txt,691488,692330,842,10,N,N,-,-1,-1
WESLEY.txt,691512,692500,988,10,N,N,-,-1,-1
WESLEY.txt,691598,692601,1003,10,N,N,-,-1,-1
WESLEY.txt,691745,692717,972,10,N,N,-,-1,-1
WESLEY.txt,691817,692730,913,10,N,N,-,-1,-1
WESLEY.txt,691895,692808,913,10,N,N,-,-1,-1
WESLEY.txt,691989,692886,897,10,N,N,-,-1,-1
WESLEY.txt,692074,692972,898,10,N,N,-,-1,-1
WESLEY.txt,692182,693073,891,10,N,N,-,-1,-1
WESLEY.txt,692253,693192,939,10,N,N,-,-1,-1
WESLEY.txt,692331,693207,876,10,N,N,-,-1,-1
WESLEY.txt,692501,693280,779,10,N,N,-,-1,-1
WESLEY.txt,692602,693383,781,10,N,N,-,-1,-1
WESLEY.txt,692718,693511,793,10,N,N,-,-1,-1
WESLEY.txt,692730,693657,927,10,N,N,-,-1,-1
WESLEY.txt,692809,693927,1118,10,N,N,-,-1,-1
WESLEY.txt,692887,694010,1123,10,N,N,-,-1,-1
WESLEY.txt,692973,694136,1163,10,N,N,-,-1,-1
WESLEY.txt,693074,694406,1332,10,N,N,-,-1,-1
WESLEY.txt,693193,694488,1295,10,N,N,-,-1,-1
WESLEY.txt,693207,694582,1375,10,N,N,-,-1,-1
WESLEY.txt,693281,694680,1399,10,N,N,-,-1,-1
WESLEY.txt,693384,694725,1341,10,N,N,-,-1,-1
WESLEY.txt,693512,694788,1276,10,N,N,-,-1,-1
WESLEY.txt,693658,694978,1320,10,N,N,-,-1,-1
WESLEY.txt,693928,695003,1075,10,N,N,-,-1,-1
WESLEY.txt,694011,695031,1020,10,N,N,-,-1,-1
WESLEY.txt,694136,695080,944,10,N,N,-,-1,-1
WESLEY.txt,694407,695095,688,10,N,N,-,-1,-1
WESLEY.txt,694489,695225,736,10,N,N,-,-1,-1
WESLEY.txt,694583,695403,820,10,N,N,-,-1,-1
WESLEY.txt,694681,695426,745,10,N,N,-,-1,-1
WESLEY.txt,694726,695441,715,10,N,N,-,-1,-1
WESLEY.txt,694789,695487,698,10,N,N,-,-1,-1
WESLEY.txt,694979,695569,590,10,N,N,-,-1,-1
WESLEY.txt,695004,695651,647,10,N,N,-,-1,-1
WESLEY.txt,695032,695816,784,10,N,N,-,-1,-1
WESLEY.txt,695081,695874,793,10,N,N,-,-1,-1
WESLEY.txt,695095,695928,833,10,N,N,-,-1,-1
WESLEY.txt,695226,696062,836,10,N,N,-,-1,-1
WESLEY.txt,695403,696206,803,10,N,N,-,-1,-1
WESLEY.txt,695427,696291,864,10,N,N,-,-1,-1
WESLEY.txt,695441,696447,1006,10,N,N,-,-1,-1
WESLEY.txt,695488,696459,971,10,N,N,-,-1,-1
WESLEY.txt,695570,696540,970,10,N,N,-,-1,-1
WESLEY.txt,695652,696579,927,10,N,N,-,-1,-1
WESLEY.txt,695817,696708,891,10,N,N,-,-1,-1
WESLEY.txt,695875,696730,855,10,N,N,-,-1,-1
WESLEY.txt,695929,696814,885,10,N,N,-,-1,-1
WESLEY.txt,696063,696977,914,10,N,N,-,-1,-1
WESLEY.txt,696207,697069,862,10,N,N,-,-1,-1
WESLEY.txt,696292,697169,877,10,N,N,-,-1,-1
WESLEY.txt,696448,697259,811,10,N,N,-,-1,-1
WESLEY.txt,696459,697343,884,10,N,N,-,-1,-1
WESLEY.txt,696541,697381,840,10,N,N,-,-1,-1
WESLEY.txt,696580,697395,815,10,N,N,-,-1,-1
WESLEY.txt,696709,697583,874,10,N,N,-,-1,-1
WESLEY.txt,696731,697697,966,10,N,N,-,-1,-1
WESLEY.txt,696815,697940,1125,10,N,N,-,-1,-1
WESLEY.txt,696978,698012,1034,10,N,N,-,-1,-1
WESLEY.txt,697069,698086,1017,10,N,N,-,-1,-1
WESLEY.txt,697170,698178,1008,10,N,N,-,-1,-1
WESLEY.txt,697260,698259,999,10,N,N,-,-1,-1
WESLEY.txt,697343,698438,1095,10,N,N,-,-1,-1
WESLEY.txt,697382,698598,1216,10,N,N,-,-1,-1
WESLEY.txt,697396,698674,1278,10,N,N,-,-1,-1
WESLEY.txt,697584,698777,1193,10,N,N,-,-1,-1
WESLEY.txt,697698,698883,1185,10,N,N,-,-1,-1
WESLEY.txt,697941,699026,1085,10,N,N,-,-1,-1
WESLEY.txt,698013,699051,1038,10,N,N,-,-1,-1
WESLEY.txt,698087,699063,976,10,N,N,-,-1,-1
WESLEY.txt,698179,699159,980,10,N,N,-,-1,-1
WESLEY.txt,698260,699250,990,10,N,N,-,-1,-1
WESLEY.txt,698439,699324,885,10,N,N,-,-1,-1
WESLEY.txt,698599,699403,804,10,N,N,-,-1,-1
WESLEY.txt,698675,699487,812,10,N,N,-,-1,-1
WESLEY.txt,698778,699501,723,10,N,N,-,-1,-1
WESLEY.txt,698884,699554,670,10,N,N,-,-1,-1
WESLEY.txt,699027,699618,591,10,N,N,-,-1,-1
WESLEY.txt,699052,699723,671,10,N,N,-,-1,-1
WESLEY.txt,699063,699817,754,10,N,N,-,-1,-1
WESLEY.txt,699160,699859,699,10,N,N,-,-1,-1
WESLEY.txt,699251,699917,666,10,N,N,-,-1,-1
WESLEY.txt,699325,700030,705,10,N,N,-,-1,-1
WESLEY.txt,699404,700078,674,10,N,N,-,-1,-1
WESLEY.txt,699488,700174,686,10,N,N,-,-1,-1
WESLEY.txt,699501,700280,779,10,N,N,-,-1,-1
WESLEY.txt,699555,700292,737,10,N,N,-,-1,-1
WESLEY.txt,699619,700328,709,10,N,N,-,-1,-1
WESLEY.txt,699724,700397,673,10,N,N,-,-1,-1
WESLEY.txt,699817,700468,651,10,N,N,-,-1,-1
WESLEY.txt,699860,700493,633,10,N,N,-,-1,-1
WESLEY.txt,699918,700678,760,10,N,N,-,-1,-1
WESLEY.txt,700031,700734,703,10,N,N,-,-1,-1
WESLEY.txt,700079,700823,744,10,N,N,-,-1,-1
WESLEY.txt,700175,700836,661,10,N,N,-,-1,-1
WESLEY.txt,700281,700885,604,10,N,N,-,-1,-1
WESLEY.txt,700292,701117,825,10,N,N,-,-1,-1
WESLEY.txt,700329,701219,890,10,N,N,-,-1,-1
WESLEY.txt,700398,701312,914,10,N,N,-,-1,-1
WESLEY.txt,700469,701374,905,10,N,N,-,-1,-1
WESLEY.txt,700494,701550,1056,10,N,N,-,-1,-1
WESLEY.txt,700679,701667,988,10,N,N,-,-1,-1
WESLEY.txt,700735,701688,953,10,N,N,-,-1,-1
WESLEY.txt,700824,701751,927,10,N,N,-,-1,-1
WESLEY.txt,700836,701797,961,10,N,N,-,-1,-1
WESLEY.txt,700886,701888,1002,10,N,N,-,-1,-1
WESLEY.txt,701118,701911,793,10,N,N,-,-1,-1
WESLEY.txt,701220,702120,900,10,N,N,-,-1,-1
WESLEY.txt,701312,702284,972,10,N,N,-,-1,-1
WESLEY.txt,701375,702383,1008,10,N,N,-,-1,-1
WESLEY.txt,701551,702476,925,10,N,N,-,-1,-1
WESLEY.txt,701668,702490,822,10,N,N,-,-1,-1
WESLEY.txt,701688,702656,968,10,N,N,-,-1,-1
WESLEY.txt,701752,702733,981,10,N,N,-,-1,-1
WESLEY.txt,701798,702785,987,10,N,N,-,-1,-1
WESLEY.txt,701889,703109,1220,10,N,N,-,-1,-1
WESLEY.txt,701911,703340,1429,10,N,N,-,-1,-1
WESLEY.txt,702121,703410,1289,10,N,N,-,-1,-1
WESLEY.txt,702285,703507,1222,10,N,N,-,-1,-1
WESLEY.txt,702384,703694,1310,10,N,N,-,-1,-1
WESLEY.txt,702477,703804,1327,10,N,N,-,-1,-1
WESLEY.txt,702490,703982,1492,10,N,N,-,-1,-1
WESLEY.txt,702657,704062,1405,10,N,N,-,-1,-1
WESLEY.txt,702734,704145,1411,10,N,N,-,-1,-1
WESLEY.txt,702786,704166,1380,10,N,N,-,-1,-1
WESLEY.txt,703110,704191,1081,10,N,N,-,-1,-1
WESLEY.txt,703341,704232,891,10,N,N,-,-1,-1
WESLEY.txt,703411,704311,900,10,N,N,-,-1,-1
WESLEY.txt,703508,704567,1059,10,N,N,-,-1,-1
WESLEY.txt,703695,704659,964,10,N,N,-,-1,-1
WESLEY.txt,703805,704742,937,10,N,N,-,-1,-1
WESLEY.txt,703983,705068,1085,10,N,N,-,-1,-1
WESLEY.txt,704063,705153,1090,10,N,N,-,-1,-1
WESLEY.txt,704146,705268,1122,10,N,N,-,-1,-1
WESLEY.txt,704167,705313,1146,10,N,N,-,-1,-1
WESLEY.txt,704192,705347,1155,10,N,N,-,-1,-1
WESLEY.txt,704232,705461,1229,10,N,N,-,-1,-1
WESLEY.txt,704312,705544,1232,10,N,N,-,-1,-1
WESLEY.txt,704568,705617,1049,10,N,N,-,-1,-1
WESLEY.txt,704660,705690,1030,10,N,N,-,-1,-1
WESLEY.txt,704743,705772,1029,10,N,N,-,-1,-1
WESLEY.txt,705069,705860,791,10,N,N,-,-1,-1
WESLEY.txt,705154,705936,782,10,N,N,-,-1,-1
WESLEY.txt,705269,706046,777,10,N,N,-,-1,-1
WESLEY.txt,705314,706136,822,10,N,N,-,-1,-1
WESLEY.txt,705348,706189,841,10,N,N,-,-1,-1
WESLEY.txt,705462,706357,895,10,N,N,-,-1,-1
WESLEY.txt,705545,706443,898,10,N,N,-,-1,-1
WESLEY.txt,705618,706494,876,10,N,N,-,-1,-1
WESLEY.txt,705691,706562,871,10,N,N,-,-1,-1
WESLEY.txt,705773,706630,857,10,N,N,-,-1,-1
WESLEY.txt,705861,706684,823,10,N,N,-,-1,-1
WESLEY.txt,705937,706717,780,10,N,N,-,-1,-1
WESLEY.txt,706047,706762,715,10,N,N,-,-1,-1
WESLEY.txt,706137,706806,669,10,N,N,-,-1,-1
WESLEY.txt,706190,706871,681,10,N,N,-,-1,-1
WESLEY.txt,706358,706937,579,10,N,N,-,-1,-1
WESLEY.txt,706444,707053,609,10,N,N,-,-1,-1
WESLEY.txt,706495,707123,628,10,N,N,-,-1,-1
WESLEY.txt,706563,707181,618,10,N,N,-,-1,-1
WESLEY.txt,706631,707200,569,10,N,N,-,-1,-1
WESLEY.txt,706685,707255,570,10,N,N,-,-1,-1
WESLEY.txt,706718,707266,548,10,N,N,-,-1,-1
WESLEY.txt,706763,707307,544,10,N,N,-,-1,-1
WESLEY.txt,706807,707455,648,10,N,N,-,-1,-1
WESLEY.txt,706871,707635,764,10,N,N,-,-1,-1
WESLEY.txt,706938,707648,710,10,N,N,-,-1,-1
WESLEY.txt,707054,707797,743,10,N,N,-,-1,-1
WESLEY.txt,707124,707830,706,10,N,N,-,-1,-1
WESLEY.txt,707182,707953,771,10,N,N,-,-1,-1
WESLEY.txt,707200,708244,1044,10,N,N,-,-1,-1
WESLEY.txt,707256,708267,1011,10,N,N,-,-1,-1
WESLEY.txt,707266,708367,1101,10,N,N,-,-1,-1
WESLEY.txt,707308,708391,1083,10,N,N,-,-1,-1
WESLEY.txt,707456,708684,1228,10,N,N,-,-1,-1
WESLEY.txt,707636,709379,1743,10,N,N,-,-1,-1
WESLEY.txt,707648,709623,1975,10,N,N,-,-1,-1
WESLEY.txt,707798,709833,2035,10,N,N,-,-1,-1
WESLEY.txt,707831,710005,2174,10,N,N,-,-1,-1
WESLEY.txt,707954,710026,2072,10,N,N,-,-1,-1
WESLEY.txt,708245,710205,1960,10,N,N,-,-1,-1
WESLEY.txt,708268,710248,1980,10,N,N,-,-1,-1
WESLEY.txt,708368,710260,1892,10,N,N,-,-1,-1
WESLEY.txt,708391,710313,1922,10,N,N,-,-1,-1
WESLEY.txt,708685,710393,1708,10,N,N,-,-1,-1
WESLEY.txt,709380,710440,1060,10,N,N,-,-1,-1
WESLEY.txt,709624,710453,829,10,N,N,-,-1,-1
WESLEY.txt,709834,710616,782,10,N,N,-,-1,-1
WESLEY.txt,710006,710713,707,10,N,N,-,-1,-1
WESLEY.txt,710027,710772,745,10,N,N,-,-1,-1
WESLEY.txt,710206,710817,611,10,N,N,-,-1,-1
WESLEY.txt,710249,710891,642,10,N,N,-,-1,-1
WESLEY.txt,710260,711012,752,10,N,N,-,-1,-1
WESLEY.txt,710314,711079,765,10,N,N,-,-1,-1
WESLEY.txt,710394,711132,738,10,N,N,-,-1,-1
WESLEY.txt,710441,711227,786,10,N,N,-,-1,-1
WESLEY.txt,710453,711416,963,10,N,N,-,-1,-1
WESLEY.txt,710617,711431,814,10,N,N,-,-1,-1
WESLEY.txt,710714,711547,833,10,N,N,-,-1,-1
WESLEY.txt,710773,711564,791,10,N,N,-,-1,-1
WESLEY.txt,710818,711626,808,10,N,N,-,-1,-1
WESLEY.txt,710892,711638,746,10,N,N,-,-1,-1
WESLEY.txt,711013,711677,664,10,N,N,-,-1,-1
WESLEY.txt,711079,711690,611,10,N,N,-,-1,-1
WESLEY.txt,711133,711815,682,10,N,N,-,-1,-1
WESLEY.txt,711228,711905,677,10,N,N,-,-1,-1
WESLEY.txt,711417,712077,660,10,N,N,-,-1,-1
WESLEY.txt,711432,712161,729,10,N,N,-,-1,-1
WESLEY.txt,711548,712242,694,10,N,N,-,-1,-1
WESLEY.txt,711564,712340,776,10,N,N,-,-1,-1
WESLEY.txt,711627,712578,951,10,N,N,-,-1,-1
WESLEY.txt,711638,712634,996,10,N,N,-,-1,-1
WESLEY.txt,711678,712711,1033,10,N,N,-,-1,-1
WESLEY.txt,711690,712796,1106,10,N,N,-,-1,-1
WESLEY.txt,711816,712870,1054,10,N,N,-,-1,-1
WESLEY.txt,711906,712954,1048,10,N,N,-,-1,-1
WESLEY.txt,712078,713032,954,10,N,N,-,-1,-1
WESLEY.txt,712161,713101,940,10,N,N,-,-1,-1
WESLEY.txt,712243,713108,865,10,N,N,-,-1,-1
WESLEY.txt,712341,713146,805,10,N,N,-,-1,-1
WESLEY.txt,712579,713231,652,10,N,N,-,-1,-1
WESLEY.txt,712635,713309,674,10,N,N,-,-1,-1
WESLEY.txt,712712,713389,677,10,N,N,-,-1,-1
WESLEY.txt,712797,713433,636,10,N,N,-,-1,-1
WESLEY.txt,712871,713627,756,10,N,N,-,-1,-1
WESLEY.txt,712955,713639,684,10,N,N,-,-1,-1
WESLEY.txt,713033,713758,725,10,N,N,-,-1,-1
WESLEY.txt,713102,713806,704,10,N,N,-,-1,-1
WESLEY.txt,713109,713874,765,10,N,N,-,-1,-1
WESLEY.txt,713147,713974,827,10,N,N,-,-1,-1
WESLEY.txt,713232,714062,830,10,N,N,-,-1,-1
WESLEY.txt,713310,714248,938,10,N,N,-,-1,-1
WESLEY.txt,713390,714457,1067,10,N,N,-,-1,-1
WESLEY.txt,713434,714578,1144,10,N,N,-,-1,-1
WESLEY.txt,713628,714661,1033,10,N,N,-,-1,-1
WESLEY.txt,713639,714808,1169,10,N,N,-,-1,-1
WESLEY.txt,713759,714899,1140,10,N,N,-,-1,-1
WESLEY.txt,713807,714991,1184,10,N,N,-,-1,-1
WESLEY.txt,713875,715077,1202,10,N,N,-,-1,-1
WESLEY.txt,713975,715168,1193,10,N,N,-,-1,-1
WESLEY.txt,714063,715425,1362,10,N,N,-,-1,-1
WESLEY.txt,714249,715543,1294,10,N,N,-,-1,-1
WESLEY.txt,714458,715924,1466,10,N,N,-,-1,-1
WESLEY.txt,714579,716059,1480,10,N,N,-,-1,-1
WESLEY.txt,714661,716130,1469,10,N,N,-,-1,-1
WESLEY.txt,714809,716169,1360,10,N,N,-,-1,-1
WESLEY.txt,714900,716267,1367,10,N,N,-,-1,-1
WESLEY.txt,714992,716385,1393,10,N,N,-,-1,-1
WESLEY.txt,715078,716462,1384,10,N,N,-,-1,-1
WESLEY.txt,715169,716617,1448,10,N,N,-,-1,-1
WESLEY.txt,715426,716663,1237,10,N,N,-,-1,-1
WESLEY.txt,715544,716757,1213,10,N,N,-,-1,-1
WESLEY.txt,715925,716911,986,10,N,N,-,-1,-1
WESLEY.txt,716060,716939,879,10,N,N,-,-1,-1
WESLEY.txt,716130,717022,892,10,N,N,-,-1,-1
WESLEY.txt,716170,717146,976,10,N,N,-,-1,-1
WESLEY.txt,716268,717234,966,10,N,N,-,-1,-1
WESLEY.txt,716386,717320,934,10,N,N,-,-1,-1
WESLEY.txt,716463,717502,1039,10,N,N,-,-1,-1
WESLEY.txt,716618,717580,962,10,N,N,-,-1,-1
WESLEY.txt,716664,717619,955,10,N,N,-,-1,-1
WESLEY.txt,716758,717737,979,10,N,N,-,-1,-1
WESLEY.txt,716912,717891,979,10,N,N,-,-1,-1
WESLEY.txt,716940,717944,1004,10,N,N,-,-1,-1
WESLEY.txt,717023,718082,1059,10,N,N,-,-1,-1
WESLEY.txt,717147,718153,1006,10,N,N,-,-1,-1
WESLEY.txt,717235,718235,1000,10,N,N,-,-1,-1
WESLEY.txt,717321,718250,929,10,N,N,-,-1,-1
WESLEY.txt,717503,718327,824,10,N,N,-,-1,-1
WESLEY.txt,717581,718547,966,10,N,N,-,-1,-1
WESLEY.txt,717620,718738,1118,10,N,N,-,-1,-1
WESLEY.txt,717738,718901,1163,10,N,N,-,-1,-1
WESLEY.txt,717892,718997,1105,10,N,N,-,-1,-1
WESLEY.txt,717945,719090,1145,10,N,N,-,-1,-1
WESLEY.txt,718083,719217,1134,10,N,N,-,-1,-1
WESLEY.txt,718154,719231,1077,10,N,N,-,-1,-1
WESLEY.txt,718236,719300,1064,10,N,N,-,-1,-1
WESLEY.txt,718250,719362,1112,10,N,N,-,-1,-1
WESLEY.txt,718328,719389,1061,10,N,N,-,-1,-1
WESLEY.txt,718548,719401,853,10,N,N,-,-1,-1
WESLEY.txt,718739,719529,790,10,N,N,-,-1,-1
WESLEY.txt,718902,719624,722,10,N,N,-,-1,-1
WESLEY.txt,718998,719735,737,10,N,N,-,-1,-1
WESLEY.txt,719091,719749,658,10,N,N,-,-1,-1
WESLEY.txt,719218,719830,612,10,N,N,-,-1,-1
WESLEY.txt,719232,719966,734,10,N,N,-,-1,-1
WESLEY.txt,719301,720005,704,10,N,N,-,-1,-1
WESLEY.txt,719362,720023,661,10,N,N,-,-1,-1
WESLEY.txt,719390,720031,641,10,N,N,-,-1,-1
WESLEY.txt,719402,720111,709,10,N,N,-,-1,-1
WESLEY.txt,719530,720191,661,10,N,N,-,-1,-1
WESLEY.txt,719625,720272,647,10,N,N,-,-1,-1
WESLEY.txt,719736,720338,602,10,N,N,-,-1,-1
WESLEY.txt,719749,720436,687,10,N,N,-,-1,-1
WESLEY.txt,719831,720600,769,10,N,N,-,-1,-1
WESLEY.txt,719967,720696,729,10,N,N,-,-1,-1
WESLEY.txt,720006,720839,833,10,N,N,-,-1,-1
WESLEY.txt,720024,721059,1035,10,N,N,-,-1,-1
WESLEY.txt,720031,721193,1162,10,N,N,-,-1,-1
WESLEY.txt,720112,721280,1168,10,N,N,-,-1,-1
WESLEY.txt,720192,721318,1126,10,N,N,-,-1,-1
WESLEY.txt,720273,721381,1108,10,N,N,-,-1,-1
WESLEY.txt,720339,721431,1092,10,N,N,-,-1,-1
WESLEY.txt,720437,721463,1026,10,N,N,-,-1,-1
WESLEY.txt,720601,721499,898,10,N,N,-,-1,-1
WESLEY.txt,720696,721561,865,10,N,N,-,-1,-1
WESLEY.txt,720840,721643,803,10,N,N,-,-1,-1
WESLEY.txt,721060,721722,662,10,N,N,-,-1,-1
WESLEY.txt,721194,721744,550,10,N,N,-,-1,-1
WESLEY.txt,721281,721780,499,10,N,N,-,-1,-1
WESLEY.txt,721319,721820,501,10,N,N,-,-1,-1
WESLEY.txt,721382,721833,451,10,N,N,-,-1,-1
WESLEY.txt,721432,721931,499,10,N,N,-,-1,-1
WESLEY.txt,721464,722033,569,10,N,N,-,-1,-1
WESLEY.txt,721500,722216,716,10,N,N,-,-1,-1
WESLEY.txt,721562,722311,749,10,N,N,-,-1,-1
WESLEY.txt,721644,722368,724,10,N,N,-,-1,-1
WESLEY.txt,721723,722420,697,10,N,N,-,-1,-1
WESLEY.txt,721745,722549,804,10,N,N,-,-1,-1
WESLEY.txt,721781,722647,866,10,N,N,-,-1,-1
WESLEY.txt,721821,722725,904,10,N,N,-,-1,-1
WESLEY.txt,721833,722818,985,10,N,N,-,-1,-1
WESLEY.txt,721932,722895,963,10,N,N,-,-1,-1
WESLEY.txt,722034,722979,945,10,N,N,-,-1,-1
WESLEY.txt,722217,723072,855,10,N,N,-,-1,-1
WESLEY.txt,722312,723204,892,10,N,N,-,-1,-1
WESLEY.txt,722369,723394,1025,10,N,N,-,-1,-1
WESLEY.txt,722421,723611,1190,10,N,N,-,-1,-1
WESLEY.txt,722550,723789,1239,10,N,N,-,-1,-1
WESLEY.txt,722647,723965,1318,10,N,N,-,-1,-1
WESLEY.txt,722726,724005,1279,10,N,N,-,-1,-1
WESLEY.txt,722819,724064,1245,10,N,N,-,-1,-1
WESLEY.txt,722896,724083,1187,10,N,N,-,-1,-1
WESLEY.txt,722980,724208,1228,10,N,N,-,-1,-1
WESLEY.txt,723073,724438,1365,10,N,N,-,-1,-1
WESLEY.txt,723205,724592,1387,10,N,N,-,-1,-1
WESLEY.txt,723395,724681,1286,10,N,N,-,-1,-1
WESLEY.txt,723612,724869,1257,10,N,N,-,-1,-1
WESLEY.txt,723790,724951,1161,10,N,N,-,-1,-1
WESLEY.txt,723966,725047,1081,10,N,N,-,-1,-1
WESLEY.txt,724006,725069,1063,10,N,N,-,-1,-1
WESLEY.txt,724065,725114,1049,10,N,N,-,-1,-1
WESLEY.txt,724083,725192,1109,10,N,N,-,-1,-1
WESLEY.txt,724209,725256,1047,10,N,N,-,-1,-1
WESLEY.txt,724438,725339,901,10,N,N,-,-1,-1
WESLEY.txt,724593,725476,883,10,N,N,-,-1,-1
WESLEY.txt,724682,725518,836,10,N,N,-,-1,-1
WESLEY.txt,724870,725530,660,10,N,N,-,-1,-1
WESLEY.txt,724952,725740,788,10,N,N,-,-1,-1
WESLEY.txt,725048,725964,916,10,N,N,-,-1,-1
WESLEY.txt,725069,726068,999,10,N,N,-,-1,-1
WESLEY.txt,725115,726087,972,10,N,N,-,-1,-1
WESLEY.txt,725193,726160,967,10,N,N,-,-1,-1
WESLEY.txt,725257,726174,917,10,N,N,-,-1,-1
WESLEY.txt,725340,726249,909,10,N,N,-,-1,-1
WESLEY.txt,725477,726329,852,10,N,N,-,-1,-1
WESLEY.txt,725519,726442,923,10,N,N,-,-1,-1
WESLEY.txt,725530,726646,1116,10,N,N,-,-1,-1
WESLEY.txt,725741,726876,1135,10,N,N,-,-1,-1
WESLEY.txt,725965,726920,955,10,N,N,-,-1,-1
WESLEY.txt,726069,727014,945,10,N,N,-,-1,-1
WESLEY.txt,726087,727034,947,10,N,N,-,-1,-1
WESLEY.txt,726161,727116,955,10,N,N,-,-1,-1
WESLEY.txt,726175,727225,1050,10,N,N,-,-1,-1
WESLEY.txt,726250,727241,991,10,N,N,-,-1,-1
WESLEY.txt,726330,727330,1000,10,N,N,-,-1,-1
WESLEY.txt,726443,727414,971,10,N,N,-,-1,-1
WESLEY.txt,726647,727526,879,10,N,N,-,-1,-1
WESLEY.txt,726877,727722,845,10,N,N,-,-1,-1
WESLEY.txt,726921,727734,813,10,N,N,-,-1,-1
WESLEY.txt,727015,727838,823,10,N,N,-,-1,-1
WESLEY.txt,727034,727947,913,10,N,N,-,-1,-1
WESLEY.txt,727117,728019,902,10,N,N,-,-1,-1
WESLEY.txt,727226,728046,820,10,N,N,-,-1,-1
WESLEY.txt,727241,728095,854,10,N,N,-,-1,-1
WESLEY.txt,727331,728192,861,10,N,N,-,-1,-1
WESLEY.txt,727415,728291,876,10,N,N,-,-1,-1
WESLEY.txt,727527,728304,777,10,N,N,-,-1,-1
WESLEY.txt,727723,728390,667,10,N,N,-,-1,-1
WESLEY.txt,727735,728479,744,10,N,N,-,-1,-1
WESLEY.txt,727839,728544,705,10,N,N,-,-1,-1
WESLEY.txt,727947,728663,716,10,N,N,-,-1,-1
WESLEY.txt,728020,728775,755,10,N,N,-,-1,-1
WESLEY.txt,728047,728855,808,10,N,N,-,-1,-1
WESLEY.txt,728096,729169,1073,10,N,N,-,-1,-1
WESLEY.txt,728193,729487,1294,10,N,N,-,-1,-1
WESLEY.txt,728292,729568,1276,10,N,N,-,-1,-1
WESLEY.txt,728304,729609,1305,10,N,N,-,-1,-1
WESLEY.txt,728391,729652,1261,10,N,N,-,-1,-1
WESLEY.txt,728480,729701,1221,10,N,N,-,-1,-1
WESLEY.txt,728545,729712,1167,10,N,N,-,-1,-1
WESLEY.txt,728664,729752,1088,10,N,N,-,-1,-1
WESLEY.txt,728776,729850,1074,10,N,N,-,-1,-1
WESLEY.txt,728856,729971,1115,10,N,N,-,-1,-1
WESLEY.txt,729170,730057,887,10,N,N,-,-1,-1
WESLEY.txt,729488,730153,665,10,N,N,-,-1,-1
WESLEY.txt,729569,730219,650,10,N,N,-,-1,-1
WESLEY.txt,729610,730317,707,10,N,N,-,-1,-1
WESLEY.txt,729653,730367,714,10,N,N,-,-1,-1
WESLEY.txt,729702,730517,815,10,N,N,-,-1,-1
WESLEY.txt,729713,730598,885,10,N,N,-,-1,-1
WESLEY.txt,729753,730699,946,10,N,N,-,-1,-1
WESLEY.txt,729851,730711,860,10,N,N,-,-1,-1
WESLEY.txt,729972,730793,821,10,N,N,-,-1,-1
WESLEY.txt,730058,730859,801,10,N,N,-,-1,-1
WESLEY.txt,730153,731035,882,10,N,N,-,-1,-1
WESLEY.txt,730220,731075,855,10,N,N,-,-1,-1
WESLEY.txt,730318,731183,865,10,N,N,-,-1,-1
WESLEY.txt,730368,731274,906,10,N,N,-,-1,-1
WESLEY.txt,730518,731319,801,10,N,N,-,-1,-1
WESLEY.txt,730599,731361,762,10,N,N,-,-1,-1
WESLEY.txt,730700,731461,761,10,N,N,-,-1,-1
WESLEY.txt,730711,731529,818,10,N,N,-,-1,-1
WESLEY.txt,730794,731544,750,10,N,N,-,-1,-1
WESLEY.txt,730860,731646,786,10,N,N,-,-1,-1
WESLEY.txt,731036,731838,802,10,N,N,-,-1,-1
WESLEY.txt,731076,731888,812,10,N,N,-,-1,-1
WESLEY.txt,731184,731991,807,10,N,N,-,-1,-1
WESLEY.txt,731275,732031,756,10,N,N,-,-1,-1
WESLEY.txt,731320,732098,778,10,N,N,-,-1,-1
WESLEY.txt,731362,732174,812,10,N,N,-,-1,-1
WESLEY.txt,731462,732200,738,10,N,N,-,-1,-1
WESLEY.txt,731530,732273,743,10,N,N,-,-1,-1
WESLEY.txt,731545,732412,867,10,N,N,-,-1,-1
WESLEY.txt,731647,732425,778,10,N,N,-,-1,-1
WESLEY.txt,731839,732581,742,10,N,N,-,-1,-1
WESLEY.txt,731889,732664,775,10,N,N,-,-1,-1
WESLEY.txt,731992,732752,760,10,N,N,-,-1,-1
WESLEY.txt,732032,732831,799,10,N,N,-,-1,-1
WESLEY.txt,732099,733099,1000,10,N,N,-,-1,-1
WESLEY.txt,732175,733198,1023,10,N,N,-,-1,-1
WESLEY.txt,732201,733365,1164,10,N,N,-,-1,-1
WESLEY.txt,732274,733451,1177,10,N,N,-,-1,-1
WESLEY.txt,732413,733463,1050,10,N,N,-,-1,-1
WESLEY.txt,732425,733633,1208,10,N,N,-,-1,-1
WESLEY.txt,732582,733835,1253,10,N,N,-,-1,-1
WESLEY.txt,732665,733918,1253,10,N,N,-,-1,-1
WESLEY.txt,732753,734067,1314,10,N,N,-,-1,-1
WESLEY.txt,732832,734229,1397,10,N,N,-,-1,-1
WESLEY.txt,733100,734310,1210,10,N,N,-,-1,-1
WESLEY.txt,733198,734372,1174,10,N,N,-,-1,-1
WESLEY.txt,733366,734391,1025,10,N,N,-,-1,-1
WESLEY.txt,733452,734467,1015,10,N,N,-,-1,-1
WESLEY.txt,733463,734480,1017,10,N,N,-,-1,-1
WESLEY.txt,733634,734576,942,10,N,N,-,-1,-1
WESLEY.txt,733836,734605,769,10,N,N,-,-1,-1
WESLEY.txt,733919,734791,872,10,N,N,-,-1,-1
WESLEY.txt,734068,734894,826,10,N,N,-,-1,-1
WESLEY.txt,734230,734907,677,10,N,N,-,-1,-1
WESLEY.txt,734311,734950,639,10,N,N,-,-1,-1
WESLEY.txt,734373,735161,788,10,N,N,-,-1,-1
WESLEY.txt,734391,735243,852,10,N,N,-,-1,-1
WESLEY.txt,734468,735319,851,10,N,N,-,-1,-1
WESLEY.txt,734480,735385,905,10,N,N,-,-1,-1
WESLEY.txt,734577,735475,898,10,N,N,-,-1,-1
WESLEY.txt,734606,735515,909,10,N,N,-,-1,-1
WESLEY.txt,734792,735622,830,10,N,N,-,-1,-1
WESLEY.txt,734895,735701,806,10,N,N,-,-1,-1
WESLEY.txt,734907,735882,975,10,N,N,-,-1,-1
WESLEY.txt,734951,735897,946,10,N,N,-,-1,-1
WESLEY.txt,735162,735984,822,10,N,N,-,-1,-1
WESLEY.txt,735244,736176,932,10,N,N,-,-1,-1
WESLEY.txt,735320,736339,1019,10,N,N,-,-1,-1
WESLEY.txt,735386,736440,1054,10,N,N,-,-1,-1
WESLEY.txt,735476,736609,1133,10,N,N,-,-1,-1
WESLEY.txt,735516,736698,1182,10,N,N,-,-1,-1
WESLEY.txt,735622,736763,1141,10,N,N,-,-1,-1
WESLEY.txt,735702,736833,1131,10,N,N,-,-1,-1
WESLEY.txt,735883,736984,1101,10,N,N,-,-1,-1
WESLEY.txt,735897,737004,1107,10,N,N,-,-1,-1
WESLEY.txt,735985,737174,1189,10,N,N,-,-1,-1
WESLEY.txt,736177,737245,1068,10,N,N,-,-1,-1
WESLEY.txt,736340,737336,996,10,N,N,-,-1,-1
WESLEY.txt,736441,737439,998,10,N,N,-,-1,-1
WESLEY.txt,736610,737511,901,10,N,N,-,-1,-1
WESLEY.txt,736699,737720,1021,10,N,N,-,-1,-1
WESLEY.txt,736764,737798,1034,10,N,N,-,-1,-1
WESLEY.txt,736834,737884,1050,10,N,N,-,-1,-1
WESLEY.txt,736985,738095,1110,10,N,N,-,-1,-1
WESLEY.txt,737005,738179,1174,10,N,N,-,-1,-1
WESLEY.txt,737175,738285,1110,10,N,N,-,-1,-1
WESLEY.txt,737246,738316,1070,10,N,N,-,-1,-1
WESLEY.txt,737337,738398,1061,10,N,N,-,-1,-1
WESLEY.txt,737440,738493,1053,10,N,N,-,-1,-1
WESLEY.txt,737512,738595,1083,10,N,N,-,-1,-1
WESLEY.txt,737721,738678,957,10,N,N,-,-1,-1
WESLEY.txt,737799,738873,1074,10,N,N,-,-1,-1
WESLEY.txt,737885,738958,1073,10,N,N,-,-1,-1
WESLEY.txt,738096,739144,1048,10,N,N,-,-1,-1
WESLEY.txt,738180,739156,976,10,N,N,-,-1,-1
WESLEY.txt,738286,739244,958,10,N,N,-,-1,-1
WESLEY.txt,738317,739327,1010,10,N,N,-,-1,-1
WESLEY.txt,738399,739485,1086,10,N,N,-,-1,-1
WESLEY.txt,738494,739645,1151,10,N,N,-,-1,-1
WESLEY.txt,738596,739804,1208,10,N,N,-,-1,-1
WESLEY.txt,738679,740088,1409,10,N,N,-,-1,-1
WESLEY.txt,738874,740184,1310,10,N,N,-,-1,-1
WESLEY.txt,738959,740281,1322,10,N,N,-,-1,-1
WESLEY.txt,739145,740469,1324,10,N,N,-,-1,-1
WESLEY.txt,739156,740530,1374,10,N,N,-,-1,-1
WESLEY.txt,739245,740597,1352,10,N,N,-,-1,-1
WESLEY.txt,739328,740625,1297,10,N,N,-,-1,-1
WESLEY.txt,739486,740708,1222,10,N,N,-,-1,-1
WESLEY.txt,739646,740739,1093,10,N,N,-,-1,-1
WESLEY.txt,739805,740790,985,10,N,N,-,-1,-1
WESLEY.txt,740089,740840,751,10,N,N,-,-1,-1
WESLEY.txt,740185,740942,757,10,N,N,-,-1,-1
WESLEY.txt,740282,741018,736,10,N,N,-,-1,-1
WESLEY.txt,740470,741093,623,10,N,N,-,-1,-1
WESLEY.txt,740530,741188,658,10,N,N,-,-1,-1
WESLEY.txt,740598,741264,666,10,N,N,-,-1,-1
WESLEY.txt,740626,741353,727,10,N,N,-,-1,-1
WESLEY.txt,740709,741365,656,10,N,N,-,-1,-1
WESLEY.txt,740740,741459,719,10,N,N,-,-1,-1
WESLEY.txt,740791,741540,749,10,N,N,-,-1,-1
WESLEY.txt,740841,741694,853,10,N,N,-,-1,-1
WESLEY.txt,740943,741767,824,10,N,N,-,-1,-1
WESLEY.txt,741019,741858,839,10,N,N,-,-1,-1
WESLEY.txt,741094,741937,843,10,N,N,-,-1,-1
WESLEY.txt,741189,742009,820,10,N,N,-,-1,-1
WESLEY.txt,741265,742089,824,10,N,N,-,-1,-1
WESLEY.txt,741354,742178,824,10,N,N,-,-1,-1
WESLEY.txt,741365,742257,892,10,N,N,-,-1,-1
WESLEY.txt,741460,742307,847,10,N,N,-,-1,-1
WESLEY.txt,741541,742353,812,10,N,N,-,-1,-1
WESLEY.txt,741695,742428,733,10,N,N,-,-1,-1
WESLEY.txt,741768,742518,750,10,N,N,-,-1,-1
WESLEY.txt,741859,742532,673,10,N,N,-,-1,-1
WESLEY.txt,741938,742585,647,10,N,N,-,-1,-1
WESLEY.txt,742010,742591,581,10,N,N,-,-1,-1
WESLEY.txt,742090,742615,525,10,N,N,-,-1,-1
WESLEY.txt,742179,742763,584,10,N,N,-,-1,-1
WESLEY.txt,742258,742836,578,10,N,N,-,-1,-1
WESLEY.txt,742308,743210,902,10,N,N,-,-1,-1
WESLEY.txt,742354,743342,988,10,N,N,-,-1,-1
WESLEY.txt,742429,743436,1007,10,N,N,-,-1,-1
WESLEY.txt,742519,743517,998,10,N,N,-,-1,-1
WESLEY.txt,742532,743627,1095,10,N,N,-,-1,-1
WESLEY.txt,742586,743769,1183,10,N,N,-,-1,-1
WESLEY.txt,742592,743857,1265,10,N,N,-,-1,-1
WESLEY.txt,742615,743971,1356,10,N,N,-,-1,-1
WESLEY.txt,742764,744050,1286,10,N,N,-,-1,-1
WESLEY.txt,742837,744161,1324,10,N,N,-,-1,-1
WESLEY.txt,743211,744267,1056,10,N,N,-,-1,-1
WESLEY.txt,743343,744290,947,10,N,N,-,-1,-1
WESLEY.txt,743437,744358,921,10,N,N,-,-1,-1
WESLEY.txt,743517,744409,892,10,N,N,-,-1,-1
WESLEY.txt,743628,744452,824,10,N,N,-,-1,-1
WESLEY.txt,743770,744545,775,10,N,N,-,-1,-1
WESLEY.txt,743858,744576,718,10,N,N,-,-1,-1
WESLEY.txt,743972,744621,649,10,N,N,-,-1,-1
WESLEY.txt,744051,744703,652,10,N,N,-,-1,-1
WESLEY.txt,744162,744715,553,10,N,N,-,-1,-1
WESLEY.txt,744268,744854,586,10,N,N,-,-1,-1
WESLEY.txt,744291,744927,636,10,N,N,-,-1,-1
WESLEY.txt,744359,745120,761,10,N,N,-,-1,-1
WESLEY.txt,744410,745217,807,10,N,N,-,-1,-1
WESLEY.txt,744453,745241,788,10,N,N,-,-1,-1
WESLEY.txt,744546,745325,779,10,N,N,-,-1,-1
WESLEY.txt,744577,745513,936,10,N,N,-,-1,-1
WESLEY.txt,744622,745552,930,10,N,N,-,-1,-1
WESLEY.txt,744704,745667,963,10,N,N,-,-1,-1
WESLEY.txt,744715,745727,1012,10,N,N,-,-1,-1
WESLEY.txt,744855,745861,1006,10,N,N,-,-1,-1
WESLEY.txt,744928,745905,977,10,N,N,-,-1,-1
WESLEY.txt,745121,745930,809,10,N,N,-,-1,-1
WESLEY.txt,745217,746067,850,10,N,N,-,-1,-1
WESLEY.txt,745242,746140,898,10,N,N,-,-1,-1
WESLEY.txt,745326,746222,896,10,N,N,-,-1,-1
WESLEY.txt,745514,746295,781,10,N,N,-,-1,-1
WESLEY.txt,745553,746377,824,10,N,N,-,-1,-1
WESLEY.txt,745668,746575,907,10,N,N,-,-1,-1
WESLEY.txt,745728,746966,1238,10,N,N,-,-1,-1
WESLEY.txt,745862,747062,1200,10,N,N,-,-1,-1
WESLEY.txt,745906,747414,1508,10,N,N,-,-1,-1
WESLEY.txt,745931,747584,1653,10,N,N,-,-1,-1
WESLEY.txt,746068,747789,1721,10,N,N,-,-1,-1
WESLEY.txt,746141,747941,1800,10,N,N,-,-1,-1
WESLEY.txt,746223,748045,1822,10,N,N,-,-1,-1
WESLEY.txt,746296,748154,1858,10,N,N,-,-1,-1
WESLEY.txt,746378,748218,1840,10,N,N,-,-1,-1
WESLEY.txt,746576,748229,1653,10,N,N,-,-1,-1
WESLEY.txt,746967,748371,1404,10,N,N,-,-1,-1
WESLEY.txt,747063,748383,1320,10,N,N,-,-1,-1
WESLEY.txt,747415,748556,1141,10,N,N,-,-1,-1
WESLEY.txt,747585,748666,1081,10,N,N,-,-1,-1
WESLEY.txt,747790,748831,1041,10,N,N,-,-1,-1
WESLEY.txt,747942,748937,995,10,N,N,-,-1,-1
WESLEY.txt,748046,748956,910,10,N,N,-,-1,-1
WESLEY.txt,748155,749065,910,10,N,N,-,-1,-1
WESLEY.txt,748219,749240,1021,10,N,N,-,-1,-1
WESLEY.txt,748229,749400,1171,10,N,N,-,-1,-1
WESLEY.txt,748372,749489,1117,10,N,N,-,-1,-1
WESLEY.txt,748383,749507,1124,10,N,N,-,-1,-1
WESLEY.txt,748557,749659,1102,10,N,N,-,-1,-1
WESLEY.txt,748667,749994,1327,10,N,N,-,-1,-1
WESLEY.txt,748832,750240,1408,10,N,N,-,-1,-1
WESLEY.txt,748938,750393,1455,10,N,N,-,-1,-1
WESLEY.txt,748956,750472,1516,10,N,N,-,-1,-1
WESLEY.txt,749066,750589,1523,10,N,N,-,-1,-1
WESLEY.txt,749241,750669,1428,10,N,N,-,-1,-1
WESLEY.txt,749401,750766,1365,10,N,N,-,-1,-1
WESLEY.txt,749490,750877,1387,10,N,N,-,-1,-1
WESLEY.txt,749507,751129,1622,10,N,N,-,-1,-1
WESLEY.txt,749660,751302,1642,10,N,N,-,-1,-1
WESLEY.txt,749995,751404,1409,10,N,N,-,-1,-1
WESLEY.txt,750241,751481,1240,10,N,N,-,-1,-1
WESLEY.txt,750394,751544,1150,10,N,N,-,-1,-1
WESLEY.txt,750473,751571,1098,10,N,N,-,-1,-1
WESLEY.txt,750590,751653,1063,10,N,N,-,-1,-1
WESLEY.txt,750670,751665,995,10,N,N,-,-1,-1
WESLEY.txt,750766,751699,933,10,N,N,-,-1,-1
WESLEY.txt,750878,751713,835,10,N,N,-,-1,-1
WESLEY.txt,751130,751766,636,10,N,N,-,-1,-1
WESLEY.txt,751303,751962,659,10,N,N,-,-1,-1
WESLEY.txt,751405,751974,569,10,N,N,-,-1,-1
WESLEY.txt,751482,752075,593,10,N,N,-,-1,-1
WESLEY.txt,751545,752183,638,10,N,N,-,-1,-1
WESLEY.txt,751572,752267,695,10,N,N,-,-1,-1
WESLEY.txt,751654,752446,792,10,N,N,-,-1,-1
WESLEY.txt,751665,752591,926,10,N,N,-,-1,-1
WESLEY.txt,751700,752627,927,10,N,N,-,-1,-1
WESLEY.txt,751714,752707,993,10,N,N,-,-1,-1
WESLEY.txt,751767,752798,1031,10,N,N,-,-1,-1
WESLEY.txt,751963,752869,906,10,N,N,-,-1,-1
WESLEY.txt,751974,753044,1070,10,N,N,-,-1,-1
WESLEY.txt,752076,753156,1080,10,N,N,-,-1,-1
WESLEY.txt,752184,753261,1077,10,N,N,-,-1,-1
WESLEY.txt,752268,753438,1170,10,N,N,-,-1,-1
WESLEY.txt,752447,753539,1092,10,N,N,-,-1,-1
WESLEY.txt,752592,753615,1023,10,N,N,-,-1,-1
WESLEY.txt,752628,753720,1092,10,N,N,-,-1,-1
WESLEY.txt,752708,753789,1081,10,N,N,-,-1,-1
WESLEY.txt,752799,753821,1022,10,N,N,-,-1,-1
WESLEY.txt,752870,753916,1046,10,N,N,-,-1,-1
WESLEY.txt,753045,754074,1029,10,N,N,-,-1,-1
WESLEY.txt,753157,754187,1030,10,N,N,-,-1,-1
WESLEY.txt,753262,754311,1049,10,N,N,-,-1,-1
WESLEY.txt,753439,754395,956,10,N,N,-,-1,-1
WESLEY.txt,753540,754548,1008,10,N,N,-,-1,-1
WESLEY.txt,753616,754560,944,10,N,N,-,-1,-1
WESLEY.txt,753721,754630,909,10,N,N,-,-1,-1
WESLEY.txt,753790,754875,1085,10,N,N,-,-1,-1
WESLEY.txt,753822,755065,1243,10,N,N,-,-1,-1
WESLEY.txt,753917,755160,1243,10,N,N,-,-1,-1
WESLEY.txt,754075,755222,1147,10,N,N,-,-1,-1
WESLEY.txt,754188,755311,1123,10,N,N,-,-1,-1
WESLEY.txt,754312,755456,1144,10,N,N,-,-1,-1
WESLEY.txt,754396,755477,1081,10,N,N,-,-1,-1
WESLEY.txt,754549,755570,1021,10,N,N,-,-1,-1
WESLEY.txt,754560,755644,1084,10,N,N,-,-1,-1
WESLEY.txt,754631,755695,1064,10,N,N,-,-1,-1
WESLEY.txt,754876,755721,845,10,N,N,-,-1,-1
WESLEY.txt,755066,755800,734,10,N,N,-,-1,-1
WESLEY.txt,755161,755905,744,10,N,N,-,-1,-1
WESLEY.txt,755223,755976,753,10,N,N,-,-1,-1
WESLEY.txt,755312,756022,710,10,N,N,-,-1,-1
WESLEY.txt,755457,756083,626,10,N,N,-,-1,-1
WESLEY.txt,755478,756160,682,10,N,N,-,-1,-1
WESLEY.txt,755571,756227,656,10,N,N,-,-1,-1
WESLEY.txt,755645,756297,652,10,N,N,-,-1,-1
WESLEY.txt,755696,756501,805,10,N,N,-,-1,-1
WESLEY.txt,755722,756518,796,10,N,N,-,-1,-1
WESLEY.txt,755801,756603,802,10,N,N,-,-1,-1
WESLEY.txt,755906,756670,764,10,N,N,-,-1,-1
WESLEY.txt,755977,756940,963,10,N,N,-,-1,-1
WESLEY.txt,756023,757080,1057,10,N,N,-,-1,-1
WESLEY.txt,756084,757119,1035,10,N,N,-,-1,-1
WESLEY.txt,756161,757183,1022,10,N,N,-,-1,-1
WESLEY.txt,756228,757250,1022,10,N,N,-,-1,-1
WESLEY.txt,756298,757295,997,10,N,N,-,-1,-1
WESLEY.txt,756502,757426,924,10,N,N,-,-1,-1
WESLEY.txt,756518,757513,995,10,N,N,-,-1,-1
WESLEY.txt,756604,757611,1007,10,N,N,-,-1,-1
WESLEY.txt,756671,757718,1047,10,N,N,-,-1,-1
WESLEY.txt,756941,757798,857,10,N,N,-,-1,-1
WESLEY.txt,757081,758006,925,10,N,N,-,-1,-1
WESLEY.txt,757120,758105,985,10,N,N,-,-1,-1
WESLEY.txt,757184,758122,938,10,N,N,-,-1,-1
WESLEY.txt,757251,758190,939,10,N,N,-,-1,-1
WESLEY.txt,757296,758350,1054,10,N,N,-,-1,-1
WESLEY.txt,757426,758378,952,10,N,N,-,-1,-1
WESLEY.txt,757514,758639,1125,10,N,N,-,-1,-1
WESLEY.txt,757612,758793,1181,10,N,N,-,-1,-1
WESLEY.txt,757719,758885,1166,10,N,N,-,-1,-1
WESLEY.txt,757799,758981,1182,10,N,N,-,-1,-1
WESLEY.txt,758007,759041,1034,10,N,N,-,-1,-1
WESLEY.txt,758106,759124,1018,10,N,N,-,-1,-1
WESLEY.txt,758123,759211,1088,10,N,N,-,-1,-1
WESLEY.txt,758191,759306,1115,10,N,N,-,-1,-1
WESLEY.txt,758351,759328,977,10,N,N,-,-1,-1
WESLEY.txt,758379,759379,1000,10,N,N,-,-1,-1
WESLEY.txt,758640,759505,865,10,N,N,-,-1,-1
WESLEY.txt,758794,759518,724,10,N,N,-,-1,-1
WESLEY.txt,758886,759575,689,10,N,N,-,-1,-1
WESLEY.txt,758982,759656,674,10,N,N,-,-1,-1
WESLEY.txt,759042,759835,793,10,N,N,-,-1,-1
WESLEY.txt,759125,759850,725,10,N,N,-,-1,-1
WESLEY.txt,759212,759924,712,10,N,N,-,-1,-1
WESLEY.txt,759307,760000,693,10,N,N,-,-1,-1
WESLEY.txt,759328,760069,741,10,N,N,-,-1,-1
WESLEY.txt,759380,760117,737,10,N,N,-,-1,-1
WESLEY.txt,759506,760132,626,10,N,N,-,-1,-1
WESLEY.txt,759518,760236,718,10,N,N,-,-1,-1
WESLEY.txt,759576,760315,739,10,N,N,-,-1,-1
WESLEY.txt,759657,760385,728,10,N,N,-,-1,-1
WESLEY.txt,759836,760543,707,10,N,N,-,-1,-1
WESLEY.txt,759850,760647,797,10,N,N,-,-1,-1
WESLEY.txt,759925,760698,773,10,N,N,-,-1,-1
WESLEY.txt,760001,760858,857,10,N,N,-,-1,-1
WESLEY.txt,760070,760939,869,10,N,N,-,-1,-1
WESLEY.txt,760118,761053,935,10,N,N,-,-1,-1
WESLEY.txt,760133,761190,1057,10,N,N,-,-1,-1
WESLEY.txt,760237,761317,1080,10,N,N,-,-1,-1
WESLEY.txt,760316,761329,1013,10,N,N,-,-1,-1
WESLEY.txt,760386,761425,1039,10,N,N,-,-1,-1
WESLEY.txt,760544,761552,1008,10,N,N,-,-1,-1
WESLEY.txt,760648,761571,923,10,N,N,-,-1,-1
WESLEY.txt,760699,761668,969,10,N,N,-,-1,-1
WESLEY.txt,760859,761838,979,10,N,N,-,-1,-1
WESLEY.txt,760940,761925,985,10,N,N,-,-1,-1
WESLEY.txt,761054,762040,986,10,N,N,-,-1,-1
WESLEY.txt,761191,762075,884,10,N,N,-,-1,-1
WESLEY.txt,761318,762153,835,10,N,N,-,-1,-1
WESLEY.txt,761329,762246,917,10,N,N,-,-1,-1
WESLEY.txt,761426,762279,853,10,N,N,-,-1,-1
WESLEY.txt,761553,762432,879,10,N,N,-,-1,-1
WESLEY.txt,761571,762539,968,10,N,N,-,-1,-1
WESLEY.txt,761669,762627,958,10,N,N,-,-1,-1
WESLEY.txt,761839,762699,860,10,N,N,-,-1,-1
WESLEY.txt,761926,762838,912,10,N,N,-,-1,-1
WESLEY.txt,762041,763002,961,10,N,N,-,-1,-1
WESLEY.txt,762076,763163,1087,10,N,N,-,-1,-1
WESLEY.txt,762154,763212,1058,10,N,N,-,-1,-1
WESLEY.txt,762247,763252,1005,10,N,N,-,-1,-1
WESLEY.txt,762280,763387,1107,10,N,N,-,-1,-1
WESLEY.txt,762433,763453,1020,10,N,N,-,-1,-1
WESLEY.txt,762540,763535,995,10,N,N,-,-1,-1
WESLEY.txt,762627,763639,1012,10,N,N,-,-1,-1
WESLEY.txt,762700,763655,955,10,N,N,-,-1,-1
WESLEY.txt,762839,763740,901,10,N,N,-,-1,-1
WESLEY.txt,763003,763935,932,10,N,N,-,-1,-1
WESLEY.txt,763164,764122,958,10,N,N,-,-1,-1
WESLEY.txt,763213,764209,996,10,N,N,-,-1,-1
WESLEY.txt,763253,764222,969,10,N,N,-,-1,-1
WESLEY.txt,763388,764324,936,10,N,N,-,-1,-1
WESLEY.txt,763454,764360,906,10,N,N,-,-1,-1
WESLEY.txt,763536,764404,868,10,N,N,-,-1,-1
WESLEY.txt,763640,764449,809,10,N,N,-,-1,-1
WESLEY.txt,763655,764478,823,10,N,N,-,-1,-1
WESLEY.txt,763741,764527,786,10,N,N,-,-1,-1
WESLEY.txt,763936,764649,713,10,N,N,-,-1,-1
WESLEY.txt,764123,764706,583,10,N,N,-,-1,-1
WESLEY.txt,764210,764824,614,10,N,N,-,-1,-1
WESLEY.txt,764223,764852,629,10,N,N,-,-1,-1
WESLEY.txt,764325,764932,607,10,N,N,-,-1,-1
WESLEY.txt,764361,764995,634,10,N,N,-,-1,-1
WESLEY.txt,764405,765055,650,10,N,N,-,-1,-1
WESLEY.txt,764450,765133,683,10,N,N,-,-1,-1
WESLEY.txt,764479,765223,744,10,N,N,-,-1,-1
WESLEY.txt,764588,765373,785,10,N,N,-,-1,-1
WESLEY.txt,764650,765464,814,10,N,N,-,-1,-1
WESLEY.txt,764707,765565,858,10,N,N,-,-1,-1
WESLEY.txt,764825,765639,814,10,N,N,-,-1,-1
WESLEY.txt,764853,765778,925,10,N,N,-,-1,-1
WESLEY.txt,764932,765852,920,10,N,N,-,-1,-1
WESLEY.txt,764996,765967,971,10,N,N,-,-1,-1
WESLEY.txt,765056,766049,993,10,N,N,-,-1,-1
WESLEY.txt,765134,766169,1035,10,N,N,-,-1,-1
WESLEY.txt,765224,766261,1037,10,N,N,-,-1,-1
WESLEY.txt,765374,766373,999,10,N,N,-,-1,-1
WESLEY.txt,765465,766386,921,10,N,N,-,-1,-1
WESLEY.txt,765566,766414,848,10,N,N,-,-1,-1
WESLEY.txt,765640,766486,846,10,N,N,-,-1,-1
WESLEY.txt,765779,766607,828,10,N,N,-,-1,-1
WESLEY.txt,765853,766722,869,10,N,N,-,-1,-1
WESLEY.txt,765968,766838,870,10,N,N,-,-1,-1
WESLEY.txt,766050,766889,839,10,N,N,-,-1,-1
WESLEY.txt,766170,766959,789,10,N,N,-,-1,-1
WESLEY.txt,766262,767031,769,10,N,N,-,-1,-1
WESLEY.txt,766374,767050,676,10,N,N,-,-1,-1
WESLEY.txt,766387,767080,693,10,N,N,-,-1,-1
WESLEY.txt,766415,767271,856,10,N,N,-,-1,-1
WESLEY.txt,766486,767343,857,10,N,N,-,-1,-1
WESLEY.txt,766608,767437,829,10,N,N,-,-1,-1
WESLEY.txt,766723,767577,854,10,N,N,-,-1,-1
WESLEY.txt,766839,767669,830,10,N,N,-,-1,-1
WESLEY.txt,766890,767752,862,10,N,N,-,-1,-1
WESLEY.txt,766960,767842,882,10,N,N,-,-1,-1
WESLEY.txt,767032,767882,850,10,N,N,-,-1,-1
WESLEY.txt,767050,767935,885,10,N,N,-,-1,-1
WESLEY.txt,767081,768031,950,10,N,N,-,-1,-1
WESLEY.txt,767272,768116,844,10,N,N,-,-1,-1
WESLEY.txt,767344,768146,802,10,N,N,-,-1,-1
WESLEY.txt,767438,768320,882,10,N,N,-,-1,-1
WESLEY.txt,767578,768364,786,10,N,N,-,-1,-1
WESLEY.txt,767670,768413,743,10,N,N,-,-1,-1
WESLEY.txt,767753,768493,740,10,N,N,-,-1,-1
WESLEY.txt,767843,768556,713,10,N,N,-,-1,-1
WESLEY.txt,767883,768597,714,10,N,N,-,-1,-1
WESLEY.txt,767936,768660,724,10,N,N,-,-1,-1
WESLEY.txt,768032,768696,664,10,N,N,-,-1,-1
WESLEY.txt,768117,768736,619,10,N,N,-,-1,-1
WESLEY.txt,768147,768782,635,10,N,N,-,-1,-1
WESLEY.txt,768321,768929,608,10,N,N,-,-1,-1
WESLEY.txt,768365,769000,635,10,N,N,-,-1,-1
WESLEY.txt,768414,769024,610,10,N,N,-,-1,-1
WESLEY.txt,768494,769218,724,10,N,N,-,-1,-1
WESLEY.txt,768557,769312,755,10,N,N,-,-1,-1
WESLEY.txt,768598,769388,790,10,N,N,-,-1,-1
WESLEY.txt,768661,769489,828,10,N,N,-,-1,-1
WESLEY.txt,768697,769495,798,10,N,N,-,-1,-1
WESLEY.txt,768737,769600,863,10,N,N,-,-1,-1
WESLEY.txt,768782,769773,991,10,N,N,-,-1,-1
WESLEY.txt,768930,769834,904,10,N,N,-,-1,-1
WESLEY.txt,769001,769851,850,10,N,N,-,-1,-1
WESLEY.txt,769024,769974,950,10,N,N,-,-1,-1
WESLEY.txt,769219,770002,783,10,N,N,-,-1,-1
WESLEY.txt,769313,770107,794,10,N,N,-,-1,-1
WESLEY.txt,769389,770128,739,10,N,N,-,-1,-1
WESLEY.txt,769490,770319,829,10,N,N,-,-1,-1
WESLEY.txt,769496,770360,864,10,N,N,-,-1,-1
WESLEY.txt,769601,770705,1104,10,N,N,-,-1,-1
WESLEY.txt,769774,770950,1176,10,N,N,-,-1,-1
WESLEY.txt,769835,771031,1196,10,N,N,-,-1,-1
WESLEY.txt,769851,771122,1271,10,N,N,-,-1,-1
WESLEY.txt,769975,771191,1216,10,N,N,-,-1,-1
WESLEY.txt,770003,771404,1401,10,N,N,-,-1,-1
WESLEY.txt,770107,771566,1459,10,N,N,-,-1,-1
WESLEY.txt,770129,771658,1529,10,N,N,-,-1,-1
WESLEY.txt,770320,771854,1534,10,N,N,-,-1,-1
WESLEY.txt,770361,772054,1693,10,N,N,-,-1,-1
WESLEY.txt,770706,772201,1495,10,N,N,-,-1,-1
WESLEY.txt,770951,772284,1333,10,N,N,-,-1,-1
WESLEY.txt,771032,772356,1324,10,N,N,-,-1,-1
WESLEY.txt,771122,772459,1337,10,N,N,-,-1,-1
WESLEY.txt,771192,772557,1365,10,N,N,-,-1,-1
WESLEY.txt,771405,772822,1417,10,N,N,-,-1,-1
WESLEY.txt,771567,772833,1266,10,N,N,-,-1,-1
WESLEY.txt,771659,772914,1255,10,N,N,-,-1,-1
WESLEY.txt,771855,772926,1071,10,N,N,-,-1,-1
WESLEY.txt,772055,772956,901,10,N,N,-,-1,-1
WESLEY.txt,772202,773105,903,10,N,N,-,-1,-1
WESLEY.txt,772285,773183,898,10,N,N,-,-1,-1
WESLEY.txt,772357,773249,892,10,N,N,-,-1,-1
WESLEY.txt,772460,773263,803,10,N,N,-,-1,-1
WESLEY.txt,772558,773346,788,10,N,N,-,-1,-1
WESLEY.txt,772823,773424,601,10,N,N,-,-1,-1
WESLEY.txt,772833,773533,700,10,N,N,-,-1,-1
WESLEY.txt,772915,773607,692,10,N,N,-,-1,-1
WESLEY.txt,772927,773620,693,10,N,N,-,-1,-1
WESLEY.txt,772957,773707,750,10,N,N,-,-1,-1
WESLEY.txt,773106,773790,684,10,N,N,-,-1,-1
WESLEY.txt,773184,773879,695,10,N,N,-,-1,-1
WESLEY.txt,773250,773949,699,10,N,N,-,-1,-1
WESLEY.txt,773263,773961,698,10,N,N,-,-1,-1
WESLEY.txt,773347,774128,781,10,N,N,-,-1,-1
WESLEY.txt,773425,774256,831,10,N,N,-,-1,-1
WESLEY.txt,773534,774329,795,10,N,N,-,-1,-1
WESLEY.txt,773608,774359,751,10,N,N,-,-1,-1
WESLEY.txt,773620,774448,828,10,N,N,-,-1,-1
WESLEY.txt,773708,774460,752,10,N,N,-,-1,-1
WESLEY.txt,773791,774536,745,10,N,N,-,-1,-1
WESLEY.txt,773880,774637,757,10,N,N,-,-1,-1
WESLEY.txt,773950,774765,815,10,N,N,-,-1,-1
WESLEY.txt,773961,774806,845,10,N,N,-,-1,-1
WESLEY.txt,774129,774882,753,10,N,N,-,-1,-1
WESLEY.txt,774257,774900,643,10,N,N,-,-1,-1
WESLEY.txt,774330,775070,740,10,N,N,-,-1,-1
WESLEY.txt,774360,775212,852,10,N,N,-,-1,-1
WESLEY.txt,774449,775396,947,10,N,N,-,-1,-1
WESLEY.txt,774460,775441,981,10,N,N,-,-1,-1
WESLEY.txt,774537,775584,1047,10,N,N,-,-1,-1
WESLEY.txt,774638,775623,985,10,N,N,-,-1,-1
WESLEY.txt,774766,775637,871,10,N,N,-,-1,-1
WESLEY.txt,774807,775711,904,10,N,N,-,-1,-1
WESLEY.txt,774883,775805,922,10,N,N,-,-1,-1
WESLEY.txt,774900,775934,1034,10,N,N,-,-1,-1
WESLEY.txt,775071,776039,968,10,N,N,-,-1,-1
WESLEY.txt,775213,776131,918,10,N,N,-,-1,-1
WESLEY.txt,775397,776248,851,10,N,N,-,-1,-1
WESLEY.txt,775442,776367,925,10,N,N,-,-1,-1
WESLEY.txt,775585,776425,840,10,N,N,-,-1,-1
WESLEY.txt,775624,776445,821,10,N,N,-,-1,-1
WESLEY.txt,775637,776527,890,10,N,N,-,-1,-1
WESLEY.txt,775712,776604,892,10,N,N,-,-1,-1
WESLEY.txt,775806,776742,936,10,N,N,-,-1,-1
WESLEY.txt,775935,776865,930,10,N,N,-,-1,-1
WESLEY.txt,776040,776880,840,10,N,N,-,-1,-1
WESLEY.txt,776132,776957,825,10,N,N,-,-1,-1
WESLEY.txt,776249,776981,732,10,N,N,-,-1,-1
WESLEY.txt,776368,777044,676,10,N,N,-,-1,-1
WESLEY.txt,776426,777096,670,10,N,N,-,-1,-1
WESLEY.txt,776445,777235,790,10,N,N,-,-1,-1
WESLEY.txt,776528,777252,724,10,N,N,-,-1,-1
WESLEY.txt,776605,777345,740,10,N,N,-,-1,-1
WESLEY.txt,776743,777490,747,10,N,N,-,-1,-1
WESLEY.txt,776866,777643,777,10,N,N,-,-1,-1
WESLEY.txt,776880,777839,959,10,N,N,-,-1,-1
WESLEY.txt,776958,777937,979,10,N,N,-,-1,-1
WESLEY.txt,776982,778147,1165,10,N,N,-,-1,-1
WESLEY.txt,777045,778215,1170,10,N,N,-,-1,-1
WESLEY.txt,777097,778331,1234,10,N,N,-,-1,-1
WESLEY.txt,777236,778387,1151,10,N,N,-,-1,-1
WESLEY.txt,777252,778456,1204,10,N,N,-,-1,-1
WESLEY.txt,777346,778491,1145,10,N,N,-,-1,-1
WESLEY.txt,777491,778554,1063,10,N,N,-,-1,-1
WESLEY.txt,777644,778635,991,10,N,N,-,-1,-1
WESLEY.txt,777840,778665,825,10,N,N,-,-1,-1
WESLEY.txt,777938,778853,915,10,N,N,-,-1,-1
WESLEY.txt,778148,778865,717,10,N,N,-,-1,-1
WESLEY.txt,778215,778901,686,10,N,N,-,-1,-1
WESLEY.txt,778332,778944,612,10,N,N,-,-1,-1
WESLEY.txt,778388,778963,575,10,N,N,-,-1,-1
WESLEY.txt,778457,779028,571,10,N,N,-,-1,-1
WESLEY.txt,778492,779039,547,10,N,N,-,-1,-1
WESLEY.txt,778555,779174,619,10,N,N,-,-1,-1
WESLEY.txt,778636,779228,592,10,N,N,-,-1,-1
WESLEY.txt,778666,779280,614,10,N,N,-,-1,-1
WESLEY.txt,778854,779310,456,10,N,N,-,-1,-1
WESLEY.txt,778865,779402,537,10,N,N,-,-1,-1
WESLEY.txt,778902,779511,609,10,N,N,-,-1,-1
WESLEY.txt,778945,779619,674,10,N,N,-,-1,-1
WESLEY.txt,778963,779675,712,10,N,N,-,-1,-1
WESLEY.txt,779029,779715,686,10,N,N,-,-1,-1
WESLEY.txt,779040,779829,789,10,N,N,-,-1,-1
WESLEY.txt,779175,779935,760,10,N,N,-,-1,-1
WESLEY.txt,779229,779999,770,10,N,N,-,-1,-1
WESLEY.txt,779281,780119,838,10,N,N,-,-1,-1
WESLEY.txt,779310,780155,845,10,N,N,-,-1,-1
WESLEY.txt,779403,780234,831,10,N,N,-,-1,-1
WESLEY.txt,779512,780308,796,10,N,N,-,-1,-1
WESLEY.txt,779620,780330,710,10,N,N,-,-1,-1
WESLEY.txt,779676,780427,751,10,N,N,-,-1,-1
WESLEY.txt,779716,780536,820,10,N,N,-,-1,-1
WESLEY.txt,779829,780584,755,10,N,N,-,-1,-1
WESLEY.txt,779936,780597,661,10,N,N,-,-1,-1
WESLEY.txt,780000,780712,712,10,N,N,-,-1,-1
WESLEY.txt,780120,780739,619,10,N,N,-,-1,-1
WESLEY.txt,780156,780801,645,10,N,N,-,-1,-1
WESLEY.txt,780235,780812,577,10,N,N,-,-1,-1
WESLEY.txt,780309,780880,571,10,N,N,-,-1,-1
WESLEY.txt,780330,780987,657,10,N,N,-,-1,-1
WESLEY.txt,780428,781064,636,10,N,N,-,-1,-1
WESLEY.txt,780537,781112,575,10,N,N,-,-1,-1
WESLEY.txt,780585,781160,575,10,N,N,-,-1,-1
WESLEY.txt,780598,781204,606,10,N,N,-,-1,-1
WESLEY.txt,780713,781210,497,10,N,N,-,-1,-1
WESLEY.txt,780740,781230,490,10,N,N,-,-1,-1
WESLEY.txt,780802,781334,532,10,N,N,-,-1,-1
WESLEY.txt,780812,781448,636,10,N,N,-,-1,-1
WESLEY.txt,780881,781487,606,10,N,N,-,-1,-1
WESLEY.txt,780988,781549,561,10,N,N,-,-1,-1
WESLEY.txt,781065,781671,606,10,N,N,-,-1,-1
WESLEY.txt,781113,781735,622,10,N,N,-,-1,-1
WESLEY.txt,781161,781783,622,10,N,N,-,-1,-1
WESLEY.txt,781205,781848,643,10,N,N,-,-1,-1
WESLEY.txt,781211,781903,692,10,N,N,-,-1,-1
WESLEY.txt,781230,782027,797,10,N,N,-,-1,-1
WESLEY.txt,781335,782242,907,10,N,N,-,-1,-1
WESLEY.txt,781449,782786,1337,10,N,N,-,-1,-1
WESLEY.txt,781488,782872,1384,10,N,N,-,-1,-1
WESLEY.txt,781550,782890,1340,10,N,N,-,-1,-1
WESLEY.txt,781671,782966,1295,10,N,N,-,-1,-1
WESLEY.txt,781736,783017,1281,10,N,N,-,-1,-1
WESLEY.txt,781784,783146,1362,10,N,N,-,-1,-1
WESLEY.txt,781849,783308,1459,10,N,N,-,-1,-1
WESLEY.txt,781904,783333,1429,10,N,N,-,-1,-1
WESLEY.txt,782028,783380,1352,10,N,N,-,-1,-1
WESLEY.txt,782243,783392,1149,10,N,N,-,-1,-1
WESLEY.txt,782787,783459,672,10,N,N,-,-1,-1
WESLEY.txt,782873,783542,669,10,N,N,-,-1,-1
WESLEY.txt,782890,783595,705,10,N,N,-,-1,-1
WESLEY.txt,782967,783608,641,10,N,N,-,-1,-1
WESLEY.txt,783018,783679,661,10,N,N,-,-1,-1
WESLEY.txt,783147,783759,612,10,N,N,-,-1,-1
WESLEY.txt,783309,783927,618,10,N,N,-,-1,-1
WESLEY.txt,783334,784022,688,10,N,N,-,-1,-1
WESLEY.txt,783381,784106,725,10,N,N,-,-1,-1
WESLEY.txt,783392,784272,880,10,N,N,-,-1,-1
WESLEY.txt,783460,784398,938,10,N,N,-,-1,-1
WESLEY.txt,783543,784450,907,10,N,N,-,-1,-1
WESLEY.txt,783596,784533,937,10,N,N,-,-1,-1
WESLEY.txt,783608,784620,1012,10,N,N,-,-1,-1
WESLEY.txt,783680,784692,1012,10,N,N,-,-1,-1
WESLEY.txt,783760,784778,1018,10,N,N,-,-1,-1
WESLEY.txt,783928,784869,941,10,N,N,-,-1,-1
WESLEY.txt,784023,784961,938,10,N,N,-,-1,-1
WESLEY.txt,784107,785097,990,10,N,N,-,-1,-1
WESLEY.txt,784273,785192,919,10,N,N,-,-1,-1
WESLEY.txt,784398,785427,1029,10,N,N,-,-1,-1
WESLEY.txt,784451,785450,999,10,N,N,-,-1,-1
WESLEY.txt,784534,785612,1078,10,N,N,-,-1,-1
WESLEY.txt,784621,785699,1078,10,N,N,-,-1,-1
WESLEY.txt,784693,785800,1107,10,N,N,-,-1,-1
WESLEY.txt,784779,785812,1033,10,N,N,-,-1,-1
WESLEY.txt,784870,785901,1031,10,N,N,-,-1,-1
WESLEY.txt,784962,785995,1033,10,N,N,-,-1,-1
WESLEY.txt,785098,786097,999,10,N,N,-,-1,-1
WESLEY.txt,785193,786179,986,10,N,N,-,-1,-1
WESLEY.txt,785428,786366,938,10,N,N,-,-1,-1
WESLEY.txt,785450,786464,1014,10,N,N,-,-1,-1
WESLEY.txt,785613,786569,956,10,N,N,-,-1,-1
WESLEY.txt,785700,786640,940,10,N,N,-,-1,-1
WESLEY.txt,785801,786802,1001,10,N,N,-,-1,-1
WESLEY.txt,785812,786942,1130,10,N,N,-,-1,-1
WESLEY.txt,785902,787034,1132,10,N,N,-,-1,-1
WESLEY.txt,785996,787049,1053,10,N,N,-,-1,-1
WESLEY.txt,786098,787129,1031,10,N,N,-,-1,-1
WESLEY.txt,786180,787209,1029,10,N,N,-,-1,-1
WESLEY.txt,786367,787289,922,10,N,N,-,-1,-1
WESLEY.txt,786465,787397,932,10,N,N,-,-1,-1
WESLEY.txt,786569,787419,850,10,N,N,-,-1,-1
WESLEY.txt,786641,787593,952,10,N,N,-,-1,-1
WESLEY.txt,786803,787773,970,10,N,N,-,-1,-1
WESLEY.txt,786943,787867,924,10,N,N,-,-1,-1
WESLEY.txt,787035,787954,919,10,N,N,-,-1,-1
WESLEY.txt,787049,787967,918,10,N,N,-,-1,-1
WESLEY.txt,787130,788055,925,10,N,N,-,-1,-1
WESLEY.txt,787210,788132,922,10,N,N,-,-1,-1
WESLEY.txt,787290,788204,914,10,N,N,-,-1,-1
WESLEY.txt,787398,788297,899,10,N,N,-,-1,-1
WESLEY.txt,787419,788392,973,10,N,N,-,-1,-1
WESLEY.txt,787594,788480,886,10,N,N,-,-1,-1
WESLEY.txt,787774,788566,792,10,N,N,-,-1,-1
WESLEY.txt,787867,788668,801,10,N,N,-,-1,-1
WESLEY.txt,787955,788760,805,10,N,N,-,-1,-1
WESLEY.txt,787968,788855,887,10,N,N,-,-1,-1
WESLEY.txt,788056,788936,880,10,N,N,-,-1,-1
WESLEY.txt,788133,789004,871,10,N,N,-,-1,-1
WESLEY.txt,788205,789165,960,10,N,N,-,-1,-1
WESLEY.txt,788298,789280,982,10,N,N,-,-1,-1
WESLEY.txt,788393,789442,1049,10,N,N,-,-1,-1
WESLEY.txt,788481,789514,1033,10,N,N,-,-1,-1
WESLEY.txt,788567,789564,997,10,N,N,-,-1,-1
WESLEY.txt,788669,789672,1003,10,N,N,-,-1,-1
WESLEY.txt,788761,789844,1083,10,N,N,-,-1,-1
WESLEY.txt,788856,789856,1000,10,N,N,-,-1,-1
WESLEY.txt,788937,789936,999,10,N,N,-,-1,-1
WESLEY.txt,789005,789993,988,10,N,N,-,-1,-1
WESLEY.txt,789166,790139,973,10,N,N,-,-1,-1
WESLEY.txt,789280,790281,1001,10,N,N,-,-1,-1
WESLEY.txt,789443,790387,944,10,N,N,-,-1,-1
WESLEY.txt,789515,790399,884,10,N,N,-,-1,-1
WESLEY.txt,789565,790600,1035,10,N,N,-,-1,-1
WESLEY.txt,789673,790612,939,10,N,N,-,-1,-1
WESLEY.txt,789845,790679,834,10,N,N,-,-1,-1
WESLEY.txt,789856,790695,839,10,N,N,-,-1,-1
WESLEY.txt,789937,790747,810,10,N,N,-,-1,-1
WESLEY.txt,789994,790773,779,10,N,N,-,-1,-1
WESLEY.txt,790140,790796,656,10,N,N,-,-1,-1
WESLEY.txt,790282,790861,579,10,N,N,-,-1,-1
WESLEY.txt,790388,790875,487,10,N,N,-,-1,-1
WESLEY.txt,790399,790968,569,10,N,N,-,-1,-1
WESLEY.txt,790601,791049,448,10,N,N,-,-1,-1
WESLEY.txt,790612,791094,482,10,N,N,-,-1,-1
WESLEY.txt,790680,791241,561,10,N,N,-,-1,-1
WESLEY.txt,790696,791280,584,10,N,N,-,-1,-1
WESLEY.txt,790748,791313,565,10,N,N,-,-1,-1
WESLEY.txt,790774,791394,620,10,N,N,-,-1,-1
WESLEY.txt,790797,791467,670,10,N,N,-,-1,-1
WESLEY.txt,790862,791561,699,10,N,N,-,-1,-1
WESLEY.txt,790875,791654,779,10,N,N,-,-1,-1
WESLEY.txt,790969,791676,707,10,N,N,-,-1,-1
WESLEY.txt,791050,791731,681,10,N,N,-,-1,-1
WESLEY.txt,791095,791792,697,10,N,N,-,-1,-1
WESLEY.txt,791242,791835,593,10,N,N,-,-1,-1
WESLEY.txt,791281,791847,566,10,N,N,-,-1,-1
WESLEY.txt,791314,791950,636,10,N,N,-,-1,-1
WESLEY.txt,791395,792048,653,10,N,N,-,-1,-1
WESLEY.txt,791468,792272,804,10,N,N,-,-1,-1
WESLEY.txt,791562,792359,797,10,N,N,-,-1,-1
WESLEY.txt,791655,792451,796,10,N,N,-,-1,-1
WESLEY.txt,791676,792522,846,10,N,N,-,-1,-1
WESLEY.txt,791732,792626,894,10,N,N,-,-1,-1
WESLEY.txt,791793,792703,910,10,N,N,-,-1,-1
WESLEY.txt,791836,792785,949,10,N,N,-,-1,-1
WESLEY.txt,791848,792986,1138,10,N,N,-,-1,-1
WESLEY.txt,791951,793076,1125,10,N,N,-,-1,-1
WESLEY.txt,792048,793172,1124,10,N,N,-,-1,-1
WESLEY.txt,792273,793294,1021,10,N,N,-,-1,-1
WESLEY.txt,792360,793377,1017,10,N,N,-,-1,-1
WESLEY.txt,792452,793520,1068,10,N,N,-,-1,-1
WESLEY.txt,792523,793632,1109,10,N,N,-,-1,-1
WESLEY.txt,792627,793716,1089,10,N,N,-,-1,-1
WESLEY.txt,792704,793799,1095,10,N,N,-,-1,-1
WESLEY.txt,792786,793908,1122,10,N,N,-,-1,-1
WESLEY.txt,792987,793960,973,10,N,N,-,-1,-1
WESLEY.txt,793077,794124,1047,10,N,N,-,-1,-1
WESLEY.txt,793173,794303,1130,10,N,N,-,-1,-1
WESLEY.txt,793295,794391,1096,10,N,N,-,-1,-1
WESLEY.txt,793378,794525,1147,10,N,N,-,-1,-1
WESLEY.txt,793521,794555,1034,10,N,N,-,-1,-1
WESLEY.txt,793633,794571,938,10,N,N,-,-1,-1
WESLEY.txt,793717,794636,919,10,N,N,-,-1,-1
WESLEY.txt,793800,794739,939,10,N,N,-,-1,-1
WESLEY.txt,793909,794845,936,10,N,N,-,-1,-1
WESLEY.txt,793961,794943,982,10,N,N,-,-1,-1
WESLEY.txt,794125,794990,865,10,N,N,-,-1,-1
WESLEY.txt,794304,795086,782,10,N,N,-,-1,-1
WESLEY.txt,794392,795123,731,10,N,N,-,-1,-1
WESLEY.txt,794526,795173,647,10,N,N,-,-1,-1
WESLEY.txt,794556,795260,704,10,N,N,-,-1,-1
WESLEY.txt,794571,795425,854,10,N,N,-,-1,-1
WESLEY.txt,794637,795509,872,10,N,N,-,-1,-1
WESLEY.txt,794740,795615,875,10,N,N,-,-1,-1
WESLEY.txt,794846,795653,807,10,N,N,-,-1,-1
WESLEY.txt,794944,795690,746,10,N,N,-,-1,-1
WESLEY.txt,794991,795743,752,10,N,N,-,-1,-1
WESLEY.txt,795087,795801,714,10,N,N,-,-1,-1
WESLEY.txt,795124,795885,761,10,N,N,-,-1,-1
WESLEY.txt,795174,795987,813,10,N,N,-,-1,-1
WESLEY.txt,795261,796091,830,10,N,N,-,-1,-1
WESLEY.txt,795426,796221,795,10,N,N,-,-1,-1
WESLEY.txt,795510,796301,791,10,N,N,-,-1,-1
WESLEY.txt,795616,796462,846,10,N,N,-,-1,-1
WESLEY.txt,795654,796480,826,10,N,N,-,-1,-1
WESLEY.txt,795691,796556,865,10,N,N,-,-1,-1
WESLEY.txt,795743,796674,931,10,N,N,-,-1,-1
WESLEY.txt,795802,796757,955,10,N,N,-,-1,-1
WESLEY.txt,795886,796851,965,10,N,N,-,-1,-1
WESLEY.txt,795988,797074,1086,10,N,N,-,-1,-1
WESLEY.txt,796092,797169,1077,10,N,N,-,-1,-1
WESLEY.txt,796222,797237,1015,10,N,N,-,-1,-1
WESLEY.txt,796302,797259,957,10,N,N,-,-1,-1
WESLEY.txt,796463,797404,941,10,N,N,-,-1,-1
WESLEY.txt,796480,797411,931,10,N,N,-,-1,-1
WESLEY.txt,796557,797456,899,10,N,N,-,-1,-1
WESLEY.txt,796675,797577,902,10,N,N,-,-1,-1
WESLEY.txt,796758,797651,893,10,N,N,-,-1,-1
WESLEY.txt,796852,797785,933,10,N,N,-,-1,-1
WESLEY.txt,797075,797940,865,10,N,N,-,-1,-1
WESLEY.txt,797170,797979,809,10,N,N,-,-1,-1
WESLEY.txt,797237,798079,842,10,N,N,-,-1,-1
WESLEY.txt,797260,798090,830,10,N,N,-,-1,-1
WESLEY.txt,797405,798175,770,10,N,N,-,-1,-1
WESLEY.txt,797412,798288,876,10,N,N,-,-1,-1
WESLEY.txt,797457,798353,896,10,N,N,-,-1,-1
WESLEY.txt,797578,798463,885,10,N,N,-,-1,-1
WESLEY.txt,797652,798624,972,10,N,N,-,-1,-1
WESLEY.txt,797786,798636,850,10,N,N,-,-1,-1
WESLEY.txt,797941,798762,821,10,N,N,-,-1,-1
WESLEY.txt,797980,798869,889,10,N,N,-,-1,-1
WESLEY.txt,798080,798940,860,10,N,N,-,-1,-1
WESLEY.txt,798090,799133,1043,10,N,N,-,-1,-1
WESLEY.txt,798176,799314,1138,10,N,N,-,-1,-1
WESLEY.txt,798289,799430,1141,10,N,N,-,-1,-1
WESLEY.txt,798354,799483,1129,10,N,N,-,-1,-1
WESLEY.txt,798464,799510,1046,10,N,N,-,-1,-1
WESLEY.txt,798625,799571,946,10,N,N,-,-1,-1
WESLEY.txt,798636,799654,1018,10,N,N,-,-1,-1
WESLEY.txt,798763,799703,940,10,N,N,-,-1,-1
WESLEY.txt,798870,799716,846,10,N,N,-,-1,-1
WESLEY.txt,798940,799753,813,10,N,N,-,-1,-1
WESLEY.txt,799134,799786,652,10,N,N,-,-1,-1
WESLEY.txt,799315,799857,542,10,N,N,-,-1,-1
WESLEY.txt,799431,799941,510,10,N,N,-,-1,-1
WESLEY.txt,799484,800040,556,10,N,N,-,-1,-1
WESLEY.txt,799511,800051,540,10,N,N,-,-1,-1
WESLEY.txt,799572,800225,653,10,N,N,-,-1,-1
WESLEY.txt,799655,800319,664,10,N,N,-,-1,-1
WESLEY.txt,799704,800396,692,10,N,N,-,-1,-1
WESLEY.txt,799716,800528,812,10,N,N,-,-1,-1
WESLEY.txt,799754,800610,856,10,N,N,-,-1,-1
WESLEY.txt,799787,800730,943,10,N,N,-,-1,-1
WESLEY.txt,799858,800967,1109,10,N,N,-,-1,-1
WESLEY.txt,799942,801058,1116,10,N,N,-,-1,-1
WESLEY.txt,800041,801160,1119,10,N,N,-,-1,-1
WESLEY.txt,800051,801218,1167,10,N,N,-,-1,-1
WESLEY.txt,800226,801354,1128,10,N,N,-,-1,-1
WESLEY.txt,800320,801432,1112,10,N,N,-,-1,-1
WESLEY.txt,800397,801445,1048,10,N,N,-,-1,-1
WESLEY.txt,800529,801524,995,10,N,N,-,-1,-1
WESLEY.txt,800611,801536,925,10,N,N,-,-1,-1
WESLEY.txt,800731,801682,951,10,N,N,-,-1,-1
WESLEY.txt,800968,801768,800,10,N,N,-,-1,-1
WESLEY.txt,801059,801849,790,10,N,N,-,-1,-1
WESLEY.txt,801161,801927,766,10,N,N,-,-1,-1
WESLEY.txt,801219,801940,721,10,N,N,-,-1,-1
WESLEY.txt,801355,802041,686,10,N,N,-,-1,-1
WESLEY.txt,801433,802185,752,10,N,N,-,-1,-1
WESLEY.txt,801445,802279,834,10,N,N,-,-1,-1
WESLEY.txt,801525,802293,768,10,N,N,-,-1,-1
WESLEY.txt,801537,802409,872,10,N,N,-,-1,-1
WESLEY.txt,801683,802550,867,10,N,N,-,-1,-1
WESLEY.txt,801769,802562,793,10,N,N,-,-1,-1
WESLEY.txt,801850,802599,749,10,N,N,-,-1,-1
WESLEY.txt,801928,802710,782,10,N,N,-,-1,-1
WESLEY.txt,801940,802765,825,10,N,N,-,-1,-1
WESLEY.txt,802042,802775,733,10,N,N,-,-1,-1
WESLEY.txt,802186,802797,611,10,N,N,-,-1,-1
WESLEY.txt,802280,802896,616,10,N,N,-,-1,-1
WESLEY.txt,802293,803007,714,10,N,N,-,-1,-1
WESLEY.txt,802410,803106,696,10,N,N,-,-1,-1
WESLEY.txt,802551,803200,649,10,N,N,-,-1,-1
WESLEY.txt,802563,803229,666,10,N,N,-,-1,-1
WESLEY.txt,802600,803296,696,10,N,N,-,-1,-1
WESLEY.txt,802711,803335,624,10,N,N,-,-1,-1
WESLEY.txt,802766,803383,617,10,N,N,-,-1,-1
WESLEY.txt,802775,803400,625,10,N,N,-,-1,-1
WESLEY.txt,802798,803480,682,10,N,N,-,-1,-1
WESLEY.txt,802897,803555,658,10,N,N,-,-1,-1
WESLEY.txt,803008,803629,621,10,N,N,-,-1,-1
WESLEY.txt,803107,803714,607,10,N,N,-,-1,-1
WESLEY.txt,803201,803772,571,10,N,N,-,-1,-1
WESLEY.txt,803230,803801,571,10,N,N,-,-1,-1
WESLEY.txt,803297,803953,656,10,N,N,-,-1,-1
WESLEY.txt,803336,804029,693,10,N,N,-,-1,-1
WESLEY.txt,803384,804108,724,10,N,N,-,-1,-1
WESLEY.txt,803400,804203,803,10,N,N,-,-1,-1
WESLEY.txt,803481,804215,734,10,N,N,-,-1,-1
WESLEY.txt,803556,804391,835,10,N,N,-,-1,-1
WESLEY.txt,803630,804462,832,10,N,N,-,-1,-1
WESLEY.txt,803715,804544,829,10,N,N,-,-1,-1
WESLEY.txt,803773,804646,873,10,N,N,-,-1,-1
WESLEY.txt,803802,804733,931,10,N,N,-,-1,-1
WESLEY.txt,803954,804779,825,10,N,N,-,-1,-1
WESLEY.txt,804030,804835,805,10,N,N,-,-1,-1
WESLEY.txt,804109,804928,819,10,N,N,-,-1,-1
WESLEY.txt,804204,804939,735,10,N,N,-,-1,-1
WESLEY.txt,804215,805073,858,10,N,N,-,-1,-1
WESLEY.txt,804392,805163,771,10,N,N,-,-1,-1
WESLEY.txt,804463,805190,727,10,N,N,-,-1,-1
WESLEY.txt,804545,805241,696,10,N,N,-,-1,-1
WESLEY.txt,804647,805321,674,10,N,N,-,-1,-1
WESLEY.txt,804734,805434,700,10,N,N,-,-1,-1
WESLEY.txt,804780,805608,828,10,N,N,-,-1,-1
WESLEY.txt,804836,805671,835,10,N,N,-,-1,-1
WESLEY.txt,804929,805738,809,10,N,N,-,-1,-1
WESLEY.txt,804939,805809,870,10,N,N,-,-1,-1
WESLEY.txt,805074,805855,781,10,N,N,-,-1,-1
WESLEY.txt,805164,805874,710,10,N,N,-,-1,-1
WESLEY.txt,805191,805989,798,10,N,N,-,-1,-1
WESLEY.txt,805242,806062,820,10,N,N,-,-1,-1
WESLEY.txt,805321,806077,756,10,N,N,-,-1,-1
WESLEY.txt,805434,806123,689,10,N,N,-,-1,-1
WESLEY.txt,805609,806135,526,10,N,N,-,-1,-1
WESLEY.txt,805672,806225,553,10,N,N,-,-1,-1
WESLEY.txt,805739,806292,553,10,N,N,-,-1,-1
WESLEY.txt,805810,806567,757,10,N,N,-,-1,-1
WESLEY.txt,805856,806585,729,10,N,N,-,-1,-1
WESLEY.txt,805875,806666,791,10,N,N,-,-1,-1
WESLEY.txt,805990,806677,687,10,N,N,-,-1,-1
WESLEY.txt,806063,806808,745,10,N,N,-,-1,-1
WESLEY.txt,806077,806922,845,10,N,N,-,-1,-1
WESLEY.txt,806124,806989,865,10,N,N,-,-1,-1
WESLEY.txt,806136,807025,889,10,N,N,-,-1,-1
WESLEY.txt,806226,807037,811,10,N,N,-,-1,-1
WESLEY.txt,806293,807187,894,10,N,N,-,-1,-1
WESLEY.txt,806568,807297,729,10,N,N,-,-1,-1
WESLEY.txt,806585,807403,818,10,N,N,-,-1,-1
WESLEY.txt,806667,807507,840,10,N,N,-,-1,-1
WESLEY.txt,806677,807620,943,10,N,N,-,-1,-1
WESLEY.txt,806809,807659,850,10,N,N,-,-1,-1
WESLEY.txt,806923,807699,776,10,N,N,-,-1,-1
WESLEY.txt,806990,807794,804,10,N,N,-,-1,-1
WESLEY.txt,807026,807900,874,10,N,N,-,-1,-1
WESLEY.txt,807037,807914,877,10,N,N,-,-1,-1
WESLEY.txt,807188,807934,746,10,N,N,-,-1,-1
WESLEY.txt,807298,807998,700,10,N,N,-,-1,-1
WESLEY.txt,807403,808013,610,10,N,N,-,-1,-1
WESLEY.txt,807508,808143,635,10,N,N,-,-1,-1
WESLEY.txt,807621,808234,613,10,N,N,-,-1,-1
WESLEY.txt,807660,808344,684,10,N,N,-,-1,-1
WESLEY.txt,807700,808364,664,10,N,N,-,-1,-1
WESLEY.txt,807795,808537,742,10,N,N,-,-1,-1
WESLEY.txt,807901,808577,676,10,N,N,-,-1,-1
WESLEY.txt,807914,808758,844,10,N,N,-,-1,-1
WESLEY.txt,807935,808835,900,10,N,N,-,-1,-1
WESLEY.txt,807999,808914,915,10,N,N,-,-1,-1
WESLEY.txt,808014,808988,974,10,N,N,-,-1,-1
WESLEY.txt,808144,809002,858,10,N,N,-,-1,-1
WESLEY.txt,808235,809122,887,10,N,N,-,-1,-1
WESLEY.txt,808345,809211,866,10,N,N,-,-1,-1
WESLEY.txt,808364,809398,1034,10,N,N,-,-1,-1
WESLEY.txt,808538,809930,1392,10,N,N,-,-1,-1
WESLEY.txt,808578,810014,1436,10,N,N,-,-1,-1
WESLEY.txt,808759,810162,1403,10,N,N,-,-1,-1
WESLEY.txt,808836,810202,1366,10,N,N,-,-1,-1
WESLEY.txt,808915,810396,1481,10,N,N,-,-1,-1
WESLEY.txt,808989,810488,1499,10,N,N,-,-1,-1
WESLEY.txt,809002,810585,1583,10,N,N,-,-1,-1
WESLEY.txt,809123,810607,1484,10,N,N,-,-1,-1
WESLEY.txt,809211,810635,1424,10,N,N,-,-1,-1
WESLEY.txt,809399,810646,1247,10,N,N,-,-1,-1
WESLEY.txt,809931,810685,754,10,N,N,-,-1,-1
WESLEY.txt,810015,810803,788,10,N,N,-,-1,-1
WESLEY.txt,810163,810815,652,10,N,N,-,-1,-1
WESLEY.txt,810203,810904,701,10,N,N,-,-1,-1
WESLEY.txt,810397,811004,607,10,N,N,-,-1,-1
WESLEY.txt,810489,811025,536,10,N,N,-,-1,-1
WESLEY.txt,810586,811192,606,10,N,N,-,-1,-1
WESLEY.txt,810607,811292,685,10,N,N,-,-1,-1
WESLEY.txt,810636,811308,672,10,N,N,-,-1,-1
WESLEY.txt,810647,811391,744,10,N,N,-,-1,-1
WESLEY.txt,810686,811499,813,10,N,N,-,-1,-1
WESLEY.txt,810804,811514,710,10,N,N,-,-1,-1
WESLEY.txt,810815,811614,799,10,N,N,-,-1,-1
WESLEY.txt,810905,811696,791,10,N,N,-,-1,-1
WESLEY.txt,811005,811800,795,10,N,N,-,-1,-1
WESLEY.txt,811025,812015,990,10,N,N,-,-1,-1
WESLEY.txt,811193,812053,860,10,N,N,-,-1,-1
WESLEY.txt,811293,812159,866,10,N,N,-,-1,-1
WESLEY.txt,811308,812288,980,10,N,N,-,-1,-1
WESLEY.txt,811392,812364,972,10,N,N,-,-1,-1
WESLEY.txt,811500,812442,942,10,N,N,-,-1,-1
WESLEY.txt,811515,812658,1143,10,N,N,-,-1,-1
WESLEY.txt,811615,812697,1082,10,N,N,-,-1,-1
WESLEY.txt,811697,812801,1104,10,N,N,-,-1,-1
WESLEY.txt,811801,812815,1014,10,N,N,-,-1,-1
WESLEY.txt,812016,812905,889,10,N,N,-,-1,-1
WESLEY.txt,812054,813063,1009,10,N,N,-,-1,-1
WESLEY.txt,812160,813176,1016,10,N,N,-,-1,-1
WESLEY.txt,812289,813301,1012,10,N,N,-,-1,-1
WESLEY.txt,812365,813374,1009,10,N,N,-,-1,-1
WESLEY.txt,812443,813797,1354,10,N,N,-,-1,-1
WESLEY.txt,812659,813902,1243,10,N,N,-,-1,-1
WESLEY.txt,812698,813994,1296,10,N,N,-,-1,-1
WESLEY.txt,812802,814109,1307,10,N,N,-,-1,-1
WESLEY.txt,812815,814275,1460,10,N,N,-,-1,-1
WESLEY.txt,812906,814369,1463,10,N,N,-,-1,-1
WESLEY.txt,813064,814647,1583,10,N,N,-,-1,-1
WESLEY.txt,813177,814706,1529,10,N,N,-,-1,-1
WESLEY.txt,813302,814742,1440,10,N,N,-,-1,-1
WESLEY.txt,813375,814754,1379,10,N,N,-,-1,-1
WESLEY.txt,813798,814828,1030,10,N,N,-,-1,-1
WESLEY.txt,813903,814872,969,10,N,N,-,-1,-1
WESLEY.txt,813995,814909,914,10,N,N,-,-1,-1
WESLEY.txt,814110,814962,852,10,N,N,-,-1,-1
WESLEY.txt,814276,815024,748,10,N,N,-,-1,-1
WESLEY.txt,814370,815076,706,10,N,N,-,-1,-1
WESLEY.txt,814648,815179,531,10,N,N,-,-1,-1
WESLEY.txt,814707,815273,566,10,N,N,-,-1,-1
WESLEY.txt,814743,815314,571,10,N,N,-,-1,-1
WESLEY.txt,814754,815371,617,10,N,N,-,-1,-1
WESLEY.txt,814829,815640,811,10,N,N,-,-1,-1
WESLEY.txt,814873,815851,978,10,N,N,-,-1,-1
WESLEY.txt,814910,815949,1039,10,N,N,-,-1,-1
WESLEY.txt,814963,815988,1025,10,N,N,-,-1,-1
WESLEY.txt,815025,816079,1054,10,N,N,-,-1,-1
WESLEY.txt,815077,816279,1202,10,N,N,-,-1,-1
WESLEY.txt,815180,816359,1179,10,N,N,-,-1,-1
WESLEY.txt,815274,816531,1257,10,N,N,-,-1,-1
WESLEY.txt,815315,816632,1317,10,N,N,-,-1,-1
WESLEY.txt,815372,816777,1405,10,N,N,-,-1,-1
WESLEY.txt,815641,816789,1148,10,N,N,-,-1,-1
WESLEY.txt,815852,816846,994,10,N,N,-,-1,-1
WESLEY.txt,815950,817035,1085,10,N,N,-,-1,-1
WESLEY.txt,815989,817087,1098,10,N,N,-,-1,-1
WESLEY.txt,816080,817219,1139,10,N,N,-,-1,-1
WESLEY.txt,816280,817309,1029,10,N,N,-,-1,-1
WESLEY.txt,816360,817395,1035,10,N,N,-,-1,-1
WESLEY.txt,816532,817529,997,10,N,N,-,-1,-1
WESLEY.txt,816633,817676,1043,10,N,N,-,-1,-1
WESLEY.txt,816778,817720,942,10,N,N,-,-1,-1
WESLEY.txt,816789,817883,1094,10,N,N,-,-1,-1
WESLEY.txt,816847,818003,1156,10,N,N,-,-1,-1
WESLEY.txt,817036,818121,1085,10,N,N,-,-1,-1
WESLEY.txt,817088,818338,1250,10,N,N,-,-1,-1
WESLEY.txt,817220,818442,1222,10,N,N,-,-1,-1
WESLEY.txt,817310,818488,1178,10,N,N,-,-1,-1
WESLEY.txt,817396,818528,1132,10,N,N,-,-1,-1
WESLEY.txt,817530,818567,1037,10,N,N,-,-1,-1
WESLEY.txt,817677,818580,903,10,N,N,-,-1,-1
WESLEY.txt,817721,818652,931,10,N,N,-,-1,-1
WESLEY.txt,817884,818821,937,10,N,N,-,-1,-1
WESLEY.txt,818004,819044,1040,10,N,N,-,-1,-1
WESLEY.txt,818122,819109,987,10,N,N,-,-1,-1
WESLEY.txt,818339,819196,857,10,N,N,-,-1,-1
WESLEY.txt,818443,819309,866,10,N,N,-,-1,-1
WESLEY.txt,818489,819369,880,10,N,N,-,-1,-1
WESLEY.txt,818529,819451,922,10,N,N,-,-1,-1
WESLEY.txt,818568,819526,958,10,N,N,-,-1,-1
WESLEY.txt,818580,819541,961,10,N,N,-,-1,-1
WESLEY.txt,818653,819632,979,10,N,N,-,-1,-1
WESLEY.txt,818822,819694,872,10,N,N,-,-1,-1
WESLEY.txt,819045,819776,731,10,N,N,-,-1,-1
WESLEY.txt,819110,819800,690,10,N,N,-,-1,-1
WESLEY.txt,819197,819954,757,10,N,N,-,-1,-1
WESLEY.txt,819310,820074,764,10,N,N,-,-1,-1
WESLEY.txt,819370,820101,731,10,N,N,-,-1,-1
WESLEY.txt,819452,820192,740,10,N,N,-,-1,-1
WESLEY.txt,819527,820285,758,10,N,N,-,-1,-1
WESLEY.txt,819542,820310,768,10,N,N,-,-1,-1
WESLEY.txt,819633,820417,784,10,N,N,-,-1,-1
WESLEY.txt,819695,820452,757,10,N,N,-,-1,-1
WESLEY.txt,819776,820637,861,10,N,N,-,-1,-1
WESLEY.txt,819801,820649,848,10,N,N,-,-1,-1
WESLEY.txt,819955,820712,757,10,N,N,-,-1,-1
WESLEY.txt,820075,820878,803,10,N,N,-,-1,-1
WESLEY.txt,820102,821000,898,10,N,N,-,-1,-1
WESLEY.txt,820193,821091,898,10,N,N,-,-1,-1
WESLEY.txt,820286,821180,894,10,N,N,-,-1,-1
WESLEY.txt,820311,821274,963,10,N,N,-,-1,-1
WESLEY.txt,820418,821357,939,10,N,N,-,-1,-1
WESLEY.txt,820453,821431,978,10,N,N,-,-1,-1
WESLEY.txt,820638,821524,886,10,N,N,-,-1,-1
WESLEY.txt,820649,821660,1011,10,N,N,-,-1,-1
WESLEY.txt,820713,821769,1056,10,N,N,-,-1,-1
WESLEY.txt,820879,821836,957,10,N,N,-,-1,-1
WESLEY.txt,821001,821930,929,10,N,N,-,-1,-1
WESLEY.txt,821092,822026,934,10,N,N,-,-1,-1
WESLEY.txt,821181,822114,933,10,N,N,-,-1,-1
WESLEY.txt,821274,822184,910,10,N,N,-,-1,-1
WESLEY.txt,821358,822263,905,10,N,N,-,-1,-1
WESLEY.txt,821432,822368,936,10,N,N,-,-1,-1
WESLEY.txt,821525,822449,924,10,N,N,-,-1,-1
WESLEY.txt,821661,822464,803,10,N,N,-,-1,-1
WESLEY.txt,821770,822491,721,10,N,N,-,-1,-1
WESLEY.txt,821837,822611,774,10,N,N,-,-1,-1
WESLEY.txt,821931,822687,756,10,N,N,-,-1,-1
WESLEY.txt,822027,822804,777,10,N,N,-,-1,-1
WESLEY.txt,822115,822829,714,10,N,N,-,-1,-1
WESLEY.txt,822185,822875,690,10,N,N,-,-1,-1
WESLEY.txt,822264,822974,710,10,N,N,-,-1,-1
WESLEY.txt,822369,823082,713,10,N,N,-,-1,-1
WESLEY.txt,822450,823193,743,10,N,N,-,-1,-1
WESLEY.txt,822464,823305,841,10,N,N,-,-1,-1
WESLEY.txt,822492,823374,882,10,N,N,-,-1,-1
WESLEY.txt,822612,823394,782,10,N,N,-,-1,-1
WESLEY.txt,822688,823490,802,10,N,N,-,-1,-1
WESLEY.txt,822805,823621,816,10,N,N,-,-1,-1
WESLEY.txt,822830,823667,837,10,N,N,-,-1,-1
WESLEY.txt,822876,823717,841,10,N,N,-,-1,-1
WESLEY.txt,822975,823770,795,10,N,N,-,-1,-1
WESLEY.txt,823083,823936,853,10,N,N,-,-1,-1
WESLEY.txt,823194,823948,754,10,N,N,-,-1,-1
WESLEY.txt,823306,824007,701,10,N,N,-,-1,-1
WESLEY.txt,823375,824114,739,10,N,N,-,-1,-1
WESLEY.txt,823395,824350,955,10,N,N,-,-1,-1
WESLEY.txt,823490,824435,945,10,N,N,-,-1,-1
WESLEY.txt,823622,824452,830,10,N,N,-,-1,-1
WESLEY.txt,823668,824534,866,10,N,N,-,-1,-1
WESLEY.txt,823718,824617,899,10,N,N,-,-1,-1
WESLEY.txt,823771,824735,964,10,N,N,-,-1,-1
WESLEY.txt,823937,824821,884,10,N,N,-,-1,-1
WESLEY.txt,823948,824979,1031,10,N,N,-,-1,-1
WESLEY.txt,824008,825126,1118,10,N,N,-,-1,-1
WESLEY.txt,824115,825285,1170,10,N,N,-,-1,-1
WESLEY.txt,824351,825296,945,10,N,N,-,-1,-1
WESLEY.txt,824436,825466,1030,10,N,N,-,-1,-1
WESLEY.txt,824452,825489,1037,10,N,N,-,-1,-1
WESLEY.txt,824535,825591,1056,10,N,N,-,-1,-1
WESLEY.txt,824618,825597,979,10,N,N,-,-1,-1
WESLEY.txt,824736,825614,878,10,N,N,-,-1,-1
WESLEY.txt,824822,825809,987,10,N,N,-,-1,-1
WESLEY.txt,824980,825852,872,10,N,N,-,-1,-1
WESLEY.txt,825127,825867,740,10,N,N,-,-1,-1
WESLEY.txt,825286,825972,686,10,N,N,-,-1,-1
WESLEY.txt,825296,826311,1015,10,N,N,-,-1,-1
WESLEY.txt,825467,826349,882,10,N,N,-,-1,-1
WESLEY.txt,825489,826497,1008,10,N,N,-,-1,-1
WESLEY.txt,825592,826610,1018,10,N,N,-,-1,-1
WESLEY.txt,825598,826703,1105,10,N,N,-,-1,-1
WESLEY.txt,825614,827179,1565,10,N,N,-,-1,-1
WESLEY.txt,825810,827191,1381,10,N,N,-,-1,-1
WESLEY.txt,825853,827353,1500,10,N,N,-,-1,-1
WESLEY.txt,825868,827430,1562,10,N,N,-,-1,-1
WESLEY.txt,825973,827506,1533,10,N,N,-,-1,-1
WESLEY.txt,826312,827736,1424,10,N,N,-,-1,-1
WESLEY.txt,826350,827779,1429,10,N,N,-,-1,-1
WESLEY.txt,826498,827868,1370,10,N,N,-,-1,-1
WESLEY.txt,826611,828030,1419,10,N,N,-,-1,-1
WESLEY.txt,826704,828099,1395,10,N,N,-,-1,-1
WESLEY.txt,827180,828164,984,10,N,N,-,-1,-1
WESLEY.txt,827191,828281,1090,10,N,N,-,-1,-1
WESLEY.txt,827354,828375,1021,10,N,N,-,-1,-1
WESLEY.txt,827431,828447,1016,10,N,N,-,-1,-1
WESLEY.txt,827507,828487,980,10,N,N,-,-1,-1
WESLEY.txt,827737,828590,853,10,N,N,-,-1,-1
WESLEY.txt,827780,828625,845,10,N,N,-,-1,-1
WESLEY.txt,827869,828672,803,10,N,N,-,-1,-1
WESLEY.txt,828031,828770,739,10,N,N,-,-1,-1
WESLEY.txt,828100,828849,749,10,N,N,-,-1,-1
WESLEY.txt,828165,828997,832,10,N,N,-,-1,-1
WESLEY.txt,828282,829120,838,10,N,N,-,-1,-1
WESLEY.txt,828376,829188,812,10,N,N,-,-1,-1
WESLEY.txt,828448,829232,784,10,N,N,-,-1,-1
WESLEY.txt,828488,829267,779,10,N,N,-,-1,-1
WESLEY.txt,828590,829374,784,10,N,N,-,-1,-1
WESLEY.txt,828626,829385,759,10,N,N,-,-1,-1
WESLEY.txt,828673,829464,791,10,N,N,-,-1,-1
WESLEY.txt,828771,829638,867,10,N,N,-,-1,-1
WESLEY.txt,828850,829721,871,10,N,N,-,-1,-1
WESLEY.txt,828998,829766,768,10,N,N,-,-1,-1
WESLEY.txt,829121,829864,743,10,N,N,-,-1,-1
WESLEY.txt,829189,829890,701,10,N,N,-,-1,-1
WESLEY.txt,829233,829979,746,10,N,N,-,-1,-1
WESLEY.txt,829268,830059,791,10,N,N,-,-1,-1
WESLEY.txt,829375,830203,828,10,N,N,-,-1,-1
WESLEY.txt,829385,830313,928,10,N,N,-,-1,-1
WESLEY.txt,829465,830399,934,10,N,N,-,-1,-1
WESLEY.txt,829639,830472,833,10,N,N,-,-1,-1
WESLEY.txt,829722,830572,850,10,N,N,-,-1,-1
WESLEY.txt,829767,830649,882,10,N,N,-,-1,-1
WESLEY.txt,829864,830662,798,10,N,N,-,-1,-1
WESLEY.txt,829891,830762,871,10,N,N,-,-1,-1
WESLEY.txt,829980,830862,882,10,N,N,-,-1,-1
WESLEY.txt,830060,830949,889,10,N,N,-,-1,-1
WESLEY.txt,830204,831049,845,10,N,N,-,-1,-1
WESLEY.txt,830314,831134,820,10,N,N,-,-1,-1
WESLEY.txt,830400,831210,810,10,N,N,-,-1,-1
WESLEY.txt,830473,831316,843,10,N,N,-,-1,-1
WESLEY.txt,830573,831408,835,10,N,N,-,-1,-1
WESLEY.txt,830650,831523,873,10,N,N,-,-1,-1
WESLEY.txt,830662,831546,884,10,N,N,-,-1,-1
WESLEY.txt,830763,831561,798,10,N,N,-,-1,-1
WESLEY.txt,830863,831678,815,10,N,N,-,-1,-1
WESLEY.txt,830950,831828,878,10,N,N,-,-1,-1
WESLEY.txt,831050,831919,869,10,N,N,-,-1,-1
WESLEY.txt,831135,831966,831,10,N,N,-,-1,-1
WESLEY.txt,831211,831980,769,10,N,N,-,-1,-1
WESLEY.txt,831317,832064,747,10,N,N,-,-1,-1
WESLEY.txt,831409,832090,681,10,N,N,-,-1,-1
WESLEY.txt,831523,832269,746,10,N,N,-,-1,-1
WESLEY.txt,831547,832430,883,10,N,N,-,-1,-1
WESLEY.txt,831562,832538,976,10,N,N,-,-1,-1
WESLEY.txt,831679,832724,1045,10,N,N,-,-1,-1
WESLEY.txt,831829,832843,1014,10,N,N,-,-1,-1
WESLEY.txt,831920,832996,1076,10,N,N,-,-1,-1
WESLEY.txt,831967,833069,1102,10,N,N,-,-1,-1
WESLEY.txt,831980,833144,1164,10,N,N,-,-1,-1
WESLEY.txt,832065,833329,1264,10,N,N,-,-1,-1
WESLEY.txt,832090,833367,1277,10,N,N,-,-1,-1
WESLEY.txt,832270,833402,1132,10,N,N,-,-1,-1
WESLEY.txt,832431,833497,1066,10,N,N,-,-1,-1
WESLEY.txt,832539,833599,1060,10,N,N,-,-1,-1
WESLEY.txt,832725,833612,887,10,N,N,-,-1,-1
WESLEY.txt,832843,833695,852,10,N,N,-,-1,-1
WESLEY.txt,832997,833735,738,10,N,N,-,-1,-1
WESLEY.txt,833070,833823,753,10,N,N,-,-1,-1
WESLEY.txt,833145,833876,731,10,N,N,-,-1,-1
WESLEY.txt,833330,833972,642,10,N,N,-,-1,-1
WESLEY.txt,833368,833994,626,10,N,N,-,-1,-1
WESLEY.txt,833403,834083,680,10,N,N,-,-1,-1
WESLEY.txt,833498,834169,671,10,N,N,-,-1,-1
WESLEY.txt,833600,834253,653,10,N,N,-,-1,-1
WESLEY.txt,833613,834349,736,10,N,N,-,-1,-1
WESLEY.txt,833696,834435,739,10,N,N,-,-1,-1
WESLEY.txt,833736,834448,712,10,N,N,-,-1,-1
WESLEY.txt,833824,834542,718,10,N,N,-,-1,-1
WESLEY.txt,833877,834566,689,10,N,N,-,-1,-1
WESLEY.txt,833973,834738,765,10,N,N,-,-1,-1
WESLEY.txt,833994,834751,757,10,N,N,-,-1,-1
WESLEY.txt,834084,834838,754,10,N,N,-,-1,-1
WESLEY.txt,834170,834850,680,10,N,N,-,-1,-1
WESLEY.txt,834254,834905,651,10,N,N,-,-1,-1
WESLEY.txt,834350,835035,685,10,N,N,-,-1,-1
WESLEY.txt,834436,835206,770,10,N,N,-,-1,-1
WESLEY.txt,834448,835284,836,10,N,N,-,-1,-1
WESLEY.txt,834543,835373,830,10,N,N,-,-1,-1
WESLEY.txt,834566,835465,899,10,N,N,-,-1,-1
WESLEY.txt,834739,835669,930,10,N,N,-,-1,-1
WESLEY.txt,834752,835737,985,10,N,N,-,-1,-1
WESLEY.txt,834839,835894,1055,10,N,N,-,-1,-1
WESLEY.txt,834850,836045,1195,10,N,N,-,-1,-1
WESLEY.txt,834906,836066,1160,10,N,N,-,-1,-1
WESLEY.txt,835036,836122,1086,10,N,N,-,-1,-1
WESLEY.txt,835207,836163,956,10,N,N,-,-1,-1
WESLEY.txt,835285,836251,966,10,N,N,-,-1,-1
WESLEY.txt,835373,836487,1114,10,N,N,-,-1,-1
WESLEY.txt,835466,836573,1107,10,N,N,-,-1,-1
WESLEY.txt,835670,836648,978,10,N,N,-,-1,-1
WESLEY.txt,835738,836808,1070,10,N,N,-,-1,-1
WESLEY.txt,835895,836820,925,10,N,N,-,-1,-1
WESLEY.txt,836046,836920,874,10,N,N,-,-1,-1
WESLEY.txt,836066,836990,924,10,N,N,-,-1,-1
WESLEY.txt,836123,837129,1006,10,N,N,-,-1,-1
WESLEY.txt,836164,837150,986,10,N,N,-,-1,-1
WESLEY.txt,836252,837230,978,10,N,N,-,-1,-1
WESLEY.txt,836488,837365,877,10,N,N,-,-1,-1
WESLEY.txt,836574,837377,803,10,N,N,-,-1,-1
WESLEY.txt,836649,837526,877,10,N,N,-,-1,-1
WESLEY.txt,836809,837634,825,10,N,N,-,-1,-1
WESLEY.txt,836820,837719,899,10,N,N,-,-1,-1
WESLEY.txt,836921,837779,858,10,N,N,-,-1,-1
WESLEY.txt,836991,837919,928,10,N,N,-,-1,-1
WESLEY.txt,837130,838099,969,10,N,N,-,-1,-1
WESLEY.txt,837150,838273,1123,10,N,N,-,-1,-1
WESLEY.txt,837231,838354,1123,10,N,N,-,-1,-1
WESLEY.txt,837366,838444,1078,10,N,N,-,-1,-1
WESLEY.txt,837378,838528,1150,10,N,N,-,-1,-1
WESLEY.txt,837527,838540,1013,10,N,N,-,-1,-1
WESLEY.txt,837634,838602,968,10,N,N,-,-1,-1
WESLEY.txt,837720,838692,972,10,N,N,-,-1,-1
WESLEY.txt,837780,838705,925,10,N,N,-,-1,-1
WESLEY.txt,837920,838760,840,10,N,N,-,-1,-1
WESLEY.txt,838100,838944,844,10,N,N,-,-1,-1
WESLEY.txt,838274,839014,740,10,N,N,-,-1,-1
WESLEY.txt,838355,839090,735,10,N,N,-,-1,-1
WESLEY.txt,838445,839189,744,10,N,N,-,-1,-1
WESLEY.txt,838529,839268,739,10,N,N,-,-1,-1
WESLEY.txt,838541,839283,742,10,N,N,-,-1,-1
WESLEY.txt,838603,839418,815,10,N,N,-,-1,-1
WESLEY.txt,838693,839430,737,10,N,N,-,-1,-1
WESLEY.txt,838706,839532,826,10,N,N,-,-1,-1
WESLEY.txt,838761,839633,872,10,N,N,-,-1,-1
WESLEY.txt,838945,839646,701,10,N,N,-,-1,-1
WESLEY.txt,839015,839697,682,10,N,N,-,-1,-1
WESLEY.txt,839091,839774,683,10,N,N,-,-1,-1
WESLEY.txt,839190,839975,785,10,N,N,-,-1,-1
WESLEY.txt,839269,840084,815,10,N,N,-,-1,-1
WESLEY.txt,839284,840277,993,10,N,N,-,-1,-1
WESLEY.txt,839419,840450,1031,10,N,N,-,-1,-1
WESLEY.txt,839430,840468,1038,10,N,N,-,-1,-1
WESLEY.txt,839533,840545,1012,10,N,N,-,-1,-1
WESLEY.txt,839634,840575,941,10,N,N,-,-1,-1
WESLEY.txt,839646,840712,1066,10,N,N,-,-1,-1
WESLEY.txt,839698,840869,1171,10,N,N,-,-1,-1
WESLEY.txt,839775,840934,1159,10,N,N,-,-1,-1
WESLEY.txt,839975,840953,978,10,N,N,-,-1,-1
WESLEY.txt,840085,840991,906,10,N,N,-,-1,-1
WESLEY.txt,840278,841027,749,10,N,N,-,-1,-1
WESLEY.txt,840451,841139,688,10,N,N,-,-1,-1
WESLEY.txt,840468,841154,686,10,N,N,-,-1,-1
WESLEY.txt,840546,841210,664,10,N,N,-,-1,-1
WESLEY.txt,840576,841285,709,10,N,N,-,-1,-1
WESLEY.txt,840713,841352,639,10,N,N,-,-1,-1
WESLEY.txt,840870,841549,679,10,N,N,-,-1,-1
WESLEY.txt,840935,841563,628,10,N,N,-,-1,-1
WESLEY.txt,840953,841663,710,10,N,N,-,-1,-1
WESLEY.txt,840992,841868,876,10,N,N,-,-1,-1
WESLEY.txt,841028,841975,947,10,N,N,-,-1,-1
WESLEY.txt,841140,841994,854,10,N,N,-,-1,-1
WESLEY.txt,841155,842080,925,10,N,N,-,-1,-1
WESLEY.txt,841211,842310,1099,10,N,N,-,-1,-1
WESLEY.txt,841286,842378,1092,10,N,N,-,-1,-1
WESLEY.txt,841353,842391,1038,10,N,N,-,-1,-1
WESLEY.txt,841550,842472,922,10,N,N,-,-1,-1
WESLEY.txt,841563,842553,990,10,N,N,-,-1,-1
WESLEY.txt,841664,842647,983,10,N,N,-,-1,-1
WESLEY.txt,841869,842667,798,10,N,N,-,-1,-1
WESLEY.txt,841976,842716,740,10,N,N,-,-1,-1
WESLEY.txt,841994,842741,747,10,N,N,-,-1,-1
WESLEY.txt,842081,842815,734,10,N,N,-,-1,-1
WESLEY.txt,842311,842863,552,10,N,N,-,-1,-1
WESLEY.txt,842379,842909,530,10,N,N,-,-1,-1
WESLEY.txt,842391,842984,593,10,N,N,-,-1,-1
WESLEY.txt,842473,843056,583,10,N,N,-,-1,-1
WESLEY.txt,842554,843153,599,10,N,N,-,-1,-1
WESLEY.txt,842648,843216,568,10,N,N,-,-1,-1
WESLEY.txt,842667,843239,572,10,N,N,-,-1,-1
WESLEY.txt,842717,843256,539,10,N,N,-,-1,-1
WESLEY.txt,842742,843371,629,10,N,N,-,-1,-1
WESLEY.txt,842816,843480,664,10,N,N,-,-1,-1
WESLEY.txt,842864,843565,701,10,N,N,-,-1,-1
WESLEY.txt,842910,843683,773,10,N,N,-,-1,-1
WESLEY.txt,842985,843812,827,10,N,N,-,-1,-1
WESLEY.txt,843057,843824,767,10,N,N,-,-1,-1
WESLEY.txt,843154,843884,730,10,N,N,-,-1,-1
WESLEY.txt,843217,843955,738,10,N,N,-,-1,-1
WESLEY.txt,843239,844075,836,10,N,N,-,-1,-1
WESLEY.txt,843257,844300,1043,10,N,N,-,-1,-1
WESLEY.txt,843372,844487,1115,10,N,N,-,-1,-1
WESLEY.txt,843481,844501,1020,10,N,N,-,-1,-1
WESLEY.txt,843566,844524,958,10,N,N,-,-1,-1
WESLEY.txt,843683,844598,915,10,N,N,-,-1,-1
WESLEY.txt,843813,844622,809,10,N,N,-,-1,-1
WESLEY.txt,843825,844686,861,10,N,N,-,-1,-1
WESLEY.txt,843885,844756,871,10,N,N,-,-1,-1
WESLEY.txt,843956,844950,994,10,N,N,-,-1,-1
WESLEY.txt,844076,844973,897,10,N,N,-,-1,-1
WESLEY.txt,844301,845116,815,10,N,N,-,-1,-1
WESLEY.txt,844488,845196,708,10,N,N,-,-1,-1
WESLEY.txt,844501,845313,812,10,N,N,-,-1,-1
WESLEY.txt,844525,845325,800,10,N,N,-,-1,-1
WESLEY.txt,844599,845368,769,10,N,N,-,-1,-1
WESLEY.txt,844623,845422,799,10,N,N,-,-1,-1
WESLEY.txt,844687,845601,914,10,N,N,-,-1,-1
WESLEY.txt,844757,845697,940,10,N,N,-,-1,-1
WESLEY.txt,844951,845716,765,10,N,N,-,-1,-1
WESLEY.txt,844973,845798,825,10,N,N,-,-1,-1
WESLEY.txt,845117,845917,800,10,N,N,-,-1,-1
WESLEY.txt,845197,845929,732,10,N,N,-,-1,-1
WESLEY.txt,845314,845994,680,10,N,N,-,-1,-1
WESLEY.txt,845325,846074,749,10,N,N,-,-1,-1
WESLEY.txt,845369,846177,808,10,N,N,-,-1,-1
WESLEY.txt,845423,846360,937,10,N,N,-,-1,-1
WESLEY.txt,845602,846449,847,10,N,N,-,-1,-1
WESLEY.txt,845698,846520,822,10,N,N,-,-1,-1
WESLEY.txt,845716,846678,962,10,N,N,-,-1,-1
WESLEY.txt,845799,846707,908,10,N,N,-,-1,-1
WESLEY.txt,845918,846770,852,10,N,N,-,-1,-1
WESLEY.txt,845930,846841,911,10,N,N,-,-1,-1
WESLEY.txt,845995,846931,936,10,N,N,-,-1,-1
WESLEY.txt,846075,847051,976,10,N,N,-,-1,-1
WESLEY.txt,846178,847138,960,10,N,N,-,-1,-1
WESLEY.txt,846361,847191,830,10,N,N,-,-1,-1
WESLEY.txt,846450,847272,822,10,N,N,-,-1,-1
WESLEY.txt,846521,847408,887,10,N,N,-,-1,-1
WESLEY.txt,846679,847506,827,10,N,N,-,-1,-1
WESLEY.txt,846708,847596,888,10,N,N,-,-1,-1
WESLEY.txt,846771,847634,863,10,N,N,-,-1,-1
WESLEY.txt,846842,847811,969,10,N,N,-,-1,-1
WESLEY.txt,846932,847856,924,10,N,N,-,-1,-1
WESLEY.txt,847051,847993,942,10,N,N,-,-1,-1
WESLEY.txt,847139,848071,932,10,N,N,-,-1,-1
WESLEY.txt,847192,848175,983,10,N,N,-,-1,-1
WESLEY.txt,847273,848372,1099,10,N,N,-,-1,-1
WESLEY.txt,847409,848387,978,10,N,N,-,-1,-1
WESLEY.txt,847507,848642,1135,10,N,N,-,-1,-1
WESLEY.txt,847597,848689,1092,10,N,N,-,-1,-1
WESLEY.txt,847635,848881,1246,10,N,N,-,-1,-1
WESLEY.txt,847812,849046,1234,10,N,N,-,-1,-1
WESLEY.txt,847857,849091,1234,10,N,N,-,-1,-1
WESLEY.txt,847994,849271,1277,10,N,N,-,-1,-1
WESLEY.txt,848072,849365,1293,10,N,N,-,-1,-1
WESLEY.txt,848176,849501,1325,10,N,N,-,-1,-1
WESLEY.txt,848373,849528,1155,10,N,N,-,-1,-1
WESLEY.txt,848387,849650,1263,10,N,N,-,-1,-1
WESLEY.txt,848643,849663,1020,10,N,N,-,-1,-1
WESLEY.txt,848690,849828,1138,10,N,N,-,-1,-1
WESLEY.txt,848882,849938,1056,10,N,N,-,-1,-1
WESLEY.txt,849047,850040,993,10,N,N,-,-1,-1
WESLEY.txt,849092,850168,1076,10,N,N,-,-1,-1
WESLEY.txt,849272,850255,983,10,N,N,-,-1,-1
WESLEY.txt,849366,850342,976,10,N,N,-,-1,-1
WESLEY.txt,849501,850397,896,10,N,N,-,-1,-1
WESLEY.txt,849529,850482,953,10,N,N,-,-1,-1
WESLEY.txt,849651,850578,927,10,N,N,-,-1,-1
WESLEY.txt,849663,850840,1177,10,N,N,-,-1,-1
WESLEY.txt,849829,850933,1104,10,N,N,-,-1,-1
WESLEY.txt,849939,851021,1082,10,N,N,-,-1,-1
WESLEY.txt,850041,851211,1170,10,N,N,-,-1,-1
WESLEY.txt,850169,851373,1204,10,N,N,-,-1,-1
WESLEY.txt,850256,851450,1194,10,N,N,-,-1,-1
WESLEY.txt,850343,851536,1193,10,N,N,-,-1,-1
WESLEY.txt,850398,851608,1210,10,N,N,-,-1,-1
WESLEY.txt,850483,851699,1216,10,N,N,-,-1,-1
WESLEY.txt,850579,851788,1209,10,N,N,-,-1,-1
WESLEY.txt,850841,851802,961,10,N,N,-,-1,-1
WESLEY.txt,850934,851888,954,10,N,N,-,-1,-1
WESLEY.txt,851022,852137,1115,10,N,N,-,-1,-1
WESLEY.txt,851212,852292,1080,10,N,N,-,-1,-1
WESLEY.txt,851374,852376,1002,10,N,N,-,-1,-1
WESLEY.txt,851451,852466,1015,10,N,N,-,-1,-1
WESLEY.txt,851537,852556,1019,10,N,N,-,-1,-1
WESLEY.txt,851609,852642,1033,10,N,N,-,-1,-1
WESLEY.txt,851700,852704,1004,10,N,N,-,-1,-1
WESLEY.txt,851789,852786,997,10,N,N,-,-1,-1
WESLEY.txt,851802,852856,1054,10,N,N,-,-1,-1
WESLEY.txt,851889,853103,1214,10,N,N,-,-1,-1
WESLEY.txt,852138,853184,1046,10,N,N,-,-1,-1
WESLEY.txt,852293,853198,905,10,N,N,-,-1,-1
WESLEY.txt,852377,853239,862,10,N,N,-,-1,-1
WESLEY.txt,852467,853281,814,10,N,N,-,-1,-1
WESLEY.txt,852556,853370,814,10,N,N,-,-1,-1
WESLEY.txt,852642,853442,800,10,N,N,-,-1,-1
WESLEY.txt,852705,853454,749,10,N,N,-,-1,-1
WESLEY.txt,852787,853558,771,10,N,N,-,-1,-1
WESLEY.txt,852857,853639,782,10,N,N,-,-1,-1
WESLEY.txt,853104,853730,626,10,N,N,-,-1,-1
WESLEY.txt,853185,853778,593,10,N,N,-,-1,-1
WESLEY.txt,853198,853879,681,10,N,N,-,-1,-1
WESLEY.txt,853240,854064,824,10,N,N,-,-1,-1
WESLEY.txt,853282,854148,866,10,N,N,-,-1,-1
WESLEY.txt,853371,854315,944,10,N,N,-,-1,-1
WESLEY.txt,853443,854502,1059,10,N,N,-,-1,-1
WESLEY.txt,853454,854515,1061,10,N,N,-,-1,-1
WESLEY.txt,853559,854569,1010,10,N,N,-,-1,-1
WESLEY.txt,853640,854618,978,10,N,N,-,-1,-1
WESLEY.txt,853731,854761,1030,10,N,N,-,-1,-1
WESLEY.txt,853779,854926,1147,10,N,N,-,-1,-1
WESLEY.txt,853879,855068,1189,10,N,N,-,-1,-1
WESLEY.txt,854065,855206,1141,10,N,N,-,-1,-1
WESLEY.txt,854149,855294,1145,10,N,N,-,-1,-1
WESLEY.txt,854316,855300,984,10,N,N,-,-1,-1
WESLEY.txt,854503,855356,853,10,N,N,-,-1,-1
WESLEY.txt,854515,855371,856,10,N,N,-,-1,-1
WESLEY.txt,854570,855460,890,10,N,N,-,-1,-1
WESLEY.txt,854619,855565,946,10,N,N,-,-1,-1
WESLEY.txt,854762,855608,846,10,N,N,-,-1,-1
WESLEY.txt,854927,855683,756,10,N,N,-,-1,-1
WESLEY.txt,855069,855747,678,10,N,N,-,-1,-1
WESLEY.txt,855207,855875,668,10,N,N,-,-1,-1
WESLEY.txt,855295,856043,748,10,N,N,-,-1,-1
WESLEY.txt,855301,856121,820,10,N,N,-,-1,-1
WESLEY.txt,855357,856205,848,10,N,N,-,-1,-1
WESLEY.txt,855371,856341,970,10,N,N,-,-1,-1
WESLEY.txt,855461,856447,986,10,N,N,-,-1,-1
WESLEY.txt,855566,856563,997,10,N,N,-,-1,-1
WESLEY.txt,855609,856623,1014,10,N,N,-,-1,-1
WESLEY.txt,855684,856673,989,10,N,N,-,-1,-1
WESLEY.txt,855748,856686,938,10,N,N,-,-1,-1
WESLEY.txt,855875,856818,943,10,N,N,-,-1,-1
WESLEY.txt,856044,856871,827,10,N,N,-,-1,-1
WESLEY.txt,856122,856966,844,10,N,N,-,-1,-1
WESLEY.txt,856206,857065,859,10,N,N,-,-1,-1
WESLEY.txt,856342,857118,776,10,N,N,-,-1,-1
WESLEY.txt,856448,857444,996,10,N,N,-,-1,-1
WESLEY.txt,856564,857601,1037,10,N,N,-,-1,-1
WESLEY.txt,856624,857635,1011,10,N,N,-,-1,-1
WESLEY.txt,856674,857657,983,10,N,N,-,-1,-1
WESLEY.txt,856686,857705,1019,10,N,N,-,-1,-1
WESLEY.txt,856819,857820,1001,10,N,N,-,-1,-1
WESLEY.txt,856872,857960,1088,10,N,N,-,-1,-1
WESLEY.txt,856967,858049,1082,10,N,N,-,-1,-1
WESLEY.txt,857066,858138,1072,10,N,N,-,-1,-1
WESLEY.txt,857119,858245,1126,10,N,N,-,-1,-1
WESLEY.txt,857445,858452,1007,10,N,N,-,-1,-1
WESLEY.txt,857602,858527,925,10,N,N,-,-1,-1
WESLEY.txt,857636,858660,1024,10,N,N,-,-1,-1
WESLEY.txt,857657,858786,1129,10,N,N,-,-1,-1
WESLEY.txt,857706,858809,1103,10,N,N,-,-1,-1
WESLEY.txt,857821,858904,1083,10,N,N,-,-1,-1
WESLEY.txt,857961,858999,1038,10,N,N,-,-1,-1
WESLEY.txt,858050,859082,1032,10,N,N,-,-1,-1
WESLEY.txt,858139,859102,963,10,N,N,-,-1,-1
WESLEY.txt,858246,859298,1052,10,N,N,-,-1,-1
WESLEY.txt,858453,859382,929,10,N,N,-,-1,-1
WESLEY.txt,858528,859549,1021,10,N,N,-,-1,-1
WESLEY.txt,858661,859667,1006,10,N,N,-,-1,-1
WESLEY.txt,858787,859889,1102,10,N,N,-,-1,-1
WESLEY.txt,858809,860067,1258,10,N,N,-,-1,-1
WESLEY.txt,858905,860079,1174,10,N,N,-,-1,-1
WESLEY.txt,859000,860133,1133,10,N,N,-,-1,-1
WESLEY.txt,859082,860236,1154,10,N,N,-,-1,-1
WESLEY.txt,859103,860269,1166,10,N,N,-,-1,-1
WESLEY.txt,859299,860334,1035,10,N,N,-,-1,-1
WESLEY.txt,859383,860369,986,10,N,N,-,-1,-1
WESLEY.txt,859550,860464,914,10,N,N,-,-1,-1
WESLEY.txt,859668,860655,987,10,N,N,-,-1,-1
WESLEY.txt,859890,860692,802,10,N,N,-,-1,-1
WESLEY.txt,860068,860833,765,10,N,N,-,-1,-1
WESLEY.txt,860079,861044,965,10,N,N,-,-1,-1
WESLEY.txt,860134,861112,978,10,N,N,-,-1,-1
WESLEY.txt,860237,861150,913,10,N,N,-,-1,-1
WESLEY.txt,860270,861241,971,10,N,N,-,-1,-1
WESLEY.txt,860335,861343,1008,10,N,N,-,-1,-1
WESLEY.txt,860370,861556,1186,10,N,N,-,-1,-1
WESLEY.txt,860465,861610,1145,10,N,N,-,-1,-1
WESLEY.txt,860656,861734,1078,10,N,N,-,-1,-1
WESLEY.txt,860693,861963,1270,10,N,N,-,-1,-1
WESLEY.txt,860834,862343,1509,10,N,N,-,-1,-1
WESLEY.txt,861045,862454,1409,10,N,N,-,-1,-1
WESLEY.txt,861113,862506,1393,10,N,N,-,-1,-1
WESLEY.txt,861151,862703,1552,10,N,N,-,-1,-1
WESLEY.txt,861242,862746,1504,10,N,N,-,-1,-1
WESLEY.txt,861343,862789,1446,10,N,N,-,-1,-1
WESLEY.txt,861557,862792,1235,10,N,N,-,-1,-1
WESLEY.txt,861611,862884,1273,10,N,N,-,-1,-1
WESLEY.txt,861735,862887,1152,10,N,N,-,-1,-1
WESLEY.txt,861964,863002,1038,10,N,N,-,-1,-1
WESLEY.txt,862344,863005,661,10,N,N,-,-1,-1
WESLEY.txt,862455,863083,628,10,N,N,-,-1,-1
WESLEY.txt,862507,863086,579,10,N,N,-,-1,-1
WESLEY.txt,862704,863158,454,10,N,N,-,-1,-1
WESLEY.txt,862747,863161,414,10,N,N,-,-1,-1
WESLEY.txt,862790,863244,454,10,N,N,-,-1,-1
WESLEY.txt,862793,863374,581,10,N,N,-,-1,-1
WESLEY.txt,862885,863505,620,10,N,N,-,-1,-1
WESLEY.txt,862888,863684,796,10,N,N,-,-1,-1
WESLEY.txt,863003,863825,822,10,N,N,-,-1,-1
WESLEY.txt,863006,863911,905,10,N,N,-,-1,-1
WESLEY.txt,863084,864098,1014,10,N,N,-,-1,-1
WESLEY.txt,863087,864114,1027,10,N,N,-,-1,-1
WESLEY.txt,863159,864277,1118,10,N,N,-,-1,-1
WESLEY.txt,863162,864363,1201,10,N,N,-,-1,-1
WESLEY.txt,863245,864450,1205,10,N,N,-,-1,-1
WESLEY.txt,863375,864493,1118,10,N,N,-,-1,-1
WESLEY.txt,863506,864515,1009,10,N,N,-,-1,-1
WESLEY.txt,863685,864598,913,10,N,N,-,-1,-1
WESLEY.txt,863826,864844,1018,10,N,N,-,-1,-1
WESLEY.txt,863911,864923,1012,10,N,N,-,-1,-1
WESLEY.txt,864099,865033,934,10,N,N,-,-1,-1
WESLEY.txt,864114,865083,969,10,N,N,-,-1,-1
WESLEY.txt,864278,865108,830,10,N,N,-,-1,-1
WESLEY.txt,864364,865237,873,10,N,N,-,-1,-1
WESLEY.txt,864451,865248,797,10,N,N,-,-1,-1
WESLEY.txt,864494,865421,927,10,N,N,-,-1,-1
WESLEY.txt,864516,865519,1003,10,N,N,-,-1,-1
WESLEY.txt,864599,865627,1028,10,N,N,-,-1,-1
WESLEY.txt,864845,865643,798,10,N,N,-,-1,-1
WESLEY.txt,864924,865751,827,10,N,N,-,-1,-1
WESLEY.txt,865034,865982,948,10,N,N,-,-1,-1
WESLEY.txt,865084,866105,1021,10,N,N,-,-1,-1
WESLEY.txt,865109,866123,1014,10,N,N,-,-1,-1
WESLEY.txt,865238,866222,984,10,N,N,-,-1,-1
WESLEY.txt,865248,866233,985,10,N,N,-,-1,-1
WESLEY.txt,865422,866357,935,10,N,N,-,-1,-1
WESLEY.txt,865520,866422,902,10,N,N,-,-1,-1
WESLEY.txt,865628,866453,825,10,N,N,-,-1,-1
WESLEY.txt,865644,866988,1344,10,N,N,-,-1,-1
WESLEY.txt,865752,867103,1351,10,N,N,-,-1,-1
WESLEY.txt,865983,867117,1134,10,N,N,-,-1,-1
WESLEY.txt,866106,867169,1063,10,N,N,-,-1,-1
WESLEY.txt,866123,867290,1167,10,N,N,-,-1,-1
WESLEY.txt,866223,867394,1171,10,N,N,-,-1,-1
WESLEY.txt,866233,867406,1173,10,N,N,-,-1,-1
WESLEY.txt,866358,867480,1122,10,N,N,-,-1,-1
WESLEY.txt,866422,867688,1266,10,N,N,-,-1,-1
WESLEY.txt,866454,867769,1315,10,N,N,-,-1,-1
WESLEY.txt,866989,867889,900,10,N,N,-,-1,-1
WESLEY.txt,867104,868059,955,10,N,N,-,-1,-1
WESLEY.txt,867117,868147,1030,10,N,N,-,-1,-1
WESLEY.txt,867170,868170,1000,10,N,N,-,-1,-1
WESLEY.txt,867291,868239,948,10,N,N,-,-1,-1
WESLEY.txt,867395,868302,907,10,N,N,-,-1,-1
WESLEY.txt,867407,868417,1010,10,N,N,-,-1,-1
WESLEY.txt,867481,868512,1031,10,N,N,-,-1,-1
WESLEY.txt,867689,868587,898,10,N,N,-,-1,-1
WESLEY.txt,867770,868651,881,10,N,N,-,-1,-1
WESLEY.txt,867890,868701,811,10,N,N,-,-1,-1
WESLEY.txt,868060,868795,735,10,N,N,-,-1,-1
WESLEY.txt,868148,868898,750,10,N,N,-,-1,-1
WESLEY.txt,868170,868998,828,10,N,N,-,-1,-1
WESLEY.txt,868240,869079,839,10,N,N,-,-1,-1
WESLEY.txt,868303,869103,800,10,N,N,-,-1,-1
WESLEY.txt,868418,869169,751,10,N,N,-,-1,-1
WESLEY.txt,868513,869322,809,10,N,N,-,-1,-1
WESLEY.txt,868587,869400,813,10,N,N,-,-1,-1
WESLEY.txt,868652,869462,810,10,N,N,-,-1,-1
WESLEY.txt,868702,869632,930,10,N,N,-,-1,-1
WESLEY.txt,868796,869718,922,10,N,N,-,-1,-1
WESLEY.txt,868899,869804,905,10,N,N,-,-1,-1
WESLEY.txt,868999,869889,890,10,N,N,-,-1,-1
WESLEY.txt,869080,869943,863,10,N,N,-,-1,-1
WESLEY.txt,869104,870061,957,10,N,N,-,-1,-1
WESLEY.txt,869170,870166,996,10,N,N,-,-1,-1
WESLEY.txt,869323,870277,954,10,N,N,-,-1,-1
WESLEY.txt,869401,870405,1004,10,N,N,-,-1,-1
WESLEY.txt,869463,870416,953,10,N,N,-,-1,-1
WESLEY.txt,869633,870485,852,10,N,N,-,-1,-1
WESLEY.txt,869719,870517,798,10,N,N,-,-1,-1
WESLEY.txt,869805,870611,806,10,N,N,-,-1,-1
WESLEY.txt,869890,870622,732,10,N,N,-,-1,-1
WESLEY.txt,869944,870681,737,10,N,N,-,-1,-1
WESLEY.txt,870062,870841,779,10,N,N,-,-1,-1
WESLEY.txt,870166,870932,766,10,N,N,-,-1,-1
WESLEY.txt,870278,870945,667,10,N,N,-,-1,-1
WESLEY.txt,870406,871006,600,10,N,N,-,-1,-1
WESLEY.txt,870416,871020,604,10,N,N,-,-1,-1
WESLEY.txt,870486,871116,630,10,N,N,-,-1,-1
WESLEY.txt,870518,871129,611,10,N,N,-,-1,-1
WESLEY.txt,870612,871179,567,10,N,N,-,-1,-1
WESLEY.txt,870622,871320,698,10,N,N,-,-1,-1
WESLEY.txt,870682,871371,689,10,N,N,-,-1,-1
WESLEY.txt,870842,871487,645,10,N,N,-,-1,-1
WESLEY.txt,870933,871629,696,10,N,N,-,-1,-1
WESLEY.txt,870945,871798,853,10,N,N,-,-1,-1
WESLEY.txt,871007,871930,923,10,N,N,-,-1,-1
WESLEY.txt,871021,871986,965,10,N,N,-,-1,-1
WESLEY.txt,871117,872005,888,10,N,N,-,-1,-1
WESLEY.txt,871129,872026,897,10,N,N,-,-1,-1
WESLEY.txt,871180,872208,1028,10,N,N,-,-1,-1
WESLEY.txt,871321,872516,1195,10,N,N,-,-1,-1
WESLEY.txt,871372,873006,1634,10,N,N,-,-1,-1
WESLEY.txt,871488,873119,1631,10,N,N,-,-1,-1
WESLEY.txt,871630,873276,1646,10,N,N,-,-1,-1
WESLEY.txt,871799,873318,1519,10,N,N,-,-1,-1
WESLEY.txt,871931,873613,1682,10,N,N,-,-1,-1
WESLEY.txt,871987,873885,1898,10,N,N,-,-1,-1
WESLEY.txt,872005,873905,1900,10,N,N,-,-1,-1
WESLEY.txt,872027,874277,2250,10,N,N,-,-1,-1
WESLEY.txt,872209,874361,2152,10,N,N,-,-1,-1
WESLEY.txt,872517,874471,1954,10,N,N,-,-1,-1
WESLEY.txt,873007,874483,1476,10,N,N,-,-1,-1
WESLEY.txt,873119,874626,1507,10,N,N,-,-1,-1
WESLEY.txt,873277,874746,1469,10,N,N,-,-1,-1
WESLEY.txt,873319,874774,1455,10,N,N,-,-1,-1
WESLEY.txt,873614,874929,1315,10,N,N,-,-1,-1
WESLEY.txt,873886,875105,1219,10,N,N,-,-1,-1
WESLEY.txt,873905,875177,1272,10,N,N,-,-1,-1
WESLEY.txt,874278,875280,1002,10,N,N,-,-1,-1
WESLEY.txt,874362,875295,933,10,N,N,-,-1,-1
WESLEY.txt,874472,875434,962,10,N,N,-,-1,-1
WESLEY.txt,874483,875448,965,10,N,N,-,-1,-1
WESLEY.txt,874627,875569,942,10,N,N,-,-1,-1
WESLEY.txt,874747,875581,834,10,N,N,-,-1,-1
WESLEY.txt,874775,875695,920,10,N,N,-,-1,-1
WESLEY.txt,874930,875709,779,10,N,N,-,-1,-1
WESLEY.txt,875106,875822,716,10,N,N,-,-1,-1
WESLEY.txt,875178,875869,691,10,N,N,-,-1,-1
WESLEY.txt,875281,875930,649,10,N,N,-,-1,-1
WESLEY.txt,875295,875942,647,10,N,N,-,-1,-1
WESLEY.txt,875435,876051,616,10,N,N,-,-1,-1
WESLEY.txt,875449,876111,662,10,N,N,-,-1,-1
WESLEY.txt,875570,876179,609,10,N,N,-,-1,-1
WESLEY.txt,875582,876230,648,10,N,N,-,-1,-1
WESLEY.txt,875696,876251,555,10,N,N,-,-1,-1
WESLEY.txt,875710,876336,626,10,N,N,-,-1,-1
WESLEY.txt,875823,876432,609,10,N,N,-,-1,-1
WESLEY.txt,875870,876511,641,10,N,N,-,-1,-1
WESLEY.txt,875931,876627,696,10,N,N,-,-1,-1
WESLEY.txt,875942,876653,711,10,N,N,-,-1,-1
WESLEY.txt,876052,876683,631,10,N,N,-,-1,-1
WESLEY.txt,876112,876736,624,10,N,N,-,-1,-1
WESLEY.txt,876180,876760,580,10,N,N,-,-1,-1
WESLEY.txt,876231,876924,693,10,N,N,-,-1,-1
WESLEY.txt,876251,876936,685,10,N,N,-,-1,-1
WESLEY.txt,876337,877085,748,10,N,N,-,-1,-1
WESLEY.txt,876433,877184,751,10,N,N,-,-1,-1
WESLEY.txt,876512,877196,684,10,N,N,-,-1,-1
WESLEY.txt,876628,877299,671,10,N,N,-,-1,-1
WESLEY.txt,876654,877430,776,10,N,N,-,-1,-1
WESLEY.txt,876684,877494,810,10,N,N,-,-1,-1
WESLEY.txt,876736,877543,807,10,N,N,-,-1,-1
WESLEY.txt,876761,877680,919,10,N,N,-,-1,-1
WESLEY.txt,876925,877757,832,10,N,N,-,-1,-1
WESLEY.txt,876937,877778,841,10,N,N,-,-1,-1
WESLEY.txt,877086,877809,723,10,N,N,-,-1,-1
WESLEY.txt,877185,877965,780,10,N,N,-,-1,-1
WESLEY.txt,877196,878061,865,10,N,N,-,-1,-1
WESLEY.txt,877300,878161,861,10,N,N,-,-1,-1
WESLEY.txt,877431,878175,744,10,N,N,-,-1,-1
WESLEY.txt,877495,878259,764,10,N,N,-,-1,-1
WESLEY.txt,877544,878278,734,10,N,N,-,-1,-1
WESLEY.txt,877681,878341,660,10,N,N,-,-1,-1
WESLEY.txt,877758,878444,686,10,N,N,-,-1,-1
WESLEY.txt,877779,878463,684,10,N,N,-,-1,-1
WESLEY.txt,877810,878512,702,10,N,N,-,-1,-1
WESLEY.txt,877966,878666,700,10,N,N,-,-1,-1
WESLEY.txt,878062,878747,685,10,N,N,-,-1,-1
WESLEY.txt,878162,878759,597,10,N,N,-,-1,-1
WESLEY.txt,878175,878835,660,10,N,N,-,-1,-1
WESLEY.txt,878260,878896,636,10,N,N,-,-1,-1
WESLEY.txt,878279,878934,655,10,N,N,-,-1,-1
WESLEY.txt,878342,878956,614,10,N,N,-,-1,-1
WESLEY.txt,878445,879018,573,10,N,N,-,-1,-1
WESLEY.txt,878463,879098,635,10,N,N,-,-1,-1
WESLEY.txt,878513,879115,602,10,N,N,-,-1,-1
WESLEY.txt,878667,879161,494,10,N,N,-,-1,-1
WESLEY.txt,878748,879298,550,10,N,N,-,-1,-1
WESLEY.txt,878759,879346,587,10,N,N,-,-1,-1
WESLEY.txt,878836,879397,561,10,N,N,-,-1,-1
WESLEY.txt,878897,879479,582,10,N,N,-,-1,-1
WESLEY.txt,878935,879652,717,10,N,N,-,-1,-1
WESLEY.txt,878956,879670,714,10,N,N,-,-1,-1
WESLEY.txt,879019,879690,671,10,N,N,-,-1,-1
WESLEY.txt,879099,879873,774,10,N,N,-,-1,-1
WESLEY.txt,879115,879962,847,10,N,N,-,-1,-1
WESLEY.txt,879162,880053,891,10,N,N,-,-1,-1
WESLEY.txt,879299,880236,937,10,N,N,-,-1,-1
WESLEY.txt,879347,880428,1081,10,N,N,-,-1,-1
WESLEY.txt,879398,880541,1143,10,N,N,-,-1,-1
WESLEY.txt,879480,880549,1069,10,N,N,-,-1,-1
WESLEY.txt,879653,880587,934,10,N,N,-,-1,-1
WESLEY.txt,879670,880626,956,10,N,N,-,-1,-1
WESLEY.txt,879691,880700,1009,10,N,N,-,-1,-1
WESLEY.txt,879874,880764,890,10,N,N,-,-1,-1
WESLEY.txt,879963,880787,824,10,N,N,-,-1,-1
WESLEY.txt,880054,880891,837,10,N,N,-,-1,-1
WESLEY.txt,880237,880902,665,10,N,N,-,-1,-1
WESLEY.txt,880429,880987,558,10,N,N,-,-1,-1
WESLEY.txt,880542,881221,679,10,N,N,-,-1,-1
WESLEY.txt,880550,881262,712,10,N,N,-,-1,-1
WESLEY.txt,880588,881327,739,10,N,N,-,-1,-1
WESLEY.txt,880627,881430,803,10,N,N,-,-1,-1
WESLEY.txt,880701,881505,804,10,N,N,-,-1,-1
WESLEY.txt,880765,881660,895,10,N,N,-,-1,-1
WESLEY.txt,880787,881745,958,10,N,N,-,-1,-1
WESLEY.txt,880892,881784,892,10,N,N,-,-1,-1
WESLEY.txt,880902,881846,944,10,N,N,-,-1,-1
WESLEY.txt,880988,881861,873,10,N,N,-,-1,-1
WESLEY.txt,881222,881983,761,10,N,N,-,-1,-1
WESLEY.txt,881263,882038,775,10,N,N,-,-1,-1
WESLEY.txt,881328,882133,805,10,N,N,-,-1,-1
WESLEY.txt,881430,882169,739,10,N,N,-,-1,-1
WESLEY.txt,881506,882210,704,10,N,N,-,-1,-1
WESLEY.txt,881661,882331,670,10,N,N,-,-1,-1
WESLEY.txt,881746,882345,599,10,N,N,-,-1,-1
WESLEY.txt,881785,882432,647,10,N,N,-,-1,-1
WESLEY.txt,881847,882551,704,10,N,N,-,-1,-1
WESLEY.txt,881861,882724,863,10,N,N,-,-1,-1
WESLEY.txt,881984,882736,752,10,N,N,-,-1,-1
WESLEY.txt,882039,882799,760,10,N,N,-,-1,-1
WESLEY.txt,882134,882873,739,10,N,N,-,-1,-1
WESLEY.txt,882170,882887,717,10,N,N,-,-1,-1
WESLEY.txt,882211,882943,732,10,N,N,-,-1,-1
WESLEY.txt,882332,882955,623,10,N,N,-,-1,-1
WESLEY.txt,882345,883082,737,10,N,N,-,-1,-1
WESLEY.txt,882433,883180,747,10,N,N,-,-1,-1
WESLEY.txt,882552,883252,700,10,N,N,-,-1,-1
WESLEY.txt,882725,883349,624,10,N,N,-,-1,-1
WESLEY.txt,882736,883448,712,10,N,N,-,-1,-1
WESLEY.txt,882800,883553,753,10,N,N,-,-1,-1
WESLEY.txt,882874,883713,839,10,N,N,-,-1,-1
WESLEY.txt,882887,883826,939,10,N,N,-,-1,-1
WESLEY.txt,882944,883839,895,10,N,N,-,-1,-1
WESLEY.txt,882955,883942,987,10,N,N,-,-1,-1
WESLEY.txt,883082,884143,1061,10,N,N,-,-1,-1
WESLEY.txt,883180,884158,978,10,N,N,-,-1,-1
WESLEY.txt,883253,884261,1008,10,N,N,-,-1,-1
WESLEY.txt,883350,884410,1060,10,N,N,-,-1,-1
WESLEY.txt,883449,884509,1060,10,N,N,-,-1,-1
WESLEY.txt,883554,884567,1013,10,N,N,-,-1,-1
WESLEY.txt,883714,884624,910,10,N,N,-,-1,-1
WESLEY.txt,883827,884751,924,10,N,N,-,-1,-1
WESLEY.txt,883839,884796,957,10,N,N,-,-1,-1
WESLEY.txt,883943,884808,865,10,N,N,-,-1,-1
WESLEY.txt,884144,884832,688,10,N,N,-,-1,-1
WESLEY.txt,884158,884844,686,10,N,N,-,-1,-1
WESLEY.txt,884262,884935,673,10,N,N,-,-1,-1
WESLEY.txt,884411,885125,714,10,N,N,-,-1,-1
WESLEY.txt,884510,885408,898,10,N,N,-,-1,-1
WESLEY.txt,884568,885543,975,10,N,N,-,-1,-1
WESLEY.txt,884625,885745,1120,10,N,N,-,-1,-1
WESLEY.txt,884752,885955,1203,10,N,N,-,-1,-1
WESLEY.txt,884797,886199,1402,10,N,N,-,-1,-1
WESLEY.txt,884808,886287,1479,10,N,N,-,-1,-1
WESLEY.txt,884833,886413,1580,10,N,N,-,-1,-1
WESLEY.txt,884844,886493,1649,10,N,N,-,-1,-1
WESLEY.txt,884936,886699,1763,10,N,N,-,-1,-1
WESLEY.txt,885126,886818,1692,10,N,N,-,-1,-1
WESLEY.txt,885409,886931,1522,10,N,N,-,-1,-1
WESLEY.txt,885544,887101,1557,10,N,N,-,-1,-1
WESLEY.txt,885746,887306,1560,10,N,N,-,-1,-1
WESLEY.txt,885956,887530,1574,10,N,N,-,-1,-1
WESLEY.txt,886200,887642,1442,10,N,N,-,-1,-1
WESLEY.txt,886288,887716,1428,10,N,N,-,-1,-1
WESLEY.txt,886414,888098,1684,10,N,N,-,-1,-1
WESLEY.txt,886494,888462,1968,10,N,N,-,-1,-1
WESLEY.txt,886700,888634,1934,10,N,N,-,-1,-1
WESLEY.txt,886819,888702,1883,10,N,N,-,-1,-1
WESLEY.txt,886932,888753,1821,10,N,N,-,-1,-1
WESLEY.txt,887102,888795,1693,10,N,N,-,-1,-1
WESLEY.txt,887307,889159,1852,10,N,N,-,-1,-1
WESLEY.txt,887531,889352,1821,10,N,N,-,-1,-1
WESLEY.txt,887643,889630,1987,10,N,N,-,-1,-1
WESLEY.txt,887717,889699,1982,10,N,N,-,-1,-1
WESLEY.txt,888099,889800,1701,10,N,N,-,-1,-1
WESLEY.txt,888463,890006,1543,10,N,N,-,-1,-1
WESLEY.txt,888635,890119,1484,10,N,N,-,-1,-1
WESLEY.txt,888703,890560,1857,10,N,N,-,-1,-1
WESLEY.txt,888754,890635,1881,10,N,N,-,-1,-1
WESLEY.txt,888796,890885,2089,10,N,N,-,-1,-1
WESLEY.txt,889160,890929,1769,10,N,N,-,-1,-1
WESLEY.txt,889353,891086,1733,10,N,N,-,-1,-1
WESLEY.txt,889631,891456,1825,10,N,N,-,-1,-1
WESLEY.txt,889700,891936,2236,10,N,N,-,-1,-1
WESLEY.txt,889801,892085,2284,10,N,N,-,-1,-1
WESLEY.txt,890007,892140,2133,10,N,N,-,-1,-1
WESLEY.txt,890120,892211,2091,10,N,N,-,-1,-1
WESLEY.txt,890561,892240,1679,10,N,N,-,-1,-1
WESLEY.txt,890636,892400,1764,10,N,N,-,-1,-1
WESLEY.txt,890886,892557,1671,10,N,N,-,-1,-1
WESLEY.txt,890930,892616,1686,10,N,N,-,-1,-1
WESLEY.txt,891087,892756,1669,10,N,N,-,-1,-1
WESLEY.txt,891457,893089,1632,10,N,N,-,-1,-1
WESLEY.txt,891937,894507,2570,10,N,N,-,-1,-1
WESLEY.txt,892086,894565,2479,10,N,N,-,-1,-1
WESLEY.txt,892141,894634,2493,10,N,N,-,-1,-1
WESLEY.txt,892212,894730,2518,10,N,N,-,-1,-1
WESLEY.txt,892241,894854,2613,10,N,N,-,-1,-1
WESLEY.txt,892401,894981,2580,10,N,N,-,-1,-1
WESLEY.txt,892558,895185,2627,10,N,N,-,-1,-1
WESLEY.txt,892617,895274,2657,10,N,N,-,-1,-1
WESLEY.txt,892757,895348,2591,10,N,N,-,-1,-1
WESLEY.txt,893090,895479,2389,10,N,N,-,-1,-1
WESLEY.txt,894508,895571,1063,10,N,N,-,-1,-1
WESLEY.txt,894566,895668,1102,10,N,N,-,-1,-1
WESLEY.txt,894635,895755,1120,10,N,N,-,-1,-1
WESLEY.txt,894731,895937,1206,10,N,N,-,-1,-1
WESLEY.txt,894855,896033,1178,10,N,N,-,-1,-1
WESLEY.txt,894982,896164,1182,10,N,N,-,-1,-1
WESLEY.txt,895186,896260,1074,10,N,N,-,-1,-1
WESLEY.txt,895275,896397,1122,10,N,N,-,-1,-1
WESLEY.txt,895349,896534,1185,10,N,N,-,-1,-1
WESLEY.txt,895480,896628,1148,10,N,N,-,-1,-1
WESLEY.txt,895572,896713,1141,10,N,N,-,-1,-1
WESLEY.txt,895669,896745,1076,10,N,N,-,-1,-1
