GLOVER.txt,0,1301,1301,10,N,N,-,-1,-1
GLOVER.txt,1302,3994,2692,10,N,N,-,-1,-1
GLOVER.txt,3995,11467,7472,10,Y,N,-,-1,-1
GLOVER.txt,11468,16363,4895,10,N,N,-,-1,-1
GLOVER.txt,16364,18754,2390,10,N,N,-,-1,-1
GLOVER.txt,18757,20786,2029,10,Y,N,-,-1,-1
GLOVER.txt,20789,22790,2001,10,N,N,-,-1,-1
GLOVER.txt,22791,24428,1637,10,N,N,-,-1,-1
GLOVER.txt,24429,25726,1297,10,N,N,-,-1,-1
GLOVER.txt,25731,27271,1540,10,N,N,-,-1,-1
GLOVER.txt,27272,29377,2105,10,N,N,-,-1,-1
GLOVER.txt,29378,31921,2543,10,N,N,-,-1,-1
GLOVER.txt,31922,33372,1450,10,N,N,-,-1,-1
GLOVER.txt,33373,35169,1796,10,N,N,-,-1,-1
GLOVER.txt,35171,36684,1513,10,N,N,-,-1,-1
GLOVER.txt,36685,38824,2139,10,N,N,-,-1,-1
GLOVER.txt,38825,40559,1734,10,N,N,-,-1,-1
GLOVER.txt,40560,42834,2274,10,N,N,-,-1,-1
GLOVER.txt,42834,44368,1534,10,N,N,-,-1,-1
GLOVER.txt,44369,45108,739,10,N,N,-,-1,-1
GLOVER.txt,45109,45973,864,10,N,N,-,-1,-1
GLOVER.txt,45974,46321,347,10,N,N,-,-1,-1
GLOVER.txt,46322,46931,609,10,N,N,-,-1,-1
GLOVER.txt,46932,47632,700,10,N,N,-,-1,-1
GLOVER.txt,47633,49516,1883,10,N,N,-,-1,-1
GLOVER.txt,49517,51487,1970,10,N,N,-,-1,-1
GLOVER.txt,51490,52905,1415,10,N,N,-,-1,-1
GLOVER.txt,52906,54018,1112,10,N,N,-,-1,-1
GLOVER.txt,54019,54679,660,10,N,N,-,-1,-1
GLOVER.txt,54680,56585,1905,10,N,N,-,-1,-1
GLOVER.txt,56586,58108,1522,10,N,N,-,-1,-1
GLOVER.txt,58109,59931,1822,10,N,N,-,-1,-1
GLOVER.txt,59934,62385,2451,10,N,N,-,-1,-1
GLOVER.txt,62388,64142,1754,10,N,N,-,-1,-1
GLOVER.txt,64143,65652,1509,10,N,N,-,-1,-1
GLOVER.txt,65653,67838,2185,10,N,N,-,-1,-1
GLOVER.txt,67839,69760,1921,10,N,N,-,-1,-1
GLOVER.txt,69761,72139,2378,10,N,N,-,-1,-1
GLOVER.txt,72142,74651,2509,10,N,N,-,-1,-1
GLOVER.txt,74654,76383,1729,10,N,N,-,-1,-1
GLOVER.txt,76384,78666,2282,10,N,N,-,-1,-1
GLOVER.txt,78667,81497,2830,10,N,N,-,-1,-1
GLOVER.txt,81500,83739,2239,10,N,N,-,-1,-1
GLOVER.txt,83740,86480,2740,10,N,N,-,-1,-1
GLOVER.txt,86481,88226,1745,10,N,N,-,-1,-1
GLOVER.txt,88227,89144,917,10,N,N,-,-1,-1
GLOVER.txt,89144,90339,1195,10,N,N,-,-1,-1
GLOVER.txt,90340,93266,2926,10,N,N,-,-1,-1
GLOVER.txt,93267,94525,1258,10,N,N,-,-1,-1
GLOVER.txt,94526,96552,2026,10,Y,N,-,-1,-1
GLOVER.txt,96554,98325,1771,10,N,N,-,-1,-1
GLOVER.txt,98326,100433,2107,10,N,N,-,-1,-1
GLOVER.txt,100434,101615,1181,10,N,N,-,-1,-1
GLOVER.txt,101616,102765,1149,10,N,N,-,-1,-1
GLOVER.txt,102768,104972,2204,10,N,N,-,-1,-1
GLOVER.txt,104975,107082,2107,10,N,Y,1436867017136,105674,106651
GLOVER.txt,107083,109242,2159,10,N,N,-,-1,-1
GLOVER.txt,109243,110511,1268,10,N,N,-,-1,-1
GLOVER.txt,110514,112511,1997,10,Y,N,-,-1,-1
GLOVER.txt,112513,113817,1304,10,N,N,-,-1,-1
GLOVER.txt,113818,115452,1634,10,N,N,-,-1,-1
GLOVER.txt,115455,117354,1899,10,N,N,-,-1,-1
GLOVER.txt,117357,118847,1490,10,Y,N,-,-1,-1
GLOVER.txt,118850,120141,1291,10,Y,N,-,-1,-1
GLOVER.txt,120144,121872,1728,10,Y,Y,1437028092146,121457,123204
GLOVER.txt,121873,123497,1624,10,N,Y,1437028092146,121457,123204
GLOVER.txt,123502,125433,1931,10,N,N,-,-1,-1
GLOVER.txt,125434,126669,1235,10,N,N,-,-1,-1
GLOVER.txt,126670,127977,1307,10,N,N,-,-1,-1
GLOVER.txt,127978,130778,2800,10,N,N,-,-1,-1
GLOVER.txt,130779,132228,1449,10,N,N,-,-1,-1
GLOVER.txt,132229,134743,2514,10,N,N,-,-1,-1
GLOVER.txt,134744,136706,1962,10,N,N,-,-1,-1
GLOVER.txt,136708,138576,1868,10,N,N,-,-1,-1
GLOVER.txt,138577,139529,952,10,N,N,-,-1,-1
GLOVER.txt,139530,140141,611,10,N,N,-,-1,-1
GLOVER.txt,140142,141669,1527,10,N,N,-,-1,-1
GLOVER.txt,141670,143963,2293,10,N,N,-,-1,-1
GLOVER.txt,143964,145863,1899,10,N,N,-,-1,-1
GLOVER.txt,145864,146650,786,10,N,N,-,-1,-1
GLOVER.txt,146651,147346,695,10,N,N,-,-1,-1
GLOVER.txt,147347,148185,838,10,N,N,-,-1,-1
GLOVER.txt,148186,149227,1041,10,N,N,-,-1,-1
GLOVER.txt,149229,150116,887,10,N,N,-,-1,-1
GLOVER.txt,150117,150971,854,10,N,N,-,-1,-1
GLOVER.txt,150973,152510,1537,10,N,Y,1437470299748,152207,152889
GLOVER.txt,152511,153400,889,10,N,Y,1437470299748,152207,152889
GLOVER.txt,153401,154241,840,10,N,N,-,-1,-1
GLOVER.txt,154243,156573,2330,10,N,N,-,-1,-1
GLOVER.txt,156576,158980,2404,10,Y,N,-,-1,-1
GLOVER.txt,158981,160267,1286,10,N,N,-,-1,-1
GLOVER.txt,160268,162023,1755,10,N,N,-,-1,-1
GLOVER.txt,162025,163926,1901,10,N,N,-,-1,-1
GLOVER.txt,163929,166069,2140,10,N,N,-,-1,-1
GLOVER.txt,166072,167609,1537,10,N,N,-,-1,-1
GLOVER.txt,167610,169547,1937,10,N,N,-,-1,-1
GLOVER.txt,169548,170867,1319,10,N,N,-,-1,-1
GLOVER.txt,170872,173316,2444,10,N,N,-,-1,-1
GLOVER.txt,173318,174811,1493,10,N,N,-,-1,-1
GLOVER.txt,174814,176589,1775,10,N,N,-,-1,-1
GLOVER.txt,176592,178673,2081,10,N,N,-,-1,-1
GLOVER.txt,178674,179719,1045,10,N,N,-,-1,-1
GLOVER.txt,179720,180342,622,10,N,N,-,-1,-1
GLOVER.txt,180344,182253,1909,10,N,N,-,-1,-1
GLOVER.txt,182256,183444,1188,10,N,N,-,-1,-1
GLOVER.txt,183445,184751,1306,10,N,N,-,-1,-1
GLOVER.txt,184752,186398,1646,10,N,N,-,-1,-1
GLOVER.txt,186399,187924,1525,10,N,N,-,-1,-1
GLOVER.txt,187925,189346,1421,10,N,N,-,-1,-1
GLOVER.txt,189347,190178,831,10,N,N,-,-1,-1
GLOVER.txt,190179,192225,2046,10,N,N,-,-1,-1
GLOVER.txt,192226,193895,1669,10,N,N,-,-1,-1
GLOVER.txt,193898,195632,1734,10,N,N,-,-1,-1
GLOVER.txt,195633,197145,1512,10,N,N,-,-1,-1
GLOVER.txt,197146,198385,1239,10,N,N,-,-1,-1
GLOVER.txt,198388,199632,1244,10,N,N,-,-1,-1
GLOVER.txt,199633,201002,1369,10,N,N,-,-1,-1
GLOVER.txt,201004,203710,2706,10,N,N,-,-1,-1
GLOVER.txt,203711,206217,2506,10,Y,N,-,-1,-1
GLOVER.txt,206218,207737,1519,10,N,N,-,-1,-1
GLOVER.txt,207740,209662,1922,10,Y,N,-,-1,-1
GLOVER.txt,209663,211375,1712,10,N,N,-,-1,-1
GLOVER.txt,211378,212854,1476,10,Y,N,-,-1,-1
GLOVER.txt,212857,213392,535,10,N,N,-,-1,-1
GLOVER.txt,213393,213955,562,10,N,N,-,-1,-1
GLOVER.txt,213956,214864,908,10,N,N,-,-1,-1
GLOVER.txt,214865,216509,1644,10,N,N,-,-1,-1
GLOVER.txt,216510,218180,1670,10,N,N,-,-1,-1
GLOVER.txt,218181,219964,1783,10,N,N,-,-1,-1
GLOVER.txt,219967,221599,1632,10,N,N,-,-1,-1
GLOVER.txt,221600,223890,2290,10,N,N,-,-1,-1
GLOVER.txt,223891,225508,1617,10,N,N,-,-1,-1
GLOVER.txt,225509,227088,1579,10,N,N,-,-1,-1
GLOVER.txt,227089,228587,1498,10,N,N,-,-1,-1
GLOVER.txt,228588,229612,1024,10,N,N,-,-1,-1
GLOVER.txt,229613,231285,1672,10,N,N,-,-1,-1
GLOVER.txt,231286,231972,686,10,N,N,-,-1,-1
GLOVER.txt,231973,233799,1826,10,N,N,-,-1,-1
GLOVER.txt,233802,235034,1232,10,N,N,-,-1,-1
GLOVER.txt,235035,236569,1534,10,N,N,-,-1,-1
GLOVER.txt,236570,237786,1216,10,N,N,-,-1,-1
GLOVER.txt,237787,240133,2346,10,N,N,-,-1,-1
GLOVER.txt,240136,242338,2202,10,N,N,-,-1,-1
GLOVER.txt,242341,243299,958,10,N,N,-,-1,-1
GLOVER.txt,243300,244643,1343,10,N,N,-,-1,-1
GLOVER.txt,244644,245271,627,10,N,N,-,-1,-1
GLOVER.txt,245274,247625,2351,10,N,N,-,-1,-1
GLOVER.txt,247626,249393,1767,10,N,N,-,-1,-1
GLOVER.txt,249394,251224,1830,10,N,N,-,-1,-1
GLOVER.txt,251225,252290,1065,10,N,N,-,-1,-1
GLOVER.txt,252293,254173,1880,10,N,N,-,-1,-1
GLOVER.txt,254174,255329,1155,10,N,N,-,-1,-1
GLOVER.txt,255330,257102,1772,10,Y,N,-,-1,-1
GLOVER.txt,257105,258594,1489,10,N,N,-,-1,-1
GLOVER.txt,258597,259797,1200,10,N,N,-,-1,-1
GLOVER.txt,259798,261105,1307,10,N,N,-,-1,-1
GLOVER.txt,261106,262561,1455,10,N,N,-,-1,-1
GLOVER.txt,262566,264184,1618,10,N,N,-,-1,-1
GLOVER.txt,264185,265396,1211,10,N,N,-,-1,-1
GLOVER.txt,265397,267049,1652,10,N,N,-,-1,-1
GLOVER.txt,267050,268541,1491,10,N,N,-,-1,-1
GLOVER.txt,268542,269800,1258,10,N,N,-,-1,-1
GLOVER.txt,269803,271121,1318,10,N,N,-,-1,-1
GLOVER.txt,271122,272070,948,10,N,N,-,-1,-1
GLOVER.txt,272071,273412,1341,10,N,N,-,-1,-1
GLOVER.txt,273413,275341,1928,10,N,N,-,-1,-1
GLOVER.txt,275342,276311,969,10,N,N,-,-1,-1
GLOVER.txt,276312,277942,1630,10,N,N,-,-1,-1
GLOVER.txt,277943,278905,962,10,N,N,-,-1,-1
GLOVER.txt,278908,279807,899,10,N,N,-,-1,-1
GLOVER.txt,279808,280417,609,10,N,N,-,-1,-1
GLOVER.txt,280418,281705,1287,10,N,N,-,-1,-1
GLOVER.txt,281707,283995,2288,10,N,N,-,-1,-1
GLOVER.txt,283998,285316,1318,10,N,N,-,-1,-1
GLOVER.txt,285317,287874,2557,10,N,N,-,-1,-1
GLOVER.txt,287877,288918,1041,10,N,N,-,-1,-1
GLOVER.txt,288919,290554,1635,10,N,N,-,-1,-1
GLOVER.txt,290559,291876,1317,10,N,N,-,-1,-1
GLOVER.txt,291877,292594,717,10,N,N,-,-1,-1
GLOVER.txt,292595,293047,452,10,N,N,-,-1,-1
GLOVER.txt,293049,293549,500,10,N,N,-,-1,-1
GLOVER.txt,293550,294164,614,10,N,N,-,-1,-1
GLOVER.txt,294165,295367,1202,10,N,N,-,-1,-1
GLOVER.txt,295368,296691,1323,10,N,N,-,-1,-1
GLOVER.txt,296691,297793,1102,10,N,N,-,-1,-1
GLOVER.txt,297796,298719,923,10,N,N,-,-1,-1
GLOVER.txt,298721,299411,690,10,N,N,-,-1,-1
GLOVER.txt,299412,300167,755,10,N,N,-,-1,-1
GLOVER.txt,300168,301460,1292,10,N,N,-,-1,-1
GLOVER.txt,301463,302277,814,10,N,N,-,-1,-1
GLOVER.txt,302278,303310,1032,10,N,N,-,-1,-1
GLOVER.txt,303311,304644,1333,10,N,N,-,-1,-1
GLOVER.txt,304645,306019,1374,10,N,N,-,-1,-1
GLOVER.txt,306020,307656,1636,10,Y,N,-,-1,-1
GLOVER.txt,307657,308071,414,10,N,N,-,-1,-1
GLOVER.txt,308072,308894,822,10,N,N,-,-1,-1
GLOVER.txt,308895,310487,1592,10,N,N,-,-1,-1
GLOVER.txt,310488,312115,1627,10,N,N,-,-1,-1
GLOVER.txt,312116,314041,1925,10,Y,N,-,-1,-1
GLOVER.txt,314044,315622,1578,10,Y,N,-,-1,-1
GLOVER.txt,315623,317026,1403,10,Y,N,-,-1,-1
GLOVER.txt,317027,318083,1056,10,N,N,-,-1,-1
GLOVER.txt,318084,319113,1029,10,N,N,-,-1,-1
GLOVER.txt,319114,320008,894,10,N,N,-,-1,-1
GLOVER.txt,320011,321438,1427,10,N,N,-,-1,-1
GLOVER.txt,321439,322758,1319,10,Y,N,-,-1,-1
GLOVER.txt,322759,325299,2540,10,N,N,-,-1,-1
GLOVER.txt,325300,326730,1430,10,N,N,-,-1,-1
GLOVER.txt,326731,328058,1327,10,N,N,-,-1,-1
GLOVER.txt,328059,330302,2243,10,N,N,-,-1,-1
GLOVER.txt,330303,332096,1793,10,N,N,-,-1,-1
GLOVER.txt,332097,334236,2139,10,N,N,-,-1,-1
GLOVER.txt,334239,337038,2799,10,N,N,-,-1,-1
GLOVER.txt,337041,338044,1003,10,N,N,-,-1,-1
GLOVER.txt,338045,339505,1460,10,N,N,-,-1,-1
GLOVER.txt,339506,339883,377,10,N,N,-,-1,-1
GLOVER.txt,339885,341564,1679,10,N,N,-,-1,-1
GLOVER.txt,341565,342518,953,10,N,N,-,-1,-1
GLOVER.txt,342519,344011,1492,10,N,N,-,-1,-1
GLOVER.txt,344012,345268,1256,10,N,N,-,-1,-1
GLOVER.txt,345269,346614,1345,10,N,N,-,-1,-1
GLOVER.txt,346615,347836,1221,10,N,N,-,-1,-1
GLOVER.txt,347837,349515,1678,10,N,N,-,-1,-1
GLOVER.txt,349516,350565,1049,10,N,N,-,-1,-1
GLOVER.txt,350566,351769,1203,10,N,Y,1437471397525,350644,351290
GLOVER.txt,351770,353067,1297,10,N,Y,1437471855423,351318,351853
GLOVER.txt,353069,354423,1354,10,N,N,-,-1,-1
GLOVER.txt,354425,355939,1514,10,Y,N,-,-1,-1
GLOVER.txt,355940,357278,1338,10,N,N,-,-1,-1
GLOVER.txt,357279,358878,1599,10,N,N,-,-1,-1
GLOVER.txt,358881,359918,1037,10,N,N,-,-1,-1
GLOVER.txt,359919,361983,2064,10,Y,N,-,-1,-1
GLOVER.txt,361985,363232,1247,10,Y,N,-,-1,-1
GLOVER.txt,363233,364108,875,10,N,N,-,-1,-1
GLOVER.txt,364109,365328,1219,10,N,N,-,-1,-1
GLOVER.txt,365329,367635,2306,10,N,N,-,-1,-1
GLOVER.txt,367638,369764,2126,10,N,N,-,-1,-1
GLOVER.txt,369765,371150,1385,10,N,N,-,-1,-1
GLOVER.txt,371153,372746,1593,10,N,N,-,-1,-1
GLOVER.txt,372749,373288,539,10,N,N,-,-1,-1
GLOVER.txt,373289,374867,1578,10,N,N,-,-1,-1
GLOVER.txt,374868,376713,1845,10,N,N,-,-1,-1
GLOVER.txt,376715,377882,1167,10,N,N,-,-1,-1
GLOVER.txt,377883,379390,1507,10,N,N,-,-1,-1
GLOVER.txt,379391,380915,1524,10,N,N,-,-1,-1
GLOVER.txt,380916,382393,1477,10,Y,N,-,-1,-1
GLOVER.txt,382394,383555,1161,10,N,N,-,-1,-1
GLOVER.txt,383556,384987,1431,10,N,N,-,-1,-1
GLOVER.txt,384988,386489,1501,10,N,N,-,-1,-1
GLOVER.txt,386490,387548,1058,10,N,N,-,-1,-1
GLOVER.txt,387549,389025,1476,10,N,N,-,-1,-1
GLOVER.txt,389026,390136,1110,10,N,N,-,-1,-1
GLOVER.txt,390137,391274,1137,10,N,N,-,-1,-1
GLOVER.txt,391275,392627,1352,10,N,N,-,-1,-1
GLOVER.txt,392628,394414,1786,10,N,N,-,-1,-1
GLOVER.txt,394415,395977,1562,10,N,Y,1437472966198,394609,395892
GLOVER.txt,395980,397360,1380,10,N,N,-,-1,-1
GLOVER.txt,397361,398784,1423,10,N,N,-,-1,-1
GLOVER.txt,398785,399664,879,10,N,N,-,-1,-1
GLOVER.txt,399665,401662,1997,10,N,N,-,-1,-1
GLOVER.txt,401665,403278,1613,10,N,N,-,-1,-1
GLOVER.txt,403280,404961,1681,10,N,N,-,-1,-1
GLOVER.txt,404962,406676,1714,10,N,N,-,-1,-1
GLOVER.txt,406681,407840,1159,10,N,N,-,-1,-1
GLOVER.txt,407841,409443,1602,10,N,N,-,-1,-1
GLOVER.txt,409446,411467,2021,10,N,N,-,-1,-1
GLOVER.txt,411468,412846,1378,10,N,N,-,-1,-1
GLOVER.txt,412849,414453,1604,10,N,N,-,-1,-1
GLOVER.txt,414456,415942,1486,10,N,N,-,-1,-1
GLOVER.txt,415945,416503,558,10,N,N,-,-1,-1
GLOVER.txt,416506,418549,2043,10,N,N,-,-1,-1
GLOVER.txt,418550,420873,2323,10,N,N,-,-1,-1
GLOVER.txt,420874,421259,385,10,N,N,-,-1,-1
GLOVER.txt,421262,422581,1319,10,N,N,-,-1,-1
GLOVER.txt,422582,424141,1559,10,N,N,-,-1,-1
GLOVER.txt,424142,425152,1010,10,N,N,-,-1,-1
GLOVER.txt,425153,425629,476,10,N,N,-,-1,-1
GLOVER.txt,425630,426505,875,10,N,N,-,-1,-1
GLOVER.txt,426506,426979,473,10,N,N,-,-1,-1
GLOVER.txt,426980,427495,515,10,N,N,-,-1,-1
GLOVER.txt,427496,428532,1036,10,N,N,-,-1,-1
GLOVER.txt,428533,429080,547,10,N,N,-,-1,-1
GLOVER.txt,429081,429460,379,10,N,N,-,-1,-1
GLOVER.txt,429461,431413,1952,10,N,N,-,-1,-1
GLOVER.txt,431416,432759,1343,10,N,N,-,-1,-1
GLOVER.txt,432760,434326,1566,10,N,N,-,-1,-1
GLOVER.txt,434328,435552,1224,10,N,N,-,-1,-1
GLOVER.txt,435553,437002,1449,10,N,N,-,-1,-1
GLOVER.txt,437003,439565,2562,10,N,N,-,-1,-1
GLOVER.txt,439566,441822,2256,10,N,N,-,-1,-1
GLOVER.txt,441823,443532,1709,10,N,N,-,-1,-1
GLOVER.txt,443534,445694,2160,10,N,N,-,-1,-1
GLOVER.txt,445695,447292,1597,10,N,N,-,-1,-1
GLOVER.txt,447293,448588,1295,10,N,N,-,-1,-1
GLOVER.txt,448589,449997,1408,10,N,N,-,-1,-1
GLOVER.txt,449998,451811,1813,10,N,N,-,-1,-1
GLOVER.txt,451812,453770,1958,10,N,N,-,-1,-1
GLOVER.txt,453772,455654,1882,10,N,N,-,-1,-1
GLOVER.txt,455655,457704,2049,10,N,N,-,-1,-1
GLOVER.txt,457705,458526,821,10,N,N,-,-1,-1
GLOVER.txt,458527,459856,1329,10,N,N,-,-1,-1
GLOVER.txt,459857,460829,972,10,N,N,-,-1,-1
GLOVER.txt,460830,462788,1958,10,N,N,-,-1,-1
GLOVER.txt,462789,463779,990,10,N,N,-,-1,-1
GLOVER.txt,463782,465945,2163,10,N,N,-,-1,-1
GLOVER.txt,465946,466920,974,10,N,N,-,-1,-1
GLOVER.txt,466922,467906,984,10,N,N,-,-1,-1
GLOVER.txt,467907,469241,1334,10,N,N,-,-1,-1
GLOVER.txt,469242,471442,2200,10,N,N,-,-1,-1
GLOVER.txt,471445,473014,1569,10,N,N,-,-1,-1
GLOVER.txt,473017,474579,1562,10,N,N,-,-1,-1
GLOVER.txt,474580,475631,1051,10,N,N,-,-1,-1
GLOVER.txt,475632,476066,434,10,N,N,-,-1,-1
GLOVER.txt,476067,476405,338,10,N,N,-,-1,-1
GLOVER.txt,476406,476845,439,10,N,N,-,-1,-1
GLOVER.txt,476846,478304,1458,10,N,N,-,-1,-1
GLOVER.txt,478305,480351,2046,10,N,N,-,-1,-1
GLOVER.txt,480354,482579,2225,10,N,N,-,-1,-1
GLOVER.txt,482580,484338,1758,10,N,N,-,-1,-1
GLOVER.txt,484341,484723,382,10,N,N,-,-1,-1
GLOVER.txt,484726,485368,642,10,N,N,-,-1,-1
GLOVER.txt,485371,486515,1144,10,N,N,-,-1,-1
GLOVER.txt,486516,487190,674,10,N,N,-,-1,-1
GLOVER.txt,487193,487815,622,10,N,N,-,-1,-1
GLOVER.txt,487816,488434,618,10,N,N,-,-1,-1
GLOVER.txt,488435,489010,575,10,N,N,-,-1,-1
GLOVER.txt,489011,490279,1268,10,N,N,-,-1,-1
GLOVER.txt,490280,490715,435,10,N,N,-,-1,-1
GLOVER.txt,490716,491340,624,10,N,N,-,-1,-1
GLOVER.txt,491341,491790,449,10,N,N,-,-1,-1
GLOVER.txt,491791,492492,701,10,N,N,-,-1,-1
GLOVER.txt,492493,493082,589,10,N,N,-,-1,-1
GLOVER.txt,493083,493582,499,10,N,N,-,-1,-1
GLOVER.txt,493585,494078,493,10,N,N,-,-1,-1
GLOVER.txt,494079,495883,1804,10,N,N,-,-1,-1
GLOVER.txt,495884,496742,858,10,N,N,-,-1,-1
GLOVER.txt,496743,497343,600,10,N,N,-,-1,-1
GLOVER.txt,497345,497584,239,10,N,N,-,-1,-1
GLOVER.txt,497589,497805,216,10,N,N,-,-1,-1
GLOVER.txt,497808,498046,238,10,N,N,-,-1,-1
GLOVER.txt,498049,498196,147,10,N,N,-,-1,-1
GLOVER.txt,498197,499430,1233,10,N,N,-,-1,-1
GLOVER.txt,499431,501408,1977,10,N,N,-,-1,-1
GLOVER.txt,501409,502921,1512,10,N,N,-,-1,-1
GLOVER.txt,502922,504379,1457,10,N,N,-,-1,-1
GLOVER.txt,504380,505374,994,10,N,N,-,-1,-1
GLOVER.txt,505375,506980,1605,10,N,N,-,-1,-1
GLOVER.txt,506985,507743,758,10,N,N,-,-1,-1
GLOVER.txt,507746,508343,597,10,N,N,-,-1,-1
GLOVER.txt,508344,510300,1956,10,N,N,-,-1,-1
GLOVER.txt,510301,511107,806,10,N,N,-,-1,-1
GLOVER.txt,511108,512476,1368,10,N,N,-,-1,-1
GLOVER.txt,512477,526494,14017,10,N,N,-,-1,-1
GRONOW.txt,0,599,599,10,N,N,-,-1,-1
GRONOW.txt,602,1501,899,10,N,N,-,-1,-1
GRONOW.txt,1504,3182,1678,10,N,N,-,-1,-1
GRONOW.txt,3183,3749,566,10,N,N,-,-1,-1
GRONOW.txt,3752,5540,1788,10,N,N,-,-1,-1
GRONOW.txt,5541,7993,2452,10,N,N,-,-1,-1
GRONOW.txt,7994,9014,1020,10,N,N,-,-1,-1
GRONOW.txt,9016,10632,1616,10,N,N,-,-1,-1
GRONOW.txt,10635,12335,1700,10,N,N,-,-1,-1
GRONOW.txt,12338,14151,1813,10,N,N,-,-1,-1
GRONOW.txt,14154,16326,2172,10,N,N,-,-1,-1
GRONOW.txt,16329,18219,1890,10,N,N,-,-1,-1
GRONOW.txt,18224,20063,1839,10,N,N,-,-1,-1
GRONOW.txt,20066,21877,1811,10,N,N,-,-1,-1
GRONOW.txt,21878,23233,1355,10,N,N,-,-1,-1
GRONOW.txt,23236,24848,1612,10,N,N,-,-1,-1
GRONOW.txt,24849,26525,1676,10,N,N,-,-1,-1
GRONOW.txt,26526,28008,1482,10,N,N,-,-1,-1
GRONOW.txt,28009,29961,1952,10,N,N,-,-1,-1
GRONOW.txt,29962,32298,2336,10,N,N,-,-1,-1
GRONOW.txt,32301,34021,1720,10,N,N,-,-1,-1
GRONOW.txt,34022,35747,1725,10,N,N,-,-1,-1
GRONOW.txt,35748,37743,1995,10,N,N,-,-1,-1
GRONOW.txt,37744,39703,1959,10,N,N,-,-1,-1
GRONOW.txt,39704,40821,1117,10,N,N,-,-1,-1
GRONOW.txt,40822,42368,1546,10,N,N,-,-1,-1
GRONOW.txt,42369,43463,1094,10,N,N,-,-1,-1
GRONOW.txt,43464,44988,1524,10,N,N,-,-1,-1
GRONOW.txt,44989,46001,1012,10,N,N,-,-1,-1
GRONOW.txt,46002,47271,1269,10,N,N,-,-1,-1
GRONOW.txt,47273,48548,1275,10,N,N,-,-1,-1
GRONOW.txt,48549,50045,1496,10,N,N,-,-1,-1
GRONOW.txt,50046,51487,1441,10,N,N,-,-1,-1
GRONOW.txt,51488,53007,1519,10,N,N,-,-1,-1
GRONOW.txt,53008,54619,1611,10,N,N,-,-1,-1
GRONOW.txt,54622,56200,1578,10,N,N,-,-1,-1
GRONOW.txt,56201,57889,1688,10,N,N,-,-1,-1
GRONOW.txt,57890,59313,1423,10,N,N,-,-1,-1
GRONOW.txt,59314,60825,1511,10,N,N,-,-1,-1
GRONOW.txt,60826,62465,1639,10,N,N,-,-1,-1
GRONOW.txt,62466,64091,1625,10,N,N,-,-1,-1
GRONOW.txt,64094,65720,1626,10,N,N,-,-1,-1
GRONOW.txt,65721,66591,870,10,N,N,-,-1,-1
GRONOW.txt,66592,67789,1197,10,N,N,-,-1,-1
GRONOW.txt,67792,68660,868,10,N,N,-,-1,-1
GRONOW.txt,68662,69645,983,10,N,N,-,-1,-1
GRONOW.txt,69646,70900,1254,10,N,N,-,-1,-1
GRONOW.txt,70901,72252,1351,10,N,N,-,-1,-1
GRONOW.txt,72253,73781,1528,10,N,N,-,-1,-1
GRONOW.txt,73782,75210,1428,10,N,N,-,-1,-1
GRONOW.txt,75211,76913,1702,10,N,N,-,-1,-1
GRONOW.txt,76916,78668,1752,10,N,N,-,-1,-1
GRONOW.txt,78669,80928,2259,10,N,N,-,-1,-1
GRONOW.txt,80931,82562,1631,10,N,N,-,-1,-1
GRONOW.txt,82563,84277,1714,10,N,N,-,-1,-1
GRONOW.txt,84278,85838,1560,10,N,N,-,-1,-1
GRONOW.txt,85839,87927,2088,10,N,N,-,-1,-1
GRONOW.txt,87928,89261,1333,10,N,N,-,-1,-1
GRONOW.txt,89263,90400,1137,10,N,N,-,-1,-1
GRONOW.txt,90401,93289,2888,10,N,N,-,-1,-1
GRONOW.txt,93290,94730,1440,10,N,N,-,-1,-1
GRONOW.txt,94732,96113,1381,10,N,N,-,-1,-1
GRONOW.txt,96114,97358,1244,10,N,N,-,-1,-1
GRONOW.txt,97359,99462,2103,10,N,Y,1437475017618,98942,100041
GRONOW.txt,99463,101155,1692,10,N,Y,1437475017618,98942,100041
GRONOW.txt,101156,102983,1827,10,N,N,-,-1,-1
GRONOW.txt,102986,104361,1375,10,N,N,-,-1,-1
GRONOW.txt,104364,106382,2018,10,N,N,-,-1,-1
GRONOW.txt,106383,108181,1798,10,N,N,-,-1,-1
GRONOW.txt,108183,109895,1712,10,N,N,-,-1,-1
GRONOW.txt,109896,112303,2407,10,N,N,-,-1,-1
GRONOW.txt,112304,114151,1847,10,N,N,-,-1,-1
GRONOW.txt,114156,115340,1184,10,N,N,-,-1,-1
GRONOW.txt,115342,117633,2291,10,N,N,-,-1,-1
GRONOW.txt,117636,119823,2187,10,N,N,-,-1,-1
GRONOW.txt,119824,121223,1399,10,N,N,-,-1,-1
GRONOW.txt,121225,122738,1513,10,N,N,-,-1,-1
GRONOW.txt,122739,124214,1475,10,N,N,-,-1,-1
GRONOW.txt,124215,125056,841,10,N,N,-,-1,-1
GRONOW.txt,125057,126994,1937,10,N,N,-,-1,-1
GRONOW.txt,126995,128942,1947,10,N,N,-,-1,-1
GRONOW.txt,128943,131089,2146,10,N,N,-,-1,-1
GRONOW.txt,131092,133066,1974,10,N,N,-,-1,-1
GRONOW.txt,133067,134992,1925,10,N,N,-,-1,-1
GRONOW.txt,134993,136639,1646,10,N,N,-,-1,-1
GRONOW.txt,136640,137743,1103,10,N,N,-,-1,-1
GRONOW.txt,137744,139206,1462,10,N,N,-,-1,-1
GRONOW.txt,139207,140114,907,10,N,N,-,-1,-1
GRONOW.txt,140115,141874,1759,10,N,N,-,-1,-1
GRONOW.txt,141875,143636,1761,10,N,N,-,-1,-1
GRONOW.txt,143637,144849,1212,10,N,N,-,-1,-1
GRONOW.txt,144852,146628,1776,10,N,N,-,-1,-1
GRONOW.txt,146629,148877,2248,10,N,N,-,-1,-1
GRONOW.txt,148879,151375,2496,10,N,N,-,-1,-1
GRONOW.txt,151376,153309,1933,10,N,N,-,-1,-1
GRONOW.txt,153311,155067,1756,10,N,N,-,-1,-1
GRONOW.txt,155072,156900,1828,10,N,N,-,-1,-1
GRONOW.txt,156901,158808,1907,10,N,N,-,-1,-1
GRONOW.txt,158811,160560,1749,10,N,N,-,-1,-1
GRONOW.txt,160563,162552,1989,10,N,N,-,-1,-1
GRONOW.txt,162553,163966,1413,10,N,N,-,-1,-1
GRONOW.txt,163967,165944,1977,10,N,N,-,-1,-1
GRONOW.txt,165945,167703,1758,10,N,N,-,-1,-1
GRONOW.txt,167704,169531,1827,10,N,N,-,-1,-1
GRONOW.txt,169532,170846,1314,10,N,N,-,-1,-1
GRONOW.txt,170847,173579,2732,10,Y,N,-,-1,-1
GRONOW.txt,173580,175572,1992,10,N,N,-,-1,-1
GRONOW.txt,175577,177657,2080,10,N,N,-,-1,-1
GRONOW.txt,177659,178899,1240,10,N,N,-,-1,-1
GRONOW.txt,178900,180363,1463,10,N,N,-,-1,-1
GRONOW.txt,180364,181989,1625,10,N,N,-,-1,-1
GRONOW.txt,181991,183385,1394,10,N,N,-,-1,-1
GRONOW.txt,183386,185349,1963,10,N,N,-,-1,-1
GRONOW.txt,185350,187212,1862,10,N,N,-,-1,-1
GRONOW.txt,187213,188859,1646,10,N,N,-,-1,-1
GRONOW.txt,188860,190074,1214,10,N,N,-,-1,-1
GRONOW.txt,190075,192318,2243,10,N,N,-,-1,-1
GRONOW.txt,192323,194244,1921,10,N,N,-,-1,-1
GRONOW.txt,194245,196495,2250,10,N,N,-,-1,-1
GRONOW.txt,196498,198746,2248,10,N,N,-,-1,-1
GRONOW.txt,198749,200539,1790,10,N,N,-,-1,-1
GRONOW.txt,200542,202241,1699,10,N,N,-,-1,-1
GRONOW.txt,202242,204107,1865,10,N,N,-,-1,-1
GRONOW.txt,204108,206070,1962,10,N,N,-,-1,-1
GRONOW.txt,206071,207583,1512,10,N,N,-,-1,-1
GRONOW.txt,207584,209837,2253,10,N,N,-,-1,-1
GRONOW.txt,209838,211008,1170,10,N,N,-,-1,-1
GRONOW.txt,211009,212254,1245,10,N,N,-,-1,-1
GRONOW.txt,212257,213803,1546,10,Y,N,-,-1,-1
GRONOW.txt,213804,215149,1345,10,Y,N,-,-1,-1
GRONOW.txt,215150,217280,2130,10,N,N,-,-1,-1
GRONOW.txt,217283,218497,1214,10,N,N,-,-1,-1
GRONOW.txt,218500,220007,1507,10,N,N,-,-1,-1
GRONOW.txt,220008,221790,1782,10,Y,Y,1437476486340,221621,222520
GRONOW.txt,221791,223636,1845,10,Y,Y,1437476486340,221621,222520
GRONOW.txt,223637,225902,2265,10,N,N,-,-1,-1
GRONOW.txt,225904,227601,1697,10,N,N,-,-1,-1
GRONOW.txt,227602,228839,1237,10,N,N,-,-1,-1
GRONOW.txt,228840,230086,1246,10,N,N,-,-1,-1
GRONOW.txt,230087,231550,1463,10,N,N,-,-1,-1
GRONOW.txt,231551,233432,1881,10,N,N,-,-1,-1
GRONOW.txt,233433,235311,1878,10,N,N,-,-1,-1
GRONOW.txt,235312,237637,2325,10,N,N,-,-1,-1
GRONOW.txt,237638,239535,1897,10,N,N,-,-1,-1
GRONOW.txt,239536,241592,2056,10,N,N,-,-1,-1
GRONOW.txt,241593,243692,2099,10,N,N,-,-1,-1
GRONOW.txt,243693,245973,2280,10,N,N,-,-1,-1
GRONOW.txt,245975,248306,2331,10,N,N,-,-1,-1
GRONOW.txt,248309,249744,1435,10,N,N,-,-1,-1
GRONOW.txt,249745,252400,2655,10,N,N,-,-1,-1
GRONOW.txt,252403,254036,1633,10,N,N,-,-1,-1
GRONOW.txt,254037,256283,2246,10,N,N,-,-1,-1
GRONOW.txt,256284,258426,2142,10,N,N,-,-1,-1
GRONOW.txt,258427,260766,2339,10,N,N,-,-1,-1
GRONOW.txt,260769,262447,1678,10,N,N,-,-1,-1
GRONOW.txt,262448,264740,2292,10,N,N,-,-1,-1
GRONOW.txt,264741,266372,1631,10,N,N,-,-1,-1
GRONOW.txt,266375,267516,1141,10,N,N,-,-1,-1
GRONOW.txt,267517,269256,1739,10,N,N,-,-1,-1
GRONOW.txt,269257,271531,2274,10,N,N,-,-1,-1
GRONOW.txt,271532,273827,2295,10,N,N,-,-1,-1
GRONOW.txt,273828,275906,2078,10,N,N,-,-1,-1
GRONOW.txt,275907,277616,1709,10,N,N,-,-1,-1
GRONOW.txt,277619,279705,2086,10,N,N,-,-1,-1
GRONOW.txt,279706,282133,2427,10,N,N,-,-1,-1
GRONOW.txt,282134,284259,2125,10,N,N,-,-1,-1
GRONOW.txt,284261,286809,2548,10,N,N,-,-1,-1
GRONOW.txt,286810,289352,2542,10,N,N,-,-1,-1
GRONOW.txt,289353,292019,2666,10,N,N,-,-1,-1
GRONOW.txt,292022,294853,2831,10,N,N,-,-1,-1
GRONOW.txt,294856,297135,2279,10,N,N,-,-1,-1
GRONOW.txt,297136,299074,1938,10,N,N,-,-1,-1
GRONOW.txt,299075,301194,2119,10,N,N,-,-1,-1
GRONOW.txt,301195,303172,1977,10,N,N,-,-1,-1
GRONOW.txt,303173,305197,2024,10,N,N,-,-1,-1
GRONOW.txt,305202,307875,2673,10,N,N,-,-1,-1
GRONOW.txt,307876,309690,1814,10,N,N,-,-1,-1
GRONOW.txt,309692,311433,1741,10,N,N,-,-1,-1
GRONOW.txt,311434,313606,2172,10,N,N,-,-1,-1
GRONOW.txt,313607,315955,2348,10,N,N,-,-1,-1
GRONOW.txt,315956,318114,2158,10,N,N,-,-1,-1
GRONOW.txt,318115,320207,2092,10,N,N,-,-1,-1
GRONOW.txt,320210,321903,1693,10,N,N,-,-1,-1
GRONOW.txt,321904,323956,2052,10,N,N,-,-1,-1
GRONOW.txt,323959,325210,1251,10,N,N,-,-1,-1
GRONOW.txt,325212,326821,1609,10,N,N,-,-1,-1
GRONOW.txt,326824,328263,1439,10,N,N,-,-1,-1
GRONOW.txt,328264,329531,1267,10,N,N,-,-1,-1
GRONOW.txt,329534,331093,1559,10,N,N,-,-1,-1
GRONOW.txt,331094,332948,1854,10,N,N,-,-1,-1
GRONOW.txt,332949,334646,1697,10,N,N,-,-1,-1
GRONOW.txt,334647,336448,1801,10,N,N,-,-1,-1
GRONOW.txt,336449,338471,2022,10,N,N,-,-1,-1
GRONOW.txt,338474,340513,2039,10,N,N,-,-1,-1
GRONOW.txt,340515,343035,2520,10,N,N,-,-1,-1
GRONOW.txt,343036,344590,1554,10,N,N,-,-1,-1
GRONOW.txt,344591,346259,1668,10,N,N,-,-1,-1
GRONOW.txt,346260,347662,1402,10,N,N,-,-1,-1
GRONOW.txt,347663,349511,1848,10,N,N,-,-1,-1
GRONOW.txt,349514,351159,1645,10,N,N,-,-1,-1
GRONOW.txt,351161,352645,1484,10,N,N,-,-1,-1
GRONOW.txt,352646,354156,1510,10,N,N,-,-1,-1
GRONOW.txt,354157,356098,1941,10,N,N,-,-1,-1
GRONOW.txt,356100,358020,1920,10,N,N,-,-1,-1
GRONOW.txt,358021,360552,2531,10,N,N,-,-1,-1
GRONOW.txt,360555,362250,1695,10,N,N,-,-1,-1
GRONOW.txt,362251,363772,1521,10,N,N,-,-1,-1
GRONOW.txt,363773,364883,1110,10,N,N,-,-1,-1
GRONOW.txt,364884,366208,1324,10,N,N,-,-1,-1
GRONOW.txt,366211,368438,2227,10,N,N,-,-1,-1
GRONOW.txt,368439,370415,1976,10,N,N,-,-1,-1
GRONOW.txt,370416,371671,1255,10,N,N,-,-1,-1
GRONOW.txt,371674,372818,1144,10,N,N,-,-1,-1
GRONOW.txt,372819,374606,1787,10,N,N,-,-1,-1
GRONOW.txt,374607,376397,1790,10,N,N,-,-1,-1
GRONOW.txt,376400,378543,2143,10,N,N,-,-1,-1
GRONOW.txt,378546,380128,1582,10,N,N,-,-1,-1
GRONOW.txt,380129,382130,2001,10,N,N,-,-1,-1
GRONOW.txt,382131,384175,2044,10,N,N,-,-1,-1
GRONOW.txt,384176,385986,1810,10,N,N,-,-1,-1
GRONOW.txt,385989,387325,1336,10,N,N,-,-1,-1
GRONOW.txt,387326,389002,1676,10,N,N,-,-1,-1
GRONOW.txt,389003,390793,1790,10,N,N,-,-1,-1
GRONOW.txt,390796,392487,1691,10,N,N,-,-1,-1
GRONOW.txt,392488,394393,1905,10,N,N,-,-1,-1
GRONOW.txt,394394,395759,1365,10,N,N,-,-1,-1
GRONOW.txt,395761,397179,1418,10,N,N,-,-1,-1
GRONOW.txt,397180,398820,1640,10,N,N,-,-1,-1
GRONOW.txt,398823,400315,1492,10,N,N,-,-1,-1
GRONOW.txt,400316,401763,1447,10,N,N,-,-1,-1
GRONOW.txt,401764,403516,1752,10,N,N,-,-1,-1
GRONOW.txt,403519,405002,1483,10,N,N,-,-1,-1
GRONOW.txt,405003,407032,2029,10,N,N,-,-1,-1
GRONOW.txt,407033,408815,1782,10,N,N,-,-1,-1
GRONOW.txt,408816,410101,1285,10,N,N,-,-1,-1
GRONOW.txt,410103,412199,2096,10,N,N,-,-1,-1
GRONOW.txt,412200,413589,1389,10,N,N,-,-1,-1
GRONOW.txt,413590,415187,1597,10,N,N,-,-1,-1
GRONOW.txt,415190,416790,1600,10,N,N,-,-1,-1
GRONOW.txt,416791,419001,2210,10,N,N,-,-1,-1
GRONOW.txt,419004,420634,1630,10,N,N,-,-1,-1
GRONOW.txt,420635,422302,1667,10,N,N,-,-1,-1
GRONOW.txt,422303,423066,763,10,N,N,-,-1,-1
GRONOW.txt,423067,424367,1300,10,N,N,-,-1,-1
GRONOW.txt,424368,425887,1519,10,N,Y,1437477480340,424837,425856
GRONOW.txt,425888,427165,1277,10,N,N,-,-1,-1
GRONOW.txt,427166,428511,1345,10,N,Y,1437477878183,427206,428439
GRONOW.txt,428514,429570,1056,10,N,N,-,-1,-1
GRONOW.txt,429571,430456,885,10,N,N,-,-1,-1
GRONOW.txt,430457,432404,1947,10,N,N,-,-1,-1
GRONOW.txt,432406,434104,1698,10,N,N,-,-1,-1
GRONOW.txt,434105,435553,1448,10,N,N,-,-1,-1
GRONOW.txt,435555,436567,1012,10,N,N,-,-1,-1
GRONOW.txt,436568,437987,1419,10,N,N,-,-1,-1
GRONOW.txt,437988,439491,1503,10,N,N,-,-1,-1
GRONOW.txt,439492,440553,1061,10,N,N,-,-1,-1
GRONOW.txt,440554,441934,1380,10,N,N,-,-1,-1
GRONOW.txt,441935,443754,1819,10,N,N,-,-1,-1
GRONOW.txt,443755,445447,1692,10,N,N,-,-1,-1
GRONOW.txt,445448,447259,1811,10,N,N,-,-1,-1
GRONOW.txt,447260,448865,1605,10,N,N,-,-1,-1
GRONOW.txt,448868,450336,1468,10,N,N,-,-1,-1
GRONOW.txt,450337,451951,1614,10,N,N,-,-1,-1
GRONOW.txt,451953,453368,1415,10,N,N,-,-1,-1
GRONOW.txt,453369,455090,1721,10,N,N,-,-1,-1
GRONOW.txt,455095,457075,1980,10,N,N,-,-1,-1
GRONOW.txt,457076,459280,2204,10,N,N,-,-1,-1
GRONOW.txt,459283,460653,1370,10,N,N,-,-1,-1
GRONOW.txt,460654,462304,1650,10,Y,Y,1437490253936,460795,462238
GRONOW.txt,462305,463645,1340,10,N,N,-,-1,-1
GRONOW.txt,463646,465085,1439,10,N,N,-,-1,-1
GRONOW.txt,465088,466415,1327,10,N,N,-,-1,-1
GRONOW.txt,466416,468649,2233,10,N,N,-,-1,-1
GRONOW.txt,468654,471047,2393,10,N,N,-,-1,-1
GRONOW.txt,471050,472114,1064,10,N,N,-,-1,-1
GRONOW.txt,472115,473385,1270,10,N,N,-,-1,-1
GRONOW.txt,473388,474945,1557,10,N,N,-,-1,-1
GRONOW.txt,474948,476549,1601,10,N,N,-,-1,-1
GRONOW.txt,476550,478056,1506,10,N,N,-,-1,-1
GRONOW.txt,478057,480203,2146,10,N,N,-,-1,-1
GRONOW.txt,480204,481529,1325,10,N,N,-,-1,-1
GRONOW.txt,481530,482872,1342,10,N,N,-,-1,-1
GRONOW.txt,482873,484646,1773,10,N,N,-,-1,-1
GRONOW.txt,484647,486397,1750,10,N,N,-,-1,-1
GRONOW.txt,486398,487992,1594,10,N,N,-,-1,-1
GRONOW.txt,487993,490041,2048,10,N,N,-,-1,-1
GRONOW.txt,490042,492101,2059,10,N,N,-,-1,-1
GRONOW.txt,492102,493829,1727,10,N,N,-,-1,-1
GRONOW.txt,493830,495235,1405,10,N,N,-,-1,-1
GRONOW.txt,495236,496611,1375,10,N,N,-,-1,-1
GRONOW.txt,496612,498114,1502,10,N,N,-,-1,-1
GRONOW.txt,498115,499434,1319,10,N,N,-,-1,-1
GRONOW.txt,499435,501095,1660,10,N,N,-,-1,-1
GRONOW.txt,501096,503271,2175,10,N,N,-,-1,-1
GRONOW.txt,503272,505433,2161,10,N,N,-,-1,-1
GRONOW.txt,505434,507365,1931,10,N,N,-,-1,-1
GRONOW.txt,507366,509270,1904,10,N,N,-,-1,-1
GRONOW.txt,509273,510799,1526,10,N,N,-,-1,-1
GRONOW.txt,510800,512211,1411,10,N,N,-,-1,-1
GRONOW.txt,512212,514103,1891,10,N,N,-,-1,-1
GRONOW.txt,514104,515880,1776,10,N,N,-,-1,-1
GRONOW.txt,515883,517287,1404,10,N,N,-,-1,-1
GRONOW.txt,517292,518659,1367,10,N,N,-,-1,-1
GRONOW.txt,518661,519819,1158,10,N,N,-,-1,-1
GRONOW.txt,519820,521967,2147,10,N,N,-,-1,-1
GRONOW.txt,521970,523217,1247,10,N,N,-,-1,-1
GRONOW.txt,523218,524920,1702,10,N,N,-,-1,-1
GRONOW.txt,524923,526186,1263,10,N,N,-,-1,-1
GRONOW.txt,526187,527252,1065,10,N,N,-,-1,-1
GRONOW.txt,527253,529110,1857,10,N,N,-,-1,-1
GRONOW.txt,529111,530487,1376,10,N,N,-,-1,-1
GRONOW.txt,530488,532394,1906,10,N,N,-,-1,-1
GRONOW.txt,532397,534511,2114,10,N,N,-,-1,-1
GRONOW.txt,534512,536098,1586,10,N,N,-,-1,-1
GRONOW.txt,536099,537652,1553,10,N,N,-,-1,-1
GRONOW.txt,537653,538910,1257,10,N,N,-,-1,-1
GRONOW.txt,538911,539943,1032,10,N,N,-,-1,-1
GRONOW.txt,539946,541520,1574,10,N,N,-,-1,-1
GRONOW.txt,541521,543042,1521,10,N,N,-,-1,-1
GRONOW.txt,543044,545264,2220,10,N,N,-,-1,-1
GRONOW.txt,545265,546508,1243,10,N,N,-,-1,-1
GRONOW.txt,546510,548617,2107,10,N,N,-,-1,-1
GRONOW.txt,548618,549474,856,10,N,N,-,-1,-1
GRONOW.txt,549475,551259,1784,10,N,N,-,-1,-1
GRONOW.txt,551261,553162,1901,10,N,N,-,-1,-1
GRONOW.txt,553163,554858,1695,10,N,N,-,-1,-1
GRONOW.txt,554859,555870,1011,10,N,N,-,-1,-1
GRONOW.txt,555873,557387,1514,10,N,N,-,-1,-1
GRONOW.txt,557392,558588,1196,10,N,N,-,-1,-1
GRONOW.txt,558589,560015,1426,10,Y,N,-,-1,-1
GRONOW.txt,560016,562172,2156,10,N,N,-,-1,-1
GRONOW.txt,562173,563725,1552,10,N,N,-,-1,-1
GRONOW.txt,563726,563882,156,10,N,N,-,-1,-1
GRONOW.txt,563883,564191,308,10,N,N,-,-1,-1
GRONOW.txt,564191,564367,176,10,N,N,-,-1,-1
GRONOW.txt,564370,564675,305,10,N,N,-,-1,-1
GRONOW.txt,564676,564985,309,10,N,N,-,-1,-1
GRONOW.txt,564986,565318,332,10,N,N,-,-1,-1
GRONOW.txt,565320,565499,179,10,N,N,-,-1,-1
GRONOW.txt,565500,565767,267,10,N,N,-,-1,-1
MASONB.txt,0,1439,1439,10,N,N,-,-1,-1
MASONB.txt,1442,2793,1351,10,N,N,-,-1,-1
MASONB.txt,2794,3605,811,10,N,N,-,-1,-1
MASONB.txt,3608,5538,1930,10,N,N,-,-1,-1
MASONB.txt,5539,6669,1130,10,N,N,-,-1,-1
MASONB.txt,6672,7807,1135,10,N,N,-,-1,-1
MASONB.txt,7810,8333,523,10,N,N,-,-1,-1
MASONB.txt,8334,9388,1054,10,N,N,-,-1,-1
MASONB.txt,9389,10495,1106,10,N,N,-,-1,-1
MASONB.txt,10496,11846,1350,10,N,N,-,-1,-1
MASONB.txt,11847,13385,1538,10,N,N,-,-1,-1
MASONB.txt,13387,14396,1009,10,N,Y,1448037533268,13930,15031
MASONB.txt,14397,15219,822,10,N,Y,1448038101349,15101,17486
MASONB.txt,15220,16370,1150,10,N,Y,1448038101349,15101,17486
MASONB.txt,16371,17571,1200,10,N,Y,1448038101349,15101,17486
MASONB.txt,17574,19011,1437,10,N,Y,1448038803075,18895,19670
MASONB.txt,19013,20637,1624,10,N,Y,1448038803075,18895,19670
MASONB.txt,20640,21783,1143,10,N,Y,1448039370049,20775,21297
MASONB.txt,21786,22685,899,10,N,Y,1448274783410,21836,25159
MASONB.txt,22686,24060,1374,10,N,Y,1448274783410,21836,25159
MASONB.txt,24061,24903,842,10,N,Y,1448274783410,21836,25159
MASONB.txt,24904,26181,1277,10,N,Y,1448274893770,25386,26202
MASONB.txt,26182,27169,987,10,N,Y,1448275407308,26987,29181
MASONB.txt,27170,28914,1744,10,Y,Y,1448275407308,26987,29181
MASONB.txt,28916,29840,924,10,N,Y,1448275407308,26987,29181
MASONB.txt,29843,32207,2364,10,Y,Y,1448276340407,30017,39003
MASONB.txt,32208,34224,2016,10,Y,Y,1448276340407,30017,39003
MASONB.txt,34227,36088,1861,10,Y,Y,1448276340407,30017,39003
MASONB.txt,36089,36899,810,10,N,Y,1448276340407,30017,39003
MASONB.txt,36902,37904,1002,10,Y,Y,1448276340407,30017,39003
MASONB.txt,37905,38917,1012,10,N,Y,1448276340407,30017,39003
MASONB.txt,38918,40685,1767,10,N,Y,1448276340407,30017,39003
MASONB.txt,40686,41536,850,10,N,Y,1448277167610,40886,47737
MASONB.txt,41537,43195,1658,10,N,Y,1448277167610,40886,47737
MASONB.txt,43198,44886,1688,10,Y,Y,1448277167610,40886,47737
MASONB.txt,44887,47028,2141,10,N,Y,1448277167610,40886,47737
MASONB.txt,47029,48041,1012,10,N,Y,1448277167610,40886,47737
MASONB.txt,48046,49763,1717,10,N,N,-,-1,-1
MASONB.txt,49766,52494,2728,10,Y,N,-,-1,-1
MASONB.txt,52497,53850,1353,10,N,Y,1448277582432,52552,54595
MASONB.txt,53851,55413,1562,10,Y,Y,1448277582432,52552,54595
MASONB.txt,55414,57207,1793,10,N,Y,1448278147591,54631,55869
MASONB.txt,57210,58640,1430,10,Y,N,-,-1,-1
MASONB.txt,58645,60262,1617,10,N,Y,1448278279697,58861,59444
MASONB.txt,60263,61899,1636,10,N,N,-,-1,-1
MASONB.txt,61900,63146,1246,10,N,N,-,-1,-1
MASONB.txt,63148,64727,1579,10,N,N,-,-1,-1
MASONB.txt,64730,66462,1732,10,N,Y,1448278425221,65586,65914
MASONB.txt,66463,67689,1226,10,N,Y,1448279089520,67624,69991
MASONB.txt,67690,68689,999,10,N,Y,1448279089520,67624,69991
MASONB.txt,68690,69754,1064,10,Y,Y,1448279089520,67624,69991
MASONB.txt,69755,71045,1290,10,Y,Y,1448279620157,70041,71486
MASONB.txt,71046,71895,849,10,Y,Y,1448279620157,70041,71486
MASONB.txt,71896,73140,1244,10,N,Y,1448279941918,72406,72905
MASONB.txt,73141,75219,2078,10,N,N,-,-1,-1
MASONB.txt,75220,77514,2294,10,N,N,-,-1,-1
MASONB.txt,77515,79176,1661,10,Y,N,-,-1,-1
MASONB.txt,79177,81327,2150,10,N,N,-,-1,-1
MASONB.txt,81328,83234,1906,10,N,N,-,-1,-1
MASONB.txt,83236,83940,704,10,N,N,-,-1,-1
MASONB.txt,83943,85312,1369,10,N,Y,1448280297446,84055,84972
MASONB.txt,85313,86398,1085,10,N,Y,1448280423373,85694,86154
MASONB.txt,86399,87443,1044,10,N,N,-,-1,-1
MASONB.txt,87444,88832,1388,10,N,Y,1448280884746,88496,89294
MASONB.txt,88833,89855,1022,10,N,Y,1448281320115,89144,91129
MASONB.txt,89856,90052,196,10,N,Y,1448281320115,89144,91129
MASONB.txt,90053,90911,858,10,N,Y,1448281320115,89144,91129
MASONB.txt,90913,92554,1641,10,N,Y,1448281320115,89144,91129
MASONB.txt,92555,94343,1788,10,N,N,-,-1,-1
MASONB.txt,94344,95974,1630,10,N,N,-,-1,-1
MASONB.txt,95975,97749,1774,10,N,N,-,-1,-1
MASONB.txt,97752,98914,1162,10,N,Y,1448281888079,98877,102290
MASONB.txt,98915,100525,1610,10,N,Y,1448281888079,98877,102290
MASONB.txt,100527,102096,1569,10,N,Y,1448281888079,98877,102290
MASONB.txt,102097,102930,833,10,N,Y,1448281888079,98877,102290
MASONB.txt,102931,104355,1424,10,N,Y,1448285563397,102964,108476
MASONB.txt,104356,106112,1756,10,N,Y,1448285563397,102964,108476
MASONB.txt,106115,107642,1527,10,N,Y,1448285563397,102964,108476
MASONB.txt,107643,108659,1016,10,Y,Y,1448285563397,102964,108476
MASONB.txt,108664,109698,1034,10,N,Y,1448285913012,108803,110925
MASONB.txt,109699,111186,1487,10,Y,Y,1448285913012,108803,110925
MASONB.txt,111187,111575,388,10,N,Y,1448286451685,111065,112127
MASONB.txt,111578,112848,1270,10,Y,Y,1448286451685,111065,112127
MASONB.txt,112849,114009,1160,10,N,Y,1448286880729,112151,113274
MASONB.txt,114010,115525,1515,10,N,Y,1448287306770,114686,120152
MASONB.txt,115526,116800,1274,10,N,Y,1448287306770,114686,120152
MASONB.txt,116801,118130,1329,10,Y,Y,1448287306770,114686,120152
MASONB.txt,118131,119461,1330,10,Y,Y,1448287306770,114686,120152
MASONB.txt,119462,121195,1733,10,N,Y,1448287306770,114686,120152
MASONB.txt,121196,122808,1612,10,N,Y,1448287490368,120754,123385
MASONB.txt,122809,123896,1087,10,N,Y,1448287490368,120754,123385
MASONB.txt,123897,125598,1701,10,N,N,-,-1,-1
MASONB.txt,125599,127468,1869,10,N,N,-,-1,-1
MASONB.txt,127469,128712,1243,10,N,N,-,-1,-1
MASONB.txt,128713,130001,1288,10,Y,N,-,-1,-1
MASONB.txt,130002,131446,1444,10,Y,N,-,-1,-1
MASONB.txt,131447,132654,1207,10,N,N,-,-1,-1
MASONB.txt,132655,134311,1656,10,N,N,-,-1,-1
MASONB.txt,134314,136110,1796,10,N,N,-,-1,-1
MASONB.txt,136113,137512,1399,10,N,Y,1448310549245,137491,141408
MASONB.txt,137513,139103,1590,10,Y,Y,1448310549245,137491,141408
MASONB.txt,139106,140623,1517,10,Y,Y,1448310549245,137491,141408
MASONB.txt,140624,141478,854,10,N,Y,1448310549245,137491,141408
MASONB.txt,141479,143007,1528,10,N,N,-,-1,-1
MASONB.txt,143008,143852,844,10,N,Y,1448311366799,143137,146264
MASONB.txt,143853,144119,266,10,N,Y,1448311366799,143137,146264
MASONB.txt,144120,144945,825,10,N,Y,1448311366799,143137,146264
MASONB.txt,144946,146249,1303,10,Y,Y,1448311366799,143137,146264
MASONB.txt,146250,147398,1148,10,N,Y,1448311366799,143137,146264
MASONB.txt,147403,148932,1529,10,Y,N,-,-1,-1
MASONB.txt,148934,150565,1631,10,N,N,-,-1,-1
MASONB.txt,150567,152673,2106,10,Y,N,-,-1,-1
MASONB.txt,152674,154343,1669,10,N,N,-,-1,-1
MASONB.txt,154344,156325,1981,10,Y,Y,1448311594480,155711,156312
MASONB.txt,156330,157355,1025,10,N,N,-,-1,-1
MASONB.txt,157356,158687,1331,10,N,Y,1448311811907,157566,161100
MASONB.txt,158690,160409,1719,10,N,Y,1448311811907,157566,161100
MASONB.txt,160410,161724,1314,10,N,Y,1448311811907,157566,161100
MASONB.txt,161727,162394,667,10,N,N,-,-1,-1
MASONB.txt,162394,163382,988,10,N,N,-,-1,-1
MASONB.txt,163384,164964,1580,10,N,N,-,-1,-1
MASONB.txt,164967,165760,793,10,N,N,-,-1,-1
MASONB.txt,165762,167185,1423,10,N,N,-,-1,-1
MASONB.txt,167186,168737,1551,10,N,N,-,-1,-1
MASONB.txt,168738,169942,1204,10,N,N,-,-1,-1
MASONB.txt,169945,171699,1754,10,N,N,-,-1,-1
MASONB.txt,171702,173036,1334,10,N,Y,1448312128598,172353,173027
MASONB.txt,173037,174565,1528,10,Y,Y,1448312844411,173573,174472
MASONB.txt,174566,175724,1158,10,N,Y,1448313123004,175370,176057
MASONB.txt,175725,177707,1982,10,Y,Y,1448313482895,176553,176862
MASONB.txt,177710,179024,1314,10,N,Y,1448313674408,176614,178600
MASONB.txt,179027,179955,928,10,N,Y,1448313800274,179025,179317
MASONB.txt,179956,181770,1814,10,Y,Y,1448315012079,181380,182053
MASONB.txt,181771,183224,1453,10,N,Y,1448315012079,181380,182053
MASONB.txt,183227,184476,1249,10,N,Y,1448316079788,183824,184995
MASONB.txt,184477,185268,791,10,N,Y,1448316079788,183824,184995
MASONB.txt,185271,186825,1554,10,Y,N,-,-1,-1
MASONB.txt,186826,188378,1552,10,N,N,-,-1,-1
MASONB.txt,188379,190248,1869,10,N,N,-,-1,-1
MASONB.txt,190249,191637,1388,10,N,N,-,-1,-1
MASONB.txt,191638,192362,724,10,N,N,-,-1,-1
MASONB.txt,192363,192639,276,10,N,N,-,-1,-1
MASONB.txt,192642,192930,288,10,N,N,-,-1,-1
MASONB.txt,192931,193256,325,10,N,N,-,-1,-1
MASONB.txt,193257,193762,505,10,N,N,-,-1,-1
MASONB.txt,193763,194116,353,10,N,N,-,-1,-1
MASONB.txt,194119,194520,401,10,N,N,-,-1,-1
MASONB.txt,194521,195198,677,10,N,N,-,-1,-1
MASONB.txt,195198,195512,314,10,N,N,-,-1,-1
MASONB.txt,195515,195818,303,10,N,N,-,-1,-1
MASONB.txt,195819,196161,342,10,N,N,-,-1,-1
MASONB.txt,196162,198814,2652,10,Y,N,-,-1,-1
MASONB.txt,198815,201638,2823,10,Y,N,-,-1,-1
MASONB.txt,201639,203876,2237,10,Y,N,-,-1,-1
MASONB.txt,203877,205768,1891,10,N,N,-,-1,-1
MASONB.txt,205769,206672,903,10,N,Y,1448316411409,206556,208475
MASONB.txt,206673,208121,1448,10,Y,Y,1448316411409,206556,208475
MASONB.txt,208122,210236,2114,10,Y,Y,1448316586529,210063,210674
MASONB.txt,210239,211651,1412,10,N,Y,1448316586529,210063,210674
MASONB.txt,211652,212973,1321,10,N,Y,1448321627053,211159,212725
MASONB.txt,212976,214072,1096,10,N,Y,1448322095209,213778,214023
MASONB.txt,214075,215098,1023,10,N,N,-,-1,-1
MASONB.txt,215099,216932,1833,10,N,N,-,-1,-1
MASONB.txt,216933,219937,3004,10,N,Y,1448322273366,219239,219544
MASONB.txt,219938,221328,1390,10,Y,Y,1448322514970,220165,221397
MASONB.txt,221329,222179,850,10,N,Y,1448322514970,220165,221397
MASONB.txt,222180,224031,1851,10,Y,Y,1448322713112,221941,223038
MASONB.txt,224032,225421,1389,10,Y,N,-,-1,-1
MASONB.txt,225424,226765,1341,10,N,N,-,-1,-1
MASONB.txt,226768,227964,1196,10,N,Y,1448323072174,227638,227786
MASONB.txt,227965,229108,1143,10,N,N,-,-1,-1
MASONB.txt,229109,230271,1162,10,N,Y,1448323254416,230223,230526
MASONB.txt,230272,231475,1203,10,N,Y,1448325046337,230539,231128
MASONB.txt,231476,233030,1554,10,Y,Y,1448357159811,231190,232925
MASONB.txt,233033,234675,1642,10,Y,Y,1448357582358,234204,234401
MASONB.txt,234676,236200,1524,10,N,Y,1448358276684,234999,235995
MASONB.txt,236201,237467,1266,10,N,N,-,-1,-1
MASONB.txt,237470,238849,1379,10,Y,Y,1448358538400,238461,240031
MASONB.txt,238850,240151,1301,10,Y,Y,1448358538400,238461,240031
MASONB.txt,240152,241400,1248,10,N,Y,1448358806100,240524,240915
MASONB.txt,241401,242214,813,10,N,N,-,-1,-1
MASONB.txt,242215,243908,1693,10,Y,N,-,-1,-1
MASONB.txt,243911,245546,1635,10,N,N,-,-1,-1
MASONB.txt,245548,246626,1078,10,N,N,-,-1,-1
MASONB.txt,246627,247612,985,10,N,Y,1448359079273,247104,249268
MASONB.txt,247613,249193,1580,10,N,Y,1448359079273,247104,249268
MASONB.txt,249194,250616,1422,10,N,Y,1448359079273,247104,249268
MASONB.txt,250619,251706,1087,10,N,N,-,-1,-1
MASONB.txt,251707,252720,1013,10,N,N,-,-1,-1
MASONB.txt,252721,253490,769,10,N,N,-,-1,-1
MASONB.txt,253491,254811,1320,10,N,N,-,-1,-1
MASONB.txt,254816,255956,1140,10,N,N,-,-1,-1
MASONB.txt,255957,257584,1627,10,N,N,-,-1,-1
MASONB.txt,257586,259228,1642,10,N,N,-,-1,-1
MASONB.txt,259229,260601,1372,10,N,N,-,-1,-1
MASONB.txt,260603,261442,839,10,N,N,-,-1,-1
MASONB.txt,261443,262390,947,10,N,N,-,-1,-1
MASONB.txt,262391,263496,1105,10,N,Y,1448359440819,262798,263079
MASONB.txt,263497,264662,1165,10,N,N,-,-1,-1
MASONB.txt,264663,265782,1119,10,N,Y,1448359608080,265546,265784
MASONB.txt,265783,267348,1565,10,N,Y,1448359878707,265791,267089
MASONB.txt,267349,268821,1472,10,N,Y,1448360140810,268069,269800
MASONB.txt,268822,270645,1823,10,N,Y,1448360140810,268069,269800
MASONB.txt,270646,272078,1432,10,Y,Y,1448366107348,271942,274308
MASONB.txt,272079,273208,1129,10,N,Y,1448366107348,271942,274308
MASONB.txt,273209,274654,1445,10,Y,Y,1448366107348,271942,274308
MASONB.txt,274655,276579,1924,10,N,Y,1448366492754,275659,275884
MASONB.txt,276580,278011,1431,10,N,Y,1448366833867,275966,276698
MASONB.txt,278016,279184,1168,10,N,Y,1448367094347,278355,278591
MASONB.txt,279185,280497,1312,10,N,Y,1448369133400,279084,280004
MASONB.txt,280500,283078,2578,10,N,Y,1448369703497,282374,282547
MASONB.txt,283081,284461,1380,10,Y,Y,1448393386565,284140,284575
MASONB.txt,284464,285742,1278,10,N,Y,1448393386565,284140,284575
MASONB.txt,285743,286793,1050,10,N,N,-,-1,-1
MASONB.txt,286794,287737,943,10,N,N,-,-1,-1
MASONB.txt,287740,289018,1278,10,N,Y,1448393552252,287738,288962
MASONB.txt,289021,290352,1331,10,N,Y,1448393918391,289044,290517
MASONB.txt,290353,291096,743,10,N,Y,1448393918391,289044,290517
MASONB.txt,291097,291420,323,10,N,Y,1448394436678,290724,292129
MASONB.txt,291425,292539,1114,10,N,Y,1448394636895,292272,293963
MASONB.txt,292540,292965,425,10,N,Y,1448394636895,292272,293963
MASONB.txt,292966,293972,1006,10,N,Y,1448394636895,292272,293963
MASONB.txt,293975,295049,1074,10,N,Y,1448395538701,294934,295016
MASONB.txt,295052,296762,1710,10,Y,Y,1448396118064,295199,297352
MASONB.txt,296765,298503,1738,10,Y,Y,1448396118064,295199,297352
MASONB.txt,298504,299600,1096,10,N,Y,1448396244435,298633,299110
MASONB.txt,299603,300400,797,10,N,Y,1448396441082,299649,301294
MASONB.txt,300402,301211,809,10,N,Y,1448396441082,299649,301294
MASONB.txt,301212,302598,1386,10,N,Y,1448396441082,299649,301294
MASONB.txt,302599,303331,732,10,N,Y,1448396898923,302722,302823
MASONB.txt,303332,304043,711,10,N,N,-,-1,-1
MASONB.txt,304046,305381,1335,10,N,N,-,-1,-1
MASONB.txt,305382,306788,1406,10,N,Y,1448397101672,305423,307582
MASONB.txt,306789,308689,1900,10,N,Y,1448397101672,305423,307582
MASONB.txt,308690,310445,1755,10,N,Y,1448397303768,308560,309010
MASONB.txt,310446,311905,1459,10,N,Y,1448397400459,310446,310619
MASONB.txt,311906,312979,1073,10,N,Y,1448658303622,312507,313648
MASONB.txt,312982,314063,1081,10,N,Y,1448658303622,312507,313648
MASONB.txt,314064,315819,1755,10,N,N,-,-1,-1
MASONB.txt,315820,317455,1635,10,N,Y,1448658612805,316427,316672
MASONB.txt,317458,319417,1959,10,N,Y,1448659006435,318991,319718
MASONB.txt,319418,321878,2460,10,N,Y,1448659006435,318991,319718
MASONB.txt,321879,323747,1868,10,N,Y,1448659261066,322714,323579
MASONB.txt,323748,325513,1765,10,N,Y,1448659532009,324326,325031
MASONB.txt,325514,327298,1784,10,N,Y,1448660077114,325649,326955
MASONB.txt,327299,329202,1903,10,N,Y,1448660482807,328289,328500
MASONB.txt,329203,331132,1929,10,Y,Y,1448660677535,329295,329761
MASONB.txt,331133,333052,1919,10,N,Y,1448706327916,331732,332605
MASONB.txt,333055,334265,1210,10,N,Y,1448707430181,333075,333132
MASONB.txt,334266,335242,976,10,N,Y,1448709266671,335017,336316
MASONB.txt,335245,335641,396,10,N,Y,1448709266671,335017,336316
MASONB.txt,335644,336039,395,10,N,Y,1448709266671,335017,336316
MASONB.txt,336040,336220,180,10,N,Y,1448709266671,335017,336316
MASONB.txt,336221,337116,895,10,N,Y,1448709266671,335017,336316
MASONB.txt,337119,337794,675,10,N,Y,1448709417506,337306,338419
MASONB.txt,337797,339325,1528,10,N,Y,1448709670572,338913,339172
MASONB.txt,339326,340782,1456,10,N,Y,1448709848065,339253,340600
MASONB.txt,340784,341818,1034,10,N,Y,1448835299579,341107,342636
MASONB.txt,341821,342580,759,10,N,Y,1448835299579,341107,342636
MASONB.txt,342583,343023,440,10,N,Y,1448835299579,341107,342636
MASONB.txt,343024,343236,212,10,N,N,-,-1,-1
MASONB.txt,343237,343526,289,10,N,N,-,-1,-1
MASONB.txt,343527,343865,338,10,N,N,-,-1,-1
MASONB.txt,343866,344153,287,10,N,N,-,-1,-1
MASONB.txt,344153,344463,310,10,N,N,-,-1,-1
MASONB.txt,344464,344692,228,10,N,N,-,-1,-1
MASONB.txt,344693,345238,545,10,N,N,-,-1,-1
MASONB.txt,345239,346241,1002,10,N,Y,1448835409437,345709,346338
MASONB.txt,346242,346767,525,10,N,Y,1448835409437,345709,346338
MASONB.txt,346770,348244,1474,10,N,Y,1448919978818,348008,348718
MASONB.txt,348246,349831,1585,10,Y,Y,1448919978818,348008,348718
MASONB.txt,349832,351060,1228,10,N,Y,1448920117937,349054,349858
MASONB.txt,351063,352905,1842,10,N,N,-,-1,-1
MASONB.txt,352910,354659,1749,10,N,N,-,-1,-1
MASONB.txt,354662,355826,1164,10,N,N,-,-1,-1
MASONB.txt,355828,357527,1699,10,N,N,-,-1,-1
MASONB.txt,357528,358867,1339,10,N,Y,1448920293515,357836,358190
MASONB.txt,358868,360626,1758,10,N,N,-,-1,-1
MASONB.txt,360627,362257,1630,10,Y,N,-,-1,-1
MASONB.txt,362258,364645,2387,10,Y,Y,1448920858487,363333,364839
MASONB.txt,364646,365975,1329,10,N,Y,1448920858487,363333,364839
MASONB.txt,365978,367052,1074,10,N,N,-,-1,-1
MASONB.txt,367053,369144,2091,10,Y,Y,1448921338450,367291,368573
MASONB.txt,369145,370263,1118,10,N,N,-,-1,-1
MASONB.txt,370264,371023,759,10,N,Y,1448921716519,370956,371267
MASONB.txt,371024,372506,1482,10,Y,Y,1448921716519,370956,371267
MASONB.txt,372507,373846,1339,10,Y,Y,1448922003968,373392,374323
MASONB.txt,373847,375316,1469,10,Y,Y,1448922003968,373392,374323
MASONB.txt,375317,376431,1114,10,Y,N,-,-1,-1
MASONB.txt,376432,377736,1304,10,N,Y,1448922458482,377161,378772
MASONB.txt,377737,378864,1127,10,N,Y,1448922458482,377161,378772
MASONB.txt,378865,380575,1710,10,N,N,-,-1,-1
MASONB.txt,380577,382014,1437,10,Y,Y,1448923016815,381625,382381
MASONB.txt,382015,383692,1677,10,Y,Y,1448923016815,381625,382381
MASONB.txt,383693,384635,942,10,Y,N,-,-1,-1
MASONB.txt,384637,385652,1015,10,N,N,-,-1,-1
MASONB.txt,385655,386759,1104,10,N,N,-,-1,-1
MASONB.txt,386760,387680,920,10,N,N,-,-1,-1
MASONB.txt,387681,388806,1125,10,N,N,-,-1,-1
MASONB.txt,388807,390189,1382,10,N,N,-,-1,-1
MASONB.txt,390190,391732,1542,10,Y,N,-,-1,-1
MASONB.txt,391733,394137,2404,10,Y,N,-,-1,-1
MASONB.txt,394140,395126,986,10,N,N,-,-1,-1
MASONB.txt,395128,395768,640,10,N,N,-,-1,-1
MASONB.txt,395768,396435,667,10,N,N,-,-1,-1
MASONB.txt,396435,397158,723,10,N,N,-,-1,-1
MASONB.txt,397159,397557,398,10,N,N,-,-1,-1
MASONB.txt,397558,397888,330,10,N,N,-,-1,-1
MASONB.txt,397889,398490,601,10,N,N,-,-1,-1
MASONB.txt,398491,399575,1084,10,N,N,-,-1,-1
MASONB.txt,399577,400620,1043,10,Y,N,-,-1,-1
MASONB.txt,400623,402073,1450,10,Y,N,-,-1,-1
MASONB.txt,402074,403378,1304,10,N,N,-,-1,-1
MASONB.txt,403379,404698,1319,10,N,N,-,-1,-1
MASONB.txt,404699,406269,1570,10,Y,N,-,-1,-1
MASONB.txt,406270,407413,1143,10,N,N,-,-1,-1
MASONB.txt,407414,408574,1160,10,Y,N,-,-1,-1
MASONB.txt,408575,409681,1106,10,N,N,-,-1,-1
MASONB.txt,409682,410769,1087,10,N,N,-,-1,-1
MASONB.txt,410770,412233,1463,10,Y,N,-,-1,-1
MASONB.txt,412234,413175,941,10,N,N,-,-1,-1
MASONB.txt,413176,414204,1028,10,N,N,-,-1,-1
MASONB.txt,414205,414525,320,10,N,N,-,-1,-1
MASONB.txt,414526,414695,169,10,N,N,-,-1,-1
MASONB.txt,414696,415325,629,10,N,N,-,-1,-1
MASONB.txt,415325,415631,306,10,N,N,-,-1,-1
MASONB.txt,415632,416656,1024,10,N,N,-,-1,-1
MASONB.txt,416657,417989,1332,10,N,N,-,-1,-1
MASONB.txt,417990,419434,1444,10,Y,N,-,-1,-1
MASONB.txt,419435,420333,898,10,N,N,-,-1,-1
MASONB.txt,420334,421890,1556,10,N,N,-,-1,-1
MASONB.txt,421891,422826,935,10,Y,N,-,-1,-1
MASONB.txt,422827,424146,1319,10,N,N,-,-1,-1
MASONB.txt,424147,425376,1229,10,N,N,-,-1,-1
MASONB.txt,425377,427016,1639,10,Y,N,-,-1,-1
MASONB.txt,427017,428151,1134,10,N,N,-,-1,-1
MASONB.txt,428153,429593,1440,10,N,N,-,-1,-1
MASONB.txt,429594,431115,1521,10,Y,N,-,-1,-1
MASONB.txt,431116,432063,947,10,N,N,-,-1,-1
MASONB.txt,432064,433428,1364,10,N,N,-,-1,-1
MASONB.txt,433429,434641,1212,10,N,N,-,-1,-1
MASONB.txt,434642,435663,1021,10,Y,N,-,-1,-1
MASONB.txt,435664,436778,1114,10,Y,N,-,-1,-1
MASONB.txt,436780,438724,1944,10,N,N,-,-1,-1
MASONB.txt,438725,440566,1841,10,N,N,-,-1,-1
MASONB.txt,440567,441964,1397,10,Y,N,-,-1,-1
MASONB.txt,441965,443775,1810,10,N,N,-,-1,-1
MASONB.txt,443776,445794,2018,10,N,N,-,-1,-1
MASONB.txt,445797,446385,588,10,N,N,-,-1,-1
MASONB.txt,446387,447879,1492,10,N,N,-,-1,-1
MASONB.txt,447880,448730,850,10,N,N,-,-1,-1
MASONB.txt,448731,449159,428,10,N,N,-,-1,-1
MASONB.txt,449160,449595,435,10,N,N,-,-1,-1
MASONB.txt,449598,449956,358,10,N,N,-,-1,-1
MASONB.txt,449957,450425,468,10,N,N,-,-1,-1
MASONB.txt,450427,451561,1134,10,N,N,-,-1,-1
MASONB.txt,451562,452807,1245,10,N,N,-,-1,-1
MASONB.txt,452808,454149,1341,10,N,N,-,-1,-1
MASONB.txt,454150,455422,1272,10,N,N,-,-1,-1
MASONB.txt,455423,456541,1118,10,N,N,-,-1,-1
MASONB.txt,456542,457900,1358,10,N,N,-,-1,-1
MASONB.txt,457901,458854,953,10,N,N,-,-1,-1
MASONB.txt,458854,459473,619,10,N,N,-,-1,-1
MASONB.txt,459476,460116,640,10,N,N,-,-1,-1
MASONB.txt,460118,460819,701,10,N,N,-,-1,-1
MASONB.txt,460821,461365,544,10,N,N,-,-1,-1
MASONB.txt,461366,462370,1004,10,N,N,-,-1,-1
MASONB.txt,462375,462903,528,10,N,N,-,-1,-1
MASONB.txt,462904,463962,1058,10,Y,N,-,-1,-1
MASONB.txt,463965,465286,1321,10,N,N,-,-1,-1
MASONB.txt,465287,466385,1098,10,N,N,-,-1,-1
MASONB.txt,466387,467366,979,10,N,N,-,-1,-1
MASONB.txt,467367,468244,877,10,N,N,-,-1,-1
MASONB.txt,468245,469197,952,10,N,N,-,-1,-1
MASONB.txt,469198,470104,906,10,N,N,-,-1,-1
MASONB.txt,470107,471317,1210,10,N,Y,1448923619461,471131,472718
MASONB.txt,471318,472321,1003,10,N,Y,1448923619461,471131,472718
MASONB.txt,472323,473611,1288,10,N,Y,1448923619461,471131,472718
MASONB.txt,473612,474507,895,10,N,Y,1449009694213,473488,474410
MASONB.txt,474510,475880,1370,10,N,N,-,-1,-1
MASONB.txt,475882,477569,1687,10,Y,N,-,-1,-1
MASONB.txt,477571,479156,1585,10,N,N,-,-1,-1
MASONB.txt,479157,479724,567,10,N,N,-,-1,-1
MASONB.txt,479725,481492,1767,10,Y,N,-,-1,-1
MASONB.txt,481493,482366,873,10,N,N,-,-1,-1
MASONB.txt,482367,482745,378,10,N,N,-,-1,-1
MASONB.txt,482746,482930,184,10,N,N,-,-1,-1
MASONB.txt,482930,483312,382,10,N,N,-,-1,-1
MASONB.txt,483313,483685,372,10,N,N,-,-1,-1
MASONB.txt,483690,485391,1701,10,N,N,-,-1,-1
MASONB.txt,485392,486446,1054,10,N,N,-,-1,-1
MASONB.txt,486449,488152,1703,10,N,N,-,-1,-1
MASONB.txt,488153,488442,289,10,N,N,-,-1,-1
MASONB.txt,488443,488768,325,10,N,N,-,-1,-1
MASONB.txt,488771,489183,412,10,N,N,-,-1,-1
MASONB.txt,489186,489599,413,10,N,N,-,-1,-1
MASONB.txt,489600,489994,394,10,N,N,-,-1,-1
MASONB.txt,489995,492180,2185,10,Y,N,-,-1,-1
MASONB.txt,492182,493904,1722,10,N,N,-,-1,-1
MASONB.txt,493905,495109,1204,10,Y,N,-,-1,-1
MASONB.txt,495110,496177,1067,10,N,N,-,-1,-1
MASONB.txt,496179,498192,2013,10,N,N,-,-1,-1
MASONB.txt,498193,498889,696,10,N,N,-,-1,-1
MASONB.txt,498892,500002,1110,10,N,N,-,-1,-1
MASONB.txt,500003,501322,1319,10,Y,N,-,-1,-1
MASONB.txt,501323,503088,1765,10,N,N,-,-1,-1
MASONB.txt,503089,504628,1539,10,N,N,-,-1,-1
MASONB.txt,504629,506231,1602,10,N,N,-,-1,-1
MASONB.txt,506232,507351,1119,10,N,N,-,-1,-1
MASONB.txt,507352,508226,874,10,N,N,-,-1,-1
MASONB.txt,508229,509338,1109,10,N,N,-,-1,-1
MASONB.txt,509341,510061,720,10,N,N,-,-1,-1
MASONB.txt,510062,510487,425,10,N,N,-,-1,-1
MASONB.txt,510490,511027,537,10,N,N,-,-1,-1
MASONB.txt,511028,511914,886,10,N,N,-,-1,-1
MASONB.txt,511915,512803,888,10,N,N,-,-1,-1
MASONB.txt,512804,514544,1740,10,N,N,-,-1,-1
MASONB.txt,514547,516152,1605,10,N,N,-,-1,-1
MASONB.txt,516153,517356,1203,10,Y,N,-,-1,-1
MASONB.txt,517359,518627,1268,10,Y,N,-,-1,-1
MASONB.txt,518628,519809,1181,10,Y,N,-,-1,-1
MASONB.txt,519810,520739,929,10,N,N,-,-1,-1
MASONB.txt,520740,521624,884,10,N,N,-,-1,-1
MASONB.txt,521626,522765,1139,10,Y,N,-,-1,-1
MASONB.txt,522767,523952,1185,10,Y,N,-,-1,-1
MASONB.txt,523953,525063,1110,10,Y,N,-,-1,-1
MASONB.txt,525064,526535,1471,10,N,N,-,-1,-1
MASONB.txt,526536,527147,611,10,N,N,-,-1,-1
MASONB.txt,527148,528450,1302,10,N,Y,1449011557797,528395,529262
MASONB.txt,528451,529609,1158,10,N,Y,1449011557797,528395,529262
MASONB.txt,529612,530496,884,10,N,N,-,-1,-1
MASONB.txt,530497,532907,2410,10,Y,N,-,-1,-1
MASONB.txt,532910,533794,884,10,N,Y,1449011929492,533126,533951
MASONB.txt,533796,535336,1540,10,N,Y,1461670558474,533968,535655
MASONB.txt,535337,536422,1085,10,N,Y,1461670707714,535735,535836
MASONB.txt,536424,537833,1409,10,N,Y,1461671039271,535897,538614
MASONB.txt,537834,538690,856,10,N,Y,1461671039271,535897,538614
MASONB.txt,538695,539722,1027,10,N,Y,1461671237429,538958,540588
MASONB.txt,539723,540996,1273,10,N,Y,1461682939139,540732,541471
MASONB.txt,540997,541752,755,10,N,Y,1461682939139,540732,541471
MASONB.txt,541753,542215,462,10,N,N,-,-1,-1
MASONB.txt,542216,542694,478,10,N,N,-,-1,-1
MASONB.txt,542695,543271,576,10,N,N,-,-1,-1
MASONB.txt,543274,544089,815,10,N,Y,1461777193721,543550,543984
MASONB.txt,544090,545247,1157,10,N,Y,1461777612954,544164,545194
MASONB.txt,545250,546531,1281,10,N,N,-,-1,-1
MASONB.txt,546536,547979,1443,10,N,Y,1461779662782,546686,549591
MASONB.txt,547982,549146,1164,10,N,Y,1461779662782,546686,549591
MASONB.txt,549147,550058,911,10,N,Y,1461790279048,549743,550180
MASONB.txt,550059,551407,1348,10,Y,Y,1461790554025,550059,551049
MASONB.txt,551408,552614,1206,10,N,Y,1461791817263,551075,551983
MASONB.txt,552615,553671,1056,10,N,Y,1462035341084,552137,553334
MASONB.txt,553672,554839,1167,10,N,Y,1462037372440,554649,554769
MASONB.txt,554840,556425,1585,10,Y,Y,1462038250768,556311,558014
MASONB.txt,556427,558247,1820,10,N,Y,1462038250768,556311,558014
MASONB.txt,558248,559177,929,10,N,Y,1462038377036,558101,558326
MASONB.txt,559178,560488,1310,10,N,N,-,-1,-1
MASONB.txt,560493,560808,315,10,N,N,-,-1,-1
MASONB.txt,560809,561069,260,10,N,N,-,-1,-1
MASONB.txt,561070,562257,1187,10,N,N,-,-1,-1
MASONB.txt,562262,563155,893,10,N,N,-,-1,-1
MASONB.txt,563156,564191,1035,10,N,N,-,-1,-1
MASONB.txt,564192,565023,831,10,Y,N,-,-1,-1
MASONB.txt,565024,566207,1183,10,Y,N,-,-1,-1
MASONB.txt,566210,567340,1130,10,N,N,-,-1,-1
MASONB.txt,567342,568630,1288,10,N,N,-,-1,-1
MASONB.txt,568631,570235,1604,10,N,N,-,-1,-1
MASONB.txt,570236,571521,1285,10,N,N,-,-1,-1
MEMMUS.txt,0,7939,7939,10,Y,N,-,-1,-1
MEMMUS.txt,7940,11007,3067,10,N,N,-,-1,-1
MEMMUS.txt,11008,11611,603,10,N,N,-,-1,-1
MEMMUS.txt,11612,13127,1515,10,Y,N,-,-1,-1
MEMMUS.txt,13130,14807,1677,10,Y,N,-,-1,-1
MEMMUS.txt,14808,16124,1316,10,Y,N,-,-1,-1
MEMMUS.txt,16126,17212,1086,10,Y,N,-,-1,-1
MEMMUS.txt,17213,18455,1242,10,Y,Y,1435840591315,18262,18851
MEMMUS.txt,18456,19363,907,10,N,Y,1435840591315,18262,18851
MEMMUS.txt,19364,20220,856,10,N,N,-,-1,-1
MEMMUS.txt,20221,21041,820,10,Y,N,-,-1,-1
MEMMUS.txt,21044,22360,1316,10,Y,Y,1435915325286,22285,22827
MEMMUS.txt,22361,23503,1142,10,Y,Y,1435915325286,22285,22827
MEMMUS.txt,23504,24851,1347,10,Y,Y,1435915981952,24325,25472
MEMMUS.txt,24852,26359,1507,10,N,Y,1435916345649,25766,26337
MEMMUS.txt,26362,28241,1879,10,Y,N,-,-1,-1
MEMMUS.txt,28244,29732,1488,10,Y,Y,1435916831062,28859,29721
MEMMUS.txt,29735,31063,1328,10,Y,N,-,-1,-1
MEMMUS.txt,31064,32671,1607,10,N,Y,1435926808950,31555,32153
MEMMUS.txt,32672,34195,1523,10,Y,Y,1435927129543,33653,34022
MEMMUS.txt,34196,35776,1580,10,N,Y,1435927632749,34517,35131
MEMMUS.txt,35777,37431,1654,10,Y,Y,1435928087149,36052,37379
MEMMUS.txt,37434,38764,1330,10,N,N,-,-1,-1
MEMMUS.txt,38767,39747,980,10,N,N,-,-1,-1
MEMMUS.txt,39750,41517,1767,10,Y,N,-,-1,-1
MEMMUS.txt,41520,42993,1473,10,Y,N,-,-1,-1
MEMMUS.txt,42995,44285,1290,10,N,N,-,-1,-1
MEMMUS.txt,44286,45590,1304,10,Y,N,-,-1,-1
MEMMUS.txt,45591,46460,869,10,N,Y,1435929264418,46072,46536
MEMMUS.txt,46461,47352,891,10,N,Y,1435930107895,46560,46927
MEMMUS.txt,47353,48514,1161,10,Y,Y,1435930476313,46955,47602
MEMMUS.txt,48515,50311,1796,10,Y,N,-,-1,-1
MEMMUS.txt,50314,51963,1649,10,Y,N,-,-1,-1
MEMMUS.txt,51966,53872,1906,10,Y,Y,1435930984335,53222,54022
MEMMUS.txt,53873,55295,1422,10,Y,Y,1435930984335,53222,54022
MEMMUS.txt,55296,56783,1487,10,N,N,-,-1,-1
MEMMUS.txt,56784,58611,1827,10,Y,N,-,-1,-1
MEMMUS.txt,58612,59964,1352,10,Y,N,-,-1,-1
MEMMUS.txt,59966,61715,1749,10,Y,N,-,-1,-1
MEMMUS.txt,61718,63059,1341,10,Y,N,-,-1,-1
MEMMUS.txt,63062,64299,1237,10,Y,N,-,-1,-1
MEMMUS.txt,64300,65783,1483,10,Y,Y,1435931512268,64554,65135
MEMMUS.txt,65785,67281,1496,10,N,N,-,-1,-1
MEMMUS.txt,67284,69123,1839,10,Y,Y,1436164309168,67698,68227
MEMMUS.txt,69124,70577,1453,10,N,Y,1436164628291,70081,70559
MEMMUS.txt,70580,72026,1446,10,N,N,-,-1,-1
MEMMUS.txt,72027,73317,1290,10,N,Y,1436173608702,72553,73111
MEMMUS.txt,73318,74201,883,10,N,N,-,-1,-1
MEMMUS.txt,74202,75851,1649,10,N,N,-,-1,-1
MEMMUS.txt,75852,77124,1272,10,N,Y,1436174454662,76332,76889
MEMMUS.txt,77125,78751,1626,10,N,N,-,-1,-1
MEMMUS.txt,78752,79603,851,10,N,N,-,-1,-1
MEMMUS.txt,79606,81402,1796,10,N,N,-,-1,-1
MEMMUS.txt,81407,82959,1552,10,Y,Y,1436174968369,81917,82485
MEMMUS.txt,82960,84103,1143,10,N,Y,1436175572082,83734,84298
MEMMUS.txt,84104,85368,1264,10,Y,Y,1436175572082,83734,84298
MEMMUS.txt,85369,87493,2124,10,Y,Y,1436176439600,86589,87384
MEMMUS.txt,87496,89087,1591,10,Y,N,-,-1,-1
MEMMUS.txt,89088,89992,904,10,Y,N,-,-1,-1
MEMMUS.txt,89997,90300,303,10,N,N,-,-1,-1
MEMMUS.txt,90301,91202,901,10,N,N,-,-1,-1
MEMMUS.txt,91203,92098,895,10,N,N,-,-1,-1
MEMMUS.txt,92100,93331,1231,10,N,N,-,-1,-1
MEMMUS.txt,93332,95112,1780,10,Y,Y,1436178232441,94736,96568
MEMMUS.txt,95113,96689,1576,10,Y,Y,1436178232441,94736,96568
MEMMUS.txt,96691,98222,1531,10,Y,Y,1436180874507,96703,97450
MEMMUS.txt,98225,99866,1641,10,Y,N,-,-1,-1
MEMMUS.txt,99867,101487,1620,10,Y,N,-,-1,-1
MEMMUS.txt,101490,103028,1538,10,N,N,-,-1,-1
MEMMUS.txt,103029,104392,1363,10,N,N,-,-1,-1
MEMMUS.txt,104393,105810,1417,10,Y,N,-,-1,-1
MEMMUS.txt,105811,107608,1797,10,Y,N,-,-1,-1
MEMMUS.txt,107611,109542,1931,10,Y,Y,1436181440816,109452,110419
MEMMUS.txt,109543,110505,962,10,N,Y,1436181440816,109452,110419
MEMMUS.txt,110508,111753,1245,10,N,N,-,-1,-1
MEMMUS.txt,111758,113199,1441,10,N,N,-,-1,-1
MEMMUS.txt,113201,114109,908,10,N,N,-,-1,-1
MEMMUS.txt,114112,115548,1436,10,N,N,-,-1,-1
MEMMUS.txt,115553,117931,2378,10,Y,Y,1436182498768,117674,118815
MEMMUS.txt,117934,119393,1459,10,Y,Y,1436182498768,117674,118815
MEMMUS.txt,119394,120898,1504,10,Y,Y,1436182942743,119767,120353
MEMMUS.txt,120899,122541,1642,10,Y,Y,1436183373358,121001,122265
MEMMUS.txt,122542,124002,1460,10,Y,N,-,-1,-1
MEMMUS.txt,124003,125277,1274,10,Y,N,-,-1,-1
MEMMUS.txt,125278,126466,1188,10,N,N,-,-1,-1
MEMMUS.txt,126467,127677,1210,10,Y,N,-,-1,-1
MEMMUS.txt,127679,129478,1799,10,Y,N,-,-1,-1
MEMMUS.txt,129481,131397,1916,10,Y,N,-,-1,-1
MEMMUS.txt,131400,132603,1203,10,N,N,-,-1,-1
MEMMUS.txt,132604,134403,1799,10,Y,Y,1436192343938,134271,135042
MEMMUS.txt,134405,135800,1395,10,Y,Y,1436192343938,134271,135042
MEMMUS.txt,135801,137367,1566,10,Y,Y,1436193426140,136824,137579
MEMMUS.txt,137368,139287,1919,10,Y,Y,1436193426140,136824,137579
MEMMUS.txt,139288,140634,1346,10,Y,N,-,-1,-1
MEMMUS.txt,140635,142677,2042,10,Y,N,-,-1,-1
MEMMUS.txt,142678,144326,1648,10,Y,N,-,-1,-1
MEMMUS.txt,144329,145587,1258,10,Y,N,-,-1,-1
MEMMUS.txt,145588,146914,1326,10,N,N,-,-1,-1
MEMMUS.txt,146917,148110,1193,10,N,N,-,-1,-1
MEMMUS.txt,148112,149702,1590,10,Y,N,-,-1,-1
MEMMUS.txt,149703,151313,1610,10,Y,N,-,-1,-1
MEMMUS.txt,151314,152650,1336,10,N,N,-,-1,-1
MEMMUS.txt,152651,153928,1277,10,Y,N,-,-1,-1
MEMMUS.txt,153929,155191,1262,10,Y,Y,1436194630719,153960,154457
MEMMUS.txt,155192,156855,1663,10,Y,N,-,-1,-1
MEMMUS.txt,156856,158297,1441,10,N,N,-,-1,-1
MEMMUS.txt,158300,159937,1637,10,Y,N,-,-1,-1
MEMMUS.txt,159938,161779,1841,10,Y,N,-,-1,-1
MEMMUS.txt,161780,163431,1651,10,Y,N,-,-1,-1
MEMMUS.txt,163432,165191,1759,10,N,N,-,-1,-1
MEMMUS.txt,165192,166676,1484,10,N,Y,1436195369775,166223,166802
MEMMUS.txt,166677,168451,1774,10,N,Y,1436195369775,166223,166802
MEMMUS.txt,168452,169684,1232,10,Y,Y,1436195820165,167327,168540
MEMMUS.txt,169685,171421,1736,10,Y,N,-,-1,-1
MEMMUS.txt,171422,173111,1689,10,Y,N,-,-1,-1
MEMMUS.txt,173112,174681,1569,10,Y,N,-,-1,-1
MEMMUS.txt,174682,176473,1791,10,Y,N,-,-1,-1
MEMMUS.txt,176474,178122,1648,10,Y,N,-,-1,-1
MEMMUS.txt,178123,180884,2761,10,N,N,-,-1,-1
MEMMUS.txt,180885,182550,1665,10,Y,Y,1436200836078,181418,182145
MEMMUS.txt,182551,183911,1360,10,N,Y,1436201256737,183322,184063
MEMMUS.txt,183912,184977,1065,10,N,Y,1436201256737,183322,184063
MEMMUS.txt,184978,186171,1193,10,N,Y,1436201856954,185075,185632
MEMMUS.txt,186172,187533,1361,10,Y,Y,1436202482351,186272,186982
MEMMUS.txt,187536,188827,1291,10,Y,N,-,-1,-1
MEMMUS.txt,188828,190241,1413,10,N,N,-,-1,-1
MEMMUS.txt,190243,191183,940,10,N,Y,1436250750453,190583,190982
MEMMUS.txt,191184,192427,1243,10,Y,Y,1436250955725,191454,191936
MEMMUS.txt,192430,194007,1577,10,Y,Y,1436251795765,192428,192905
MEMMUS.txt,194008,195486,1478,10,Y,Y,1436258886793,195179,195770
MEMMUS.txt,195489,197102,1613,10,Y,Y,1436258886793,195179,195770
MEMMUS.txt,197103,198664,1561,10,N,Y,1436260072528,196557,197950
MEMMUS.txt,198667,200220,1553,10,N,Y,1436260597356,198665,199131
MEMMUS.txt,200221,201678,1457,10,Y,Y,1436261428542,200089,200824
MEMMUS.txt,201679,203182,1503,10,Y,Y,1436262032838,201561,202518
MEMMUS.txt,203183,204677,1494,10,Y,Y,1436262651824,202630,204072
MEMMUS.txt,204678,206031,1353,10,N,Y,1436263043874,205904,206889
MEMMUS.txt,206032,207160,1128,10,Y,Y,1436263043874,205904,206889
MEMMUS.txt,207161,207429,268,10,N,Y,1436263335878,206962,209396
MEMMUS.txt,207430,207955,525,10,N,Y,1436263335878,206962,209396
MEMMUS.txt,207957,208227,270,10,N,Y,1436263335878,206962,209396
MEMMUS.txt,208228,208427,199,10,N,Y,1436263335878,206962,209396
MEMMUS.txt,208428,208761,333,10,N,Y,1436263335878,206962,209396
MEMMUS.txt,208764,209244,480,10,N,Y,1436263335878,206962,209396
MEMMUS.txt,209247,210854,1607,10,Y,Y,1436263335878,206962,209396
MEMMUS.txt,210855,212025,1170,10,N,N,-,-1,-1
MEMMUS.txt,212027,213808,1781,10,Y,N,-,-1,-1
MEMMUS.txt,213811,215179,1368,10,N,Y,1436264049561,214305,214870
MEMMUS.txt,215179,216618,1439,10,N,N,-,-1,-1
MEMMUS.txt,216619,217807,1188,10,N,N,-,-1,-1
MEMMUS.txt,217812,219451,1639,10,Y,N,-,-1,-1
MEMMUS.txt,219452,220982,1530,10,N,N,-,-1,-1
MEMMUS.txt,220985,222539,1554,10,Y,N,-,-1,-1
MEMMUS.txt,222540,223533,993,10,Y,N,-,-1,-1
MEMMUS.txt,223534,224719,1185,10,N,Y,1436265325522,223973,225467
MEMMUS.txt,224720,225836,1116,10,N,Y,1436265822598,225579,226125
MEMMUS.txt,225839,226916,1077,10,N,Y,1436265822598,225579,226125
MEMMUS.txt,226917,228682,1765,10,N,Y,1436266262307,226191,228765
MEMMUS.txt,228685,230123,1438,10,N,Y,1436266262307,226191,228765
MEMMUS.txt,230124,231370,1246,10,N,N,-,-1,-1
MEMMUS.txt,231371,232987,1616,10,Y,N,-,-1,-1
MEMMUS.txt,232988,234274,1286,10,N,N,-,-1,-1
MEMMUS.txt,234275,235735,1460,10,N,N,-,-1,-1
MEMMUS.txt,235738,237666,1928,10,N,N,-,-1,-1
MEMMUS.txt,237667,239978,2311,10,N,N,-,-1,-1
MEMMUS.txt,239979,241430,1451,10,Y,Y,1436280456835,240521,241413
MEMMUS.txt,241432,242868,1436,10,N,N,-,-1,-1
MEMMUS.txt,242870,244249,1379,10,Y,Y,1436281042239,244109,244443
MEMMUS.txt,244250,245864,1614,10,Y,Y,1436281325939,245388,246385
MEMMUS.txt,245865,247133,1268,10,N,Y,1436281325939,245388,246385
MEMMUS.txt,247134,249120,1986,10,Y,Y,1436281535809,247698,249142
MEMMUS.txt,249123,250547,1424,10,Y,Y,1436281897258,250318,251929
MEMMUS.txt,250548,252075,1527,10,Y,Y,1436281897258,250318,251929
MEMMUS.txt,252076,253833,1757,10,N,Y,1436282192995,253074,254294
MEMMUS.txt,253834,254819,985,10,N,Y,1436282192995,253074,254294
MEMMUS.txt,254820,256116,1296,10,Y,N,-,-1,-1
MEMMUS.txt,256117,257654,1537,10,Y,N,-,-1,-1
MEMMUS.txt,257655,259594,1939,10,Y,Y,1436282832945,258754,259560
MEMMUS.txt,259595,260839,1244,10,N,Y,1436283306101,260256,261072
MEMMUS.txt,260842,262130,1288,10,Y,Y,1436283306101,260256,261072
MEMMUS.txt,262131,263598,1467,10,Y,Y,1436284721620,262676,264766
MEMMUS.txt,263601,265065,1464,10,N,Y,1436284721620,262676,264766
MEMMUS.txt,265066,266740,1674,10,N,Y,1436423346848,266385,267054
MEMMUS.txt,266741,268080,1339,10,Y,Y,1436423346848,266385,267054
MEMMUS.txt,268081,269679,1598,10,N,N,-,-1,-1
MEMMUS.txt,269680,270853,1173,10,N,N,-,-1,-1
MEMMUS.txt,270856,272386,1530,10,Y,N,-,-1,-1
MEMMUS.txt,272387,273864,1477,10,N,N,-,-1,-1
MEMMUS.txt,273865,275097,1232,10,N,N,-,-1,-1
MEMMUS.txt,275099,276789,1690,10,Y,Y,1436423891936,276321,278167
MEMMUS.txt,276790,278240,1450,10,N,Y,1436423891936,276321,278167
MEMMUS.txt,278243,279509,1266,10,N,N,-,-1,-1
MEMMUS.txt,279510,281000,1490,10,N,N,-,-1,-1
MEMMUS.txt,281001,282414,1413,10,Y,Y,1436424974663,281505,282511
MEMMUS.txt,282415,284387,1972,10,Y,Y,1436424974663,281505,282511
MEMMUS.txt,284388,286136,1748,10,Y,N,-,-1,-1
MEMMUS.txt,286137,288093,1956,10,Y,N,-,-1,-1
MEMMUS.txt,288094,289486,1392,10,N,N,-,-1,-1
MEMMUS.txt,289488,290837,1349,10,N,N,-,-1,-1
MEMMUS.txt,290838,292355,1517,10,N,N,-,-1,-1
MEMMUS.txt,292358,293713,1355,10,N,N,-,-1,-1
MEMMUS.txt,293716,295172,1456,10,N,N,-,-1,-1
MEMMUS.txt,295173,296215,1042,10,N,N,-,-1,-1
MEMMUS.txt,296218,297225,1007,10,N,N,-,-1,-1
MEMMUS.txt,297228,298181,953,10,N,N,-,-1,-1
MEMMUS.txt,298182,299488,1306,10,Y,N,-,-1,-1
MEMMUS.txt,299489,301058,1569,10,N,N,-,-1,-1
MEMMUS.txt,301059,302069,1010,10,N,N,-,-1,-1
MEMMUS.txt,302070,303095,1025,10,N,N,-,-1,-1
MEMMUS.txt,303096,304265,1169,10,N,Y,1436432727712,303953,304575
MEMMUS.txt,304266,304987,721,10,N,Y,1436432727712,303953,304575
MEMMUS.txt,304989,306192,1203,10,N,Y,1436433150618,304772,305829
MEMMUS.txt,306193,307932,1739,10,N,N,-,-1,-1
MEMMUS.txt,307933,309375,1442,10,N,N,-,-1,-1
MEMMUS.txt,309376,310926,1550,10,N,N,-,-1,-1
MEMMUS.txt,310927,312703,1776,10,Y,N,-,-1,-1
MEMMUS.txt,312704,314644,1940,10,N,N,-,-1,-1
MEMMUS.txt,314647,316189,1542,10,N,N,-,-1,-1
MEMMUS.txt,316190,318009,1819,10,N,N,-,-1,-1
MEMMUS.txt,318010,319544,1534,10,N,N,-,-1,-1
MEMMUS.txt,319545,320913,1368,10,N,N,-,-1,-1
MEMMUS.txt,320914,322206,1292,10,N,N,-,-1,-1
MEMMUS.txt,322207,323830,1623,10,N,N,-,-1,-1
MEMMUS.txt,323831,325661,1830,10,N,N,-,-1,-1
MEMMUS.txt,325663,327369,1706,10,Y,N,-,-1,-1
MEMMUS.txt,327370,329204,1834,10,N,N,-,-1,-1
MEMMUS.txt,329205,330443,1238,10,Y,N,-,-1,-1
MEMMUS.txt,330446,332347,1901,10,Y,Y,1436434376182,331404,332945
MEMMUS.txt,332349,333551,1202,10,N,Y,1436434376182,331404,332945
MEMMUS.txt,333554,334699,1145,10,N,Y,1436434595667,333552,333949
MEMMUS.txt,334700,335772,1072,10,N,N,-,-1,-1
MEMMUS.txt,335773,337767,1994,10,Y,Y,1436435221703,336880,337454
MEMMUS.txt,337768,339162,1394,10,N,N,-,-1,-1
MEMMUS.txt,339163,339998,835,10,N,N,-,-1,-1
MEMMUS.txt,339999,341102,1103,10,N,Y,1436435912176,340974,341737
MEMMUS.txt,341103,342811,1708,10,N,Y,1436435912176,340974,341737
MEMMUS.txt,342814,344623,1809,10,N,N,-,-1,-1
MEMMUS.txt,344624,346314,1690,10,Y,Y,1436436770716,345847,347230
MEMMUS.txt,346315,347192,877,10,N,Y,1436436770716,345847,347230
MEMMUS.txt,347193,348412,1219,10,Y,Y,1436436770716,345847,347230
MEMMUS.txt,348413,349632,1219,10,N,N,-,-1,-1
MEMMUS.txt,349633,350903,1270,10,N,N,-,-1,-1
MEMMUS.txt,350904,352071,1167,10,N,N,-,-1,-1
MEMMUS.txt,352072,353643,1571,10,N,N,-,-1,-1
MEMMUS.txt,353644,355470,1826,10,N,N,-,-1,-1
MEMMUS.txt,355471,356963,1492,10,Y,N,-,-1,-1
MEMMUS.txt,356964,358632,1668,10,Y,N,-,-1,-1
MEMMUS.txt,358633,359847,1214,10,Y,N,-,-1,-1
MEMMUS.txt,359850,361450,1600,10,Y,Y,1436438224836,360102,360820
MEMMUS.txt,361451,362972,1521,10,Y,Y,1436438560540,362307,362847
MEMMUS.txt,362973,364258,1285,10,N,N,-,-1,-1
MEMMUS.txt,364260,365663,1403,10,N,N,-,-1,-1
MEMMUS.txt,365664,366603,939,10,N,N,-,-1,-1
MEMMUS.txt,366604,367829,1225,10,N,Y,1436438967800,366801,367625
MEMMUS.txt,367830,369349,1519,10,N,N,-,-1,-1
MEMMUS.txt,369350,370777,1427,10,Y,N,-,-1,-1
MEMMUS.txt,370779,371750,971,10,N,N,-,-1,-1
MEMMUS.txt,371751,373110,1359,10,N,N,-,-1,-1
MEMMUS.txt,373111,374251,1140,10,N,N,-,-1,-1
MEMMUS.txt,374253,375577,1324,10,N,N,-,-1,-1
MEMMUS.txt,375578,376688,1110,10,N,Y,1436444993373,376611,377536
MEMMUS.txt,376689,378247,1558,10,Y,Y,1436445421219,377558,378460
MEMMUS.txt,378248,379766,1518,10,N,Y,1436445421219,377558,378460
MEMMUS.txt,379769,381467,1698,10,Y,N,-,-1,-1
MEMMUS.txt,381470,382806,1336,10,N,N,-,-1,-1
MEMMUS.txt,382809,384519,1710,10,N,N,-,-1,-1
MEMMUS.txt,384520,385872,1352,10,N,N,-,-1,-1
MEMMUS.txt,385874,387850,1976,10,N,N,-,-1,-1
MEMMUS.txt,387851,389342,1491,10,N,N,-,-1,-1
MEMMUS.txt,389343,390850,1507,10,N,N,-,-1,-1
MEMMUS.txt,390851,392252,1401,10,N,N,-,-1,-1
MEMMUS.txt,392253,394190,1937,10,Y,N,-,-1,-1
MEMMUS.txt,394191,395529,1338,10,Y,N,-,-1,-1
MEMMUS.txt,395530,397296,1766,10,Y,N,-,-1,-1
MEMMUS.txt,397297,398560,1263,10,N,N,-,-1,-1
MEMMUS.txt,398561,400224,1663,10,N,N,-,-1,-1
MEMMUS.txt,400226,402133,1907,10,N,N,-,-1,-1
MEMMUS.txt,402134,402982,848,10,N,N,-,-1,-1
MEMMUS.txt,402983,403132,149,10,N,N,-,-1,-1
MEMMUS.txt,403135,404959,1824,10,N,N,-,-1,-1
MEMMUS.txt,404961,406973,2012,10,N,N,-,-1,-1
MEMMUS.txt,406974,408646,1672,10,N,Y,1436457314337,407582,409801
MEMMUS.txt,408649,410031,1382,10,Y,Y,1436457314337,407582,409801
MEMMUS.txt,410034,411387,1353,10,N,N,-,-1,-1
MEMMUS.txt,411388,413707,2319,10,N,N,-,-1,-1
MEMMUS.txt,413710,415599,1889,10,N,N,-,-1,-1
MEMMUS.txt,415600,417239,1639,10,Y,N,-,-1,-1
MEMMUS.txt,417242,418573,1331,10,N,N,-,-1,-1
MEMMUS.txt,418574,419654,1080,10,Y,N,-,-1,-1
MEMMUS.txt,419655,420985,1330,10,Y,N,-,-1,-1
MEMMUS.txt,420986,422419,1433,10,N,N,-,-1,-1
MEMMUS.txt,422420,423684,1264,10,N,N,-,-1,-1
MEMMUS.txt,423685,425577,1892,10,N,N,-,-1,-1
MEMMUS.txt,425580,427286,1706,10,N,N,-,-1,-1
MEMMUS.txt,427289,428827,1538,10,N,N,-,-1,-1
MEMMUS.txt,428828,429766,938,10,N,N,-,-1,-1
MEMMUS.txt,429767,432025,2258,10,N,N,-,-1,-1
MEMMUS.txt,432026,433229,1203,10,N,N,-,-1,-1
MEMMUS.txt,433230,434399,1169,10,N,N,-,-1,-1
MEMMUS.txt,434400,435956,1556,10,N,N,-,-1,-1
MEMMUS.txt,435961,438297,2336,10,Y,Y,1436458807940,438002,438706
MEMMUS.txt,438298,439742,1444,10,Y,Y,1436459343773,439368,440020
MEMMUS.txt,439743,441105,1362,10,N,Y,1436459343773,439368,440020
MEMMUS.txt,441107,441921,814,10,N,N,-,-1,-1
MEMMUS.txt,441922,443057,1135,10,N,N,-,-1,-1
MEMMUS.txt,443058,444513,1455,10,Y,Y,1436518466769,443385,444821
MEMMUS.txt,444514,446287,1773,10,N,Y,1436518466769,443385,444821
MEMMUS.txt,446290,447978,1688,10,N,Y,1436519123026,447131,447676
MEMMUS.txt,447979,449338,1359,10,N,Y,1436519578396,448667,449299
MEMMUS.txt,449339,450843,1504,10,N,N,-,-1,-1
MEMMUS.txt,450844,452523,1679,10,N,N,-,-1,-1
MEMMUS.txt,452524,453904,1380,10,N,Y,1436519953118,452615,453356
MEMMUS.txt,453905,455774,1869,10,Y,N,-,-1,-1
MEMMUS.txt,455775,456674,899,10,N,N,-,-1,-1
MEMMUS.txt,456675,457911,1236,10,N,N,-,-1,-1
MEMMUS.txt,457914,459256,1342,10,N,N,-,-1,-1
MEMMUS.txt,459257,461047,1790,10,N,N,-,-1,-1
MEMMUS.txt,461048,462790,1742,10,Y,N,-,-1,-1
MEMMUS.txt,462791,464387,1596,10,Y,N,-,-1,-1
MEMMUS.txt,464388,466432,2044,10,Y,N,-,-1,-1
MEMMUS.txt,466435,467738,1303,10,N,N,-,-1,-1
MEMMUS.txt,467739,469530,1791,10,N,Y,1436521270492,469143,469869
MEMMUS.txt,469531,471298,1767,10,N,Y,1436521270492,469143,469869
MEMMUS.txt,471300,472865,1565,10,N,Y,1436522398418,471475,474672
MEMMUS.txt,472866,474535,1669,10,N,Y,1436522398418,471475,474672
MEMMUS.txt,474538,476599,2061,10,Y,Y,1436522398418,471475,474672
MEMMUS.txt,476602,477753,1151,10,N,N,-,-1,-1
MEMMUS.txt,477754,479240,1486,10,N,N,-,-1,-1
MEMMUS.txt,479241,480087,846,10,N,N,-,-1,-1
MEMMUS.txt,480090,480224,134,10,N,N,-,-1,-1
MEMMUS.txt,480225,480389,164,10,N,N,-,-1,-1
MEMMUS.txt,480390,480540,150,10,N,N,-,-1,-1
MEMMUS.txt,480543,480831,288,10,N,N,-,-1,-1
MEMMUS.txt,480834,481064,230,10,N,N,-,-1,-1
MEMMUS.txt,481067,488061,6994,10,N,N,-,-1,-1
MULIFE.txt,0,799,799,10,N,N,-,-1,-1
MULIFE.txt,804,1604,800,10,N,N,-,-1,-1
MULIFE.txt,1605,1839,234,10,N,N,-,-1,-1
MULIFE.txt,1840,2049,209,10,N,N,-,-1,-1
MULIFE.txt,2050,2224,174,10,N,N,-,-1,-1
MULIFE.txt,2225,2487,262,10,N,N,-,-1,-1
MULIFE.txt,2488,2732,244,10,N,N,-,-1,-1
MULIFE.txt,2733,2923,190,10,N,N,-,-1,-1
MULIFE.txt,2924,3137,213,10,N,N,-,-1,-1
MULIFE.txt,3142,3302,160,10,N,N,-,-1,-1
MULIFE.txt,3302,3525,223,10,N,N,-,-1,-1
MULIFE.txt,3526,3681,155,10,N,N,-,-1,-1
MULIFE.txt,3684,3901,217,10,N,N,-,-1,-1
MULIFE.txt,3902,4205,303,10,N,N,-,-1,-1
MULIFE.txt,4206,4461,255,10,N,N,-,-1,-1
MULIFE.txt,4464,4734,270,10,N,N,-,-1,-1
MULIFE.txt,4735,5014,279,10,N,N,-,-1,-1
MULIFE.txt,5015,5352,337,10,N,N,-,-1,-1
MULIFE.txt,5353,5582,229,10,N,N,-,-1,-1
MULIFE.txt,5583,5756,173,10,N,N,-,-1,-1
MULIFE.txt,5757,6007,250,10,N,N,-,-1,-1
MULIFE.txt,6008,6308,300,10,N,N,-,-1,-1
MULIFE.txt,6309,6639,330,10,N,N,-,-1,-1
MULIFE.txt,6640,6910,270,10,N,N,-,-1,-1
MULIFE.txt,6911,7131,220,10,N,N,-,-1,-1
MULIFE.txt,7132,7420,288,10,N,N,-,-1,-1
MULIFE.txt,7421,7690,269,10,N,N,-,-1,-1
MULIFE.txt,7691,8004,313,10,N,N,-,-1,-1
MULIFE.txt,8005,8156,151,10,N,N,-,-1,-1
MULIFE.txt,8157,8361,204,10,N,N,-,-1,-1
MULIFE.txt,8362,8658,296,10,N,N,-,-1,-1
MULIFE.txt,8659,8920,261,10,N,N,-,-1,-1
MULIFE.txt,8921,9235,314,10,N,N,-,-1,-1
MULIFE.txt,9236,9628,392,10,N,N,-,-1,-1
MULIFE.txt,9629,9999,370,10,N,N,-,-1,-1
MULIFE.txt,10000,10370,370,10,N,N,-,-1,-1
MULIFE.txt,10371,10595,224,10,N,N,-,-1,-1
MULIFE.txt,10596,10821,225,10,N,N,-,-1,-1
MULIFE.txt,10824,10996,172,10,N,N,-,-1,-1
MULIFE.txt,10997,11131,134,10,N,N,-,-1,-1
MULIFE.txt,11132,11427,295,10,N,N,-,-1,-1
MULIFE.txt,11428,11713,285,10,N,N,-,-1,-1
MULIFE.txt,11714,11945,231,10,N,N,-,-1,-1
MULIFE.txt,11946,12167,221,10,N,N,-,-1,-1
MULIFE.txt,12168,12431,263,10,N,N,-,-1,-1
MULIFE.txt,12434,12580,146,10,N,N,-,-1,-1
MULIFE.txt,12581,12899,318,10,N,N,-,-1,-1
MULIFE.txt,12900,13228,328,10,N,N,-,-1,-1
MULIFE.txt,13229,13555,326,10,N,N,-,-1,-1
MULIFE.txt,13556,13873,317,10,N,N,-,-1,-1
MULIFE.txt,13876,14115,239,10,N,N,-,-1,-1
MULIFE.txt,14116,14421,305,10,N,N,-,-1,-1
MULIFE.txt,14422,14711,289,10,N,N,-,-1,-1
MULIFE.txt,14712,14967,255,10,N,N,-,-1,-1
MULIFE.txt,14968,15183,215,10,N,N,-,-1,-1
MULIFE.txt,15184,15501,317,10,N,N,-,-1,-1
MULIFE.txt,15502,15757,255,10,N,N,-,-1,-1
MULIFE.txt,15758,16035,277,10,N,N,-,-1,-1
MULIFE.txt,16036,16286,250,10,N,N,-,-1,-1
MULIFE.txt,16287,16515,228,10,N,N,-,-1,-1
MULIFE.txt,16516,16763,247,10,N,N,-,-1,-1
MULIFE.txt,16764,17075,311,10,N,N,-,-1,-1
MULIFE.txt,17076,17335,259,10,N,N,-,-1,-1
MULIFE.txt,17336,17557,221,10,N,N,-,-1,-1
MULIFE.txt,17558,17817,259,10,N,N,-,-1,-1
MULIFE.txt,17818,18050,232,10,N,N,-,-1,-1
MULIFE.txt,18051,18347,296,10,N,N,-,-1,-1
MULIFE.txt,18348,18616,268,10,N,N,-,-1,-1
MULIFE.txt,18617,18833,216,10,N,N,-,-1,-1
MULIFE.txt,18834,19050,216,10,N,N,-,-1,-1
MULIFE.txt,19051,19313,262,10,N,N,-,-1,-1
MULIFE.txt,19314,19540,226,10,N,N,-,-1,-1
MULIFE.txt,19541,19771,230,10,N,N,-,-1,-1
MULIFE.txt,19772,19982,210,10,N,N,-,-1,-1
MULIFE.txt,19985,20246,261,10,N,N,-,-1,-1
MULIFE.txt,20247,20422,175,10,N,N,-,-1,-1
MULIFE.txt,20423,20754,331,10,N,N,-,-1,-1
MULIFE.txt,20755,21134,379,10,N,N,-,-1,-1
MULIFE.txt,21135,21397,262,10,N,N,-,-1,-1
MULIFE.txt,21398,21657,259,10,N,N,-,-1,-1
MULIFE.txt,21658,21977,319,10,N,N,-,-1,-1
MULIFE.txt,21978,22744,766,10,N,N,-,-1,-1
MULIFE.txt,22745,23639,894,10,N,N,-,-1,-1
MULIFE.txt,23642,24620,978,10,N,N,-,-1,-1
MULIFE.txt,24623,25421,798,10,N,N,-,-1,-1
MULIFE.txt,25421,26589,1168,10,N,N,-,-1,-1
MULIFE.txt,26590,27682,1092,10,N,N,-,-1,-1
MULIFE.txt,27683,28518,835,10,N,N,-,-1,-1
MULIFE.txt,28519,29755,1236,10,Y,N,-,-1,-1
MULIFE.txt,29756,31623,1867,10,N,N,-,-1,-1
MULIFE.txt,31624,32737,1113,10,N,N,-,-1,-1
MULIFE.txt,32738,34062,1324,10,N,Y,1437637327937,33188,35197
MULIFE.txt,34063,35255,1192,10,N,Y,1437637327937,33188,35197
MULIFE.txt,35256,36468,1212,10,N,Y,1437642866570,35507,37282
MULIFE.txt,36469,37417,948,10,N,Y,1437642866570,35507,37282
MULIFE.txt,37418,38748,1330,10,Y,N,-,-1,-1
MULIFE.txt,38749,39817,1068,10,N,Y,1437643218811,39345,39813
MULIFE.txt,39819,40538,719,10,N,Y,1437643552468,40385,41243
MULIFE.txt,40539,41316,777,10,N,Y,1437643552468,40385,41243
MULIFE.txt,41317,42598,1281,10,Y,N,-,-1,-1
MULIFE.txt,42601,43967,1366,10,N,N,-,-1,-1
MULIFE.txt,43968,45078,1110,10,N,N,-,-1,-1
MULIFE.txt,45079,46317,1238,10,N,N,-,-1,-1
MULIFE.txt,46319,47348,1029,10,N,N,-,-1,-1
MULIFE.txt,47349,48292,943,10,N,N,-,-1,-1
MULIFE.txt,48293,49487,1194,10,Y,N,-,-1,-1
MULIFE.txt,49488,50622,1134,10,N,Y,1437644129613,50016,51209
MULIFE.txt,50624,51592,968,10,Y,Y,1437644129613,50016,51209
MULIFE.txt,51593,52533,940,10,N,N,-,-1,-1
MULIFE.txt,52534,53632,1098,10,N,N,-,-1,-1
MULIFE.txt,53633,54845,1212,10,N,Y,1437644802503,53881,55535
MULIFE.txt,54846,55924,1078,10,Y,Y,1437670019221,55738,57876
MULIFE.txt,55925,56946,1021,10,N,Y,1437670019221,55738,57876
MULIFE.txt,56948,58401,1453,10,Y,Y,1437670019221,55738,57876
MULIFE.txt,58402,59324,922,10,N,Y,1437670482083,58835,59579
MULIFE.txt,59325,60585,1260,10,N,Y,1437670482083,58835,59579
MULIFE.txt,60586,61192,606,10,N,N,-,-1,-1
MULIFE.txt,61193,62743,1550,10,N,N,-,-1,-1
MULIFE.txt,62746,63571,825,10,N,N,-,-1,-1
MULIFE.txt,63572,64767,1195,10,Y,Y,1437671026479,63906,64392
MULIFE.txt,64770,65852,1082,10,N,N,-,-1,-1
MULIFE.txt,65855,67852,1997,10,Y,N,-,-1,-1
MULIFE.txt,67855,68552,697,10,N,N,-,-1,-1
MULIFE.txt,68557,68995,438,10,N,N,-,-1,-1
MULIFE.txt,68996,69742,746,10,N,N,-,-1,-1
MULIFE.txt,69743,70970,1227,10,N,N,-,-1,-1
MULIFE.txt,70973,71991,1018,10,N,N,-,-1,-1
MULIFE.txt,71992,73006,1014,10,N,N,-,-1,-1
MULIFE.txt,73007,73645,638,10,N,N,-,-1,-1
MULIFE.txt,73647,74878,1231,10,N,Y,1437671604320,74249,75453
MULIFE.txt,74879,76371,1492,10,N,Y,1437672056241,76209,76827
MULIFE.txt,76374,77666,1292,10,Y,Y,1437672056241,76209,76827
MULIFE.txt,77667,78386,719,10,N,N,-,-1,-1
MULIFE.txt,78387,79976,1589,10,N,N,-,-1,-1
MULIFE.txt,79979,80727,748,10,N,N,-,-1,-1
MULIFE.txt,80728,81849,1121,10,N,N,-,-1,-1
MULIFE.txt,81850,83171,1321,10,N,Y,1437672626512,82770,83334
MULIFE.txt,83172,84168,996,10,Y,Y,1437672626512,82770,83334
MULIFE.txt,84169,85247,1078,10,N,N,-,-1,-1
MULIFE.txt,85248,86472,1224,10,N,N,-,-1,-1
MULIFE.txt,86473,87413,940,10,Y,N,-,-1,-1
MULIFE.txt,87414,88792,1378,10,N,N,-,-1,-1
MULIFE.txt,88793,89577,784,10,N,N,-,-1,-1
MULIFE.txt,89578,90438,860,10,N,N,-,-1,-1
MULIFE.txt,90439,91715,1276,10,N,N,-,-1,-1
MULIFE.txt,91716,93044,1328,10,N,N,-,-1,-1
MULIFE.txt,93045,94202,1157,10,N,N,-,-1,-1
MULIFE.txt,94203,95707,1504,10,N,N,-,-1,-1
MULIFE.txt,95710,96707,997,10,N,N,-,-1,-1
MULIFE.txt,96708,97957,1249,10,N,N,-,-1,-1
MULIFE.txt,97958,98664,706,10,N,N,-,-1,-1
MULIFE.txt,98665,99776,1111,10,N,N,-,-1,-1
MULIFE.txt,99777,100805,1028,10,N,N,-,-1,-1
MULIFE.txt,100806,101316,510,10,N,N,-,-1,-1
MULIFE.txt,101319,102127,808,10,N,N,-,-1,-1
MULIFE.txt,102128,102963,835,10,N,N,-,-1,-1
MULIFE.txt,102966,104107,1141,10,N,N,-,-1,-1
MULIFE.txt,104108,104840,732,10,N,N,-,-1,-1
MULIFE.txt,104843,105398,555,10,N,N,-,-1,-1
MULIFE.txt,105401,106108,707,10,N,N,-,-1,-1
MULIFE.txt,106109,107055,946,10,N,N,-,-1,-1
MULIFE.txt,107056,108191,1135,10,N,N,-,-1,-1
MULIFE.txt,108194,109018,824,10,N,N,-,-1,-1
MULIFE.txt,109020,110241,1221,10,N,N,-,-1,-1
MULIFE.txt,110242,111659,1417,10,N,N,-,-1,-1
MULIFE.txt,111662,112262,600,10,N,N,-,-1,-1
MULIFE.txt,112263,112864,601,10,N,N,-,-1,-1
MULIFE.txt,112866,113847,981,10,N,N,-,-1,-1
MULIFE.txt,113849,115033,1184,10,N,Y,1437727565787,114231,114741
MULIFE.txt,115035,116213,1178,10,N,Y,1437728842716,115343,116376
MULIFE.txt,116214,117160,946,10,N,Y,1437728842716,115343,116376
MULIFE.txt,117161,118659,1498,10,N,Y,1437729348025,117608,118272
MULIFE.txt,118660,119489,829,10,Y,N,-,-1,-1
MULIFE.txt,119490,120397,907,10,N,N,-,-1,-1
MULIFE.txt,120398,121460,1062,10,N,N,-,-1,-1
MULIFE.txt,121463,122418,955,10,N,N,-,-1,-1
MULIFE.txt,122419,123120,701,10,N,N,-,-1,-1
MULIFE.txt,123121,123500,379,10,N,N,-,-1,-1
MULIFE.txt,123501,124693,1192,10,N,N,-,-1,-1
MULIFE.txt,124694,126111,1417,10,N,N,-,-1,-1
MULIFE.txt,126112,127286,1174,10,N,N,-,-1,-1
MULIFE.txt,127289,128768,1479,10,N,Y,1437729941282,127304,128704
MULIFE.txt,128771,129913,1142,10,N,Y,1437730322242,128854,129770
MULIFE.txt,129915,130805,890,10,N,N,-,-1,-1
MULIFE.txt,130806,131279,473,10,N,N,-,-1,-1
MULIFE.txt,131281,132305,1024,10,N,N,-,-1,-1
MULIFE.txt,132306,133259,953,10,N,N,-,-1,-1
MULIFE.txt,133260,133958,698,10,N,N,-,-1,-1
MULIFE.txt,133959,135036,1077,10,N,N,-,-1,-1
MULIFE.txt,135037,136595,1558,10,N,N,-,-1,-1
MULIFE.txt,136596,137243,647,10,N,Y,1437731100795,137101,140058
MULIFE.txt,137244,138884,1640,10,N,Y,1437731100795,137101,140058
MULIFE.txt,138885,140441,1556,10,Y,Y,1437731100795,137101,140058
MULIFE.txt,140442,141942,1500,10,N,Y,1437731620872,140380,141808
MULIFE.txt,141943,142589,646,10,N,Y,1437732462096,142028,144946
MULIFE.txt,142590,143481,891,10,N,Y,1437732462096,142028,144946
MULIFE.txt,143483,144571,1088,10,N,Y,1437732462096,142028,144946
MULIFE.txt,144572,146085,1513,10,N,Y,1437732462096,142028,144946
MULIFE.txt,146086,147259,1173,10,Y,N,-,-1,-1
MULIFE.txt,147260,148412,1152,10,N,N,-,-1,-1
MULIFE.txt,148413,149541,1128,10,N,N,-,-1,-1
MULIFE.txt,149543,151142,1599,10,N,N,-,-1,-1
MULIFE.txt,151145,152489,1344,10,N,N,-,-1,-1
MULIFE.txt,152490,153387,897,10,N,N,-,-1,-1
MULIFE.txt,153388,154287,899,10,N,N,-,-1,-1
MULIFE.txt,154288,155155,867,10,N,N,-,-1,-1
MULIFE.txt,155156,155638,482,10,N,N,-,-1,-1
MULIFE.txt,155639,156515,876,10,N,N,-,-1,-1
MULIFE.txt,156516,157123,607,10,N,N,-,-1,-1
MULIFE.txt,157124,158647,1523,10,N,N,-,-1,-1
MULIFE.txt,158649,159896,1247,10,Y,N,-,-1,-1
MULIFE.txt,159897,161114,1217,10,N,N,-,-1,-1
MULIFE.txt,161116,162457,1341,10,N,N,-,-1,-1
MULIFE.txt,162460,163232,772,10,N,N,-,-1,-1
MULIFE.txt,163233,164129,896,10,N,N,-,-1,-1
MULIFE.txt,164130,165539,1409,10,N,N,-,-1,-1
MULIFE.txt,165540,166700,1160,10,N,N,-,-1,-1
MULIFE.txt,166701,168048,1347,10,N,N,-,-1,-1
MULIFE.txt,168051,169046,995,10,N,N,-,-1,-1
MULIFE.txt,169047,171319,2272,10,N,Y,1437736266658,170580,171597
MULIFE.txt,171320,172392,1072,10,N,Y,1437736266658,170580,171597
MULIFE.txt,172395,173359,964,10,N,N,-,-1,-1
MULIFE.txt,173360,175029,1669,10,N,N,-,-1,-1
MULIFE.txt,175031,176794,1763,10,N,N,-,-1,-1
MULIFE.txt,176797,177849,1052,10,N,N,-,-1,-1
MULIFE.txt,177850,178384,534,10,N,N,-,-1,-1
MULIFE.txt,178385,179520,1135,10,N,N,-,-1,-1
MULIFE.txt,179521,180401,880,10,N,N,-,-1,-1
MULIFE.txt,180404,181842,1438,10,N,N,-,-1,-1
MULIFE.txt,181844,182928,1084,10,N,N,-,-1,-1
MULIFE.txt,182930,183394,464,10,N,N,-,-1,-1
MULIFE.txt,183395,184547,1152,10,N,N,-,-1,-1
MULIFE.txt,184548,185526,978,10,N,N,-,-1,-1
MULIFE.txt,185527,186923,1396,10,N,N,-,-1,-1
MULIFE.txt,186925,187670,745,10,N,N,-,-1,-1
MULIFE.txt,187671,188777,1106,10,N,Y,1437737385709,188168,190108
MULIFE.txt,188778,189880,1102,10,N,Y,1437737385709,188168,190108
MULIFE.txt,189881,191563,1682,10,N,Y,1437737385709,188168,190108
MULIFE.txt,191566,192504,938,10,N,Y,1437737964896,191891,192160
MULIFE.txt,192505,193358,853,10,N,N,-,-1,-1
MULIFE.txt,193359,194578,1219,10,N,N,-,-1,-1
MULIFE.txt,194579,195969,1390,10,N,N,-,-1,-1
MULIFE.txt,195970,197003,1033,10,N,N,-,-1,-1
MULIFE.txt,197006,197968,962,10,N,N,-,-1,-1
MULIFE.txt,197969,198902,933,10,N,N,-,-1,-1
MULIFE.txt,198903,199912,1009,10,N,N,-,-1,-1
MULIFE.txt,199915,201085,1170,10,N,N,-,-1,-1
MULIFE.txt,201086,202184,1098,10,N,N,-,-1,-1
MULIFE.txt,202185,203213,1028,10,N,N,-,-1,-1
MULIFE.txt,203215,204398,1183,10,N,N,-,-1,-1
MULIFE.txt,204399,206490,2091,10,N,N,-,-1,-1
MULIFE.txt,206491,206950,459,10,N,N,-,-1,-1
MULIFE.txt,206956,208407,1451,10,N,N,-,-1,-1
MULIFE.txt,208410,209674,1264,10,N,N,-,-1,-1
MULIFE.txt,209675,210723,1048,10,N,N,-,-1,-1
MULIFE.txt,210724,211595,871,10,N,N,-,-1,-1
MULIFE.txt,211596,212572,976,10,N,N,-,-1,-1
MULIFE.txt,212573,213569,996,10,N,N,-,-1,-1
MULIFE.txt,213570,214742,1172,10,N,N,-,-1,-1
MULIFE.txt,214743,215597,854,10,N,N,-,-1,-1
MULIFE.txt,215600,216591,991,10,N,N,-,-1,-1
MULIFE.txt,216592,217951,1359,10,N,N,-,-1,-1
MULIFE.txt,217952,219075,1123,10,N,N,-,-1,-1
MULIFE.txt,219078,219680,602,10,N,N,-,-1,-1
MULIFE.txt,219681,220663,982,10,N,N,-,-1,-1
MULIFE.txt,220664,221719,1055,10,N,N,-,-1,-1
MULIFE.txt,221722,223154,1432,10,N,N,-,-1,-1
MULIFE.txt,223155,224831,1676,10,N,N,-,-1,-1
MULIFE.txt,224832,225291,459,10,N,N,-,-1,-1
MULIFE.txt,225292,226456,1164,10,N,N,-,-1,-1
MULIFE.txt,226459,227475,1016,10,N,N,-,-1,-1
MULIFE.txt,227476,228148,672,10,N,N,-,-1,-1
MULIFE.txt,228151,229804,1653,10,N,N,-,-1,-1
MULIFE.txt,229807,231973,2166,10,N,N,-,-1,-1
MULIFE.txt,231974,233724,1750,10,N,N,-,-1,-1
MULIFE.txt,233725,234853,1128,10,N,N,-,-1,-1
MULIFE.txt,234854,236287,1433,10,N,N,-,-1,-1
MULIFE.txt,236288,237416,1128,10,N,N,-,-1,-1
MULIFE.txt,237417,238606,1189,10,N,N,-,-1,-1
MULIFE.txt,238607,239896,1289,10,N,N,-,-1,-1
MULIFE.txt,239899,240857,958,10,N,N,-,-1,-1
MULIFE.txt,240860,241756,896,10,N,N,-,-1,-1
MULIFE.txt,241757,242860,1103,10,N,N,-,-1,-1
MULIFE.txt,242861,244050,1189,10,N,N,-,-1,-1
MULIFE.txt,244051,245170,1119,10,N,N,-,-1,-1
MULIFE.txt,245171,246648,1477,10,N,N,-,-1,-1
MULIFE.txt,246651,248156,1505,10,N,N,-,-1,-1
MULIFE.txt,248157,249428,1271,10,N,N,-,-1,-1
MULIFE.txt,249431,250771,1340,10,N,N,-,-1,-1
MULIFE.txt,250772,252192,1420,10,N,N,-,-1,-1
MULIFE.txt,252193,253752,1559,10,N,N,-,-1,-1
MULIFE.txt,253753,255957,2204,10,N,N,-,-1,-1
MULIFE.txt,255958,257742,1784,10,N,N,-,-1,-1
MULIFE.txt,257743,258978,1235,10,N,N,-,-1,-1
MULIFE.txt,258981,259710,729,10,N,N,-,-1,-1
MULIFE.txt,259711,260620,909,10,N,N,-,-1,-1
MULIFE.txt,260621,261791,1170,10,N,N,-,-1,-1
MULIFE.txt,261792,262827,1035,10,N,N,-,-1,-1
MULIFE.txt,262830,263685,855,10,N,N,-,-1,-1
MULIFE.txt,263686,265110,1424,10,N,N,-,-1,-1
MULIFE.txt,265110,266625,1515,10,N,N,-,-1,-1
MULIFE.txt,266626,268383,1757,10,N,N,-,-1,-1
MULIFE.txt,268384,269801,1417,10,N,N,-,-1,-1
MULIFE.txt,269802,270725,923,10,N,N,-,-1,-1
MULIFE.txt,270726,271839,1113,10,N,N,-,-1,-1
MULIFE.txt,271840,272869,1029,10,N,N,-,-1,-1
MULIFE.txt,272872,273429,557,10,N,N,-,-1,-1
MULIFE.txt,273430,274622,1192,10,N,N,-,-1,-1
MULIFE.txt,274624,275888,1264,10,Y,Y,1437748188744,274892,276661
MULIFE.txt,275889,277432,1543,10,Y,Y,1437748188744,274892,276661
MULIFE.txt,277435,278886,1451,10,N,N,-,-1,-1
MULIFE.txt,278887,280303,1416,10,N,N,-,-1,-1
MULIFE.txt,280304,282217,1913,10,N,N,-,-1,-1
MULIFE.txt,282218,283208,990,10,N,N,-,-1,-1
MULIFE.txt,283209,284414,1205,10,N,N,-,-1,-1
MULIFE.txt,284415,286305,1890,10,Y,N,-,-1,-1
MULIFE.txt,286305,287792,1487,10,N,N,-,-1,-1
MULIFE.txt,287793,288589,796,10,N,N,-,-1,-1
MULIFE.txt,288590,289220,630,10,N,N,-,-1,-1
MULIFE.txt,289221,291047,1826,10,N,N,-,-1,-1
MULIFE.txt,291050,292983,1933,10,N,N,-,-1,-1
MULIFE.txt,292986,294865,1879,10,N,N,-,-1,-1
MULIFE.txt,294867,296389,1522,10,Y,N,-,-1,-1
MULIFE.txt,296390,297621,1231,10,N,N,-,-1,-1
MULIFE.txt,297622,299642,2020,10,N,N,-,-1,-1
MULIFE.txt,299645,300789,1144,10,N,N,-,-1,-1
MULIFE.txt,300790,301633,843,10,N,N,-,-1,-1
MULIFE.txt,301634,302574,940,10,N,N,-,-1,-1
MULIFE.txt,302575,304136,1561,10,N,N,-,-1,-1
MULIFE.txt,304137,305414,1277,10,Y,N,-,-1,-1
MULIFE.txt,305417,306268,851,10,N,N,-,-1,-1
MULIFE.txt,306270,307860,1590,10,N,N,-,-1,-1
MULIFE.txt,307861,308164,303,10,N,N,-,-1,-1
MULIFE.txt,308165,308984,819,10,N,N,-,-1,-1
MULIFE.txt,308985,311250,2265,10,N,N,-,-1,-1
MULIFE.txt,311253,312528,1275,10,N,N,-,-1,-1
MULIFE.txt,312529,314240,1711,10,N,N,-,-1,-1
MULIFE.txt,314241,314514,273,10,N,N,-,-1,-1
MULIFE.txt,314515,315710,1195,10,N,N,-,-1,-1
MULIFE.txt,315711,318728,3017,10,N,N,-,-1,-1
MULIFE.txt,318729,320607,1878,10,N,N,-,-1,-1
MULIFE.txt,320610,322513,1903,10,N,N,-,-1,-1
MULIFE.txt,322514,323844,1330,10,N,N,-,-1,-1
MULIFE.txt,323846,325035,1189,10,N,N,-,-1,-1
MULIFE.txt,325036,326169,1133,10,N,N,-,-1,-1
MULIFE.txt,326172,327624,1452,10,N,N,-,-1,-1
MULIFE.txt,327627,329166,1539,10,N,N,-,-1,-1
MULIFE.txt,329168,330341,1173,10,N,N,-,-1,-1
MULIFE.txt,330342,331814,1472,10,N,N,-,-1,-1
MULIFE.txt,331815,332731,916,10,N,N,-,-1,-1
MULIFE.txt,332736,333708,972,10,N,N,-,-1,-1
MULIFE.txt,333709,334744,1035,10,N,N,-,-1,-1
MULIFE.txt,334749,335647,898,10,N,N,-,-1,-1
MULIFE.txt,335648,336737,1089,10,N,N,-,-1,-1
MULIFE.txt,336739,338235,1496,10,N,N,-,-1,-1
MULIFE.txt,338236,339842,1606,10,N,N,-,-1,-1
MULIFE.txt,339843,340795,952,10,N,N,-,-1,-1
MULIFE.txt,340797,342424,1627,10,N,N,-,-1,-1
MULIFE.txt,342427,343629,1202,10,N,N,-,-1,-1
MULIFE.txt,343630,344813,1183,10,N,N,-,-1,-1
MULIFE.txt,344814,346196,1382,10,N,N,-,-1,-1
MULIFE.txt,346197,347069,872,10,N,N,-,-1,-1
MULIFE.txt,347072,347986,914,10,N,N,-,-1,-1
MULIFE.txt,347989,349905,1916,10,N,N,-,-1,-1
MULIFE.txt,349906,351337,1431,10,N,N,-,-1,-1
MULIFE.txt,351338,352520,1182,10,N,N,-,-1,-1
MULIFE.txt,352522,353784,1262,10,N,N,-,-1,-1
MULIFE.txt,353785,354990,1205,10,N,N,-,-1,-1
MULIFE.txt,354991,356023,1032,10,N,N,-,-1,-1
MULIFE.txt,356026,357346,1320,10,N,N,-,-1,-1
MULIFE.txt,357349,359638,2289,10,Y,N,-,-1,-1
MULIFE.txt,359639,361057,1418,10,N,N,-,-1,-1
MULIFE.txt,361060,362150,1090,10,N,N,-,-1,-1
MULIFE.txt,362153,363616,1463,10,N,N,-,-1,-1
MULIFE.txt,363619,364606,987,10,N,N,-,-1,-1
MULIFE.txt,364607,366113,1506,10,N,N,-,-1,-1
MULIFE.txt,366116,367593,1477,10,N,N,-,-1,-1
MULIFE.txt,367594,368677,1083,10,N,N,-,-1,-1
MULIFE.txt,368678,369415,737,10,N,N,-,-1,-1
MULIFE.txt,369416,370358,942,10,N,N,-,-1,-1
MULIFE.txt,370359,372455,2096,10,Y,N,-,-1,-1
MULIFE.txt,372456,374081,1625,10,N,N,-,-1,-1
MULIFE.txt,374084,375522,1438,10,N,N,-,-1,-1
MULIFE.txt,375525,377008,1483,10,N,N,-,-1,-1
MULIFE.txt,377011,378821,1810,10,N,N,-,-1,-1
MULIFE.txt,378822,379748,926,10,N,N,-,-1,-1
MULIFE.txt,379749,380886,1137,10,N,N,-,-1,-1
MULIFE.txt,380889,381989,1100,10,N,N,-,-1,-1
MULIFE.txt,381990,383512,1522,10,N,N,-,-1,-1
MULIFE.txt,383513,384908,1395,10,N,N,-,-1,-1
MULIFE.txt,384909,385918,1009,10,N,N,-,-1,-1
MULIFE.txt,385920,386946,1026,10,N,N,-,-1,-1
MULIFE.txt,386947,388068,1121,10,N,N,-,-1,-1
MULIFE.txt,388071,389342,1271,10,N,N,-,-1,-1
MULIFE.txt,389344,390438,1094,10,N,N,-,-1,-1
MULIFE.txt,390441,392233,1792,10,N,N,-,-1,-1
MULIFE.txt,392236,393155,919,10,N,N,-,-1,-1
MULIFE.txt,393156,394161,1005,10,N,N,-,-1,-1
MULIFE.txt,394162,394716,554,10,N,N,-,-1,-1
MULIFE.txt,394719,395048,329,10,N,N,-,-1,-1
MULIFE.txt,395049,395272,223,10,N,N,-,-1,-1
MULIFE.txt,395275,395496,221,10,N,N,-,-1,-1
MULIFE.txt,395499,396490,991,10,N,N,-,-1,-1
MULIFE.txt,396491,397922,1431,10,N,N,-,-1,-1
MULIFE.txt,397923,399845,1922,10,N,N,-,-1,-1
MULIFE.txt,399848,400891,1043,10,N,N,-,-1,-1
MULIFE.txt,400892,402829,1937,10,N,N,-,-1,-1
MULIFE.txt,402830,404629,1799,10,N,N,-,-1,-1
MULIFE.txt,404631,405570,939,10,N,N,-,-1,-1
MULIFE.txt,405571,407052,1481,10,Y,N,-,-1,-1
MULIFE.txt,407055,408706,1651,10,Y,N,-,-1,-1
MULIFE.txt,408707,410210,1503,10,N,N,-,-1,-1
MULIFE.txt,410211,411868,1657,10,N,N,-,-1,-1
MULIFE.txt,411869,413886,2017,10,Y,N,-,-1,-1
MULIFE.txt,413888,415156,1268,10,N,N,-,-1,-1
MULIFE.txt,415158,416427,1269,10,N,N,-,-1,-1
MULIFE.txt,416430,417738,1308,10,N,N,-,-1,-1
MULIFE.txt,417740,418726,986,10,N,N,-,-1,-1
MULIFE.txt,418728,420530,1802,10,N,N,-,-1,-1
MULIFE.txt,420531,422685,2154,10,N,N,-,-1,-1
MULIFE.txt,422688,425315,2627,10,N,N,-,-1,-1
MULIFE.txt,425316,426509,1193,10,N,N,-,-1,-1
MULIFE.txt,426510,428788,2278,10,N,N,-,-1,-1
MULIFE.txt,428789,429819,1030,10,N,N,-,-1,-1
MULIFE.txt,429820,431158,1338,10,N,N,-,-1,-1
MULIFE.txt,431159,432532,1373,10,N,N,-,-1,-1
MULIFE.txt,432534,433363,829,10,N,N,-,-1,-1
MULIFE.txt,433364,434478,1114,10,N,N,-,-1,-1
MULIFE.txt,434479,435745,1266,10,N,N,-,-1,-1
MULIFE.txt,435746,437380,1634,10,N,N,-,-1,-1
MULIFE.txt,437383,438630,1247,10,N,N,-,-1,-1
MULIFE.txt,438631,439681,1050,10,N,N,-,-1,-1
MULIFE.txt,439682,441053,1371,10,N,N,-,-1,-1
MULIFE.txt,441054,442213,1159,10,N,N,-,-1,-1
MULIFE.txt,442213,443415,1202,10,N,N,-,-1,-1
MULIFE.txt,443417,444258,841,10,N,N,-,-1,-1
MULIFE.txt,444259,445580,1321,10,N,N,-,-1,-1
MULIFE.txt,445581,446692,1111,10,N,N,-,-1,-1
MULIFE.txt,446694,448045,1351,10,N,N,-,-1,-1
MULIFE.txt,448046,449383,1337,10,Y,N,-,-1,-1
MULIFE.txt,449384,450343,959,10,N,N,-,-1,-1
MULIFE.txt,450346,451543,1197,10,N,N,-,-1,-1
MULIFE.txt,451544,452741,1197,10,N,N,-,-1,-1
MULIFE.txt,452742,454308,1566,10,N,N,-,-1,-1
MULIFE.txt,454309,456463,2154,10,N,N,-,-1,-1
MULIFE.txt,456466,457727,1261,10,N,N,-,-1,-1
MULIFE.txt,457728,458802,1074,10,N,N,-,-1,-1
MULIFE.txt,458803,460247,1444,10,N,N,-,-1,-1
MULIFE.txt,460250,461893,1643,10,Y,N,-,-1,-1
MULIFE.txt,461894,463250,1356,10,N,N,-,-1,-1
MULIFE.txt,463251,464465,1214,10,N,N,-,-1,-1
MULIFE.txt,464466,465936,1470,10,N,N,-,-1,-1
MULIFE.txt,465937,466688,751,10,N,N,-,-1,-1
MULIFE.txt,466689,467450,761,10,N,N,-,-1,-1
MULIFE.txt,467451,468784,1333,10,N,N,-,-1,-1
MULIFE.txt,468785,470006,1221,10,N,N,-,-1,-1
MULIFE.txt,470009,471098,1089,10,N,N,-,-1,-1
MULIFE.txt,471099,472066,967,10,N,N,-,-1,-1
MULIFE.txt,472067,472985,918,10,N,N,-,-1,-1
MULIFE.txt,472986,475331,2345,10,Y,N,-,-1,-1
MULIFE.txt,475334,475961,627,10,N,N,-,-1,-1
MULIFE.txt,475962,476962,1000,10,N,N,-,-1,-1
MULIFE.txt,476963,477563,600,10,N,N,-,-1,-1
MULIFE.txt,477566,478107,541,10,N,N,-,-1,-1
MULIFE.txt,478108,479228,1120,10,N,N,-,-1,-1
MULIFE.txt,479229,479889,660,10,N,N,-,-1,-1
MULIFE.txt,479890,480956,1066,10,N,N,-,-1,-1
MULIFE.txt,480957,481531,574,10,N,N,-,-1,-1
MULIFE.txt,481532,482454,922,10,N,N,-,-1,-1
MULIFE.txt,482457,483429,972,10,N,N,-,-1,-1
MULIFE.txt,483432,484511,1079,10,N,N,-,-1,-1
MULIFE.txt,484512,485632,1120,10,N,N,-,-1,-1
MULIFE.txt,485633,488024,2391,10,N,N,-,-1,-1
MULIFE.txt,488027,488760,733,10,N,N,-,-1,-1
MULIFE.txt,488761,489152,391,10,N,N,-,-1,-1
MULIFE.txt,489155,489831,676,10,N,N,-,-1,-1
MULIFE.txt,489834,490584,750,10,N,N,-,-1,-1
MULIFE.txt,490585,492181,1596,10,Y,Y,1437819193404,491891,492364
MULIFE.txt,492182,493246,1064,10,N,Y,1437819193404,491891,492364
MULIFE.txt,493249,494229,980,10,Y,Y,1437819940135,493797,494222
MULIFE.txt,494231,494702,471,10,N,N,-,-1,-1
MULIFE.txt,494703,495452,749,10,N,N,-,-1,-1
MULIFE.txt,495453,496706,1253,10,Y,N,-,-1,-1
MULIFE.txt,496707,497602,895,10,N,N,-,-1,-1
MULIFE.txt,497603,498620,1017,10,N,N,-,-1,-1
MULIFE.txt,498621,499671,1050,10,Y,N,-,-1,-1
MULIFE.txt,499672,500190,518,10,N,N,-,-1,-1
MULIFE.txt,500191,501396,1205,10,N,N,-,-1,-1
MULIFE.txt,501397,503333,1936,10,N,N,-,-1,-1
MULIFE.txt,503334,504443,1109,10,N,N,-,-1,-1
MULIFE.txt,504446,506674,2228,10,N,N,-,-1,-1
MULIFE.txt,506676,508596,1920,10,N,N,-,-1,-1
MULIFE.txt,508597,510008,1411,10,N,N,-,-1,-1
MULIFE.txt,510011,510883,872,10,N,Y,1437821785598,510009,510542
MULIFE.txt,510884,511995,1111,10,N,Y,1437822193958,511750,512403
MULIFE.txt,511997,513280,1283,10,N,Y,1437822193958,511750,512403
MULIFE.txt,513281,514559,1278,10,N,N,-,-1,-1
MULIFE.txt,514562,515859,1297,10,N,N,-,-1,-1
MULIFE.txt,515860,517940,2080,10,Y,Y,1437822538234,517368,517636
MULIFE.txt,517943,520121,2178,10,N,N,-,-1,-1
MULIFE.txt,520122,521252,1130,10,N,Y,1437823433827,520914,521651
MULIFE.txt,521253,522305,1052,10,N,Y,1437823700026,522255,523121
MULIFE.txt,522306,524218,1912,10,N,Y,1437823700026,522255,523121
MULIFE.txt,524219,525706,1487,10,N,N,-,-1,-1
MULIFE.txt,525708,527349,1641,10,N,N,-,-1,-1
MULIFE.txt,527352,528318,966,10,N,N,-,-1,-1
MULIFE.txt,528319,529889,1570,10,N,N,-,-1,-1
MULIFE.txt,529890,531717,1827,10,N,Y,1437842085814,530652,531925
MULIFE.txt,531718,532982,1264,10,N,Y,1437842085814,530652,531925
MULIFE.txt,532984,533991,1007,10,N,N,-,-1,-1
MULIFE.txt,533992,535433,1441,10,N,N,-,-1,-1
MULIFE.txt,535434,536720,1286,10,N,N,-,-1,-1
MULIFE.txt,536721,537685,964,10,N,N,-,-1,-1
MULIFE.txt,537686,539004,1318,10,N,N,-,-1,-1
MULIFE.txt,539005,540701,1696,10,N,N,-,-1,-1
MULIFE.txt,540704,541813,1109,10,N,N,-,-1,-1
MULIFE.txt,541814,543791,1977,10,N,N,-,-1,-1
MULIFE.txt,543794,544999,1205,10,N,N,-,-1,-1
MULIFE.txt,545002,546068,1066,10,N,Y,1437842663182,545558,546298
MULIFE.txt,546070,547318,1248,10,N,Y,1437842663182,545558,546298
MULIFE.txt,547319,548235,916,10,N,N,-,-1,-1
MULIFE.txt,548236,549013,777,10,N,N,-,-1,-1
MULIFE.txt,549014,550126,1112,10,N,Y,1437842936274,549355,550003
MULIFE.txt,550127,551354,1227,10,N,N,-,-1,-1
MULIFE.txt,551355,552524,1169,10,N,N,-,-1,-1
MULIFE.txt,552525,553607,1082,10,N,Y,1437843377951,552763,553884
MULIFE.txt,553608,555249,1641,10,N,Y,1437843377951,552763,553884
MULIFE.txt,555250,556861,1611,10,N,N,-,-1,-1
MULIFE.txt,556862,558563,1701,10,N,N,-,-1,-1
MULIFE.txt,558566,559654,1088,10,N,N,-,-1,-1
MULIFE.txt,559656,561093,1437,10,N,N,-,-1,-1
MULIFE.txt,561096,562252,1156,10,N,N,-,-1,-1
MULIFE.txt,562255,563752,1497,10,N,N,-,-1,-1
MULIFE.txt,563753,565038,1285,10,N,Y,1437843751491,564174,565427
MULIFE.txt,565039,566860,1821,10,Y,Y,1437843751491,564174,565427
MULIFE.txt,566861,568503,1642,10,Y,Y,1437844476348,567281,568945
MULIFE.txt,568504,570187,1683,10,N,Y,1437844476348,567281,568945
MULIFE.txt,570190,572096,1906,10,N,N,-,-1,-1
MULIFE.txt,572099,572940,841,10,N,N,-,-1,-1
MULIFE.txt,572941,574125,1184,10,N,N,-,-1,-1
MULIFE.txt,574126,575045,919,10,N,N,-,-1,-1
MULIFE.txt,575046,576711,1665,10,N,N,-,-1,-1
MULIFE.txt,576714,577621,907,10,N,N,-,-1,-1
MULIFE.txt,577623,579074,1451,10,N,N,-,-1,-1
MULIFE.txt,579079,579431,352,10,N,N,-,-1,-1
MULIFE.txt,579432,580384,952,10,N,N,-,-1,-1
MULIFE.txt,580385,582386,2001,10,N,Y,1437845266061,581723,582485
MULIFE.txt,582387,583394,1007,10,N,Y,1437845266061,581723,582485
MULIFE.txt,583396,584734,1338,10,N,N,-,-1,-1
MULIFE.txt,584735,586202,1467,10,N,N,-,-1,-1
MULIFE.txt,586205,587661,1456,10,N,N,-,-1,-1
MULIFE.txt,587662,588753,1091,10,N,N,-,-1,-1
MULIFE.txt,588754,590082,1328,10,N,N,-,-1,-1
MULIFE.txt,590085,591423,1338,10,N,N,-,-1,-1
MULIFE.txt,591424,593149,1725,10,N,N,-,-1,-1
MULIFE.txt,593150,594603,1453,10,N,N,-,-1,-1
MULIFE.txt,594604,596549,1945,10,N,N,-,-1,-1
MULIFE.txt,596550,598364,1814,10,N,N,-,-1,-1
MULIFE.txt,598365,599809,1444,10,N,N,-,-1,-1
MULIFE.txt,599810,600996,1186,10,N,N,-,-1,-1
MULIFE.txt,600997,602583,1586,10,N,N,-,-1,-1
MULIFE.txt,602583,604161,1578,10,Y,N,-,-1,-1
MULIFE.txt,604162,605149,987,10,N,N,-,-1,-1
MULIFE.txt,605152,606828,1676,10,Y,N,-,-1,-1
MULIFE.txt,606831,608504,1673,10,N,N,-,-1,-1
MULIFE.txt,608507,609915,1408,10,N,N,-,-1,-1
MULIFE.txt,609918,612078,2160,10,N,N,-,-1,-1
MULIFE.txt,612079,613594,1515,10,N,N,-,-1,-1
MULIFE.txt,613595,615190,1595,10,N,N,-,-1,-1
MULIFE.txt,615191,617308,2117,10,N,N,-,-1,-1
MULIFE.txt,617309,618985,1676,10,N,N,-,-1,-1
MULIFE.txt,618988,620681,1693,10,N,Y,1437986157098,620366,620948
MULIFE.txt,620682,621890,1208,10,N,Y,1437986157098,620366,620948
MULIFE.txt,621891,623488,1597,10,N,N,-,-1,-1
MULIFE.txt,623489,625240,1751,10,N,N,-,-1,-1
MULIFE.txt,625241,626414,1173,10,N,Y,1437986573396,626278,626853
MULIFE.txt,626415,627678,1263,10,N,Y,1437986573396,626278,626853
MULIFE.txt,627679,629955,2276,10,N,N,-,-1,-1
MULIFE.txt,629956,631082,1126,10,Y,N,-,-1,-1
MULIFE.txt,631083,632868,1785,10,N,N,-,-1,-1
MULIFE.txt,632869,634126,1257,10,N,Y,1437987243903,633307,634055
MULIFE.txt,634129,636115,1986,10,N,Y,1437987949897,635438,636165
MULIFE.txt,636117,637598,1481,10,N,Y,1437987949897,635438,636165
MULIFE.txt,637599,638861,1262,10,N,N,-,-1,-1
MULIFE.txt,638862,640816,1954,10,N,N,-,-1,-1
MULIFE.txt,640817,642587,1770,10,N,N,-,-1,-1
MULIFE.txt,642588,643385,797,10,N,N,-,-1,-1
MULIFE.txt,643387,644862,1475,10,N,N,-,-1,-1
MULIFE.txt,644863,645914,1051,10,N,N,-,-1,-1
MULIFE.txt,645916,647094,1178,10,N,N,-,-1,-1
MULIFE.txt,647096,647579,483,10,N,N,-,-1,-1
MULIFE.txt,647579,648659,1080,10,N,N,-,-1,-1
MULIFE.txt,648662,649899,1237,10,N,N,-,-1,-1
MULIFE.txt,649900,650802,902,10,N,N,-,-1,-1
MULIFE.txt,650805,652026,1221,10,N,N,-,-1,-1
MULIFE.txt,652027,653301,1274,10,N,N,-,-1,-1
MULIFE.txt,653304,654742,1438,10,N,N,-,-1,-1
MULIFE.txt,654743,655976,1233,10,N,N,-,-1,-1
MULIFE.txt,655979,656897,918,10,N,N,-,-1,-1
MULIFE.txt,656898,658786,1888,10,Y,N,-,-1,-1
MULIFE.txt,658787,659673,886,10,N,Y,1437988651932,659204,659887
MULIFE.txt,659675,661013,1338,10,N,Y,1437988651932,659204,659887
MULIFE.txt,661014,662043,1029,10,N,Y,1437989149214,661990,662272
MULIFE.txt,662045,663158,1113,10,N,Y,1437989149214,661990,662272
MULIFE.txt,663161,664564,1403,10,N,Y,1437989518903,664383,664855
MULIFE.txt,664565,665996,1431,10,N,Y,1437989518903,664383,664855
MULIFE.txt,665999,666677,678,10,N,N,-,-1,-1
MULIFE.txt,666678,667419,741,10,N,N,-,-1,-1
MULIFE.txt,667421,668135,714,10,N,N,-,-1,-1
MULIFE.txt,668136,668921,785,10,N,N,-,-1,-1
MULIFE.txt,668926,669611,685,10,N,Y,1437990390319,668943,669389
MULIFE.txt,669612,670518,906,10,N,N,-,-1,-1
MULIFE.txt,670521,671408,887,10,N,N,-,-1,-1
MULIFE.txt,671411,672243,832,10,N,N,-,-1,-1
MULIFE.txt,672244,672742,498,10,N,N,-,-1,-1
MULIFE.txt,672743,673644,901,10,N,N,-,-1,-1
MULIFE.txt,673645,674638,993,10,N,N,-,-1,-1
MULIFE.txt,674641,675393,752,10,N,N,-,-1,-1
MULIFE.txt,675394,676201,807,10,N,N,-,-1,-1
MULIFE.txt,676202,677196,994,10,N,N,-,-1,-1
MULIFE.txt,677199,678432,1233,10,N,N,-,-1,-1
MULIFE.txt,678435,679571,1136,10,N,N,-,-1,-1
MULIFE.txt,679574,680798,1224,10,N,N,-,-1,-1
MULIFE.txt,680799,681857,1058,10,N,N,-,-1,-1
MULIFE.txt,681858,682606,748,10,N,N,-,-1,-1
MULIFE.txt,682607,683289,682,10,N,N,-,-1,-1
MULIFE.txt,683292,684342,1050,10,N,N,-,-1,-1
MULIFE.txt,684343,685568,1225,10,N,N,-,-1,-1
MULIFE.txt,685571,687334,1763,10,N,N,-,-1,-1
MULIFE.txt,687335,688104,769,10,N,N,-,-1,-1
MULIFE.txt,688105,689857,1752,10,N,N,-,-1,-1
MULIFE.txt,689858,691004,1146,10,N,N,-,-1,-1
MULIFE.txt,691007,692594,1587,10,N,N,-,-1,-1
MULIFE.txt,692597,693435,838,10,N,Y,1437991397891,693219,694006
MULIFE.txt,693436,694058,622,10,N,Y,1437991397891,693219,694006
MULIFE.txt,694061,695143,1082,10,N,Y,1437991665521,694564,695190
MULIFE.txt,695144,695849,705,10,N,Y,1437991665521,694564,695190
MULIFE.txt,695854,696815,961,10,N,N,-,-1,-1
MULIFE.txt,696816,698218,1402,10,N,N,-,-1,-1
MULIFE.txt,698219,699558,1339,10,N,N,-,-1,-1
MULIFE.txt,699561,700848,1287,10,N,N,-,-1,-1
MULIFE.txt,700849,701285,436,10,N,N,-,-1,-1
MULIFE.txt,701286,702082,796,10,N,Y,1437991986836,701932,703111
MULIFE.txt,702083,703040,957,10,N,Y,1437991986836,701932,703111
MULIFE.txt,703041,704209,1168,10,N,Y,1437991986836,701932,703111
MULIFE.txt,704211,705596,1385,10,N,N,-,-1,-1
MULIFE.txt,705601,706782,1181,10,N,N,-,-1,-1
MULIFE.txt,706783,707936,1153,10,N,Y,1437992265363,707653,708287
MULIFE.txt,707937,708728,791,10,N,Y,1437992265363,707653,708287
MULIFE.txt,708729,709571,842,10,N,N,-,-1,-1
MULIFE.txt,709574,710689,1115,10,N,N,-,-1,-1
MULIFE.txt,710690,711488,798,10,N,N,-,-1,-1
MULIFE.txt,711491,712617,1126,10,N,N,-,-1,-1
MULIFE.txt,712618,714388,1770,10,N,N,-,-1,-1
MULIFE.txt,714389,715356,967,10,N,N,-,-1,-1
MULIFE.txt,715357,716370,1013,10,N,N,-,-1,-1
MULIFE.txt,716371,717958,1587,10,N,N,-,-1,-1
MULIFE.txt,717959,718964,1005,10,N,Y,1437992560557,718760,719849
MULIFE.txt,718965,720493,1528,10,N,Y,1437992801449,719924,720764
MULIFE.txt,720494,721148,654,10,N,Y,1437992801449,719924,720764
MULIFE.txt,721149,722233,1084,10,N,N,-,-1,-1
MULIFE.txt,722234,722916,682,10,N,N,-,-1,-1
MULIFE.txt,722917,724005,1088,10,N,N,-,-1,-1
MULIFE.txt,724008,725386,1378,10,N,N,-,-1,-1
MULIFE.txt,725387,726922,1535,10,N,N,-,-1,-1
MULIFE.txt,726923,728135,1212,10,N,N,-,-1,-1
MULIFE.txt,728136,729677,1541,10,N,N,-,-1,-1
MULIFE.txt,729680,731172,1492,10,N,N,-,-1,-1
MULIFE.txt,731173,732165,992,10,N,N,-,-1,-1
MULIFE.txt,732166,733607,1441,10,N,N,-,-1,-1
MULIFE.txt,733607,734722,1115,10,N,N,-,-1,-1
MULIFE.txt,734723,736017,1294,10,N,N,-,-1,-1
MULIFE.txt,736018,737071,1053,10,N,N,-,-1,-1
MULIFE.txt,737074,738016,942,10,N,N,-,-1,-1
MULIFE.txt,738019,739184,1165,10,N,N,-,-1,-1
MULIFE.txt,739189,739921,732,10,N,N,-,-1,-1
MULIFE.txt,739922,740851,929,10,N,Y,1437993458963,740703,741759
MULIFE.txt,740852,741839,987,10,N,Y,1437993458963,740703,741759
MULIFE.txt,741842,742694,852,10,N,N,-,-1,-1
MULIFE.txt,742695,743250,555,10,N,N,-,-1,-1
MULIFE.txt,743251,743854,603,10,N,N,-,-1,-1
MULIFE.txt,743855,745183,1328,10,N,N,-,-1,-1
MULIFE.txt,745184,746619,1435,10,N,N,-,-1,-1
MULIFE.txt,746620,748138,1518,10,N,Y,1437993739565,746751,748086
MULIFE.txt,748143,749107,964,10,N,N,-,-1,-1
MULIFE.txt,749110,750514,1404,10,N,N,-,-1,-1
MULIFE.txt,750515,751791,1276,10,N,N,-,-1,-1
MULIFE.txt,751794,753088,1294,10,N,N,-,-1,-1
MULIFE.txt,753089,754306,1217,10,N,N,-,-1,-1
MULIFE.txt,754307,755263,956,10,N,N,-,-1,-1
MULIFE.txt,755264,756089,825,10,N,N,-,-1,-1
MULIFE.txt,756091,758041,1950,10,N,N,-,-1,-1
MULIFE.txt,758044,759819,1775,10,N,N,-,-1,-1
MULIFE.txt,759822,760992,1170,10,N,Y,1437994269353,759820,760565
MULIFE.txt,760993,762353,1360,10,N,N,-,-1,-1
MULIFE.txt,762354,764037,1683,10,N,N,-,-1,-1
MULIFE.txt,764040,765015,975,10,N,N,-,-1,-1
MULIFE.txt,765016,766417,1401,10,N,N,-,-1,-1
MULIFE.txt,766420,768498,2078,10,N,N,-,-1,-1
MULIFE.txt,768499,770140,1641,10,N,N,-,-1,-1
MULIFE.txt,770141,771029,888,10,N,N,-,-1,-1
MULIFE.txt,771034,771956,922,10,N,Y,1438000608332,771119,771952
MULIFE.txt,771959,773375,1416,10,N,N,-,-1,-1
MULIFE.txt,773376,774318,942,10,N,N,-,-1,-1
MULIFE.txt,774319,775994,1675,10,N,N,-,-1,-1
MULIFE.txt,775995,777034,1039,10,N,N,-,-1,-1
MULIFE.txt,777035,778536,1501,10,N,N,-,-1,-1
MULIFE.txt,778537,779369,832,10,N,Y,1438001606981,778715,780387
MULIFE.txt,779370,780777,1407,10,N,Y,1438001606981,778715,780387
MULIFE.txt,780778,781661,883,10,N,N,-,-1,-1
MULIFE.txt,781664,782326,662,10,N,N,-,-1,-1
MULIFE.txt,782329,783268,939,10,N,N,-,-1,-1
MULIFE.txt,783269,785000,1731,10,N,N,-,-1,-1
MULIFE.txt,785003,785839,836,10,N,N,-,-1,-1
MULIFE.txt,785840,786534,694,10,N,N,-,-1,-1
MULIFE.txt,786535,787511,976,10,N,N,-,-1,-1
MULIFE.txt,787512,788660,1148,10,N,N,-,-1,-1
MULIFE.txt,788661,790692,2031,10,N,N,-,-1,-1
MULIFE.txt,790693,791832,1139,10,N,N,-,-1,-1
MULIFE.txt,791834,793376,1542,10,N,N,-,-1,-1
MULIFE.txt,793377,794894,1517,10,N,N,-,-1,-1
MULIFE.txt,794895,796114,1219,10,N,N,-,-1,-1
MULIFE.txt,796117,796755,638,10,N,N,-,-1,-1
MULIFE.txt,796758,799176,2418,10,N,N,-,-1,-1
MULIFE.txt,799179,801196,2017,10,N,N,-,-1,-1
MULIFE.txt,801197,802810,1613,10,N,N,-,-1,-1
MULIFE.txt,802812,804086,1274,10,N,N,-,-1,-1
MULIFE.txt,804087,805675,1588,10,N,N,-,-1,-1
MULIFE.txt,805676,806361,685,10,N,N,-,-1,-1
MULIFE.txt,806362,807617,1255,10,N,N,-,-1,-1
MULIFE.txt,807618,809220,1602,10,N,N,-,-1,-1
MULIFE.txt,809221,810693,1472,10,N,N,-,-1,-1
MULIFE.txt,810694,812028,1334,10,N,N,-,-1,-1
MULIFE.txt,812031,813601,1570,10,N,N,-,-1,-1
MULIFE.txt,813602,815281,1679,10,N,N,-,-1,-1
MULIFE.txt,815282,816774,1492,10,N,N,-,-1,-1
MULIFE.txt,816775,817876,1101,10,N,N,-,-1,-1
MULIFE.txt,817877,819314,1437,10,N,N,-,-1,-1
MULIFE.txt,819317,821087,1770,10,N,N,-,-1,-1
MULIFE.txt,821092,822641,1549,10,N,N,-,-1,-1
MULIFE.txt,822642,823646,1004,10,N,N,-,-1,-1
MULIFE.txt,823647,824817,1170,10,N,N,-,-1,-1
MULIFE.txt,824818,825974,1156,10,N,N,-,-1,-1
MULIFE.txt,825977,827429,1452,10,N,N,-,-1,-1
MULIFE.txt,827430,828061,631,10,N,N,-,-1,-1
MULIFE.txt,828064,829126,1062,10,N,N,-,-1,-1
MULIFE.txt,829127,829910,783,10,N,N,-,-1,-1
MULIFE.txt,829911,831041,1130,10,N,N,-,-1,-1
MULIFE.txt,831042,832074,1032,10,N,N,-,-1,-1
MULIFE.txt,832075,832804,729,10,N,N,-,-1,-1
MULIFE.txt,832805,833823,1018,10,N,N,-,-1,-1
MULIFE.txt,833824,834922,1098,10,N,N,-,-1,-1
MULIFE.txt,834923,836329,1406,10,N,N,-,-1,-1
MULIFE.txt,836332,837308,976,10,N,N,-,-1,-1
MULIFE.txt,837309,838428,1119,10,N,N,-,-1,-1
MULIFE.txt,838429,839756,1327,10,N,N,-,-1,-1
MULIFE.txt,839757,840681,924,10,N,N,-,-1,-1
MULIFE.txt,840682,841535,853,10,N,N,-,-1,-1
MULIFE.txt,841536,842299,763,10,N,N,-,-1,-1
MULIFE.txt,842302,843993,1691,10,N,N,-,-1,-1
MULIFE.txt,843994,844982,988,10,N,N,-,-1,-1
MULIFE.txt,844983,846449,1466,10,N,N,-,-1,-1
MULIFE.txt,846452,847668,1216,10,Y,N,-,-1,-1
MULIFE.txt,847669,849351,1682,10,N,N,-,-1,-1
MULIFE.txt,849354,851210,1856,10,N,N,-,-1,-1
MULIFE.txt,851211,852196,985,10,N,N,-,-1,-1
MULIFE.txt,852197,852973,776,10,N,N,-,-1,-1
MULIFE.txt,852974,853849,875,10,N,N,-,-1,-1
MULIFE.txt,853850,854486,636,10,N,N,-,-1,-1
MULIFE.txt,854487,855326,839,10,N,N,-,-1,-1
MULIFE.txt,855327,855756,429,10,N,N,-,-1,-1
MULIFE.txt,855757,856607,850,10,N,N,-,-1,-1
MULIFE.txt,856608,858096,1488,10,N,N,-,-1,-1
MULIFE.txt,858099,859674,1575,10,N,N,-,-1,-1
MULIFE.txt,859677,860759,1082,10,N,N,-,-1,-1
MULIFE.txt,860760,861481,721,10,N,N,-,-1,-1
MULIFE.txt,861482,862701,1219,10,N,N,-,-1,-1
MULIFE.txt,862703,864235,1532,10,N,N,-,-1,-1
MULIFE.txt,864236,865847,1611,10,N,N,-,-1,-1
MULIFE.txt,865850,867077,1227,10,N,N,-,-1,-1
MULIFE.txt,867078,867596,518,10,N,N,-,-1,-1
MULIFE.txt,867599,869040,1441,10,N,N,-,-1,-1
MULIFE.txt,869043,870597,1554,10,N,N,-,-1,-1
MULIFE.txt,870598,871468,870,10,N,N,-,-1,-1
MULIFE.txt,871469,871992,523,10,N,N,-,-1,-1
MULIFE.txt,871993,873587,1594,10,N,N,-,-1,-1
MULIFE.txt,873590,874163,573,10,N,N,-,-1,-1
MULIFE.txt,874164,875482,1318,10,N,N,-,-1,-1
MULIFE.txt,875483,875994,511,10,N,N,-,-1,-1
MULIFE.txt,875995,876556,561,10,N,N,-,-1,-1
MULIFE.txt,876557,877007,450,10,N,N,-,-1,-1
MULIFE.txt,877008,877670,662,10,N,N,-,-1,-1
MULIFE.txt,877673,878261,588,10,N,N,-,-1,-1
MULIFE.txt,878263,878889,626,10,N,N,-,-1,-1
MULIFE.txt,878890,879661,771,10,N,N,-,-1,-1
MULIFE.txt,879662,880179,517,10,N,N,-,-1,-1
MULIFE.txt,880180,880873,693,10,N,N,-,-1,-1
MULIFE.txt,880876,882232,1356,10,N,N,-,-1,-1
MULIFE.txt,882233,883531,1298,10,N,N,-,-1,-1
MULIFE.txt,883532,885253,1721,10,N,N,-,-1,-1
MULIFE.txt,885256,885881,625,10,N,N,-,-1,-1
MULIFE.txt,885883,886491,608,10,N,N,-,-1,-1
MULIFE.txt,886494,887458,964,10,N,N,-,-1,-1
MULIFE.txt,887459,888375,916,10,N,N,-,-1,-1
MULIFE.txt,888378,891033,2655,10,Y,N,-,-1,-1
MULIFE.txt,891035,892556,1521,10,N,N,-,-1,-1
MULIFE.txt,892564,893085,521,10,N,Y,1438002747854,892999,894161
MULIFE.txt,893088,894745,1657,10,N,Y,1438002747854,892999,894161
MULIFE.txt,894748,896477,1729,10,N,N,-,-1,-1
MULIFE.txt,896478,897502,1024,10,N,N,-,-1,-1
MULIFE.txt,897505,898689,1184,10,N,N,-,-1,-1
MULIFE.txt,898690,899646,956,10,N,N,-,-1,-1
MULIFE.txt,899647,900801,1154,10,N,N,-,-1,-1
MULIFE.txt,900802,902185,1383,10,N,Y,1438003564102,901839,902422
MULIFE.txt,902188,903246,1058,10,N,Y,1438003564102,901839,902422
MULIFE.txt,903247,904284,1037,10,N,Y,1438003925285,903100,903985
MULIFE.txt,904285,905248,963,10,N,N,-,-1,-1
MULIFE.txt,905249,906415,1166,10,N,Y,1438004319285,905549,905936
MULIFE.txt,906416,907543,1127,10,N,N,-,-1,-1
MULIFE.txt,907546,908660,1114,10,N,N,-,-1,-1
MULIFE.txt,908661,909806,1145,10,N,N,-,-1,-1
MULIFE.txt,909807,911008,1201,10,N,N,-,-1,-1
MULIFE.txt,911009,912043,1034,10,N,N,-,-1,-1
MULIFE.txt,912044,912881,837,10,N,N,-,-1,-1
MULIFE.txt,912882,913527,645,10,N,N,-,-1,-1
MULIFE.txt,913528,914137,609,10,N,N,-,-1,-1
MULIFE.txt,914139,914979,840,10,N,N,-,-1,-1
MULIFE.txt,914980,916139,1159,10,N,N,-,-1,-1
MULIFE.txt,916140,917367,1227,10,N,N,-,-1,-1
MULIFE.txt,917370,918503,1133,10,N,N,-,-1,-1
MULIFE.txt,918504,919831,1327,10,N,N,-,-1,-1
MULIFE.txt,919834,920973,1139,10,N,N,-,-1,-1
MULIFE.txt,920974,922279,1305,10,N,N,-,-1,-1
MULIFE.txt,922281,923513,1232,10,N,N,-,-1,-1
MULIFE.txt,923514,925514,2000,10,N,N,-,-1,-1
MULIFE.txt,925517,927006,1489,10,N,N,-,-1,-1
MULIFE.txt,927007,929088,2081,10,N,N,-,-1,-1
MULIFE.txt,929091,930326,1235,10,N,N,-,-1,-1
MULIFE.txt,930327,931324,997,10,N,N,-,-1,-1
MULIFE.txt,931325,932697,1372,10,N,N,-,-1,-1
MULIFE.txt,932700,933568,868,10,N,N,-,-1,-1
MULIFE.txt,933569,934919,1350,10,N,N,-,-1,-1
MULIFE.txt,934922,936491,1569,10,N,N,-,-1,-1
MULIFE.txt,936492,937495,1003,10,N,N,-,-1,-1
MULIFE.txt,937497,938778,1281,10,N,N,-,-1,-1
MULIFE.txt,938779,939804,1025,10,N,N,-,-1,-1
MULIFE.txt,939805,940568,763,10,N,N,-,-1,-1
MULIFE.txt,940570,941319,749,10,N,N,-,-1,-1
MULIFE.txt,941320,942086,766,10,N,N,-,-1,-1
MULIFE.txt,942089,943061,972,10,N,N,-,-1,-1
MULIFE.txt,943062,944251,1189,10,N,N,-,-1,-1
MULIFE.txt,944252,945813,1561,10,N,N,-,-1,-1
MULIFE.txt,945814,947066,1252,10,N,N,-,-1,-1
MULIFE.txt,947069,948312,1243,10,N,N,-,-1,-1
MULIFE.txt,948313,949491,1178,10,N,N,-,-1,-1
MULIFE.txt,949492,950448,956,10,N,N,-,-1,-1
MULIFE.txt,950449,952241,1792,10,N,N,-,-1,-1
MULIFE.txt,952242,953760,1518,10,N,Y,1438005303228,953665,955052
MULIFE.txt,953761,954953,1192,10,N,Y,1438005303228,953665,955052
MULIFE.txt,954954,956064,1110,10,N,Y,1438005724733,955431,957516
MULIFE.txt,956065,957909,1844,10,N,Y,1438005724733,955431,957516
MULIFE.txt,957912,959644,1732,10,N,N,-,-1,-1
MULIFE.txt,959645,961316,1671,10,N,N,-,-1,-1
MULIFE.txt,961319,962900,1581,10,N,N,-,-1,-1
MULIFE.txt,962903,964594,1691,10,N,N,-,-1,-1
MULIFE.txt,964595,966235,1640,10,N,N,-,-1,-1
MULIFE.txt,966236,967112,876,10,N,N,-,-1,-1
MULIFE.txt,967115,968059,944,10,N,N,-,-1,-1
MULIFE.txt,968061,969092,1031,10,N,N,-,-1,-1
MULIFE.txt,969094,970658,1564,10,N,N,-,-1,-1
MULIFE.txt,970659,972405,1746,10,N,Y,1438006506960,970689,974719
MULIFE.txt,972406,974826,2420,10,N,Y,1438006506960,970689,974719
MULIFE.txt,974827,976041,1214,10,N,N,-,-1,-1
MULIFE.txt,976042,976746,704,10,N,N,-,-1,-1
MULIFE.txt,976747,977715,968,10,N,N,-,-1,-1
MULIFE.txt,977716,978350,634,10,N,N,-,-1,-1
MULIFE.txt,978353,979676,1323,10,N,N,-,-1,-1
MULIFE.txt,979679,980866,1187,10,N,N,-,-1,-1
MULIFE.txt,980867,981931,1064,10,N,N,-,-1,-1
MULIFE.txt,981934,982607,673,10,N,N,-,-1,-1
MULIFE.txt,982608,984133,1525,10,N,N,-,-1,-1
MULIFE.txt,984135,984369,234,10,N,N,-,-1,-1
MULIFE.txt,984370,984591,221,10,N,N,-,-1,-1
MULIFE.txt,984592,984865,273,10,N,N,-,-1,-1
MULIFE.txt,984866,985217,351,10,N,N,-,-1,-1
MULIFE.txt,985219,985492,273,10,N,N,-,-1,-1
MULIFE.txt,985493,985795,302,10,N,N,-,-1,-1
MULIFE.txt,985798,986200,402,10,N,N,-,-1,-1
MULIFE.txt,986201,986382,181,10,N,N,-,-1,-1
MULIFE.txt,986383,986603,220,10,N,N,-,-1,-1
MULIFE.txt,986604,986799,195,10,N,N,-,-1,-1
MULIFE.txt,986800,987090,290,10,N,N,-,-1,-1
MULIFE.txt,987092,987558,466,10,N,N,-,-1,-1
MULIFE.txt,987558,987777,219,10,N,N,-,-1,-1
MULIFE.txt,987778,988103,325,10,N,N,-,-1,-1
MULIFE.txt,988104,988323,219,10,N,N,-,-1,-1
MULIFE.txt,988324,988464,140,10,N,N,-,-1,-1
MULIFE.txt,988465,988738,273,10,N,N,-,-1,-1
MULIFE.txt,988740,988943,203,10,N,N,-,-1,-1
MULIFE.txt,988944,989100,156,10,N,N,-,-1,-1
MULIFE.txt,989101,989324,223,10,N,N,-,-1,-1
MULIFE.txt,989325,989499,174,10,N,N,-,-1,-1
MULIFE.txt,989500,989627,127,10,N,N,-,-1,-1
MULIFE.txt,989628,989870,242,10,N,N,-,-1,-1
MULIFE.txt,989871,989979,108,10,N,N,-,-1,-1
MULIFE.txt,989980,990352,372,10,N,N,-,-1,-1
MULIFE.txt,990353,990681,328,10,N,N,-,-1,-1
MULIFE.txt,990684,991090,406,10,N,N,-,-1,-1
MULIFE.txt,991091,991426,335,10,N,N,-,-1,-1
MULIFE.txt,991428,991640,212,10,N,N,-,-1,-1
MULIFE.txt,991641,991832,191,10,N,N,-,-1,-1
MULIFE.txt,991833,992014,181,10,N,N,-,-1,-1
MULIFE.txt,992015,992285,270,10,N,N,-,-1,-1
MULIFE.txt,992286,992713,427,10,N,N,-,-1,-1
MULIFE.txt,992714,992848,134,10,N,N,-,-1,-1
MULIFE.txt,992850,993047,197,10,N,N,-,-1,-1
MULIFE.txt,993048,993162,114,10,N,N,-,-1,-1
MULIFE.txt,993164,993258,94,10,N,N,-,-1,-1
MULIFE.txt,993260,993507,247,10,N,N,-,-1,-1
MULIFE.txt,993510,993664,154,10,N,N,-,-1,-1
MULIFE.txt,993665,993938,273,10,N,N,-,-1,-1
MULIFE.txt,993939,994058,119,10,N,N,-,-1,-1
MULIFE.txt,994059,994203,144,10,N,N,-,-1,-1
MULIFE.txt,994204,994305,101,10,N,N,-,-1,-1
MULIFE.txt,994306,994423,117,10,N,N,-,-1,-1
MULIFE.txt,994426,994620,194,10,N,N,-,-1,-1
MULIFE.txt,994621,994886,265,10,N,N,-,-1,-1
MULIFE.txt,994887,995041,154,10,N,N,-,-1,-1
MULIFE.txt,995042,995177,135,10,N,N,-,-1,-1
MULIFE.txt,995178,995418,240,10,N,N,-,-1,-1
MULIFE.txt,995421,995649,228,10,N,N,-,-1,-1
MULIFE.txt,995650,995790,140,10,N,N,-,-1,-1
MULIFE.txt,995793,996062,269,10,N,N,-,-1,-1
MULIFE.txt,996063,996247,184,10,N,N,-,-1,-1
MULIFE.txt,996248,996693,445,10,N,N,-,-1,-1
MULIFE.txt,996695,997028,333,10,N,N,-,-1,-1
MULIFE.txt,997031,997293,262,10,N,N,-,-1,-1
MULIFE.txt,997295,997577,282,10,N,N,-,-1,-1
MULIFE.txt,997579,997727,148,10,N,N,-,-1,-1
MULIFE.txt,997728,997955,227,10,N,N,-,-1,-1
MULIFE.txt,997956,998166,210,10,N,N,-,-1,-1
MULIFE.txt,998167,998416,249,10,N,N,-,-1,-1
MULIFE.txt,998421,998684,263,10,N,N,-,-1,-1
MULIFE.txt,998684,998988,304,10,N,N,-,-1,-1
MULIFE.txt,998991,999163,172,10,N,N,-,-1,-1
MULIFE.txt,999164,999314,150,10,N,N,-,-1,-1
MULIFE.txt,999314,999653,339,10,N,N,-,-1,-1
MULIFE.txt,999654,999768,114,10,N,N,-,-1,-1
MULIFE.txt,999768,1000004,236,10,N,N,-,-1,-1
MULIFE.txt,1000009,1000278,269,10,N,N,-,-1,-1
MULIFE.txt,1000279,1000435,156,10,N,N,-,-1,-1
MULIFE.txt,1000437,1000608,171,10,N,N,-,-1,-1
MULIFE.txt,1000609,1001108,499,10,N,N,-,-1,-1
MULIFE.txt,1001109,1001297,188,10,N,N,-,-1,-1
MULIFE.txt,1001298,1001461,163,10,N,N,-,-1,-1
MULIFE.txt,1001464,1001575,111,10,N,N,-,-1,-1
MULIFE.txt,1001576,1001760,184,10,N,N,-,-1,-1
MULIFE.txt,1001761,1001956,195,10,N,N,-,-1,-1
MULIFE.txt,1001957,1002127,170,10,N,N,-,-1,-1
MULIFE.txt,1002128,1002376,248,10,N,N,-,-1,-1
MULIFE.txt,1002379,1002650,271,10,N,N,-,-1,-1
MULIFE.txt,1002651,1002897,246,10,N,N,-,-1,-1
MULIFE.txt,1002898,1003088,190,10,N,N,-,-1,-1
MULIFE.txt,1003089,1003189,100,10,N,N,-,-1,-1
MULIFE.txt,1003190,1003327,137,10,N,N,-,-1,-1
MULIFE.txt,1003328,1003456,128,10,N,N,-,-1,-1
MULIFE.txt,1003457,1003705,248,10,N,N,-,-1,-1
MULIFE.txt,1003706,1004042,336,10,N,N,-,-1,-1
MULIFE.txt,1004043,1004269,226,10,N,N,-,-1,-1
MULIFE.txt,1004270,1004559,289,10,N,N,-,-1,-1
MULIFE.txt,1004560,1004825,265,10,N,N,-,-1,-1
MULIFE.txt,1004826,1005055,229,10,N,N,-,-1,-1
MULIFE.txt,1005056,1005366,310,10,N,N,-,-1,-1
MULIFE.txt,1005368,1005682,314,10,N,N,-,-1,-1
MULIFE.txt,1005683,1005874,191,10,N,N,-,-1,-1
MULIFE.txt,1005875,1006118,243,10,N,N,-,-1,-1
MULIFE.txt,1006120,1006343,223,10,N,N,-,-1,-1
MULIFE.txt,1006348,1006562,214,10,N,N,-,-1,-1
MULIFE.txt,1006563,1006776,213,10,N,N,-,-1,-1
MULIFE.txt,1006777,1007114,337,10,N,N,-,-1,-1
MULIFE.txt,1007114,1007350,236,10,N,N,-,-1,-1
MULIFE.txt,1007351,1007621,270,10,N,N,-,-1,-1
MULIFE.txt,1007623,1007858,235,10,N,N,-,-1,-1
MULIFE.txt,1007859,1008028,169,10,N,N,-,-1,-1
MULIFE.txt,1008031,1008157,126,10,N,N,-,-1,-1
MULIFE.txt,1008158,1008325,167,10,N,N,-,-1,-1
MULIFE.txt,1008326,1008498,172,10,N,N,-,-1,-1
MULIFE.txt,1008500,1008657,157,10,N,N,-,-1,-1
MULIFE.txt,1008658,1008996,338,10,N,N,-,-1,-1
MULIFE.txt,1008999,1009478,479,10,N,N,-,-1,-1
MULIFE.txt,1009479,1009656,177,10,N,N,-,-1,-1
MULIFE.txt,1009658,1009849,191,10,N,N,-,-1,-1
MULIFE.txt,1009850,1010000,150,10,N,N,-,-1,-1
MULIFE.txt,1010001,1010124,123,10,N,N,-,-1,-1
MULIFE.txt,1010125,1010354,229,10,N,N,-,-1,-1
MULIFE.txt,1010357,1010779,422,10,N,N,-,-1,-1
MULIFE.txt,1010780,1010901,121,10,N,N,-,-1,-1
MULIFE.txt,1010901,1011079,178,10,N,N,-,-1,-1
MULIFE.txt,1011084,1011548,464,10,N,N,-,-1,-1
MULIFE.txt,1011549,1011921,372,10,N,N,-,-1,-1
MULIFE.txt,1011923,1012209,286,10,N,N,-,-1,-1
MULIFE.txt,1012214,1012384,170,10,N,N,-,-1,-1
MULIFE.txt,1012389,1012571,182,10,N,N,-,-1,-1
MULIFE.txt,1012572,1012801,229,10,N,N,-,-1,-1
MULIFE.txt,1012802,1013312,510,10,N,N,-,-1,-1
MULIFE.txt,1013313,1013667,354,10,N,N,-,-1,-1
MULIFE.txt,1013668,1013907,239,10,N,N,-,-1,-1
MULIFE.txt,1013908,1014268,360,10,N,N,-,-1,-1
MULIFE.txt,1014273,1014602,329,10,N,N,-,-1,-1
MULIFE.txt,1014603,1014943,340,10,N,N,-,-1,-1
MULIFE.txt,1014945,1015233,288,10,N,N,-,-1,-1
MULIFE.txt,1015234,1015585,351,10,N,N,-,-1,-1
MULIFE.txt,1015586,1015964,378,10,N,N,-,-1,-1
MULIFE.txt,1015965,1016126,161,10,N,N,-,-1,-1
MULIFE.txt,1016131,1016584,453,10,N,N,-,-1,-1
MULIFE.txt,1016585,1016869,284,10,N,N,-,-1,-1
MULIFE.txt,1016870,1017301,431,10,N,N,-,-1,-1
MULIFE.txt,1017302,1017644,342,10,N,N,-,-1,-1
MULIFE.txt,1017645,1017961,316,10,N,N,-,-1,-1
MULIFE.txt,1017962,1018180,218,10,N,N,-,-1,-1
MULIFE.txt,1018181,1018430,249,10,N,N,-,-1,-1
MULIFE.txt,1018431,1018854,423,10,N,N,-,-1,-1
MULIFE.txt,1018855,1019186,331,10,N,N,-,-1,-1
MULIFE.txt,1019189,1019614,425,10,N,N,-,-1,-1
MULIFE.txt,1019615,1020019,404,10,N,N,-,-1,-1
MULIFE.txt,1020020,1020427,407,10,N,N,-,-1,-1
MULIFE.txt,1020428,1020840,412,10,N,N,-,-1,-1
MULIFE.txt,1020843,1021130,287,10,N,N,-,-1,-1
MULIFE.txt,1021132,1021437,305,10,N,N,-,-1,-1
MULIFE.txt,1021438,1021759,321,10,N,N,-,-1,-1
MULIFE.txt,1021759,1022053,294,10,N,N,-,-1,-1
MULIFE.txt,1022054,1022351,297,10,N,N,-,-1,-1
MULIFE.txt,1022352,1022828,476,10,N,N,-,-1,-1
MULIFE.txt,1022829,1023152,323,10,N,N,-,-1,-1
MULIFE.txt,1023153,1023303,150,10,N,N,-,-1,-1
MULIFE.txt,1023304,1023681,377,10,N,N,-,-1,-1
MULIFE.txt,1023684,1024048,364,10,N,N,-,-1,-1
MULIFE.txt,1024049,1024169,120,10,N,N,-,-1,-1
MULIFE.txt,1024172,1024504,332,10,N,N,-,-1,-1
MULIFE.txt,1024505,1024779,274,10,N,N,-,-1,-1
MULIFE.txt,1024781,1025125,344,10,N,N,-,-1,-1
MULIFE.txt,1025126,1025278,152,10,N,N,-,-1,-1
MULIFE.txt,1025279,1025411,132,10,N,N,-,-1,-1
MULIFE.txt,1025412,1025623,211,10,N,N,-,-1,-1
MULIFE.txt,1025624,1025985,361,10,N,N,-,-1,-1
MULIFE.txt,1025986,1026165,179,10,N,N,-,-1,-1
MULIFE.txt,1026166,1026457,291,10,N,N,-,-1,-1
MULIFE.txt,1026458,1026753,295,10,N,N,-,-1,-1
MULIFE.txt,1026754,1027031,277,10,N,N,-,-1,-1
MULIFE.txt,1027032,1027209,177,10,N,N,-,-1,-1
MULIFE.txt,1027210,1027435,225,10,N,N,-,-1,-1
MULIFE.txt,1027436,1027609,173,10,N,N,-,-1,-1
MULIFE.txt,1027610,1027757,147,10,N,N,-,-1,-1
MULIFE.txt,1027760,1027958,198,10,N,N,-,-1,-1
MULIFE.txt,1027961,1028133,172,10,N,N,-,-1,-1
MULIFE.txt,1028134,1028299,165,10,N,N,-,-1,-1
MULIFE.txt,1028301,1028783,482,10,N,N,-,-1,-1
MULIFE.txt,1028786,1029005,219,10,N,N,-,-1,-1
MULIFE.txt,1029006,1029201,195,10,N,N,-,-1,-1
MULIFE.txt,1029202,1029427,225,10,N,N,-,-1,-1
MULIFE.txt,1029428,1029596,168,10,N,N,-,-1,-1
MULIFE.txt,1029597,1029703,106,10,N,N,-,-1,-1
MULIFE.txt,1029704,1029880,176,10,N,N,-,-1,-1
MULIFE.txt,1029883,1030305,422,10,N,N,-,-1,-1
MULIFE.txt,1030308,1030692,384,10,N,N,-,-1,-1
MULIFE.txt,1030693,1030900,207,10,N,N,-,-1,-1
MULIFE.txt,1030901,1031226,325,10,N,N,-,-1,-1
MULIFE.txt,1031229,1031412,183,10,N,N,-,-1,-1
MULIFE.txt,1031413,1031619,206,10,N,N,-,-1,-1
MULIFE.txt,1031621,1031802,181,10,N,N,-,-1,-1
MULIFE.txt,1031805,1031949,144,10,N,N,-,-1,-1
MULIFE.txt,1031950,1032126,176,10,N,N,-,-1,-1
MULIFE.txt,1032127,1032399,272,10,N,N,-,-1,-1
MULIFE.txt,1032401,1032561,160,10,N,N,-,-1,-1
MULIFE.txt,1032562,1032767,205,10,N,N,-,-1,-1
MULIFE.txt,1032768,1032937,169,10,N,N,-,-1,-1
MULIFE.txt,1032938,1033198,260,10,N,N,-,-1,-1
MULIFE.txt,1033199,1033517,318,10,N,N,-,-1,-1
MULIFE.txt,1033520,1033624,104,10,N,N,-,-1,-1
MULIFE.txt,1033627,1033929,302,10,N,N,-,-1,-1
MULIFE.txt,1033931,1034244,313,10,N,N,-,-1,-1
MULIFE.txt,1034244,1034416,172,10,N,N,-,-1,-1
MULIFE.txt,1034417,1034625,208,10,N,N,-,-1,-1
MULIFE.txt,1034626,1034849,223,10,N,N,-,-1,-1
MULIFE.txt,1034850,1035067,217,10,N,N,-,-1,-1
MULIFE.txt,1035072,1035338,266,10,N,N,-,-1,-1
MULIFE.txt,1035341,1035672,331,10,N,N,-,-1,-1
MULIFE.txt,1035673,1035912,239,10,N,N,-,-1,-1
MULIFE.txt,1035913,1036052,139,10,N,N,-,-1,-1
MULIFE.txt,1036054,1036407,353,10,N,N,-,-1,-1
MULIFE.txt,1036408,1036576,168,10,N,N,-,-1,-1
MULIFE.txt,1036577,1036754,177,10,N,N,-,-1,-1
MULIFE.txt,1036755,1036894,139,10,N,N,-,-1,-1
MULIFE.txt,1036895,1037035,140,10,N,N,-,-1,-1
MULIFE.txt,1037036,1037125,89,10,N,N,-,-1,-1
MULIFE.txt,1037126,1037267,141,10,N,N,-,-1,-1
MULIFE.txt,1037268,1037541,273,10,N,N,-,-1,-1
MULIFE.txt,1037542,1037676,134,10,N,N,-,-1,-1
MULIFE.txt,1037677,1037965,288,10,N,N,-,-1,-1
MULIFE.txt,1037967,1038095,128,10,N,N,-,-1,-1
MULIFE.txt,1038096,1038315,219,10,N,N,-,-1,-1
MULIFE.txt,1038316,1038568,252,10,N,N,-,-1,-1
MULIFE.txt,1038569,1038799,230,10,N,N,-,-1,-1
MULIFE.txt,1038804,1039255,451,10,N,N,-,-1,-1
MULIFE.txt,1039258,1039481,223,10,N,N,-,-1,-1
MULIFE.txt,1039482,1039647,165,10,N,N,-,-1,-1
MULIFE.txt,1039650,1039959,309,10,N,N,-,-1,-1
MULIFE.txt,1039960,1040122,162,10,N,N,-,-1,-1
MULIFE.txt,1040123,1040234,111,10,N,N,-,-1,-1
MULIFE.txt,1040235,1040366,131,10,N,N,-,-1,-1
MULIFE.txt,1040369,1040671,302,10,N,N,-,-1,-1
MULIFE.txt,1040673,1040837,164,10,N,N,-,-1,-1
MULIFE.txt,1040838,1041086,248,10,N,N,-,-1,-1
MULIFE.txt,1041087,1041445,358,10,N,N,-,-1,-1
MULIFE.txt,1041446,1041664,218,10,N,N,-,-1,-1
MULIFE.txt,1041665,1042028,363,10,N,N,-,-1,-1
MULIFE.txt,1042031,1042174,143,10,N,N,-,-1,-1
MULIFE.txt,1042175,1042372,197,10,N,N,-,-1,-1
MULIFE.txt,1042373,1042674,301,10,N,N,-,-1,-1
MULIFE.txt,1042675,1042836,161,10,N,N,-,-1,-1
MULIFE.txt,1042837,1043061,224,10,N,N,-,-1,-1
MULIFE.txt,1043064,1043351,287,10,N,N,-,-1,-1
MULIFE.txt,1043352,1043532,180,10,N,N,-,-1,-1
MULIFE.txt,1043534,1043724,190,10,N,N,-,-1,-1
MULIFE.txt,1043726,1043846,120,10,N,N,-,-1,-1
MULIFE.txt,1043849,1043984,135,10,N,N,-,-1,-1
MULIFE.txt,1043985,1044230,245,10,N,N,-,-1,-1
MULIFE.txt,1044232,1044557,325,10,N,N,-,-1,-1
MULIFE.txt,1044557,1044782,225,10,N,N,-,-1,-1
MULIFE.txt,1044787,1045108,321,10,N,N,-,-1,-1
MULIFE.txt,1045109,1045283,174,10,N,N,-,-1,-1
MULIFE.txt,1045284,1045392,108,10,N,N,-,-1,-1
MULIFE.txt,1045395,1045623,228,10,N,N,-,-1,-1
MULIFE.txt,1045624,1045759,135,10,N,N,-,-1,-1
MULIFE.txt,1045760,1045848,88,10,N,N,-,-1,-1
MULIFE.txt,1045849,1046020,171,10,N,N,-,-1,-1
MULIFE.txt,1046023,1046132,109,10,N,N,-,-1,-1
MULIFE.txt,1046134,1046298,164,10,N,N,-,-1,-1
MULIFE.txt,1046299,1046673,374,10,N,N,-,-1,-1
MULIFE.txt,1046674,1046877,203,10,N,N,-,-1,-1
MULIFE.txt,1046878,1047030,152,10,N,N,-,-1,-1
MULIFE.txt,1047030,1047190,160,10,N,N,-,-1,-1
MULIFE.txt,1047192,1047410,218,10,N,N,-,-1,-1
MULIFE.txt,1047411,1047625,214,10,N,N,-,-1,-1
MULIFE.txt,1047626,1047760,134,10,N,N,-,-1,-1
MULIFE.txt,1047761,1047998,237,10,N,N,-,-1,-1
MULIFE.txt,1047999,1048218,219,10,N,N,-,-1,-1
MULIFE.txt,1048221,1048564,343,10,N,N,-,-1,-1
MULIFE.txt,1048565,1048801,236,10,N,N,-,-1,-1
MULIFE.txt,1048802,1049045,243,10,N,N,-,-1,-1
MULIFE.txt,1049046,1049255,209,10,N,N,-,-1,-1
MULIFE.txt,1049256,1049456,200,10,N,N,-,-1,-1
MULIFE.txt,1049457,1049738,281,10,N,N,-,-1,-1
MULIFE.txt,1049743,1050043,300,10,N,N,-,-1,-1
MULIFE.txt,1050044,1050236,192,10,N,N,-,-1,-1
MULIFE.txt,1050237,1050516,279,10,N,N,-,-1,-1
MULIFE.txt,1050517,1050717,200,10,N,N,-,-1,-1
MULIFE.txt,1050720,1050938,218,10,N,N,-,-1,-1
MULIFE.txt,1050939,1051078,139,10,N,N,-,-1,-1
MULIFE.txt,1051080,1051288,208,10,N,N,-,-1,-1
MULIFE.txt,1051289,1051459,170,10,N,N,-,-1,-1
MULIFE.txt,1051460,1051677,217,10,N,N,-,-1,-1
MULIFE.txt,1051678,1051873,195,10,N,N,-,-1,-1
MULIFE.txt,1051874,1052182,308,10,N,N,-,-1,-1
MULIFE.txt,1052183,1052304,121,10,N,N,-,-1,-1
MULIFE.txt,1052304,1052423,119,10,N,N,-,-1,-1
MULIFE.txt,1052424,1052600,176,10,N,N,-,-1,-1
MULIFE.txt,1052601,1052724,123,10,N,N,-,-1,-1
MULIFE.txt,1052729,1052910,181,10,N,N,-,-1,-1
MULIFE.txt,1052911,1053069,158,10,N,N,-,-1,-1
MULIFE.txt,1053070,1053210,140,10,N,N,-,-1,-1
MULIFE.txt,1053211,1053352,141,10,N,N,-,-1,-1
MULIFE.txt,1053353,1053530,177,10,N,N,-,-1,-1
MULIFE.txt,1053531,1053719,188,10,N,N,-,-1,-1
MULIFE.txt,1053720,1054002,282,10,N,N,-,-1,-1
MULIFE.txt,1054003,1054238,235,10,N,N,-,-1,-1
MULIFE.txt,1054241,1054496,255,10,N,N,-,-1,-1
MULIFE.txt,1054498,1054612,114,10,N,N,-,-1,-1
MULIFE.txt,1054615,1054726,111,10,N,N,-,-1,-1
MULIFE.txt,1054726,1054897,171,10,N,N,-,-1,-1
MULIFE.txt,1054898,1055181,283,10,N,N,-,-1,-1
MULIFE.txt,1055182,1055425,243,10,N,N,-,-1,-1
MULIFE.txt,1055426,1055661,235,10,N,N,-,-1,-1
MULIFE.txt,1055662,1055786,124,10,N,N,-,-1,-1
MULIFE.txt,1055787,1055968,181,10,N,N,-,-1,-1
MULIFE.txt,1055969,1056365,396,10,N,N,-,-1,-1
MULIFE.txt,1056368,1056664,296,10,N,N,-,-1,-1
MULIFE.txt,1056665,1056896,231,10,N,N,-,-1,-1
MULIFE.txt,1056897,1057090,193,10,N,N,-,-1,-1
MULIFE.txt,1057092,1057286,194,10,N,N,-,-1,-1
MULIFE.txt,1057287,1057446,159,10,N,N,-,-1,-1
MULIFE.txt,1057451,1057670,219,10,N,N,-,-1,-1
MULIFE.txt,1057673,1057909,236,10,N,N,-,-1,-1
MULIFE.txt,1057910,1058168,258,10,N,N,-,-1,-1
MULIFE.txt,1058169,1058357,188,10,N,N,-,-1,-1
MULIFE.txt,1058358,1058463,105,10,N,N,-,-1,-1
MULIFE.txt,1058464,1058610,146,10,N,N,-,-1,-1
MULIFE.txt,1058611,1058743,132,10,N,N,-,-1,-1
MULIFE.txt,1058744,1058852,108,10,N,N,-,-1,-1
MULIFE.txt,1058854,1058983,129,10,N,N,-,-1,-1
MULIFE.txt,1058984,1059080,96,10,N,N,-,-1,-1
MULIFE.txt,1059081,1059216,135,10,N,N,-,-1,-1
MULIFE.txt,1059217,1059366,149,10,N,N,-,-1,-1
MULIFE.txt,1059367,1059511,144,10,N,N,-,-1,-1
MULIFE.txt,1059512,1059845,333,10,N,N,-,-1,-1
MULIFE.txt,1059846,1060035,189,10,N,N,-,-1,-1
MULIFE.txt,1060036,1060321,285,10,N,N,-,-1,-1
MULIFE.txt,1060322,1060606,284,10,N,N,-,-1,-1
MULIFE.txt,1060611,1060824,213,10,N,N,-,-1,-1
MULIFE.txt,1060825,1060965,140,10,N,N,-,-1,-1
MULIFE.txt,1060966,1061175,209,10,N,N,-,-1,-1
MULIFE.txt,1061176,1061327,151,10,N,N,-,-1,-1
MULIFE.txt,1061328,1061486,158,10,N,N,-,-1,-1
MULIFE.txt,1061489,1061661,172,10,N,N,-,-1,-1
MULIFE.txt,1061662,1061972,310,10,N,N,-,-1,-1
MULIFE.txt,1061973,1062317,344,10,N,N,-,-1,-1
MULIFE.txt,1062319,1062485,166,10,N,N,-,-1,-1
MULIFE.txt,1062486,1062735,249,10,N,N,-,-1,-1
MULIFE.txt,1062736,1063049,313,10,N,N,-,-1,-1
MULIFE.txt,1063050,1063324,274,10,N,N,-,-1,-1
MULIFE.txt,1063327,1063564,237,10,N,N,-,-1,-1
MULIFE.txt,1063565,1063725,160,10,N,N,-,-1,-1
MULIFE.txt,1063726,1063882,156,10,N,N,-,-1,-1
MULIFE.txt,1063883,1064038,155,10,N,N,-,-1,-1
MULIFE.txt,1064043,1064314,271,10,N,N,-,-1,-1
MULIFE.txt,1064317,1064541,224,10,N,N,-,-1,-1
MULIFE.txt,1064542,1064750,208,10,N,N,-,-1,-1
MULIFE.txt,1064752,1065003,251,10,N,N,-,-1,-1
MULIFE.txt,1065006,1065391,385,10,N,N,-,-1,-1
MULIFE.txt,1065394,1065742,348,10,N,N,-,-1,-1
MULIFE.txt,1065743,1065981,238,10,N,N,-,-1,-1
MULIFE.txt,1065982,1066207,225,10,N,N,-,-1,-1
MULIFE.txt,1066210,1066432,222,10,N,N,-,-1,-1
MULIFE.txt,1066435,1066628,193,10,N,N,-,-1,-1
MULIFE.txt,1066629,1066849,220,10,N,N,-,-1,-1
MULIFE.txt,1066850,1067013,163,10,N,N,-,-1,-1
MULIFE.txt,1067014,1067215,201,10,N,N,-,-1,-1
MULIFE.txt,1067217,1067424,207,10,N,N,-,-1,-1
MULIFE.txt,1067429,1067623,194,10,N,N,-,-1,-1
MULIFE.txt,1067624,1067856,232,10,N,N,-,-1,-1
MULIFE.txt,1067857,1068128,271,10,N,N,-,-1,-1
MULIFE.txt,1068129,1068433,304,10,N,N,-,-1,-1
MULIFE.txt,1068436,1068645,209,10,N,N,-,-1,-1
MULIFE.txt,1068646,1068884,238,10,N,N,-,-1,-1
MULIFE.txt,1068887,1069073,186,10,N,N,-,-1,-1
MULIFE.txt,1069076,1069387,311,10,N,N,-,-1,-1
MULIFE.txt,1069388,1069703,315,10,N,N,-,-1,-1
MULIFE.txt,1069704,1070048,344,10,N,N,-,-1,-1
MULIFE.txt,1070049,1070335,286,10,N,N,-,-1,-1
MULIFE.txt,1070336,1070670,334,10,N,N,-,-1,-1
MULIFE.txt,1070673,1070834,161,10,N,N,-,-1,-1
MULIFE.txt,1070836,1071000,164,10,N,N,-,-1,-1
MULIFE.txt,1071002,1071220,218,10,N,N,-,-1,-1
MULIFE.txt,1071222,1071567,345,10,N,N,-,-1,-1
MULIFE.txt,1071568,1071838,270,10,N,N,-,-1,-1
MULIFE.txt,1071840,1072074,234,10,N,N,-,-1,-1
MULIFE.txt,1072075,1072323,248,10,N,N,-,-1,-1
MULIFE.txt,1072325,1072577,252,10,N,N,-,-1,-1
MULIFE.txt,1072579,1072892,313,10,N,N,-,-1,-1
MULIFE.txt,1072893,1073065,172,10,N,N,-,-1,-1
MULIFE.txt,1073068,1073382,314,10,N,N,-,-1,-1
MULIFE.txt,1073384,1073769,385,10,N,N,-,-1,-1
MULIFE.txt,1073771,1074285,514,10,N,N,-,-1,-1
MULIFE.txt,1074286,1074714,428,10,N,N,-,-1,-1
MULIFE.txt,1074715,1074985,270,10,N,N,-,-1,-1
MULIFE.txt,1074986,1075218,232,10,N,N,-,-1,-1
MULIFE.txt,1075221,1075472,251,10,N,N,-,-1,-1
MULIFE.txt,1075474,1075766,292,10,N,N,-,-1,-1
MULIFE.txt,1075767,1076009,242,10,N,N,-,-1,-1
MULIFE.txt,1076011,1076379,368,10,N,N,-,-1,-1
MULIFE.txt,1076382,1076746,364,10,N,N,-,-1,-1
MULIFE.txt,1076747,1077101,354,10,N,N,-,-1,-1
MULIFE.txt,1077104,1077427,323,10,N,N,-,-1,-1
MULIFE.txt,1077430,1077678,248,10,N,N,-,-1,-1
MULIFE.txt,1077679,1077845,166,10,N,N,-,-1,-1
MULIFE.txt,1077846,1078128,282,10,N,N,-,-1,-1
MULIFE.txt,1078129,1078443,314,10,N,N,-,-1,-1
MULIFE.txt,1078446,1078575,129,10,N,N,-,-1,-1
MULIFE.txt,1078577,1078689,112,10,N,N,-,-1,-1
MULIFE.txt,1078690,1078772,82,10,N,N,-,-1,-1
MULIFE.txt,1078773,1078879,106,10,N,N,-,-1,-1
MULIFE.txt,1078880,1078964,84,10,N,N,-,-1,-1
MULIFE.txt,1078965,1079109,144,10,N,N,-,-1,-1
MULIFE.txt,1079110,1079236,126,10,N,N,-,-1,-1
MULIFE.txt,1079237,1079417,180,10,N,N,-,-1,-1
MULIFE.txt,1079418,1079553,135,10,N,N,-,-1,-1
MULIFE.txt,1079554,1079697,143,10,N,N,-,-1,-1
MULIFE.txt,1079700,1079898,198,10,N,N,-,-1,-1
MULIFE.txt,1079899,1080064,165,10,N,N,-,-1,-1
MULIFE.txt,1080065,1080256,191,10,N,N,-,-1,-1
MULIFE.txt,1080257,1080465,208,10,N,N,-,-1,-1
MULIFE.txt,1080468,1080624,156,10,N,N,-,-1,-1
MULIFE.txt,1080625,1080725,100,10,N,N,-,-1,-1
MULIFE.txt,1080725,1080848,123,10,N,N,-,-1,-1
MULIFE.txt,1080851,1080976,125,10,N,N,-,-1,-1
MULIFE.txt,1080977,1081112,135,10,N,N,-,-1,-1
MULIFE.txt,1081113,1081228,115,10,N,N,-,-1,-1
MULIFE.txt,1081231,1081500,269,10,N,N,-,-1,-1
MULIFE.txt,1081503,1081964,461,10,N,N,-,-1,-1
MULIFE.txt,1081965,1082331,366,10,N,N,-,-1,-1
MULIFE.txt,1082332,1082794,462,10,N,N,-,-1,-1
MULIFE.txt,1082794,1083047,253,10,N,N,-,-1,-1
MULIFE.txt,1083048,1083265,217,10,N,N,-,-1,-1
MULIFE.txt,1083266,1083521,255,10,N,N,-,-1,-1
MULIFE.txt,1083523,1083747,224,10,N,N,-,-1,-1
MULIFE.txt,1083748,1084015,267,10,N,N,-,-1,-1
MULIFE.txt,1084016,1084162,146,10,N,N,-,-1,-1
MULIFE.txt,1084163,1084341,178,10,N,N,-,-1,-1
MULIFE.txt,1084342,1084555,213,10,N,N,-,-1,-1
MULIFE.txt,1084557,1084881,324,10,N,N,-,-1,-1
MULIFE.txt,1084882,1085127,245,10,N,N,-,-1,-1
MULIFE.txt,1085128,1085242,114,10,N,N,-,-1,-1
MULIFE.txt,1085244,1085384,140,10,N,N,-,-1,-1
MULIFE.txt,1085385,1085466,81,10,N,N,-,-1,-1
MULIFE.txt,1085467,1085592,125,10,N,N,-,-1,-1
MULIFE.txt,1085595,1085734,139,10,N,N,-,-1,-1
MULIFE.txt,1085735,1086067,332,10,N,N,-,-1,-1
MULIFE.txt,1086069,1086212,143,10,N,N,-,-1,-1
MULIFE.txt,1086213,1086311,98,10,N,N,-,-1,-1
MULIFE.txt,1086311,1086452,141,10,N,N,-,-1,-1
MULIFE.txt,1086453,1086660,207,10,N,N,-,-1,-1
MULIFE.txt,1086661,1087053,392,10,N,N,-,-1,-1
MULIFE.txt,1087054,1087336,282,10,N,N,-,-1,-1
MULIFE.txt,1087337,1087486,149,10,N,N,-,-1,-1
MULIFE.txt,1087487,1087680,193,10,N,N,-,-1,-1
MULIFE.txt,1087681,1088027,346,10,N,N,-,-1,-1
MULIFE.txt,1088028,1088138,110,10,N,N,-,-1,-1
MULIFE.txt,1088140,1088265,125,10,N,N,-,-1,-1
MULIFE.txt,1088266,1088757,491,10,N,N,-,-1,-1
MULIFE.txt,1088758,1088900,142,10,N,N,-,-1,-1
MULIFE.txt,1088901,1089365,464,10,N,N,-,-1,-1
MULIFE.txt,1089368,1089714,346,10,N,N,-,-1,-1
MULIFE.txt,1089717,1089959,242,10,N,N,-,-1,-1
MULIFE.txt,1089960,1090198,238,10,N,N,-,-1,-1
MULIFE.txt,1090200,1090440,240,10,N,N,-,-1,-1
MULIFE.txt,1090441,1090706,265,10,N,N,-,-1,-1
MULIFE.txt,1090707,1090966,259,10,N,N,-,-1,-1
MULIFE.txt,1090967,1091158,191,10,N,N,-,-1,-1
MULIFE.txt,1091159,1091316,157,10,N,N,-,-1,-1
MULIFE.txt,1091317,1091522,205,10,N,N,-,-1,-1
MULIFE.txt,1091523,1091824,301,10,N,N,-,-1,-1
MULIFE.txt,1091825,1092143,318,10,N,N,-,-1,-1
MULIFE.txt,1092144,1092269,125,10,N,N,-,-1,-1
MULIFE.txt,1092274,1092627,353,10,N,N,-,-1,-1
MULIFE.txt,1092628,1092716,88,10,N,N,-,-1,-1
MULIFE.txt,1092717,1093166,449,10,N,N,-,-1,-1
MUSING.txt,0,2031,2031,10,N,N,-,-1,-1
MUSING.txt,2032,5332,3300,10,N,N,-,-1,-1
MUSING.txt,5334,6953,1619,10,N,N,-,-1,-1
MUSING.txt,6955,9101,2146,10,N,N,-,-1,-1
MUSING.txt,9102,10190,1088,10,N,N,-,-1,-1
MUSING.txt,10191,13362,3171,10,N,Y,1452197105481,12624,12995
MUSING.txt,13363,16595,3232,10,Y,Y,1452197298690,13035,13782
MUSING.txt,16598,20142,3544,10,Y,Y,1452552834876,19293,19784
MUSING.txt,20143,22263,2120,10,Y,Y,1452552963937,20183,20500
MUSING.txt,22264,25106,2842,10,N,Y,1452633313155,24231,24696
MUSING.txt,25107,27628,2521,10,Y,N,-,-1,-1
MUSING.txt,27631,30171,2540,10,Y,Y,1452633925920,28052,28470
MUSING.txt,30172,32621,2449,10,Y,Y,1452636055684,32302,33666
MUSING.txt,32622,35333,2711,10,N,Y,1452636055684,32302,33666
MUSING.txt,35334,36925,1591,10,N,N,-,-1,-1
MUSING.txt,36926,40078,3152,10,N,Y,1452636825724,38193,39614
MUSING.txt,40079,42424,2345,10,N,Y,1452637642930,39672,40424
MUSING.txt,42425,44381,1956,10,Y,Y,1452638022184,43114,43497
MUSING.txt,44384,46355,1971,10,N,N,-,-1,-1
MUSING.txt,46357,47640,1283,10,N,N,-,-1,-1
MUSING.txt,47642,49001,1359,10,N,N,-,-1,-1
MUSING.txt,49002,51834,2832,10,Y,Y,1452808243495,49009,49545
MUSING.txt,51835,54299,2464,10,Y,Y,1452810063851,53076,53440
MUSING.txt,54300,56634,2334,10,Y,Y,1452810619236,55897,56755
MUSING.txt,56636,57931,1295,10,N,Y,1452811308084,57736,58274
MUSING.txt,57932,59990,2058,10,Y,Y,1452811308084,57736,58274
MUSING.txt,59993,63053,3060,10,N,Y,1453045736851,60609,61623
MUSING.txt,63054,64633,1579,10,N,Y,1453049225205,63792,64405
MUSING.txt,64635,67707,3072,10,N,Y,1453050717776,66941,67842
MUSING.txt,67708,69846,2138,10,Y,Y,1453051275841,69685,69839
MUSING.txt,69849,72340,2491,10,Y,Y,1453051493027,69834,70210
MUSING.txt,72343,74686,2343,10,Y,Y,1453053339147,74161,74769
MUSING.txt,74687,76920,2233,10,Y,Y,1453054180764,75925,76428
MUSING.txt,76921,79269,2348,10,Y,Y,1453054446277,77703,78851
MUSING.txt,79270,81323,2053,10,N,N,-,-1,-1
MUSING.txt,81324,84243,2919,10,N,N,-,-1,-1
MUSING.txt,84244,87168,2924,10,N,N,-,-1,-1
MUSING.txt,87169,89578,2409,10,N,N,-,-1,-1
MUSING.txt,89579,91641,2062,10,N,N,-,-1,-1
MUSING.txt,91642,93242,1600,10,N,N,-,-1,-1
MUSING.txt,93243,95661,2418,10,N,N,-,-1,-1
MUSING.txt,95662,98360,2698,10,N,N,-,-1,-1
MUSING.txt,98361,100553,2192,10,Y,N,-,-1,-1
MUSING.txt,100554,102131,1577,10,N,N,-,-1,-1
MUSING.txt,102132,104761,2629,10,Y,N,-,-1,-1
MUSING.txt,104763,107009,2246,10,Y,Y,1461619406602,106559,106998
MUSING.txt,107010,109171,2161,10,Y,Y,1461619728886,107422,107922
MUSING.txt,109172,110711,1539,10,N,Y,1473711868958,108578,109622
MUSING.txt,110712,111821,1109,10,N,N,-,-1,-1
MUSING.txt,111822,112840,1018,10,N,N,-,-1,-1
MUSING.txt,112845,114566,1721,10,N,Y,1473713496783,113607,114030
MUSING.txt,114568,116195,1627,10,N,N,-,-1,-1
MUSING.txt,116196,118785,2589,10,Y,N,-,-1,-1
MUSING.txt,118786,119771,985,10,N,N,-,-1,-1
MUSING.txt,119774,121414,1640,10,N,N,-,-1,-1
MUSING.txt,121415,123455,2040,10,N,Y,1473715568245,121644,121983
MUSING.txt,123456,125145,1689,10,N,N,-,-1,-1
MUSING.txt,125148,126366,1218,10,N,N,-,-1,-1
MUSING.txt,126371,127838,1467,10,N,Y,1483014061568,126874,127277
MUSING.txt,127839,129587,1748,10,N,N,-,-1,-1
MUSING.txt,129588,130518,930,10,N,N,-,-1,-1
MUSING.txt,130521,132124,1603,10,N,N,-,-1,-1
MUSING.txt,132125,133428,1303,10,N,N,-,-1,-1
MUSING.txt,133429,134840,1411,10,N,N,-,-1,-1
MUSING.txt,134841,136560,1719,10,N,N,-,-1,-1
MUSING.txt,136562,137318,756,10,N,N,-,-1,-1
MUSING.txt,137319,138082,763,10,N,N,-,-1,-1
MUSING.txt,138083,139306,1223,10,N,N,-,-1,-1
MUSING.txt,139307,140608,1301,10,N,N,-,-1,-1
MUSING.txt,140611,141518,907,10,N,Y,1483023499163,140609,141162
MUSING.txt,141519,142555,1036,10,N,N,-,-1,-1
MUSING.txt,142556,143757,1201,10,N,N,-,-1,-1
MUSING.txt,143759,145244,1485,10,N,N,-,-1,-1
MUSING.txt,145245,147165,1920,10,N,N,-,-1,-1
MUSING.txt,147166,149185,2019,10,N,N,-,-1,-1
MUSING.txt,149186,150428,1242,10,N,N,-,-1,-1
MUSING.txt,150429,151732,1303,10,N,N,-,-1,-1
MUSING.txt,151733,153020,1287,10,N,Y,1483028149168,151984,152882
MUSING.txt,153023,153879,856,10,N,N,-,-1,-1
MUSING.txt,153882,155091,1209,10,N,Y,1483028673856,154833,155406
MUSING.txt,155092,155936,844,10,N,Y,1483028673856,154833,155406
MUSING.txt,155937,157273,1336,10,N,N,-,-1,-1
MUSING.txt,157274,158805,1531,10,N,N,-,-1,-1
MUSING.txt,158810,160919,2109,10,N,N,-,-1,-1
MUSING.txt,160922,163099,2177,10,N,N,-,-1,-1
MUSING.txt,163100,164486,1386,10,N,N,-,-1,-1
MUSING.txt,164489,166301,1812,10,N,N,-,-1,-1
MUSING.txt,166302,167710,1408,10,N,N,-,-1,-1
MUSING.txt,167711,171419,3708,10,Y,N,-,-1,-1
MUSING.txt,171420,173067,1647,10,N,N,-,-1,-1
MUSING.txt,173068,175814,2746,10,Y,N,-,-1,-1
MUSING.txt,175815,177854,2039,10,Y,N,-,-1,-1
MUSING.txt,177857,179955,2098,10,N,N,-,-1,-1
MUSING.txt,179958,184121,4163,10,N,N,-,-1,-1
MUSING.txt,184123,186990,2867,10,N,N,-,-1,-1
MUSING.txt,186993,189894,2901,10,N,N,-,-1,-1
MUSING.txt,189895,191129,1234,10,N,N,-,-1,-1
MUSING.txt,191130,193046,1916,10,N,N,-,-1,-1
MUSING.txt,193049,195645,2596,10,Y,N,-,-1,-1
MUSING.txt,195646,198215,2569,10,N,N,-,-1,-1
MUSING.txt,198216,201553,3337,10,N,N,-,-1,-1
MUSING.txt,201555,203384,1829,10,N,N,-,-1,-1
MUSING.txt,203385,206537,3152,10,N,N,-,-1,-1
MUSING.txt,206538,208906,2368,10,N,N,-,-1,-1
MUSING.txt,208907,211402,2495,10,Y,N,-,-1,-1
MUSING.txt,211403,213516,2113,10,N,N,-,-1,-1
MUSING.txt,213517,215539,2022,10,Y,N,-,-1,-1
MUSING.txt,215540,216769,1229,10,N,N,-,-1,-1
MUSING.txt,216770,219481,2711,10,N,N,-,-1,-1
MUSING.txt,219482,221131,1649,10,N,N,-,-1,-1
MUSING.txt,221132,223044,1912,10,N,N,-,-1,-1
MUSING.txt,223046,225905,2859,10,Y,N,-,-1,-1
MUSING.txt,225906,227482,1576,10,Y,N,-,-1,-1
MUSING.txt,227483,229246,1763,10,N,N,-,-1,-1
MUSING.txt,229247,231627,2380,10,Y,N,-,-1,-1
MUSING.txt,231628,233646,2018,10,Y,N,-,-1,-1
MUSING.txt,233647,235828,2181,10,N,N,-,-1,-1
MUSING.txt,235829,236876,1047,10,N,N,-,-1,-1
MUSING.txt,236877,239539,2662,10,N,N,-,-1,-1
MUSING.txt,239540,241555,2015,10,Y,N,-,-1,-1
MUSING.txt,241558,244048,2490,10,Y,N,-,-1,-1
MUSING.txt,244049,245523,1474,10,N,N,-,-1,-1
MUSING.txt,245525,247855,2330,10,Y,N,-,-1,-1
MUSING.txt,247856,250260,2404,10,N,N,-,-1,-1
MUSING.txt,250262,253282,3020,10,N,N,-,-1,-1
MUSING.txt,253283,256209,2926,10,N,N,-,-1,-1
MUSING.txt,256210,259012,2802,10,N,N,-,-1,-1
MUSING.txt,259013,262395,3382,10,N,N,-,-1,-1
MUSING.txt,262396,266006,3610,10,N,N,-,-1,-1
MUSING.txt,266007,267379,1372,10,N,N,-,-1,-1
MUSING.txt,267380,268912,1532,10,N,N,-,-1,-1
MUSING.txt,268913,269674,761,10,N,N,-,-1,-1
MUSING.txt,269675,270404,729,10,N,N,-,-1,-1
MUSING.txt,270405,271743,1338,10,Y,N,-,-1,-1
MUSING.txt,271744,274058,2314,10,N,N,-,-1,-1
MUSING.txt,274059,276537,2478,10,Y,N,-,-1,-1
MUSING.txt,276538,277914,1376,10,N,N,-,-1,-1
MUSING.txt,277915,279789,1874,10,Y,N,-,-1,-1
MUSING.txt,279792,280978,1186,10,N,N,-,-1,-1
MUSING.txt,280979,283295,2316,10,Y,N,-,-1,-1
MUSING.txt,283298,285420,2122,10,Y,N,-,-1,-1
MUSING.txt,285421,288388,2967,10,N,N,-,-1,-1
MUSING.txt,288389,290995,2606,10,N,N,-,-1,-1
MUSING.txt,290998,291991,993,10,N,N,-,-1,-1
MUSING.txt,291992,293368,1376,10,N,N,-,-1,-1
MUSING.txt,293369,294787,1418,10,N,N,-,-1,-1
MUSING.txt,294792,297078,2286,10,N,N,-,-1,-1
MUSING.txt,297081,299170,2089,10,N,N,-,-1,-1
MUSING.txt,299173,301829,2656,10,N,N,-,-1,-1
MUSING.txt,301832,304975,3143,10,N,N,-,-1,-1
MUSING.txt,304976,307421,2445,10,N,N,-,-1,-1
MUSING.txt,307422,308858,1436,10,N,N,-,-1,-1
MUSING.txt,308859,310095,1236,10,N,N,-,-1,-1
MUSING.txt,310096,312100,2004,10,N,N,-,-1,-1
MUSING.txt,312101,314427,2326,10,N,N,-,-1,-1
MUSING.txt,314429,315467,1038,10,N,N,-,-1,-1
MUSING.txt,315468,316615,1147,10,N,N,-,-1,-1
MUSING.txt,316616,318685,2069,10,N,N,-,-1,-1
MUSING.txt,318686,320250,1564,10,N,N,-,-1,-1
MUSING.txt,320255,323050,2795,10,Y,N,-,-1,-1
MUSING.txt,323053,326059,3006,10,N,N,-,-1,-1
MUSING.txt,326061,328225,2164,10,Y,N,-,-1,-1
MUSING.txt,328226,330248,2022,10,N,N,-,-1,-1
MUSING.txt,330251,332165,1914,10,N,N,-,-1,-1
MUSING.txt,332167,334237,2070,10,N,N,-,-1,-1
MUSING.txt,334240,336994,2754,10,N,N,-,-1,-1
MUSING.txt,336995,337932,937,10,N,N,-,-1,-1
MUSING.txt,337937,340692,2755,10,N,N,-,-1,-1
MUSING.txt,340697,343136,2439,10,N,N,-,-1,-1
MUSING.txt,343137,345365,2228,10,Y,N,-,-1,-1
MUSING.txt,345366,347041,1675,10,N,N,-,-1,-1
MUSING.txt,347044,348985,1941,10,N,N,-,-1,-1
MUSING.txt,348986,350907,1921,10,N,N,-,-1,-1
MUSING.txt,350908,352359,1451,10,N,N,-,-1,-1
MUSING.txt,352360,353963,1603,10,N,N,-,-1,-1
MUSING.txt,353964,356409,2445,10,N,N,-,-1,-1
MUSING.txt,356410,358775,2365,10,N,N,-,-1,-1
MUSING.txt,358776,360193,1417,10,N,N,-,-1,-1
MUSING.txt,360194,361530,1336,10,N,N,-,-1,-1
MUSING.txt,361531,363329,1798,10,N,N,-,-1,-1
MUSING.txt,363330,364924,1594,10,Y,N,-,-1,-1
MUSING.txt,364927,366458,1531,10,N,N,-,-1,-1
MUSING.txt,366459,367904,1445,10,N,N,-,-1,-1
MUSING.txt,367907,368834,927,10,N,N,-,-1,-1
MUSING.txt,368835,370564,1729,10,Y,N,-,-1,-1
MUSING.txt,370567,372031,1464,10,N,N,-,-1,-1
MUSING.txt,372036,372947,911,10,N,N,-,-1,-1
MUSING.txt,372949,374832,1883,10,N,N,-,-1,-1
MUSING.txt,374833,377018,2185,10,N,N,-,-1,-1
MUSING.txt,377019,378231,1212,10,N,N,-,-1,-1
MUSING.txt,378232,380408,2176,10,N,N,-,-1,-1
MUSING.txt,380409,383545,3136,10,N,N,-,-1,-1
MUSING.txt,383546,385632,2086,10,N,N,-,-1,-1
MUSING.txt,385633,387714,2081,10,N,N,-,-1,-1
MUSING.txt,387715,391334,3619,10,N,N,-,-1,-1
MUSING.txt,391335,392983,1648,10,N,N,-,-1,-1
MUSING.txt,392984,394900,1916,10,N,N,-,-1,-1
MUSING.txt,394901,398899,3998,10,Y,N,-,-1,-1
MUSING.txt,398900,400665,1765,10,Y,N,-,-1,-1
MUSING.txt,400666,402003,1337,10,N,N,-,-1,-1
MUSING.txt,402008,404348,2340,10,Y,N,-,-1,-1
MUSING.txt,404349,406295,1946,10,N,N,-,-1,-1
MUSING.txt,406296,408294,1998,10,Y,N,-,-1,-1
MUSING.txt,408295,410350,2055,10,N,N,-,-1,-1
MUSING.txt,410352,410654,302,10,N,N,-,-1,-1
MUSING.txt,410656,410939,283,10,N,N,-,-1,-1
MUSING.txt,410941,411152,211,10,N,N,-,-1,-1
MUSING.txt,411154,411359,205,10,N,N,-,-1,-1
MUSING.txt,411362,411620,258,10,N,N,-,-1,-1
MUSING.txt,411622,411900,278,10,N,N,-,-1,-1
MUSING.txt,411902,412137,235,10,N,N,-,-1,-1
MUSING.txt,412138,413511,1373,10,N,N,-,-1,-1
MUSING.txt,413514,415226,1712,10,N,N,-,-1,-1
MUSING.txt,415227,416444,1217,10,N,N,-,-1,-1
MUSING.txt,416447,417564,1117,10,N,N,-,-1,-1
MUSING.txt,417565,418925,1360,10,N,N,-,-1,-1
MUSING.txt,418926,420558,1632,10,N,N,-,-1,-1
MUSING.txt,420559,423456,2897,10,N,N,-,-1,-1
MUSING.txt,423457,424704,1247,10,N,N,-,-1,-1
MUSING.txt,424706,426540,1834,10,N,N,-,-1,-1
MUSING.txt,426541,428681,2140,10,N,N,-,-1,-1
MUSING.txt,428683,431067,2384,10,Y,N,-,-1,-1
MUSING.txt,431068,432005,937,10,N,N,-,-1,-1
MUSING.txt,432006,433859,1853,10,N,N,-,-1,-1
MUSING.txt,433860,435658,1798,10,N,N,-,-1,-1
MUSING.txt,435659,437472,1813,10,Y,N,-,-1,-1
MUSING.txt,437473,439134,1661,10,N,N,-,-1,-1
MUSING.txt,439135,440722,1587,10,N,N,-,-1,-1
MUSING.txt,440725,442336,1611,10,Y,N,-,-1,-1
MUSING.txt,442341,444790,2449,10,N,N,-,-1,-1
MUSING.txt,444792,446998,2206,10,N,N,-,-1,-1
MUSING.txt,446999,448440,1441,10,N,N,-,-1,-1
MUSING.txt,448441,449538,1097,10,N,N,-,-1,-1
MUSING.txt,449543,452185,2642,10,N,N,-,-1,-1
MUSING.txt,452187,454546,2359,10,N,N,-,-1,-1
MUSING.txt,454547,457052,2505,10,N,N,-,-1,-1
MUSING.txt,457053,460561,3508,10,N,N,-,-1,-1
MUSING.txt,460564,463362,2798,10,N,N,-,-1,-1
MUSING.txt,463363,465458,2095,10,N,N,-,-1,-1
MUSING.txt,465461,467032,1571,10,N,N,-,-1,-1
MUSING.txt,467035,468870,1835,10,Y,N,-,-1,-1
MUSING.txt,468872,471117,2245,10,N,N,-,-1,-1
MUSING.txt,471118,474242,3124,10,N,N,-,-1,-1
MUSING.txt,474243,475878,1635,10,N,N,-,-1,-1
MUSING.txt,475879,477823,1944,10,Y,N,-,-1,-1
MUSING.txt,477828,479605,1777,10,Y,N,-,-1,-1
MUSING.txt,479606,480678,1072,10,N,N,-,-1,-1
MUSING.txt,480679,482628,1949,10,N,N,-,-1,-1
MUSING.txt,482629,485223,2594,10,N,N,-,-1,-1
MUSING.txt,485224,487798,2574,10,N,N,-,-1,-1
MUSING.txt,487799,490303,2504,10,N,N,-,-1,-1
MUSING.txt,490304,491630,1326,10,N,N,-,-1,-1
MUSING.txt,491631,493944,2313,10,N,N,-,-1,-1
MUSING.txt,493947,495994,2047,10,N,N,-,-1,-1
MUSING.txt,495995,497827,1832,10,N,N,-,-1,-1
MUSING.txt,497828,500093,2265,10,Y,N,-,-1,-1
MUSING.txt,500094,501482,1388,10,N,N,-,-1,-1
MUSING.txt,501483,503637,2154,10,N,N,-,-1,-1
MUSING.txt,503638,505180,1542,10,N,N,-,-1,-1
MUSING.txt,505181,508225,3044,10,Y,N,-,-1,-1
MUSING.txt,508228,509902,1674,10,N,N,-,-1,-1
MUSREM.txt,8,503,495,10,N,N,-,-1,-1
MUSREM.txt,506,1107,601,10,N,N,-,-1,-1
MUSREM.txt,1110,2089,979,10,N,N,-,-1,-1
MUSREM.txt,2092,3533,1441,10,N,N,-,-1,-1
MUSREM.txt,3534,6163,2629,10,Y,N,-,-1,-1
MUSREM.txt,6164,8068,1904,10,N,N,-,-1,-1
MUSREM.txt,8073,9736,1663,10,N,N,-,-1,-1
MUSREM.txt,9739,11056,1317,10,Y,Y,1445944603888,10479,11042
MUSREM.txt,11057,12228,1171,10,Y,Y,1445946913032,11418,11636
MUSREM.txt,12231,14146,1915,10,Y,N,-,-1,-1
MUSREM.txt,14147,15790,1643,10,Y,Y,1445947674116,15382,15779
MUSREM.txt,15793,17145,1352,10,Y,Y,1445948029052,16577,17138
MUSREM.txt,17146,18365,1219,10,N,Y,1445955109644,17888,18866
MUSREM.txt,18366,19915,1549,10,Y,Y,1445955109644,17888,18866
MUSREM.txt,19920,21455,1535,10,Y,Y,1445955591123,20528,20953
MUSREM.txt,21456,23214,1758,10,Y,Y,1445955912022,23018,23382
MUSREM.txt,23215,24958,1743,10,Y,Y,1445955912022,23018,23382
MUSREM.txt,24959,26583,1624,10,Y,Y,1445956802191,26011,26302
MUSREM.txt,26584,27907,1323,10,N,N,-,-1,-1
MUSREM.txt,27908,29590,1682,10,Y,Y,1445957251664,27927,28212
MUSREM.txt,29591,30673,1082,10,N,N,-,-1,-1
MUSREM.txt,30674,32267,1593,10,Y,Y,1445957972281,31471,31861
MUSREM.txt,32268,34012,1744,10,Y,N,-,-1,-1
MUSREM.txt,34014,35318,1304,10,Y,Y,1445963721474,35258,35532
MUSREM.txt,35319,36598,1279,10,N,Y,1445963721474,35258,35532
MUSREM.txt,36601,38154,1553,10,N,Y,1445964475278,37399,37589
MUSREM.txt,38155,39850,1695,10,Y,Y,1445964873481,39066,39377
MUSREM.txt,39851,41297,1446,10,Y,Y,1445965566465,40802,41605
MUSREM.txt,41298,43021,1723,10,Y,Y,1445965566465,40802,41605
MUSREM.txt,43022,44281,1259,10,N,Y,1445966436521,43605,43853
MUSREM.txt,44282,45491,1209,10,Y,Y,1446052439741,45238,45486
MUSREM.txt,45494,47146,1652,10,Y,Y,1446052861415,46803,47133
MUSREM.txt,47147,48584,1437,10,Y,Y,1446053757053,48262,48584
MUSREM.txt,48585,50111,1526,10,Y,Y,1446054206870,48925,49472
MUSREM.txt,50114,51673,1559,10,Y,Y,1446635157507,51003,51207
MUSREM.txt,51674,53341,1667,10,N,N,-,-1,-1
MUSREM.txt,53342,54948,1606,10,Y,N,-,-1,-1
MUSREM.txt,54949,56861,1912,10,Y,Y,1446636156055,56380,57523
MUSREM.txt,56862,58685,1823,10,Y,Y,1446636156055,56380,57523
MUSREM.txt,58686,59904,1218,10,Y,N,-,-1,-1
MUSREM.txt,59905,61696,1791,10,Y,Y,1446637443845,60250,60839
MUSREM.txt,61699,63318,1619,10,Y,Y,1446638321422,63089,63407
MUSREM.txt,63319,64868,1549,10,Y,Y,1446638321422,63089,63407
MUSREM.txt,64869,66473,1604,10,N,Y,1446640118196,66272,66825
MUSREM.txt,66475,68492,2017,10,Y,Y,1446640118196,66272,66825
MUSREM.txt,68493,70046,1553,10,N,Y,1446640889918,69534,70949
MUSREM.txt,70049,71343,1294,10,Y,Y,1446640889918,69534,70949
MUSREM.txt,71344,73077,1733,10,N,N,-,-1,-1
MUSREM.txt,73078,74767,1689,10,N,N,-,-1,-1
MUSREM.txt,74768,76396,1628,10,Y,N,-,-1,-1
MUSREM.txt,76397,78200,1803,10,Y,N,-,-1,-1
MUSREM.txt,78202,79862,1660,10,Y,N,-,-1,-1
MUSREM.txt,79863,81193,1330,10,N,N,-,-1,-1
MUSREM.txt,81196,82531,1335,10,Y,Y,1446647463097,81750,82066
MUSREM.txt,82532,83825,1293,10,Y,N,-,-1,-1
MUSREM.txt,83828,85572,1744,10,Y,N,-,-1,-1
MUSREM.txt,85574,86942,1368,10,N,Y,1446648222034,86772,88203
MUSREM.txt,86943,88729,1786,10,Y,Y,1446648222034,86772,88203
MUSREM.txt,88730,90134,1404,10,Y,Y,1446719749074,89471,89818
MUSREM.txt,90135,91801,1666,10,Y,Y,1446720066011,90716,91222
MUSREM.txt,91802,93468,1666,10,Y,Y,1446720539477,92682,93428
MUSREM.txt,93471,94597,1126,10,Y,Y,1446721175262,93832,94969
MUSREM.txt,94598,95713,1115,10,Y,Y,1446721440313,95396,95514
MUSREM.txt,95714,96855,1141,10,N,Y,1446721729201,95506,95816
MUSREM.txt,96856,98093,1237,10,Y,Y,1446722309879,97182,97409
MUSREM.txt,98096,99924,1828,10,Y,Y,1446722777424,97629,98299
MUSREM.txt,99925,101494,1569,10,Y,Y,1446743095300,100170,100734
MUSREM.txt,101495,103287,1792,10,Y,Y,1446743750418,103215,103356
MUSREM.txt,103290,104715,1425,10,N,Y,1446743750418,103215,103356
MUSREM.txt,104715,107260,2545,10,Y,Y,1446744408545,105127,106612
MUSREM.txt,107261,108854,1593,10,Y,N,-,-1,-1
MUSREM.txt,108855,110440,1585,10,Y,N,-,-1,-1
MUSREM.txt,110441,111881,1440,10,Y,Y,1446744877240,111104,111542
MUSREM.txt,111884,113693,1809,10,Y,N,-,-1,-1
MUSREM.txt,113694,115792,2098,10,N,N,-,-1,-1
MUSREM.txt,115797,117363,1566,10,N,N,-,-1,-1
MUSREM.txt,117366,119735,2369,10,Y,Y,1446808893671,117606,117864
MUSREM.txt,119736,121536,1800,10,Y,Y,1446809343172,120380,120695
MUSREM.txt,121538,122993,1455,10,Y,N,-,-1,-1
MUSREM.txt,122998,124473,1475,10,N,Y,1446809771688,123931,124283
MUSREM.txt,124476,126034,1558,10,N,N,-,-1,-1
MUSREM.txt,126037,128217,2180,10,Y,N,-,-1,-1
MUSREM.txt,128218,129501,1283,10,Y,N,-,-1,-1
MUSREM.txt,129504,131638,2134,10,Y,N,-,-1,-1
MUSREM.txt,131643,133207,1564,10,Y,N,-,-1,-1
MUSREM.txt,133208,134746,1538,10,Y,N,-,-1,-1
MUSREM.txt,134747,136464,1717,10,N,N,-,-1,-1
MUSREM.txt,136467,138391,1924,10,N,Y,1446810408665,136481,136987
MUSREM.txt,138394,140011,1617,10,Y,N,-,-1,-1
MUSREM.txt,140012,141604,1592,10,N,N,-,-1,-1
MUSREM.txt,141605,143434,1829,10,N,N,-,-1,-1
MUSREM.txt,143437,144488,1051,10,Y,Y,1446810866600,143464,144041
MUSREM.txt,144491,145974,1483,10,Y,Y,1446811109129,144788,145068
MUSREM.txt,145976,147518,1542,10,Y,Y,1446811837346,147380,148123
MUSREM.txt,147519,148584,1065,10,N,Y,1446811837346,147380,148123
MUSREM.txt,148585,150281,1696,10,Y,N,-,-1,-1
MUSREM.txt,150282,152026,1744,10,Y,Y,1446813333984,151500,152176
MUSREM.txt,152027,153148,1121,10,N,Y,1446813333984,151500,152176
MUSREM.txt,153151,154756,1605,10,Y,Y,1446813762750,154311,154910
MUSREM.txt,154757,156629,1872,10,Y,Y,1446813762750,154311,154910
MUSREM.txt,156630,158270,1640,10,Y,Y,1446814509617,157137,157477
MUSREM.txt,158271,159915,1644,10,Y,Y,1446818906646,158638,159239
MUSREM.txt,159916,160788,872,10,N,N,-,-1,-1
MUSREM.txt,160791,162272,1481,10,N,Y,1446819402984,161235,162017
MUSREM.txt,162273,163512,1239,10,N,N,-,-1,-1
MUSREM.txt,163515,164910,1395,10,N,N,-,-1,-1
MUSREM.txt,164911,166508,1597,10,N,N,-,-1,-1
MUSREM.txt,166511,168423,1912,10,Y,Y,1446820062767,167097,167662
MUSREM.txt,168426,170594,2168,10,Y,Y,1446820734391,170585,172593
MUSREM.txt,170595,172385,1790,10,Y,Y,1446820734391,170585,172593
MUSREM.txt,172386,173397,1011,10,Y,Y,1446821453239,172722,173763
MUSREM.txt,173398,174812,1414,10,Y,Y,1446821453239,172722,173763
MUSREM.txt,174815,176327,1512,10,Y,Y,1446821880661,175939,176466
MUSREM.txt,176328,177920,1592,10,Y,Y,1446823433860,177434,177715
MUSREM.txt,177921,179790,1869,10,Y,Y,1446823931858,179105,180424
MUSREM.txt,179795,180824,1029,10,Y,Y,1446823931858,179105,180424
MUSREM.txt,180824,182543,1719,10,Y,N,-,-1,-1
MUSREM.txt,182543,183661,1118,10,Y,N,-,-1,-1
MUSREM.txt,183662,185664,2002,10,Y,N,-,-1,-1
MUSREM.txt,185665,188077,2412,10,N,N,-,-1,-1
MUSREM.txt,188078,190008,1930,10,N,N,-,-1,-1
MUSREM.txt,190009,191620,1611,10,N,N,-,-1,-1
MUSREM.txt,191621,193212,1591,10,N,N,-,-1,-1
MUSREM.txt,193215,195487,2272,10,N,N,-,-1,-1
MUSREM.txt,195489,197463,1974,10,Y,N,-,-1,-1
MUSREM.txt,197464,198983,1519,10,N,Y,1446824933321,197918,199597
MUSREM.txt,198985,200574,1589,10,N,Y,1447063241953,200523,201321
MUSREM.txt,200575,202011,1436,10,Y,Y,1447063241953,200523,201321
MUSREM.txt,202012,203104,1092,10,N,N,-,-1,-1
MUSREM.txt,203105,204462,1357,10,Y,N,-,-1,-1
MUSREM.txt,204467,205840,1373,10,N,N,-,-1,-1
MUSREM.txt,205841,207226,1385,10,N,N,-,-1,-1
MUSREM.txt,207227,208300,1073,10,N,Y,1447063940500,207257,208280
MUSREM.txt,208302,209394,1092,10,N,N,-,-1,-1
MUSREM.txt,209397,210660,1263,10,N,Y,1447064379607,210331,210573
MUSREM.txt,210661,212365,1704,10,Y,Y,1447065110339,211796,212188
MUSREM.txt,212366,213659,1293,10,Y,Y,1447065659153,213218,213654
MUSREM.txt,213660,215058,1398,10,Y,Y,1448538454094,214861,215222
MUSREM.txt,215059,216430,1371,10,Y,Y,1448538803111,215417,216014
MUSREM.txt,216433,217595,1162,10,Y,N,-,-1,-1
MUSREM.txt,217596,218761,1165,10,Y,Y,1448539695891,217596,217897
MUSREM.txt,218762,220119,1357,10,Y,Y,1448540487155,218969,220902
MUSREM.txt,220120,221435,1315,10,Y,Y,1448540487155,218969,220902
MUSREM.txt,221436,222839,1403,10,Y,N,-,-1,-1
MUSREM.txt,222840,224823,1983,10,Y,N,-,-1,-1
MUSREM.txt,224826,225981,1155,10,Y,N,-,-1,-1
MUSREM.txt,225982,227935,1953,10,Y,N,-,-1,-1
MUSREM.txt,227938,229444,1506,10,N,N,-,-1,-1
MUSREM.txt,229447,230781,1334,10,N,N,-,-1,-1
MUSREM.txt,230782,232252,1470,10,N,N,-,-1,-1
MUSREM.txt,232253,233888,1635,10,N,N,-,-1,-1
MUSREM.txt,233889,235862,1973,10,N,N,-,-1,-1
MUSREM.txt,235863,237224,1361,10,N,N,-,-1,-1
MUSREM.txt,237226,238850,1624,10,Y,N,-,-1,-1
MUSREM.txt,238851,240283,1432,10,Y,Y,1448634950635,239410,239860
MUSREM.txt,240283,240484,201,10,N,N,-,-1,-1
MUSREM.txt,240489,242193,1704,10,Y,N,-,-1,-1
MUSREM.txt,242195,243701,1506,10,N,N,-,-1,-1
MUSREM.txt,243702,245871,2169,10,Y,N,-,-1,-1
MUSREM.txt,245872,247780,1908,10,N,N,-,-1,-1
MUSREM.txt,247781,249238,1457,10,N,Y,1448635413557,249132,249521
MUSREM.txt,249239,251013,1774,10,Y,Y,1448635980588,250398,250825
MUSREM.txt,251014,252004,990,10,N,N,-,-1,-1
MUSREM.txt,252006,253813,1807,10,N,N,-,-1,-1
MUSREM.txt,253814,255353,1539,10,N,N,-,-1,-1
MUSREM.txt,255354,256862,1508,10,N,Y,1448636605363,256225,257318
MUSREM.txt,256863,258159,1296,10,N,Y,1448636605363,256225,257318
MUSREM.txt,258160,259738,1578,10,Y,N,-,-1,-1
MUSREM.txt,259739,261235,1496,10,N,Y,1448637072058,259739,260989
MUSREM.txt,261238,262472,1234,10,N,Y,1448637339862,262368,262868
MUSREM.txt,262473,264449,1976,10,Y,Y,1448637339862,262368,262868
MUSREM.txt,264450,266073,1623,10,N,Y,1448640538484,265221,266337
MUSREM.txt,266074,267312,1238,10,Y,Y,1448640538484,265221,266337
MUSREM.txt,267313,268535,1222,10,Y,Y,1448971601346,266958,268184
MUSREM.txt,268536,269752,1216,10,N,Y,1448972027684,268678,270113
MUSREM.txt,269753,270863,1110,10,Y,Y,1448972027684,268678,270113
MUSREM.txt,270866,272433,1567,10,Y,Y,1448972712694,271727,272544
MUSREM.txt,272434,273612,1178,10,N,Y,1448972712694,271727,272544
MUSREM.txt,273613,275057,1444,10,Y,Y,1448973059320,274486,274617
MUSREM.txt,275060,276287,1227,10,N,Y,1448973292285,274886,275121
MUSREM.txt,276288,277299,1011,10,N,Y,1448980124717,276863,277295
MUSREM.txt,277302,278978,1676,10,N,N,-,-1,-1
MUSREM.txt,278979,280567,1588,10,N,Y,1448980436772,279074,279287
MUSREM.txt,280568,281723,1155,10,N,Y,1448981398336,280787,280977
MUSREM.txt,281724,283105,1381,10,Y,Y,1448981870937,282204,283086
MUSREM.txt,283106,284368,1262,10,N,Y,1448982281247,283638,283867
MUSREM.txt,284369,286196,1827,10,Y,Y,1448983037053,285585,285882
MUSREM.txt,286197,287349,1152,10,Y,Y,1448988789823,287061,287381
MUSREM.txt,287350,288208,858,10,N,Y,1448988789823,287061,287381
MUSREM.txt,288209,289355,1146,10,Y,Y,1448989363526,288790,289249
MUSREM.txt,289356,291207,1851,10,Y,Y,1448989871144,289506,290112
MUSREM.txt,291208,293246,2038,10,Y,Y,1448990639546,291228,292408
MUSREM.txt,293247,294852,1605,10,N,Y,1448991259482,294449,294734
MUSREM.txt,294853,296701,1848,10,N,N,-,-1,-1
MUSREM.txt,296702,298318,1616,10,N,N,-,-1,-1
MUSREM.txt,298319,300008,1689,10,N,N,-,-1,-1
MUSREM.txt,300009,301515,1506,10,N,N,-,-1,-1
MUSREM.txt,301520,303359,1839,10,N,N,-,-1,-1
MUSREM.txt,303359,304815,1456,10,N,N,-,-1,-1
MUSREM.txt,304820,305988,1168,10,N,N,-,-1,-1
OUSELEY.txt,0,2717,2717,10,N,N,-,-1,-1
OUSELEY.txt,2718,7977,5259,10,N,N,-,-1,-1
OUSELEY.txt,7978,11499,3521,10,N,N,-,-1,-1
OUSELEY.txt,11499,11884,385,10,N,N,-,-1,-1
OUSELEY.txt,11885,13030,1145,10,N,N,-,-1,-1
OUSELEY.txt,13031,14592,1561,10,N,N,-,-1,-1
OUSELEY.txt,14593,15276,683,10,N,N,-,-1,-1
OUSELEY.txt,15278,16358,1080,10,N,N,-,-1,-1
OUSELEY.txt,16360,17625,1265,10,N,N,-,-1,-1
OUSELEY.txt,17626,20284,2658,10,N,N,-,-1,-1
OUSELEY.txt,20289,21780,1491,10,N,N,-,-1,-1
OUSELEY.txt,21783,23987,2204,10,Y,N,-,-1,-1
OUSELEY.txt,23988,25971,1983,10,N,N,-,-1,-1
OUSELEY.txt,25972,26594,622,10,N,N,-,-1,-1
OUSELEY.txt,26595,27361,766,10,N,N,-,-1,-1
OUSELEY.txt,27362,29377,2015,10,Y,N,-,-1,-1
OUSELEY.txt,29380,30036,656,10,N,N,-,-1,-1
OUSELEY.txt,30037,32106,2069,10,N,N,-,-1,-1
OUSELEY.txt,32107,33459,1352,10,N,N,-,-1,-1
OUSELEY.txt,33462,34856,1394,10,N,N,-,-1,-1
OUSELEY.txt,34859,36988,2129,10,N,N,-,-1,-1
OUSELEY.txt,36993,39113,2120,10,N,N,-,-1,-1
OUSELEY.txt,39116,39892,776,10,N,N,-,-1,-1
OUSELEY.txt,39895,41391,1496,10,Y,N,-,-1,-1
OUSELEY.txt,41392,42946,1554,10,Y,Y,1436610229204,41646,43959
OUSELEY.txt,42949,44464,1515,10,N,Y,1436610229204,41646,43959
OUSELEY.txt,44465,45472,1007,10,N,N,-,-1,-1
OUSELEY.txt,45473,45711,238,10,N,N,-,-1,-1
OUSELEY.txt,45714,47109,1395,10,N,N,-,-1,-1
OUSELEY.txt,47110,48116,1006,10,N,N,-,-1,-1
OUSELEY.txt,48117,49306,1189,10,N,N,-,-1,-1
OUSELEY.txt,49307,50911,1604,10,N,N,-,-1,-1
OUSELEY.txt,50912,52472,1560,10,N,N,-,-1,-1
OUSELEY.txt,52473,54066,1593,10,N,N,-,-1,-1
OUSELEY.txt,54068,55522,1454,10,N,N,-,-1,-1
OUSELEY.txt,55523,57459,1936,10,N,N,-,-1,-1
OUSELEY.txt,57460,58604,1144,10,N,N,-,-1,-1
OUSELEY.txt,58605,59714,1109,10,N,N,-,-1,-1
OUSELEY.txt,59715,61223,1508,10,Y,N,-,-1,-1
OUSELEY.txt,61225,62613,1388,10,N,N,-,-1,-1
OUSELEY.txt,62616,64202,1586,10,N,N,-,-1,-1
OUSELEY.txt,64203,65739,1536,10,N,N,-,-1,-1
OUSELEY.txt,65740,67887,2147,10,N,N,-,-1,-1
OUSELEY.txt,67888,69565,1677,10,N,N,-,-1,-1
OUSELEY.txt,69566,71384,1818,10,N,N,-,-1,-1
OUSELEY.txt,71385,72595,1210,10,N,N,-,-1,-1
OUSELEY.txt,72596,74090,1494,10,N,N,-,-1,-1
OUSELEY.txt,74091,75370,1279,10,N,N,-,-1,-1
OUSELEY.txt,75372,76974,1602,10,N,N,-,-1,-1
OUSELEY.txt,76975,78862,1887,10,N,N,-,-1,-1
OUSELEY.txt,78865,79704,839,10,N,N,-,-1,-1
OUSELEY.txt,79705,81984,2279,10,N,N,-,-1,-1
OUSELEY.txt,81989,83298,1309,10,N,N,-,-1,-1
OUSELEY.txt,83299,84628,1329,10,N,N,-,-1,-1
OUSELEY.txt,84629,85962,1333,10,N,N,-,-1,-1
OUSELEY.txt,85963,87693,1730,10,Y,N,-,-1,-1
OUSELEY.txt,87694,88959,1265,10,N,N,-,-1,-1
OUSELEY.txt,88960,91112,2152,10,N,N,-,-1,-1
OUSELEY.txt,91117,92964,1847,10,N,N,-,-1,-1
OUSELEY.txt,92965,94873,1908,10,N,N,-,-1,-1
OUSELEY.txt,94874,96532,1658,10,N,N,-,-1,-1
OUSELEY.txt,96535,98099,1564,10,N,N,-,-1,-1
OUSELEY.txt,98100,101036,2936,10,N,N,-,-1,-1
OUSELEY.txt,101037,104592,3555,10,N,N,-,-1,-1
OUSELEY.txt,104593,106929,2336,10,N,N,-,-1,-1
OUSELEY.txt,106930,108082,1152,10,N,N,-,-1,-1
OUSELEY.txt,108085,108710,625,10,N,N,-,-1,-1
OUSELEY.txt,108711,109749,1038,10,N,N,-,-1,-1
OUSELEY.txt,109750,110800,1050,10,N,N,-,-1,-1
OUSELEY.txt,110801,112272,1471,10,N,N,-,-1,-1
OUSELEY.txt,112273,113993,1720,10,N,N,-,-1,-1
OUSELEY.txt,113994,115738,1744,10,N,N,-,-1,-1
OUSELEY.txt,115739,116523,784,10,N,N,-,-1,-1
OUSELEY.txt,116524,117182,658,10,N,N,-,-1,-1
OUSELEY.txt,117183,117709,526,10,N,N,-,-1,-1
OUSELEY.txt,117710,118332,622,10,N,N,-,-1,-1
OUSELEY.txt,118334,119609,1275,10,N,N,-,-1,-1
OUSELEY.txt,119610,120692,1082,10,N,N,-,-1,-1
OUSELEY.txt,120693,122869,2176,10,N,N,-,-1,-1
OUSELEY.txt,122874,124695,1821,10,N,N,-,-1,-1
OUSELEY.txt,124698,125949,1251,10,N,N,-,-1,-1
OUSELEY.txt,125954,127694,1740,10,N,N,-,-1,-1
OUSELEY.txt,127695,130424,2729,10,N,N,-,-1,-1
OUSELEY.txt,130425,133012,2587,10,N,N,-,-1,-1
OUSELEY.txt,133013,134821,1808,10,N,N,-,-1,-1
OUSELEY.txt,134826,137303,2477,10,N,N,-,-1,-1
OUSELEY.txt,137304,139093,1789,10,N,N,-,-1,-1
OUSELEY.txt,139095,140135,1040,10,N,N,-,-1,-1
OUSELEY.txt,140136,141576,1440,10,N,N,-,-1,-1
OUSELEY.txt,141577,143442,1865,10,N,N,-,-1,-1
OUSELEY.txt,143443,145220,1777,10,N,N,-,-1,-1
OUSELEY.txt,145221,146392,1171,10,N,N,-,-1,-1
OUSELEY.txt,146392,147938,1546,10,N,N,-,-1,-1
OUSELEY.txt,147941,149910,1969,10,N,N,-,-1,-1
OUSELEY.txt,149911,151443,1532,10,N,N,-,-1,-1
OUSELEY.txt,151444,153069,1625,10,N,N,-,-1,-1
OUSELEY.txt,153074,154635,1561,10,N,N,-,-1,-1
OUSELEY.txt,154636,156501,1865,10,N,N,-,-1,-1
OUSELEY.txt,156504,159047,2543,10,N,N,-,-1,-1
OUSELEY.txt,159052,160588,1536,10,N,N,-,-1,-1
OUSELEY.txt,160589,162313,1724,10,N,N,-,-1,-1
OUSELEY.txt,162316,163684,1368,10,N,N,-,-1,-1
OUSELEY.txt,163685,164969,1284,10,N,N,-,-1,-1
OUSELEY.txt,164971,166549,1578,10,Y,N,-,-1,-1
OUSELEY.txt,166554,167474,920,10,N,N,-,-1,-1
OUSELEY.txt,167475,169098,1623,10,N,N,-,-1,-1
OUSELEY.txt,169103,170816,1713,10,N,N,-,-1,-1
OUSELEY.txt,170818,171843,1025,10,N,N,-,-1,-1
OUSELEY.txt,171844,173491,1647,10,N,N,-,-1,-1
OUSELEY.txt,173496,175237,1741,10,N,N,-,-1,-1
OUSELEY.txt,175238,176674,1436,10,N,N,-,-1,-1
OUSELEY.txt,176675,178383,1708,10,N,N,-,-1,-1
OUSELEY.txt,178384,179910,1526,10,N,N,-,-1,-1
OUSELEY.txt,179912,181871,1959,10,N,N,-,-1,-1
OUSELEY.txt,181874,183417,1543,10,N,N,-,-1,-1
OUSELEY.txt,183418,184728,1310,10,N,N,-,-1,-1
OUSELEY.txt,184729,187029,2300,10,N,N,-,-1,-1
OUSELEY.txt,187030,188607,1577,10,N,N,-,-1,-1
OUSELEY.txt,188610,188776,166,10,N,N,-,-1,-1
OUSELEY.txt,188781,190159,1378,10,N,N,-,-1,-1
OUSELEY.txt,190162,192742,2580,10,N,N,-,-1,-1
OUSELEY.txt,192745,194610,1865,10,N,N,-,-1,-1
OUSELEY.txt,194611,196878,2267,10,N,N,-,-1,-1
OUSELEY.txt,196879,198079,1200,10,N,N,-,-1,-1
OUSELEY.txt,198080,199165,1085,10,N,N,-,-1,-1
OUSELEY.txt,199168,199790,622,10,N,N,-,-1,-1
OUSELEY.txt,199793,201607,1814,10,N,N,-,-1,-1
OUSELEY.txt,201608,204639,3031,10,N,N,-,-1,-1
OUSELEY.txt,204640,206723,2083,10,N,N,-,-1,-1
OUSELEY.txt,206728,207400,672,10,N,N,-,-1,-1
OUSELEY.txt,207401,208830,1429,10,N,N,-,-1,-1
OUSELEY.txt,208831,210227,1396,10,N,N,-,-1,-1
OUSELEY.txt,210228,211888,1660,10,N,N,-,-1,-1
OUSELEY.txt,211889,213120,1231,10,N,N,-,-1,-1
OUSELEY.txt,213121,215034,1913,10,N,N,-,-1,-1
OUSELEY.txt,215035,216688,1653,10,N,N,-,-1,-1
OUSELEY.txt,216689,218741,2052,10,N,N,-,-1,-1
OUSELEY.txt,218742,220669,1927,10,N,N,-,-1,-1
OUSELEY.txt,220670,222632,1962,10,N,N,-,-1,-1
OUSELEY.txt,222634,225768,3134,10,N,N,-,-1,-1
OUSELEY.txt,225769,228460,2691,10,N,N,-,-1,-1
OUSELEY.txt,228461,230308,1847,10,N,N,-,-1,-1
OUSELEY.txt,230309,232064,1755,10,Y,N,-,-1,-1
OUSELEY.txt,232065,233938,1873,10,N,N,-,-1,-1
OUSELEY.txt,233940,236606,2666,10,N,N,-,-1,-1
OUSELEY.txt,236608,239140,2532,10,N,N,-,-1,-1
OUSELEY.txt,239141,241587,2446,10,N,N,-,-1,-1
OUSELEY.txt,241588,243379,1791,10,N,N,-,-1,-1
OUSELEY.txt,243380,246112,2732,10,N,N,-,-1,-1
OUSELEY.txt,246115,248069,1954,10,N,N,-,-1,-1
OUSELEY.txt,248070,249824,1754,10,N,N,-,-1,-1
OUSELEY.txt,249825,252161,2336,10,N,N,-,-1,-1
OUSELEY.txt,252162,253663,1501,10,N,N,-,-1,-1
OUSELEY.txt,253666,254712,1046,10,N,N,-,-1,-1
OUSELEY.txt,254713,256121,1408,10,N,N,-,-1,-1
OUSELEY.txt,256122,258429,2307,10,N,N,-,-1,-1
OUSELEY.txt,258434,259785,1351,10,N,N,-,-1,-1
OUSELEY.txt,259786,261936,2150,10,Y,N,-,-1,-1
OUSELEY.txt,261941,263289,1348,10,N,N,-,-1,-1
OUSELEY.txt,263290,264623,1333,10,N,N,-,-1,-1
OUSELEY.txt,264628,266240,1612,10,N,N,-,-1,-1
OUSELEY.txt,266241,267618,1377,10,N,N,-,-1,-1
OUSELEY.txt,267619,269357,1738,10,N,N,-,-1,-1
OUSELEY.txt,269358,270678,1320,10,N,N,-,-1,-1
OUSELEY.txt,270679,272055,1376,10,N,N,-,-1,-1
OUSELEY.txt,272056,273300,1244,10,N,N,-,-1,-1
OUSELEY.txt,273301,274840,1539,10,N,N,-,-1,-1
OUSELEY.txt,274842,276194,1352,10,N,N,-,-1,-1
OUSELEY.txt,276194,277418,1224,10,N,N,-,-1,-1
OUSELEY.txt,277419,278746,1327,10,N,N,-,-1,-1
OUSELEY.txt,278747,280408,1661,10,Y,N,-,-1,-1
OUSELEY.txt,280409,281819,1410,10,N,N,-,-1,-1
OUSELEY.txt,281820,283834,2014,10,N,N,-,-1,-1
OUSELEY.txt,283835,284797,962,10,N,N,-,-1,-1
OUSELEY.txt,284799,285086,287,10,N,N,-,-1,-1
OUSELEY.txt,285088,285646,558,10,N,N,-,-1,-1
OUSELEY.txt,285651,286387,736,10,N,N,-,-1,-1
OUSELEY.txt,286388,286769,381,10,N,N,-,-1,-1
OUSELEY.txt,286772,287132,360,10,N,N,-,-1,-1
OUSELEY.txt,287135,287518,383,10,N,N,-,-1,-1
OUSELEY.txt,287520,287845,325,10,N,N,-,-1,-1
OUSELEY.txt,287848,288159,311,10,N,N,-,-1,-1
OUSELEY.txt,288160,288416,256,10,N,N,-,-1,-1
OUSELEY.txt,288417,289786,1369,10,N,N,-,-1,-1
OUSELEY.txt,289786,291602,1816,10,N,N,-,-1,-1
OUSELEY.txt,291603,292582,979,10,N,N,-,-1,-1
OUSELEY.txt,292585,293288,703,10,N,N,-,-1,-1
OUSELEY.txt,293289,293487,198,10,N,N,-,-1,-1
OUSELEY.txt,293488,293654,166,10,N,N,-,-1,-1
OUSELEY.txt,293657,294276,619,10,N,N,-,-1,-1
OUSELEY.txt,294277,295186,909,10,N,N,-,-1,-1
OUSELEY.txt,295187,295369,182,10,N,N,-,-1,-1
OUSELEY.txt,295371,295622,251,10,N,N,-,-1,-1
OUSELEY.txt,295623,295904,281,10,N,N,-,-1,-1
OUSELEY.txt,295905,296098,193,10,N,N,-,-1,-1
OUSELEY.txt,296101,296329,228,10,N,N,-,-1,-1
OUSELEY.txt,296330,296501,171,10,N,N,-,-1,-1
OUSELEY.txt,296506,296792,286,10,N,N,-,-1,-1
OUSELEY.txt,296793,297939,1146,10,N,N,-,-1,-1
OUSELEY.txt,297941,298446,505,10,N,N,-,-1,-1
OUSELEY.txt,298449,299979,1530,10,Y,N,-,-1,-1
OUSELEY.txt,299980,300593,613,10,N,N,-,-1,-1
OUSELEY.txt,300594,302282,1688,10,N,N,-,-1,-1
OUSELEY.txt,302284,303542,1258,10,N,N,-,-1,-1
OUSELEY.txt,303548,304394,846,10,N,N,-,-1,-1
OUSELEY.txt,304396,305204,808,10,N,N,-,-1,-1
OUSELEY.txt,305205,306599,1394,10,N,N,-,-1,-1
OUSELEY.txt,306600,307759,1159,10,N,N,-,-1,-1
OUSELEY.txt,307765,308684,919,10,N,N,-,-1,-1
OUSELEY.txt,308685,310097,1412,10,N,N,-,-1,-1
OUSELEY.txt,310100,311789,1689,10,N,N,-,-1,-1
OUSELEY.txt,311790,312360,570,10,N,N,-,-1,-1
OUSELEY.txt,312363,312943,580,10,N,N,-,-1,-1
PILGRIM.txt,0,899,899,10,N,N,-,-1,-1
PILGRIM.txt,901,1873,972,10,N,N,-,-1,-1
PILGRIM.txt,1874,2348,474,10,N,N,-,-1,-1
PILGRIM.txt,2348,3998,1650,10,N,N,-,-1,-1
PILGRIM.txt,3999,5712,1713,10,N,N,-,-1,-1
PILGRIM.txt,5713,7179,1466,10,N,N,-,-1,-1
PILGRIM.txt,7180,8981,1801,10,N,N,-,-1,-1
PILGRIM.txt,8982,10734,1752,10,N,N,-,-1,-1
PILGRIM.txt,10737,12925,2188,10,N,N,-,-1,-1
PILGRIM.txt,12928,15542,2614,10,N,N,-,-1,-1
PILGRIM.txt,15545,18630,3085,10,N,N,-,-1,-1
PILGRIM.txt,18633,20292,1659,10,N,N,-,-1,-1
PILGRIM.txt,20295,22074,1779,10,N,N,-,-1,-1
PILGRIM.txt,22075,23276,1201,10,N,N,-,-1,-1
PILGRIM.txt,23279,24751,1472,10,N,N,-,-1,-1
PILGRIM.txt,24752,26233,1481,10,N,N,-,-1,-1
PILGRIM.txt,26234,28187,1953,10,N,N,-,-1,-1
PILGRIM.txt,28190,29828,1638,10,N,N,-,-1,-1
PILGRIM.txt,29829,31161,1332,10,N,N,-,-1,-1
PILGRIM.txt,31162,32271,1109,10,N,N,-,-1,-1
PILGRIM.txt,32272,33952,1680,10,N,N,-,-1,-1
PILGRIM.txt,33954,35681,1727,10,N,N,-,-1,-1
PILGRIM.txt,35683,36689,1006,10,N,N,-,-1,-1
PILGRIM.txt,36690,37937,1247,10,Y,N,-,-1,-1
PILGRIM.txt,37940,39056,1116,10,Y,N,-,-1,-1
PILGRIM.txt,39057,40501,1444,10,N,N,-,-1,-1
PILGRIM.txt,40502,41956,1454,10,Y,N,-,-1,-1
PILGRIM.txt,41957,42966,1009,10,N,N,-,-1,-1
PILGRIM.txt,42967,44278,1311,10,N,N,-,-1,-1
PILGRIM.txt,44279,45811,1532,10,Y,N,-,-1,-1
PILGRIM.txt,45812,46908,1096,10,N,N,-,-1,-1
PILGRIM.txt,46909,48633,1724,10,N,N,-,-1,-1
PILGRIM.txt,48635,49449,814,10,N,N,-,-1,-1
PILGRIM.txt,49450,50805,1355,10,N,Y,1430808947621,50425,50979
PILGRIM.txt,50806,52022,1216,10,N,Y,1430808947621,50425,50979
PILGRIM.txt,52025,53225,1200,10,N,N,-,-1,-1
PILGRIM.txt,53226,54478,1252,10,N,N,-,-1,-1
PILGRIM.txt,54479,55873,1394,10,N,N,-,-1,-1
PILGRIM.txt,55875,57583,1708,10,N,N,-,-1,-1
PILGRIM.txt,57584,58947,1363,10,N,N,-,-1,-1
PILGRIM.txt,58948,60062,1114,10,N,N,-,-1,-1
PILGRIM.txt,60063,61328,1265,10,N,N,-,-1,-1
PILGRIM.txt,61331,62329,998,10,N,N,-,-1,-1
PILGRIM.txt,62332,64265,1933,10,Y,N,-,-1,-1
PILGRIM.txt,64268,65494,1226,10,N,N,-,-1,-1
PILGRIM.txt,65499,66599,1100,10,N,N,-,-1,-1
PILGRIM.txt,66600,67901,1301,10,N,N,-,-1,-1
PILGRIM.txt,67902,68936,1034,10,N,N,-,-1,-1
PILGRIM.txt,68938,70153,1215,10,N,N,-,-1,-1
PILGRIM.txt,70154,71294,1140,10,N,N,-,-1,-1
PILGRIM.txt,71295,72810,1515,10,N,N,-,-1,-1
PILGRIM.txt,72812,73965,1153,10,N,N,-,-1,-1
PILGRIM.txt,73971,75067,1096,10,N,N,-,-1,-1
PILGRIM.txt,75068,76317,1249,10,N,N,-,-1,-1
PILGRIM.txt,76320,77904,1584,10,N,Y,1432737524261,76323,77903
PILGRIM.txt,77905,79284,1379,10,N,N,-,-1,-1
PILGRIM.txt,79285,80536,1251,10,N,N,-,-1,-1
PILGRIM.txt,80539,82083,1544,10,N,N,-,-1,-1
PILGRIM.txt,82084,83563,1479,10,N,N,-,-1,-1
PILGRIM.txt,83568,85002,1434,10,N,N,-,-1,-1
PILGRIM.txt,85004,86567,1563,10,N,N,-,-1,-1
PILGRIM.txt,86568,87989,1421,10,N,N,-,-1,-1
PILGRIM.txt,87990,89407,1417,10,N,N,-,-1,-1
PILGRIM.txt,89408,90254,846,10,N,N,-,-1,-1
PILGRIM.txt,90255,91796,1541,10,N,N,-,-1,-1
PILGRIM.txt,91797,93451,1654,10,N,N,-,-1,-1
PILGRIM.txt,93452,94832,1380,10,N,N,-,-1,-1
PILGRIM.txt,94833,96232,1399,10,N,N,-,-1,-1
PILGRIM.txt,96233,97541,1308,10,Y,N,-,-1,-1
PILGRIM.txt,97543,99319,1776,10,N,N,-,-1,-1
PILGRIM.txt,99320,100625,1305,10,N,N,-,-1,-1
PILGRIM.txt,100626,102085,1459,10,N,N,-,-1,-1
PILGRIM.txt,102086,103100,1014,10,N,N,-,-1,-1
PILGRIM.txt,103101,104318,1217,10,N,N,-,-1,-1
PILGRIM.txt,104321,105626,1305,10,N,N,-,-1,-1
PILGRIM.txt,105627,106758,1131,10,N,N,-,-1,-1
PILGRIM.txt,106759,107936,1177,10,N,N,-,-1,-1
PILGRIM.txt,107937,109274,1337,10,N,N,-,-1,-1
PILGRIM.txt,109275,110504,1229,10,N,N,-,-1,-1
PILGRIM.txt,110505,111824,1319,10,N,N,-,-1,-1
PILGRIM.txt,111825,113255,1430,10,N,N,-,-1,-1
PILGRIM.txt,113256,114898,1642,10,N,N,-,-1,-1
PILGRIM.txt,114901,116026,1125,10,N,N,-,-1,-1
PILGRIM.txt,116027,117230,1203,10,N,N,-,-1,-1
PILGRIM.txt,117231,119184,1953,10,N,N,-,-1,-1
PILGRIM.txt,119185,120452,1267,10,N,N,-,-1,-1
PILGRIM.txt,120457,121842,1385,10,N,N,-,-1,-1
PILGRIM.txt,121843,123048,1205,10,N,N,-,-1,-1
PILGRIM.txt,123049,124007,958,10,Y,N,-,-1,-1
PILGRIM.txt,124010,125148,1138,10,N,N,-,-1,-1
PILGRIM.txt,125149,126315,1166,10,N,N,-,-1,-1
PILGRIM.txt,126316,127308,992,10,N,N,-,-1,-1
PILGRIM.txt,127309,128755,1446,10,N,N,-,-1,-1
PILGRIM.txt,128756,130212,1456,10,N,Y,1432747851515,129932,131402
PILGRIM.txt,130213,131368,1155,10,Y,Y,1432747851515,129932,131402
PILGRIM.txt,131369,132205,836,10,N,Y,1432747851515,129932,131402
PILGRIM.txt,132206,133083,877,10,N,N,-,-1,-1
PILGRIM.txt,133084,134587,1503,10,N,N,-,-1,-1
PILGRIM.txt,134588,135651,1063,10,N,Y,1432792603693,134919,135643
PILGRIM.txt,135652,136847,1195,10,N,N,-,-1,-1
PILGRIM.txt,136849,137702,853,10,N,N,-,-1,-1
PILGRIM.txt,137704,139324,1620,10,N,N,-,-1,-1
PILGRIM.txt,139329,141239,1910,10,N,N,-,-1,-1
PILGRIM.txt,141244,142291,1047,10,N,N,-,-1,-1
PILGRIM.txt,142292,143228,936,10,N,N,-,-1,-1
PILGRIM.txt,143229,144020,791,10,N,N,-,-1,-1
PILGRIM.txt,144025,145863,1838,10,N,N,-,-1,-1
PILGRIM.txt,145866,147272,1406,10,N,Y,1432795431094,146203,147710
PILGRIM.txt,147273,148805,1532,10,N,Y,1432795431094,146203,147710
PILGRIM.txt,148806,150282,1476,10,N,N,-,-1,-1
PILGRIM.txt,150283,151594,1311,10,N,N,-,-1,-1
PILGRIM.txt,151596,153067,1471,10,N,N,-,-1,-1
PILGRIM.txt,153068,154734,1666,10,N,N,-,-1,-1
PILGRIM.txt,154735,156143,1408,10,N,N,-,-1,-1
PILGRIM.txt,156144,157625,1481,10,N,N,-,-1,-1
PILGRIM.txt,157626,158702,1076,10,N,N,-,-1,-1
PILGRIM.txt,158703,159845,1142,10,N,N,-,-1,-1
PILGRIM.txt,159846,161474,1628,10,N,N,-,-1,-1
PILGRIM.txt,161475,162811,1336,10,Y,N,-,-1,-1
PILGRIM.txt,162812,164490,1678,10,N,N,-,-1,-1
PILGRIM.txt,164491,165645,1154,10,N,N,-,-1,-1
PILGRIM.txt,165647,167223,1576,10,N,N,-,-1,-1
PILGRIM.txt,167224,168466,1242,10,N,N,-,-1,-1
PILGRIM.txt,168467,169847,1380,10,N,N,-,-1,-1
PILGRIM.txt,169848,171416,1568,10,N,N,-,-1,-1
PILGRIM.txt,171419,172891,1472,10,N,N,-,-1,-1
PILGRIM.txt,172892,175065,2173,10,N,N,-,-1,-1
PILGRIM.txt,175066,176539,1473,10,N,N,-,-1,-1
PILGRIM.txt,176541,177989,1448,10,N,N,-,-1,-1
PILGRIM.txt,177990,179386,1396,10,N,N,-,-1,-1
PILGRIM.txt,179388,180864,1476,10,N,N,-,-1,-1
PILGRIM.txt,180865,182405,1540,10,N,N,-,-1,-1
PILGRIM.txt,182408,183240,832,10,N,N,-,-1,-1
PILGRIM.txt,183241,184507,1266,10,N,N,-,-1,-1
PILGRIM.txt,184508,185775,1267,10,N,N,-,-1,-1
PILGRIM.txt,185776,186832,1056,10,N,N,-,-1,-1
PILGRIM.txt,186833,187507,674,10,N,N,-,-1,-1
PILGRIM.txt,187512,188301,789,10,N,N,-,-1,-1
PILGRIM.txt,188302,188967,665,10,N,N,-,-1,-1
PILGRIM.txt,188968,189867,899,10,N,N,-,-1,-1
PILGRIM.txt,189868,190883,1015,10,N,N,-,-1,-1
PILGRIM.txt,190884,191828,944,10,N,N,-,-1,-1
PILGRIM.txt,191829,193057,1228,10,N,N,-,-1,-1
PILGRIM.txt,193060,193984,924,10,N,N,-,-1,-1
PILGRIM.txt,193985,195296,1311,10,N,N,-,-1,-1
PILGRIM.txt,195297,196602,1305,10,N,N,-,-1,-1
PILGRIM.txt,196603,197935,1332,10,N,N,-,-1,-1
PILGRIM.txt,197938,199259,1321,10,N,N,-,-1,-1
PILGRIM.txt,199260,200296,1036,10,N,N,-,-1,-1
PILGRIM.txt,200297,201674,1377,10,N,N,-,-1,-1
PILGRIM.txt,201675,203010,1335,10,N,N,-,-1,-1
PILGRIM.txt,203011,203985,974,10,N,N,-,-1,-1
PILGRIM.txt,203986,204966,980,10,N,N,-,-1,-1
PILGRIM.txt,204967,206052,1085,10,N,N,-,-1,-1
PILGRIM.txt,206053,207237,1184,10,N,N,-,-1,-1
PILGRIM.txt,207238,208853,1615,10,N,N,-,-1,-1
PILGRIM.txt,208854,210465,1611,10,N,N,-,-1,-1
PILGRIM.txt,210466,211569,1103,10,N,N,-,-1,-1
PILGRIM.txt,211570,212780,1210,10,N,N,-,-1,-1
PILGRIM.txt,212783,213836,1053,10,N,N,-,-1,-1
PILGRIM.txt,213837,214952,1115,10,N,N,-,-1,-1
PILGRIM.txt,214953,216034,1081,10,N,N,-,-1,-1
PILGRIM.txt,216035,217250,1215,10,N,N,-,-1,-1
PILGRIM.txt,217253,218217,964,10,N,N,-,-1,-1
PILGRIM.txt,218218,218667,449,10,N,N,-,-1,-1
PILGRIM.txt,218668,219833,1165,10,N,N,-,-1,-1
PILGRIM.txt,219834,220631,797,10,N,N,-,-1,-1
PILGRIM.txt,220632,221661,1029,10,N,N,-,-1,-1
PILGRIM.txt,221662,223087,1425,10,N,N,-,-1,-1
PILGRIM.txt,223088,224468,1380,10,N,N,-,-1,-1
PILGRIM.txt,224471,225710,1239,10,N,N,-,-1,-1
PILGRIM.txt,225711,226915,1204,10,N,N,-,-1,-1
PILGRIM.txt,226916,227830,914,10,N,N,-,-1,-1
PILGRIM.txt,227831,229079,1248,10,N,Y,1432812913267,228270,230251
PILGRIM.txt,229080,230557,1477,10,N,Y,1432812913267,228270,230251
PILGRIM.txt,230558,232739,2181,10,N,N,-,-1,-1
PILGRIM.txt,232742,234712,1970,10,N,N,-,-1,-1
PILGRIM.txt,234713,235742,1029,10,N,N,-,-1,-1
PILGRIM.txt,235744,237337,1593,10,N,Y,1432826715274,237060,238022
PILGRIM.txt,237338,238296,958,10,N,Y,1432826715274,237060,238022
PILGRIM.txt,238298,239379,1081,10,N,N,-,-1,-1
PILGRIM.txt,239380,240624,1244,10,N,N,-,-1,-1
PILGRIM.txt,240629,241983,1354,10,N,N,-,-1,-1
PILGRIM.txt,241984,243400,1416,10,Y,N,-,-1,-1
PILGRIM.txt,243401,244827,1426,10,N,N,-,-1,-1
PILGRIM.txt,244828,246021,1193,10,N,N,-,-1,-1
PILGRIM.txt,246022,247198,1176,10,N,N,-,-1,-1
PILGRIM.txt,247199,248608,1409,10,N,N,-,-1,-1
PILGRIM.txt,248609,249666,1057,10,N,N,-,-1,-1
PILGRIM.txt,249671,250919,1248,10,Y,N,-,-1,-1
PILGRIM.txt,250920,252281,1361,10,N,N,-,-1,-1
PILGRIM.txt,252282,253745,1463,10,N,N,-,-1,-1
PILGRIM.txt,253747,255039,1292,10,N,N,-,-1,-1
PILGRIM.txt,255040,256579,1539,10,N,N,-,-1,-1
PILGRIM.txt,256580,258126,1546,10,N,N,-,-1,-1
PILGRIM.txt,258129,259526,1397,10,N,N,-,-1,-1
PILGRIM.txt,259527,261593,2066,10,Y,Y,1432830272373,259940,261638
PILGRIM.txt,261593,262600,1007,10,N,Y,1432830272373,259940,261638
PILGRIM.txt,262601,263148,547,10,N,N,-,-1,-1
PILGRIM.txt,263149,264137,988,10,N,N,-,-1,-1
PILGRIM.txt,264138,265279,1141,10,N,N,-,-1,-1
PILGRIM.txt,265280,266977,1697,10,N,N,-,-1,-1
PILGRIM.txt,266979,268269,1290,10,N,N,-,-1,-1
PILGRIM.txt,268270,269951,1681,10,N,N,-,-1,-1
PILGRIM.txt,269954,271227,1273,10,N,N,-,-1,-1
PILGRIM.txt,271228,272455,1227,10,N,N,-,-1,-1
PILGRIM.txt,272456,273394,938,10,N,N,-,-1,-1
PILGRIM.txt,273395,274894,1499,10,N,N,-,-1,-1
PILGRIM.txt,274895,276266,1371,10,N,N,-,-1,-1
PILGRIM.txt,276269,278062,1793,10,N,N,-,-1,-1
PILGRIM.txt,278063,280064,2001,10,N,N,-,-1,-1
PILGRIM.txt,280065,281281,1216,10,N,N,-,-1,-1
PILGRIM.txt,281284,282323,1039,10,N,N,-,-1,-1
PILGRIM.txt,282324,283332,1008,10,N,N,-,-1,-1
PILGRIM.txt,283333,284474,1141,10,N,N,-,-1,-1
PILGRIM.txt,284475,285738,1263,10,N,N,-,-1,-1
PILGRIM.txt,285739,287023,1284,10,N,N,-,-1,-1
PILGRIM.txt,287024,288729,1705,10,N,N,-,-1,-1
PILGRIM.txt,288730,289959,1229,10,N,N,-,-1,-1
PILGRIM.txt,289960,291287,1327,10,N,N,-,-1,-1
PILGRIM.txt,291288,293116,1828,10,N,N,-,-1,-1
PILGRIM.txt,293117,294304,1187,10,N,N,-,-1,-1
PILGRIM.txt,294305,295067,762,10,N,N,-,-1,-1
PILGRIM.txt,295068,296154,1086,10,N,N,-,-1,-1
PILGRIM.txt,296155,297554,1399,10,N,N,-,-1,-1
PILGRIM.txt,297556,298963,1407,10,N,N,-,-1,-1
PILGRIM.txt,298966,300505,1539,10,N,N,-,-1,-1
PILGRIM.txt,300506,302022,1516,10,N,N,-,-1,-1
PILGRIM.txt,302023,303843,1820,10,N,N,-,-1,-1
PILGRIM.txt,303844,305115,1271,10,N,N,-,-1,-1
PILGRIM.txt,305118,306238,1120,10,N,N,-,-1,-1
PILGRIM.txt,306239,307154,915,10,Y,N,-,-1,-1
PILGRIM.txt,307155,308148,993,10,Y,N,-,-1,-1
PILGRIM.txt,308151,309255,1104,10,N,Y,1432919383904,308149,309945
PILGRIM.txt,309256,310195,939,10,N,Y,1432919383904,308149,309945
PILGRIM.txt,310196,311528,1332,10,N,N,-,-1,-1
PILGRIM.txt,311529,313010,1481,10,N,N,-,-1,-1
PILGRIM.txt,313012,314326,1314,10,N,N,-,-1,-1
PILGRIM.txt,314327,315539,1212,10,N,N,-,-1,-1
PILGRIM.txt,315540,316786,1246,10,N,N,-,-1,-1
PILGRIM.txt,316787,317729,942,10,N,N,-,-1,-1
PILGRIM.txt,317732,319558,1826,10,N,N,-,-1,-1
PILGRIM.txt,319559,320606,1047,10,N,N,-,-1,-1
PILGRIM.txt,320607,321507,900,10,N,N,-,-1,-1
PILGRIM.txt,321508,322842,1334,10,N,N,-,-1,-1
PILGRIM.txt,322845,324446,1601,10,N,N,-,-1,-1
PILGRIM.txt,324447,325862,1415,10,N,N,-,-1,-1
PILGRIM.txt,325863,327412,1549,10,N,N,-,-1,-1
PILGRIM.txt,327413,328774,1361,10,N,Y,1432976483264,327834,329881
PILGRIM.txt,328775,330145,1370,10,N,Y,1432976483264,327834,329881
PILGRIM.txt,330146,332111,1965,10,N,N,-,-1,-1
PILGRIM.txt,332112,333368,1256,10,N,N,-,-1,-1
PILGRIM.txt,333371,334621,1250,10,N,N,-,-1,-1
PILGRIM.txt,334623,336841,2218,10,N,N,-,-1,-1
PILGRIM.txt,336842,338248,1406,10,N,N,-,-1,-1
PILGRIM.txt,338251,340075,1824,10,N,N,-,-1,-1
PILGRIM.txt,340076,341673,1597,10,N,N,-,-1,-1
PILGRIM.txt,341674,343642,1968,10,N,N,-,-1,-1
PILGRIM.txt,343647,345460,1813,10,N,N,-,-1,-1
PILGRIM.txt,345462,347041,1579,10,N,N,-,-1,-1
PILGRIM.txt,347042,348234,1192,10,N,N,-,-1,-1
PILGRIM.txt,348236,349852,1616,10,Y,N,-,-1,-1
PILGRIM.txt,349853,351370,1517,10,N,N,-,-1,-1
PILGRIM.txt,351371,352875,1504,10,N,N,-,-1,-1
PILGRIM.txt,352876,354931,2055,10,N,N,-,-1,-1
PILGRIM.txt,354934,356348,1414,10,N,N,-,-1,-1
PILGRIM.txt,356349,357835,1486,10,N,N,-,-1,-1
PILGRIM.txt,357836,358813,977,10,N,N,-,-1,-1
PILGRIM.txt,358814,360236,1422,10,N,N,-,-1,-1
PILGRIM.txt,360237,361543,1306,10,N,N,-,-1,-1
PILGRIM.txt,361545,363072,1527,10,N,Y,1432978478641,361921,364422
PILGRIM.txt,363074,365105,2031,10,N,Y,1432978478641,361921,364422
PILGRIM.txt,365106,366519,1413,10,N,N,-,-1,-1
PILGRIM.txt,366520,367699,1179,10,N,N,-,-1,-1
PILGRIM.txt,367700,369093,1393,10,N,N,-,-1,-1
PILGRIM.txt,369094,370847,1753,10,N,N,-,-1,-1
PILGRIM.txt,370850,372456,1606,10,N,N,-,-1,-1
PILGRIM.txt,372457,373880,1423,10,N,N,-,-1,-1
PILGRIM.txt,373881,375150,1269,10,N,N,-,-1,-1
PILGRIM.txt,375151,376603,1452,10,N,N,-,-1,-1
PILGRIM.txt,376604,377834,1230,10,N,N,-,-1,-1
PILGRIM.txt,377835,379185,1350,10,N,N,-,-1,-1
PILGRIM.txt,379186,380485,1299,10,N,N,-,-1,-1
PILGRIM.txt,380490,382129,1639,10,N,N,-,-1,-1
PILGRIM.txt,382132,383563,1431,10,N,N,-,-1,-1
PILGRIM.txt,383566,385308,1742,10,N,Y,1432979435232,384507,385447
PILGRIM.txt,385309,387389,2080,10,N,Y,1432979435232,384507,385447
PILGRIM.txt,387391,388391,1000,10,N,N,-,-1,-1
PILGRIM.txt,388392,389629,1237,10,N,N,-,-1,-1
PILGRIM.txt,389630,391255,1625,10,N,N,-,-1,-1
PILGRIM.txt,391256,393230,1974,10,N,N,-,-1,-1
PILGRIM.txt,393231,394032,801,10,N,N,-,-1,-1
PILGRIM.txt,394037,395161,1124,10,N,N,-,-1,-1
PILGRIM.txt,395164,396600,1436,10,N,N,-,-1,-1
PILGRIM.txt,396601,398592,1991,10,N,N,-,-1,-1
PILGRIM.txt,398595,401092,2497,10,N,Y,1432980418512,399130,400458
PILGRIM.txt,401094,402572,1478,10,N,N,-,-1,-1
PILGRIM.txt,402573,403482,909,10,N,N,-,-1,-1
PILGRIM.txt,403484,405146,1662,10,N,N,-,-1,-1
PILGRIM.txt,405147,406630,1483,10,N,N,-,-1,-1
PILGRIM.txt,406632,407884,1252,10,N,N,-,-1,-1
PILGRIM.txt,407885,409373,1488,10,N,N,-,-1,-1
PILGRIM.txt,409376,410737,1361,10,N,N,-,-1,-1
PILGRIM.txt,410740,412187,1447,10,N,Y,1432982795628,411959,413612
PILGRIM.txt,412188,413679,1491,10,N,Y,1432982795628,411959,413612
PILGRIM.txt,413682,415529,1847,10,N,N,-,-1,-1
PILGRIM.txt,415530,417060,1530,10,N,N,-,-1,-1
PILGRIM.txt,417063,418935,1872,10,N,N,-,-1,-1
PILGRIM.txt,418938,420309,1371,10,N,N,-,-1,-1
PILGRIM.txt,420311,421993,1682,10,N,Y,1432984504343,420736,421597
PILGRIM.txt,421994,423543,1549,10,Y,N,-,-1,-1
PILGRIM.txt,423544,424876,1332,10,N,N,-,-1,-1
PILGRIM.txt,424878,426088,1210,10,N,N,-,-1,-1
PILGRIM.txt,426091,427689,1598,10,N,N,-,-1,-1
PILGRIM.txt,427690,429326,1636,10,N,N,-,-1,-1
PILGRIM.txt,429327,430971,1644,10,N,N,-,-1,-1
PILGRIM.txt,430974,432544,1570,10,Y,N,-,-1,-1
PILGRIM.txt,432545,433782,1237,10,N,N,-,-1,-1
PILGRIM.txt,433784,435655,1871,10,N,N,-,-1,-1
PILGRIM.txt,435656,436507,851,10,N,N,-,-1,-1
PILGRIM.txt,436508,437599,1091,10,N,N,-,-1,-1
PILGRIM.txt,437604,439011,1407,10,N,N,-,-1,-1
PILGRIM.txt,439012,440428,1416,10,N,N,-,-1,-1
PILGRIM.txt,440430,441567,1137,10,N,N,-,-1,-1
PILGRIM.txt,441568,442685,1117,10,N,N,-,-1,-1
PILGRIM.txt,442690,443344,654,10,N,N,-,-1,-1
PILGRIM.txt,443345,444751,1406,10,N,N,-,-1,-1
PILGRIM.txt,444753,446120,1367,10,N,N,-,-1,-1
PILGRIM.txt,446121,447538,1417,10,N,N,-,-1,-1
PILGRIM.txt,447539,449026,1487,10,N,N,-,-1,-1
PILGRIM.txt,449027,450246,1219,10,N,N,-,-1,-1
PILGRIM.txt,450247,451735,1488,10,Y,N,-,-1,-1
PILGRIM.txt,451736,453139,1403,10,N,N,-,-1,-1
PILGRIM.txt,453140,454701,1561,10,N,N,-,-1,-1
PILGRIM.txt,454702,456165,1463,10,N,Y,1433089799400,455451,455857
PILGRIM.txt,456166,457463,1297,10,N,N,-,-1,-1
PILGRIM.txt,457464,458491,1027,10,N,N,-,-1,-1
PILGRIM.txt,458493,459901,1408,10,N,N,-,-1,-1
PILGRIM.txt,459902,461138,1236,10,N,N,-,-1,-1
PILGRIM.txt,461141,462786,1645,10,N,N,-,-1,-1
PILGRIM.txt,462789,464145,1356,10,N,N,-,-1,-1
PILGRIM.txt,464146,465298,1152,10,N,N,-,-1,-1
PILGRIM.txt,465301,466890,1589,10,N,N,-,-1,-1
PILGRIM.txt,466891,468070,1179,10,N,N,-,-1,-1
PILGRIM.txt,468071,469154,1083,10,N,N,-,-1,-1
PILGRIM.txt,469155,470570,1415,10,N,N,-,-1,-1
PILGRIM.txt,470573,472647,2074,10,N,Y,1433091318633,471647,472306
PILGRIM.txt,472648,473918,1270,10,N,N,-,-1,-1
PILGRIM.txt,473919,474929,1010,10,N,N,-,-1,-1
PILGRIM.txt,474930,476941,2011,10,N,N,-,-1,-1
PILGRIM.txt,476944,478834,1890,10,N,N,-,-1,-1
PILGRIM.txt,478837,481015,2178,10,N,N,-,-1,-1
PILGRIM.txt,481018,482815,1797,10,N,N,-,-1,-1
PILGRIM.txt,482818,484389,1571,10,N,N,-,-1,-1
PILGRIM.txt,484390,486163,1773,10,N,N,-,-1,-1
PILGRIM.txt,486166,487923,1757,10,N,N,-,-1,-1
PILGRIM.txt,487924,489538,1614,10,N,N,-,-1,-1
PILGRIM.txt,489539,490903,1364,10,N,N,-,-1,-1
PILGRIM.txt,490905,492307,1402,10,N,N,-,-1,-1
PILGRIM.txt,492308,493831,1523,10,N,N,-,-1,-1
PILGRIM.txt,493832,495624,1792,10,N,N,-,-1,-1
PILGRIM.txt,495625,497600,1975,10,Y,Y,1433092717054,496037,497172
PILGRIM.txt,497601,499296,1695,10,N,Y,1433093250202,497882,499236
PILGRIM.txt,499299,500991,1692,10,N,N,-,-1,-1
PILGRIM.txt,500994,502931,1937,10,N,N,-,-1,-1
PILGRIM.txt,502932,504351,1419,10,N,N,-,-1,-1
PILGRIM.txt,504352,505781,1429,10,N,N,-,-1,-1
PILGRIM.txt,505784,507428,1644,10,N,N,-,-1,-1
PILGRIM.txt,507429,508578,1149,10,N,N,-,-1,-1
PILGRIM.txt,508579,509877,1298,10,N,N,-,-1,-1
PILGRIM.txt,509878,511111,1233,10,N,N,-,-1,-1
PILGRIM.txt,511112,512456,1344,10,N,N,-,-1,-1
PILGRIM.txt,512459,513839,1380,10,N,N,-,-1,-1
PILGRIM.txt,513841,515335,1494,10,N,N,-,-1,-1
PILGRIM.txt,515337,516472,1135,10,N,N,-,-1,-1
PILGRIM.txt,516473,517664,1191,10,N,N,-,-1,-1
PILGRIM.txt,517666,518984,1318,10,N,N,-,-1,-1
PILGRIM.txt,518986,520675,1689,10,N,N,-,-1,-1
PILGRIM.txt,520680,521665,985,10,N,N,-,-1,-1
PILGRIM.txt,521667,522785,1118,10,N,N,-,-1,-1
PILGRIM.txt,522786,523923,1137,10,N,N,-,-1,-1
PILGRIM.txt,523925,525364,1439,10,N,N,-,-1,-1
PILGRIM.txt,525365,526876,1511,10,N,Y,1433140776828,526138,528487
PILGRIM.txt,526879,529256,2377,10,N,Y,1433140776828,526138,528487
PILGRIM.txt,529257,530938,1681,10,N,N,-,-1,-1
PILGRIM.txt,530941,531976,1035,10,N,N,-,-1,-1
PILGRIM.txt,531977,533113,1136,10,N,Y,1433166467939,532258,533091
PILGRIM.txt,533116,535158,2042,10,N,N,-,-1,-1
PILGRIM.txt,535159,536559,1400,10,N,N,-,-1,-1
PILGRIM.txt,536560,538137,1577,10,N,N,-,-1,-1
PILGRIM.txt,538138,538792,654,10,N,N,-,-1,-1
PILGRIM.txt,538795,539561,766,10,N,N,-,-1,-1
PILGRIM.txt,539562,540896,1334,10,N,N,-,-1,-1
PILGRIM.txt,540899,542276,1377,10,N,N,-,-1,-1
PILGRIM.txt,542278,543746,1468,10,N,N,-,-1,-1
PILGRIM.txt,543749,545315,1566,10,N,Y,1433167548802,544513,546084
PILGRIM.txt,545316,546618,1302,10,N,Y,1433167548802,544513,546084
PILGRIM.txt,546620,548618,1998,10,Y,Y,1433168080595,547752,548387
PILGRIM.txt,548619,550044,1425,10,N,N,-,-1,-1
PILGRIM.txt,550045,551302,1257,10,N,N,-,-1,-1
PILGRIM.txt,551305,552962,1657,10,Y,N,-,-1,-1
PILGRIM.txt,552965,554945,1980,10,N,N,-,-1,-1
PILGRIM.txt,554948,556579,1631,10,N,N,-,-1,-1
PILGRIM.txt,556582,557996,1414,10,N,Y,1433168856414,556592,557358
PILGRIM.txt,557997,559062,1065,10,N,N,-,-1,-1
PILGRIM.txt,559063,560330,1267,10,N,N,-,-1,-1
PILGRIM.txt,560331,562000,1669,10,N,N,-,-1,-1
PILGRIM.txt,562001,563447,1446,10,N,N,-,-1,-1
PILGRIM.txt,563449,564346,897,10,N,N,-,-1,-1
PILGRIM.txt,564347,564933,586,10,N,N,-,-1,-1
PILGRIM.txt,564934,566124,1190,10,N,N,-,-1,-1
PILGRIM.txt,566127,566903,776,10,N,N,-,-1,-1
PILGRIM.txt,566904,567940,1036,10,N,N,-,-1,-1
PILGRIM.txt,567941,568862,921,10,N,N,-,-1,-1
PILGRIM.txt,568864,570218,1354,10,N,N,-,-1,-1
PILGRIM.txt,570219,571605,1386,10,N,N,-,-1,-1
PILGRIM.txt,571606,572663,1057,10,N,N,-,-1,-1
PILGRIM.txt,572665,574063,1398,10,N,N,-,-1,-1
PILGRIM.txt,574066,576078,2012,10,N,N,-,-1,-1
PILGRIM.txt,576081,577179,1098,10,N,N,-,-1,-1
PILGRIM.txt,577180,579017,1837,10,N,N,-,-1,-1
PILGRIM.txt,579018,580549,1531,10,N,N,-,-1,-1
PILGRIM.txt,580549,582402,1853,10,N,N,-,-1,-1
PILGRIM.txt,582403,584459,2056,10,N,N,-,-1,-1
PILGRIM.txt,584462,585538,1076,10,N,N,-,-1,-1
PILGRIM.txt,585541,586255,714,10,N,N,-,-1,-1
PILGRIM.txt,586256,587451,1195,10,N,N,-,-1,-1
PILGRIM.txt,587452,588421,969,10,N,N,-,-1,-1
PILGRIM.txt,588422,589418,996,10,N,N,-,-1,-1
PILGRIM.txt,589419,590430,1011,10,N,N,-,-1,-1
PILGRIM.txt,590433,591462,1029,10,N,N,-,-1,-1
PILGRIM.txt,591463,592796,1333,10,N,N,-,-1,-1
PILGRIM.txt,592797,594416,1619,10,N,N,-,-1,-1
PILGRIM.txt,594416,596125,1709,10,N,N,-,-1,-1
PILGRIM.txt,596126,597303,1177,10,N,N,-,-1,-1
PILGRIM.txt,597304,600018,2714,10,N,N,-,-1,-1
PILGRIM.txt,600021,601782,1761,10,N,N,-,-1,-1
PILGRIM.txt,601787,603308,1521,10,N,N,-,-1,-1
PILGRIM.txt,603311,604959,1648,10,N,N,-,-1,-1
PILGRIM.txt,604960,606643,1683,10,N,N,-,-1,-1
PILGRIM.txt,606644,609018,2374,10,N,N,-,-1,-1
PILGRIM.txt,609021,609417,396,10,N,N,-,-1,-1
PILGRIM.txt,609417,609489,72,10,N,N,-,-1,-1
PILGRIM.txt,609489,609794,305,10,N,N,-,-1,-1
PILGRIM.txt,609795,610127,332,10,N,N,-,-1,-1
PILGRIM.txt,610127,610254,127,10,N,N,-,-1,-1
PILGRIM.txt,610257,610578,321,10,N,N,-,-1,-1
PILGRIM.txt,610578,610858,280,10,N,N,-,-1,-1
PILGRIM.txt,610859,612703,1844,10,N,N,-,-1,-1
PILGRIM.txt,612704,615188,2484,10,N,N,-,-1,-1
PILGRIM.txt,615190,616946,1756,10,N,N,-,-1,-1
PILGRIM.txt,616947,618379,1432,10,N,N,-,-1,-1
PILGRIM.txt,618380,619619,1239,10,N,N,-,-1,-1
PILGRIM.txt,619620,621592,1972,10,N,N,-,-1,-1
PILGRIM.txt,621595,623000,1405,10,N,N,-,-1,-1
PILGRIM.txt,623003,624427,1424,10,N,N,-,-1,-1
PILGRIM.txt,624429,625761,1332,10,N,N,-,-1,-1
PILGRIM.txt,625762,627837,2075,10,N,N,-,-1,-1
PILGRIM.txt,627838,629068,1230,10,N,N,-,-1,-1
PILGRIM.txt,629071,630760,1689,10,N,N,-,-1,-1
PILGRIM.txt,630761,632359,1598,10,N,N,-,-1,-1
PILGRIM.txt,632360,640579,8219,10,Y,N,-,-1,-1
PILGRIM.txt,640581,645148,4567,10,N,N,-,-1,-1
PILGRIM.txt,645151,653558,8407,10,N,N,-,-1,-1
PILGRIM.txt,653560,662919,9359,10,N,N,-,-1,-1
RECMUS.txt,0,464,464,10,N,N,-,-1,-1
RECMUS.txt,465,1082,617,10,N,N,-,-1,-1
RECMUS.txt,1083,2109,1026,10,N,N,-,-1,-1
RECMUS.txt,2110,3406,1296,10,N,N,-,-1,-1
RECMUS.txt,3411,4561,1150,10,N,N,-,-1,-1
RECMUS.txt,4564,7245,2681,10,N,N,-,-1,-1
RECMUS.txt,7248,9445,2197,10,N,N,-,-1,-1
RECMUS.txt,9448,11702,2254,10,N,N,-,-1,-1
RECMUS.txt,11705,13409,1704,10,N,N,-,-1,-1
RECMUS.txt,13412,15449,2037,10,N,N,-,-1,-1
RECMUS.txt,15452,17687,2235,10,N,N,-,-1,-1
RECMUS.txt,17690,18963,1273,10,N,N,-,-1,-1
RECMUS.txt,18966,20818,1852,10,N,N,-,-1,-1
RECMUS.txt,20819,22013,1194,10,N,N,-,-1,-1
RECMUS.txt,22014,23441,1427,10,N,N,-,-1,-1
RECMUS.txt,23442,24696,1254,10,N,N,-,-1,-1
RECMUS.txt,24697,26096,1399,10,N,N,-,-1,-1
RECMUS.txt,26096,27238,1142,10,N,N,-,-1,-1
RECMUS.txt,27239,28260,1021,10,N,N,-,-1,-1
RECMUS.txt,28262,29884,1622,10,N,N,-,-1,-1
RECMUS.txt,29885,30922,1037,10,N,N,-,-1,-1
RECMUS.txt,30925,32364,1439,10,N,N,-,-1,-1
RECMUS.txt,32366,33440,1074,10,N,N,-,-1,-1
RECMUS.txt,33441,35223,1782,10,Y,N,-,-1,-1
RECMUS.txt,35226,36526,1300,10,N,N,-,-1,-1
RECMUS.txt,36527,38121,1594,10,N,N,-,-1,-1
RECMUS.txt,38124,39465,1341,10,N,N,-,-1,-1
RECMUS.txt,39468,40619,1151,10,N,N,-,-1,-1
RECMUS.txt,40621,41995,1374,10,N,N,-,-1,-1
RECMUS.txt,41996,43126,1130,10,Y,N,-,-1,-1
RECMUS.txt,43127,44028,901,10,N,N,-,-1,-1
RECMUS.txt,44029,45661,1632,10,Y,N,-,-1,-1
RECMUS.txt,45662,46689,1027,10,N,N,-,-1,-1
RECMUS.txt,46690,48232,1542,10,N,N,-,-1,-1
RECMUS.txt,48233,49811,1578,10,N,N,-,-1,-1
RECMUS.txt,49816,51305,1489,10,N,N,-,-1,-1
RECMUS.txt,51306,52537,1231,10,N,N,-,-1,-1
RECMUS.txt,52539,53726,1187,10,N,N,-,-1,-1
RECMUS.txt,53727,55340,1613,10,N,N,-,-1,-1
RECMUS.txt,55341,56957,1616,10,N,N,-,-1,-1
RECMUS.txt,56960,58431,1471,10,N,N,-,-1,-1
RECMUS.txt,58432,59741,1309,10,N,N,-,-1,-1
RECMUS.txt,59742,60497,755,10,N,N,-,-1,-1
RECMUS.txt,60498,60683,185,10,N,N,-,-1,-1
RECMUS.txt,60684,61860,1176,10,Y,N,-,-1,-1
RECMUS.txt,61861,63159,1298,10,N,N,-,-1,-1
RECMUS.txt,63160,64547,1387,10,N,N,-,-1,-1
RECMUS.txt,64548,66204,1656,10,Y,N,-,-1,-1
RECMUS.txt,66205,67807,1602,10,Y,Y,1426859941632,67129,67357
RECMUS.txt,67810,69532,1722,10,N,N,-,-1,-1
RECMUS.txt,69533,71236,1703,10,Y,N,-,-1,-1
RECMUS.txt,71237,72559,1322,10,N,Y,1426861072576,72354,72768
RECMUS.txt,72561,73858,1297,10,N,Y,1426861072576,72354,72768
RECMUS.txt,73861,75040,1179,10,N,N,-,-1,-1
RECMUS.txt,75041,76596,1555,10,N,Y,1426861595037,75041,75166
RECMUS.txt,76597,77882,1285,10,N,N,-,-1,-1
RECMUS.txt,77885,79445,1560,10,Y,Y,1426863415047,78494,78880
RECMUS.txt,79446,81018,1572,10,N,N,-,-1,-1
RECMUS.txt,81019,82284,1265,10,N,N,-,-1,-1
RECMUS.txt,82285,83185,900,10,N,N,-,-1,-1
RECMUS.txt,83186,84511,1325,10,N,N,-,-1,-1
RECMUS.txt,84512,85593,1081,10,N,N,-,-1,-1
RECMUS.txt,85594,86948,1354,10,Y,N,-,-1,-1
RECMUS.txt,86953,87854,901,10,N,N,-,-1,-1
RECMUS.txt,87856,88552,696,10,N,N,-,-1,-1
RECMUS.txt,88553,89726,1173,10,N,N,-,-1,-1
RECMUS.txt,89729,90512,783,10,N,N,-,-1,-1
RECMUS.txt,90513,92102,1589,10,N,N,-,-1,-1
RECMUS.txt,92103,93906,1803,10,Y,N,-,-1,-1
RECMUS.txt,93907,95894,1987,10,Y,N,-,-1,-1
RECMUS.txt,95897,97060,1163,10,N,N,-,-1,-1
RECMUS.txt,97061,98656,1595,10,N,N,-,-1,-1
RECMUS.txt,98661,100063,1402,10,Y,N,-,-1,-1
RECMUS.txt,100066,100852,786,10,N,N,-,-1,-1
RECMUS.txt,100853,101820,967,10,N,N,-,-1,-1
RECMUS.txt,101821,102463,642,10,N,N,-,-1,-1
RECMUS.txt,102465,103352,887,10,N,Y,1427479456712,102659,102787
RECMUS.txt,103353,104811,1458,10,N,N,-,-1,-1
RECMUS.txt,104814,105930,1116,10,N,N,-,-1,-1
RECMUS.txt,105933,107761,1828,10,N,N,-,-1,-1
RECMUS.txt,107764,109039,1275,10,N,N,-,-1,-1
RECMUS.txt,109042,110362,1320,10,N,N,-,-1,-1
RECMUS.txt,110363,111693,1330,10,N,N,-,-1,-1
RECMUS.txt,111694,113359,1665,10,N,N,-,-1,-1
RECMUS.txt,113360,114570,1210,10,Y,N,-,-1,-1
RECMUS.txt,114573,115031,458,10,N,N,-,-1,-1
RECMUS.txt,115032,115149,117,10,N,N,-,-1,-1
RECMUS.txt,115150,115329,179,10,N,N,-,-1,-1
RECMUS.txt,115332,115522,190,10,N,N,-,-1,-1
RECMUS.txt,115523,115776,253,10,N,N,-,-1,-1
RECMUS.txt,115779,116411,632,10,N,N,-,-1,-1
RECMUS.txt,116412,117669,1257,10,N,N,-,-1,-1
RECMUS.txt,117670,118968,1298,10,N,N,-,-1,-1
RECMUS.txt,118969,120848,1879,10,N,N,-,-1,-1
RECMUS.txt,120851,122140,1289,10,N,N,-,-1,-1
RECMUS.txt,122143,123345,1202,10,N,N,-,-1,-1
RECMUS.txt,123346,125188,1842,10,N,Y,1428494785912,123570,123801
RECMUS.txt,125189,126821,1632,10,N,N,-,-1,-1
RECMUS.txt,126822,128412,1590,10,Y,N,-,-1,-1
RECMUS.txt,128413,129641,1228,10,N,N,-,-1,-1
RECMUS.txt,129642,131038,1396,10,N,N,-,-1,-1
RECMUS.txt,131039,132555,1516,10,N,N,-,-1,-1
RECMUS.txt,132558,133882,1324,10,N,N,-,-1,-1
RECMUS.txt,133883,135089,1206,10,N,N,-,-1,-1
RECMUS.txt,135090,136151,1061,10,N,N,-,-1,-1
RECMUS.txt,136154,137504,1350,10,N,N,-,-1,-1
RECMUS.txt,137509,138439,930,10,N,N,-,-1,-1
RECMUS.txt,138440,139816,1376,10,N,Y,1429002645768,138633,138684
RECMUS.txt,139821,140982,1161,10,N,N,-,-1,-1
RECMUS.txt,140982,142688,1706,10,Y,N,-,-1,-1
RECMUS.txt,142689,144181,1492,10,Y,N,-,-1,-1
RECMUS.txt,144184,145166,982,10,N,N,-,-1,-1
RECMUS.txt,145167,147011,1844,10,N,N,-,-1,-1
RECMUS.txt,147012,148686,1674,10,N,N,-,-1,-1
RECMUS.txt,148687,150085,1398,10,N,N,-,-1,-1
RECMUS.txt,150086,151831,1745,10,N,N,-,-1,-1
RECMUS.txt,151832,153521,1689,10,Y,N,-,-1,-1
RECMUS.txt,153522,154790,1268,10,N,N,-,-1,-1
RECMUS.txt,154792,156248,1456,10,N,N,-,-1,-1
RECMUS.txt,156249,157598,1349,10,N,N,-,-1,-1
RECMUS.txt,157599,158680,1081,10,N,N,-,-1,-1
RECMUS.txt,158681,159840,1159,10,N,Y,1429102663064,159583,159924
RECMUS.txt,159841,160835,994,10,N,Y,1429102663064,159583,159924
RECMUS.txt,160836,162648,1812,10,N,N,-,-1,-1
RECMUS.txt,162649,163664,1015,10,N,Y,1429103324122,162708,162980
RECMUS.txt,163665,164462,797,10,N,N,-,-1,-1
RECMUS.txt,164463,165041,578,10,N,N,-,-1,-1
RECMUS.txt,165042,165785,743,10,N,N,-,-1,-1
RECMUS.txt,165785,166651,866,10,N,N,-,-1,-1
RECMUS.txt,166654,168240,1586,10,N,N,-,-1,-1
RECMUS.txt,168242,169732,1490,10,N,N,-,-1,-1
RECMUS.txt,169733,170966,1233,10,N,N,-,-1,-1
RECMUS.txt,170967,172115,1148,10,N,N,-,-1,-1
RECMUS.txt,172116,172867,751,10,N,N,-,-1,-1
RECMUS.txt,172868,174102,1234,10,N,N,-,-1,-1
RECMUS.txt,174103,175260,1157,10,N,N,-,-1,-1
RECMUS.txt,175261,176587,1326,10,N,N,-,-1,-1
RECMUS.txt,176588,177789,1201,10,N,N,-,-1,-1
RECMUS.txt,177794,179321,1527,10,N,N,-,-1,-1
RECMUS.txt,179322,180649,1327,10,N,N,-,-1,-1
RECMUS.txt,180650,182099,1449,10,N,N,-,-1,-1
RECMUS.txt,182102,183116,1014,10,N,N,-,-1,-1
RECMUS.txt,183118,183901,783,10,N,N,-,-1,-1
RECMUS.txt,183902,184775,873,10,N,N,-,-1,-1
RECMUS.txt,184776,185454,678,10,N,N,-,-1,-1
RECMUS.txt,185455,186379,924,10,N,N,-,-1,-1
RECMUS.txt,186380,187638,1258,10,N,N,-,-1,-1
RECMUS.txt,187639,188765,1126,10,N,Y,1429532686038,188361,188583
RECMUS.txt,188766,189703,937,10,N,N,-,-1,-1
RECMUS.txt,189705,191203,1498,10,N,N,-,-1,-1
RECMUS.txt,191204,192997,1793,10,Y,N,-,-1,-1
RECMUS.txt,192998,194479,1481,10,Y,N,-,-1,-1
RECMUS.txt,194480,195353,873,10,N,N,-,-1,-1
RECMUS.txt,195356,197645,2289,10,Y,Y,1429535538810,196482,199062
RECMUS.txt,197646,198736,1090,10,N,Y,1429535538810,196482,199062
RECMUS.txt,198737,200097,1360,10,N,Y,1429535538810,196482,199062
RECMUS.txt,200098,201821,1723,10,N,N,-,-1,-1
RECMUS.txt,201822,202952,1130,10,N,N,-,-1,-1
RECMUS.txt,202953,204000,1047,10,N,N,-,-1,-1
RECMUS.txt,204001,205308,1307,10,N,N,-,-1,-1
RECMUS.txt,205313,206358,1045,10,N,N,-,-1,-1
RECMUS.txt,206359,207691,1332,10,N,N,-,-1,-1
RECMUS.txt,207696,209417,1721,10,N,N,-,-1,-1
RECMUS.txt,209418,210669,1251,10,N,N,-,-1,-1
RECMUS.txt,210670,211622,952,10,N,N,-,-1,-1
RECMUS.txt,211623,212575,952,10,N,N,-,-1,-1
RECMUS.txt,212576,213781,1205,10,N,N,-,-1,-1
RECMUS.txt,213782,215341,1559,10,N,N,-,-1,-1
RECMUS.txt,215342,216862,1520,10,N,N,-,-1,-1
RECMUS.txt,216863,218073,1210,10,N,N,-,-1,-1
RECMUS.txt,218074,219614,1540,10,Y,N,-,-1,-1
RECMUS.txt,219615,221327,1712,10,N,N,-,-1,-1
RECMUS.txt,221328,222718,1390,10,N,N,-,-1,-1
RECMUS.txt,222719,223800,1081,10,N,N,-,-1,-1
RECMUS.txt,223801,224959,1158,10,N,N,-,-1,-1
RECMUS.txt,224964,226143,1179,10,N,N,-,-1,-1
RECMUS.txt,226144,226984,840,10,N,N,-,-1,-1
RECMUS.txt,226985,227992,1007,10,N,N,-,-1,-1
RECMUS.txt,227993,229287,1294,10,N,N,-,-1,-1
RECMUS.txt,229288,231279,1991,10,N,N,-,-1,-1
RECMUS.txt,231282,232737,1455,10,N,N,-,-1,-1
RECMUS.txt,232738,233604,866,10,N,N,-,-1,-1
RECMUS.txt,233606,235449,1843,10,N,N,-,-1,-1
RECMUS.txt,235452,236482,1030,10,N,N,-,-1,-1
RECMUS.txt,236483,237931,1448,10,N,N,-,-1,-1
RECMUS.txt,237932,238607,675,10,N,N,-,-1,-1
RECMUS.txt,238608,239852,1244,10,N,N,-,-1,-1
RECMUS.txt,239855,240819,964,10,N,N,-,-1,-1
RECMUS.txt,240820,242010,1190,10,N,N,-,-1,-1
RECMUS.txt,242011,243182,1171,10,N,N,-,-1,-1
RECMUS.txt,243183,244409,1226,10,N,N,-,-1,-1
RECMUS.txt,244412,246004,1592,10,N,N,-,-1,-1
RECMUS.txt,246005,247362,1357,10,N,N,-,-1,-1
RECMUS.txt,247363,248546,1183,10,N,N,-,-1,-1
RECMUS.txt,248547,250332,1785,10,N,N,-,-1,-1
RECMUS.txt,250333,251465,1132,10,N,N,-,-1,-1
RECMUS.txt,251466,252443,977,10,N,N,-,-1,-1
RECMUS.txt,252444,253043,599,10,N,N,-,-1,-1
RECMUS.txt,253044,254503,1459,10,N,N,-,-1,-1
RECMUS.txt,254504,255425,921,10,N,N,-,-1,-1
RECMUS.txt,255430,256207,777,10,N,N,-,-1,-1
RECMUS.txt,256210,257442,1232,10,N,N,-,-1,-1
RECMUS.txt,257445,258454,1009,10,N,N,-,-1,-1
RECMUS.txt,258457,259598,1141,10,N,N,-,-1,-1
RECMUS.txt,259601,260309,708,10,N,N,-,-1,-1
RECMUS.txt,260311,261830,1519,10,N,N,-,-1,-1
RECMUS.txt,261831,262774,943,10,N,N,-,-1,-1
RECMUS.txt,262777,264462,1685,10,N,Y,1429610699650,262775,263040
RECMUS.txt,264463,265631,1168,10,N,N,-,-1,-1
RECMUS.txt,265632,266543,911,10,N,N,-,-1,-1
RECMUS.txt,266544,269120,2576,10,N,N,-,-1,-1
RECMUS.txt,269121,270700,1579,10,N,N,-,-1,-1
RECMUS.txt,270701,271746,1045,10,N,N,-,-1,-1
RECMUS.txt,271747,273174,1427,10,N,N,-,-1,-1
RECMUS.txt,273175,273817,642,10,N,N,-,-1,-1
RECMUS.txt,273820,275480,1660,10,N,N,-,-1,-1
RECMUS.txt,275481,276613,1132,10,N,N,-,-1,-1
RECMUS.txt,276614,278030,1416,10,N,N,-,-1,-1
RECMUS.txt,278031,278839,808,10,N,N,-,-1,-1
RECMUS.txt,278840,279851,1011,10,N,N,-,-1,-1
RECMUS.txt,279852,281175,1323,10,N,N,-,-1,-1
RECMUS.txt,281176,283677,2501,10,N,N,-,-1,-1
RECMUS.txt,283678,285522,1844,10,N,N,-,-1,-1
RECMUS.txt,285523,287258,1735,10,N,N,-,-1,-1
RECMUS.txt,287259,288543,1284,10,N,N,-,-1,-1
RECMUS.txt,288544,290221,1677,10,N,N,-,-1,-1
RECMUS.txt,290224,291938,1714,10,N,N,-,-1,-1
RECMUS.txt,291939,293681,1742,10,N,N,-,-1,-1
RECMUS.txt,293683,295229,1546,10,N,N,-,-1,-1
RECMUS.txt,295230,296188,958,10,N,N,-,-1,-1
RECMUS.txt,296188,297810,1622,10,N,N,-,-1,-1
RECMUS.txt,297811,299634,1823,10,N,N,-,-1,-1
RECMUS.txt,299636,300415,779,10,N,N,-,-1,-1
RECMUS.txt,300420,301212,792,10,N,N,-,-1,-1
RECMUS.txt,301215,302176,961,10,N,N,-,-1,-1
RECMUS.txt,302177,303396,1219,10,N,N,-,-1,-1
RECMUS.txt,303399,304636,1237,10,N,N,-,-1,-1
RECMUS.txt,304639,305870,1231,10,N,N,-,-1,-1
RECMUS.txt,305871,307689,1818,10,N,N,-,-1,-1
RECMUS.txt,307690,309466,1776,10,N,N,-,-1,-1
RECMUS.txt,309467,311252,1785,10,N,N,-,-1,-1
RECMUS.txt,311253,312848,1595,10,N,N,-,-1,-1
RECMUS.txt,312849,314592,1743,10,N,N,-,-1,-1
RECMUS.txt,314593,316159,1566,10,N,N,-,-1,-1
RECMUS.txt,316161,316654,493,10,N,N,-,-1,-1
RECMUS.txt,316659,317672,1013,10,N,Y,1429618477739,317165,317427
RECMUS.txt,317673,318578,905,10,N,N,-,-1,-1
RECMUS.txt,318579,320159,1580,10,N,N,-,-1,-1
RECMUS.txt,320161,321318,1157,10,N,N,-,-1,-1
RECMUS.txt,321319,322478,1159,10,N,N,-,-1,-1
RECMUS.txt,322479,324153,1674,10,N,N,-,-1,-1
RECMUS.txt,324154,325586,1432,10,Y,N,-,-1,-1
RECMUS.txt,325587,326719,1132,10,Y,Y,1429619541244,325924,326642
RECMUS.txt,326720,327827,1107,10,N,Y,1429620133235,326889,327207
RECMUS.txt,327828,328833,1005,10,N,N,-,-1,-1
RECMUS.txt,328834,330372,1538,10,N,N,-,-1,-1
RECMUS.txt,330373,331501,1128,10,N,N,-,-1,-1
RECMUS.txt,331502,332910,1408,10,N,N,-,-1,-1
RECMUS.txt,332913,334458,1545,10,N,N,-,-1,-1
RECMUS.txt,334461,335760,1299,10,N,N,-,-1,-1
RECMUS.txt,335763,337639,1876,10,N,N,-,-1,-1
RECMUS.txt,337642,339097,1455,10,N,N,-,-1,-1
RECMUS.txt,339098,339620,522,10,N,N,-,-1,-1
RECMUS.txt,339625,341199,1574,10,N,N,-,-1,-1
RECMUS.txt,341202,342692,1490,10,N,Y,1429621761088,341740,341892
RECMUS.txt,342693,344649,1956,10,N,N,-,-1,-1
RECMUS.txt,344650,346247,1597,10,N,N,-,-1,-1
RECMUS.txt,346248,347487,1239,10,Y,N,-,-1,-1
RECMUS.txt,347488,349748,2260,10,N,N,-,-1,-1
RECMUS.txt,349749,351245,1496,10,N,N,-,-1,-1
RECMUS.txt,351246,352400,1154,10,N,N,-,-1,-1
RECMUS.txt,352401,353684,1283,10,N,N,-,-1,-1
RECMUS.txt,353685,354890,1205,10,N,N,-,-1,-1
RECMUS.txt,354891,356186,1295,10,N,N,-,-1,-1
RECMUS.txt,356189,357367,1178,10,N,N,-,-1,-1
RECMUS.txt,357368,358391,1023,10,N,N,-,-1,-1
RECMUS.txt,358392,359841,1449,10,N,N,-,-1,-1
RECMUS.txt,359843,361557,1714,10,N,N,-,-1,-1
RECMUS.txt,361558,362527,969,10,N,N,-,-1,-1
RECMUS.txt,362528,363722,1194,10,N,N,-,-1,-1
RECMUS.txt,363723,364835,1112,10,N,N,-,-1,-1
RECMUS.txt,364835,365796,961,10,N,N,-,-1,-1
RECMUS.txt,365797,366949,1152,10,N,N,-,-1,-1
RECMUS.txt,366950,368614,1664,10,N,N,-,-1,-1
RECMUS.txt,368615,370879,2264,10,Y,N,-,-1,-1
RECMUS.txt,370880,372466,1586,10,N,N,-,-1,-1
RECMUS.txt,372467,373614,1147,10,N,N,-,-1,-1
RECMUS.txt,373616,375313,1697,10,N,N,-,-1,-1
RECMUS.txt,375314,377066,1752,10,N,N,-,-1,-1
RECMUS.txt,377068,378842,1774,10,Y,N,-,-1,-1
RECMUS.txt,378843,380466,1623,10,N,N,-,-1,-1
RECMUS.txt,380469,382475,2006,10,Y,N,-,-1,-1
RECMUS.txt,382476,384503,2027,10,Y,N,-,-1,-1
RECMUS.txt,384504,385371,867,10,N,N,-,-1,-1
RECMUS.txt,385372,387152,1780,10,Y,Y,1429703438525,385609,386315
RECMUS.txt,387154,387945,791,10,N,Y,1429703659582,387900,389542
RECMUS.txt,387946,389993,2047,10,N,Y,1429703659582,387900,389542
RECMUS.txt,389994,390920,926,10,N,N,-,-1,-1
RECMUS.txt,390921,392716,1795,10,N,N,-,-1,-1
RECMUS.txt,392719,393572,853,10,N,N,-,-1,-1
RECMUS.txt,393573,394639,1066,10,N,N,-,-1,-1
RECMUS.txt,394640,396650,2010,10,N,N,-,-1,-1
RECMUS.txt,396651,398301,1650,10,N,N,-,-1,-1
RECMUS.txt,398302,399535,1233,10,N,N,-,-1,-1
RECMUS.txt,399536,401214,1678,10,Y,N,-,-1,-1
RECMUS.txt,401215,402953,1738,10,N,N,-,-1,-1
RECMUS.txt,402956,404779,1823,10,N,N,-,-1,-1
RECMUS.txt,404780,405912,1132,10,N,Y,1429958746761,405220,405568
RECMUS.txt,405913,406899,986,10,N,N,-,-1,-1
RECMUS.txt,406902,408054,1152,10,Y,N,-,-1,-1
RECMUS.txt,408055,409273,1218,10,N,N,-,-1,-1
RECMUS.txt,409274,410075,801,10,N,Y,1430061110446,409752,410058
RECMUS.txt,410076,410735,659,10,N,Y,1430062095918,410386,410666
RECMUS.txt,410736,412019,1283,10,N,N,-,-1,-1
RECMUS.txt,412020,413126,1106,10,N,N,-,-1,-1
RECMUS.txt,413127,414537,1410,10,N,N,-,-1,-1
RECMUS.txt,414538,415967,1429,10,N,N,-,-1,-1
RECMUS.txt,415968,417304,1336,10,N,N,-,-1,-1
RECMUS.txt,417305,419028,1723,10,N,N,-,-1,-1
RECMUS.txt,419029,419968,939,10,N,N,-,-1,-1
RECMUS.txt,419969,421448,1479,10,N,N,-,-1,-1
RECMUS.txt,421449,422648,1199,10,N,N,-,-1,-1
RECMUS.txt,422649,424376,1727,10,N,Y,1430132370365,422842,422953
RECMUS.txt,424377,425608,1231,10,N,N,-,-1,-1
RECMUS.txt,425609,427079,1470,10,N,N,-,-1,-1
RECMUS.txt,427082,428447,1365,10,N,N,-,-1,-1
RECMUS.txt,428448,429508,1060,10,N,N,-,-1,-1
RECMUS.txt,429510,430740,1230,10,N,N,-,-1,-1
RECMUS.txt,430741,432157,1416,10,N,N,-,-1,-1
RECMUS.txt,432158,433754,1596,10,N,N,-,-1,-1
RECMUS.txt,433755,435931,2176,10,Y,N,-,-1,-1
RECMUS.txt,435933,437534,1601,10,N,N,-,-1,-1
RECMUS.txt,437539,438877,1338,10,Y,N,-,-1,-1
RECMUS.txt,438880,439610,730,10,N,N,-,-1,-1
RECMUS.txt,439611,440455,844,10,N,N,-,-1,-1
RECMUS.txt,440456,441888,1432,10,N,N,-,-1,-1
RECMUS.txt,441889,443527,1638,10,Y,N,-,-1,-1
RECMUS.txt,443529,444863,1334,10,N,Y,1430143421055,444786,444985
RECMUS.txt,444864,446899,2035,10,Y,Y,1430143421055,444786,444985
RECMUS.txt,446904,448608,1704,10,Y,N,-,-1,-1
RECMUS.txt,448611,450076,1465,10,N,N,-,-1,-1
RECMUS.txt,450079,451219,1140,10,N,N,-,-1,-1
RECMUS.txt,451220,453017,1797,10,N,N,-,-1,-1
RECMUS.txt,453018,454273,1255,10,N,N,-,-1,-1
RECMUS.txt,454276,455948,1672,10,N,N,-,-1,-1
RECMUS.txt,455949,457046,1097,10,N,N,-,-1,-1
RECMUS.txt,457047,458494,1447,10,N,N,-,-1,-1
RECMUS.txt,458495,460416,1921,10,Y,N,-,-1,-1
RECMUS.txt,460417,461235,818,10,N,N,-,-1,-1
RECMUS.txt,461236,461386,150,10,N,N,-,-1,-1
RECMUS.txt,461386,461656,270,10,N,N,-,-1,-1
RECMUS.txt,461657,461818,161,10,N,N,-,-1,-1
RECMUS.txt,461818,463299,1481,10,Y,N,-,-1,-1
RECMUS.txt,463300,464502,1202,10,N,N,-,-1,-1
RECMUS.txt,464503,466671,2168,10,N,Y,1430146867800,465338,465502
RECMUS.txt,466672,468046,1374,10,N,N,-,-1,-1
RECMUS.txt,468046,469459,1413,10,N,N,-,-1,-1
RECMUS.txt,469460,471285,1825,10,Y,N,-,-1,-1
RECMUS.txt,471286,472555,1269,10,N,N,-,-1,-1
RECMUS.txt,472556,473321,765,10,N,N,-,-1,-1
RECMUS.txt,473322,474546,1224,10,N,N,-,-1,-1
RECMUS.txt,474547,476137,1590,10,N,N,-,-1,-1
RECMUS.txt,476138,477865,1727,10,Y,N,-,-1,-1
RECMUS.txt,477866,478806,940,10,N,N,-,-1,-1
RECMUS.txt,478807,479897,1090,10,N,N,-,-1,-1
RECMUS.txt,479898,480663,765,10,N,N,-,-1,-1
RECMUS.txt,480664,482188,1524,10,N,N,-,-1,-1
RECMUS.txt,482189,483288,1099,10,N,N,-,-1,-1
RECMUS.txt,483289,484372,1083,10,Y,N,-,-1,-1
RECMUS.txt,484373,485659,1286,10,N,N,-,-1,-1
RECMUS.txt,485660,486450,790,10,N,N,-,-1,-1
RECMUS.txt,486451,487463,1012,10,N,N,-,-1,-1
RECMUS.txt,487464,488290,826,10,N,N,-,-1,-1
RECMUS.txt,488291,489010,719,10,N,N,-,-1,-1
RECMUS.txt,489011,490022,1011,10,N,N,-,-1,-1
RECMUS.txt,490024,490717,693,10,N,N,-,-1,-1
RECMUS.txt,490718,491472,754,10,N,N,-,-1,-1
RECMUS.txt,491473,492677,1204,10,N,N,-,-1,-1
RECMUS.txt,492678,494312,1634,10,N,N,-,-1,-1
RECMUS.txt,494313,495867,1554,10,N,N,-,-1,-1
RECMUS.txt,495868,497733,1865,10,N,N,-,-1,-1
RECMUS.txt,497734,498937,1203,10,N,N,-,-1,-1
RECMUS.txt,498938,500032,1094,10,N,N,-,-1,-1
RECMUS.txt,500035,501493,1458,10,N,N,-,-1,-1
RECMUS.txt,501494,503107,1613,10,N,N,-,-1,-1
RECMUS.txt,503108,504797,1689,10,N,N,-,-1,-1
RECMUS.txt,504798,505950,1152,10,N,N,-,-1,-1
RECMUS.txt,505952,507291,1339,10,Y,Y,1430222777118,506387,506555
RECMUS.txt,507292,508911,1619,10,N,N,-,-1,-1
RECMUS.txt,508914,510263,1349,10,N,N,-,-1,-1
RECMUS.txt,510264,512262,1998,10,Y,N,-,-1,-1
RECMUS.txt,512263,513911,1648,10,N,N,-,-1,-1
RECMUS.txt,513912,515263,1351,10,N,N,-,-1,-1
RECMUS.txt,515264,516531,1267,10,N,N,-,-1,-1
RECMUS.txt,516532,518061,1529,10,N,Y,1430310307659,517170,517520
RECMUS.txt,518062,519425,1363,10,N,N,-,-1,-1
RECMUS.txt,519426,521209,1783,10,N,Y,1430312272173,520626,520894
RECMUS.txt,521214,523079,1865,10,N,N,-,-1,-1
RECMUS.txt,523080,524676,1596,10,N,N,-,-1,-1
RECMUS.txt,524677,526346,1669,10,N,N,-,-1,-1
RECMUS.txt,526349,527962,1613,10,N,N,-,-1,-1
RECMUS.txt,527963,529595,1632,10,N,N,-,-1,-1
RECMUS.txt,529596,531219,1623,10,N,N,-,-1,-1
RECMUS.txt,531222,533057,1835,10,N,N,-,-1,-1
RECMUS.txt,533058,535588,2530,10,Y,Y,1430813590521,534892,535075
RECMUS.txt,535589,537585,1996,10,Y,N,-,-1,-1
RECMUS.txt,537588,539162,1574,10,N,N,-,-1,-1
RECMUS.txt,539163,540703,1540,10,N,N,-,-1,-1
RECMUS.txt,540704,541932,1228,10,N,Y,1430814562699,541292,541683
RECMUS.txt,541933,543859,1926,10,N,N,-,-1,-1
RECMUS.txt,543860,544870,1010,10,N,N,-,-1,-1
RECMUS.txt,544871,545888,1017,10,N,N,-,-1,-1
RECMUS.txt,545889,547298,1409,10,N,N,-,-1,-1
RECMUS.txt,547299,548425,1126,10,N,N,-,-1,-1
RECMUS.txt,548426,550488,2062,10,N,N,-,-1,-1
RECMUS.txt,550491,552296,1805,10,N,N,-,-1,-1
RECMUS.txt,552297,554189,1892,10,Y,N,-,-1,-1
RECMUS.txt,554190,555876,1686,10,N,N,-,-1,-1
RECMUS.txt,555878,557829,1951,10,N,N,-,-1,-1
RECMUS.txt,557830,559484,1654,10,Y,N,-,-1,-1
RECMUS.txt,559484,561451,1967,10,N,N,-,-1,-1
RECMUS.txt,561452,563589,2137,10,N,N,-,-1,-1
RECMUS.txt,563591,565294,1703,10,N,N,-,-1,-1
RECMUS.txt,565295,567268,1973,10,N,N,-,-1,-1
RECMUS.txt,567269,568850,1581,10,Y,N,-,-1,-1
RECMUS.txt,568851,570529,1678,10,Y,N,-,-1,-1
RECMUS.txt,570530,571876,1346,10,N,N,-,-1,-1
RECMUS.txt,571877,574150,2273,10,N,N,-,-1,-1
RECMUS.txt,574151,575753,1602,10,N,N,-,-1,-1
RECMUS.txt,575754,577430,1676,10,N,N,-,-1,-1
RECMUS.txt,577431,579155,1724,10,N,N,-,-1,-1
RECMUS.txt,579158,580668,1510,10,N,N,-,-1,-1
RECMUS.txt,580669,581574,905,10,N,N,-,-1,-1
RECMUS.txt,581575,582920,1345,10,N,Y,1430903585194,582416,582681
RECMUS.txt,582921,583897,976,10,N,N,-,-1,-1
RECMUS.txt,583898,585108,1210,10,N,N,-,-1,-1
RECMUS.txt,585108,586205,1097,10,N,Y,1430906475487,585907,586013
RECMUS.txt,586206,587325,1119,10,N,N,-,-1,-1
RECMUS.txt,587326,589217,1891,10,N,N,-,-1,-1
RECMUS.txt,589220,590373,1153,10,N,N,-,-1,-1
RECMUS.txt,590376,592049,1673,10,N,N,-,-1,-1
RECMUS.txt,592050,593480,1430,10,N,N,-,-1,-1
RECMUS.txt,593481,594902,1421,10,N,Y,1430917862299,593970,594073
RECMUS.txt,594903,596372,1469,10,N,N,-,-1,-1
RECMUS.txt,596374,597919,1545,10,N,N,-,-1,-1
RECMUS.txt,597920,598905,985,10,N,N,-,-1,-1
RECMUS.txt,598906,600369,1463,10,Y,N,-,-1,-1
RECMUS.txt,600370,601509,1139,10,N,Y,1430919558858,600376,600634
RECMUS.txt,601510,603218,1708,10,Y,Y,1430920461435,602905,603306
RECMUS.txt,603219,604116,897,10,N,Y,1430920461435,602905,603306
RECMUS.txt,604117,605148,1031,10,N,N,-,-1,-1
RECMUS.txt,605149,605965,816,10,N,N,-,-1,-1
RECMUS.txt,605966,607001,1035,10,N,N,-,-1,-1
RECMUS.txt,607002,608391,1389,10,N,N,-,-1,-1
RECMUS.txt,608393,609361,968,10,N,N,-,-1,-1
RECMUS.txt,609364,610349,985,10,N,N,-,-1,-1
RECMUS.txt,610350,611333,983,10,N,Y,1431164339653,610804,611223
RECMUS.txt,611334,612166,832,10,N,N,-,-1,-1
RECMUS.txt,612167,613255,1088,10,N,N,-,-1,-1
RECMUS.txt,613256,614104,848,10,N,N,-,-1,-1
RECMUS.txt,614105,615274,1169,10,Y,N,-,-1,-1
RECMUS.txt,615279,616263,984,10,N,N,-,-1,-1
RECMUS.txt,616264,616681,417,10,N,N,-,-1,-1
RECMUS.txt,616682,617473,791,10,N,N,-,-1,-1
RECMUS.txt,617476,618940,1464,10,N,N,-,-1,-1
RECMUS.txt,618941,620016,1075,10,N,N,-,-1,-1
RECMUS.txt,620019,622119,2100,10,N,N,-,-1,-1
RECMUS.txt,622120,623516,1396,10,N,N,-,-1,-1
RECMUS.txt,623521,624691,1170,10,N,N,-,-1,-1
RECMUS.txt,624692,625944,1252,10,N,N,-,-1,-1
RECMUS.txt,625945,627885,1940,10,N,N,-,-1,-1
RECMUS.txt,627890,629428,1538,10,N,N,-,-1,-1
RECMUS.txt,629429,631004,1575,10,N,N,-,-1,-1
RECMUS.txt,631005,632678,1673,10,N,N,-,-1,-1
RECMUS.txt,632679,634712,2033,10,N,N,-,-1,-1
RECMUS.txt,634713,636048,1335,10,N,N,-,-1,-1
RECMUS.txt,636049,637389,1340,10,N,N,-,-1,-1
RECMUS.txt,637392,638918,1526,10,Y,N,-,-1,-1
RECMUS.txt,638919,640632,1713,10,N,Y,1431361104528,639924,640273
RECMUS.txt,640635,641602,967,10,N,N,-,-1,-1
RECMUS.txt,641603,642822,1219,10,N,N,-,-1,-1
RECMUS.txt,642823,643802,979,10,N,N,-,-1,-1
RECMUS.txt,643803,644906,1103,10,N,N,-,-1,-1
RECMUS.txt,644907,646305,1398,10,N,N,-,-1,-1
RECMUS.txt,646306,648560,2254,10,N,N,-,-1,-1
RECMUS.txt,648562,649818,1256,10,N,N,-,-1,-1
RECMUS.txt,649819,651616,1797,10,Y,N,-,-1,-1
RECMUS.txt,651618,653693,2075,10,N,N,-,-1,-1
RECMUS.txt,653694,654806,1112,10,N,N,-,-1,-1
RECMUS.txt,654807,656571,1764,10,Y,N,-,-1,-1
RECMUS.txt,656571,657593,1022,10,N,N,-,-1,-1
RECMUS.txt,657596,659136,1540,10,N,N,-,-1,-1
RECMUS.txt,659137,660505,1368,10,N,N,-,-1,-1
RECMUS.txt,660506,661727,1221,10,N,N,-,-1,-1
RECMUS.txt,661732,663199,1467,10,N,N,-,-1,-1
RECMUS.txt,663200,665009,1809,10,Y,N,-,-1,-1
RECMUS.txt,665014,666599,1585,10,N,N,-,-1,-1
RECMUS.txt,666602,667790,1188,10,N,Y,1431440815809,666612,666881
RECMUS.txt,667793,669279,1486,10,Y,Y,1431445668256,668943,669143
RECMUS.txt,669280,670515,1235,10,N,Y,1431446268360,670256,670506
RECMUS.txt,670515,672073,1558,10,N,N,-,-1,-1
RECMUS.txt,672074,673390,1316,10,N,N,-,-1,-1
RECMUS.txt,673391,674347,956,10,N,N,-,-1,-1
RECMUS.txt,674348,675396,1048,10,N,N,-,-1,-1
RECMUS.txt,675397,676603,1206,10,N,N,-,-1,-1
RECMUS.txt,676604,677663,1059,10,N,N,-,-1,-1
RECMUS.txt,677666,678604,938,10,N,N,-,-1,-1
RECMUS.txt,678605,680120,1515,10,N,N,-,-1,-1
RECMUS.txt,680121,681357,1236,10,N,Y,1431506517034,680207,680323
RECMUS.txt,681358,682685,1327,10,N,N,-,-1,-1
RECMUS.txt,682688,684012,1324,10,N,N,-,-1,-1
RECMUS.txt,684013,685304,1291,10,N,Y,1431508066369,685259,685876
RECMUS.txt,685305,686543,1238,10,N,Y,1431508066369,685259,685876
RECMUS.txt,686544,687764,1220,10,N,N,-,-1,-1
RECMUS.txt,687766,689084,1318,10,N,N,-,-1,-1
RECMUS.txt,689087,689690,603,10,N,N,-,-1,-1
RECMUS.txt,689693,690525,832,10,N,Y,1431520391464,690129,690293
RECMUS.txt,690528,691948,1420,10,N,N,-,-1,-1
RECMUS.txt,691949,693322,1373,10,N,N,-,-1,-1
RECMUS.txt,693325,694907,1582,10,N,N,-,-1,-1
RECMUS.txt,694908,696193,1285,10,N,N,-,-1,-1
RECMUS.txt,696194,698028,1834,10,N,N,-,-1,-1
RECMUS.txt,698029,699335,1306,10,N,N,-,-1,-1
RECMUS.txt,699336,700909,1573,10,Y,Y,1431686580301,699502,699758
RECMUS.txt,700910,702852,1942,10,N,N,-,-1,-1
RECMUS.txt,702853,704651,1798,10,N,N,-,-1,-1
RECMUS.txt,704652,705195,543,10,N,Y,1431687599525,705104,705244
RECMUS.txt,705196,706328,1132,10,N,Y,1431687599525,705104,705244
RECMUS.txt,706329,707074,745,10,N,N,-,-1,-1
RECMUS.txt,707075,708286,1211,10,N,N,-,-1,-1
RECMUS.txt,708287,709450,1163,10,N,N,-,-1,-1
RECMUS.txt,709451,711074,1623,10,N,N,-,-1,-1
RECMUS.txt,711079,712507,1428,10,N,N,-,-1,-1
RECMUS.txt,712508,714201,1693,10,N,N,-,-1,-1
RECMUS.txt,714202,715931,1729,10,N,N,-,-1,-1
RECMUS.txt,715934,717928,1994,10,N,N,-,-1,-1
RECMUS.txt,717929,719326,1397,10,N,N,-,-1,-1
RECMUS.txt,719327,720636,1309,10,N,N,-,-1,-1
RECMUS.txt,720637,722136,1499,10,N,N,-,-1,-1
RECMUS.txt,722137,723836,1699,10,N,N,-,-1,-1
RECMUS.txt,723837,725322,1485,10,N,N,-,-1,-1
RECMUS.txt,725323,727242,1919,10,Y,Y,1431697022699,725354,725864
RECMUS.txt,727243,729092,1849,10,N,N,-,-1,-1
RECMUS.txt,729093,730504,1411,10,Y,Y,1431697584022,729902,730181
RECMUS.txt,730507,730893,386,10,N,N,-,-1,-1
RECMUS.txt,730896,732278,1382,10,N,N,-,-1,-1
RECMUS.txt,732280,733798,1518,10,N,Y,1431790026329,733306,733503
RECMUS.txt,733799,734897,1098,10,N,N,-,-1,-1
RECMUS.txt,734898,736326,1428,10,N,N,-,-1,-1
RECMUS.txt,736329,737441,1112,10,N,Y,1431791455244,736369,736531
RECMUS.txt,737443,738927,1484,10,N,N,-,-1,-1
RECMUS.txt,738928,740432,1504,10,N,N,-,-1,-1
RECMUS.txt,740434,741875,1441,10,Y,N,-,-1,-1
RECMUS.txt,741880,743472,1592,10,N,Y,1431941266117,742610,743297
RECMUS.txt,743474,745214,1740,10,Y,Y,1431941771447,744892,745049
RECMUS.txt,745215,746009,794,10,N,N,-,-1,-1
RECMUS.txt,746010,747760,1750,10,Y,N,-,-1,-1
RECMUS.txt,747763,749038,1275,10,N,N,-,-1,-1
RECMUS.txt,749039,750305,1266,10,N,Y,1431943173931,749552,750043
RECMUS.txt,750307,752027,1720,10,N,N,-,-1,-1
RECMUS.txt,752028,752986,958,10,N,N,-,-1,-1
RECMUS.txt,752987,754575,1588,10,N,N,-,-1,-1
RECMUS.txt,754576,755769,1193,10,N,N,-,-1,-1
RECMUS.txt,755770,756820,1050,10,N,N,-,-1,-1
RECMUS.txt,756821,757512,691,10,N,N,-,-1,-1
RECMUS.txt,757514,758719,1205,10,N,N,-,-1,-1
RECMUS.txt,758720,760170,1450,10,N,N,-,-1,-1
RECMUS.txt,760173,761842,1669,10,N,N,-,-1,-1
RECMUS.txt,761843,763458,1615,10,N,Y,1431950693551,763304,763649
RECMUS.txt,763459,764567,1108,10,N,Y,1431950693551,763304,763649
RECMUS.txt,764570,765420,850,10,N,N,-,-1,-1
RECMUS.txt,765422,766125,703,10,N,N,-,-1,-1
RECMUS.txt,766126,767226,1100,10,N,N,-,-1,-1
RECMUS.txt,767228,768613,1385,10,N,N,-,-1,-1
RECMUS.txt,768614,770093,1479,10,N,N,-,-1,-1
RECMUS.txt,770094,771664,1570,10,N,N,-,-1,-1
RECMUS.txt,771667,773335,1668,10,N,N,-,-1,-1
RECMUS.txt,773336,774827,1491,10,N,N,-,-1,-1
RECMUS.txt,774828,776512,1684,10,Y,Y,1431952551670,775158,775489
RECMUS.txt,776513,777923,1410,10,N,N,-,-1,-1
RECMUS.txt,777924,778749,825,10,N,N,-,-1,-1
RECMUS.txt,778750,780626,1876,10,N,N,-,-1,-1
RECMUS.txt,780631,781890,1259,10,N,N,-,-1,-1
RECMUS.txt,781891,783714,1823,10,N,Y,1431953940995,782482,782580
RECMUS.txt,783717,784921,1204,10,N,N,-,-1,-1
RECMUS.txt,784922,786321,1399,10,N,N,-,-1,-1
RECMUS.txt,786322,787985,1663,10,Y,N,-,-1,-1
RECMUS.txt,787986,789299,1313,10,N,N,-,-1,-1
RECMUS.txt,789300,790711,1411,10,N,N,-,-1,-1
RECMUS.txt,790712,791895,1183,10,N,Y,1432024843245,791416,792120
RECMUS.txt,791896,793351,1455,10,Y,Y,1432024843245,791416,792120
RECMUS.txt,793354,794670,1316,10,N,N,-,-1,-1
RECMUS.txt,794673,796288,1615,10,N,N,-,-1,-1
RECMUS.txt,796290,797726,1436,10,N,Y,1432028613565,796637,797464
RECMUS.txt,797729,798916,1187,10,N,N,-,-1,-1
RECMUS.txt,798919,801222,2303,10,N,N,-,-1,-1
RECMUS.txt,801225,802877,1652,10,Y,N,-,-1,-1
RECMUS.txt,802878,804112,1234,10,Y,N,-,-1,-1
RECMUS.txt,804113,805573,1460,10,N,N,-,-1,-1
RECMUS.txt,805576,807303,1727,10,N,N,-,-1,-1
RECMUS.txt,807304,808752,1448,10,N,N,-,-1,-1
RECMUS.txt,808753,810155,1402,10,N,N,-,-1,-1
RECMUS.txt,810156,811715,1559,10,N,N,-,-1,-1
RECMUS.txt,811716,813632,1916,10,Y,Y,1432129974051,812469,812989
RECMUS.txt,813633,815195,1562,10,N,N,-,-1,-1
RECMUS.txt,815196,816951,1755,10,Y,N,-,-1,-1
RECMUS.txt,816952,818504,1552,10,N,N,-,-1,-1
RECMUS.txt,818506,819708,1202,10,N,N,-,-1,-1
RECMUS.txt,819713,820780,1067,10,N,N,-,-1,-1
RECMUS.txt,820780,822449,1669,10,N,N,-,-1,-1
RECMUS.txt,822450,824094,1644,10,N,N,-,-1,-1
RECMUS.txt,824095,825524,1429,10,N,N,-,-1,-1
RECMUS.txt,825526,826712,1186,10,N,N,-,-1,-1
RECMUS.txt,826713,827657,944,10,N,N,-,-1,-1
RECMUS.txt,827657,828914,1257,10,N,Y,1432288594537,828067,828512
RECMUS.txt,828915,830313,1398,10,Y,N,-,-1,-1
RECMUS.txt,830315,831607,1292,10,N,Y,1432289841006,830618,830976
RECMUS.txt,831609,833123,1514,10,N,N,-,-1,-1
RECMUS.txt,833124,834952,1828,10,Y,N,-,-1,-1
RECMUS.txt,834953,836421,1468,10,N,N,-,-1,-1
RECMUS.txt,836424,837844,1420,10,N,N,-,-1,-1
RECMUS.txt,837845,839937,2092,10,N,Y,1432374854992,839856,840598
RECMUS.txt,839938,840843,905,10,N,Y,1432374854992,839856,840598
RECMUS.txt,840844,841595,751,10,N,N,-,-1,-1
RECMUS.txt,841596,843899,2303,10,Y,Y,1432375899241,842288,842780
RECMUS.txt,843900,845592,1692,10,Y,N,-,-1,-1
RECMUS.txt,845593,846558,965,10,N,N,-,-1,-1
RECMUS.txt,846561,847617,1056,10,N,N,-,-1,-1
RECMUS.txt,847618,849232,1614,10,N,N,-,-1,-1
RECMUS.txt,849235,850900,1665,10,N,N,-,-1,-1
RECMUS.txt,850905,851936,1031,10,N,N,-,-1,-1
RECMUS.txt,851939,854361,2422,10,Y,N,-,-1,-1
RECMUS.txt,854364,855308,944,10,N,N,-,-1,-1
RECMUS.txt,855310,856872,1562,10,N,N,-,-1,-1
RECMUS.txt,856873,858773,1900,10,N,N,-,-1,-1
RECMUS.txt,858774,860173,1399,10,N,N,-,-1,-1
RECMUS.txt,860174,861654,1480,10,N,N,-,-1,-1
RECMUS.txt,861655,863576,1921,10,N,N,-,-1,-1
RECMUS.txt,863577,865164,1587,10,N,N,-,-1,-1
RECMUS.txt,865165,866880,1715,10,N,Y,1432468347198,866650,866878
RECMUS.txt,866883,868302,1419,10,N,N,-,-1,-1
RECMUS.txt,868303,869438,1135,10,N,N,-,-1,-1
RECMUS.txt,869439,871038,1599,10,N,N,-,-1,-1
RECMUS.txt,871039,871658,619,10,N,N,-,-1,-1
RECMUS.txt,871660,872653,993,10,N,N,-,-1,-1
RECMUS.txt,872654,874254,1600,10,N,Y,1432486376679,873579,873808
RECMUS.txt,874255,875967,1712,10,N,Y,1432487662435,875600,875831
RECMUS.txt,875968,877219,1251,10,N,N,-,-1,-1
RECMUS.txt,877220,878848,1628,10,N,N,-,-1,-1
RECMUS.txt,878851,880090,1239,10,N,N,-,-1,-1
RECMUS.txt,880091,881484,1393,10,N,N,-,-1,-1
RECMUS.txt,881485,882800,1315,10,Y,N,-,-1,-1
RECMUS.txt,882802,884403,1601,10,N,N,-,-1,-1
RECMUS.txt,884404,885606,1202,10,N,N,-,-1,-1
RECMUS.txt,885611,886335,724,10,N,N,-,-1,-1
RECMUS.txt,886337,886887,550,10,N,N,-,-1,-1
RECMUS.txt,886890,888081,1191,10,N,Y,1432546852411,887723,888158
RECMUS.txt,888082,889734,1652,10,N,Y,1432546852411,887723,888158
RECMUS.txt,889735,890999,1264,10,N,N,-,-1,-1
RECMUS.txt,891000,892258,1258,10,Y,N,-,-1,-1
RECMUS.txt,892259,893717,1458,10,Y,N,-,-1,-1
RECMUS.txt,893720,895573,1853,10,Y,N,-,-1,-1
RECMUS.txt,895574,897747,2173,10,Y,N,-,-1,-1
RECMUS.txt,897748,899380,1632,10,N,N,-,-1,-1
RECMUS.txt,899381,900706,1325,10,N,N,-,-1,-1
RECMUS.txt,900707,901824,1117,10,N,N,-,-1,-1
RECMUS.txt,901825,903110,1285,10,N,N,-,-1,-1
RECMUS.txt,903113,904639,1526,10,N,N,-,-1,-1
RECMUS.txt,904640,905810,1170,10,N,N,-,-1,-1
RECMUS.txt,905813,907931,2118,10,N,N,-,-1,-1
RECMUS.txt,907934,910059,2125,10,N,N,-,-1,-1
RECMUS.txt,910060,911527,1467,10,N,N,-,-1,-1
RECMUS.txt,911528,913608,2080,10,N,N,-,-1,-1
RECMUS.txt,913609,915802,2193,10,N,Y,1432552116295,913989,914217
RECMUS.txt,915804,917523,1719,10,N,N,-,-1,-1
RECMUS.txt,917528,919386,1858,10,N,N,-,-1,-1
RECMUS.txt,919387,921475,2088,10,N,N,-,-1,-1
RECMUS.txt,921476,923294,1818,10,N,N,-,-1,-1
RECMUS.txt,923295,924996,1701,10,N,N,-,-1,-1
RECMUS.txt,924997,927183,2186,10,Y,Y,1432554740755,925747,926238
RECMUS.txt,927184,928911,1727,10,N,N,-,-1,-1
RECMUS.txt,928916,930224,1308,10,N,N,-,-1,-1
RECMUS.txt,930225,931175,950,10,N,N,-,-1,-1
RECMUS.txt,931176,932295,1119,10,N,N,-,-1,-1
RECMUS.txt,932300,933675,1375,10,N,N,-,-1,-1
RECMUS.txt,933678,934773,1095,10,N,N,-,-1,-1
RECMUS.txt,934776,934982,206,10,N,N,-,-1,-1
RECMUS.txt,934983,935243,260,10,N,N,-,-1,-1
RECMUS.txt,935245,935474,229,10,N,N,-,-1,-1
RECMUS.txt,935475,935774,299,10,N,N,-,-1,-1
RECMUS.txt,935775,935937,162,10,N,N,-,-1,-1
RECMUS.txt,935938,936285,347,10,N,N,-,-1,-1
RECMUS.txt,936286,936389,103,10,N,N,-,-1,-1
RECMUS.txt,936393,936453,60,10,N,N,-,-1,-1
RECMUS.txt,936457,936597,140,10,N,N,-,-1,-1
RECMUS.txt,936599,936874,275,10,N,N,-,-1,-1
RECMUS.txt,936875,937091,216,10,N,N,-,-1,-1
RECMUS.txt,937092,937394,302,10,N,N,-,-1,-1
RECMUS.txt,937395,937728,333,10,N,N,-,-1,-1
RECMUS.txt,937730,938045,315,10,N,N,-,-1,-1
RECMUS.txt,938046,938329,283,10,N,N,-,-1,-1
RECMUS.txt,938330,938657,327,10,N,N,-,-1,-1
RECMUS.txt,938659,939018,359,10,N,N,-,-1,-1
RECMUS.txt,939019,939401,382,10,N,N,-,-1,-1
RECMUS.txt,939402,939683,281,10,N,N,-,-1,-1
RECMUS.txt,939685,940065,380,10,N,N,-,-1,-1
RECMUS.txt,940066,940358,292,10,N,N,-,-1,-1
RECMUS.txt,940359,940779,420,10,N,N,-,-1,-1
RECMUS.txt,940780,940990,210,10,N,N,-,-1,-1
RECMUS.txt,940992,941253,261,10,N,N,-,-1,-1
RECMUS.txt,941257,941330,73,10,N,N,-,-1,-1
RECMUS.txt,941334,941410,76,10,N,N,-,-1,-1
RECMUS.txt,941414,941487,73,10,N,N,-,-1,-1
RECMUS.txt,941489,941686,197,10,N,N,-,-1,-1
RECMUS.txt,941687,941962,275,10,N,N,-,-1,-1
RECMUS.txt,941963,942248,285,10,N,N,-,-1,-1
RECMUS.txt,942249,942465,216,10,N,N,-,-1,-1
RECMUS.txt,942466,942651,185,10,N,N,-,-1,-1
RECMUS.txt,942652,942867,215,10,N,N,-,-1,-1
RECMUS.txt,942868,943122,254,10,N,N,-,-1,-1
RECMUS.txt,943125,943350,225,10,N,N,-,-1,-1
RECMUS.txt,943351,943604,253,10,N,N,-,-1,-1
RECMUS.txt,943605,943794,189,10,N,N,-,-1,-1
RECMUS.txt,943795,944069,274,10,N,N,-,-1,-1
RECMUS.txt,944070,944430,360,10,N,N,-,-1,-1
RECMUS.txt,944433,944822,389,10,N,N,-,-1,-1
RECMUS.txt,944823,944999,176,10,N,N,-,-1,-1
RECMUS.txt,945000,945251,251,10,N,N,-,-1,-1
RECMUS.txt,945254,945684,430,10,N,N,-,-1,-1
RECMUS.txt,945685,946084,399,10,N,N,-,-1,-1
RECMUS.txt,946085,946351,266,10,N,N,-,-1,-1
RECMUS.txt,946352,946535,183,10,N,N,-,-1,-1
RECMUS.txt,946536,946722,186,10,N,N,-,-1,-1
RECMUS.txt,946723,947127,404,10,N,N,-,-1,-1
RECMUS.txt,947128,947493,365,10,N,N,-,-1,-1
RECMUS.txt,947494,947699,205,10,N,N,-,-1,-1
RECMUS.txt,947700,948006,306,10,N,N,-,-1,-1
RECMUS.txt,948009,948212,203,10,N,N,-,-1,-1
RECMUS.txt,948215,948435,220,10,N,N,-,-1,-1
RECMUS.txt,948438,948664,226,10,N,N,-,-1,-1
RECMUS.txt,948665,948918,253,10,N,N,-,-1,-1
RECMUS.txt,948921,949183,262,10,N,N,-,-1,-1
RECMUS.txt,949184,949368,184,10,N,N,-,-1,-1
RECMUS.txt,949369,949608,239,10,N,N,-,-1,-1
RECMUS.txt,949609,949979,370,10,N,N,-,-1,-1
RECMUS.txt,949980,950204,224,10,N,N,-,-1,-1
RECMUS.txt,950207,950598,391,10,N,N,-,-1,-1
RECMUS.txt,950599,950861,262,10,N,N,-,-1,-1
RECMUS.txt,950862,951126,264,10,N,N,-,-1,-1
RECMUS.txt,951129,951402,273,10,N,N,-,-1,-1
RECMUS.txt,951405,951686,281,10,N,N,-,-1,-1
RECMUS.txt,951687,951906,219,10,N,N,-,-1,-1
RECMUS.txt,951907,952164,257,10,N,N,-,-1,-1
RECMUS.txt,952165,952351,186,10,N,N,-,-1,-1
RECMUS.txt,952352,952677,325,10,N,N,-,-1,-1
RECMUS.txt,952678,952870,192,10,N,N,-,-1,-1
RECMUS.txt,952873,953178,305,10,N,N,-,-1,-1
RECMUS.txt,953179,953334,155,10,N,N,-,-1,-1
RECMUS.txt,953335,953521,186,10,N,N,-,-1,-1
RECMUS.txt,953522,953829,307,10,N,N,-,-1,-1
RECMUS.txt,953831,954043,212,10,N,N,-,-1,-1
RECMUS.txt,954045,954226,181,10,N,N,-,-1,-1
RECMUS.txt,954228,954414,186,10,N,N,-,-1,-1
RECMUS.txt,954416,954671,255,10,N,N,-,-1,-1
RECMUS.txt,954673,954864,191,10,N,N,-,-1,-1
RECMUS.txt,954867,955092,225,10,N,N,-,-1,-1
RECMUS.txt,955095,955316,221,10,N,N,-,-1,-1
RECMUS.txt,955319,955629,310,10,N,N,-,-1,-1
RECMUS.txt,955632,955879,247,10,N,N,-,-1,-1
RECMUS.txt,955882,956187,305,10,N,N,-,-1,-1
RECMUS.txt,956189,956499,310,10,N,N,-,-1,-1
RECMUS.txt,956502,956713,211,10,N,N,-,-1,-1
RECMUS.txt,956716,956935,219,10,N,N,-,-1,-1
RECMUS.txt,956937,957178,241,10,N,N,-,-1,-1
RECMUS.txt,957179,957343,164,10,N,N,-,-1,-1
RECMUS.txt,957346,957613,267,10,N,N,-,-1,-1
RECMUS.txt,957615,957811,196,10,N,N,-,-1,-1
RECMUS.txt,957813,958099,286,10,N,N,-,-1,-1
RECMUS.txt,958101,958299,198,10,N,N,-,-1,-1
RECMUS.txt,958301,958530,229,10,N,N,-,-1,-1
RECMUS.txt,958532,958743,211,10,N,N,-,-1,-1
RECMUS.txt,958744,958999,255,10,N,N,-,-1,-1
RECMUS.txt,959002,959229,227,10,N,N,-,-1,-1
RECMUS.txt,959231,959468,237,10,N,N,-,-1,-1
RECMUS.txt,959470,959712,242,10,N,N,-,-1,-1
RECMUS.txt,959714,959887,173,10,N,N,-,-1,-1
RECMUS.txt,959889,960109,220,10,N,N,-,-1,-1
RECMUS.txt,960111,960297,186,10,N,N,-,-1,-1
RECMUS.txt,960299,960459,160,10,N,N,-,-1,-1
RECMUS.txt,960461,960697,236,10,N,N,-,-1,-1
RECMUS.txt,960699,960948,249,10,N,N,-,-1,-1
RECMUS.txt,960950,961132,182,10,N,N,-,-1,-1
RECMUS.txt,961134,961353,219,10,N,N,-,-1,-1
RECMUS.txt,961355,961779,424,10,N,N,-,-1,-1
RECMUS.txt,961780,962022,242,10,N,N,-,-1,-1
RECMUS.txt,962025,962246,221,10,N,N,-,-1,-1
RECMUS.txt,962249,962462,213,10,N,N,-,-1,-1
RECMUS.txt,962465,962716,251,10,N,N,-,-1,-1
RECMUS.txt,962719,962928,209,10,N,N,-,-1,-1
RECMUS.txt,962933,963185,252,10,N,N,-,-1,-1
RECMUS.txt,963188,963391,203,10,N,N,-,-1,-1
RECMUS.txt,963394,963565,171,10,N,N,-,-1,-1
RECMUS.txt,963567,963795,228,10,N,N,-,-1,-1
RECMUS.txt,963797,963969,172,10,N,N,-,-1,-1
RECMUS.txt,963972,964170,198,10,N,N,-,-1,-1
RECMUS.txt,964172,964431,259,10,N,N,-,-1,-1
RECMUS.txt,964434,964618,184,10,N,N,-,-1,-1
RECMUS.txt,964621,964913,292,10,N,N,-,-1,-1
RECMUS.txt,964915,965197,282,10,N,N,-,-1,-1
RECMUS.txt,965199,965330,131,10,N,N,-,-1,-1
RECMUS.txt,965332,965584,252,10,N,N,-,-1,-1
RECMUS.txt,965586,965859,273,10,N,N,-,-1,-1
RECMUS.txt,965864,966112,248,10,N,N,-,-1,-1
RECMUS.txt,966114,966348,234,10,N,N,-,-1,-1
RECMUS.txt,966350,966628,278,10,N,N,-,-1,-1
RECMUS.txt,966630,966818,188,10,N,N,-,-1,-1
RECMUS.txt,966820,967052,232,10,N,N,-,-1,-1
RECMUS.txt,967055,967276,221,10,N,N,-,-1,-1
RECMUS.txt,967281,967501,220,10,N,N,-,-1,-1
RECMUS.txt,967504,967714,210,10,N,N,-,-1,-1
RECOLL.txt,0,1439,1439,10,N,N,-,-1,-1
RECOLL.txt,1442,2793,1351,10,N,N,-,-1,-1
RECOLL.txt,2794,4732,1938,10,N,N,-,-1,-1
RECOLL.txt,4735,5446,711,10,N,N,-,-1,-1
RECOLL.txt,5449,7429,1980,10,N,N,-,-1,-1
RECOLL.txt,7432,9517,2085,10,Y,N,-,-1,-1
RECOLL.txt,9518,13940,4422,10,Y,N,-,-1,-1
RECOLL.txt,13940,15432,1492,10,N,N,-,-1,-1
RECOLL.txt,15434,17038,1604,10,N,N,-,-1,-1
RECOLL.txt,17039,18430,1391,10,N,Y,1448997318962,17781,18305
RECOLL.txt,18431,19524,1093,10,N,N,-,-1,-1
RECOLL.txt,19525,21357,1832,10,N,N,-,-1,-1
RECOLL.txt,21358,22905,1547,10,N,N,-,-1,-1
RECOLL.txt,22906,24416,1510,10,N,N,-,-1,-1
RECOLL.txt,24419,26285,1866,10,N,N,-,-1,-1
RECOLL.txt,26286,27967,1681,10,N,N,-,-1,-1
RECOLL.txt,27968,29120,1152,10,N,N,-,-1,-1
RECOLL.txt,29121,30151,1030,10,N,N,-,-1,-1
RECOLL.txt,30152,31184,1032,10,N,N,-,-1,-1
RECOLL.txt,31185,32080,895,10,Y,Y,1449564497346,31421,33114
RECOLL.txt,32081,33397,1316,10,N,Y,1449564497346,31421,33114
RECOLL.txt,33399,35045,1646,10,N,Y,1449564002703,34459,35028
RECOLL.txt,35048,36927,1879,10,Y,Y,1449564936771,35046,35717
RECOLL.txt,36930,38229,1299,10,Y,Y,1449565237768,37503,38152
RECOLL.txt,38231,39348,1117,10,N,N,-,-1,-1
RECOLL.txt,39349,40906,1557,10,N,Y,1449565481530,39801,40627
RECOLL.txt,40908,42016,1108,10,N,N,-,-1,-1
RECOLL.txt,42017,43276,1259,10,N,N,-,-1,-1
RECOLL.txt,43277,44272,995,10,N,N,-,-1,-1
RECOLL.txt,44273,45225,952,10,N,N,-,-1,-1
RECOLL.txt,45226,46944,1718,10,N,N,-,-1,-1
RECOLL.txt,46945,48216,1271,10,N,Y,1449566012674,47822,49423
RECOLL.txt,48217,49432,1215,10,N,Y,1449566012674,47822,49423
RECOLL.txt,49435,50623,1188,10,N,N,-,-1,-1
RECOLL.txt,50624,52154,1530,10,Y,Y,1449566376755,51356,52539
RECOLL.txt,52155,53697,1542,10,Y,Y,1449566376755,51356,52539
RECOLL.txt,53702,55361,1659,10,N,Y,1449566781717,52623,55207
RECOLL.txt,55363,56476,1113,10,Y,N,-,-1,-1
RECOLL.txt,56477,57996,1519,10,N,Y,1449567312089,57825,59193
RECOLL.txt,57998,59273,1275,10,Y,Y,1449567312089,57825,59193
RECOLL.txt,59274,60446,1172,10,N,N,-,-1,-1
RECOLL.txt,60447,61681,1234,10,N,N,-,-1,-1
RECOLL.txt,61684,63615,1931,10,N,N,-,-1,-1
RECOLL.txt,63616,64847,1231,10,N,Y,1449604006516,63836,64388
RECOLL.txt,64848,66191,1343,10,N,Y,1449604885298,64679,65628
RECOLL.txt,66192,66690,498,10,N,N,-,-1,-1
RECOLL.txt,66693,67624,931,10,N,Y,1449605311607,66740,67367
RECOLL.txt,67625,68701,1076,10,N,N,-,-1,-1
RECOLL.txt,68702,70094,1392,10,Y,Y,1449605831232,69255,71638
RECOLL.txt,70095,71020,925,10,N,Y,1449605831232,69255,71638
RECOLL.txt,71021,72055,1034,10,Y,Y,1449606203855,71875,72052
RECOLL.txt,72056,72488,432,10,N,N,-,-1,-1
RECOLL.txt,72489,72777,288,10,N,N,-,-1,-1
RECOLL.txt,72778,73189,411,10,N,N,-,-1,-1
RECOLL.txt,73190,74105,915,10,N,N,-,-1,-1
RECOLL.txt,74108,75493,1385,10,N,Y,1449606753172,75354,75839
RECOLL.txt,75494,76842,1348,10,N,Y,1449606753172,75354,75839
RECOLL.txt,76845,77973,1128,10,Y,Y,1449607148586,77156,77751
RECOLL.txt,77975,79405,1430,10,N,N,-,-1,-1
RECOLL.txt,79406,80859,1453,10,N,N,-,-1,-1
RECOLL.txt,80861,82275,1414,10,Y,Y,1450194336026,81036,82029
RECOLL.txt,82276,83661,1385,10,Y,Y,1450194991609,83440,83936
RECOLL.txt,83662,84858,1196,10,Y,Y,1450194991609,83440,83936
RECOLL.txt,84859,85940,1081,10,N,Y,1450195763304,85744,87933
RECOLL.txt,85941,87549,1608,10,N,Y,1450195763304,85744,87933
RECOLL.txt,87550,89069,1519,10,N,Y,1450195763304,85744,87933
RECOLL.txt,89070,90153,1083,10,N,Y,1450196241886,89386,90252
RECOLL.txt,90154,90972,818,10,N,Y,1450196241886,89386,90252
RECOLL.txt,90973,91117,144,10,N,N,-,-1,-1
RECOLL.txt,91118,91305,187,10,N,N,-,-1,-1
RECOLL.txt,91306,92272,966,10,N,Y,1450196550118,92044,92813
RECOLL.txt,92273,93684,1411,10,Y,Y,1450196550118,92044,92813
RECOLL.txt,93689,95263,1574,10,N,N,-,-1,-1
RECOLL.txt,95266,96686,1420,10,N,N,-,-1,-1
RECOLL.txt,96687,98097,1410,10,N,Y,1450197272502,97289,98405
RECOLL.txt,98098,99383,1285,10,Y,Y,1450197272502,97289,98405
RECOLL.txt,99384,100999,1615,10,Y,Y,1450197827406,100079,100567
RECOLL.txt,101002,102440,1438,10,N,Y,1450198228374,101899,104222
RECOLL.txt,102441,104390,1949,10,N,Y,1450198228374,101899,104222
RECOLL.txt,104392,105525,1133,10,N,N,-,-1,-1
RECOLL.txt,105526,106989,1463,10,Y,Y,1450198608392,105951,106876
RECOLL.txt,106990,107766,776,10,Y,Y,1450198899921,107006,107437
RECOLL.txt,107769,108941,1172,10,Y,Y,1450209381136,108935,109356
RECOLL.txt,108943,110152,1209,10,N,Y,1450209381136,108935,109356
RECOLL.txt,110153,111659,1506,10,N,Y,1450210289855,109766,110720
RECOLL.txt,111660,113168,1508,10,N,N,-,-1,-1
RECOLL.txt,113169,115239,2070,10,N,N,-,-1,-1
RECOLL.txt,115240,116562,1322,10,N,Y,1450211094623,115807,116651
RECOLL.txt,116563,117592,1029,10,N,Y,1450212524850,116654,117006
RECOLL.txt,117595,119146,1551,10,N,N,-,-1,-1
RECOLL.txt,119147,120301,1154,10,N,Y,1450213154792,119938,120294
RECOLL.txt,120304,121327,1023,10,N,Y,1450214083353,120984,121752
RECOLL.txt,121328,122335,1007,10,N,Y,1450214856877,122255,122760
RECOLL.txt,122336,123744,1408,10,N,Y,1450214856877,122255,122760
RECOLL.txt,123747,123984,237,10,N,N,-,-1,-1
RECOLL.txt,123985,124710,725,10,N,N,-,-1,-1
RECOLL.txt,124711,125913,1202,10,N,Y,1450215357428,125505,126500
RECOLL.txt,125916,127300,1384,10,N,Y,1450215357428,125505,126500
RECOLL.txt,127303,128948,1645,10,N,Y,1450215778344,128744,129064
RECOLL.txt,128949,130166,1217,10,N,Y,1450215778344,128744,129064
RECOLL.txt,130167,131782,1615,10,N,N,-,-1,-1
RECOLL.txt,131783,133429,1646,10,N,Y,1450217142535,132155,132920
RECOLL.txt,133432,135025,1593,10,N,N,-,-1,-1
RECOLL.txt,135026,136221,1195,10,N,N,-,-1,-1
RECOLL.txt,136222,137256,1034,10,N,N,-,-1,-1
RECOLL.txt,137257,138869,1612,10,Y,Y,1450265940821,137499,138662
RECOLL.txt,138872,140030,1158,10,N,N,-,-1,-1
RECOLL.txt,140031,141258,1227,10,N,N,-,-1,-1
RECOLL.txt,141261,142418,1157,10,N,N,-,-1,-1
RECOLL.txt,142421,143409,988,10,N,N,-,-1,-1
RECOLL.txt,143410,145014,1604,10,N,N,-,-1,-1
RECOLL.txt,145019,146494,1475,10,N,N,-,-1,-1
RECOLL.txt,146495,147706,1211,10,N,N,-,-1,-1
RECOLL.txt,147707,148848,1141,10,N,N,-,-1,-1
RECOLL.txt,148851,150267,1416,10,N,Y,1450266255219,149476,150064
RECOLL.txt,150268,151340,1072,10,N,N,-,-1,-1
RECOLL.txt,151341,152643,1302,10,N,N,-,-1,-1
RECOLL.txt,152644,154217,1573,10,N,N,-,-1,-1
RECOLL.txt,154218,155800,1582,10,N,Y,1450266659853,155779,156351
RECOLL.txt,155801,156945,1144,10,N,Y,1450266659853,155779,156351
RECOLL.txt,156946,158790,1844,10,N,Y,1450267181437,158411,159424
RECOLL.txt,158791,159566,775,10,N,Y,1450267181437,158411,159424
RECOLL.txt,159567,160333,766,10,N,N,-,-1,-1
RECOLL.txt,160336,162425,2089,10,N,Y,1450267451569,160340,162732
RECOLL.txt,162426,163828,1402,10,N,Y,1450268185046,162966,163418
RECOLL.txt,163831,165379,1548,10,Y,Y,1450268661242,163528,164918
RECOLL.txt,165380,166211,831,10,N,N,-,-1,-1
RECOLL.txt,166214,168016,1802,10,N,N,-,-1,-1
RECOLL.txt,168019,169513,1494,10,N,Y,1450268978542,169359,170509
RECOLL.txt,169514,170646,1132,10,N,Y,1450268978542,169359,170509
RECOLL.txt,170649,171885,1236,10,N,N,-,-1,-1
RECOLL.txt,171886,173058,1172,10,N,N,-,-1,-1
RECOLL.txt,173061,174560,1499,10,N,N,-,-1,-1
RECOLL.txt,174561,176075,1514,10,Y,Y,1450269524213,175141,176459
RECOLL.txt,176076,177800,1724,10,N,Y,1450272604542,176533,177646
RECOLL.txt,177801,179171,1370,10,N,Y,1450273026631,178707,180918
RECOLL.txt,179172,179921,749,10,N,Y,1450273026631,178707,180918
RECOLL.txt,179922,180923,1001,10,N,Y,1450273026631,178707,180918
RECOLL.txt,180926,182241,1315,10,N,Y,1450273354749,181694,182351
RECOLL.txt,182242,183665,1423,10,N,Y,1450273354749,181694,182351
RECOLL.txt,183668,185004,1336,10,N,Y,1450273729052,184450,185295
RECOLL.txt,185007,186278,1271,10,Y,Y,1450273729052,184450,185295
RECOLL.txt,186279,187298,1019,10,N,N,-,-1,-1
RECOLL.txt,187299,188628,1329,10,N,N,-,-1,-1
RECOLL.txt,188629,189844,1215,10,N,N,-,-1,-1
RECOLL.txt,189845,191253,1408,10,N,Y,1450274247305,190587,191139
RECOLL.txt,191256,192888,1632,10,N,Y,1450274641828,192265,194302
RECOLL.txt,192889,194177,1288,10,N,Y,1450274641828,192265,194302
RECOLL.txt,194178,195230,1052,10,N,Y,1450274641828,192265,194302
RECOLL.txt,195233,195992,759,10,N,N,-,-1,-1
RECOLL.txt,195993,197151,1158,10,N,N,-,-1,-1
RECOLL.txt,197152,198682,1530,10,N,Y,1450276878994,198569,198873
RECOLL.txt,198683,200093,1410,10,Y,Y,1450276878994,198569,198873
RECOLL.txt,200095,201106,1011,10,N,Y,1450277256048,200011,201853
RECOLL.txt,201107,202345,1238,10,N,Y,1450278260874,201966,203744
RECOLL.txt,202346,203529,1183,10,N,Y,1450278260874,201966,203744
RECOLL.txt,203530,204493,963,10,N,Y,1450278260874,201966,203744
RECOLL.txt,204494,205969,1475,10,Y,Y,1450278710609,204409,206093
RECOLL.txt,205972,207423,1451,10,Y,Y,1450278710609,204409,206093
RECOLL.txt,207426,208577,1151,10,N,Y,1450278992417,207433,208043
RECOLL.txt,208582,209734,1152,10,N,N,-,-1,-1
RECOLL.txt,209736,210600,864,10,N,N,-,-1,-1
RECOLL.txt,210603,211889,1286,10,N,N,-,-1,-1
RECOLL.txt,211890,212934,1044,10,N,N,-,-1,-1
RECOLL.txt,212935,214388,1453,10,N,N,-,-1,-1
RECOLL.txt,214389,216275,1886,10,N,N,-,-1,-1
RECOLL.txt,216277,217884,1607,10,N,Y,1450279453888,217252,218068
RECOLL.txt,217885,219510,1625,10,N,Y,1450279453888,217252,218068
RECOLL.txt,219511,221527,2016,10,N,Y,1450279955242,219797,222549
RECOLL.txt,221530,223226,1696,10,N,Y,1450279955242,219797,222549
RECOLL.txt,223229,224003,774,10,N,N,-,-1,-1
RECOLL.txt,224006,224835,829,10,N,N,-,-1,-1
RECOLL.txt,224838,226286,1448,10,N,N,-,-1,-1
RECOLL.txt,226288,227190,902,10,N,N,-,-1,-1
RECOLL.txt,227191,228884,1693,10,N,N,-,-1,-1
RECOLL.txt,228887,229898,1011,10,N,N,-,-1,-1
RECOLL.txt,229899,231326,1427,10,N,N,-,-1,-1
RECOLL.txt,231327,232655,1328,10,N,N,-,-1,-1
RECOLL.txt,232656,233852,1196,10,N,N,-,-1,-1
RECOLL.txt,233853,235952,2099,10,N,N,-,-1,-1
RECOLL.txt,235953,237246,1293,10,N,N,-,-1,-1
RECOLL.txt,237247,238667,1420,10,N,N,-,-1,-1
RECOLL.txt,238669,239853,1184,10,N,N,-,-1,-1
RECOLL.txt,239854,241569,1715,10,Y,Y,1450280673034,241380,241838
RECOLL.txt,241570,242855,1285,10,N,Y,1450280673034,241380,241838
RECOLL.txt,242858,244846,1988,10,Y,Y,1450281212744,242862,245207
RECOLL.txt,244847,246132,1285,10,Y,Y,1450281212744,242862,245207
RECOLL.txt,246137,246876,739,10,N,N,-,-1,-1
RECOLL.txt,246877,247133,256,10,N,N,-,-1,-1
RECOLL.txt,247134,247389,255,10,N,N,-,-1,-1
RECOLL.txt,247392,247708,316,10,N,N,-,-1,-1
RECOLL.txt,247709,248982,1273,10,N,Y,1450281669613,248365,249575
RECOLL.txt,248983,250425,1442,10,N,Y,1450281669613,248365,249575
RECOLL.txt,250428,251677,1249,10,Y,Y,1450281882861,250970,251409
RECOLL.txt,251680,253265,1585,10,N,Y,1450282101282,251678,252272
RECOLL.txt,253266,255113,1847,10,N,N,-,-1,-1
RECOLL.txt,255114,256514,1400,10,N,Y,1449243316327,255345,255936
RECOLL.txt,256515,258034,1519,10,Y,N,-,-1,-1
RECOLL.txt,258035,258942,907,10,N,Y,1449477805345,258325,259491
RECOLL.txt,258943,260201,1258,10,N,Y,1449477805345,258325,259491
RECOLL.txt,260202,262261,2059,10,N,N,-,-1,-1
RECOLL.txt,262262,263349,1087,10,N,N,-,-1,-1
RECOLL.txt,263351,264533,1182,10,N,N,-,-1,-1
RECOLL.txt,264534,265662,1128,10,N,Y,1449478274965,265280,265790
RECOLL.txt,265663,266643,980,10,N,Y,1449478274965,265280,265790
RECOLL.txt,266644,267802,1158,10,N,N,-,-1,-1
RECOLL.txt,267803,269494,1691,10,N,N,-,-1,-1
RECOLL.txt,269495,270585,1090,10,N,N,-,-1,-1
RECOLL.txt,270586,271769,1183,10,N,N,-,-1,-1
RECOLL.txt,271770,273199,1429,10,N,Y,1449478691795,272071,273405
RECOLL.txt,273200,274727,1527,10,N,Y,1449478691795,272071,273405
RECOLL.txt,274728,276815,2087,10,N,N,-,-1,-1
RECOLL.txt,276816,278509,1693,10,N,Y,1449478940431,277862,278041
RECOLL.txt,278512,280688,2176,10,N,Y,1449479202651,279288,279481
RECOLL.txt,280691,281948,1257,10,N,N,-,-1,-1
RECOLL.txt,281949,283754,1805,10,N,N,-,-1,-1
RECOLL.txt,283756,284730,974,10,N,N,-,-1,-1
RECOLL.txt,284732,285785,1053,10,N,N,-,-1,-1
RECOLL.txt,285786,287150,1364,10,N,N,-,-1,-1
RECOLL.txt,287151,288666,1515,10,N,Y,1449479515559,287879,288347
RECOLL.txt,288669,289617,948,10,N,Y,1449479752042,288402,288873
RECOLL.txt,289618,290698,1080,10,N,Y,1449479980197,289681,290130
RECOLL.txt,290703,292033,1330,10,N,N,-,-1,-1
RECOLL.txt,292034,293247,1213,10,N,N,-,-1,-1
RECOLL.txt,293248,294412,1164,10,N,Y,1449480291305,294170,295182
RECOLL.txt,294413,295705,1292,10,N,Y,1449480291305,294170,295182
RECOLL.txt,295706,296624,918,10,N,Y,1449480505835,295854,296393
RECOLL.txt,296627,297775,1148,10,N,Y,1449480881121,297386,298052
RECOLL.txt,297776,299039,1263,10,N,Y,1449480881121,297386,298052
RECOLL.txt,299040,300134,1094,10,N,N,-,-1,-1
RECOLL.txt,300135,301466,1331,10,N,Y,1450284116337,300339,301692
RECOLL.txt,301467,303020,1553,10,N,Y,1450284116337,300339,301692
RECOLL.txt,303021,304261,1240,10,N,N,-,-1,-1
RECOLL.txt,304262,305548,1286,10,N,N,-,-1,-1
RECOLL.txt,305551,306943,1392,10,N,N,-,-1,-1
RECOLL.txt,306944,308232,1288,10,N,Y,1450350186677,307230,309481
RECOLL.txt,308233,309657,1424,10,N,Y,1450350186677,307230,309481
RECOLL.txt,309658,310728,1070,10,N,Y,1450350675404,309528,311486
RECOLL.txt,310729,311897,1168,10,N,Y,1450350675404,309528,311486
RECOLL.txt,311898,313198,1300,10,N,N,-,-1,-1
RECOLL.txt,313199,314573,1374,10,N,N,-,-1,-1
RECOLL.txt,314574,315904,1330,10,N,N,-,-1,-1
RECOLL.txt,315905,317207,1302,10,N,Y,1450350993349,315954,316737
RECOLL.txt,317209,318353,1144,10,N,N,-,-1,-1
RECOLL.txt,318354,319929,1575,10,N,Y,1450351323826,319770,320896
RECOLL.txt,319930,321780,1850,10,N,Y,1450351323826,319770,320896
RECOLL.txt,321781,323254,1473,10,N,N,-,-1,-1
RECOLL.txt,323255,324770,1515,10,N,N,-,-1,-1
RECOLL.txt,324771,326189,1418,10,N,N,-,-1,-1
RECOLL.txt,326190,327869,1679,10,N,N,-,-1,-1
RECOLL.txt,327869,329885,2016,10,N,N,-,-1,-1
RECOLL.txt,329888,331908,2020,10,N,N,-,-1,-1
RECOLL.txt,331909,333019,1110,10,N,N,-,-1,-1
RECOLL.txt,333020,334451,1431,10,N,N,-,-1,-1
RECOLL.txt,334454,336158,1704,10,N,N,-,-1,-1
RECOLL.txt,336159,337654,1495,10,N,N,-,-1,-1
RECOLL.txt,337655,339315,1660,10,Y,N,-,-1,-1
REMKEL1.txt,3,784,781,10,N,N,-,-1,-1
REMKEL1.txt,785,1808,1023,10,N,N,-,-1,-1
REMKEL1.txt,1809,2256,447,10,N,N,-,-1,-1
REMKEL1.txt,2258,2579,321,10,N,N,-,-1,-1
REMKEL1.txt,2582,3094,512,10,N,N,-,-1,-1
REMKEL1.txt,3096,3682,586,10,N,N,-,-1,-1
REMKEL1.txt,3683,4031,348,10,N,N,-,-1,-1
REMKEL1.txt,4032,4532,500,10,N,N,-,-1,-1
REMKEL1.txt,4533,4902,369,10,N,N,-,-1,-1
REMKEL1.txt,4903,5241,338,10,N,N,-,-1,-1
REMKEL1.txt,5242,5744,502,10,N,N,-,-1,-1
REMKEL1.txt,5745,6128,383,10,N,N,-,-1,-1
REMKEL1.txt,6131,6569,438,10,N,N,-,-1,-1
REMKEL1.txt,6570,6943,373,10,N,N,-,-1,-1
REMKEL1.txt,6944,7328,384,10,N,N,-,-1,-1
REMKEL1.txt,7329,7836,507,10,N,N,-,-1,-1
REMKEL1.txt,7837,8198,361,10,N,N,-,-1,-1
REMKEL1.txt,8200,8523,323,10,N,N,-,-1,-1
REMKEL1.txt,8525,8948,423,10,N,N,-,-1,-1
REMKEL1.txt,8949,9502,553,10,N,N,-,-1,-1
REMKEL1.txt,9503,9923,420,10,N,N,-,-1,-1
REMKEL1.txt,9924,10537,613,10,N,N,-,-1,-1
REMKEL1.txt,10540,10969,429,10,N,N,-,-1,-1
REMKEL1.txt,10970,11629,659,10,N,N,-,-1,-1
REMKEL1.txt,11630,12321,691,10,N,N,-,-1,-1
REMKEL1.txt,12322,12605,283,10,N,N,-,-1,-1
REMKEL1.txt,12606,13023,417,10,N,N,-,-1,-1
REMKEL1.txt,13024,13293,269,10,N,N,-,-1,-1
REMKEL1.txt,13295,13608,313,10,N,N,-,-1,-1
REMKEL1.txt,13609,14043,434,10,N,N,-,-1,-1
REMKEL1.txt,14044,14551,507,10,N,N,-,-1,-1
REMKEL1.txt,14552,15026,474,10,N,N,-,-1,-1
REMKEL1.txt,15028,15396,368,10,N,N,-,-1,-1
REMKEL1.txt,15397,15883,486,10,N,N,-,-1,-1
REMKEL1.txt,15884,16251,367,10,N,N,-,-1,-1
REMKEL1.txt,16252,16620,368,10,N,N,-,-1,-1
REMKEL1.txt,16623,17806,1183,10,N,N,-,-1,-1
REMKEL1.txt,17807,19835,2028,10,N,N,-,-1,-1
REMKEL1.txt,19836,21312,1476,10,Y,N,-,-1,-1
REMKEL1.txt,21313,22648,1335,10,N,N,-,-1,-1
REMKEL1.txt,22651,24644,1993,10,N,N,-,-1,-1
REMKEL1.txt,24645,27036,2391,10,Y,N,-,-1,-1
REMKEL1.txt,27037,28520,1483,10,N,N,-,-1,-1
REMKEL1.txt,28523,29837,1314,10,Y,N,-,-1,-1
REMKEL1.txt,29840,31689,1849,10,N,N,-,-1,-1
REMKEL1.txt,31694,33699,2005,10,Y,N,-,-1,-1
REMKEL1.txt,33700,35703,2003,10,Y,N,-,-1,-1
REMKEL1.txt,35706,37436,1730,10,Y,N,-,-1,-1
REMKEL1.txt,37439,38921,1482,10,Y,N,-,-1,-1
REMKEL1.txt,38924,40326,1402,10,Y,N,-,-1,-1
REMKEL1.txt,40327,41593,1266,10,N,N,-,-1,-1
REMKEL1.txt,41594,42440,846,10,N,N,-,-1,-1
REMKEL1.txt,42443,43529,1086,10,N,N,-,-1,-1
REMKEL1.txt,43530,45084,1554,10,N,N,-,-1,-1
REMKEL1.txt,45085,46134,1049,10,N,N,-,-1,-1
REMKEL1.txt,46135,47498,1363,10,N,N,-,-1,-1
REMKEL1.txt,47501,49868,2367,10,N,N,-,-1,-1
REMKEL1.txt,49869,51802,1933,10,Y,Y,1427373119628,50476,51323
REMKEL1.txt,51805,53880,2075,10,N,N,-,-1,-1
REMKEL1.txt,53881,55260,1379,10,Y,Y,1427373691557,54475,55337
REMKEL1.txt,55261,56639,1378,10,N,Y,1427373691557,54475,55337
REMKEL1.txt,56641,58193,1552,10,N,N,-,-1,-1
REMKEL1.txt,58196,59836,1640,10,N,N,-,-1,-1
REMKEL1.txt,59837,61666,1829,10,N,N,-,-1,-1
REMKEL1.txt,61667,62967,1300,10,N,N,-,-1,-1
REMKEL1.txt,62968,64746,1778,10,N,N,-,-1,-1
REMKEL1.txt,64747,66136,1389,10,N,N,-,-1,-1
REMKEL1.txt,66137,67976,1839,10,N,N,-,-1,-1
REMKEL1.txt,67977,69816,1839,10,N,N,-,-1,-1
REMKEL1.txt,69817,71360,1543,10,N,N,-,-1,-1
REMKEL1.txt,71361,72574,1213,10,N,N,-,-1,-1
REMKEL1.txt,72575,74510,1935,10,N,Y,1427375995210,73781,74572
REMKEL1.txt,74511,76191,1680,10,Y,Y,1427376630476,75869,76825
REMKEL1.txt,76192,77688,1496,10,Y,Y,1427376630476,75869,76825
REMKEL1.txt,77689,79176,1487,10,N,N,-,-1,-1
REMKEL1.txt,79179,80760,1581,10,N,Y,1427377322048,80447,80948
REMKEL1.txt,80763,82206,1443,10,Y,Y,1427377322048,80447,80948
REMKEL1.txt,82207,83002,795,10,Y,Y,1427379753297,81978,82676
REMKEL1.txt,83003,83568,565,10,N,N,-,-1,-1
REMKEL1.txt,83569,84696,1127,10,N,Y,1427459918395,84645,85149
REMKEL1.txt,84697,85812,1115,10,N,Y,1427459918395,84645,85149
REMKEL1.txt,85813,87235,1422,10,N,Y,1427460086043,85397,86219
REMKEL1.txt,87236,89379,2143,10,N,N,-,-1,-1
REMKEL1.txt,89380,91558,2178,10,N,N,-,-1,-1
REMKEL1.txt,91561,93278,1717,10,N,N,-,-1,-1
REMKEL1.txt,93279,93900,621,10,N,N,-,-1,-1
REMKEL1.txt,93901,95264,1363,10,N,N,-,-1,-1
REMKEL1.txt,95265,96790,1525,10,N,N,-,-1,-1
REMKEL1.txt,96791,98504,1713,10,N,Y,1427462513930,98050,98577
REMKEL1.txt,98505,100220,1715,10,N,Y,1427462513930,98050,98577
REMKEL1.txt,100221,102092,1871,10,N,Y,1427462848427,99143,100650
REMKEL1.txt,102095,103709,1614,10,N,Y,1428065655005,103366,109009
REMKEL1.txt,103710,105311,1601,10,Y,Y,1428065655005,103366,109009
REMKEL1.txt,105312,107038,1726,10,N,Y,1428065655005,103366,109009
REMKEL1.txt,107041,108681,1640,10,N,Y,1428065655005,103366,109009
REMKEL1.txt,108682,110719,2037,10,N,Y,1428065655005,103366,109009
REMKEL1.txt,110720,112204,1484,10,N,N,-,-1,-1
REMKEL1.txt,112205,113589,1384,10,Y,N,-,-1,-1
REMKEL1.txt,113590,114733,1143,10,N,Y,1428139555093,114267,115295
REMKEL1.txt,114734,116704,1970,10,N,Y,1428139555093,114267,115295
REMKEL1.txt,116705,118222,1517,10,N,N,-,-1,-1
REMKEL1.txt,118223,119677,1454,10,N,Y,1428140980187,119629,120812
REMKEL1.txt,119678,121062,1384,10,N,Y,1428140980187,119629,120812
REMKEL1.txt,121063,121486,423,10,N,N,-,-1,-1
REMKEL1.txt,121487,122543,1056,10,N,N,-,-1,-1
REMKEL1.txt,122546,124527,1981,10,N,N,-,-1,-1
REMKEL1.txt,124530,126091,1561,10,N,Y,1428142329788,124908,125971
REMKEL1.txt,126094,128061,1967,10,N,N,-,-1,-1
REMKEL1.txt,128062,129515,1453,10,N,N,-,-1,-1
REMKEL1.txt,129517,130846,1329,10,N,N,-,-1,-1
REMKEL1.txt,130847,132942,2095,10,N,N,-,-1,-1
REMKEL1.txt,132945,134682,1737,10,N,N,-,-1,-1
REMKEL1.txt,134685,136433,1748,10,N,N,-,-1,-1
REMKEL1.txt,136434,137732,1298,10,N,N,-,-1,-1
REMKEL1.txt,137733,139347,1614,10,N,N,-,-1,-1
REMKEL1.txt,139348,140688,1340,10,N,N,-,-1,-1
REMKEL1.txt,140689,142256,1567,10,N,N,-,-1,-1
REMKEL1.txt,142259,144247,1988,10,N,Y,1428143866274,142277,143444
REMKEL1.txt,144250,145635,1385,10,N,N,-,-1,-1
REMKEL1.txt,145636,147160,1524,10,N,N,-,-1,-1
REMKEL1.txt,147161,148868,1707,10,N,N,-,-1,-1
REMKEL1.txt,148871,150052,1181,10,N,N,-,-1,-1
REMKEL1.txt,150053,151803,1750,10,N,Y,1428144732441,150786,151788
REMKEL1.txt,151806,153159,1353,10,N,Y,1428145340599,152563,152962
REMKEL1.txt,153161,154461,1300,10,Y,N,-,-1,-1
REMKEL1.txt,154462,155518,1056,10,N,N,-,-1,-1
REMKEL1.txt,155519,156862,1343,10,N,N,-,-1,-1
REMKEL1.txt,156865,158644,1779,10,N,N,-,-1,-1
REMKEL1.txt,158645,160132,1487,10,Y,N,-,-1,-1
REMKEL1.txt,160133,161902,1769,10,N,N,-,-1,-1
REMKEL1.txt,161903,163374,1471,10,N,N,-,-1,-1
REMKEL1.txt,163377,164962,1585,10,N,Y,1428156251387,163375,165208
REMKEL1.txt,164963,166400,1437,10,N,Y,1428164866689,166001,167438
REMKEL1.txt,166401,167759,1358,10,Y,Y,1428164866689,166001,167438
REMKEL1.txt,167761,169156,1395,10,Y,N,-,-1,-1
REMKEL1.txt,169157,170840,1683,10,N,Y,1428166121742,169838,170346
REMKEL1.txt,170842,172283,1441,10,Y,Y,1428167038498,170602,172231
REMKEL1.txt,172285,173922,1637,10,N,N,-,-1,-1
REMKEL1.txt,173923,175842,1919,10,Y,N,-,-1,-1
REMKEL1.txt,175843,177299,1456,10,N,N,-,-1,-1
REMKEL1.txt,177300,178661,1361,10,N,N,-,-1,-1
REMKEL1.txt,178661,179787,1126,10,N,N,-,-1,-1
REMKEL1.txt,179788,181340,1552,10,N,N,-,-1,-1
REMKEL1.txt,181341,182333,992,10,N,N,-,-1,-1
REMKEL1.txt,182334,184061,1727,10,N,N,-,-1,-1
REMKEL1.txt,184062,185788,1726,10,N,N,-,-1,-1
REMKEL1.txt,185790,187335,1545,10,N,Y,1429179224952,186363,187163
REMKEL1.txt,187336,188191,855,10,N,N,-,-1,-1
REMKEL1.txt,188192,189756,1564,10,N,N,-,-1,-1
REMKEL1.txt,189759,191178,1419,10,N,N,-,-1,-1
REMKEL1.txt,191179,192308,1129,10,Y,Y,1429180017418,191485,192427
REMKEL1.txt,192309,193894,1585,10,Y,Y,1429180740975,192464,193718
REMKEL1.txt,193895,195727,1832,10,N,N,-,-1,-1
REMKEL1.txt,195728,197838,2110,10,N,N,-,-1,-1
REMKEL1.txt,197839,199923,2084,10,N,N,-,-1,-1
REMKEL1.txt,199926,201329,1403,10,N,N,-,-1,-1
REMKEL1.txt,201332,203963,2631,10,N,N,-,-1,-1
REMKEL1.txt,203966,204769,803,10,N,N,-,-1,-1
REMKEL1.txt,204770,207066,2296,10,N,N,-,-1,-1
REMKEL1.txt,207067,208760,1693,10,N,Y,1429183348411,208524,209310
REMKEL1.txt,208761,209962,1201,10,N,Y,1429183348411,208524,209310
REMKEL1.txt,209963,211791,1828,10,N,N,-,-1,-1
REMKEL1.txt,211794,213603,1809,10,N,N,-,-1,-1
REMKEL1.txt,213606,214932,1326,10,N,Y,1429184555165,213619,214284
REMKEL1.txt,214933,216121,1188,10,N,N,-,-1,-1
REMKEL1.txt,216122,217875,1753,10,N,N,-,-1,-1
REMKEL1.txt,217876,219123,1247,10,N,N,-,-1,-1
REMKEL1.txt,219126,220774,1648,10,N,N,-,-1,-1
REMKEL1.txt,220775,221608,833,10,N,N,-,-1,-1
REMKEL1.txt,221609,223360,1751,10,N,Y,1429478561003,223319,224140
REMKEL1.txt,223362,224687,1325,10,N,Y,1429478561003,223319,224140
REMKEL1.txt,224688,226110,1422,10,N,Y,1429479695836,224360,224906
REMKEL1.txt,226111,227067,956,10,N,N,-,-1,-1
REMKEL1.txt,227068,228233,1165,10,N,N,-,-1,-1
REMKEL1.txt,228236,230671,2435,10,N,N,-,-1,-1
REMKEL1.txt,230672,233659,2987,10,N,N,-,-1,-1
REMKEL1.txt,233662,235144,1482,10,N,N,-,-1,-1
REMKEL1.txt,235145,237428,2283,10,N,N,-,-1,-1
REMKEL1.txt,237430,239257,1827,10,Y,N,-,-1,-1
REMKEL1.txt,239260,241208,1948,10,N,N,-,-1,-1
REMKEL1.txt,241209,243005,1796,10,Y,Y,1429702947558,242053,243400
REMKEL1.txt,243006,244494,1488,10,N,Y,1429702947558,242053,243400
REMKEL1.txt,244495,246604,2109,10,N,Y,1429703626688,244429,245446
REMKEL1.txt,246605,248579,1974,10,N,N,-,-1,-1
REMKEL1.txt,248582,250298,1716,10,N,N,-,-1,-1
REMKEL1.txt,250299,253133,2834,10,N,N,-,-1,-1
REMKEL1.txt,253134,255724,2590,10,N,Y,1430585951765,253480,254126
REMKEL1.txt,255725,257068,1343,10,N,N,-,-1,-1
REMKEL1.txt,257069,259061,1992,10,N,N,-,-1,-1
REMKEL1.txt,259062,261777,2715,10,Y,Y,1430588560920,259596,260149
REMKEL1.txt,261778,263725,1947,10,Y,N,-,-1,-1
REMKEL1.txt,263726,265125,1399,10,N,N,-,-1,-1
REMKEL1.txt,265126,266989,1863,10,N,N,-,-1,-1
REMKEL1.txt,266990,268854,1864,10,N,N,-,-1,-1
REMKEL1.txt,268855,270070,1215,10,N,N,-,-1,-1
REMKEL1.txt,270071,271739,1668,10,Y,N,-,-1,-1
REMKEL1.txt,271742,273776,2034,10,N,N,-,-1,-1
REMKEL1.txt,273777,275513,1736,10,N,N,-,-1,-1
REMKEL1.txt,275514,277628,2114,10,Y,Y,1430593986926,275535,275764
REMKEL1.txt,277629,280661,3032,10,N,N,-,-1,-1
REMKEL1.txt,280662,282481,1819,10,N,Y,1430594989217,280917,281849
REMKEL1.txt,282481,284255,1774,10,N,N,-,-1,-1
REMKEL1.txt,284258,285489,1231,10,N,N,-,-1,-1
REMKEL1.txt,285490,287287,1797,10,N,N,-,-1,-1
REMKEL1.txt,287288,288881,1593,10,N,N,-,-1,-1
REMKEL1.txt,288883,289962,1079,10,N,N,-,-1,-1
REMKEL1.txt,289963,291385,1422,10,N,N,-,-1,-1
REMKEL1.txt,291386,292880,1494,10,N,N,-,-1,-1
REMKEL1.txt,292883,294059,1176,10,N,N,-,-1,-1
REMKEL1.txt,294062,295674,1612,10,N,N,-,-1,-1
REMKEL1.txt,295675,297543,1868,10,N,N,-,-1,-1
REMKEL1.txt,297546,298978,1432,10,N,N,-,-1,-1
REMKEL1.txt,298979,300450,1471,10,N,N,-,-1,-1
REMKEL1.txt,300451,302068,1617,10,N,N,-,-1,-1
REMKEL1.txt,302069,304103,2034,10,N,N,-,-1,-1
REMKEL1.txt,304104,305823,1719,10,N,N,-,-1,-1
REMKEL1.txt,305824,308015,2191,10,N,N,-,-1,-1
REMKEL1.txt,308016,309656,1640,10,N,N,-,-1,-1
REMKEL1.txt,309658,311122,1464,10,N,N,-,-1,-1
REMKEL1.txt,311123,312720,1597,10,N,N,-,-1,-1
REMKEL1.txt,312721,314477,1756,10,N,N,-,-1,-1
REMKEL1.txt,314480,315819,1339,10,N,N,-,-1,-1
REMKEL1.txt,315824,317131,1307,10,N,N,-,-1,-1
REMKEL1.txt,317132,318982,1850,10,Y,N,-,-1,-1
REMKEL1.txt,318983,320252,1269,10,N,N,-,-1,-1
REMKEL1.txt,320253,322120,1867,10,Y,Y,1430747238328,321121,323743
REMKEL1.txt,322121,322773,652,10,N,Y,1430747238328,321121,323743
REMKEL1.txt,322775,324295,1520,10,N,Y,1430747238328,321121,323743
REMKEL1.txt,324298,325720,1422,10,N,N,-,-1,-1
REMKEL1.txt,325723,326695,972,10,N,Y,1430749600786,325904,327946
REMKEL1.txt,326696,328143,1447,10,N,Y,1430749600786,325904,327946
REMKEL1.txt,328143,329304,1161,10,N,N,-,-1,-1
REMKEL1.txt,329306,330491,1185,10,N,N,-,-1,-1
REMKEL1.txt,330492,332258,1766,10,Y,Y,1430751146450,332109,333778
REMKEL1.txt,332263,333565,1302,10,Y,Y,1430751146450,332109,333778
REMKEL1.txt,333566,335952,2386,10,Y,Y,1430751146450,332109,333778
REMKEL1.txt,335953,338449,2496,10,N,N,-,-1,-1
REMKEL1.txt,338450,339880,1430,10,Y,N,-,-1,-1
REMKEL1.txt,339881,341873,1992,10,N,Y,1430753605807,341769,342306
REMKEL1.txt,341874,344045,2171,10,N,Y,1430753605807,341769,342306
REMKEL1.txt,344046,345535,1489,10,N,N,-,-1,-1
REMKEL1.txt,345536,346878,1342,10,N,N,-,-1,-1
REMKEL1.txt,346879,348139,1260,10,Y,N,-,-1,-1
REMKEL1.txt,348140,349506,1366,10,Y,Y,1430927911131,348654,350235
REMKEL1.txt,349507,351223,1716,10,Y,Y,1430927911131,348654,350235
REMKEL1.txt,351224,352654,1430,10,N,N,-,-1,-1
REMKEL1.txt,352654,353711,1057,10,N,N,-,-1,-1
REMKEL1.txt,353712,355350,1638,10,N,N,-,-1,-1
REMKEL1.txt,355353,356637,1284,10,N,N,-,-1,-1
REMKEL1.txt,356638,357815,1177,10,N,N,-,-1,-1
REMKEL1.txt,357818,359338,1520,10,N,N,-,-1,-1
REMKEL1.txt,359340,360636,1296,10,N,N,-,-1,-1
REMKEL1.txt,360639,363000,2361,10,N,N,-,-1,-1
REMKEL1.txt,363001,364062,1061,10,N,Y,1431600860056,363201,364042
REMKEL1.txt,364065,365721,1656,10,Y,N,-,-1,-1
REMKEL1.txt,365722,367206,1484,10,Y,N,-,-1,-1
REMKEL1.txt,367211,368915,1704,10,Y,N,-,-1,-1
REMKEL1.txt,368916,370403,1487,10,N,Y,1431602703832,369125,369571
REMKEL1.txt,370404,372047,1643,10,N,N,-,-1,-1
REMKEL1.txt,372050,373335,1285,10,Y,N,-,-1,-1
REMKEL1.txt,373336,374922,1586,10,Y,N,-,-1,-1
REMKEL1.txt,374925,375892,967,10,N,N,-,-1,-1
REMKEL1.txt,375893,377476,1583,10,N,N,-,-1,-1
REMKEL1.txt,377479,379912,2433,10,N,N,-,-1,-1
REMKEL1.txt,379913,381324,1411,10,N,N,-,-1,-1
REMKEL1.txt,381327,382530,1203,10,N,N,-,-1,-1
REMKEL1.txt,382531,383685,1154,10,N,N,-,-1,-1
REMKEL1.txt,383686,384746,1060,10,N,N,-,-1,-1
REMKEL1.txt,384749,385964,1215,10,N,N,-,-1,-1
REMKEL1.txt,385965,387121,1156,10,N,N,-,-1,-1
REMKEL1.txt,387122,388641,1519,10,N,N,-,-1,-1
REMKEL1.txt,388643,390316,1673,10,N,N,-,-1,-1
REMKEL1.txt,390317,391999,1682,10,N,N,-,-1,-1
REMKEL1.txt,392002,393687,1685,10,N,N,-,-1,-1
REMKEL1.txt,393690,395795,2105,10,N,N,-,-1,-1
REMKEL1.txt,395796,396981,1185,10,N,N,-,-1,-1
REMKEL1.txt,396982,398360,1378,10,N,N,-,-1,-1
REMKEL1.txt,398361,400895,2534,10,N,Y,1431611462110,399892,400362
REMKEL1.txt,400896,402262,1366,10,N,N,-,-1,-1
REMKEL1.txt,402265,404368,2103,10,Y,N,-,-1,-1
REMKEL1.txt,404369,406751,2382,10,N,Y,1431613303057,404779,405342
REMKEL1.txt,406752,408911,2159,10,Y,N,-,-1,-1
REMKEL1.txt,408913,411747,2834,10,Y,N,-,-1,-1
REMKEL1.txt,411748,413784,2036,10,Y,Y,1431615187175,412407,415852
REMKEL1.txt,413785,415365,1580,10,Y,Y,1431615187175,412407,415852
REMKEL1.txt,415366,416954,1588,10,N,Y,1431615187175,412407,415852
REMKEL1.txt,416957,419716,2759,10,N,N,-,-1,-1
REMKEL1.txt,419717,421465,1748,10,Y,N,-,-1,-1
REMKEL1.txt,421466,422873,1407,10,N,N,-,-1,-1
REMKEL1.txt,422874,424302,1428,10,Y,Y,1432056176787,423095,424004
REMKEL1.txt,424303,426911,2608,10,N,N,-,-1,-1
REMKEL1.txt,426912,428166,1254,10,N,N,-,-1,-1
REMKEL1.txt,428171,429567,1396,10,N,N,-,-1,-1
REMKEL1.txt,429569,430901,1332,10,N,Y,1432060885983,429653,430653
REMKEL1.txt,430902,432758,1856,10,Y,Y,1432137873706,431575,434541
REMKEL1.txt,432761,434688,1927,10,Y,Y,1432137873706,431575,434541
REMKEL1.txt,434689,436767,2078,10,N,Y,1432138360719,435276,437675
REMKEL1.txt,436768,439068,2300,10,N,Y,1432138360719,435276,437675
REMKEL1.txt,439070,440083,1013,10,N,N,-,-1,-1
REMKEL1.txt,440084,441318,1234,10,N,Y,1432138782679,440486,440948
REMKEL1.txt,441319,443906,2587,10,N,Y,1432138943360,440957,441390
REMKEL1.txt,443909,445634,1725,10,N,Y,1432139637153,443461,444025
REMKEL1.txt,445635,447748,2113,10,N,Y,1432140652765,444022,446180
REMKEL1.txt,447749,449582,1833,10,N,N,-,-1,-1
REMKEL1.txt,449585,451178,1593,10,N,Y,1434304562715,449617,451671
REMKEL1.txt,451179,453725,2546,10,Y,Y,1434304562715,449617,451671
REMKEL1.txt,453726,455646,1920,10,N,N,-,-1,-1
REMKEL1.txt,455647,455935,288,10,N,N,-,-1,-1
REMKEL1.txt,455936,457054,1118,10,N,Y,1435163669623,456834,458582
REMKEL1.txt,457054,458890,1836,10,N,Y,1435164506717,458656,459229
REMKEL1.txt,458891,459636,745,10,N,Y,1435164969620,459343,460812
REMKEL1.txt,459637,459740,103,10,N,Y,1435164969620,459343,460812
REMKEL1.txt,459743,460242,499,10,N,Y,1435164969620,459343,460812
REMKEL1.txt,460243,461972,1729,10,Y,Y,1435164969620,459343,460812
REMKEL1.txt,461974,463658,1684,10,Y,Y,1435165913179,460834,463218
REMKEL1.txt,463659,464829,1170,10,N,Y,1435246296080,463319,464604
REMKEL1.txt,464830,466281,1451,10,N,Y,1435246956861,465116,468674
REMKEL1.txt,466282,468613,2331,10,Y,Y,1435246956861,465116,468674
REMKEL1.txt,468614,470232,1618,10,N,Y,1435246956861,465116,468674
REMKEL1.txt,470233,471832,1599,10,N,N,-,-1,-1
REMKEL1.txt,471833,472688,855,10,Y,N,-,-1,-1
REMKEL1.txt,472689,473793,1104,10,N,N,-,-1,-1
REMKEL1.txt,473794,475338,1544,10,Y,Y,1435248772832,474122,475026
REMKEL1.txt,475341,477116,1775,10,Y,N,-,-1,-1
REMKEL1.txt,477117,478316,1199,10,N,Y,1435249587702,477567,478661
REMKEL1.txt,478317,481102,2785,10,N,Y,1435249587702,477567,478661
REMKEL1.txt,481103,482719,1616,10,N,N,-,-1,-1
REMKEL1.txt,482720,484370,1650,10,N,N,-,-1,-1
REMKEL1.txt,484371,485889,1518,10,N,N,-,-1,-1
REMKEL1.txt,485890,487036,1146,10,N,N,-,-1,-1
REMKEL1.txt,487037,488639,1602,10,N,N,-,-1,-1
REMKEL1.txt,488642,490643,2001,10,N,Y,1435312884754,489937,490626
REMKEL1.txt,490646,492346,1700,10,N,N,-,-1,-1
REMKEL1.txt,492347,494324,1977,10,N,N,-,-1,-1
REMKEL1.txt,494325,495639,1314,10,N,N,-,-1,-1
REMKEL1.txt,495641,497281,1640,10,N,N,-,-1,-1
REMKEL1.txt,497282,498802,1520,10,N,N,-,-1,-1
REMKEL1.txt,498805,500813,2008,10,N,Y,1435314166443,498844,500332
REMKEL1.txt,500816,501417,601,10,N,N,-,-1,-1
REMKEL2.txt,0,528,528,10,N,N,-,-1,-1
REMKEL2.txt,530,923,393,10,N,N,-,-1,-1
REMKEL2.txt,925,1412,487,10,N,N,-,-1,-1
REMKEL2.txt,1413,1833,420,10,N,N,-,-1,-1
REMKEL2.txt,1834,2390,556,10,N,N,-,-1,-1
REMKEL2.txt,2391,2929,538,10,N,N,-,-1,-1
REMKEL2.txt,2930,3414,484,10,N,N,-,-1,-1
REMKEL2.txt,3415,3860,445,10,N,N,-,-1,-1
REMKEL2.txt,3861,4217,356,10,N,N,-,-1,-1
REMKEL2.txt,4218,4542,324,10,N,N,-,-1,-1
REMKEL2.txt,4544,4982,438,10,N,N,-,-1,-1
REMKEL2.txt,4983,5423,440,10,N,N,-,-1,-1
REMKEL2.txt,5424,5807,383,10,N,N,-,-1,-1
REMKEL2.txt,5808,6199,391,10,N,N,-,-1,-1
REMKEL2.txt,6200,6669,469,10,N,N,-,-1,-1
REMKEL2.txt,6669,7063,394,10,N,N,-,-1,-1
REMKEL2.txt,7064,7449,385,10,N,N,-,-1,-1
REMKEL2.txt,7450,7856,406,10,N,N,-,-1,-1
REMKEL2.txt,7857,8160,303,10,N,N,-,-1,-1
REMKEL2.txt,8163,8596,433,10,N,N,-,-1,-1
REMKEL2.txt,8599,9094,495,10,N,N,-,-1,-1
REMKEL2.txt,9095,9427,332,10,N,N,-,-1,-1
REMKEL2.txt,9428,9845,417,10,N,N,-,-1,-1
REMKEL2.txt,9846,10168,322,10,N,N,-,-1,-1
REMKEL2.txt,10169,10513,344,10,N,N,-,-1,-1
REMKEL2.txt,10516,10817,301,10,N,N,-,-1,-1
REMKEL2.txt,10818,11295,477,10,N,N,-,-1,-1
REMKEL2.txt,11296,11636,340,10,N,N,-,-1,-1
REMKEL2.txt,11637,11989,352,10,N,N,-,-1,-1
REMKEL2.txt,11990,12754,764,10,N,N,-,-1,-1
REMKEL2.txt,12755,13775,1020,10,N,Y,1435351885643,13188,14403
REMKEL2.txt,13776,15129,1353,10,N,Y,1435355555620,14479,15098
REMKEL2.txt,15130,18420,3290,10,N,Y,1435357682797,15132,15608
REMKEL2.txt,18421,19364,943,10,N,N,-,-1,-1
REMKEL2.txt,19367,21074,1707,10,N,Y,1435769270470,19677,20071
REMKEL2.txt,21076,23083,2007,10,N,Y,1435769967749,22041,22587
REMKEL2.txt,23084,24811,1727,10,N,Y,1435771053245,23433,25540
REMKEL2.txt,24812,26727,1915,10,N,Y,1435771053245,23433,25540
REMKEL2.txt,26728,28585,1857,10,N,Y,1435782599159,27378,29050
REMKEL2.txt,28586,29545,959,10,N,Y,1435782599159,27378,29050
REMKEL2.txt,29548,30660,1112,10,N,N,-,-1,-1
REMKEL2.txt,30663,31872,1209,10,N,Y,1435783099009,31525,31867
REMKEL2.txt,31875,33649,1774,10,N,Y,1435784346015,31918,33454
REMKEL2.txt,33650,35592,1942,10,N,N,-,-1,-1
REMKEL2.txt,35595,37337,1742,10,N,N,-,-1,-1
REMKEL2.txt,37338,38979,1641,10,N,N,-,-1,-1
REMKEL2.txt,38980,41317,2337,10,N,N,-,-1,-1
REMKEL2.txt,41318,43957,2639,10,N,Y,1435857399186,41984,42949
REMKEL2.txt,43958,45384,1426,10,N,N,-,-1,-1
REMKEL2.txt,45387,47673,2286,10,N,N,-,-1,-1
REMKEL2.txt,47675,49789,2114,10,N,N,-,-1,-1
REMKEL2.txt,49792,51556,1764,10,N,N,-,-1,-1
REMKEL2.txt,51557,53408,1851,10,N,N,-,-1,-1
REMKEL2.txt,53409,54715,1306,10,N,Y,1435858450692,53412,54290
REMKEL2.txt,54717,55872,1155,10,N,Y,1435858990668,54337,55671
REMKEL2.txt,55873,57938,2065,10,Y,Y,1435862440580,57258,58200
REMKEL2.txt,57939,59729,1790,10,N,Y,1435862440580,57258,58200
REMKEL2.txt,59730,60815,1085,10,N,Y,1435863052573,60462,60688
REMKEL2.txt,60816,62192,1376,10,N,Y,1435863114996,60692,60989
REMKEL2.txt,62194,63568,1374,10,N,N,-,-1,-1
REMKEL2.txt,63569,65294,1725,10,N,N,-,-1,-1
REMKEL2.txt,65295,67447,2152,10,N,N,-,-1,-1
REMKEL2.txt,67450,68945,1495,10,N,N,-,-1,-1
REMKEL2.txt,68946,70293,1347,10,N,N,-,-1,-1
REMKEL2.txt,70298,72374,2076,10,N,N,-,-1,-1
REMKEL2.txt,72375,74056,1681,10,N,N,-,-1,-1
REMKEL2.txt,74057,74835,778,10,N,N,-,-1,-1
REMKEL2.txt,74836,76585,1749,10,N,N,-,-1,-1
REMKEL2.txt,76586,78116,1530,10,N,N,-,-1,-1
REMKEL2.txt,78117,78903,786,10,N,N,-,-1,-1
REMKEL2.txt,78905,80700,1795,10,N,N,-,-1,-1
REMKEL2.txt,80703,81552,849,10,N,Y,1435865160115,81233,81988
REMKEL2.txt,81554,83241,1687,10,N,Y,1435865160115,81233,81988
REMKEL2.txt,83243,85287,2044,10,N,N,-,-1,-1
REMKEL2.txt,85289,87926,2637,10,N,Y,1435865766643,87290,87654
REMKEL2.txt,87927,89804,1877,10,N,N,-,-1,-1
REMKEL2.txt,89806,90883,1077,10,N,N,-,-1,-1
REMKEL2.txt,90886,93089,2203,10,Y,N,-,-1,-1
REMKEL2.txt,93090,94597,1507,10,N,N,-,-1,-1
REMKEL2.txt,94598,96174,1576,10,Y,N,-,-1,-1
REMKEL2.txt,96177,97456,1279,10,N,N,-,-1,-1
REMKEL2.txt,97459,98935,1476,10,N,Y,1436126047679,97988,98333
REMKEL2.txt,98937,101052,2115,10,N,Y,1436126680550,100972,101605
REMKEL2.txt,101053,102387,1334,10,N,Y,1436126680550,100972,101605
REMKEL2.txt,102388,103702,1314,10,N,Y,1436126929844,101615,102764
REMKEL2.txt,103703,104680,977,10,N,Y,1436293470468,103834,104024
REMKEL2.txt,104681,106291,1610,10,N,Y,1436293974870,105377,105629
REMKEL2.txt,106292,106943,651,10,N,N,-,-1,-1
REMKEL2.txt,106946,108471,1525,10,N,N,-,-1,-1
REMKEL2.txt,108474,109779,1305,10,Y,N,-,-1,-1
REMKEL2.txt,109782,111584,1802,10,Y,Y,1436298400992,111204,111685
REMKEL2.txt,111585,112790,1205,10,N,Y,1436298400992,111204,111685
REMKEL2.txt,112795,114513,1718,10,N,Y,1436298772179,111746,112985
REMKEL2.txt,114516,115913,1397,10,N,Y,1436352571813,115777,116442
REMKEL2.txt,115914,117527,1613,10,N,Y,1436352919472,117021,119063
REMKEL2.txt,117528,118984,1456,10,N,Y,1436352919472,117021,119063
REMKEL2.txt,118985,120052,1067,10,N,Y,1436352919472,117021,119063
REMKEL2.txt,120057,120873,816,10,N,N,-,-1,-1
REMKEL2.txt,120876,121598,722,10,N,N,-,-1,-1
REMKEL2.txt,121598,123184,1586,10,Y,Y,1436472126635,121874,122900
REMKEL2.txt,123185,124927,1742,10,N,N,-,-1,-1
REMKEL2.txt,124928,126782,1854,10,N,N,-,-1,-1
REMKEL2.txt,126785,128831,2046,10,Y,N,-,-1,-1
REMKEL2.txt,128832,130988,2156,10,N,N,-,-1,-1
REMKEL2.txt,130991,132923,1932,10,N,N,-,-1,-1
REMKEL2.txt,132924,134956,2032,10,N,Y,1436813469893,134408,134846
REMKEL2.txt,134958,136482,1524,10,N,N,-,-1,-1
REMKEL2.txt,136484,137843,1359,10,N,N,-,-1,-1
REMKEL2.txt,137846,138970,1124,10,N,N,-,-1,-1
REMKEL2.txt,138971,141177,2206,10,N,N,-,-1,-1
REMKEL2.txt,141178,142938,1760,10,N,N,-,-1,-1
REMKEL2.txt,142941,144143,1202,10,N,N,-,-1,-1
REMKEL2.txt,144144,145340,1196,10,N,N,-,-1,-1
REMKEL2.txt,145341,147210,1869,10,N,N,-,-1,-1
REMKEL2.txt,147211,149284,2073,10,N,N,-,-1,-1
REMKEL2.txt,149285,150938,1653,10,N,N,-,-1,-1
REMKEL2.txt,150939,152236,1297,10,N,N,-,-1,-1
REMKEL2.txt,152238,153857,1619,10,N,N,-,-1,-1
REMKEL2.txt,153858,155481,1623,10,N,N,-,-1,-1
REMKEL2.txt,155482,156865,1383,10,N,N,-,-1,-1
REMKEL2.txt,156866,159219,2353,10,Y,N,-,-1,-1
REMKEL2.txt,159222,160305,1083,10,N,N,-,-1,-1
REMKEL2.txt,160310,161939,1629,10,N,N,-,-1,-1
REMKEL2.txt,161939,163674,1735,10,N,N,-,-1,-1
REMKEL2.txt,163677,165789,2112,10,N,N,-,-1,-1
REMKEL2.txt,165791,168230,2439,10,N,N,-,-1,-1
REMKEL2.txt,168231,169945,1714,10,Y,N,-,-1,-1
REMKEL2.txt,169948,172005,2057,10,N,Y,1436888170573,169972,170218
REMKEL2.txt,172006,173510,1504,10,N,N,-,-1,-1
REMKEL2.txt,173513,175856,2343,10,N,N,-,-1,-1
REMKEL2.txt,175857,177022,1165,10,N,N,-,-1,-1
REMKEL2.txt,177023,178813,1790,10,N,N,-,-1,-1
REMKEL2.txt,178814,179996,1182,10,N,N,-,-1,-1
REMKEL2.txt,179999,181088,1089,10,N,N,-,-1,-1
REMKEL2.txt,181089,182933,1844,10,N,N,-,-1,-1
REMKEL2.txt,182936,184574,1638,10,N,Y,1436889057877,184044,184421
REMKEL2.txt,184576,186050,1474,10,Y,N,-,-1,-1
REMKEL2.txt,186051,188032,1981,10,N,N,-,-1,-1
REMKEL2.txt,188033,189055,1022,10,N,N,-,-1,-1
REMKEL2.txt,189057,190422,1365,10,N,N,-,-1,-1
REMKEL2.txt,190425,192086,1661,10,N,N,-,-1,-1
REMKEL2.txt,192087,193753,1666,10,N,N,-,-1,-1
REMKEL2.txt,193754,195042,1288,10,N,N,-,-1,-1
REMKEL2.txt,195043,196743,1700,10,N,N,-,-1,-1
REMKEL2.txt,196744,198703,1959,10,N,N,-,-1,-1
REMKEL2.txt,198704,200519,1815,10,N,N,-,-1,-1
REMKEL2.txt,200520,202489,1969,10,N,N,-,-1,-1
REMKEL2.txt,202492,204244,1752,10,N,N,-,-1,-1
REMKEL2.txt,204247,205803,1556,10,N,Y,1436891628994,205586,205983
REMKEL2.txt,205804,207053,1249,10,N,Y,1436892204871,206775,207267
REMKEL2.txt,207053,209338,2285,10,N,Y,1436892204871,206775,207267
REMKEL2.txt,209341,211310,1969,10,N,N,-,-1,-1
REMKEL2.txt,211311,214093,2782,10,N,N,-,-1,-1
REMKEL2.txt,214094,216329,2235,10,N,N,-,-1,-1
REMKEL2.txt,216330,218344,2014,10,N,N,-,-1,-1
REMKEL2.txt,218347,219745,1398,10,N,N,-,-1,-1
REMKEL2.txt,219746,221457,1711,10,N,N,-,-1,-1
REMKEL2.txt,221458,223559,2101,10,Y,N,-,-1,-1
REMKEL2.txt,223562,224480,918,10,N,N,-,-1,-1
REMKEL2.txt,224481,225954,1473,10,Y,N,-,-1,-1
REMKEL2.txt,225955,227321,1366,10,Y,N,-,-1,-1
REMKEL2.txt,227323,228777,1454,10,N,N,-,-1,-1
REMKEL2.txt,228778,230128,1350,10,N,N,-,-1,-1
REMKEL2.txt,230131,231661,1530,10,N,Y,1436953347952,230164,230508
REMKEL2.txt,231664,233258,1594,10,N,N,-,-1,-1
REMKEL2.txt,233261,234546,1285,10,N,Y,1436954082750,233291,233734
REMKEL2.txt,234549,236313,1764,10,N,N,-,-1,-1
REMKEL2.txt,236314,237963,1649,10,N,N,-,-1,-1
REMKEL2.txt,237964,239337,1373,10,N,N,-,-1,-1
REMKEL2.txt,239338,240674,1336,10,N,N,-,-1,-1
REMKEL2.txt,240675,241664,989,10,N,Y,1436990194671,241135,241539
REMKEL2.txt,241665,242783,1118,10,N,N,-,-1,-1
REMKEL2.txt,242784,244374,1590,10,N,Y,1437162662523,242944,243494
REMKEL2.txt,244377,245743,1366,10,N,N,-,-1,-1
REMKEL2.txt,245745,247157,1412,10,N,N,-,-1,-1
REMKEL2.txt,247158,249030,1872,10,N,N,-,-1,-1
REMKEL2.txt,249031,250355,1324,10,N,N,-,-1,-1
REMKEL2.txt,250357,251339,982,10,N,N,-,-1,-1
REMKEL2.txt,251340,253208,1868,10,N,N,-,-1,-1
REMKEL2.txt,253210,254532,1322,10,N,Y,1437230370982,253380,254066
REMKEL2.txt,254533,256246,1713,10,Y,N,-,-1,-1
REMKEL2.txt,256247,257956,1709,10,N,N,-,-1,-1
REMKEL2.txt,257957,259697,1740,10,N,N,-,-1,-1
REMKEL2.txt,259698,261753,2055,10,Y,N,-,-1,-1
REMKEL2.txt,261754,263219,1465,10,N,Y,1437239674324,263038,263264
REMKEL2.txt,263220,264945,1725,10,N,Y,1437239750517,263268,263763
REMKEL2.txt,264946,266081,1135,10,N,Y,1437246845677,264808,265284
REMKEL2.txt,266082,267514,1432,10,N,Y,1437247439363,265960,266383
REMKEL2.txt,267515,269431,1916,10,N,Y,1437247700707,268409,269169
REMKEL2.txt,269432,270503,1071,10,N,Y,1437248020573,269635,269983
REMKEL2.txt,270506,272099,1593,10,N,N,-,-1,-1
REMKEL2.txt,272100,273069,969,10,N,N,-,-1,-1
REMKEL2.txt,273072,274968,1896,10,N,N,-,-1,-1
REMKEL2.txt,274969,276249,1280,10,N,N,-,-1,-1
REMKEL2.txt,276251,277881,1630,10,N,N,-,-1,-1
REMKEL2.txt,277881,279864,1983,10,Y,N,-,-1,-1
REMKEL2.txt,279865,281378,1513,10,N,N,-,-1,-1
REMKEL2.txt,281379,283315,1936,10,N,N,-,-1,-1
REMKEL2.txt,283317,284377,1060,10,N,N,-,-1,-1
REMKEL2.txt,284378,286001,1623,10,N,N,-,-1,-1
REMKEL2.txt,286002,287281,1279,10,N,Y,1437304627219,286832,287509
REMKEL2.txt,287283,289352,2069,10,Y,Y,1437304627219,286832,287509
REMKEL2.txt,289353,291277,1924,10,N,N,-,-1,-1
REMKEL2.txt,291278,292705,1427,10,N,Y,1437307314987,292427,293858
REMKEL2.txt,292706,294080,1374,10,N,Y,1437307314987,292427,293858
REMKEL2.txt,294081,295256,1175,10,N,Y,1437308275313,294601,295236
REMKEL2.txt,295261,296745,1484,10,N,Y,1437308845347,295831,296335
REMKEL2.txt,296746,298087,1341,10,N,N,-,-1,-1
REMKEL2.txt,298088,299674,1586,10,N,N,-,-1,-1
REMKEL2.txt,299675,301339,1664,10,N,N,-,-1,-1
REMKEL2.txt,301342,302616,1274,10,N,N,-,-1,-1
REMKEL2.txt,302618,304046,1428,10,N,Y,1437326732408,303180,303407
REMKEL2.txt,304048,305277,1229,10,N,N,-,-1,-1
REMKEL2.txt,305280,306843,1563,10,N,N,-,-1,-1
REMKEL2.txt,306845,308487,1642,10,N,N,-,-1,-1
REMKEL2.txt,308488,309744,1256,10,N,N,-,-1,-1
REMKEL2.txt,309746,311373,1627,10,N,Y,1437327783601,310966,311726
REMKEL2.txt,311374,312400,1026,10,N,Y,1437328064404,312197,312391
REMKEL2.txt,312403,313521,1118,10,N,N,-,-1,-1
REMKEL2.txt,313524,314954,1430,10,N,N,-,-1,-1
REMKEL2.txt,314957,317049,2092,10,N,N,-,-1,-1
REMKEL2.txt,317052,318927,1875,10,N,N,-,-1,-1
REMKEL2.txt,318930,320298,1368,10,N,N,-,-1,-1
REMKEL2.txt,320299,321505,1206,10,N,N,-,-1,-1
REMKEL2.txt,321507,322537,1030,10,N,N,-,-1,-1
REMKEL2.txt,322538,323927,1389,10,N,N,-,-1,-1
REMKEL2.txt,323932,325843,1911,10,N,N,-,-1,-1
REMKEL2.txt,325844,326907,1063,10,N,N,-,-1,-1
REMKEL2.txt,326910,328102,1192,10,Y,N,-,-1,-1
REMKEL2.txt,328103,329263,1160,10,N,Y,1437329475190,328720,329175
REMKEL2.txt,329264,330811,1547,10,Y,Y,1437329990944,330563,331008
REMKEL2.txt,330812,332437,1625,10,N,Y,1437329990944,330563,331008
REMKEL2.txt,332438,333734,1296,10,N,Y,1437330221492,332568,334983
REMKEL2.txt,333735,335043,1308,10,N,Y,1437330221492,332568,334983
REMKEL2.txt,335046,336320,1274,10,N,N,-,-1,-1
REMKEL2.txt,336321,337856,1535,10,N,Y,1437406606228,336576,337981
REMKEL2.txt,337859,338844,985,10,N,Y,1437406606228,336576,337981
REMKEL2.txt,338845,340003,1158,10,N,Y,1437406989981,338684,339072
REMKEL2.txt,340004,341893,1889,10,Y,Y,1437407180880,341111,341253
REMKEL2.txt,341894,343238,1344,10,N,N,-,-1,-1
REMKEL2.txt,343241,344823,1582,10,N,Y,1437408733806,343263,344199
REMKEL2.txt,344824,346465,1641,10,N,N,-,-1,-1
REMKEL2.txt,346466,347680,1214,10,N,N,-,-1,-1
REMKEL2.txt,347683,349449,1766,10,N,N,-,-1,-1
REMKEL2.txt,349450,350454,1004,10,N,Y,1437411277724,350226,350749
REMKEL2.txt,350455,352395,1940,10,Y,Y,1437411366462,350764,351452
REMKEL2.txt,352396,354311,1915,10,N,Y,1437415954991,352776,353698
REMKEL2.txt,354314,356975,2661,10,N,N,-,-1,-1
REMKEL2.txt,356976,358912,1936,10,N,N,-,-1,-1
REMKEL2.txt,358915,361073,2158,10,N,N,-,-1,-1
REMKEL2.txt,361074,363476,2402,10,N,Y,1437426519522,362639,362832
REMKEL2.txt,363477,364716,1239,10,N,Y,1437428195505,364284,364459
REMKEL2.txt,364718,366135,1417,10,N,N,-,-1,-1
REMKEL2.txt,366138,367304,1166,10,N,N,-,-1,-1
REMKEL2.txt,367305,368930,1625,10,N,N,-,-1,-1
REMKEL2.txt,368933,371074,2141,10,N,Y,1437429287876,369796,370314
REMKEL2.txt,371075,372520,1445,10,N,Y,1437429758375,371960,372645
REMKEL2.txt,372523,373647,1124,10,N,Y,1437429758375,371960,372645
REMKEL2.txt,373648,374410,762,10,N,N,-,-1,-1
REMKEL2.txt,374411,375940,1529,10,N,N,-,-1,-1
REMKEL2.txt,375941,377080,1139,10,N,N,-,-1,-1
REMKEL2.txt,377081,377842,761,10,N,N,-,-1,-1
REMKEL2.txt,377845,378808,963,10,N,Y,1437430915650,378465,378654
REMKEL2.txt,378811,380585,1774,10,N,Y,1437497691523,379511,381383
REMKEL2.txt,380586,381856,1270,10,N,Y,1437497691523,379511,381383
REMKEL2.txt,381857,383813,1956,10,N,Y,1437499345691,382582,382870
REMKEL2.txt,383816,386177,2361,10,N,N,-,-1,-1
REMKEL2.txt,386178,387400,1222,10,N,N,-,-1,-1
REMKEL2.txt,387401,388059,658,10,N,Y,1437499592999,387747,388053
REMKEL2.txt,388062,389425,1363,10,N,Y,1437500212019,388065,389412
REMKEL2.txt,389428,390952,1524,10,Y,Y,1437557057765,389552,390910
REMKEL2.txt,390957,392367,1410,10,N,Y,1437557985724,390983,391293
REMKEL2.txt,392368,393997,1629,10,N,Y,1437558718321,393945,394737
REMKEL2.txt,393998,396328,2330,10,N,Y,1437558718321,393945,394737
REMKEL2.txt,396333,398206,1873,10,N,Y,1438688689316,397692,398374
REMKEL2.txt,398209,400221,2012,10,N,Y,1438688689316,397692,398374
REMKEL2.txt,400224,402276,2052,10,N,N,-,-1,-1
REMKEL2.txt,402277,403517,1240,10,N,N,-,-1,-1
REMKEL2.txt,403518,404556,1038,10,N,Y,1438689541013,403594,405079
REMKEL2.txt,404557,405039,482,10,N,Y,1438689541013,403594,405079
REMKEL2.txt,405040,407043,2003,10,N,Y,1438689541013,403594,405079
REMKEL2.txt,407045,408395,1350,10,N,Y,1438690627657,407139,408101
REMKEL2.txt,408398,409310,912,10,N,N,-,-1,-1
REMKEL2.txt,409311,410897,1586,10,N,N,-,-1,-1
REMKEL2.txt,410900,412484,1584,10,Y,N,-,-1,-1
REMKEL2.txt,412486,414071,1585,10,N,N,-,-1,-1
REMKEL2.txt,414072,415033,961,10,N,N,-,-1,-1
REMKEL2.txt,415034,416891,1857,10,N,N,-,-1,-1
REMKEL2.txt,416896,418937,2041,10,N,Y,1438707390329,418837,419955
REMKEL2.txt,418938,420785,1847,10,Y,Y,1438707390329,418837,419955
REMKEL2.txt,420788,422702,1914,10,N,Y,1438708055915,422648,423704
REMKEL2.txt,422703,424332,1629,10,N,Y,1438708497019,423911,424226
REMKEL2.txt,424335,425723,1388,10,N,N,-,-1,-1
REMKEL2.txt,425724,427382,1658,10,N,N,-,-1,-1
REMKEL2.txt,427383,429051,1668,10,N,N,-,-1,-1
REMKEL2.txt,429052,430894,1842,10,N,N,-,-1,-1
REMKEL2.txt,430895,433221,2326,10,N,N,-,-1,-1
REMKEL2.txt,433222,435418,2196,10,N,N,-,-1,-1
REMKEL2.txt,435421,438681,3260,10,N,N,-,-1,-1
REMKEL2.txt,438682,440345,1663,10,N,N,-,-1,-1
REMKEL2.txt,440346,442007,1661,10,N,N,-,-1,-1
REMKEL2.txt,442010,443701,1691,10,N,N,-,-1,-1
REMKEL2.txt,443702,444926,1224,10,N,N,-,-1,-1
REMKEL2.txt,444929,446520,1591,10,N,N,-,-1,-1
REMKEL2.txt,446521,447847,1326,10,N,N,-,-1,-1
REMKEL2.txt,447848,449261,1413,10,N,N,-,-1,-1
REMKEL2.txt,449262,451691,2429,10,N,N,-,-1,-1
REMKEL2.txt,451694,452623,929,10,N,N,-,-1,-1
REMKEL2.txt,452626,454068,1442,10,N,Y,1438711328776,453254,453945
REMKEL2.txt,454073,454373,300,10,N,N,-,-1,-1
REMKEL2.txt,454374,454844,470,10,N,N,-,-1,-1
REMKEL2.txt,454847,455042,195,10,N,N,-,-1,-1
REMKEL2.txt,455043,455155,112,10,N,N,-,-1,-1
REMKEL2.txt,455157,455505,348,10,N,N,-,-1,-1
REMKEL2.txt,455506,455734,228,10,N,N,-,-1,-1
REMKEL2.txt,455735,456065,330,10,N,N,-,-1,-1
REMKEL2.txt,456068,456285,217,10,N,N,-,-1,-1
REMKEL2.txt,456286,456451,165,10,N,N,-,-1,-1
REMKEL2.txt,456454,456800,346,10,N,N,-,-1,-1
REMKEL2.txt,456801,457204,403,10,N,N,-,-1,-1
REMKEL2.txt,457205,457417,212,10,N,N,-,-1,-1
REMKEL2.txt,457418,457674,256,10,N,N,-,-1,-1
REMKEL2.txt,457675,459518,1843,10,Y,N,-,-1,-1
REMKEL2.txt,459520,461280,1760,10,N,N,-,-1,-1
REMKEL2.txt,461282,463252,1970,10,N,Y,1438857102755,461608,465337
REMKEL2.txt,463253,464571,1318,10,N,Y,1438857102755,461608,465337
REMKEL2.txt,464574,466733,2159,10,N,Y,1438857102755,461608,465337
REMKEL2.txt,466736,468883,2147,10,Y,N,-,-1,-1
REMKEL2.txt,468884,470457,1573,10,N,N,-,-1,-1
REMKEL2.txt,470458,472486,2028,10,N,N,-,-1,-1
REMKEL2.txt,472488,474342,1854,10,Y,N,-,-1,-1
REMKEL2.txt,474343,475088,745,10,N,N,-,-1,-1
REMKEL2.txt,475089,475754,665,10,N,N,-,-1,-1
REMKEL2.txt,475756,476904,1148,10,N,N,-,-1,-1
REMKEL2.txt,476906,477533,627,10,N,N,-,-1,-1
REMKEL2.txt,477535,477931,396,10,N,N,-,-1,-1
REMKEL2.txt,477932,478549,617,10,N,N,-,-1,-1
REMKEL2.txt,478550,479873,1323,10,N,N,-,-1,-1
REMKEL2.txt,479874,480939,1065,10,N,N,-,-1,-1
REMKEL2.txt,480940,481136,196,10,N,N,-,-1,-1
REMKEL2.txt,481139,482422,1283,10,N,N,-,-1,-1
REMKEL2.txt,482423,484298,1875,10,N,N,-,-1,-1
REMKEL2.txt,484299,485448,1149,10,N,N,-,-1,-1
REMKEL2.txt,485449,486927,1478,10,N,N,-,-1,-1
REMKEL2.txt,486929,487979,1050,10,N,N,-,-1,-1
REMKEL2.txt,487980,489003,1023,10,N,N,-,-1,-1
REMKEL2.txt,489004,489914,910,10,N,N,-,-1,-1
REMKEL2.txt,489915,490933,1018,10,N,N,-,-1,-1
REMKEL2.txt,490934,491989,1055,10,N,N,-,-1,-1
REMKEL2.txt,491990,493238,1248,10,N,N,-,-1,-1
REMKEL2.txt,493239,494168,929,10,N,N,-,-1,-1
REMKEL2.txt,494169,496149,1980,10,N,N,-,-1,-1
REMKEL2.txt,496150,497327,1177,10,N,N,-,-1,-1
REMKEL2.txt,497328,498614,1286,10,N,N,-,-1,-1
REMKEL2.txt,498615,499460,845,10,N,N,-,-1,-1
REMKEL2.txt,499461,500272,811,10,N,N,-,-1,-1
REMKEL2.txt,500273,500750,477,10,N,N,-,-1,-1
REMKEL2.txt,500751,501282,531,10,N,N,-,-1,-1
REMKEL2.txt,501283,501837,554,10,N,N,-,-1,-1
REMKEL2.txt,501838,502103,265,10,N,N,-,-1,-1
REMKEL2.txt,502104,502423,319,10,N,N,-,-1,-1
REMKEL2.txt,502424,502795,371,10,N,N,-,-1,-1
REMKEL2.txt,502796,503234,438,10,N,N,-,-1,-1
REMKEL2.txt,503235,504713,1478,10,N,N,-,-1,-1
REMKEL2.txt,504716,506053,1337,10,N,N,-,-1,-1
REMKEL2.txt,506054,506977,923,10,N,N,-,-1,-1
REMKEL2.txt,506978,507695,717,10,N,N,-,-1,-1
REMKEL2.txt,507696,508375,679,10,N,N,-,-1,-1
REMKEL2.txt,508377,509113,736,10,N,N,-,-1,-1
REMKEL2.txt,509114,509684,570,10,N,N,-,-1,-1
REMKEL2.txt,509685,510383,698,10,N,N,-,-1,-1
REMKEL2.txt,510384,510870,486,10,N,N,-,-1,-1
REMKEL2.txt,510871,511989,1118,10,N,N,-,-1,-1
REMKEL2.txt,511990,513342,1352,10,N,N,-,-1,-1
REMKEL2.txt,513343,514356,1013,10,N,N,-,-1,-1
REMKEL2.txt,514357,515145,788,10,N,N,-,-1,-1
REMKEL2.txt,515146,516030,884,10,N,N,-,-1,-1
REMKEL2.txt,516031,516539,508,10,N,N,-,-1,-1
REMKEL2.txt,516541,517359,818,10,N,N,-,-1,-1
REMKEL2.txt,517361,517721,360,10,N,N,-,-1,-1
REMKEL2.txt,517722,518275,553,10,N,N,-,-1,-1
REMKEL2.txt,518276,518974,698,10,N,N,-,-1,-1
REMKEL2.txt,518975,519745,770,10,N,N,-,-1,-1
REOPER.txt,0,945,945,10,N,N,-,-1,-1
REOPER.txt,947,2690,1743,10,N,N,-,-1,-1
REOPER.txt,2691,5346,2655,10,Y,N,-,-1,-1
REOPER.txt,5347,9358,4011,10,Y,N,-,-1,-1
REOPER.txt,9361,12949,3588,10,Y,N,-,-1,-1
REOPER.txt,12952,17298,4346,10,N,N,-,-1,-1
REOPER.txt,17301,19617,2316,10,N,N,-,-1,-1
REOPER.txt,19619,22625,3006,10,N,N,-,-1,-1
REOPER.txt,22626,23956,1330,10,N,N,-,-1,-1
REOPER.txt,23959,26961,3002,10,N,N,-,-1,-1
REOPER.txt,26964,28908,1944,10,N,N,-,-1,-1
REOPER.txt,28910,30945,2035,10,N,N,-,-1,-1
REOPER.txt,30946,33278,2332,10,N,N,-,-1,-1
REOPER.txt,33279,34991,1712,10,N,N,-,-1,-1
REOPER.txt,34992,37588,2596,10,N,N,-,-1,-1
REOPER.txt,37589,39329,1740,10,N,N,-,-1,-1
REOPER.txt,39330,41503,2173,10,N,N,-,-1,-1
REOPER.txt,41505,43121,1616,10,Y,N,-,-1,-1
REOPER.txt,43122,44566,1444,10,N,N,-,-1,-1
REOPER.txt,44567,46756,2189,10,N,N,-,-1,-1
REOPER.txt,46757,48717,1960,10,N,N,-,-1,-1
REOPER.txt,48718,50179,1461,10,N,N,-,-1,-1
REOPER.txt,50180,50976,796,10,N,N,-,-1,-1
REOPER.txt,50977,51855,878,10,N,N,-,-1,-1
REOPER.txt,51857,53305,1448,10,N,N,-,-1,-1
REOPER.txt,53306,54267,961,10,N,N,-,-1,-1
REOPER.txt,54268,57145,2877,10,N,N,-,-1,-1
REOPER.txt,57148,59379,2231,10,N,N,-,-1,-1
REOPER.txt,59382,61201,1819,10,N,N,-,-1,-1
REOPER.txt,61202,62570,1368,10,N,N,-,-1,-1
REOPER.txt,62573,64515,1942,10,N,N,-,-1,-1
REOPER.txt,64516,65913,1397,10,N,N,-,-1,-1
REOPER.txt,65914,67926,2012,10,N,N,-,-1,-1
REOPER.txt,67928,69561,1633,10,N,N,-,-1,-1
REOPER.txt,69563,70549,986,10,N,N,-,-1,-1
REOPER.txt,70550,72906,2356,10,N,N,-,-1,-1
REOPER.txt,72907,75107,2200,10,N,N,-,-1,-1
REOPER.txt,75110,77124,2014,10,N,N,-,-1,-1
REOPER.txt,77125,79095,1970,10,N,N,-,-1,-1
REOPER.txt,79096,81314,2218,10,N,N,-,-1,-1
REOPER.txt,81317,83034,1717,10,N,N,-,-1,-1
REOPER.txt,83035,84710,1675,10,N,N,-,-1,-1
REOPER.txt,84713,85801,1088,10,N,N,-,-1,-1
REOPER.txt,85802,87142,1340,10,N,Y,1438607512684,86513,88081
REOPER.txt,87143,88877,1734,10,N,Y,1438607512684,86513,88081
REOPER.txt,88882,90288,1406,10,N,N,-,-1,-1
REOPER.txt,90291,92570,2279,10,N,N,-,-1,-1
REOPER.txt,92572,93986,1414,10,N,Y,1438607969604,92585,93513
REOPER.txt,93987,95890,1903,10,N,Y,1438608430250,93743,94780
REOPER.txt,95891,97225,1334,10,N,N,-,-1,-1
REOPER.txt,97226,98768,1542,10,N,Y,1438609131672,98413,101156
REOPER.txt,98769,99999,1230,10,N,Y,1438609131672,98413,101156
REOPER.txt,100000,101773,1773,10,Y,Y,1438609131672,98413,101156
REOPER.txt,101774,103230,1456,10,N,Y,1438609640620,101604,103071
REOPER.txt,103231,104413,1182,10,N,N,-,-1,-1
REOPER.txt,104414,105782,1368,10,N,N,-,-1,-1
REOPER.txt,105783,106521,738,10,N,N,-,-1,-1
REOPER.txt,106523,108663,2140,10,N,Y,1438610692536,108268,109736
REOPER.txt,108664,110267,1603,10,Y,Y,1438610692536,108268,109736
REOPER.txt,110270,111575,1305,10,N,N,-,-1,-1
REOPER.txt,111576,113289,1713,10,N,N,-,-1,-1
REOPER.txt,113290,114694,1404,10,N,N,-,-1,-1
REOPER.txt,114695,116634,1939,10,Y,Y,1438611798217,114785,115820
REOPER.txt,116635,118242,1607,10,N,N,-,-1,-1
REOPER.txt,118244,120032,1788,10,N,N,-,-1,-1
REOPER.txt,120033,121250,1217,10,N,N,-,-1,-1
REOPER.txt,121251,122489,1238,10,N,N,-,-1,-1
REOPER.txt,122490,124841,2351,10,N,N,-,-1,-1
REOPER.txt,124843,125848,1005,10,N,N,-,-1,-1
REOPER.txt,125849,127270,1421,10,Y,N,-,-1,-1
REOPER.txt,127271,129281,2010,10,N,N,-,-1,-1
REOPER.txt,129283,130859,1576,10,N,N,-,-1,-1
REOPER.txt,130862,132811,1949,10,N,N,-,-1,-1
REOPER.txt,132814,134415,1601,10,N,N,-,-1,-1
REOPER.txt,134418,136083,1665,10,N,Y,1438612728607,134463,135433
REOPER.txt,136086,137602,1516,10,N,Y,1438613292607,137557,139183
REOPER.txt,137605,138568,963,10,N,Y,1438613292607,137557,139183
REOPER.txt,138571,140235,1664,10,Y,Y,1438613292607,137557,139183
REOPER.txt,140238,141981,1743,10,N,N,-,-1,-1
REOPER.txt,141982,143270,1288,10,N,Y,1438613865632,142946,144271
REOPER.txt,143271,144595,1324,10,N,Y,1438613865632,142946,144271
REOPER.txt,144597,146038,1441,10,N,Y,1438614360025,144333,145484
REOPER.txt,146039,147910,1871,10,N,N,-,-1,-1
REOPER.txt,147911,150132,2221,10,N,N,-,-1,-1
REOPER.txt,150135,151763,1628,10,N,N,-,-1,-1
REOPER.txt,151766,153255,1489,10,N,N,-,-1,-1
REOPER.txt,153258,154986,1728,10,N,N,-,-1,-1
REOPER.txt,154987,156557,1570,10,Y,Y,1438614732055,155289,156104
REOPER.txt,156558,158088,1530,10,N,N,-,-1,-1
REOPER.txt,158089,160289,2200,10,N,N,-,-1,-1
REOPER.txt,160292,161701,1409,10,N,N,-,-1,-1
REOPER.txt,161702,162852,1150,10,N,N,-,-1,-1
REOPER.txt,162853,164341,1488,10,N,N,-,-1,-1
REOPER.txt,164342,165828,1486,10,N,N,-,-1,-1
REOPER.txt,165829,167618,1789,10,N,N,-,-1,-1
REOPER.txt,167621,168690,1069,10,Y,Y,1438615349115,168230,169109
REOPER.txt,168691,169825,1134,10,N,Y,1438615690871,169126,169616
REOPER.txt,169826,171187,1361,10,N,N,-,-1,-1
REOPER.txt,171188,172544,1356,10,N,N,-,-1,-1
REOPER.txt,172545,173786,1241,10,N,N,-,-1,-1
REOPER.txt,173789,176146,2357,10,N,Y,1438616254874,175117,176691
REOPER.txt,176147,178122,1975,10,N,Y,1438616740544,177666,179189
REOPER.txt,178123,179199,1076,10,N,Y,1438616740544,177666,179189
REOPER.txt,179202,181050,1848,10,Y,Y,1438617107509,180955,181678
REOPER.txt,181052,182680,1628,10,N,Y,1438617107509,180955,181678
REOPER.txt,182681,184358,1677,10,N,N,-,-1,-1
REOPER.txt,184359,185917,1558,10,N,N,-,-1,-1
REOPER.txt,185920,187432,1512,10,Y,N,-,-1,-1
REOPER.txt,187433,188899,1466,10,N,N,-,-1,-1
REOPER.txt,188900,190419,1519,10,N,N,-,-1,-1
REOPER.txt,190420,192171,1751,10,N,N,-,-1,-1
REOPER.txt,192174,193126,952,10,N,N,-,-1,-1
REOPER.txt,193127,194109,982,10,N,N,-,-1,-1
REOPER.txt,194110,194563,453,10,N,N,-,-1,-1
REOPER.txt,194564,194985,421,10,N,N,-,-1,-1
REOPER.txt,194988,195413,425,10,N,N,-,-1,-1
REOPER.txt,195416,195997,581,10,N,N,-,-1,-1
REOPER.txt,195998,196522,524,10,N,N,-,-1,-1
REOPER.txt,196523,197164,641,10,N,N,-,-1,-1
REOPER.txt,197167,199073,1906,10,N,N,-,-1,-1
REOPER.txt,199076,200480,1404,10,N,N,-,-1,-1
REOPER.txt,200481,202153,1672,10,N,Y,1438678160825,201557,202648
REOPER.txt,202154,203841,1687,10,N,Y,1438678160825,201557,202648
REOPER.txt,203842,205256,1414,10,N,Y,1438678872682,204536,204996
REOPER.txt,205257,206831,1574,10,N,Y,1438679318783,205023,206296
REOPER.txt,206834,208470,1636,10,N,N,-,-1,-1
REOPER.txt,208471,210361,1890,10,N,N,-,-1,-1
REOPER.txt,210364,211778,1414,10,N,N,-,-1,-1
REOPER.txt,211780,213697,1917,10,N,N,-,-1,-1
REOPER.txt,213698,214572,874,10,N,N,-,-1,-1
REOPER.txt,214573,216192,1619,10,N,N,-,-1,-1
REOPER.txt,216193,217485,1292,10,N,N,-,-1,-1
REOPER.txt,217486,219326,1840,10,N,N,-,-1,-1
REOPER.txt,219327,220775,1448,10,N,N,-,-1,-1
REOPER.txt,220776,222547,1771,10,N,N,-,-1,-1
REOPER.txt,222548,223770,1222,10,N,N,-,-1,-1
REOPER.txt,223771,225309,1538,10,N,N,-,-1,-1
REOPER.txt,225310,226785,1475,10,N,N,-,-1,-1
REOPER.txt,226786,227843,1057,10,N,N,-,-1,-1
REOPER.txt,227844,228655,811,10,N,N,-,-1,-1
REOPER.txt,228656,229512,856,10,N,N,-,-1,-1
REOPER.txt,229513,231203,1690,10,N,Y,1438680128352,229816,231640
REOPER.txt,231206,232849,1643,10,Y,Y,1438680128352,229816,231640
REOPER.txt,232851,235477,2626,10,N,Y,1438680995516,235335,237205
REOPER.txt,235478,237292,1814,10,N,Y,1438680995516,235335,237205
REOPER.txt,237295,240372,3077,10,N,N,-,-1,-1
REOPER.txt,240373,242950,2577,10,N,N,-,-1,-1
REOPER.txt,242951,244453,1502,10,N,N,-,-1,-1
REOPER.txt,244454,246666,2212,10,N,N,-,-1,-1
REOPER.txt,246667,248809,2142,10,N,N,-,-1,-1
REOPER.txt,248810,250840,2030,10,N,N,-,-1,-1
REOPER.txt,250841,253521,2680,10,N,N,-,-1,-1
REOPER.txt,253522,256178,2656,10,N,N,-,-1,-1
REOPER.txt,256179,258318,2139,10,N,N,-,-1,-1
REOPER.txt,258321,259866,1545,10,N,N,-,-1,-1
REOPER.txt,259867,261066,1199,10,N,N,-,-1,-1
REOPER.txt,261067,262215,1148,10,N,N,-,-1,-1
REOPER.txt,262216,263189,973,10,N,N,-,-1,-1
REOPER.txt,263190,264313,1123,10,Y,N,-,-1,-1
REOPER.txt,264314,265816,1502,10,N,N,-,-1,-1
REOPER.txt,265817,267112,1295,10,N,N,-,-1,-1
REOPER.txt,267113,268923,1810,10,N,N,-,-1,-1
REOPER.txt,268924,270717,1793,10,N,N,-,-1,-1
REOPER.txt,270718,272396,1678,10,N,N,-,-1,-1
REOPER.txt,272397,274580,2183,10,N,N,-,-1,-1
REOPER.txt,274582,276327,1745,10,N,Y,1438682217043,275162,278631
REOPER.txt,276328,277718,1390,10,N,Y,1438682217043,275162,278631
REOPER.txt,277719,279839,2120,10,Y,Y,1438682217043,275162,278631
REOPER.txt,279840,280985,1145,10,N,Y,1438685164472,280335,281058
REOPER.txt,280986,282398,1412,10,N,Y,1438685164472,280335,281058
REOPER.txt,282400,283746,1346,10,N,Y,1438685629660,282434,284008
REOPER.txt,283747,285008,1261,10,N,Y,1438685960938,284054,284833
REOPER.txt,285009,286458,1449,10,N,N,-,-1,-1
REOPER.txt,286459,287709,1250,10,N,N,-,-1,-1
REOPER.txt,287712,289677,1965,10,N,N,-,-1,-1
REOPER.txt,289678,290760,1082,10,N,N,-,-1,-1
REOPER.txt,290763,292876,2113,10,Y,N,-,-1,-1
REOPER.txt,292879,294481,1602,10,N,N,-,-1,-1
REOPER.txt,294482,296626,2144,10,Y,N,-,-1,-1
REOPER.txt,296627,298462,1835,10,N,N,-,-1,-1
REOPER.txt,298465,300147,1682,10,N,N,-,-1,-1
REOPER.txt,300148,302091,1943,10,N,N,-,-1,-1
REOPER.txt,302094,303670,1576,10,N,N,-,-1,-1
REOPER.txt,303671,305350,1679,10,N,N,-,-1,-1
REOPER.txt,305351,307702,2351,10,N,N,-,-1,-1
REOPER.txt,307705,309657,1952,10,N,N,-,-1,-1
REOPER.txt,309658,312195,2537,10,N,N,-,-1,-1
REOPER.txt,312196,313683,1487,10,N,N,-,-1,-1
REOPER.txt,313684,315985,2301,10,N,N,-,-1,-1
REOPER.txt,315986,318409,2423,10,N,N,-,-1,-1
REOPER.txt,318410,320493,2083,10,N,N,-,-1,-1
REOPER.txt,320494,322748,2254,10,N,N,-,-1,-1
REOPER.txt,322750,324454,1704,10,Y,N,-,-1,-1
REOPER.txt,324455,325941,1486,10,N,Y,1438686868625,325508,327523
REOPER.txt,325942,327272,1330,10,Y,Y,1438686868625,325508,327523
REOPER.txt,327273,328207,934,10,N,Y,1438686868625,325508,327523
REOPER.txt,328208,330533,2325,10,N,Y,1438687348398,330268,331286
REOPER.txt,330534,332338,1804,10,Y,Y,1438687348398,330268,331286
REOPER.txt,332339,333921,1582,10,N,N,-,-1,-1
REOPER.txt,333922,336044,2122,10,N,N,-,-1,-1
REOPER.txt,336045,337227,1182,10,N,N,-,-1,-1
REOPER.txt,337228,338631,1403,10,N,N,-,-1,-1
REOPER.txt,338632,339927,1295,10,Y,Y,1438687949932,339086,339844
REOPER.txt,339928,341145,1217,10,N,Y,1438702766275,340360,340868
REOPER.txt,341146,342041,895,10,N,N,-,-1,-1
REOPER.txt,342043,342973,930,10,N,N,-,-1,-1
REOPER.txt,342974,344045,1071,10,N,N,-,-1,-1
REOPER.txt,344046,345319,1273,10,N,N,-,-1,-1
REOPER.txt,345320,347125,1805,10,N,Y,1438703676425,346475,348599
REOPER.txt,347126,348216,1090,10,Y,Y,1438703676425,346475,348599
REOPER.txt,348217,349171,954,10,N,Y,1438703676425,346475,348599
REOPER.txt,349173,351441,2268,10,N,Y,1438703994435,348752,349433
REOPER.txt,351442,352917,1475,10,N,N,-,-1,-1
REOPER.txt,352918,354524,1606,10,N,Y,1438704734352,354115,355438
REOPER.txt,354526,356735,2209,10,Y,Y,1438705014163,355515,357095
REOPER.txt,356736,358117,1381,10,N,Y,1438705014163,355515,357095
REOPER.txt,358118,359911,1793,10,N,Y,1438705728692,359763,361602
REOPER.txt,359912,360977,1065,10,Y,Y,1438705728692,359763,361602
REOPER.txt,360978,362424,1446,10,N,Y,1438706068692,361693,362653
REOPER.txt,362425,363605,1180,10,Y,Y,1438706068692,361693,362653
REOPER.txt,363608,365278,1670,10,Y,N,-,-1,-1
REOPER.txt,365279,367173,1894,10,N,N,-,-1,-1
REOPER.txt,367174,368718,1544,10,N,N,-,-1,-1
REOPER.txt,368720,370476,1756,10,N,N,-,-1,-1
REOPER.txt,370477,372174,1697,10,N,N,-,-1,-1
REOPER.txt,372175,373298,1123,10,N,N,-,-1,-1
REOPER.txt,373299,374755,1456,10,N,N,-,-1,-1
REOPER.txt,374756,375774,1018,10,N,N,-,-1,-1
REOPER.txt,375777,376911,1134,10,N,N,-,-1,-1
REOPER.txt,376912,378531,1619,10,N,N,-,-1,-1
REOPER.txt,378532,380053,1521,10,N,N,-,-1,-1
REOPER.txt,380054,381844,1790,10,N,N,-,-1,-1
REOPER.txt,381845,383364,1519,10,N,N,-,-1,-1
REOPER.txt,383365,384764,1399,10,N,Y,1438706551121,383929,384620
REOPER.txt,384765,386206,1441,10,N,N,-,-1,-1
REOPER.txt,386207,387634,1427,10,N,N,-,-1,-1
REOPER.txt,387635,388960,1325,10,N,N,-,-1,-1
REOPER.txt,388963,390329,1366,10,N,N,-,-1,-1
REOPER.txt,390330,392240,1910,10,N,N,-,-1,-1
REOPER.txt,392241,393972,1731,10,N,N,-,-1,-1
REOPER.txt,393975,396047,2072,10,N,Y,1438707526102,395204,399120
REOPER.txt,396048,397412,1364,10,N,Y,1438707526102,395204,399120
REOPER.txt,397413,398723,1310,10,Y,Y,1438707526102,395204,399120
REOPER.txt,398723,400234,1511,10,Y,Y,1438707526102,395204,399120
REOPER.txt,400236,401434,1198,10,N,Y,1438763811355,400311,402065
REOPER.txt,401435,402502,1067,10,N,Y,1438763811355,400311,402065
REOPER.txt,402503,404188,1685,10,N,N,-,-1,-1
REOPER.txt,404191,405010,819,10,N,N,-,-1,-1
REOPER.txt,405011,406841,1830,10,N,Y,1438764333941,406033,406469
REOPER.txt,406842,408794,1952,10,N,Y,1438764866768,406493,408910
REOPER.txt,408795,410740,1945,10,N,Y,1438764866768,406493,408910
REOPER.txt,410741,411917,1176,10,N,Y,1438765478053,411548,412139
REOPER.txt,411918,413444,1526,10,N,Y,1438765478053,411548,412139
REOPER.txt,413445,415370,1925,10,N,Y,1438765812082,413195,414167
REOPER.txt,415371,416857,1486,10,Y,Y,1438767071786,415842,416696
REOPER.txt,416858,419583,2725,10,Y,Y,1438767795308,417699,419098
REOPER.txt,419586,421059,1473,10,N,Y,1438768079697,419611,420712
REOPER.txt,421060,423007,1947,10,N,N,-,-1,-1
REOPER.txt,423008,424683,1675,10,N,N,-,-1,-1
REOPER.txt,424684,426554,1870,10,N,N,-,-1,-1
REOPER.txt,426555,428052,1497,10,N,N,-,-1,-1
REOPER.txt,428055,430342,2287,10,N,N,-,-1,-1
REOPER.txt,430343,431501,1158,10,N,N,-,-1,-1
REOPER.txt,431502,433395,1893,10,N,N,-,-1,-1
REOPER.txt,433396,435029,1633,10,N,N,-,-1,-1
REOPER.txt,435030,436926,1896,10,N,N,-,-1,-1
REOPER.txt,436927,438658,1731,10,N,N,-,-1,-1
REOPER.txt,438659,440693,2034,10,Y,Y,1438769202218,438794,441102
REOPER.txt,440696,441769,1073,10,N,Y,1438769202218,438794,441102
REOPER.txt,441771,443178,1407,10,N,N,-,-1,-1
REOPER.txt,443183,443673,490,10,N,N,-,-1,-1
REOPER.txt,443674,444319,645,10,N,N,-,-1,-1
REOPER.txt,444320,445062,742,10,N,N,-,-1,-1
REOPER.txt,445063,445847,784,10,N,N,-,-1,-1
REOPER.txt,445848,446513,665,10,N,N,-,-1,-1
REOPER.txt,446514,448654,2140,10,Y,N,-,-1,-1
REOPER.txt,448657,450413,1756,10,Y,Y,1438769699545,450302,451135
REOPER.txt,450414,451956,1542,10,N,Y,1438769699545,450302,451135
REOPER.txt,451957,453265,1308,10,N,Y,1438770178253,451891,452641
REOPER.txt,453266,454059,793,10,N,Y,1438770629803,453971,456097
REOPER.txt,454060,455262,1202,10,N,Y,1438770629803,453971,456097
REOPER.txt,455263,457045,1782,10,Y,Y,1438771010421,456188,458240
REOPER.txt,457048,458062,1014,10,N,Y,1438771010421,456188,458240
REOPER.txt,458063,460135,2072,10,N,Y,1438771010421,456188,458240
REOPER.txt,460137,461853,1716,10,N,Y,1438771468604,459391,461406
REOPER.txt,461854,463879,2025,10,N,Y,1438771823978,462479,463275
REOPER.txt,463880,465837,1957,10,N,N,-,-1,-1
REOPER.txt,465839,467644,1805,10,N,N,-,-1,-1
REOPER.txt,467645,468609,964,10,N,N,-,-1,-1
REOPER.txt,468610,469744,1134,10,N,N,-,-1,-1
REOPER.txt,469745,471388,1643,10,N,N,-,-1,-1
REOPER.txt,471389,472744,1355,10,N,N,-,-1,-1
REOPER.txt,472745,474192,1447,10,N,Y,1438778151735,473810,477429
REOPER.txt,474193,475425,1232,10,N,Y,1438778151735,473810,477429
REOPER.txt,475426,476424,998,10,N,Y,1438778151735,473810,477429
REOPER.txt,476425,477579,1154,10,N,Y,1438778151735,473810,477429
REOPER.txt,477580,478826,1246,10,N,Y,1438778406473,477978,478874
REOPER.txt,478829,480385,1556,10,Y,Y,1438778406473,477978,478874
REOPER.txt,480386,481414,1028,10,N,Y,1438778739733,480167,480764
REOPER.txt,481415,482405,990,10,N,N,-,-1,-1
REOPER.txt,482408,483708,1300,10,N,N,-,-1,-1
REOPER.txt,483709,485092,1383,10,N,N,-,-1,-1
REOPER.txt,485094,486785,1691,10,N,N,-,-1,-1
REOPER.txt,486786,488619,1833,10,N,N,-,-1,-1
REOPER.txt,488620,490247,1627,10,N,N,-,-1,-1
REOPER.txt,490248,491270,1022,10,N,N,-,-1,-1
REOPER.txt,491273,493105,1832,10,N,N,-,-1,-1
REOPER.txt,493106,495507,2401,10,N,N,-,-1,-1
REOPER.txt,495508,497872,2364,10,N,N,-,-1,-1
REOPER.txt,497872,499150,1278,10,N,N,-,-1,-1
REOPER.txt,499152,500322,1170,10,N,N,-,-1,-1
REOPER.txt,500323,502287,1964,10,N,N,-,-1,-1
REOPER.txt,502288,503871,1583,10,N,N,-,-1,-1
REOPER.txt,503874,506035,2161,10,Y,Y,1438779843654,505464,507513
REOPER.txt,506036,507585,1549,10,Y,Y,1438779843654,505464,507513
REOPER.txt,507586,509397,1811,10,Y,Y,1438780085816,508364,509135
REOPER.txt,509398,510863,1465,10,N,Y,1438780706972,510534,511384
REOPER.txt,510864,512069,1205,10,N,Y,1438780706972,510534,511384
REOPER.txt,512070,513541,1471,10,Y,Y,1438781426985,512557,514085
REOPER.txt,513544,514931,1387,10,N,Y,1438781426985,512557,514085
REOPER.txt,514932,516664,1732,10,Y,N,-,-1,-1
REOPER.txt,516665,518333,1668,10,N,N,-,-1,-1
REOPER.txt,518336,520114,1778,10,N,N,-,-1,-1
REOPER.txt,520115,521475,1360,10,N,N,-,-1,-1
REOPER.txt,521476,522583,1107,10,N,Y,1438782478949,521766,525299
REOPER.txt,522584,523335,751,10,N,Y,1438782478949,521766,525299
REOPER.txt,523338,524525,1187,10,N,Y,1438782478949,521766,525299
REOPER.txt,524526,526443,1917,10,N,Y,1438782478949,521766,525299
REOPER.txt,526444,528369,1925,10,Y,Y,1438783041826,526732,528338
REOPER.txt,528372,529820,1448,10,N,N,-,-1,-1
REOPER.txt,529821,531065,1244,10,N,Y,1438783543267,530789,532585
REOPER.txt,531066,532285,1219,10,N,Y,1438783543267,530789,532585
REOPER.txt,532286,533480,1194,10,N,Y,1438784312899,533121,535184
REOPER.txt,533481,534875,1394,10,N,Y,1438784312899,533121,535184
REOPER.txt,534876,536231,1355,10,N,Y,1438784652063,535262,536596
REOPER.txt,536232,537609,1377,10,N,Y,1438784652063,535262,536596
REOPER.txt,537610,538812,1202,10,N,N,-,-1,-1
REOPER.txt,538813,540784,1971,10,N,N,-,-1,-1
REOPER.txt,540786,542169,1383,10,N,N,-,-1,-1
REOPER.txt,542170,543560,1390,10,N,N,-,-1,-1
REOPER.txt,543563,544832,1269,10,N,N,-,-1,-1
REOPER.txt,544833,546558,1725,10,N,N,-,-1,-1
REOPER.txt,546559,548009,1450,10,N,N,-,-1,-1
REOPER.txt,548010,549432,1422,10,N,N,-,-1,-1
REOPER.txt,549433,551022,1589,10,N,N,-,-1,-1
REOPER.txt,551023,552904,1881,10,N,N,-,-1,-1
REOPER.txt,552905,554477,1572,10,N,N,-,-1,-1
REOPER.txt,554478,555621,1143,10,N,N,-,-1,-1
REOPER.txt,555623,557522,1899,10,N,N,-,-1,-1
REOPER.txt,557523,559259,1736,10,N,N,-,-1,-1
REOPER.txt,559260,560985,1725,10,Y,N,-,-1,-1
REOPER.txt,560988,562611,1623,10,N,N,-,-1,-1
REOPER.txt,562613,564304,1691,10,Y,N,-,-1,-1
REOPER.txt,564305,565733,1428,10,Y,N,-,-1,-1
REOPER.txt,565734,567164,1430,10,N,N,-,-1,-1
REOPER.txt,567165,568811,1646,10,N,N,-,-1,-1
REOPER.txt,568812,570557,1745,10,Y,N,-,-1,-1
REOPER.txt,570558,572229,1671,10,N,N,-,-1,-1
REOPER.txt,572232,573818,1586,10,N,N,-,-1,-1
REOPER.txt,573819,575451,1632,10,N,N,-,-1,-1
REOPER.txt,575454,576629,1175,10,Y,N,-,-1,-1
REOPER.txt,576630,578678,2048,10,Y,N,-,-1,-1
REOPER.txt,578679,580875,2196,10,N,N,-,-1,-1
REOPER.txt,580876,582732,1856,10,Y,N,-,-1,-1
REOPER.txt,582735,584293,1558,10,Y,N,-,-1,-1
REOPER.txt,584294,585339,1045,10,N,N,-,-1,-1
REOPER.txt,585340,586540,1200,10,N,N,-,-1,-1
REOPER.txt,586542,587502,960,10,N,N,-,-1,-1
REOPER.txt,587503,588859,1356,10,N,N,-,-1,-1
REOPER.txt,588860,590131,1271,10,N,N,-,-1,-1
REOPER.txt,590133,592011,1878,10,Y,N,-,-1,-1
REOPER.txt,592012,593522,1510,10,Y,N,-,-1,-1
REOPER.txt,593523,595312,1789,10,Y,N,-,-1,-1
REOPER.txt,595313,597256,1943,10,N,N,-,-1,-1
REOPER.txt,597257,598966,1709,10,N,N,-,-1,-1
REOPER.txt,598967,600641,1674,10,N,N,-,-1,-1
REOPER.txt,600642,602698,2056,10,N,N,-,-1,-1
REOPER.txt,602703,604374,1671,10,N,N,-,-1,-1
REOPER.txt,604375,605768,1393,10,N,N,-,-1,-1
REOPER.txt,605769,607797,2028,10,N,N,-,-1,-1
REOPER.txt,607798,609462,1664,10,N,N,-,-1,-1
REOPER.txt,609463,610907,1444,10,N,N,-,-1,-1
REOPER.txt,610908,612531,1623,10,N,N,-,-1,-1
REOPER.txt,612532,614068,1536,10,N,N,-,-1,-1
REOPER.txt,614069,615379,1310,10,N,N,-,-1,-1
REOPER.txt,615380,616859,1479,10,N,N,-,-1,-1
REOPER.txt,616860,619093,2233,10,N,N,-,-1,-1
REOPER.txt,619094,620695,1601,10,N,N,-,-1,-1
REOPER.txt,620697,622209,1512,10,N,N,-,-1,-1
REOPER.txt,622210,624208,1998,10,N,N,-,-1,-1
REOPER.txt,624209,625738,1529,10,N,N,-,-1,-1
REOPER.txt,625741,627269,1528,10,N,N,-,-1,-1
REOPER.txt,627270,628910,1640,10,N,N,-,-1,-1
REOPER.txt,628911,630163,1252,10,N,N,-,-1,-1
REOPER.txt,630166,631223,1057,10,N,N,-,-1,-1
REOPER.txt,631224,632781,1557,10,N,N,-,-1,-1
REOPER.txt,632782,634586,1804,10,Y,N,-,-1,-1
REOPER.txt,634587,635977,1390,10,N,N,-,-1,-1
REOPER.txt,635978,637732,1754,10,Y,N,-,-1,-1
REOPER.txt,637733,639506,1773,10,N,N,-,-1,-1
REOPER.txt,639509,641162,1653,10,N,N,-,-1,-1
REOPER.txt,641163,643036,1873,10,N,N,-,-1,-1
REOPER.txt,643036,644504,1468,10,Y,N,-,-1,-1
REOPER.txt,644506,646600,2094,10,N,N,-,-1,-1
REOPER.txt,646601,649239,2638,10,N,N,-,-1,-1
REOPER.txt,649242,651291,2049,10,N,N,-,-1,-1
REOPER.txt,651292,652185,893,10,N,N,-,-1,-1
REOPER.txt,652188,653889,1701,10,N,N,-,-1,-1
REOPER.txt,653892,655704,1812,10,N,N,-,-1,-1
REOPER.txt,655707,657149,1442,10,N,N,-,-1,-1
REOPER.txt,657151,659150,1999,10,N,N,-,-1,-1
REOPER.txt,659152,660483,1331,10,N,N,-,-1,-1
REOPER.txt,660486,661752,1266,10,N,N,-,-1,-1
REOPER.txt,661753,663305,1552,10,N,N,-,-1,-1
REOPER.txt,663306,665496,2190,10,N,N,-,-1,-1
REOPER.txt,665497,667464,1967,10,N,N,-,-1,-1
REOPER.txt,667465,669331,1866,10,N,N,-,-1,-1
REOPER.txt,669332,671003,1671,10,N,N,-,-1,-1
REOPER.txt,671004,671884,880,10,N,N,-,-1,-1
REOPER.txt,671885,673073,1188,10,N,N,-,-1,-1
REOPER.txt,673074,674603,1529,10,N,N,-,-1,-1
REOPER.txt,674604,675858,1254,10,N,N,-,-1,-1
REOPER.txt,675861,677014,1153,10,N,N,-,-1,-1
REOPER.txt,677015,678012,997,10,N,N,-,-1,-1
REOPER.txt,678013,679540,1527,10,N,N,-,-1,-1
REOPER.txt,679541,681174,1633,10,N,N,-,-1,-1
REOPER.txt,681175,682628,1453,10,N,N,-,-1,-1
REOPER.txt,682629,684065,1436,10,N,N,-,-1,-1
REOPER.txt,684067,685876,1809,10,Y,N,-,-1,-1
REOPER.txt,685878,687340,1462,10,Y,N,-,-1,-1
REOPER.txt,687341,688385,1044,10,N,N,-,-1,-1
REOPER.txt,688386,689970,1584,10,N,N,-,-1,-1
REOPER.txt,689971,691617,1646,10,N,N,-,-1,-1
REOPER.txt,691619,693258,1639,10,N,N,-,-1,-1
REOPER.txt,693261,694192,931,10,N,N,-,-1,-1
REOPER.txt,694193,695239,1046,10,N,N,-,-1,-1
REOPER.txt,695240,696283,1043,10,N,N,-,-1,-1
REOPER.txt,696284,696981,697,10,N,N,-,-1,-1
REOPER.txt,696984,697602,618,10,N,N,-,-1,-1
REOPER.txt,697605,699385,1780,10,Y,N,-,-1,-1
REOPER.txt,699386,701040,1654,10,N,N,-,-1,-1
REOPER.txt,701041,702094,1053,10,N,N,-,-1,-1
REOPER.txt,702095,703798,1703,10,N,N,-,-1,-1
REOPER.txt,703799,705144,1345,10,N,N,-,-1,-1
REOPER.txt,705145,706347,1202,10,N,N,-,-1,-1
REOPER.txt,706348,707967,1619,10,Y,N,-,-1,-1
REOPER.txt,707968,709287,1319,10,N,N,-,-1,-1
REOPER.txt,709288,710902,1614,10,N,N,-,-1,-1
REOPER.txt,710903,711721,818,10,N,N,-,-1,-1
REOPER.txt,711722,712796,1074,10,N,N,-,-1,-1
REOPER.txt,712797,713955,1158,10,N,N,-,-1,-1
REOPER.txt,713957,715158,1201,10,N,N,-,-1,-1
REOPER.txt,715159,716660,1501,10,N,N,-,-1,-1
REOPER.txt,716662,717836,1174,10,N,N,-,-1,-1
REOPER.txt,717839,719659,1820,10,N,N,-,-1,-1
REOPER.txt,719662,720847,1185,10,N,N,-,-1,-1
REOPER.txt,720849,722696,1847,10,N,N,-,-1,-1
REOPER.txt,722697,724784,2087,10,N,N,-,-1,-1
REOPER.txt,724785,726102,1317,10,N,N,-,-1,-1
REOPER.txt,726103,727565,1462,10,N,N,-,-1,-1
REOPER.txt,727568,728381,813,10,N,N,-,-1,-1
REOPER.txt,728382,730155,1773,10,N,N,-,-1,-1
REOPER.txt,730155,731206,1051,10,N,N,-,-1,-1
REOPER.txt,731207,732336,1129,10,N,N,-,-1,-1
REOPER.txt,732338,733644,1306,10,N,N,-,-1,-1
REOPER.txt,733644,735361,1717,10,N,N,-,-1,-1
REOPER.txt,735366,737250,1884,10,N,N,-,-1,-1
REOPER.txt,737251,739153,1902,10,N,N,-,-1,-1
REOPER.txt,739154,740298,1144,10,N,N,-,-1,-1
REOPER.txt,740299,742027,1728,10,N,N,-,-1,-1
REOPER.txt,742028,743900,1872,10,N,N,-,-1,-1
REOPER.txt,743901,745408,1507,10,N,N,-,-1,-1
REOPER.txt,745409,746551,1142,10,N,N,-,-1,-1
REOPER.txt,746552,747595,1043,10,N,N,-,-1,-1
REOPER.txt,747597,749265,1668,10,Y,N,-,-1,-1
REOPER.txt,749267,751344,2077,10,Y,N,-,-1,-1
REOPER.txt,751345,753008,1663,10,N,N,-,-1,-1
REOPER.txt,753009,754887,1878,10,N,N,-,-1,-1
REOPER.txt,754888,756151,1263,10,N,N,-,-1,-1
REOPER.txt,756152,757392,1240,10,N,N,-,-1,-1
REOPER.txt,757393,758910,1517,10,Y,N,-,-1,-1
REOPER.txt,758911,760135,1224,10,N,N,-,-1,-1
REOPER.txt,760136,761603,1467,10,N,N,-,-1,-1
REOPER.txt,761604,763276,1672,10,Y,N,-,-1,-1
REOPER.txt,763277,765169,1892,10,N,N,-,-1,-1
REOPER.txt,765170,766505,1335,10,N,N,-,-1,-1
REOPER.txt,766506,767915,1409,10,N,N,-,-1,-1
REOPER.txt,767917,769827,1910,10,N,N,-,-1,-1
REOPER.txt,769828,770674,846,10,N,N,-,-1,-1
REOPER.txt,770674,771987,1313,10,N,N,-,-1,-1
REOPER.txt,771988,773224,1236,10,Y,N,-,-1,-1
REOPER.txt,773225,774636,1411,10,N,N,-,-1,-1
REOPER.txt,774637,776667,2030,10,Y,N,-,-1,-1
REOPER.txt,776668,777972,1304,10,N,N,-,-1,-1
REOPER.txt,777973,779213,1240,10,N,N,-,-1,-1
REOPER.txt,779214,779961,747,10,N,N,-,-1,-1
REOPER.txt,779962,781369,1407,10,N,N,-,-1,-1
REOPER.txt,781370,782687,1317,10,N,N,-,-1,-1
REOPER.txt,782688,784204,1516,10,N,N,-,-1,-1
REOPER.txt,784205,785357,1152,10,N,N,-,-1,-1
REOPER.txt,785358,785620,262,10,N,N,-,-1,-1
REOPER.txt,785622,787408,1786,10,N,N,-,-1,-1
REOPER.txt,787409,789480,2071,10,N,N,-,-1,-1
REOPER.txt,789483,791390,1907,10,N,N,-,-1,-1
REOPER.txt,791393,792658,1265,10,Y,N,-,-1,-1
REOPER.txt,792660,794206,1546,10,Y,N,-,-1,-1
REOPER.txt,794207,795319,1112,10,N,N,-,-1,-1
REOPER.txt,795322,796969,1647,10,Y,N,-,-1,-1
REOPER.txt,796969,798402,1433,10,Y,N,-,-1,-1
REOPER.txt,798405,800838,2433,10,N,N,-,-1,-1
REOPER.txt,800839,802389,1550,10,N,N,-,-1,-1
REOPER.txt,802390,803782,1392,10,N,N,-,-1,-1
REOPER.txt,803783,804816,1033,10,N,N,-,-1,-1
REOPER.txt,804817,806010,1193,10,N,N,-,-1,-1
REOPER.txt,806011,807511,1500,10,N,N,-,-1,-1
REOPER.txt,807512,808419,907,10,N,N,-,-1,-1
REOPER.txt,808420,810169,1749,10,N,N,-,-1,-1
REOPER.txt,810170,812054,1884,10,N,N,-,-1,-1
REOPER.txt,812055,813338,1283,10,N,N,-,-1,-1
REOPER.txt,813339,814587,1248,10,N,N,-,-1,-1
REOPER.txt,814588,816201,1613,10,N,N,-,-1,-1
REOPER.txt,816201,817831,1630,10,N,N,-,-1,-1
REOPER.txt,817836,819325,1489,10,N,N,-,-1,-1
REOPER.txt,819326,820695,1369,10,N,N,-,-1,-1
REOPER.txt,820696,821950,1254,10,N,N,-,-1,-1
REOPER.txt,821950,823561,1611,10,N,N,-,-1,-1
REOPER.txt,823562,825692,2130,10,N,N,-,-1,-1
REOPER.txt,825693,827582,1889,10,N,N,-,-1,-1
THIRTY.txt,1,2895,2894,10,N,N,-,-1,-1
THIRTY.txt,2896,5988,3092,10,Y,N,-,-1,-1
THIRTY.txt,5989,8155,2166,10,N,N,-,-1,-1
THIRTY.txt,8156,10867,2711,10,N,N,-,-1,-1
THIRTY.txt,10868,13405,2537,10,N,N,-,-1,-1
THIRTY.txt,13408,14866,1458,10,N,N,-,-1,-1
THIRTY.txt,14867,16620,1753,10,Y,N,-,-1,-1
THIRTY.txt,16621,18320,1699,10,Y,Y,1438157398793,16921,17950
THIRTY.txt,18321,20395,2074,10,Y,Y,1438159538620,18153,19649
THIRTY.txt,20396,22054,1658,10,N,N,-,-1,-1
THIRTY.txt,22057,23745,1688,10,N,N,-,-1,-1
THIRTY.txt,23746,25360,1614,10,N,N,-,-1,-1
THIRTY.txt,25362,26264,902,10,N,N,-,-1,-1
THIRTY.txt,26265,27743,1478,10,N,N,-,-1,-1
THIRTY.txt,27745,29371,1626,10,Y,Y,1438160199087,28565,29351
THIRTY.txt,29374,31031,1657,10,N,Y,1438161059126,29508,30161
THIRTY.txt,31032,32801,1769,10,N,Y,1438161785448,31562,32150
THIRTY.txt,32802,33867,1065,10,N,Y,1438162296864,32161,34110
THIRTY.txt,33870,35407,1537,10,Y,Y,1438162296864,32161,34110
THIRTY.txt,35408,37641,2233,10,Y,N,-,-1,-1
THIRTY.txt,37642,39188,1546,10,N,N,-,-1,-1
THIRTY.txt,39189,40860,1671,10,Y,Y,1438162931556,40152,41509
THIRTY.txt,40861,42550,1689,10,Y,Y,1438163419525,41973,43188
THIRTY.txt,42551,43788,1237,10,N,Y,1438163419525,41973,43188
THIRTY.txt,43789,44894,1105,10,N,Y,1438165222216,44881,46194
THIRTY.txt,44895,46762,1867,10,Y,Y,1438165222216,44881,46194
THIRTY.txt,46763,48225,1462,10,N,N,-,-1,-1
THIRTY.txt,48226,49400,1174,10,N,N,-,-1,-1
THIRTY.txt,49401,50342,941,10,N,N,-,-1,-1
THIRTY.txt,50345,52233,1888,10,Y,N,-,-1,-1
THIRTY.txt,52236,54098,1862,10,N,N,-,-1,-1
THIRTY.txt,54099,55498,1399,10,Y,Y,1438165920566,55062,56456
THIRTY.txt,55503,56718,1215,10,N,Y,1438165920566,55062,56456
THIRTY.txt,56719,58100,1381,10,Y,N,-,-1,-1
THIRTY.txt,58101,59593,1492,10,N,Y,1438166902193,59219,61464
THIRTY.txt,59594,61482,1888,10,Y,Y,1438166902193,59219,61464
THIRTY.txt,61483,63346,1863,10,N,Y,1438167435224,61729,62292
THIRTY.txt,63348,64964,1616,10,N,N,-,-1,-1
THIRTY.txt,64965,66297,1332,10,N,N,-,-1,-1
THIRTY.txt,66298,68084,1786,10,N,N,-,-1,-1
THIRTY.txt,68085,69204,1119,10,N,N,-,-1,-1
THIRTY.txt,69205,70933,1728,10,N,N,-,-1,-1
THIRTY.txt,70936,73102,2166,10,N,N,-,-1,-1
THIRTY.txt,73103,75056,1953,10,N,Y,1438169169141,74247,75379
THIRTY.txt,75057,77214,2157,10,Y,Y,1438169169141,74247,75379
THIRTY.txt,77215,78743,1528,10,Y,N,-,-1,-1
THIRTY.txt,78744,79861,1117,10,N,N,-,-1,-1
THIRTY.txt,79863,81249,1386,10,N,N,-,-1,-1
THIRTY.txt,81252,82267,1015,10,N,N,-,-1,-1
THIRTY.txt,82272,84094,1822,10,Y,Y,1438170164484,82295,83217
THIRTY.txt,84095,86001,1906,10,N,N,-,-1,-1
THIRTY.txt,86002,88114,2112,10,N,N,-,-1,-1
THIRTY.txt,88117,89472,1355,10,N,N,-,-1,-1
THIRTY.txt,89473,90459,986,10,N,N,-,-1,-1
THIRTY.txt,90461,91490,1029,10,N,N,-,-1,-1
THIRTY.txt,91491,92903,1412,10,N,Y,1438189723317,92178,95121
THIRTY.txt,92906,94237,1331,10,N,Y,1438189723317,92178,95121
THIRTY.txt,94238,95593,1355,10,Y,Y,1438189723317,92178,95121
THIRTY.txt,95594,96734,1140,10,N,N,-,-1,-1
THIRTY.txt,96737,97925,1188,10,N,N,-,-1,-1
THIRTY.txt,97927,99728,1801,10,N,N,-,-1,-1
THIRTY.txt,99730,101395,1665,10,N,N,-,-1,-1
THIRTY.txt,101395,102435,1040,10,N,Y,1438190510320,101962,103008
THIRTY.txt,102436,104082,1646,10,N,Y,1438190510320,101962,103008
THIRTY.txt,104083,105330,1247,10,N,Y,1438191374996,103260,104214
THIRTY.txt,105333,107095,1762,10,Y,N,-,-1,-1
THIRTY.txt,107096,108630,1534,10,N,Y,1438246777986,107205,109556
THIRTY.txt,108631,110302,1671,10,Y,Y,1438246777986,107205,109556
THIRTY.txt,110303,112600,2297,10,Y,N,-,-1,-1
THIRTY.txt,112601,114197,1596,10,N,N,-,-1,-1
THIRTY.txt,114198,115082,884,10,N,N,-,-1,-1
THIRTY.txt,115085,116656,1571,10,N,Y,1438247270881,115104,115832
THIRTY.txt,116657,118316,1659,10,N,Y,1438247916111,118197,118881
THIRTY.txt,118317,119843,1526,10,N,Y,1438247916111,118197,118881
THIRTY.txt,119844,121095,1251,10,Y,Y,1438248640511,119038,120318
THIRTY.txt,121096,123134,2038,10,N,N,-,-1,-1
THIRTY.txt,123135,124563,1428,10,N,Y,1438249161833,123571,124012
THIRTY.txt,124564,126775,2211,10,N,N,-,-1,-1
THIRTY.txt,126778,128344,1566,10,N,N,-,-1,-1
THIRTY.txt,128347,130034,1687,10,N,N,-,-1,-1
THIRTY.txt,130035,131582,1547,10,N,N,-,-1,-1
THIRTY.txt,131585,132927,1342,10,N,N,-,-1,-1
THIRTY.txt,132928,135091,2163,10,N,N,-,-1,-1
THIRTY.txt,135092,136023,931,10,N,N,-,-1,-1
THIRTY.txt,136025,136279,254,10,N,N,-,-1,-1
THIRTY.txt,136284,136525,241,10,N,N,-,-1,-1
THIRTY.txt,136525,136622,97,10,N,N,-,-1,-1
THIRTY.txt,136627,136785,158,10,N,N,-,-1,-1
THIRTY.txt,136787,136945,158,10,N,N,-,-1,-1
THIRTY.txt,136950,137092,142,10,N,N,-,-1,-1
THIRTY.txt,137092,139191,2099,10,Y,N,-,-1,-1
THIRTY.txt,139192,140293,1101,10,N,N,-,-1,-1
THIRTY.txt,140294,141950,1656,10,N,N,-,-1,-1
THIRTY.txt,141953,143630,1677,10,N,N,-,-1,-1
THIRTY.txt,143630,145592,1962,10,N,N,-,-1,-1
THIRTY.txt,145593,146744,1151,10,N,Y,1438250592994,145798,147831
THIRTY.txt,146745,149301,2556,10,Y,Y,1438250592994,145798,147831
THIRTY.txt,149304,151050,1746,10,N,N,-,-1,-1
THIRTY.txt,151053,152906,1853,10,N,Y,1438251442654,151139,153995
THIRTY.txt,152907,154244,1337,10,N,Y,1438251442654,151139,153995
THIRTY.txt,154247,155821,1574,10,N,Y,1438251999106,154831,155580
THIRTY.txt,155822,157395,1573,10,N,N,-,-1,-1
THIRTY.txt,157396,159078,1682,10,N,N,-,-1,-1
THIRTY.txt,159079,160863,1784,10,N,N,-,-1,-1
THIRTY.txt,160864,162153,1289,10,N,N,-,-1,-1
THIRTY.txt,162154,163696,1542,10,N,N,-,-1,-1
THIRTY.txt,163697,164603,906,10,N,N,-,-1,-1
THIRTY.txt,164604,166232,1628,10,N,N,-,-1,-1
THIRTY.txt,166235,167262,1027,10,N,Y,1438252600776,166233,167088
THIRTY.txt,167263,169036,1773,10,N,N,-,-1,-1
THIRTY.txt,169036,171011,1975,10,Y,N,-,-1,-1
THIRTY.txt,171012,172927,1915,10,N,Y,1438253344818,172096,173864
THIRTY.txt,172928,174234,1306,10,Y,Y,1438253344818,172096,173864
THIRTY.txt,174235,175205,970,10,N,Y,1438253717853,174584,175030
THIRTY.txt,175208,177025,1817,10,N,N,-,-1,-1
THIRTY.txt,177026,178843,1817,10,N,Y,1438260340275,178702,179144
THIRTY.txt,178844,180682,1838,10,N,Y,1438260662836,180296,180671
THIRTY.txt,180683,182419,1736,10,N,N,-,-1,-1
THIRTY.txt,182420,184502,2082,10,N,Y,1438261222496,182454,183438
THIRTY.txt,184503,185528,1025,10,N,N,-,-1,-1
THIRTY.txt,185529,186590,1061,10,N,N,-,-1,-1
THIRTY.txt,186591,187674,1083,10,N,N,-,-1,-1
THIRTY.txt,187674,189291,1617,10,N,N,-,-1,-1
THIRTY.txt,189292,190263,971,10,N,N,-,-1,-1
THIRTY.txt,190264,191221,957,10,N,N,-,-1,-1
THIRTY.txt,191222,192226,1004,10,N,N,-,-1,-1
THIRTY.txt,192227,193471,1244,10,Y,N,-,-1,-1
THIRTY.txt,193472,194694,1222,10,Y,N,-,-1,-1
THIRTY.txt,194695,195561,866,10,Y,N,-,-1,-1
THIRTY.txt,195561,196697,1136,10,N,N,-,-1,-1
THIRTY.txt,196697,197986,1289,10,N,N,-,-1,-1
THIRTY.txt,197987,200233,2246,10,Y,N,-,-1,-1
THIRTY.txt,200234,201355,1121,10,N,N,-,-1,-1
THIRTY.txt,201357,202806,1449,10,Y,Y,1438261922656,202060,202369
THIRTY.txt,202808,204054,1246,10,N,Y,1438262221763,203293,203654
THIRTY.txt,204056,205057,1001,10,N,N,-,-1,-1
THIRTY.txt,205060,206549,1489,10,N,N,-,-1,-1
THIRTY.txt,206552,208075,1523,10,N,N,-,-1,-1
THIRTY.txt,208076,210135,2059,10,N,Y,1438262649189,209904,210317
THIRTY.txt,210136,211837,1701,10,N,Y,1438262649189,209904,210317
THIRTY.txt,211840,213491,1651,10,N,Y,1438263571731,212203,213237
THIRTY.txt,213492,214841,1349,10,N,Y,1438264301777,214763,216915
THIRTY.txt,214842,216110,1268,10,N,Y,1438264301777,214763,216915
THIRTY.txt,216111,218099,1988,10,Y,Y,1438264301777,214763,216915
THIRTY.txt,218100,219744,1644,10,N,Y,1438264789808,219545,219984
THIRTY.txt,219745,221511,1766,10,Y,Y,1438265344157,220057,220486
THIRTY.txt,221514,222994,1480,10,N,N,-,-1,-1
THIRTY.txt,222995,224636,1641,10,N,N,-,-1,-1
THIRTY.txt,224639,225932,1293,10,N,N,-,-1,-1
THIRTY.txt,225933,227769,1836,10,N,N,-,-1,-1
THIRTY.txt,227771,229501,1730,10,Y,Y,1438266059280,228002,229500
THIRTY.txt,229504,230711,1207,10,N,N,-,-1,-1
THIRTY.txt,230712,231581,869,10,N,N,-,-1,-1
THIRTY.txt,231584,232819,1235,10,N,N,-,-1,-1
THIRTY.txt,232820,234286,1466,10,Y,N,-,-1,-1
THIRTY.txt,234287,235830,1543,10,N,N,-,-1,-1
THIRTY.txt,235831,237062,1231,10,N,N,-,-1,-1
THIRTY.txt,237062,238632,1570,10,N,N,-,-1,-1
THIRTY.txt,238633,239760,1127,10,N,N,-,-1,-1
THIRTY.txt,239761,240992,1231,10,N,N,-,-1,-1
THIRTY.txt,240993,242327,1334,10,N,N,-,-1,-1
THIRTY.txt,242328,243284,956,10,Y,N,-,-1,-1
THIRTY.txt,243285,245222,1937,10,N,N,-,-1,-1
THIRTY.txt,245223,246497,1274,10,N,N,-,-1,-1
THIRTY.txt,246500,247744,1244,10,N,N,-,-1,-1
THIRTY.txt,247747,248779,1032,10,N,N,-,-1,-1
THIRTY.txt,248780,249725,945,10,N,N,-,-1,-1
THIRTY.txt,249726,250901,1175,10,N,N,-,-1,-1
THIRTY.txt,250904,252274,1370,10,N,Y,1438423300058,250954,251876
THIRTY.txt,252275,253923,1648,10,N,N,-,-1,-1
THIRTY.txt,253924,255914,1990,10,N,N,-,-1,-1
THIRTY.txt,255915,257467,1552,10,N,Y,1438423663362,256945,257426
THIRTY.txt,257468,259296,1828,10,N,N,-,-1,-1
THIRTY.txt,259297,261204,1907,10,N,Y,1438424184434,260766,262372
THIRTY.txt,261206,262498,1292,10,N,Y,1438424184434,260766,262372
THIRTY.txt,262499,263382,883,10,N,N,-,-1,-1
THIRTY.txt,263383,264278,895,10,N,N,-,-1,-1
THIRTY.txt,264279,265503,1224,10,N,N,-,-1,-1
THIRTY.txt,265504,267085,1581,10,N,N,-,-1,-1
THIRTY.txt,267088,268213,1125,10,N,N,-,-1,-1
THIRTY.txt,268218,269539,1321,10,N,N,-,-1,-1
THIRTY.txt,269540,271318,1778,10,N,N,-,-1,-1
THIRTY.txt,271320,273200,1880,10,Y,N,-,-1,-1
THIRTY.txt,273200,275130,1930,10,N,Y,1438425910414,274750,276774
THIRTY.txt,275131,276728,1597,10,N,Y,1438425910414,274750,276774
THIRTY.txt,276729,278408,1679,10,N,Y,1438426336365,278251,279327
THIRTY.txt,278409,279940,1531,10,N,Y,1438426336365,278251,279327
THIRTY.txt,279942,281174,1232,10,N,N,-,-1,-1
THIRTY.txt,281177,282704,1527,10,Y,Y,1438426775375,281224,282800
THIRTY.txt,282705,284834,2129,10,N,Y,1438426775375,281224,282800
THIRTY.txt,284835,286138,1303,10,N,N,-,-1,-1
THIRTY.txt,286139,287313,1174,10,N,Y,1438427296305,286896,287713
THIRTY.txt,287316,288637,1321,10,N,Y,1438427296305,286896,287713
THIRTY.txt,288638,289886,1248,10,N,N,-,-1,-1
THIRTY.txt,289887,291627,1740,10,N,N,-,-1,-1
THIRTY.txt,291628,292845,1217,10,N,N,-,-1,-1
THIRTY.txt,292847,293691,844,10,N,N,-,-1,-1
THIRTY.txt,293694,295067,1373,10,N,N,-,-1,-1
THIRTY.txt,295068,296220,1152,10,N,N,-,-1,-1
THIRTY.txt,296223,298465,2242,10,N,N,-,-1,-1
THIRTY.txt,298466,300143,1677,10,Y,N,-,-1,-1
THIRTY.txt,300144,301643,1499,10,N,Y,1438427933753,301337,301636
THIRTY.txt,301644,303245,1601,10,N,Y,1438428449081,302448,305774
THIRTY.txt,303246,305061,1815,10,N,Y,1438428449081,302448,305774
THIRTY.txt,305062,306320,1258,10,Y,Y,1438436113840,305935,306928
THIRTY.txt,306321,307910,1589,10,N,Y,1438436113840,305935,306928
THIRTY.txt,307911,309146,1235,10,N,N,-,-1,-1
THIRTY.txt,309147,311090,1943,10,N,N,-,-1,-1
THIRTY.txt,311093,312453,1360,10,N,N,-,-1,-1
THIRTY.txt,312454,313668,1214,10,N,N,-,-1,-1
THIRTY.txt,313669,315307,1638,10,N,Y,1438436987445,314654,315248
THIRTY.txt,315308,317130,1822,10,N,Y,1438437740936,316545,317774
THIRTY.txt,317131,319231,2100,10,N,Y,1438437740936,316545,317774
THIRTY.txt,319232,320699,1467,10,N,Y,1438438056880,318703,319615
THIRTY.txt,320702,322266,1564,10,N,N,-,-1,-1
THIRTY.txt,322267,323962,1695,10,N,N,-,-1,-1
THIRTY.txt,323963,325336,1373,10,N,N,-,-1,-1
THIRTY.txt,325337,326681,1344,10,Y,Y,1438438506460,326211,326819
THIRTY.txt,326682,328130,1448,10,N,Y,1438438506460,326211,326819
THIRTY.txt,328135,329900,1765,10,N,N,-,-1,-1
THIRTY.txt,329901,331477,1576,10,N,Y,1438442848699,330488,331687
THIRTY.txt,331478,332983,1505,10,N,Y,1438442848699,330488,331687
THIRTY.txt,332984,334395,1411,10,N,N,-,-1,-1
THIRTY.txt,334396,335620,1224,10,N,Y,1438443458585,334890,335870
THIRTY.txt,335621,337157,1536,10,N,Y,1438443458585,334890,335870
THIRTY.txt,337158,338418,1260,10,N,Y,1438443842388,336005,338631
THIRTY.txt,338419,340019,1600,10,N,Y,1438444169457,339222,340309
THIRTY.txt,340020,342076,2056,10,N,Y,1438444169457,339222,340309
THIRTY.txt,342077,343786,1709,10,N,N,-,-1,-1
THIRTY.txt,343789,345419,1630,10,N,Y,1438444885260,343875,346542
THIRTY.txt,345420,346913,1493,10,N,Y,1438444885260,343875,346542
THIRTY.txt,346914,348614,1700,10,N,Y,1438445991237,347950,348352
THIRTY.txt,348614,350306,1692,10,N,N,-,-1,-1
THIRTY.txt,350307,352026,1719,10,N,Y,1438446807342,351574,353976
THIRTY.txt,352027,353192,1165,10,N,Y,1438446807342,351574,353976
THIRTY.txt,353195,354253,1058,10,N,Y,1438446807342,351574,353976
THIRTY.txt,354253,356423,2170,10,N,N,-,-1,-1
THIRTY.txt,356424,358473,2049,10,N,N,-,-1,-1
THIRTY.txt,358475,359663,1188,10,N,N,-,-1,-1
THIRTY.txt,359664,361320,1656,10,N,N,-,-1,-1
THIRTY.txt,361323,362783,1460,10,N,N,-,-1,-1
THIRTY.txt,362788,364207,1419,10,N,N,-,-1,-1
THIRTY.txt,364208,365407,1199,10,N,N,-,-1,-1
THIRTY.txt,365408,366463,1055,10,N,N,-,-1,-1
THIRTY.txt,366464,367842,1378,10,N,N,-,-1,-1
THIRTY.txt,367845,369373,1528,10,N,N,-,-1,-1
THIRTY.txt,369376,371520,2144,10,N,Y,1438447751146,369829,370680
THIRTY.txt,371521,373094,1573,10,N,Y,1438448043481,372740,373741
THIRTY.txt,373095,374418,1323,10,N,Y,1438448043481,372740,373741
THIRTY.txt,374421,375954,1533,10,N,N,-,-1,-1
THIRTY.txt,375959,377068,1109,10,Y,N,-,-1,-1
THIRTY.txt,377069,379058,1989,10,N,N,-,-1,-1
THIRTY.txt,379059,380709,1650,10,N,N,-,-1,-1
THIRTY.txt,380710,382080,1370,10,N,N,-,-1,-1
THIRTY.txt,382081,383192,1111,10,N,N,-,-1,-1
THIRTY.txt,383194,384708,1514,10,N,N,-,-1,-1
THIRTY.txt,384709,386210,1501,10,N,N,-,-1,-1
THIRTY.txt,386211,387802,1591,10,N,N,-,-1,-1
THIRTY.txt,387804,388912,1108,10,N,N,-,-1,-1
THIRTY.txt,388913,391009,2096,10,N,N,-,-1,-1
THIRTY.txt,391012,392251,1239,10,N,N,-,-1,-1
THIRTY.txt,392252,393289,1037,10,N,Y,1438520691591,392603,394020
THIRTY.txt,393294,394451,1157,10,N,Y,1438520691591,392603,394020
THIRTY.txt,394452,396613,2161,10,Y,Y,1438521743713,395976,397187
THIRTY.txt,396613,398462,1849,10,N,Y,1438521743713,395976,397187
THIRTY.txt,398464,399748,1284,10,N,N,-,-1,-1
THIRTY.txt,399749,400687,938,10,N,Y,1438522453832,399958,400307
THIRTY.txt,400688,401805,1117,10,N,N,-,-1,-1
THIRTY.txt,401806,403333,1527,10,Y,N,-,-1,-1
THIRTY.txt,403334,404916,1582,10,N,N,-,-1,-1
THIRTY.txt,404918,406523,1605,10,Y,N,-,-1,-1
THIRTY.txt,406525,408007,1482,10,N,Y,1438523309595,407082,408026
THIRTY.txt,408008,409188,1180,10,N,Y,1438523309595,407082,408026
THIRTY.txt,409189,409982,793,10,N,N,-,-1,-1
THIRTY.txt,409985,411890,1905,10,N,N,-,-1,-1
THIRTY.txt,411891,413539,1648,10,N,Y,1438524170239,412054,412585
THIRTY.txt,413540,415432,1892,10,Y,Y,1438524762496,413657,414319
THIRTY.txt,415437,417004,1567,10,N,N,-,-1,-1
THIRTY.txt,417009,418421,1412,10,N,N,-,-1,-1
THIRTY.txt,418422,419631,1209,10,N,Y,1438525236574,419169,419622
THIRTY.txt,419632,421196,1564,10,N,Y,1438525660625,420215,421606
THIRTY.txt,421197,422707,1510,10,Y,Y,1438525660625,420215,421606
THIRTY.txt,422707,424645,1938,10,N,N,-,-1,-1
THIRTY.txt,424646,426255,1609,10,N,N,-,-1,-1
THIRTY.txt,426256,427794,1538,10,N,Y,1438526435174,427361,428109
THIRTY.txt,427795,430111,2316,10,N,Y,1438526435174,427361,428109
THIRTY.txt,430112,432540,2428,10,N,N,-,-1,-1
THIRTY.txt,432541,434462,1921,10,N,N,-,-1,-1
THIRTY.txt,434463,436245,1782,10,N,Y,1438527042090,435881,437111
THIRTY.txt,436246,438227,1981,10,Y,Y,1438527042090,435881,437111
THIRTY.txt,438229,439627,1398,10,N,Y,1438532103693,439032,440498
THIRTY.txt,439628,441510,1882,10,N,Y,1438532103693,439032,440498
THIRTY.txt,441511,443218,1707,10,N,N,-,-1,-1
THIRTY.txt,443219,444784,1565,10,N,N,-,-1,-1
THIRTY.txt,444785,445868,1083,10,N,N,-,-1,-1
THIRTY.txt,445869,447076,1207,10,N,Y,1438532730981,446979,448516
THIRTY.txt,447077,448585,1508,10,N,Y,1438532730981,446979,448516
THIRTY.txt,448586,450616,2030,10,N,Y,1438533206356,448586,449872
THIRTY.txt,450617,451957,1340,10,N,N,-,-1,-1
THIRTY.txt,451960,453310,1350,10,N,N,-,-1,-1
THIRTY.txt,453313,454486,1173,10,N,N,-,-1,-1
THIRTY.txt,454487,456352,1865,10,Y,N,-,-1,-1
THIRTY.txt,456353,458539,2186,10,Y,Y,1438533757046,457288,458186
THIRTY.txt,458540,461041,2501,10,N,N,-,-1,-1
THIRTY.txt,461042,463334,2292,10,N,N,-,-1,-1
THIRTY.txt,463335,464828,1493,10,N,Y,1438534266920,463977,464515
THIRTY.txt,464833,466934,2101,10,Y,N,-,-1,-1
THIRTY.txt,466937,468440,1503,10,N,N,-,-1,-1
THIRTY.txt,468441,470291,1850,10,Y,N,-,-1,-1
THIRTY.txt,470293,471717,1424,10,Y,N,-,-1,-1
THIRTY.txt,471720,473588,1868,10,N,Y,1438589777282,472848,474072
THIRTY.txt,473589,475069,1480,10,N,Y,1438589777282,472848,474072
THIRTY.txt,475070,476543,1473,10,N,Y,1438590330949,474159,475584
THIRTY.txt,476544,478102,1558,10,N,N,-,-1,-1
THIRTY.txt,478104,479479,1375,10,Y,Y,1438591228595,478885,480708
THIRTY.txt,479480,480476,996,10,N,Y,1438591228595,478885,480708
THIRTY.txt,480479,482315,1836,10,N,Y,1438591228595,478885,480708
THIRTY.txt,482316,484336,2020,10,N,Y,1438592214311,484044,484590
THIRTY.txt,484337,486465,2128,10,N,Y,1438592530594,484631,485560
THIRTY.txt,486468,487907,1439,10,N,N,-,-1,-1
THIRTY.txt,487908,489263,1355,10,N,Y,1438592996577,488903,489682
THIRTY.txt,489264,490868,1604,10,N,Y,1438592996577,488903,489682
THIRTY.txt,490869,492558,1689,10,Y,Y,1438593512176,489782,492138
THIRTY.txt,492559,493671,1112,10,N,N,-,-1,-1
THIRTY.txt,493672,495135,1463,10,N,N,-,-1,-1
THIRTY.txt,495136,497168,2032,10,N,N,-,-1,-1
THIRTY.txt,497169,498907,1738,10,N,Y,1438594174047,498899,500136
THIRTY.txt,498908,500873,1965,10,N,Y,1438594174047,498899,500136
THIRTY.txt,500874,503220,2346,10,N,Y,1438596375620,500735,501901
THIRTY.txt,503221,505073,1852,10,N,N,-,-1,-1
THIRTY.txt,505076,506755,1679,10,Y,Y,1438596889671,505129,506172
THIRTY.txt,506758,508290,1532,10,N,N,-,-1,-1
THIRTY.txt,508291,510466,2175,10,N,N,-,-1,-1
THIRTY.txt,510467,512170,1703,10,N,Y,1438597622333,511659,513933
THIRTY.txt,512173,514037,1864,10,N,Y,1438597622333,511659,513933
THIRTY.txt,514040,515284,1244,10,N,N,-,-1,-1
THIRTY.txt,515285,516981,1696,10,N,N,-,-1,-1
THIRTY.txt,516982,518342,1360,10,N,N,-,-1,-1
THIRTY.txt,518344,519966,1622,10,N,Y,1438598288957,519286,519820
THIRTY.txt,519967,521635,1668,10,N,N,-,-1,-1
THIRTY.txt,521636,523344,1708,10,N,Y,1438598938260,522322,523335
THIRTY.txt,523345,525929,2584,10,Y,Y,1438599418291,525144,526021
THIRTY.txt,525930,527021,1091,10,N,Y,1438599418291,525144,526021
THIRTY.txt,527022,527895,873,10,N,N,-,-1,-1
THIRTY.txt,527896,529779,1883,10,Y,Y,1438599831167,529511,530072
THIRTY.txt,529780,531108,1328,10,N,Y,1438599831167,529511,530072
THIRTY.txt,531109,532792,1683,10,N,N,-,-1,-1
THIRTY.txt,532793,533916,1123,10,N,N,-,-1,-1
THIRTY.txt,533917,536040,2123,10,Y,Y,1438600198307,534335,534790
THIRTY.txt,536041,538675,2634,10,Y,N,-,-1,-1
THIRTY.txt,538676,540397,1721,10,N,N,-,-1,-1
THIRTY.txt,540398,545939,5541,10,N,N,-,-1,-1
THIRTY.txt,545940,559079,13139,10,N,N,-,-1,-1
THIRTY.txt,559080,575368,16288,10,N,N,-,-1,-1
TWOMEN.txt,2,3380,3378,10,N,N,-,-1,-1
TWOMEN.txt,3381,4697,1316,10,N,N,-,-1,-1
TWOMEN.txt,4698,5059,361,10,N,N,-,-1,-1
TWOMEN.txt,5061,5784,723,10,N,N,-,-1,-1
TWOMEN.txt,5785,7601,1816,10,Y,N,-,-1,-1
TWOMEN.txt,7603,8865,1262,10,N,N,-,-1,-1
TWOMEN.txt,8867,10749,1882,10,N,Y,1433438168945,10115,10944
TWOMEN.txt,10750,12850,2100,10,N,Y,1433438168945,10115,10944
TWOMEN.txt,12851,14827,1976,10,Y,N,-,-1,-1
TWOMEN.txt,14829,16923,2094,10,N,N,-,-1,-1
TWOMEN.txt,16924,18472,1548,10,N,N,-,-1,-1
TWOMEN.txt,18473,20202,1729,10,N,N,-,-1,-1
TWOMEN.txt,20204,21325,1121,10,N,N,-,-1,-1
TWOMEN.txt,21326,22550,1224,10,N,N,-,-1,-1
TWOMEN.txt,22551,23802,1251,10,N,N,-,-1,-1
TWOMEN.txt,23804,24257,453,10,N,N,-,-1,-1
TWOMEN.txt,24258,24653,395,10,N,N,-,-1,-1
TWOMEN.txt,24656,25601,945,10,N,N,-,-1,-1
TWOMEN.txt,25602,26676,1074,10,N,N,-,-1,-1
TWOMEN.txt,26677,28734,2057,10,N,N,-,-1,-1
TWOMEN.txt,28735,30020,1285,10,N,N,-,-1,-1
TWOMEN.txt,30020,30397,377,10,N,N,-,-1,-1
TWOMEN.txt,30400,30616,216,10,N,N,-,-1,-1
TWOMEN.txt,30617,31127,510,10,N,N,-,-1,-1
TWOMEN.txt,31129,31642,513,10,N,N,-,-1,-1
TWOMEN.txt,31644,32022,378,10,N,N,-,-1,-1
TWOMEN.txt,32027,32878,851,10,N,N,-,-1,-1
TWOMEN.txt,32879,33995,1116,10,N,N,-,-1,-1
TWOMEN.txt,33998,34638,640,10,N,N,-,-1,-1
TWOMEN.txt,34639,35014,375,10,N,N,-,-1,-1
TWOMEN.txt,35016,35432,416,10,N,N,-,-1,-1
TWOMEN.txt,35433,36003,570,10,N,N,-,-1,-1
TWOMEN.txt,36005,36420,415,10,N,N,-,-1,-1
TWOMEN.txt,36421,37140,719,10,N,N,-,-1,-1
TWOMEN.txt,37142,37674,532,10,N,N,-,-1,-1
TWOMEN.txt,37676,38158,482,10,N,N,-,-1,-1
TWOMEN.txt,38160,39062,902,10,N,N,-,-1,-1
TWOMEN.txt,39063,40974,1911,10,N,N,-,-1,-1
TWOMEN.txt,40976,41864,888,10,N,N,-,-1,-1
TWOMEN.txt,41865,42244,379,10,N,N,-,-1,-1
TWOMEN.txt,42246,43176,930,10,N,N,-,-1,-1
TWOMEN.txt,43177,43880,703,10,N,N,-,-1,-1
TWOMEN.txt,43883,45351,1468,10,N,N,-,-1,-1
TWOMEN.txt,45352,47210,1858,10,N,N,-,-1,-1
TWOMEN.txt,47212,48869,1657,10,N,N,-,-1,-1
TWOMEN.txt,48870,49825,955,10,N,N,-,-1,-1
TWOMEN.txt,49827,50262,435,10,N,N,-,-1,-1
TWOMEN.txt,50264,50652,388,10,N,N,-,-1,-1
TWOMEN.txt,50653,52155,1502,10,N,N,-,-1,-1
TWOMEN.txt,52156,53349,1193,10,N,N,-,-1,-1
TWOMEN.txt,53354,56554,3200,10,N,N,-,-1,-1
TWOMEN.txt,56555,58347,1792,10,N,N,-,-1,-1
TWOMEN.txt,58348,59510,1162,10,N,N,-,-1,-1
TWOMEN.txt,59511,60778,1267,10,N,N,-,-1,-1
TWOMEN.txt,60780,61188,408,10,N,N,-,-1,-1
TWOMEN.txt,61189,61838,649,10,N,N,-,-1,-1
TWOMEN.txt,61840,62924,1084,10,N,N,-,-1,-1
TWOMEN.txt,62925,64639,1714,10,N,N,-,-1,-1
TWOMEN.txt,64640,65592,952,10,N,N,-,-1,-1
TWOMEN.txt,65594,66997,1403,10,N,N,-,-1,-1
TWOMEN.txt,66998,67949,951,10,N,N,-,-1,-1
TWOMEN.txt,67951,68840,889,10,N,N,-,-1,-1
TWOMEN.txt,68841,70381,1540,10,N,Y,1435165746603,69147,70419
TWOMEN.txt,70382,72365,1983,10,N,Y,1435165746603,69147,70419
TWOMEN.txt,72366,73539,1173,10,N,N,-,-1,-1
TWOMEN.txt,73541,74838,1297,10,N,N,-,-1,-1
TWOMEN.txt,74839,75588,749,10,N,N,-,-1,-1
TWOMEN.txt,75589,76575,986,10,N,N,-,-1,-1
TWOMEN.txt,76578,77480,902,10,N,N,-,-1,-1
TWOMEN.txt,77481,78313,832,10,N,N,-,-1,-1
TWOMEN.txt,78314,79965,1651,10,N,N,-,-1,-1
TWOMEN.txt,79966,80799,833,10,N,N,-,-1,-1
TWOMEN.txt,80800,81828,1028,10,N,N,-,-1,-1
TWOMEN.txt,81829,82680,851,10,N,N,-,-1,-1
TWOMEN.txt,82685,83827,1142,10,N,N,-,-1,-1
TWOMEN.txt,83828,84961,1133,10,N,N,-,-1,-1
TWOMEN.txt,84963,85914,951,10,N,N,-,-1,-1
TWOMEN.txt,85918,86872,954,10,N,N,-,-1,-1
TWOMEN.txt,86874,87681,807,10,N,N,-,-1,-1
TWOMEN.txt,87683,88929,1246,10,N,N,-,-1,-1
TWOMEN.txt,88932,89398,466,10,N,N,-,-1,-1
TWOMEN.txt,89399,90139,740,10,N,N,-,-1,-1
TWOMEN.txt,90140,90442,302,10,N,N,-,-1,-1
TWOMEN.txt,90443,91950,1507,10,N,N,-,-1,-1
TWOMEN.txt,91951,93020,1069,10,N,N,-,-1,-1
TWOMEN.txt,93021,93846,825,10,N,N,-,-1,-1
TWOMEN.txt,93847,94564,717,10,N,N,-,-1,-1
TWOMEN.txt,94565,95289,724,10,N,N,-,-1,-1
TWOMEN.txt,95291,96536,1245,10,N,N,-,-1,-1
TWOMEN.txt,96537,97820,1283,10,N,N,-,-1,-1
TWOMEN.txt,97821,98760,939,10,N,N,-,-1,-1
TWOMEN.txt,98761,99728,967,10,N,N,-,-1,-1
TWOMEN.txt,99729,101066,1337,10,N,N,-,-1,-1
TWOMEN.txt,101068,101954,886,10,N,N,-,-1,-1
TWOMEN.txt,101956,102843,887,10,N,N,-,-1,-1
TWOMEN.txt,102845,103773,928,10,N,N,-,-1,-1
TWOMEN.txt,103775,105286,1511,10,N,N,-,-1,-1
TWOMEN.txt,105287,107006,1719,10,N,N,-,-1,-1
TWOMEN.txt,107007,108957,1950,10,N,N,-,-1,-1
TWOMEN.txt,108959,110162,1203,10,N,N,-,-1,-1
TWOMEN.txt,110164,111380,1216,10,N,N,-,-1,-1
TWOMEN.txt,111384,112125,741,10,N,N,-,-1,-1
TWOMEN.txt,112127,113300,1173,10,N,N,-,-1,-1
TWOMEN.txt,113301,114112,811,10,N,N,-,-1,-1
TWOMEN.txt,114113,115506,1393,10,N,N,-,-1,-1
TWOMEN.txt,115507,116732,1225,10,N,N,-,-1,-1
TWOMEN.txt,116734,118052,1318,10,N,N,-,-1,-1
TWOMEN.txt,118054,119401,1347,10,N,N,-,-1,-1
TWOMEN.txt,119402,121107,1705,10,N,N,-,-1,-1
TWOMEN.txt,121108,122735,1627,10,N,Y,1435248397073,122627,123247
TWOMEN.txt,122736,124096,1360,10,N,Y,1435248397073,122627,123247
TWOMEN.txt,124097,125629,1532,10,N,Y,1435251420562,125574,126313
TWOMEN.txt,125630,126232,602,10,N,Y,1435251420562,125574,126313
TWOMEN.txt,126233,127594,1361,10,N,Y,1435251420562,125574,126313
TWOMEN.txt,127595,128640,1045,10,N,N,-,-1,-1
TWOMEN.txt,128640,129978,1338,10,N,N,-,-1,-1
TWOMEN.txt,129979,130892,913,10,N,N,-,-1,-1
TWOMEN.txt,130893,131806,913,10,N,N,-,-1,-1
TWOMEN.txt,131806,134462,2656,10,N,N,-,-1,-1
TWOMEN.txt,134464,135648,1184,10,N,N,-,-1,-1
TWOMEN.txt,135649,136459,810,10,N,N,-,-1,-1
TWOMEN.txt,136460,137964,1504,10,N,N,-,-1,-1
TWOMEN.txt,137965,138810,845,10,N,N,-,-1,-1
TWOMEN.txt,138811,139599,788,10,N,N,-,-1,-1
TWOMEN.txt,139601,140107,506,10,N,N,-,-1,-1
TWOMEN.txt,140108,140891,783,10,N,N,-,-1,-1
TWOMEN.txt,140892,141513,621,10,N,N,-,-1,-1
TWOMEN.txt,141514,142093,579,10,N,N,-,-1,-1
TWOMEN.txt,142096,142994,898,10,N,N,-,-1,-1
TWOMEN.txt,142994,143803,809,10,N,N,-,-1,-1
TWOMEN.txt,143805,144692,887,10,N,Y,1435252280553,144644,145005
TWOMEN.txt,144693,145311,618,10,N,Y,1435252280553,144644,145005
TWOMEN.txt,145313,146067,754,10,N,N,-,-1,-1
TWOMEN.txt,146067,146636,569,10,N,N,-,-1,-1
TWOMEN.txt,146637,147307,670,10,N,N,-,-1,-1
TWOMEN.txt,147308,147932,624,10,N,N,-,-1,-1
TWOMEN.txt,147934,148692,758,10,N,N,-,-1,-1
TWOMEN.txt,148694,149342,648,10,N,N,-,-1,-1
TWOMEN.txt,149343,149798,455,10,N,N,-,-1,-1
TWOMEN.txt,149799,150472,673,10,N,N,-,-1,-1
TWOMEN.txt,150474,151132,658,10,N,N,-,-1,-1
TWOMEN.txt,151133,151978,845,10,N,N,-,-1,-1
TWOMEN.txt,151979,152488,509,10,N,N,-,-1,-1
TWOMEN.txt,152493,153132,639,10,N,N,-,-1,-1
TWOMEN.txt,153135,153507,372,10,N,N,-,-1,-1
TWOMEN.txt,153508,154349,841,10,N,N,-,-1,-1
TWOMEN.txt,154351,155130,779,10,N,N,-,-1,-1
TWOMEN.txt,155131,155992,861,10,N,N,-,-1,-1
TWOMEN.txt,155993,156513,520,10,N,N,-,-1,-1
TWOMEN.txt,156513,157515,1002,10,N,N,-,-1,-1
TWOMEN.txt,157517,158426,909,10,N,N,-,-1,-1
TWOMEN.txt,158428,159502,1074,10,N,N,-,-1,-1
TWOMEN.txt,159504,160541,1037,10,N,Y,1435252717170,159519,160234
TWOMEN.txt,160543,161523,980,10,N,N,-,-1,-1
TWOMEN.txt,161526,162056,530,10,N,N,-,-1,-1
TWOMEN.txt,162058,163358,1300,10,N,N,-,-1,-1
TWOMEN.txt,163359,164611,1252,10,N,N,-,-1,-1
TWOMEN.txt,164616,165114,498,10,N,N,-,-1,-1
TWOMEN.txt,165116,165704,588,10,N,N,-,-1,-1
TWOMEN.txt,165706,166052,346,10,N,N,-,-1,-1
TWOMEN.txt,166054,166626,572,10,N,N,-,-1,-1
TWOMEN.txt,166628,167875,1247,10,N,N,-,-1,-1
TWOMEN.txt,167876,168913,1037,10,N,N,-,-1,-1
TWOMEN.txt,168914,169646,732,10,N,N,-,-1,-1
TWOMEN.txt,169648,171005,1357,10,N,N,-,-1,-1
TWOMEN.txt,171006,171466,460,10,N,N,-,-1,-1
TWOMEN.txt,171468,172385,917,10,N,N,-,-1,-1
TWOMEN.txt,172386,173212,826,10,N,N,-,-1,-1
TWOMEN.txt,173214,173984,770,10,N,N,-,-1,-1
TWOMEN.txt,173988,174736,748,10,N,N,-,-1,-1
TWOMEN.txt,174737,176133,1396,10,N,N,-,-1,-1
TWOMEN.txt,176135,177037,902,10,N,N,-,-1,-1
TWOMEN.txt,177038,178351,1313,10,N,N,-,-1,-1
TWOMEN.txt,178352,179474,1122,10,N,N,-,-1,-1
TWOMEN.txt,179476,180253,777,10,N,N,-,-1,-1
TWOMEN.txt,180255,181261,1006,10,N,N,-,-1,-1
TWOMEN.txt,181261,182178,917,10,N,N,-,-1,-1
TWOMEN.txt,182181,183820,1639,10,N,N,-,-1,-1
TWOMEN.txt,183821,184724,903,10,N,N,-,-1,-1
TWOMEN.txt,184725,185791,1066,10,N,N,-,-1,-1
TWOMEN.txt,185793,187229,1436,10,N,N,-,-1,-1
TWOMEN.txt,187230,188057,827,10,N,N,-,-1,-1
TWOMEN.txt,188060,189273,1213,10,N,N,-,-1,-1
TWOMEN.txt,189278,190253,975,10,N,N,-,-1,-1
TWOMEN.txt,190256,191028,772,10,N,N,-,-1,-1
TWOMEN.txt,191030,192414,1384,10,N,N,-,-1,-1
TWOMEN.txt,192416,193457,1041,10,N,N,-,-1,-1
TWOMEN.txt,193458,194287,829,10,N,N,-,-1,-1
TWOMEN.txt,194289,194538,249,10,N,N,-,-1,-1
TWOMEN.txt,194539,194808,269,10,N,N,-,-1,-1
TWOMEN.txt,194811,195712,901,10,N,N,-,-1,-1
TWOMEN.txt,195714,196502,788,10,N,N,-,-1,-1
TWOMEN.txt,196503,197685,1182,10,N,N,-,-1,-1
TWOMEN.txt,197688,198476,788,10,N,N,-,-1,-1
TWOMEN.txt,198476,199314,838,10,N,N,-,-1,-1
TWOMEN.txt,199316,199645,329,10,N,N,-,-1,-1
TWOMEN.txt,199646,200400,754,10,N,N,-,-1,-1
TWOMEN.txt,200401,201260,859,10,N,Y,1435559512755,200724,201031
TWOMEN.txt,201262,201867,605,10,N,N,-,-1,-1
TWOMEN.txt,201868,202755,887,10,N,N,-,-1,-1
TWOMEN.txt,202756,203891,1135,10,N,N,-,-1,-1
TWOMEN.txt,203893,204797,904,10,N,N,-,-1,-1
TWOMEN.txt,204798,205515,717,10,N,N,-,-1,-1
TWOMEN.txt,205516,205969,453,10,N,N,-,-1,-1
TWOMEN.txt,205974,206657,683,10,N,N,-,-1,-1
TWOMEN.txt,206658,207214,556,10,N,N,-,-1,-1
TWOMEN.txt,207217,207969,752,10,N,N,-,-1,-1
TWOMEN.txt,207970,209089,1119,10,N,N,-,-1,-1
TWOMEN.txt,209090,210428,1338,10,N,N,-,-1,-1
TWOMEN.txt,210429,211207,778,10,N,N,-,-1,-1
TWOMEN.txt,211207,212876,1669,10,N,N,-,-1,-1
TWOMEN.txt,212877,213987,1110,10,N,N,-,-1,-1
TWOMEN.txt,213988,214920,932,10,N,N,-,-1,-1
TWOMEN.txt,214922,215952,1030,10,N,N,-,-1,-1
TWOMEN.txt,215953,217494,1541,10,N,N,-,-1,-1
TWOMEN.txt,217495,218484,989,10,N,N,-,-1,-1
TWOMEN.txt,218485,219855,1370,10,N,N,-,-1,-1
TWOMEN.txt,219856,220752,896,10,N,N,-,-1,-1
TWOMEN.txt,220753,221643,890,10,N,N,-,-1,-1
TWOMEN.txt,221644,222739,1095,10,N,N,-,-1,-1
TWOMEN.txt,222740,223766,1026,10,N,Y,1435560377740,223014,223315
TWOMEN.txt,223768,224420,652,10,N,N,-,-1,-1
TWOMEN.txt,224425,225241,816,10,N,N,-,-1,-1
TWOMEN.txt,225242,225753,511,10,N,N,-,-1,-1
TWOMEN.txt,225754,226287,533,10,N,N,-,-1,-1
TWOMEN.txt,226289,227455,1166,10,N,N,-,-1,-1
TWOMEN.txt,227456,227782,326,10,N,N,-,-1,-1
TWOMEN.txt,227783,228970,1187,10,N,N,-,-1,-1
TWOMEN.txt,228972,229467,495,10,N,N,-,-1,-1
TWOMEN.txt,229468,230464,996,10,N,N,-,-1,-1
TWOMEN.txt,230466,230990,524,10,N,N,-,-1,-1
TWOMEN.txt,230992,232336,1344,10,N,N,-,-1,-1
TWOMEN.txt,232338,232681,343,10,N,N,-,-1,-1
TWOMEN.txt,232683,233104,421,10,N,N,-,-1,-1
TWOMEN.txt,233105,233656,551,10,N,N,-,-1,-1
TWOMEN.txt,233657,234555,898,10,N,N,-,-1,-1
TWOMEN.txt,234557,235201,644,10,N,N,-,-1,-1
TWOMEN.txt,235202,235542,340,10,N,N,-,-1,-1
TWOMEN.txt,235543,236531,988,10,N,N,-,-1,-1
TWOMEN.txt,236533,237373,840,10,N,Y,1435569753505,236911,237277
TWOMEN.txt,237375,238227,852,10,N,N,-,-1,-1
TWOMEN.txt,238228,239099,871,10,N,N,-,-1,-1
TWOMEN.txt,239100,240195,1095,10,N,N,-,-1,-1
TWOMEN.txt,240196,241223,1027,10,N,N,-,-1,-1
TWOMEN.txt,241225,242093,868,10,N,N,-,-1,-1
TWOMEN.txt,242095,242985,890,10,N,Y,1435570787049,242195,242945
TWOMEN.txt,242986,243752,766,10,N,N,-,-1,-1
TWOMEN.txt,243753,244424,671,10,N,N,-,-1,-1
TWOMEN.txt,244426,245439,1013,10,N,N,-,-1,-1
TWOMEN.txt,245440,246160,720,10,N,N,-,-1,-1
TWOMEN.txt,246162,247047,885,10,N,N,-,-1,-1
TWOMEN.txt,247049,247870,821,10,N,N,-,-1,-1
TWOMEN.txt,247871,249429,1558,10,N,N,-,-1,-1
TWOMEN.txt,249430,250785,1355,10,N,N,-,-1,-1
TWOMEN.txt,250786,251687,901,10,N,N,-,-1,-1
TWOMEN.txt,251688,252853,1165,10,N,N,-,-1,-1
TWOMEN.txt,252855,253968,1113,10,N,N,-,-1,-1
TWOMEN.txt,253970,254661,691,10,N,N,-,-1,-1
TWOMEN.txt,254661,255244,583,10,N,N,-,-1,-1
TWOMEN.txt,255245,256393,1148,10,N,N,-,-1,-1
TWOMEN.txt,256394,257296,902,10,N,N,-,-1,-1
TWOMEN.txt,257297,258586,1289,10,N,N,-,-1,-1
TWOMEN.txt,258588,259830,1242,10,N,N,-,-1,-1
TWOMEN.txt,259832,260745,913,10,N,N,-,-1,-1
TWOMEN.txt,260750,262220,1470,10,N,N,-,-1,-1
TWOMEN.txt,262222,262974,752,10,N,N,-,-1,-1
TWOMEN.txt,262975,263758,783,10,N,N,-,-1,-1
TWOMEN.txt,263760,264675,915,10,N,N,-,-1,-1
TWOMEN.txt,264676,265950,1274,10,N,N,-,-1,-1
TWOMEN.txt,265951,266796,845,10,N,N,-,-1,-1
TWOMEN.txt,266798,267526,728,10,N,N,-,-1,-1
TWOMEN.txt,267529,268930,1401,10,N,N,-,-1,-1
TWOMEN.txt,268931,269926,995,10,N,N,-,-1,-1
TWOMEN.txt,269927,271015,1088,10,N,N,-,-1,-1
TWOMEN.txt,271016,272367,1351,10,N,N,-,-1,-1
TWOMEN.txt,272368,273573,1205,10,N,N,-,-1,-1
TWOMEN.txt,273575,275037,1462,10,N,N,-,-1,-1
TWOMEN.txt,275038,275501,463,10,N,N,-,-1,-1
TWOMEN.txt,275502,276689,1187,10,N,N,-,-1,-1
TWOMEN.txt,276691,277809,1118,10,N,N,-,-1,-1
TWOMEN.txt,277810,278747,937,10,N,N,-,-1,-1
TWOMEN.txt,278748,279829,1081,10,N,N,-,-1,-1
TWOMEN.txt,279830,280403,573,10,N,N,-,-1,-1
TWOMEN.txt,280405,281495,1090,10,N,N,-,-1,-1
TWOMEN.txt,281496,282897,1401,10,N,N,-,-1,-1
TWOMEN.txt,282898,283543,645,10,N,N,-,-1,-1
TWOMEN.txt,283544,283887,343,10,N,N,-,-1,-1
TWOMEN.txt,283887,284477,590,10,N,N,-,-1,-1
TWOMEN.txt,284478,285355,877,10,N,N,-,-1,-1
TWOMEN.txt,285356,286471,1115,10,N,N,-,-1,-1
TWOMEN.txt,286476,287683,1207,10,N,N,-,-1,-1
TWOMEN.txt,287684,288803,1119,10,N,N,-,-1,-1
TWOMEN.txt,288803,289867,1064,10,N,N,-,-1,-1
TWOMEN.txt,289868,290884,1016,10,N,N,-,-1,-1
TWOMEN.txt,290885,292791,1906,10,N,N,-,-1,-1
TWOMEN.txt,292794,293828,1034,10,N,N,-,-1,-1
TWOMEN.txt,293830,294614,784,10,N,N,-,-1,-1
TWOMEN.txt,294614,295607,993,10,N,N,-,-1,-1
TWOMEN.txt,295609,296421,812,10,N,N,-,-1,-1
TWOMEN.txt,296422,297678,1256,10,N,N,-,-1,-1
TWOMEN.txt,297680,298940,1260,10,N,N,-,-1,-1
TWOMEN.txt,298940,299594,654,10,N,N,-,-1,-1
TWOMEN.txt,299595,300691,1096,10,N,N,-,-1,-1
TWOMEN.txt,300693,301869,1176,10,N,N,-,-1,-1
TWOMEN.txt,301870,302484,614,10,N,N,-,-1,-1
TWOMEN.txt,302485,303688,1203,10,N,N,-,-1,-1
TWOMEN.txt,303690,304427,737,10,N,N,-,-1,-1
TWOMEN.txt,304428,305652,1224,10,N,N,-,-1,-1
TWOMEN.txt,305653,307144,1491,10,N,N,-,-1,-1
TWOMEN.txt,307145,308076,931,10,N,N,-,-1,-1
TWOMEN.txt,308080,308777,697,10,N,N,-,-1,-1
TWOMEN.txt,308778,310620,1842,10,N,N,-,-1,-1
TWOMEN.txt,310621,311363,742,10,N,N,-,-1,-1
TWOMEN.txt,311365,311531,166,10,N,N,-,-1,-1
TWOMEN.txt,311532,312406,874,10,N,N,-,-1,-1
TWOMEN.txt,312409,313377,968,10,N,N,-,-1,-1
TWOMEN.txt,313378,314125,747,10,N,N,-,-1,-1
TWOMEN.txt,314127,315326,1199,10,N,N,-,-1,-1
TWOMEN.txt,315327,316954,1627,10,N,N,-,-1,-1
TWOMEN.txt,316955,318116,1161,10,N,N,-,-1,-1
TWOMEN.txt,318117,319008,891,10,N,N,-,-1,-1
TWOMEN.txt,319010,319922,912,10,N,N,-,-1,-1
TWOMEN.txt,319924,320982,1058,10,N,N,-,-1,-1
TWOMEN.txt,320983,321783,800,10,N,N,-,-1,-1
TWOMEN.txt,321784,322905,1121,10,N,N,-,-1,-1
TWOMEN.txt,322907,323432,525,10,N,N,-,-1,-1
TWOMEN.txt,323433,324347,914,10,N,N,-,-1,-1
TWOMEN.txt,324348,325118,770,10,N,N,-,-1,-1
TWOMEN.txt,325120,326010,890,10,N,N,-,-1,-1
TWOMEN.txt,326011,326740,729,10,N,N,-,-1,-1
TWOMEN.txt,326745,327547,802,10,N,N,-,-1,-1
TWOMEN.txt,327549,328482,933,10,N,N,-,-1,-1
TWOMEN.txt,328483,329330,847,10,N,N,-,-1,-1
TWOMEN.txt,329332,330554,1222,10,N,N,-,-1,-1
TWOMEN.txt,330555,332219,1664,10,N,N,-,-1,-1
TWOMEN.txt,332221,333278,1057,10,N,N,-,-1,-1
TWOMEN.txt,333281,334049,768,10,N,N,-,-1,-1
TWOMEN.txt,334050,334677,627,10,N,N,-,-1,-1
TWOMEN.txt,334678,336010,1332,10,N,N,-,-1,-1
TWOMEN.txt,336011,337020,1009,10,N,N,-,-1,-1
TWOMEN.txt,337021,337698,677,10,N,N,-,-1,-1
TWOMEN.txt,337701,338413,712,10,N,N,-,-1,-1
TWOMEN.txt,338414,339331,917,10,N,N,-,-1,-1
TWOMEN.txt,339332,340028,696,10,N,N,-,-1,-1
TWOMEN.txt,340029,340559,530,10,N,N,-,-1,-1
TWOMEN.txt,340560,340975,415,10,N,N,-,-1,-1
TWOMEN.txt,340978,341404,426,10,N,N,-,-1,-1
TWOMEN.txt,341405,342088,683,10,N,N,-,-1,-1
TWOMEN.txt,342089,343154,1065,10,N,N,-,-1,-1
TWOMEN.txt,343155,343680,525,10,N,N,-,-1,-1
TWOMEN.txt,343681,344008,327,10,N,N,-,-1,-1
TWOMEN.txt,344009,344437,428,10,N,N,-,-1,-1
TWOMEN.txt,344439,345213,774,10,N,N,-,-1,-1
TWOMEN.txt,345215,346026,811,10,N,N,-,-1,-1
TWOMEN.txt,346028,347428,1400,10,N,N,-,-1,-1
TWOMEN.txt,347431,348211,780,10,N,N,-,-1,-1
TWOMEN.txt,348211,348970,759,10,N,N,-,-1,-1
TWOMEN.txt,348971,349780,809,10,N,N,-,-1,-1
TWOMEN.txt,349782,350387,605,10,N,N,-,-1,-1
TWOMEN.txt,350389,350936,547,10,N,N,-,-1,-1
TWOMEN.txt,350937,351919,982,10,N,N,-,-1,-1
TWOMEN.txt,351924,352332,408,10,N,N,-,-1,-1
TWOMEN.txt,352332,352899,567,10,N,N,-,-1,-1
TWOMEN.txt,352899,353840,941,10,N,N,-,-1,-1
TWOMEN.txt,353840,354709,869,10,N,N,-,-1,-1
TWOMEN.txt,354710,355739,1029,10,N,N,-,-1,-1
TWOMEN.txt,355740,356350,610,10,N,N,-,-1,-1
TWOMEN.txt,356352,357029,677,10,N,N,-,-1,-1
TWOMEN.txt,357034,357623,589,10,N,N,-,-1,-1
TWOMEN.txt,357625,358381,756,10,N,N,-,-1,-1
TWOMEN.txt,358383,359326,943,10,N,N,-,-1,-1
TWOMEN.txt,359327,360315,988,10,N,N,-,-1,-1
TWOMEN.txt,360316,361218,902,10,N,N,-,-1,-1
TWOMEN.txt,361220,362082,862,10,N,N,-,-1,-1
TWOMEN.txt,362087,363070,983,10,N,N,-,-1,-1
TWOMEN.txt,363071,364087,1016,10,N,N,-,-1,-1
TWOMEN.txt,364088,364598,510,10,N,N,-,-1,-1
TWOMEN.txt,364599,364930,331,10,N,N,-,-1,-1
TWOMEN.txt,364931,365401,470,10,N,N,-,-1,-1
TWOMEN.txt,365403,366377,974,10,N,N,-,-1,-1
TWOMEN.txt,366378,367090,712,10,N,N,-,-1,-1
TWOMEN.txt,367091,367886,795,10,N,N,-,-1,-1
TWOMEN.txt,367888,369045,1157,10,N,N,-,-1,-1
TWOMEN.txt,369046,369592,546,10,N,N,-,-1,-1
TWOMEN.txt,369595,370111,516,10,N,N,-,-1,-1
TWOMEN.txt,370112,370550,438,10,N,N,-,-1,-1
TWOMEN.txt,370551,371067,516,10,N,N,-,-1,-1
TWOMEN.txt,371070,371935,865,10,N,N,-,-1,-1
TWOMEN.txt,371936,372651,715,10,N,N,-,-1,-1
TWOMEN.txt,372652,373575,923,10,N,N,-,-1,-1
TWOMEN.txt,373576,374495,919,10,N,N,-,-1,-1
TWOMEN.txt,374496,375253,757,10,N,N,-,-1,-1
TWOMEN.txt,375255,376268,1013,10,N,N,-,-1,-1
TWOMEN.txt,376272,377411,1139,10,N,N,-,-1,-1
TWOMEN.txt,377412,378431,1019,10,N,N,-,-1,-1
TWOMEN.txt,378434,379111,677,10,N,N,-,-1,-1
TWOMEN.txt,379113,379735,622,10,N,N,-,-1,-1
TWOMEN.txt,379737,380600,863,10,N,N,-,-1,-1
TWOMEN.txt,380602,382155,1553,10,N,Y,1435574979068,381547,381864
TWOMEN.txt,382157,383075,918,10,N,N,-,-1,-1
TWOMEN.txt,383076,383726,650,10,N,N,-,-1,-1
TWOMEN.txt,383728,385183,1455,10,N,N,-,-1,-1
TWOMEN.txt,385184,385865,681,10,N,N,-,-1,-1
TWOMEN.txt,385867,386537,670,10,N,N,-,-1,-1
TWOMEN.txt,386539,387611,1072,10,N,N,-,-1,-1
TWOMEN.txt,387616,388750,1134,10,N,N,-,-1,-1
TWOMEN.txt,388751,389792,1041,10,N,N,-,-1,-1
TWOMEN.txt,389793,391048,1255,10,N,N,-,-1,-1
TWOMEN.txt,391051,391839,788,10,N,N,-,-1,-1
TWOMEN.txt,391840,392829,989,10,N,N,-,-1,-1
TWOMEN.txt,392830,393527,697,10,N,N,-,-1,-1
TWOMEN.txt,393527,394120,593,10,N,N,-,-1,-1
TWOMEN.txt,394121,394643,522,10,N,N,-,-1,-1
TWOMEN.txt,394645,395401,756,10,N,N,-,-1,-1
TWOMEN.txt,395402,396467,1065,10,N,N,-,-1,-1
TWOMEN.txt,396468,397657,1189,10,N,N,-,-1,-1
TWOMEN.txt,397658,398489,831,10,N,N,-,-1,-1
TWOMEN.txt,398490,398946,456,10,N,N,-,-1,-1
TWOMEN.txt,398946,399616,670,10,N,N,-,-1,-1
TWOMEN.txt,399617,400395,778,10,N,N,-,-1,-1
TWOMEN.txt,400397,401360,963,10,N,N,-,-1,-1
TWOMEN.txt,401361,402352,991,10,N,N,-,-1,-1
TWOMEN.txt,402354,403634,1280,10,N,N,-,-1,-1
TWOMEN.txt,403635,404535,900,10,N,N,-,-1,-1
TWOMEN.txt,404536,405576,1040,10,N,N,-,-1,-1
TWOMEN.txt,405577,406974,1397,10,N,N,-,-1,-1
TWOMEN.txt,406975,407676,701,10,N,N,-,-1,-1
TWOMEN.txt,407677,408550,873,10,N,N,-,-1,-1
TWOMEN.txt,408552,409241,689,10,N,N,-,-1,-1
TWOMEN.txt,409243,410059,816,10,N,N,-,-1,-1
TWOMEN.txt,410062,410407,345,10,N,N,-,-1,-1
TWOMEN.txt,410410,410966,556,10,N,N,-,-1,-1
TWOMEN.txt,410967,411380,413,10,N,N,-,-1,-1
TWOMEN.txt,411381,412864,1483,10,N,N,-,-1,-1
TWOMEN.txt,412867,415102,2235,10,N,N,-,-1,-1
TWOMEN.txt,415104,415645,541,10,N,N,-,-1,-1
TWOMEN.txt,415646,416338,692,10,N,N,-,-1,-1
TWOMEN.txt,416343,417447,1104,10,N,N,-,-1,-1
TWOMEN.txt,417448,417952,504,10,N,N,-,-1,-1
TWOMEN.txt,417954,418773,819,10,N,N,-,-1,-1
TWOMEN.txt,418775,419756,981,10,N,N,-,-1,-1
TWOMEN.txt,419758,420995,1237,10,N,N,-,-1,-1
TWOMEN.txt,420997,421859,862,10,N,N,-,-1,-1
TWOMEN.txt,421862,423103,1241,10,N,N,-,-1,-1
TWOMEN.txt,423104,424170,1066,10,N,N,-,-1,-1
TWOMEN.txt,424171,425463,1292,10,N,N,-,-1,-1
TWOMEN.txt,425464,426856,1392,10,N,N,-,-1,-1
TWOMEN.txt,426858,427658,800,10,N,N,-,-1,-1
TWOMEN.txt,427659,428923,1264,10,N,N,-,-1,-1
TWOMEN.txt,428924,429709,785,10,N,N,-,-1,-1
TWOMEN.txt,429710,431363,1653,10,N,N,-,-1,-1
TWOMEN.txt,431364,432271,907,10,N,N,-,-1,-1
TWOMEN.txt,432272,433830,1558,10,N,N,-,-1,-1
TWOMEN.txt,433831,435150,1319,10,N,N,-,-1,-1
TWOMEN.txt,435151,436066,915,10,N,N,-,-1,-1
TWOMEN.txt,436067,437333,1266,10,N,N,-,-1,-1
TWOMEN.txt,437334,438215,881,10,N,N,-,-1,-1
TWOMEN.txt,438216,439897,1681,10,N,N,-,-1,-1
TWOMEN.txt,439898,440737,839,10,N,N,-,-1,-1
TWOMEN.txt,440738,441841,1103,10,N,N,-,-1,-1
TWOMEN.txt,441842,443339,1497,10,N,N,-,-1,-1
TWOMEN.txt,443340,444316,976,10,N,Y,1435577123675,444026,444632
TWOMEN.txt,444317,445473,1156,10,N,Y,1435577123675,444026,444632
TWOMEN.txt,445474,446077,603,10,N,N,-,-1,-1
TWOMEN.txt,446078,446996,918,10,N,N,-,-1,-1
TWOMEN.txt,446998,447705,707,10,N,N,-,-1,-1
TWOMEN.txt,447707,448962,1255,10,N,N,-,-1,-1
TWOMEN.txt,448965,450112,1147,10,N,N,-,-1,-1
TWOMEN.txt,450114,451063,949,10,N,N,-,-1,-1
TWOMEN.txt,451066,451848,782,10,N,N,-,-1,-1
TWOMEN.txt,451848,452242,394,10,N,N,-,-1,-1
TWOMEN.txt,452242,453345,1103,10,N,N,-,-1,-1
TWOMEN.txt,453347,454801,1454,10,N,N,-,-1,-1
TWOMEN.txt,454802,455346,544,10,N,N,-,-1,-1
TWOMEN.txt,455347,456316,969,10,N,N,-,-1,-1
TWOMEN.txt,456317,457418,1101,10,N,N,-,-1,-1
TWOMEN.txt,457419,457899,480,10,N,N,-,-1,-1
TWOMEN.txt,457901,459186,1285,10,N,N,-,-1,-1
TWOMEN.txt,459187,460805,1618,10,N,N,-,-1,-1
TWOMEN.txt,460806,462086,1280,10,N,N,-,-1,-1
TWOMEN.txt,462087,463213,1126,10,N,N,-,-1,-1
TWOMEN.txt,463214,464442,1228,10,N,N,-,-1,-1
TWOMEN.txt,464443,465694,1251,10,N,N,-,-1,-1
TWOMEN.txt,465695,466564,869,10,N,N,-,-1,-1
TWOMEN.txt,466565,468169,1604,10,N,N,-,-1,-1
TWOMEN.txt,468171,469356,1185,10,N,N,-,-1,-1
TWOMEN.txt,469357,470005,648,10,N,N,-,-1,-1
TWOMEN.txt,470005,470515,510,10,N,N,-,-1,-1
TWOMEN.txt,470516,472296,1780,10,N,N,-,-1,-1
TWOMEN.txt,472297,474017,1720,10,N,N,-,-1,-1
TWOMEN.txt,474017,475105,1088,10,N,N,-,-1,-1
TWOMEN.txt,475106,476567,1461,10,N,N,-,-1,-1
TWOMEN.txt,476569,478088,1519,10,N,N,-,-1,-1
TWOMEN.txt,478089,478526,437,10,N,N,-,-1,-1
TWOMEN.txt,478527,478983,456,10,N,N,-,-1,-1
TWOMEN.txt,478984,479945,961,10,N,N,-,-1,-1
TWOMEN.txt,479947,480908,961,10,N,N,-,-1,-1
TWOMEN.txt,480911,481736,825,10,N,N,-,-1,-1
TWOMEN.txt,481736,482490,754,10,N,N,-,-1,-1
TWOMEN.txt,482490,483441,951,10,N,N,-,-1,-1
TWOMEN.txt,483442,484530,1088,10,N,N,-,-1,-1
TWOMEN.txt,484531,485365,834,10,N,N,-,-1,-1
TWOMEN.txt,485366,486757,1391,10,N,N,-,-1,-1
TWOMEN.txt,486758,488249,1491,10,N,N,-,-1,-1
TWOMEN.txt,488254,489325,1071,10,N,N,-,-1,-1
TWOMEN.txt,489326,490280,954,10,N,N,-,-1,-1
TWOMEN.txt,490281,492132,1851,10,N,N,-,-1,-1
TWOMEN.txt,492133,493702,1569,10,N,N,-,-1,-1
WESLEY.txt,1,3981,3980,10,N,N,-,-1,-1
WESLEY.txt,3982,9161,5179,10,N,N,-,-1,-1
WESLEY.txt,9162,14013,4851,10,N,N,-,-1,-1
WESLEY.txt,14014,15087,1073,10,N,N,-,-1,-1
WESLEY.txt,15088,16895,1807,10,N,N,-,-1,-1
WESLEY.txt,16896,18249,1353,10,N,N,-,-1,-1
WESLEY.txt,18250,19695,1445,10,N,N,-,-1,-1
WESLEY.txt,19696,20832,1136,10,N,N,-,-1,-1
WESLEY.txt,20833,22037,1204,10,N,N,-,-1,-1
WESLEY.txt,22038,23027,989,10,N,N,-,-1,-1
WESLEY.txt,23028,24691,1663,10,N,N,-,-1,-1
WESLEY.txt,24692,26608,1916,10,N,N,-,-1,-1
WESLEY.txt,26609,28627,2018,10,N,N,-,-1,-1
WESLEY.txt,28628,29636,1008,10,N,N,-,-1,-1
WESLEY.txt,29637,30892,1255,10,N,N,-,-1,-1
WESLEY.txt,30893,32192,1299,10,N,N,-,-1,-1
WESLEY.txt,32193,33516,1323,10,N,N,-,-1,-1
WESLEY.txt,33517,35212,1695,10,N,N,-,-1,-1
WESLEY.txt,35213,36269,1056,10,N,N,-,-1,-1
WESLEY.txt,36270,37810,1540,10,N,N,-,-1,-1
WESLEY.txt,37811,38778,967,10,N,N,-,-1,-1
WESLEY.txt,38779,40591,1812,10,N,N,-,-1,-1
WESLEY.txt,40592,41696,1104,10,N,N,-,-1,-1
WESLEY.txt,41697,42938,1241,10,N,N,-,-1,-1
WESLEY.txt,42939,44248,1309,10,N,N,-,-1,-1
WESLEY.txt,44249,45312,1063,10,N,N,-,-1,-1
WESLEY.txt,45314,46761,1447,10,N,N,-,-1,-1
WESLEY.txt,46762,47975,1213,10,N,N,-,-1,-1
WESLEY.txt,47976,49191,1215,10,N,N,-,-1,-1
WESLEY.txt,49192,50588,1396,10,N,N,-,-1,-1
WESLEY.txt,50589,51967,1378,10,N,N,-,-1,-1
WESLEY.txt,51968,52903,935,10,N,N,-,-1,-1
WESLEY.txt,52904,53824,920,10,N,N,-,-1,-1
WESLEY.txt,53825,55157,1332,10,N,N,-,-1,-1
WESLEY.txt,55158,56800,1642,10,N,N,-,-1,-1
WESLEY.txt,56801,58189,1388,10,N,N,-,-1,-1
WESLEY.txt,58190,60689,2499,10,N,N,-,-1,-1
WESLEY.txt,60690,61808,1118,10,N,N,-,-1,-1
WESLEY.txt,61809,62420,611,10,N,N,-,-1,-1
WESLEY.txt,62421,63529,1108,10,N,N,-,-1,-1
WESLEY.txt,63530,64185,655,10,N,N,-,-1,-1
WESLEY.txt,64186,64994,808,10,N,N,-,-1,-1
WESLEY.txt,64994,65827,833,10,N,N,-,-1,-1
WESLEY.txt,65828,66495,667,10,N,N,-,-1,-1
WESLEY.txt,66496,67586,1090,10,N,N,-,-1,-1
WESLEY.txt,67587,68186,599,10,N,N,-,-1,-1
WESLEY.txt,68187,68901,714,10,N,N,-,-1,-1
WESLEY.txt,68902,69538,636,10,N,N,-,-1,-1
WESLEY.txt,69540,70209,669,10,N,N,-,-1,-1
WESLEY.txt,70210,71025,815,10,N,N,-,-1,-1
WESLEY.txt,71026,72709,1683,10,N,N,-,-1,-1
WESLEY.txt,72710,74225,1515,10,N,N,-,-1,-1
WESLEY.txt,74226,75028,802,10,N,N,-,-1,-1
WESLEY.txt,75029,75919,890,10,N,N,-,-1,-1
WESLEY.txt,75920,76459,539,10,N,N,-,-1,-1
WESLEY.txt,76461,77302,841,10,N,N,-,-1,-1
WESLEY.txt,77303,78439,1136,10,N,N,-,-1,-1
WESLEY.txt,78440,79751,1311,10,N,N,-,-1,-1
WESLEY.txt,79752,81194,1442,10,N,N,-,-1,-1
WESLEY.txt,81195,82710,1515,10,N,N,-,-1,-1
WESLEY.txt,82711,83562,851,10,N,N,-,-1,-1
WESLEY.txt,83562,85161,1599,10,N,N,-,-1,-1
WESLEY.txt,85162,85934,772,10,N,N,-,-1,-1
WESLEY.txt,85935,86823,888,10,N,N,-,-1,-1
WESLEY.txt,86824,87676,852,10,N,N,-,-1,-1
WESLEY.txt,87677,88937,1260,10,N,N,-,-1,-1
WESLEY.txt,88938,90542,1604,10,N,N,-,-1,-1
WESLEY.txt,90543,91167,624,10,N,N,-,-1,-1
WESLEY.txt,91168,91600,432,10,N,N,-,-1,-1
WESLEY.txt,91601,92803,1202,10,N,N,-,-1,-1
WESLEY.txt,92804,94503,1699,10,N,N,-,-1,-1
WESLEY.txt,94504,95503,999,10,N,N,-,-1,-1
WESLEY.txt,95504,96401,897,10,N,N,-,-1,-1
WESLEY.txt,96402,98151,1749,10,N,N,-,-1,-1
WESLEY.txt,98152,99485,1333,10,N,N,-,-1,-1
WESLEY.txt,99486,100786,1300,10,N,N,-,-1,-1
WESLEY.txt,100787,101744,957,10,N,N,-,-1,-1
WESLEY.txt,101745,102423,678,10,N,N,-,-1,-1
WESLEY.txt,102424,103339,915,10,N,N,-,-1,-1
WESLEY.txt,103340,104277,937,10,N,N,-,-1,-1
WESLEY.txt,104278,105184,906,10,N,N,-,-1,-1
WESLEY.txt,105185,105570,385,10,N,N,-,-1,-1
WESLEY.txt,105571,107201,1630,10,N,N,-,-1,-1
WESLEY.txt,107202,108287,1085,10,N,N,-,-1,-1
WESLEY.txt,108288,109239,951,10,N,N,-,-1,-1
WESLEY.txt,109240,110118,878,10,N,N,-,-1,-1
WESLEY.txt,110120,110895,775,10,N,N,-,-1,-1
WESLEY.txt,110895,111624,729,10,N,N,-,-1,-1
WESLEY.txt,111625,112478,853,10,N,N,-,-1,-1
WESLEY.txt,112478,113517,1039,10,N,N,-,-1,-1
WESLEY.txt,113518,114354,836,10,N,N,-,-1,-1
WESLEY.txt,114355,115129,774,10,N,N,-,-1,-1
WESLEY.txt,115130,115759,629,10,N,N,-,-1,-1
WESLEY.txt,115760,116930,1170,10,N,N,-,-1,-1
WESLEY.txt,116931,118432,1501,10,N,N,-,-1,-1
WESLEY.txt,118433,119305,872,10,N,N,-,-1,-1
WESLEY.txt,119306,120470,1164,10,N,N,-,-1,-1
WESLEY.txt,120471,121674,1203,10,N,N,-,-1,-1
WESLEY.txt,121675,122711,1036,10,N,N,-,-1,-1
WESLEY.txt,122712,123770,1058,10,N,N,-,-1,-1
WESLEY.txt,123771,125280,1509,10,N,N,-,-1,-1
WESLEY.txt,125281,126000,719,10,N,N,-,-1,-1
WESLEY.txt,126001,126822,821,10,N,N,-,-1,-1
WESLEY.txt,126823,127652,829,10,N,N,-,-1,-1
WESLEY.txt,127653,128758,1105,10,N,N,-,-1,-1
WESLEY.txt,128759,129980,1221,10,N,N,-,-1,-1
WESLEY.txt,129981,130839,858,10,N,N,-,-1,-1
WESLEY.txt,130840,131906,1066,10,N,N,-,-1,-1
WESLEY.txt,131907,132752,845,10,N,N,-,-1,-1
WESLEY.txt,132753,133498,745,10,N,N,-,-1,-1
WESLEY.txt,133498,134600,1102,10,N,N,-,-1,-1
WESLEY.txt,134601,136010,1409,10,N,N,-,-1,-1
WESLEY.txt,136010,137005,995,10,N,N,-,-1,-1
WESLEY.txt,137006,138501,1495,10,N,N,-,-1,-1
WESLEY.txt,138502,140458,1956,10,N,N,-,-1,-1
WESLEY.txt,140459,141771,1312,10,N,N,-,-1,-1
WESLEY.txt,141772,143507,1735,10,N,N,-,-1,-1
WESLEY.txt,143508,144834,1326,10,N,N,-,-1,-1
WESLEY.txt,144835,145430,595,10,N,N,-,-1,-1
WESLEY.txt,145431,146402,971,10,N,N,-,-1,-1
WESLEY.txt,146403,147573,1170,10,N,N,-,-1,-1
WESLEY.txt,147574,149158,1584,10,N,N,-,-1,-1
WESLEY.txt,149159,150302,1143,10,N,N,-,-1,-1
WESLEY.txt,150303,151729,1426,10,N,N,-,-1,-1
WESLEY.txt,151730,152893,1163,10,N,N,-,-1,-1
WESLEY.txt,152894,153526,632,10,N,N,-,-1,-1
WESLEY.txt,153526,154854,1328,10,N,N,-,-1,-1
WESLEY.txt,154855,155529,674,10,N,N,-,-1,-1
WESLEY.txt,155530,156724,1194,10,N,N,-,-1,-1
WESLEY.txt,156725,157851,1126,10,N,N,-,-1,-1
WESLEY.txt,157852,159332,1480,10,N,N,-,-1,-1
WESLEY.txt,159333,160357,1024,10,N,N,-,-1,-1
WESLEY.txt,160358,161281,923,10,N,N,-,-1,-1
WESLEY.txt,161282,162320,1038,10,N,N,-,-1,-1
WESLEY.txt,162321,163854,1533,10,N,N,-,-1,-1
WESLEY.txt,163855,164751,896,10,N,N,-,-1,-1
WESLEY.txt,164752,165400,648,10,N,N,-,-1,-1
WESLEY.txt,165401,165998,597,10,N,N,-,-1,-1
WESLEY.txt,165999,166220,221,10,N,N,-,-1,-1
WESLEY.txt,166221,166623,402,10,N,N,-,-1,-1
WESLEY.txt,166624,166976,352,10,N,N,-,-1,-1
WESLEY.txt,166977,167870,893,10,N,N,-,-1,-1
WESLEY.txt,167871,168597,726,10,N,N,-,-1,-1
WESLEY.txt,168598,169553,955,10,N,N,-,-1,-1
WESLEY.txt,169554,170171,617,10,N,N,-,-1,-1
WESLEY.txt,170172,171097,925,10,N,N,-,-1,-1
WESLEY.txt,171098,171829,731,10,N,N,-,-1,-1
WESLEY.txt,171830,173347,1517,10,N,N,-,-1,-1
WESLEY.txt,173348,174440,1092,10,N,N,-,-1,-1
WESLEY.txt,174441,175534,1093,10,N,N,-,-1,-1
WESLEY.txt,175535,176389,854,10,N,N,-,-1,-1
WESLEY.txt,176389,177553,1164,10,N,N,-,-1,-1
WESLEY.txt,177554,178691,1137,10,N,N,-,-1,-1
WESLEY.txt,178691,179741,1050,10,N,N,-,-1,-1
WESLEY.txt,179742,180514,772,10,N,N,-,-1,-1
WESLEY.txt,180515,181418,903,10,N,N,-,-1,-1
WESLEY.txt,181419,182632,1213,10,N,N,-,-1,-1
WESLEY.txt,182633,183603,970,10,N,N,-,-1,-1
WESLEY.txt,183604,184485,881,10,N,N,-,-1,-1
WESLEY.txt,184486,185486,1000,10,N,N,-,-1,-1
WESLEY.txt,185487,186487,1000,10,N,N,-,-1,-1
WESLEY.txt,186488,187356,868,10,N,N,-,-1,-1
WESLEY.txt,187357,188474,1117,10,N,N,-,-1,-1
WESLEY.txt,188475,189683,1208,10,N,N,-,-1,-1
WESLEY.txt,189683,190471,788,10,N,N,-,-1,-1
WESLEY.txt,190472,191326,854,10,N,N,-,-1,-1
WESLEY.txt,191327,192392,1065,10,N,N,-,-1,-1
WESLEY.txt,192393,193582,1189,10,N,N,-,-1,-1
WESLEY.txt,193583,195114,1531,10,N,N,-,-1,-1
WESLEY.txt,195114,196631,1517,10,N,N,-,-1,-1
WESLEY.txt,196631,197730,1099,10,N,N,-,-1,-1
WESLEY.txt,197731,198633,902,10,N,N,-,-1,-1
WESLEY.txt,198634,199744,1110,10,N,N,-,-1,-1
WESLEY.txt,199745,200927,1182,10,N,N,-,-1,-1
WESLEY.txt,200928,201948,1020,10,N,N,-,-1,-1
WESLEY.txt,201949,202536,587,10,N,N,-,-1,-1
WESLEY.txt,202537,203827,1290,10,N,N,-,-1,-1
WESLEY.txt,203828,204687,859,10,N,N,-,-1,-1
WESLEY.txt,204688,205833,1145,10,N,N,-,-1,-1
WESLEY.txt,205834,206831,997,10,N,N,-,-1,-1
WESLEY.txt,206832,208272,1440,10,N,N,-,-1,-1
WESLEY.txt,208273,210331,2058,10,N,N,-,-1,-1
WESLEY.txt,210332,211680,1348,10,N,N,-,-1,-1
WESLEY.txt,211681,212620,939,10,N,N,-,-1,-1
WESLEY.txt,212621,213355,734,10,N,N,-,-1,-1
WESLEY.txt,213356,215281,1925,10,N,N,-,-1,-1
WESLEY.txt,215282,216978,1696,10,N,N,-,-1,-1
WESLEY.txt,216979,218794,1815,10,N,N,-,-1,-1
WESLEY.txt,218795,220556,1761,10,N,N,-,-1,-1
WESLEY.txt,220557,222446,1889,10,N,N,-,-1,-1
WESLEY.txt,222447,224077,1630,10,N,N,-,-1,-1
WESLEY.txt,224078,225886,1808,10,N,N,-,-1,-1
WESLEY.txt,225887,226908,1021,10,N,N,-,-1,-1
WESLEY.txt,226909,228294,1385,10,N,N,-,-1,-1
WESLEY.txt,228295,229419,1124,10,N,N,-,-1,-1
WESLEY.txt,229419,230284,865,10,N,N,-,-1,-1
WESLEY.txt,230285,231278,993,10,N,N,-,-1,-1
WESLEY.txt,231279,232061,782,10,N,N,-,-1,-1
WESLEY.txt,232062,232577,515,10,N,N,-,-1,-1
WESLEY.txt,232578,233381,803,10,N,N,-,-1,-1
WESLEY.txt,233382,234484,1102,10,N,N,-,-1,-1
WESLEY.txt,234484,235558,1074,10,N,N,-,-1,-1
WESLEY.txt,235560,236814,1254,10,N,N,-,-1,-1
WESLEY.txt,236815,237661,846,10,N,N,-,-1,-1
WESLEY.txt,237662,238827,1165,10,N,N,-,-1,-1
WESLEY.txt,238828,239610,782,10,N,N,-,-1,-1
WESLEY.txt,239611,241042,1431,10,N,N,-,-1,-1
WESLEY.txt,241043,241643,600,10,N,N,-,-1,-1
WESLEY.txt,241644,242374,730,10,N,Y,1432378713402,242169,242662
WESLEY.txt,242375,243752,1377,10,N,Y,1432378713402,242169,242662
WESLEY.txt,243753,244671,918,10,N,N,-,-1,-1
WESLEY.txt,244672,245576,904,10,N,N,-,-1,-1
WESLEY.txt,245577,246506,929,10,N,Y,1432379217690,245991,246965
WESLEY.txt,246507,248018,1511,10,N,Y,1432379217690,245991,246965
WESLEY.txt,248019,249138,1119,10,N,N,-,-1,-1
WESLEY.txt,249140,249897,757,10,N,N,-,-1,-1
WESLEY.txt,249898,250826,928,10,N,N,-,-1,-1
WESLEY.txt,250827,251703,876,10,N,N,-,-1,-1
WESLEY.txt,251704,252577,873,10,N,N,-,-1,-1
WESLEY.txt,252578,253217,639,10,N,N,-,-1,-1
WESLEY.txt,253218,254426,1208,10,N,N,-,-1,-1
WESLEY.txt,254427,255163,736,10,N,N,-,-1,-1
WESLEY.txt,255164,256644,1480,10,N,N,-,-1,-1
WESLEY.txt,256645,257988,1343,10,N,N,-,-1,-1
WESLEY.txt,257989,259244,1255,10,N,N,-,-1,-1
WESLEY.txt,259245,260594,1349,10,N,N,-,-1,-1
WESLEY.txt,260595,261318,723,10,N,N,-,-1,-1
WESLEY.txt,261319,263579,2260,10,N,N,-,-1,-1
WESLEY.txt,263580,264665,1085,10,N,N,-,-1,-1
WESLEY.txt,264665,265949,1284,10,N,N,-,-1,-1
WESLEY.txt,265950,267007,1057,10,N,N,-,-1,-1
WESLEY.txt,267008,267766,758,10,N,N,-,-1,-1
WESLEY.txt,267766,268556,790,10,N,N,-,-1,-1
WESLEY.txt,268557,269557,1000,10,N,N,-,-1,-1
WESLEY.txt,269558,270502,944,10,N,N,-,-1,-1
WESLEY.txt,270503,271861,1358,10,N,N,-,-1,-1
WESLEY.txt,271862,273187,1325,10,N,N,-,-1,-1
WESLEY.txt,273188,273960,772,10,N,N,-,-1,-1
WESLEY.txt,273961,274698,737,10,N,N,-,-1,-1
WESLEY.txt,274699,275547,848,10,N,N,-,-1,-1
WESLEY.txt,275547,276724,1177,10,N,N,-,-1,-1
WESLEY.txt,276726,277718,992,10,N,N,-,-1,-1
WESLEY.txt,277719,278419,700,10,N,N,-,-1,-1
WESLEY.txt,278420,279089,669,10,N,N,-,-1,-1
WESLEY.txt,279090,279885,795,10,N,N,-,-1,-1
WESLEY.txt,279886,281187,1301,10,N,N,-,-1,-1
WESLEY.txt,281188,281820,632,10,N,N,-,-1,-1
WESLEY.txt,281821,282498,677,10,N,N,-,-1,-1
WESLEY.txt,282499,283182,683,10,N,N,-,-1,-1
WESLEY.txt,283183,283898,715,10,N,N,-,-1,-1
WESLEY.txt,283899,284673,774,10,N,N,-,-1,-1
WESLEY.txt,284674,286173,1499,10,N,N,-,-1,-1
WESLEY.txt,286174,287273,1099,10,N,N,-,-1,-1
WESLEY.txt,287274,288511,1237,10,N,N,-,-1,-1
WESLEY.txt,288511,289249,738,10,N,N,-,-1,-1
WESLEY.txt,289250,290178,928,10,N,N,-,-1,-1
WESLEY.txt,290178,290968,790,10,N,N,-,-1,-1
WESLEY.txt,290969,291771,802,10,N,N,-,-1,-1
WESLEY.txt,291772,292777,1005,10,N,N,-,-1,-1
WESLEY.txt,292778,294041,1263,10,N,N,-,-1,-1
WESLEY.txt,294042,294863,821,10,N,N,-,-1,-1
WESLEY.txt,294864,296054,1190,10,N,N,-,-1,-1
WESLEY.txt,296055,297062,1007,10,N,N,-,-1,-1
WESLEY.txt,297063,298550,1487,10,N,N,-,-1,-1
WESLEY.txt,298551,299880,1329,10,N,N,-,-1,-1
WESLEY.txt,299881,300974,1093,10,N,N,-,-1,-1
WESLEY.txt,300975,302144,1169,10,N,N,-,-1,-1
WESLEY.txt,302145,303220,1075,10,N,N,-,-1,-1
WESLEY.txt,303221,303944,723,10,N,N,-,-1,-1
WESLEY.txt,303945,304754,809,10,N,N,-,-1,-1
WESLEY.txt,304755,305670,915,10,N,N,-,-1,-1
WESLEY.txt,305671,306451,780,10,N,N,-,-1,-1
WESLEY.txt,306452,307392,940,10,N,N,-,-1,-1
WESLEY.txt,307393,308406,1013,10,N,N,-,-1,-1
WESLEY.txt,308406,309311,905,10,N,N,-,-1,-1
WESLEY.txt,309311,310197,886,10,N,N,-,-1,-1
WESLEY.txt,310197,310870,673,10,N,N,-,-1,-1
WESLEY.txt,310871,311969,1098,10,N,N,-,-1,-1
WESLEY.txt,311970,312860,890,10,N,N,-,-1,-1
WESLEY.txt,312861,313725,864,10,N,N,-,-1,-1
WESLEY.txt,313725,314391,666,10,N,N,-,-1,-1
WESLEY.txt,314392,315181,789,10,N,N,-,-1,-1
WESLEY.txt,315183,316233,1050,10,N,Y,1433324150625,315900,316317
WESLEY.txt,316234,317389,1155,10,N,Y,1433324150625,315900,316317
WESLEY.txt,317390,318326,936,10,N,N,-,-1,-1
WESLEY.txt,318326,319210,884,10,N,N,-,-1,-1
WESLEY.txt,319211,320824,1613,10,N,N,-,-1,-1
WESLEY.txt,320825,321509,684,10,N,N,-,-1,-1
WESLEY.txt,321510,322461,951,10,N,N,-,-1,-1
WESLEY.txt,322462,323285,823,10,N,N,-,-1,-1
WESLEY.txt,323285,324508,1223,10,N,N,-,-1,-1
WESLEY.txt,324509,325406,897,10,N,N,-,-1,-1
WESLEY.txt,325407,326372,965,10,N,N,-,-1,-1
WESLEY.txt,326373,327103,730,10,N,N,-,-1,-1
WESLEY.txt,327104,328122,1018,10,N,N,-,-1,-1
WESLEY.txt,328123,328800,677,10,N,N,-,-1,-1
WESLEY.txt,328800,329712,912,10,N,N,-,-1,-1
WESLEY.txt,329713,330388,675,10,N,N,-,-1,-1
WESLEY.txt,330389,332197,1808,10,N,N,-,-1,-1
WESLEY.txt,332198,334000,1802,10,N,N,-,-1,-1
WESLEY.txt,334001,335102,1101,10,N,N,-,-1,-1
WESLEY.txt,335103,336166,1063,10,N,N,-,-1,-1
WESLEY.txt,336167,337417,1250,10,N,N,-,-1,-1
WESLEY.txt,337418,338424,1006,10,N,N,-,-1,-1
WESLEY.txt,338425,339274,849,10,N,N,-,-1,-1
WESLEY.txt,339275,340027,752,10,N,N,-,-1,-1
WESLEY.txt,340027,340877,850,10,N,N,-,-1,-1
WESLEY.txt,340878,341370,492,10,N,N,-,-1,-1
WESLEY.txt,341371,342243,872,10,N,N,-,-1,-1
WESLEY.txt,342244,343265,1021,10,N,N,-,-1,-1
WESLEY.txt,343267,344287,1020,10,N,N,-,-1,-1
WESLEY.txt,344288,344911,623,10,N,N,-,-1,-1
WESLEY.txt,344912,345695,783,10,N,N,-,-1,-1
WESLEY.txt,345695,346491,796,10,N,N,-,-1,-1
WESLEY.txt,346492,347434,942,10,N,N,-,-1,-1
WESLEY.txt,347435,348719,1284,10,N,N,-,-1,-1
WESLEY.txt,348720,349400,680,10,N,N,-,-1,-1
WESLEY.txt,349401,350331,930,10,N,N,-,-1,-1
WESLEY.txt,350332,351461,1129,10,N,N,-,-1,-1
WESLEY.txt,351462,352259,797,10,N,N,-,-1,-1
WESLEY.txt,352260,353043,783,10,N,N,-,-1,-1
WESLEY.txt,353044,354194,1150,10,N,N,-,-1,-1
WESLEY.txt,354195,355177,982,10,N,N,-,-1,-1
WESLEY.txt,355178,356047,869,10,N,N,-,-1,-1
WESLEY.txt,356048,357083,1035,10,N,N,-,-1,-1
WESLEY.txt,357084,357990,906,10,N,N,-,-1,-1
WESLEY.txt,357990,358960,970,10,N,N,-,-1,-1
WESLEY.txt,358961,359782,821,10,N,N,-,-1,-1
WESLEY.txt,359782,360869,1087,10,N,N,-,-1,-1
WESLEY.txt,360870,362021,1151,10,N,N,-,-1,-1
WESLEY.txt,362022,363123,1101,10,N,N,-,-1,-1
WESLEY.txt,363124,364161,1037,10,N,N,-,-1,-1
WESLEY.txt,364162,364862,700,10,N,N,-,-1,-1
WESLEY.txt,364863,365970,1107,10,N,N,-,-1,-1
WESLEY.txt,365971,366497,526,10,N,N,-,-1,-1
WESLEY.txt,366498,367532,1034,10,N,Y,1435058414135,367148,369648
WESLEY.txt,367534,368279,745,10,N,Y,1435058414135,367148,369648
WESLEY.txt,368280,369982,1702,10,N,Y,1435058414135,367148,369648
WESLEY.txt,369983,371039,1056,10,N,N,-,-1,-1
WESLEY.txt,371040,372272,1232,10,N,N,-,-1,-1
WESLEY.txt,372273,373275,1002,10,N,N,-,-1,-1
WESLEY.txt,373275,374178,903,10,N,N,-,-1,-1
WESLEY.txt,374179,375399,1220,10,N,N,-,-1,-1
WESLEY.txt,375400,376293,893,10,N,N,-,-1,-1
WESLEY.txt,376294,377350,1056,10,N,N,-,-1,-1
WESLEY.txt,377351,378372,1021,10,N,N,-,-1,-1
WESLEY.txt,378373,379202,829,10,N,N,-,-1,-1
WESLEY.txt,379203,380256,1053,10,N,N,-,-1,-1
WESLEY.txt,380257,380783,526,10,N,N,-,-1,-1
WESLEY.txt,380784,381665,881,10,N,N,-,-1,-1
WESLEY.txt,381666,382234,568,10,N,N,-,-1,-1
WESLEY.txt,382235,382986,751,10,N,N,-,-1,-1
WESLEY.txt,382986,383745,759,10,N,N,-,-1,-1
WESLEY.txt,383746,384516,770,10,N,N,-,-1,-1
WESLEY.txt,384517,385697,1180,10,N,N,-,-1,-1
WESLEY.txt,385699,386503,804,10,N,N,-,-1,-1
WESLEY.txt,386504,387630,1126,10,N,N,-,-1,-1
WESLEY.txt,387631,388703,1072,10,N,N,-,-1,-1
WESLEY.txt,388704,389583,879,10,N,N,-,-1,-1
WESLEY.txt,389584,390521,937,10,N,N,-,-1,-1
WESLEY.txt,390522,391339,817,10,N,N,-,-1,-1
WESLEY.txt,391340,392339,999,10,N,N,-,-1,-1
WESLEY.txt,392340,393607,1267,10,N,N,-,-1,-1
WESLEY.txt,393608,394300,692,10,N,N,-,-1,-1
WESLEY.txt,394300,395314,1014,10,N,N,-,-1,-1
WESLEY.txt,395315,396579,1264,10,N,N,-,-1,-1
WESLEY.txt,396580,397436,856,10,N,N,-,-1,-1
WESLEY.txt,397437,398305,868,10,N,N,-,-1,-1
WESLEY.txt,398306,399582,1276,10,N,N,-,-1,-1
WESLEY.txt,399583,400248,665,10,N,N,-,-1,-1
WESLEY.txt,400249,401405,1156,10,N,N,-,-1,-1
WESLEY.txt,401406,402125,719,10,N,N,-,-1,-1
WESLEY.txt,402126,402810,684,10,N,N,-,-1,-1
WESLEY.txt,402811,403598,787,10,N,N,-,-1,-1
WESLEY.txt,403599,404591,992,10,N,N,-,-1,-1
WESLEY.txt,404592,405437,845,10,N,N,-,-1,-1
WESLEY.txt,405438,406347,909,10,N,N,-,-1,-1
WESLEY.txt,406348,407127,779,10,N,N,-,-1,-1
WESLEY.txt,407129,408456,1327,10,N,N,-,-1,-1
WESLEY.txt,408457,409309,852,10,N,N,-,-1,-1
WESLEY.txt,409309,410094,785,10,N,N,-,-1,-1
WESLEY.txt,410094,411272,1178,10,N,N,-,-1,-1
WESLEY.txt,411273,412381,1108,10,N,N,-,-1,-1
WESLEY.txt,412381,413654,1273,10,N,N,-,-1,-1
WESLEY.txt,413655,414663,1008,10,N,N,-,-1,-1
WESLEY.txt,414664,415436,772,10,N,N,-,-1,-1
WESLEY.txt,415437,416770,1333,10,N,N,-,-1,-1
WESLEY.txt,416771,417817,1046,10,N,N,-,-1,-1
WESLEY.txt,417818,419124,1306,10,N,N,-,-1,-1
WESLEY.txt,419125,420030,905,10,N,N,-,-1,-1
WESLEY.txt,420031,420936,905,10,N,N,-,-1,-1
WESLEY.txt,420936,421663,727,10,N,N,-,-1,-1
WESLEY.txt,421664,422501,837,10,N,N,-,-1,-1
WESLEY.txt,422501,423498,997,10,N,N,-,-1,-1
WESLEY.txt,423499,424302,803,10,N,N,-,-1,-1
WESLEY.txt,424303,424898,595,10,N,N,-,-1,-1
WESLEY.txt,424899,425766,867,10,N,N,-,-1,-1
WESLEY.txt,425767,426851,1084,10,N,N,-,-1,-1
WESLEY.txt,426852,427575,723,10,N,N,-,-1,-1
WESLEY.txt,427576,428111,535,10,N,N,-,-1,-1
WESLEY.txt,428112,428938,826,10,N,N,-,-1,-1
WESLEY.txt,428939,429686,747,10,N,N,-,-1,-1
WESLEY.txt,429687,430664,977,10,N,N,-,-1,-1
WESLEY.txt,430665,432024,1359,10,N,N,-,-1,-1
WESLEY.txt,432025,432882,857,10,N,N,-,-1,-1
WESLEY.txt,432883,434254,1371,10,N,N,-,-1,-1
WESLEY.txt,434255,435010,755,10,N,N,-,-1,-1
WESLEY.txt,435011,436016,1005,10,N,N,-,-1,-1
WESLEY.txt,436016,437363,1347,10,N,N,-,-1,-1
WESLEY.txt,437364,438359,995,10,N,N,-,-1,-1
WESLEY.txt,438360,439491,1131,10,N,N,-,-1,-1
WESLEY.txt,439493,440291,798,10,N,N,-,-1,-1
WESLEY.txt,440292,440992,700,10,N,N,-,-1,-1
WESLEY.txt,440993,441737,744,10,N,N,-,-1,-1
WESLEY.txt,441738,442346,608,10,N,N,-,-1,-1
WESLEY.txt,442347,443324,977,10,N,N,-,-1,-1
WESLEY.txt,443324,444156,832,10,N,N,-,-1,-1
WESLEY.txt,444157,445319,1162,10,N,N,-,-1,-1
WESLEY.txt,445320,446007,687,10,N,N,-,-1,-1
WESLEY.txt,446008,446775,767,10,N,N,-,-1,-1
WESLEY.txt,446776,447427,651,10,N,N,-,-1,-1
WESLEY.txt,447428,448417,989,10,N,N,-,-1,-1
WESLEY.txt,448418,449351,933,10,N,N,-,-1,-1
WESLEY.txt,449352,450278,926,10,N,N,-,-1,-1
WESLEY.txt,450280,451154,874,10,N,N,-,-1,-1
WESLEY.txt,451155,452327,1172,10,N,N,-,-1,-1
WESLEY.txt,452328,453710,1382,10,N,N,-,-1,-1
WESLEY.txt,453711,454789,1078,10,N,N,-,-1,-1
WESLEY.txt,454790,455703,913,10,N,N,-,-1,-1
WESLEY.txt,455704,456371,667,10,N,N,-,-1,-1
WESLEY.txt,456371,457140,769,10,N,N,-,-1,-1
WESLEY.txt,457141,458237,1096,10,N,N,-,-1,-1
WESLEY.txt,458238,458956,718,10,N,N,-,-1,-1
WESLEY.txt,458956,459877,921,10,N,N,-,-1,-1
WESLEY.txt,459877,461506,1629,10,N,N,-,-1,-1
WESLEY.txt,461507,462453,946,10,N,N,-,-1,-1
WESLEY.txt,462454,463577,1123,10,N,N,-,-1,-1
WESLEY.txt,463578,464392,814,10,N,N,-,-1,-1
WESLEY.txt,464393,465531,1138,10,N,N,-,-1,-1
WESLEY.txt,465532,466352,820,10,N,N,-,-1,-1
WESLEY.txt,466353,467617,1264,10,N,N,-,-1,-1
WESLEY.txt,467618,468351,733,10,N,N,-,-1,-1
WESLEY.txt,468352,469138,786,10,N,N,-,-1,-1
WESLEY.txt,469139,470089,950,10,N,N,-,-1,-1
WESLEY.txt,470090,470993,903,10,N,N,-,-1,-1
WESLEY.txt,470994,472020,1026,10,N,N,-,-1,-1
WESLEY.txt,472021,472736,715,10,N,N,-,-1,-1
WESLEY.txt,472737,473613,876,10,N,N,-,-1,-1
WESLEY.txt,473614,474673,1059,10,N,N,-,-1,-1
WESLEY.txt,474674,475957,1283,10,N,N,-,-1,-1
WESLEY.txt,475957,476837,880,10,N,N,-,-1,-1
WESLEY.txt,476838,477906,1068,10,N,N,-,-1,-1
WESLEY.txt,477907,478688,781,10,N,N,-,-1,-1
WESLEY.txt,478689,479764,1075,10,N,N,-,-1,-1
WESLEY.txt,479765,480966,1201,10,N,Y,1435062319127,480703,480943
WESLEY.txt,480966,481861,895,10,N,N,-,-1,-1
WESLEY.txt,481862,483085,1223,10,N,N,-,-1,-1
WESLEY.txt,483086,483849,763,10,N,N,-,-1,-1
WESLEY.txt,483850,484840,990,10,N,N,-,-1,-1
WESLEY.txt,484841,485985,1144,10,N,N,-,-1,-1
WESLEY.txt,485986,487005,1019,10,N,N,-,-1,-1
WESLEY.txt,487006,488041,1035,10,N,N,-,-1,-1
WESLEY.txt,488042,488900,858,10,N,N,-,-1,-1
WESLEY.txt,488901,489685,784,10,N,N,-,-1,-1
WESLEY.txt,489686,490588,902,10,N,N,-,-1,-1
WESLEY.txt,490589,491564,975,10,N,N,-,-1,-1
WESLEY.txt,491565,492375,810,10,N,N,-,-1,-1
WESLEY.txt,492376,493348,972,10,N,N,-,-1,-1
WESLEY.txt,493349,494598,1249,10,N,Y,1435062617921,494000,496406
WESLEY.txt,494599,495752,1153,10,N,Y,1435062617921,494000,496406
WESLEY.txt,495753,496128,375,10,N,Y,1435062617921,494000,496406
WESLEY.txt,496129,497026,897,10,N,Y,1435062617921,494000,496406
WESLEY.txt,497027,498138,1111,10,N,N,-,-1,-1
WESLEY.txt,498139,499382,1243,10,N,N,-,-1,-1
WESLEY.txt,499382,500032,650,10,N,N,-,-1,-1
WESLEY.txt,500033,500794,761,10,N,N,-,-1,-1
WESLEY.txt,500794,501988,1194,10,N,N,-,-1,-1
WESLEY.txt,501989,503068,1079,10,N,N,-,-1,-1
WESLEY.txt,503069,503968,899,10,N,N,-,-1,-1
WESLEY.txt,503969,505591,1622,10,N,N,-,-1,-1
WESLEY.txt,505592,506673,1081,10,N,N,-,-1,-1
WESLEY.txt,506674,507765,1091,10,N,N,-,-1,-1
WESLEY.txt,507766,508990,1224,10,N,N,-,-1,-1
WESLEY.txt,508991,510017,1026,10,N,N,-,-1,-1
WESLEY.txt,510018,511110,1092,10,N,N,-,-1,-1
WESLEY.txt,511111,511908,797,10,N,N,-,-1,-1
WESLEY.txt,511909,512870,961,10,N,N,-,-1,-1
WESLEY.txt,512870,513757,887,10,N,N,-,-1,-1
WESLEY.txt,513758,514674,916,10,N,N,-,-1,-1
WESLEY.txt,514675,515628,953,10,N,N,-,-1,-1
WESLEY.txt,515629,516431,802,10,N,N,-,-1,-1
WESLEY.txt,516431,517600,1169,10,N,N,-,-1,-1
WESLEY.txt,517601,519046,1445,10,N,N,-,-1,-1
WESLEY.txt,519047,519721,674,10,N,N,-,-1,-1
WESLEY.txt,519722,520419,697,10,N,N,-,-1,-1
WESLEY.txt,520420,521431,1011,10,N,N,-,-1,-1
WESLEY.txt,521432,522531,1099,10,N,N,-,-1,-1
WESLEY.txt,522532,523289,757,10,N,N,-,-1,-1
WESLEY.txt,523290,524282,992,10,N,N,-,-1,-1
WESLEY.txt,524283,525370,1087,10,N,N,-,-1,-1
WESLEY.txt,525371,526225,854,10,N,N,-,-1,-1
WESLEY.txt,526226,527210,984,10,N,N,-,-1,-1
WESLEY.txt,527211,528171,960,10,N,N,-,-1,-1
WESLEY.txt,528172,529117,945,10,N,N,-,-1,-1
WESLEY.txt,529118,530109,991,10,N,N,-,-1,-1
WESLEY.txt,530110,531147,1037,10,N,N,-,-1,-1
WESLEY.txt,531148,532001,853,10,N,N,-,-1,-1
WESLEY.txt,532001,533252,1251,10,N,N,-,-1,-1
WESLEY.txt,533253,534433,1180,10,N,N,-,-1,-1
WESLEY.txt,534434,535323,889,10,N,N,-,-1,-1
WESLEY.txt,535324,536068,744,10,N,N,-,-1,-1
WESLEY.txt,536069,536961,892,10,N,Y,1435063028928,536935,537559
WESLEY.txt,536961,537685,724,10,N,Y,1435063028928,536935,537559
WESLEY.txt,537685,538614,929,10,N,N,-,-1,-1
WESLEY.txt,538615,539815,1200,10,N,N,-,-1,-1
WESLEY.txt,539816,540889,1073,10,N,N,-,-1,-1
WESLEY.txt,540890,541924,1034,10,N,N,-,-1,-1
WESLEY.txt,541925,543340,1415,10,N,N,-,-1,-1
WESLEY.txt,543341,544453,1112,10,N,N,-,-1,-1
WESLEY.txt,544454,545672,1218,10,N,N,-,-1,-1
WESLEY.txt,545673,546380,707,10,N,N,-,-1,-1
WESLEY.txt,546381,547572,1191,10,N,N,-,-1,-1
WESLEY.txt,547573,548575,1002,10,N,N,-,-1,-1
WESLEY.txt,548576,549306,730,10,N,N,-,-1,-1
WESLEY.txt,549307,550094,787,10,N,N,-,-1,-1
WESLEY.txt,550095,551176,1081,10,N,N,-,-1,-1
WESLEY.txt,551177,552186,1009,10,N,N,-,-1,-1
WESLEY.txt,552187,553233,1046,10,N,N,-,-1,-1
WESLEY.txt,553234,554179,945,10,N,N,-,-1,-1
WESLEY.txt,554180,555431,1251,10,N,N,-,-1,-1
WESLEY.txt,555432,556266,834,10,N,N,-,-1,-1
WESLEY.txt,556267,557254,987,10,N,N,-,-1,-1
WESLEY.txt,557255,557912,657,10,N,N,-,-1,-1
WESLEY.txt,557913,559037,1124,10,N,N,-,-1,-1
WESLEY.txt,559038,559931,893,10,N,N,-,-1,-1
WESLEY.txt,559932,560846,914,10,N,Y,1435063804274,560047,562154
WESLEY.txt,560847,561914,1067,10,N,Y,1435063804274,560047,562154
WESLEY.txt,561915,562807,892,10,N,Y,1435063804274,560047,562154
WESLEY.txt,562808,564353,1545,10,N,N,-,-1,-1
WESLEY.txt,564354,565584,1230,10,N,N,-,-1,-1
WESLEY.txt,565585,566353,768,10,N,N,-,-1,-1
WESLEY.txt,566354,567283,929,10,N,N,-,-1,-1
WESLEY.txt,567283,568144,861,10,N,N,-,-1,-1
WESLEY.txt,568145,569046,901,10,N,N,-,-1,-1
WESLEY.txt,569047,569501,454,10,N,N,-,-1,-1
WESLEY.txt,569502,570467,965,10,N,N,-,-1,-1
WESLEY.txt,570468,571086,618,10,N,N,-,-1,-1
WESLEY.txt,571087,571998,911,10,N,N,-,-1,-1
WESLEY.txt,571999,572975,976,10,N,N,-,-1,-1
WESLEY.txt,572976,574201,1225,10,N,N,-,-1,-1
WESLEY.txt,574202,575299,1097,10,N,N,-,-1,-1
WESLEY.txt,575300,576154,854,10,N,N,-,-1,-1
WESLEY.txt,576155,576984,829,10,N,N,-,-1,-1
WESLEY.txt,576985,578091,1106,10,N,N,-,-1,-1
WESLEY.txt,578092,578707,615,10,N,N,-,-1,-1
WESLEY.txt,578707,579824,1117,10,N,N,-,-1,-1
WESLEY.txt,579825,580519,694,10,N,N,-,-1,-1
WESLEY.txt,580519,581236,717,10,N,N,-,-1,-1
WESLEY.txt,581236,582442,1206,10,N,N,-,-1,-1
WESLEY.txt,582443,583505,1062,10,N,N,-,-1,-1
WESLEY.txt,583506,584632,1126,10,N,N,-,-1,-1
WESLEY.txt,584633,585603,970,10,N,N,-,-1,-1
WESLEY.txt,585604,586719,1115,10,N,N,-,-1,-1
WESLEY.txt,586720,587553,833,10,N,N,-,-1,-1
WESLEY.txt,587554,588717,1163,10,N,N,-,-1,-1
WESLEY.txt,588718,589603,885,10,N,N,-,-1,-1
WESLEY.txt,589604,590295,691,10,N,N,-,-1,-1
WESLEY.txt,590296,591030,734,10,N,N,-,-1,-1
WESLEY.txt,591031,592193,1162,10,N,N,-,-1,-1
WESLEY.txt,592194,593324,1130,10,N,N,-,-1,-1
WESLEY.txt,593325,594582,1257,10,N,N,-,-1,-1
WESLEY.txt,594583,595629,1046,10,N,N,-,-1,-1
WESLEY.txt,595629,596581,952,10,N,N,-,-1,-1
WESLEY.txt,596582,597957,1375,10,N,N,-,-1,-1
WESLEY.txt,597958,599009,1051,10,N,N,-,-1,-1
WESLEY.txt,599010,600075,1065,10,N,N,-,-1,-1
WESLEY.txt,600076,600903,827,10,N,N,-,-1,-1
WESLEY.txt,600904,601818,914,10,N,N,-,-1,-1
WESLEY.txt,601819,602937,1118,10,N,N,-,-1,-1
WESLEY.txt,602938,603752,814,10,N,N,-,-1,-1
WESLEY.txt,603752,604362,610,10,N,N,-,-1,-1
WESLEY.txt,604363,605193,830,10,N,N,-,-1,-1
WESLEY.txt,605194,606854,1660,10,N,N,-,-1,-1
WESLEY.txt,606855,607959,1104,10,N,N,-,-1,-1
WESLEY.txt,607960,609027,1067,10,N,N,-,-1,-1
WESLEY.txt,609028,609915,887,10,N,N,-,-1,-1
WESLEY.txt,609916,610802,886,10,N,N,-,-1,-1
WESLEY.txt,610803,611680,877,10,N,N,-,-1,-1
WESLEY.txt,611681,612446,765,10,N,N,-,-1,-1
WESLEY.txt,612447,613365,918,10,N,N,-,-1,-1
WESLEY.txt,613366,614461,1095,10,N,N,-,-1,-1
WESLEY.txt,614461,615164,703,10,N,N,-,-1,-1
WESLEY.txt,615165,615890,725,10,N,N,-,-1,-1
WESLEY.txt,615891,617030,1139,10,N,N,-,-1,-1
WESLEY.txt,617031,618382,1351,10,N,N,-,-1,-1
WESLEY.txt,618383,619105,722,10,N,N,-,-1,-1
WESLEY.txt,619106,620418,1312,10,N,N,-,-1,-1
WESLEY.txt,620419,621392,973,10,N,N,-,-1,-1
WESLEY.txt,621393,622369,976,10,N,N,-,-1,-1
WESLEY.txt,622370,623481,1111,10,N,N,-,-1,-1
WESLEY.txt,623482,624154,672,10,N,N,-,-1,-1
WESLEY.txt,624155,625193,1038,10,N,N,-,-1,-1
WESLEY.txt,625194,625826,632,10,N,N,-,-1,-1
WESLEY.txt,625827,626732,905,10,N,N,-,-1,-1
WESLEY.txt,626733,627626,893,10,N,N,-,-1,-1
WESLEY.txt,627627,628178,551,10,N,N,-,-1,-1
WESLEY.txt,628179,629049,870,10,N,N,-,-1,-1
WESLEY.txt,629050,629952,902,10,N,N,-,-1,-1
WESLEY.txt,629953,630767,814,10,N,N,-,-1,-1
WESLEY.txt,630768,631708,940,10,N,N,-,-1,-1
WESLEY.txt,631709,632937,1228,10,N,N,-,-1,-1
WESLEY.txt,632938,633907,969,10,N,N,-,-1,-1
WESLEY.txt,633907,634880,973,10,N,N,-,-1,-1
WESLEY.txt,634881,636032,1151,10,N,N,-,-1,-1
WESLEY.txt,636033,636650,617,10,N,N,-,-1,-1
WESLEY.txt,636650,637491,841,10,N,N,-,-1,-1
WESLEY.txt,637492,638327,835,10,N,N,-,-1,-1
WESLEY.txt,638327,639251,924,10,N,N,-,-1,-1
WESLEY.txt,639252,639896,644,10,N,N,-,-1,-1
WESLEY.txt,639897,640623,726,10,N,N,-,-1,-1
WESLEY.txt,640624,641420,796,10,N,N,-,-1,-1
WESLEY.txt,641421,642158,737,10,N,N,-,-1,-1
WESLEY.txt,642159,642984,825,10,N,N,-,-1,-1
WESLEY.txt,642985,644220,1235,10,N,N,-,-1,-1
WESLEY.txt,644221,644983,762,10,N,N,-,-1,-1
WESLEY.txt,644984,645690,706,10,N,N,-,-1,-1
WESLEY.txt,645691,646621,930,10,N,N,-,-1,-1
WESLEY.txt,646621,647059,438,10,N,N,-,-1,-1
WESLEY.txt,647060,648015,955,10,N,N,-,-1,-1
WESLEY.txt,648016,648947,931,10,N,N,-,-1,-1
WESLEY.txt,648948,649855,907,10,N,N,-,-1,-1
WESLEY.txt,649855,650722,867,10,N,N,-,-1,-1
WESLEY.txt,650723,651619,896,10,N,N,-,-1,-1
WESLEY.txt,651620,652923,1303,10,N,N,-,-1,-1
WESLEY.txt,652924,653931,1007,10,N,N,-,-1,-1
WESLEY.txt,653932,654701,769,10,N,N,-,-1,-1
WESLEY.txt,654702,655644,942,10,N,N,-,-1,-1
WESLEY.txt,655645,656499,854,10,N,N,-,-1,-1
WESLEY.txt,656500,657370,870,10,N,N,-,-1,-1
WESLEY.txt,657371,658265,894,10,N,N,-,-1,-1
WESLEY.txt,658266,659273,1007,10,N,N,-,-1,-1
WESLEY.txt,659273,660267,994,10,N,N,-,-1,-1
WESLEY.txt,660268,661060,792,10,N,N,-,-1,-1
WESLEY.txt,661061,661709,648,10,N,N,-,-1,-1
WESLEY.txt,661710,662433,723,10,N,N,-,-1,-1
WESLEY.txt,662434,663513,1079,10,N,N,-,-1,-1
WESLEY.txt,663514,664292,778,10,N,N,-,-1,-1
WESLEY.txt,664292,665303,1011,10,N,N,-,-1,-1
WESLEY.txt,665304,666047,743,10,N,N,-,-1,-1
WESLEY.txt,666048,666842,794,10,N,N,-,-1,-1
WESLEY.txt,666843,667609,766,10,N,N,-,-1,-1
WESLEY.txt,667609,668640,1031,10,N,N,-,-1,-1
WESLEY.txt,668641,669750,1109,10,N,N,-,-1,-1
WESLEY.txt,669751,670632,881,10,N,N,-,-1,-1
WESLEY.txt,670633,671474,841,10,N,N,-,-1,-1
WESLEY.txt,671475,672568,1093,10,N,N,-,-1,-1
WESLEY.txt,672569,673731,1162,10,N,N,-,-1,-1
WESLEY.txt,673732,674380,648,10,N,N,-,-1,-1
WESLEY.txt,674381,675106,725,10,N,N,-,-1,-1
WESLEY.txt,675107,675908,801,10,N,N,-,-1,-1
WESLEY.txt,675909,676802,893,10,N,N,-,-1,-1
WESLEY.txt,676803,677735,932,10,N,N,-,-1,-1
WESLEY.txt,677736,678595,859,10,N,N,-,-1,-1
WESLEY.txt,678596,679281,685,10,N,N,-,-1,-1
WESLEY.txt,679282,679932,650,10,N,N,-,-1,-1
WESLEY.txt,679933,680783,850,10,N,N,-,-1,-1
WESLEY.txt,680784,682001,1217,10,N,N,-,-1,-1
WESLEY.txt,682002,683049,1047,10,N,N,-,-1,-1
WESLEY.txt,683050,683924,874,10,N,N,-,-1,-1
WESLEY.txt,683925,684753,828,10,N,N,-,-1,-1
WESLEY.txt,684754,685451,697,10,N,N,-,-1,-1
WESLEY.txt,685452,686339,887,10,N,N,-,-1,-1
WESLEY.txt,686340,687277,937,10,N,N,-,-1,-1
WESLEY.txt,687278,688045,767,10,N,N,-,-1,-1
WESLEY.txt,688045,688998,953,10,N,N,-,-1,-1
WESLEY.txt,688999,689661,662,10,N,N,-,-1,-1
WESLEY.txt,689662,690244,582,10,N,N,-,-1,-1
WESLEY.txt,690245,691294,1049,10,N,N,-,-1,-1
WESLEY.txt,691295,691894,599,10,N,N,-,-1,-1
WESLEY.txt,691895,692808,913,10,N,N,-,-1,-1
WESLEY.txt,692809,693927,1118,10,N,N,-,-1,-1
WESLEY.txt,693928,695003,1075,10,N,N,-,-1,-1
WESLEY.txt,695004,695651,647,10,N,N,-,-1,-1
WESLEY.txt,695652,696579,927,10,N,N,-,-1,-1
WESLEY.txt,696580,697395,815,10,N,N,-,-1,-1
WESLEY.txt,697396,698674,1278,10,N,N,-,-1,-1
WESLEY.txt,698675,699487,812,10,N,N,-,-1,-1
WESLEY.txt,699488,700174,686,10,N,N,-,-1,-1
WESLEY.txt,700175,700836,661,10,N,N,-,-1,-1
WESLEY.txt,700836,701797,961,10,N,N,-,-1,-1
WESLEY.txt,701798,702785,987,10,N,N,-,-1,-1
WESLEY.txt,702786,704166,1380,10,N,N,-,-1,-1
WESLEY.txt,704167,705313,1146,10,N,N,-,-1,-1
WESLEY.txt,705314,706136,822,10,N,N,-,-1,-1
WESLEY.txt,706137,706806,669,10,N,N,-,-1,-1
WESLEY.txt,706807,707455,648,10,N,N,-,-1,-1
WESLEY.txt,707456,708684,1228,10,N,N,-,-1,-1
WESLEY.txt,708685,710393,1708,10,N,N,-,-1,-1
WESLEY.txt,710394,711132,738,10,N,N,-,-1,-1
WESLEY.txt,711133,711815,682,10,N,N,-,-1,-1
WESLEY.txt,711816,712870,1054,10,N,N,-,-1,-1
WESLEY.txt,712871,713627,756,10,N,N,-,-1,-1
WESLEY.txt,713628,714661,1033,10,N,N,-,-1,-1
WESLEY.txt,714661,716130,1469,10,N,N,-,-1,-1
WESLEY.txt,716130,717022,892,10,N,N,-,-1,-1
WESLEY.txt,717023,718082,1059,10,N,N,-,-1,-1
WESLEY.txt,718083,719217,1134,10,N,N,-,-1,-1
WESLEY.txt,719218,719830,612,10,N,N,-,-1,-1
WESLEY.txt,719831,720600,769,10,N,N,-,-1,-1
WESLEY.txt,720601,721499,898,10,N,N,-,-1,-1
WESLEY.txt,721500,722216,716,10,N,N,-,-1,-1
WESLEY.txt,722217,723072,855,10,N,N,-,-1,-1
WESLEY.txt,723073,724438,1365,10,N,N,-,-1,-1
WESLEY.txt,724438,725339,901,10,N,N,-,-1,-1
WESLEY.txt,725340,726249,909,10,N,N,-,-1,-1
WESLEY.txt,726250,727241,991,10,N,N,-,-1,-1
WESLEY.txt,727241,728095,854,10,N,N,-,-1,-1
WESLEY.txt,728096,729169,1073,10,N,N,-,-1,-1
WESLEY.txt,729170,730057,887,10,N,N,-,-1,-1
WESLEY.txt,730058,730859,801,10,N,N,-,-1,-1
WESLEY.txt,730860,731646,786,10,N,N,-,-1,-1
WESLEY.txt,731647,732425,778,10,N,N,-,-1,-1
WESLEY.txt,732425,733633,1208,10,N,N,-,-1,-1
WESLEY.txt,733634,734576,942,10,N,N,-,-1,-1
WESLEY.txt,734577,735475,898,10,N,N,-,-1,-1
WESLEY.txt,735476,736609,1133,10,N,N,-,-1,-1
WESLEY.txt,736610,737511,901,10,N,N,-,-1,-1
WESLEY.txt,737512,738595,1083,10,N,N,-,-1,-1
WESLEY.txt,738596,739804,1208,10,N,N,-,-1,-1
WESLEY.txt,739805,740790,985,10,N,N,-,-1,-1
WESLEY.txt,740791,741540,749,10,N,N,-,-1,-1
WESLEY.txt,741541,742353,812,10,N,N,-,-1,-1
WESLEY.txt,742354,743342,988,10,N,N,-,-1,-1
WESLEY.txt,743343,744290,947,10,N,N,-,-1,-1
WESLEY.txt,744291,744927,636,10,N,N,-,-1,-1
WESLEY.txt,744928,745905,977,10,N,N,-,-1,-1
WESLEY.txt,745906,747414,1508,10,N,N,-,-1,-1
WESLEY.txt,747415,748556,1141,10,N,N,-,-1,-1
WESLEY.txt,748557,749659,1102,10,N,N,-,-1,-1
WESLEY.txt,749660,751302,1642,10,N,N,-,-1,-1
WESLEY.txt,751303,751962,659,10,N,N,-,-1,-1
WESLEY.txt,751963,752869,906,10,N,N,-,-1,-1
WESLEY.txt,752870,753916,1046,10,N,N,-,-1,-1
WESLEY.txt,753917,755160,1243,10,N,N,-,-1,-1
WESLEY.txt,755161,755905,744,10,N,N,-,-1,-1
WESLEY.txt,755906,756670,764,10,N,N,-,-1,-1
WESLEY.txt,756671,757718,1047,10,N,N,-,-1,-1
WESLEY.txt,757719,758885,1166,10,N,N,-,-1,-1
WESLEY.txt,758886,759575,689,10,N,N,-,-1,-1
WESLEY.txt,759576,760315,739,10,N,N,-,-1,-1
WESLEY.txt,760316,761329,1013,10,N,N,-,-1,-1
WESLEY.txt,761329,762246,917,10,N,N,-,-1,-1
WESLEY.txt,762247,763252,1005,10,N,N,-,-1,-1
WESLEY.txt,763253,764222,969,10,N,N,-,-1,-1
WESLEY.txt,764223,764852,629,10,N,N,-,-1,-1
WESLEY.txt,764853,765778,925,10,N,N,-,-1,-1
WESLEY.txt,765779,766607,828,10,N,N,-,-1,-1
WESLEY.txt,766608,767437,829,10,N,N,-,-1,-1
WESLEY.txt,767438,768320,882,10,N,N,-,-1,-1
WESLEY.txt,768321,768929,608,10,N,N,-,-1,-1
WESLEY.txt,768930,769834,904,10,N,N,-,-1,-1
WESLEY.txt,769835,771031,1196,10,N,N,-,-1,-1
WESLEY.txt,771032,772356,1324,10,N,N,-,-1,-1
WESLEY.txt,772357,773249,892,10,N,N,-,-1,-1
WESLEY.txt,773250,773949,699,10,N,N,-,-1,-1
WESLEY.txt,773950,774765,815,10,N,N,-,-1,-1
WESLEY.txt,774766,775637,871,10,N,N,-,-1,-1
WESLEY.txt,775637,776527,890,10,N,N,-,-1,-1
WESLEY.txt,776528,777252,724,10,N,N,-,-1,-1
WESLEY.txt,777252,778456,1204,10,N,N,-,-1,-1
WESLEY.txt,778457,779028,571,10,N,N,-,-1,-1
WESLEY.txt,779029,779715,686,10,N,N,-,-1,-1
WESLEY.txt,779716,780536,820,10,N,N,-,-1,-1
WESLEY.txt,780537,781112,575,10,N,N,-,-1,-1
WESLEY.txt,781113,781735,622,10,N,N,-,-1,-1
WESLEY.txt,781736,783017,1281,10,N,N,-,-1,-1
WESLEY.txt,783018,783679,661,10,N,N,-,-1,-1
WESLEY.txt,783680,784692,1012,10,N,N,-,-1,-1
WESLEY.txt,784693,785800,1107,10,N,N,-,-1,-1
WESLEY.txt,785801,786802,1001,10,N,N,-,-1,-1
WESLEY.txt,786803,787773,970,10,N,N,-,-1,-1
WESLEY.txt,787774,788566,792,10,N,N,-,-1,-1
WESLEY.txt,788567,789564,997,10,N,N,-,-1,-1
WESLEY.txt,789565,790600,1035,10,N,N,-,-1,-1
WESLEY.txt,790601,791049,448,10,N,N,-,-1,-1
WESLEY.txt,791050,791731,681,10,N,N,-,-1,-1
WESLEY.txt,791732,792626,894,10,N,N,-,-1,-1
WESLEY.txt,792627,793716,1089,10,N,N,-,-1,-1
WESLEY.txt,793717,794636,919,10,N,N,-,-1,-1
WESLEY.txt,794637,795509,872,10,N,N,-,-1,-1
WESLEY.txt,795510,796301,791,10,N,N,-,-1,-1
WESLEY.txt,796302,797259,957,10,N,N,-,-1,-1
WESLEY.txt,797260,798090,830,10,N,N,-,-1,-1
WESLEY.txt,798090,799133,1043,10,N,N,-,-1,-1
WESLEY.txt,799134,799786,652,10,N,N,-,-1,-1
WESLEY.txt,799787,800730,943,10,N,N,-,-1,-1
WESLEY.txt,800731,801682,951,10,N,N,-,-1,-1
WESLEY.txt,801683,802550,867,10,N,N,-,-1,-1
WESLEY.txt,802551,803200,649,10,N,N,-,-1,-1
WESLEY.txt,803201,803772,571,10,N,N,-,-1,-1
WESLEY.txt,803773,804646,873,10,N,N,-,-1,-1
WESLEY.txt,804647,805321,674,10,N,N,-,-1,-1
WESLEY.txt,805321,806077,756,10,N,N,-,-1,-1
WESLEY.txt,806077,806922,845,10,N,N,-,-1,-1
WESLEY.txt,806923,807699,776,10,N,N,-,-1,-1
WESLEY.txt,807700,808364,664,10,N,N,-,-1,-1
WESLEY.txt,808364,809398,1034,10,N,N,-,-1,-1
WESLEY.txt,809399,810646,1247,10,N,N,-,-1,-1
WESLEY.txt,810647,811391,744,10,N,N,-,-1,-1
WESLEY.txt,811392,812364,972,10,N,N,-,-1,-1
WESLEY.txt,812365,813374,1009,10,N,N,-,-1,-1
WESLEY.txt,813375,814754,1379,10,N,N,-,-1,-1
WESLEY.txt,814754,815371,617,10,N,N,-,-1,-1
WESLEY.txt,815372,816777,1405,10,N,N,-,-1,-1
WESLEY.txt,816778,817720,942,10,N,N,-,-1,-1
WESLEY.txt,817721,818652,931,10,N,N,-,-1,-1
WESLEY.txt,818653,819632,979,10,N,N,-,-1,-1
WESLEY.txt,819633,820417,784,10,N,N,-,-1,-1
WESLEY.txt,820418,821357,939,10,N,N,-,-1,-1
WESLEY.txt,821358,822263,905,10,N,N,-,-1,-1
WESLEY.txt,822264,822974,710,10,N,N,-,-1,-1
WESLEY.txt,822975,823770,795,10,N,N,-,-1,-1
WESLEY.txt,823771,824735,964,10,N,N,-,-1,-1
WESLEY.txt,824736,825614,878,10,N,N,-,-1,-1
WESLEY.txt,825614,827179,1565,10,N,N,-,-1,-1
WESLEY.txt,827180,828164,984,10,N,N,-,-1,-1
WESLEY.txt,828165,828997,832,10,N,N,-,-1,-1
WESLEY.txt,828998,829766,768,10,N,N,-,-1,-1
WESLEY.txt,829767,830649,882,10,N,N,-,-1,-1
WESLEY.txt,830650,831523,873,10,N,N,-,-1,-1
WESLEY.txt,831523,832269,746,10,N,N,-,-1,-1
WESLEY.txt,832270,833402,1132,10,N,N,-,-1,-1
WESLEY.txt,833403,834083,680,10,N,N,-,-1,-1
WESLEY.txt,834084,834838,754,10,N,N,-,-1,-1
WESLEY.txt,834839,835894,1055,10,N,N,-,-1,-1
WESLEY.txt,835895,836820,925,10,N,N,-,-1,-1
WESLEY.txt,836820,837719,899,10,N,N,-,-1,-1
WESLEY.txt,837720,838692,972,10,N,N,-,-1,-1
WESLEY.txt,838693,839430,737,10,N,N,-,-1,-1
WESLEY.txt,839430,840468,1038,10,N,N,-,-1,-1
WESLEY.txt,840468,841154,686,10,N,N,-,-1,-1
WESLEY.txt,841155,842080,925,10,N,N,-,-1,-1
WESLEY.txt,842081,842815,734,10,N,N,-,-1,-1
WESLEY.txt,842816,843480,664,10,N,N,-,-1,-1
WESLEY.txt,843481,844501,1020,10,N,N,-,-1,-1
WESLEY.txt,844501,845313,812,10,N,N,-,-1,-1
WESLEY.txt,845314,845994,680,10,N,N,-,-1,-1
WESLEY.txt,845995,846931,936,10,N,N,-,-1,-1
WESLEY.txt,846932,847856,924,10,N,N,-,-1,-1
WESLEY.txt,847857,849091,1234,10,N,N,-,-1,-1
WESLEY.txt,849092,850168,1076,10,N,N,-,-1,-1
WESLEY.txt,850169,851373,1204,10,N,N,-,-1,-1
WESLEY.txt,851374,852376,1002,10,N,N,-,-1,-1
WESLEY.txt,852377,853239,862,10,N,N,-,-1,-1
WESLEY.txt,853240,854064,824,10,N,N,-,-1,-1
WESLEY.txt,854065,855206,1141,10,N,N,-,-1,-1
WESLEY.txt,855207,855875,668,10,N,N,-,-1,-1
WESLEY.txt,855875,856818,943,10,N,N,-,-1,-1
WESLEY.txt,856819,857820,1001,10,N,N,-,-1,-1
WESLEY.txt,857821,858904,1083,10,N,N,-,-1,-1
WESLEY.txt,858905,860079,1174,10,N,N,-,-1,-1
WESLEY.txt,860079,861044,965,10,N,N,-,-1,-1
WESLEY.txt,861045,862454,1409,10,N,N,-,-1,-1
WESLEY.txt,862455,863083,628,10,N,N,-,-1,-1
WESLEY.txt,863084,864098,1014,10,N,N,-,-1,-1
WESLEY.txt,864099,865033,934,10,N,N,-,-1,-1
WESLEY.txt,865034,865982,948,10,N,N,-,-1,-1
WESLEY.txt,865983,867117,1134,10,N,N,-,-1,-1
WESLEY.txt,867117,868147,1030,10,N,N,-,-1,-1
WESLEY.txt,868148,868898,750,10,N,N,-,-1,-1
WESLEY.txt,868899,869804,905,10,N,N,-,-1,-1
WESLEY.txt,869805,870611,806,10,N,N,-,-1,-1
WESLEY.txt,870612,871179,567,10,N,N,-,-1,-1
WESLEY.txt,871180,872208,1028,10,N,N,-,-1,-1
WESLEY.txt,872209,874361,2152,10,N,N,-,-1,-1
WESLEY.txt,874362,875295,933,10,N,N,-,-1,-1
WESLEY.txt,875295,875942,647,10,N,N,-,-1,-1
WESLEY.txt,875942,876653,711,10,N,N,-,-1,-1
WESLEY.txt,876654,877430,776,10,N,N,-,-1,-1
WESLEY.txt,877431,878175,744,10,N,N,-,-1,-1
WESLEY.txt,878175,878835,660,10,N,N,-,-1,-1
WESLEY.txt,878836,879397,561,10,N,N,-,-1,-1
WESLEY.txt,879398,880541,1143,10,N,N,-,-1,-1
WESLEY.txt,880542,881221,679,10,N,N,-,-1,-1
WESLEY.txt,881222,881983,761,10,N,N,-,-1,-1
WESLEY.txt,881984,882736,752,10,N,N,-,-1,-1
WESLEY.txt,882736,883448,712,10,N,N,-,-1,-1
WESLEY.txt,883449,884509,1060,10,N,N,-,-1,-1
WESLEY.txt,884510,885408,898,10,N,N,-,-1,-1
WESLEY.txt,885409,886931,1522,10,N,N,-,-1,-1
WESLEY.txt,886932,888753,1821,10,N,N,-,-1,-1
WESLEY.txt,888754,890635,1881,10,N,N,-,-1,-1
WESLEY.txt,890636,892400,1764,10,N,N,-,-1,-1
WESLEY.txt,892401,894981,2580,10,N,N,-,-1,-1
WESLEY.txt,894982,896164,1182,10,N,N,-,-1,-1
