GLOVER.txt,0,156,156,5,N,N,-,-1,-1
GLOVER.txt,157,1301,1144,5,N,N,-,-1,-1
GLOVER.txt,1302,2600,1298,5,N,N,-,-1,-1
GLOVER.txt,2603,3994,1391,5,N,N,-,-1,-1
GLOVER.txt,3995,7196,3201,5,N,N,-,-1,-1
GLOVER.txt,7197,11467,4270,5,N,N,-,-1,-1
GLOVER.txt,11468,15511,4043,5,N,N,-,-1,-1
GLOVER.txt,15514,16363,849,5,N,N,-,-1,-1
GLOVER.txt,16364,17590,1226,5,N,N,-,-1,-1
GLOVER.txt,17592,18754,1162,5,N,N,-,-1,-1
GLOVER.txt,18757,20075,1318,5,N,N,-,-1,-1
GLOVER.txt,20076,20786,710,5,N,N,-,-1,-1
GLOVER.txt,20789,21810,1021,5,N,N,-,-1,-1
GLOVER.txt,21811,22790,979,5,N,N,-,-1,-1
GLOVER.txt,22791,23617,826,5,N,N,-,-1,-1
GLOVER.txt,23618,24428,810,5,N,N,-,-1,-1
GLOVER.txt,24429,24644,215,5,N,N,-,-1,-1
GLOVER.txt,24645,25726,1081,5,N,N,-,-1,-1
GLOVER.txt,25731,26678,947,5,N,N,-,-1,-1
GLOVER.txt,26680,27271,591,5,N,N,-,-1,-1
GLOVER.txt,27272,27890,618,5,N,N,-,-1,-1
GLOVER.txt,27891,29377,1486,5,N,N,-,-1,-1
GLOVER.txt,29378,30590,1212,5,N,N,-,-1,-1
GLOVER.txt,30593,31921,1328,5,N,N,-,-1,-1
GLOVER.txt,31922,33075,1153,5,N,N,-,-1,-1
GLOVER.txt,33078,33372,294,5,N,N,-,-1,-1
GLOVER.txt,33373,34270,897,5,N,N,-,-1,-1
GLOVER.txt,34271,35169,898,5,N,N,-,-1,-1
GLOVER.txt,35171,35858,687,5,N,N,-,-1,-1
GLOVER.txt,35859,36684,825,5,N,N,-,-1,-1
GLOVER.txt,36685,37902,1217,5,N,N,-,-1,-1
GLOVER.txt,37905,38824,919,5,N,N,-,-1,-1
GLOVER.txt,38825,39214,389,5,N,N,-,-1,-1
GLOVER.txt,39217,40559,1342,5,N,N,-,-1,-1
GLOVER.txt,40560,41633,1073,5,N,N,-,-1,-1
GLOVER.txt,41634,42834,1200,5,N,N,-,-1,-1
GLOVER.txt,42834,43849,1015,5,N,N,-,-1,-1
GLOVER.txt,43850,44368,518,5,N,N,-,-1,-1
GLOVER.txt,44369,44893,524,5,N,N,-,-1,-1
GLOVER.txt,44894,45108,214,5,N,N,-,-1,-1
GLOVER.txt,45109,45855,746,5,N,N,-,-1,-1
GLOVER.txt,45856,45973,117,5,N,N,-,-1,-1
GLOVER.txt,45974,46066,92,5,N,N,-,-1,-1
GLOVER.txt,46067,46321,254,5,N,N,-,-1,-1
GLOVER.txt,46322,46630,308,5,N,N,-,-1,-1
GLOVER.txt,46632,46931,299,5,N,N,-,-1,-1
GLOVER.txt,46932,47200,268,5,N,N,-,-1,-1
GLOVER.txt,47201,47632,431,5,N,N,-,-1,-1
GLOVER.txt,47633,48839,1206,5,N,N,-,-1,-1
GLOVER.txt,48840,49516,676,5,N,N,-,-1,-1
GLOVER.txt,49517,50459,942,5,N,N,-,-1,-1
GLOVER.txt,50462,51487,1025,5,N,N,-,-1,-1
GLOVER.txt,51490,52266,776,5,N,N,-,-1,-1
GLOVER.txt,52269,52905,636,5,N,N,-,-1,-1
GLOVER.txt,52906,53412,506,5,N,N,-,-1,-1
GLOVER.txt,53413,54018,605,5,N,N,-,-1,-1
GLOVER.txt,54019,54398,379,5,N,N,-,-1,-1
GLOVER.txt,54399,54679,280,5,N,N,-,-1,-1
GLOVER.txt,54680,55368,688,5,N,N,-,-1,-1
GLOVER.txt,55370,56585,1215,5,N,N,-,-1,-1
GLOVER.txt,56586,57573,987,5,N,N,-,-1,-1
GLOVER.txt,57576,58108,532,5,N,N,-,-1,-1
GLOVER.txt,58109,59066,957,5,N,N,-,-1,-1
GLOVER.txt,59069,59931,862,5,N,N,-,-1,-1
GLOVER.txt,59934,60683,749,5,N,N,-,-1,-1
GLOVER.txt,60684,62385,1701,5,N,N,-,-1,-1
GLOVER.txt,62388,63424,1036,5,N,N,-,-1,-1
GLOVER.txt,63425,64142,717,5,N,N,-,-1,-1
GLOVER.txt,64143,64894,751,5,N,N,-,-1,-1
GLOVER.txt,64897,65652,755,5,N,N,-,-1,-1
GLOVER.txt,65653,66399,746,5,N,N,-,-1,-1
GLOVER.txt,66402,67838,1436,5,N,N,-,-1,-1
GLOVER.txt,67839,68793,954,5,N,N,-,-1,-1
GLOVER.txt,68794,69760,966,5,N,N,-,-1,-1
GLOVER.txt,69761,70950,1189,5,N,N,-,-1,-1
GLOVER.txt,70952,72139,1187,5,N,N,-,-1,-1
GLOVER.txt,72142,73239,1097,5,N,N,-,-1,-1
GLOVER.txt,73240,74651,1411,5,N,N,-,-1,-1
GLOVER.txt,74654,75406,752,5,N,N,-,-1,-1
GLOVER.txt,75409,76383,974,5,N,N,-,-1,-1
GLOVER.txt,76384,77412,1028,5,N,N,-,-1,-1
GLOVER.txt,77413,78666,1253,5,N,N,-,-1,-1
GLOVER.txt,78667,79974,1307,5,N,N,-,-1,-1
GLOVER.txt,79975,81497,1522,5,N,N,-,-1,-1
GLOVER.txt,81500,82469,969,5,N,N,-,-1,-1
GLOVER.txt,82470,83739,1269,5,N,N,-,-1,-1
GLOVER.txt,83740,84841,1101,5,N,N,-,-1,-1
GLOVER.txt,84842,86480,1638,5,N,N,-,-1,-1
GLOVER.txt,86481,87212,731,5,N,N,-,-1,-1
GLOVER.txt,87213,88226,1013,5,N,N,-,-1,-1
GLOVER.txt,88227,88775,548,5,N,N,-,-1,-1
GLOVER.txt,88776,89144,368,5,N,N,-,-1,-1
GLOVER.txt,89144,89711,567,5,N,N,-,-1,-1
GLOVER.txt,89712,90339,627,5,N,N,-,-1,-1
GLOVER.txt,90340,91938,1598,5,N,N,-,-1,-1
GLOVER.txt,91939,93266,1327,5,N,N,-,-1,-1
GLOVER.txt,93267,93996,729,5,N,N,-,-1,-1
GLOVER.txt,93997,94525,528,5,N,N,-,-1,-1
GLOVER.txt,94526,96128,1602,5,Y,N,-,-1,-1
GLOVER.txt,96129,96552,423,5,N,N,-,-1,-1
GLOVER.txt,96554,97560,1006,5,N,N,-,-1,-1
GLOVER.txt,97563,98325,762,5,N,N,-,-1,-1
GLOVER.txt,98326,99363,1037,5,N,N,-,-1,-1
GLOVER.txt,99364,100433,1069,5,N,N,-,-1,-1
GLOVER.txt,100434,100901,467,5,N,N,-,-1,-1
GLOVER.txt,100903,101615,712,5,N,N,-,-1,-1
GLOVER.txt,101616,102035,419,5,N,N,-,-1,-1
GLOVER.txt,102036,102765,729,5,N,N,-,-1,-1
GLOVER.txt,102768,103902,1134,5,N,N,-,-1,-1
GLOVER.txt,103903,104972,1069,5,N,N,-,-1,-1
GLOVER.txt,104975,105769,794,5,N,Y,1436867017136,105674,106651
GLOVER.txt,105770,107082,1312,5,N,Y,1436867017136,105674,106651
GLOVER.txt,107083,108118,1035,5,N,N,-,-1,-1
GLOVER.txt,108119,109242,1123,5,N,N,-,-1,-1
GLOVER.txt,109243,110055,812,5,N,N,-,-1,-1
GLOVER.txt,110056,110511,455,5,N,N,-,-1,-1
GLOVER.txt,110514,111385,871,5,N,N,-,-1,-1
GLOVER.txt,111386,112511,1125,5,N,N,-,-1,-1
GLOVER.txt,112513,113040,527,5,N,N,-,-1,-1
GLOVER.txt,113041,113817,776,5,N,N,-,-1,-1
GLOVER.txt,113818,114360,542,5,N,N,-,-1,-1
GLOVER.txt,114361,115452,1091,5,N,N,-,-1,-1
GLOVER.txt,115455,116395,940,5,N,N,-,-1,-1
GLOVER.txt,116396,117354,958,5,N,N,-,-1,-1
GLOVER.txt,117357,117690,333,5,N,N,-,-1,-1
GLOVER.txt,117691,118847,1156,5,N,N,-,-1,-1
GLOVER.txt,118850,119246,396,5,N,N,-,-1,-1
GLOVER.txt,119247,120141,894,5,N,N,-,-1,-1
GLOVER.txt,120144,121270,1126,5,N,N,-,-1,-1
GLOVER.txt,121273,121872,599,5,N,Y,1437028092146,121457,123204
GLOVER.txt,121873,122519,646,5,N,Y,1437028092146,121457,123204
GLOVER.txt,122520,123497,977,5,N,Y,1437028092146,121457,123204
GLOVER.txt,123502,124702,1200,5,N,N,-,-1,-1
GLOVER.txt,124703,125433,730,5,N,N,-,-1,-1
GLOVER.txt,125434,126316,882,5,N,N,-,-1,-1
GLOVER.txt,126319,126669,350,5,N,N,-,-1,-1
GLOVER.txt,126670,127361,691,5,N,N,-,-1,-1
GLOVER.txt,127364,127977,613,5,N,N,-,-1,-1
GLOVER.txt,127978,129418,1440,5,N,N,-,-1,-1
GLOVER.txt,129419,130778,1359,5,N,N,-,-1,-1
GLOVER.txt,130779,131147,368,5,N,N,-,-1,-1
GLOVER.txt,131148,132228,1080,5,N,N,-,-1,-1
GLOVER.txt,132229,133436,1207,5,N,N,-,-1,-1
GLOVER.txt,133439,134743,1304,5,N,N,-,-1,-1
GLOVER.txt,134744,136023,1279,5,N,N,-,-1,-1
GLOVER.txt,136024,136706,682,5,N,N,-,-1,-1
GLOVER.txt,136708,137883,1175,5,N,N,-,-1,-1
GLOVER.txt,137884,138576,692,5,N,N,-,-1,-1
GLOVER.txt,138577,138858,281,5,N,N,-,-1,-1
GLOVER.txt,138859,139529,670,5,N,N,-,-1,-1
GLOVER.txt,139530,139737,207,5,N,N,-,-1,-1
GLOVER.txt,139738,140141,403,5,N,N,-,-1,-1
GLOVER.txt,140142,140752,610,5,N,N,-,-1,-1
GLOVER.txt,140753,141669,916,5,N,N,-,-1,-1
GLOVER.txt,141670,142926,1256,5,N,N,-,-1,-1
GLOVER.txt,142927,143963,1036,5,N,N,-,-1,-1
GLOVER.txt,143964,144921,957,5,N,N,-,-1,-1
GLOVER.txt,144922,145863,941,5,N,N,-,-1,-1
GLOVER.txt,145864,146277,413,5,N,N,-,-1,-1
GLOVER.txt,146278,146650,372,5,N,N,-,-1,-1
GLOVER.txt,146651,146792,141,5,N,N,-,-1,-1
GLOVER.txt,146793,147346,553,5,N,N,-,-1,-1
GLOVER.txt,147347,147552,205,5,N,N,-,-1,-1
GLOVER.txt,147553,148185,632,5,N,N,-,-1,-1
GLOVER.txt,148186,148488,302,5,N,N,-,-1,-1
GLOVER.txt,148489,149227,738,5,N,N,-,-1,-1
GLOVER.txt,149229,149633,404,5,N,N,-,-1,-1
GLOVER.txt,149635,150116,481,5,N,N,-,-1,-1
GLOVER.txt,150117,150409,292,5,N,N,-,-1,-1
GLOVER.txt,150410,150971,561,5,N,N,-,-1,-1
GLOVER.txt,150973,151988,1015,5,N,N,-,-1,-1
GLOVER.txt,151991,152510,519,5,N,Y,1437470299748,152207,152889
GLOVER.txt,152511,152902,391,5,N,Y,1437470299748,152207,152889
GLOVER.txt,152903,153400,497,5,N,N,-,-1,-1
GLOVER.txt,153401,153766,365,5,N,N,-,-1,-1
GLOVER.txt,153767,154241,474,5,N,N,-,-1,-1
GLOVER.txt,154243,155326,1083,5,N,N,-,-1,-1
GLOVER.txt,155329,156573,1244,5,N,N,-,-1,-1
GLOVER.txt,156576,157682,1106,5,N,N,-,-1,-1
GLOVER.txt,157683,158980,1297,5,N,N,-,-1,-1
GLOVER.txt,158981,159479,498,5,N,N,-,-1,-1
GLOVER.txt,159480,160267,787,5,N,N,-,-1,-1
GLOVER.txt,160268,161231,963,5,N,N,-,-1,-1
GLOVER.txt,161232,162023,791,5,N,N,-,-1,-1
GLOVER.txt,162025,162933,908,5,N,N,-,-1,-1
GLOVER.txt,162938,163926,988,5,N,N,-,-1,-1
GLOVER.txt,163929,165023,1094,5,N,N,-,-1,-1
GLOVER.txt,165024,166069,1045,5,N,N,-,-1,-1
GLOVER.txt,166072,166822,750,5,N,N,-,-1,-1
GLOVER.txt,166823,167609,786,5,N,N,-,-1,-1
GLOVER.txt,167610,168775,1165,5,N,N,-,-1,-1
GLOVER.txt,168777,169547,770,5,N,N,-,-1,-1
GLOVER.txt,169548,170246,698,5,N,N,-,-1,-1
GLOVER.txt,170249,170867,618,5,N,N,-,-1,-1
GLOVER.txt,170872,172250,1378,5,N,N,-,-1,-1
GLOVER.txt,172252,173316,1064,5,N,N,-,-1,-1
GLOVER.txt,173318,173918,600,5,N,N,-,-1,-1
GLOVER.txt,173920,174811,891,5,N,N,-,-1,-1
GLOVER.txt,174814,175590,776,5,N,N,-,-1,-1
GLOVER.txt,175591,176589,998,5,N,N,-,-1,-1
GLOVER.txt,176592,177860,1268,5,N,N,-,-1,-1
GLOVER.txt,177863,178673,810,5,N,N,-,-1,-1
GLOVER.txt,178674,179306,632,5,N,N,-,-1,-1
GLOVER.txt,179307,179719,412,5,N,N,-,-1,-1
GLOVER.txt,179720,179979,259,5,N,N,-,-1,-1
GLOVER.txt,179980,180342,362,5,N,N,-,-1,-1
GLOVER.txt,180344,181182,838,5,N,N,-,-1,-1
GLOVER.txt,181183,182253,1070,5,N,N,-,-1,-1
GLOVER.txt,182256,182665,409,5,N,N,-,-1,-1
GLOVER.txt,182666,183444,778,5,N,N,-,-1,-1
GLOVER.txt,183445,184173,728,5,N,N,-,-1,-1
GLOVER.txt,184176,184751,575,5,N,N,-,-1,-1
GLOVER.txt,184752,185438,686,5,N,N,-,-1,-1
GLOVER.txt,185439,186398,959,5,N,N,-,-1,-1
GLOVER.txt,186399,187086,687,5,N,N,-,-1,-1
GLOVER.txt,187087,187924,837,5,N,N,-,-1,-1
GLOVER.txt,187925,188827,902,5,N,N,-,-1,-1
GLOVER.txt,188828,189346,518,5,N,N,-,-1,-1
GLOVER.txt,189347,189761,414,5,N,N,-,-1,-1
GLOVER.txt,189763,190178,415,5,N,N,-,-1,-1
GLOVER.txt,190179,190991,812,5,N,N,-,-1,-1
GLOVER.txt,190994,192225,1231,5,N,N,-,-1,-1
GLOVER.txt,192226,192995,769,5,N,N,-,-1,-1
GLOVER.txt,192996,193895,899,5,N,N,-,-1,-1
GLOVER.txt,193898,194811,913,5,N,N,-,-1,-1
GLOVER.txt,194812,195632,820,5,N,N,-,-1,-1
GLOVER.txt,195633,196024,391,5,N,N,-,-1,-1
GLOVER.txt,196025,197145,1120,5,N,N,-,-1,-1
GLOVER.txt,197146,197803,657,5,N,N,-,-1,-1
GLOVER.txt,197805,198385,580,5,N,N,-,-1,-1
GLOVER.txt,198388,198940,552,5,N,N,-,-1,-1
GLOVER.txt,198943,199632,689,5,N,N,-,-1,-1
GLOVER.txt,199633,200287,654,5,N,N,-,-1,-1
GLOVER.txt,200288,201002,714,5,N,N,-,-1,-1
GLOVER.txt,201004,202829,1825,5,N,N,-,-1,-1
GLOVER.txt,202830,203710,880,5,N,N,-,-1,-1
GLOVER.txt,203711,204950,1239,5,N,N,-,-1,-1
GLOVER.txt,204951,206217,1266,5,N,N,-,-1,-1
GLOVER.txt,206218,207014,796,5,N,N,-,-1,-1
GLOVER.txt,207015,207737,722,5,N,N,-,-1,-1
GLOVER.txt,207740,208887,1147,5,N,N,-,-1,-1
GLOVER.txt,208889,209662,773,5,N,N,-,-1,-1
GLOVER.txt,209663,210533,870,5,N,N,-,-1,-1
GLOVER.txt,210534,211375,841,5,N,N,-,-1,-1
GLOVER.txt,211378,211858,480,5,N,N,-,-1,-1
GLOVER.txt,211861,212854,993,5,N,N,-,-1,-1
GLOVER.txt,212857,213213,356,5,N,N,-,-1,-1
GLOVER.txt,213214,213392,178,5,N,N,-,-1,-1
GLOVER.txt,213393,213670,277,5,N,N,-,-1,-1
GLOVER.txt,213671,213955,284,5,N,N,-,-1,-1
GLOVER.txt,213956,214335,379,5,N,N,-,-1,-1
GLOVER.txt,214336,214864,528,5,N,N,-,-1,-1
GLOVER.txt,214865,215502,637,5,N,N,-,-1,-1
GLOVER.txt,215505,216509,1004,5,N,N,-,-1,-1
GLOVER.txt,216510,217598,1088,5,N,N,-,-1,-1
GLOVER.txt,217600,218180,580,5,N,N,-,-1,-1
GLOVER.txt,218181,218822,641,5,N,N,-,-1,-1
GLOVER.txt,218823,219964,1141,5,N,N,-,-1,-1
GLOVER.txt,219967,220750,783,5,N,N,-,-1,-1
GLOVER.txt,220751,221599,848,5,N,N,-,-1,-1
GLOVER.txt,221600,222953,1353,5,N,N,-,-1,-1
GLOVER.txt,222956,223890,934,5,N,N,-,-1,-1
GLOVER.txt,223891,224860,969,5,N,N,-,-1,-1
GLOVER.txt,224862,225508,646,5,N,N,-,-1,-1
GLOVER.txt,225509,226202,693,5,N,N,-,-1,-1
GLOVER.txt,226205,227088,883,5,N,N,-,-1,-1
GLOVER.txt,227089,228187,1098,5,N,N,-,-1,-1
GLOVER.txt,228188,228587,399,5,N,N,-,-1,-1
GLOVER.txt,228588,229024,436,5,N,N,-,-1,-1
GLOVER.txt,229025,229612,587,5,N,N,-,-1,-1
GLOVER.txt,229613,230426,813,5,N,N,-,-1,-1
GLOVER.txt,230428,231285,857,5,N,N,-,-1,-1
GLOVER.txt,231286,231650,364,5,N,N,-,-1,-1
GLOVER.txt,231651,231972,321,5,N,N,-,-1,-1
GLOVER.txt,231973,232600,627,5,N,N,-,-1,-1
GLOVER.txt,232601,233799,1198,5,N,N,-,-1,-1
GLOVER.txt,233802,234569,767,5,N,N,-,-1,-1
GLOVER.txt,234572,235034,462,5,N,N,-,-1,-1
GLOVER.txt,235035,235533,498,5,N,N,-,-1,-1
GLOVER.txt,235534,236569,1035,5,N,N,-,-1,-1
GLOVER.txt,236570,237306,736,5,N,N,-,-1,-1
GLOVER.txt,237309,237786,477,5,N,N,-,-1,-1
GLOVER.txt,237787,238464,677,5,N,N,-,-1,-1
GLOVER.txt,238465,240133,1668,5,N,N,-,-1,-1
GLOVER.txt,240136,241127,991,5,N,N,-,-1,-1
GLOVER.txt,241130,242338,1208,5,N,N,-,-1,-1
GLOVER.txt,242341,243211,870,5,N,N,-,-1,-1
GLOVER.txt,243212,243299,87,5,N,N,-,-1,-1
GLOVER.txt,243300,243634,334,5,N,N,-,-1,-1
GLOVER.txt,243637,244643,1006,5,N,N,-,-1,-1
GLOVER.txt,244644,244897,253,5,N,N,-,-1,-1
GLOVER.txt,244898,245271,373,5,N,N,-,-1,-1
GLOVER.txt,245274,246164,890,5,N,N,-,-1,-1
GLOVER.txt,246165,247625,1460,5,N,N,-,-1,-1
GLOVER.txt,247626,248473,847,5,N,N,-,-1,-1
GLOVER.txt,248476,249393,917,5,N,N,-,-1,-1
GLOVER.txt,249394,250505,1111,5,N,N,-,-1,-1
GLOVER.txt,250507,251224,717,5,N,N,-,-1,-1
GLOVER.txt,251225,251710,485,5,N,N,-,-1,-1
GLOVER.txt,251711,252290,579,5,N,N,-,-1,-1
GLOVER.txt,252293,253488,1195,5,N,N,-,-1,-1
GLOVER.txt,253489,254173,684,5,N,N,-,-1,-1
GLOVER.txt,254174,254581,407,5,N,N,-,-1,-1
GLOVER.txt,254582,255329,747,5,N,N,-,-1,-1
GLOVER.txt,255330,256204,874,5,N,N,-,-1,-1
GLOVER.txt,256205,257102,897,5,N,N,-,-1,-1
GLOVER.txt,257105,257846,741,5,N,N,-,-1,-1
GLOVER.txt,257849,258594,745,5,N,N,-,-1,-1
GLOVER.txt,258597,259501,904,5,N,N,-,-1,-1
GLOVER.txt,259502,259797,295,5,N,N,-,-1,-1
GLOVER.txt,259798,260357,559,5,N,N,-,-1,-1
GLOVER.txt,260359,261105,746,5,N,N,-,-1,-1
GLOVER.txt,261106,261986,880,5,N,N,-,-1,-1
GLOVER.txt,261987,262561,574,5,N,N,-,-1,-1
GLOVER.txt,262566,263763,1197,5,N,N,-,-1,-1
GLOVER.txt,263764,264184,420,5,N,N,-,-1,-1
GLOVER.txt,264185,264694,509,5,N,N,-,-1,-1
GLOVER.txt,264695,265396,701,5,N,N,-,-1,-1
GLOVER.txt,265397,266281,884,5,N,N,-,-1,-1
GLOVER.txt,266282,267049,767,5,N,N,-,-1,-1
GLOVER.txt,267050,267333,283,5,N,N,-,-1,-1
GLOVER.txt,267336,268541,1205,5,N,N,-,-1,-1
GLOVER.txt,268542,269145,603,5,N,N,-,-1,-1
GLOVER.txt,269146,269800,654,5,N,N,-,-1,-1
GLOVER.txt,269803,270817,1014,5,N,N,-,-1,-1
GLOVER.txt,270818,271121,303,5,N,N,-,-1,-1
GLOVER.txt,271122,271515,393,5,N,N,-,-1,-1
GLOVER.txt,271516,272070,554,5,N,N,-,-1,-1
GLOVER.txt,272071,272851,780,5,N,N,-,-1,-1
GLOVER.txt,272854,273412,558,5,N,N,-,-1,-1
GLOVER.txt,273413,274202,789,5,N,N,-,-1,-1
GLOVER.txt,274203,275341,1138,5,N,N,-,-1,-1
GLOVER.txt,275342,275706,364,5,N,N,-,-1,-1
GLOVER.txt,275708,276311,603,5,N,N,-,-1,-1
GLOVER.txt,276312,277133,821,5,N,N,-,-1,-1
GLOVER.txt,277136,277942,806,5,N,N,-,-1,-1
GLOVER.txt,277943,278396,453,5,N,N,-,-1,-1
GLOVER.txt,278397,278905,508,5,N,N,-,-1,-1
GLOVER.txt,278908,279485,577,5,N,N,-,-1,-1
GLOVER.txt,279486,279807,321,5,N,N,-,-1,-1
GLOVER.txt,279808,280209,401,5,N,N,-,-1,-1
GLOVER.txt,280210,280417,207,5,N,N,-,-1,-1
GLOVER.txt,280418,281208,790,5,N,N,-,-1,-1
GLOVER.txt,281209,281705,496,5,N,N,-,-1,-1
GLOVER.txt,281707,282480,773,5,N,N,-,-1,-1
GLOVER.txt,282481,283995,1514,5,N,N,-,-1,-1
GLOVER.txt,283998,284469,471,5,N,N,-,-1,-1
GLOVER.txt,284470,285316,846,5,N,N,-,-1,-1
GLOVER.txt,285317,286696,1379,5,N,N,-,-1,-1
GLOVER.txt,286701,287874,1173,5,N,N,-,-1,-1
GLOVER.txt,287877,288505,628,5,N,N,-,-1,-1
GLOVER.txt,288506,288918,412,5,N,N,-,-1,-1
GLOVER.txt,288919,289778,859,5,N,N,-,-1,-1
GLOVER.txt,289779,290554,775,5,N,N,-,-1,-1
GLOVER.txt,290559,291328,769,5,N,N,-,-1,-1
GLOVER.txt,291331,291876,545,5,N,N,-,-1,-1
GLOVER.txt,291877,292038,161,5,N,N,-,-1,-1
GLOVER.txt,292040,292594,554,5,N,N,-,-1,-1
GLOVER.txt,292595,292907,312,5,N,N,-,-1,-1
GLOVER.txt,292908,293047,139,5,N,N,-,-1,-1
GLOVER.txt,293049,293268,219,5,N,N,-,-1,-1
GLOVER.txt,293269,293549,280,5,N,N,-,-1,-1
GLOVER.txt,293550,293947,397,5,N,N,-,-1,-1
GLOVER.txt,293948,294164,216,5,N,N,-,-1,-1
GLOVER.txt,294165,294684,519,5,N,N,-,-1,-1
GLOVER.txt,294685,295367,682,5,N,N,-,-1,-1
GLOVER.txt,295368,295764,396,5,N,N,-,-1,-1
GLOVER.txt,295765,296691,926,5,N,N,-,-1,-1
GLOVER.txt,296691,297223,532,5,N,N,-,-1,-1
GLOVER.txt,297224,297793,569,5,N,N,-,-1,-1
GLOVER.txt,297796,298125,329,5,N,N,-,-1,-1
GLOVER.txt,298126,298719,593,5,N,N,-,-1,-1
GLOVER.txt,298721,298941,220,5,N,N,-,-1,-1
GLOVER.txt,298942,299411,469,5,N,N,-,-1,-1
GLOVER.txt,299412,299677,265,5,N,N,-,-1,-1
GLOVER.txt,299678,300167,489,5,N,N,-,-1,-1
GLOVER.txt,300168,301051,883,5,N,N,-,-1,-1
GLOVER.txt,301052,301460,408,5,N,N,-,-1,-1
GLOVER.txt,301463,302025,562,5,N,N,-,-1,-1
GLOVER.txt,302026,302277,251,5,N,N,-,-1,-1
GLOVER.txt,302278,302783,505,5,N,N,-,-1,-1
GLOVER.txt,302784,303310,526,5,N,N,-,-1,-1
GLOVER.txt,303311,304051,740,5,N,N,-,-1,-1
GLOVER.txt,304052,304644,592,5,N,N,-,-1,-1
GLOVER.txt,304645,305337,692,5,N,N,-,-1,-1
GLOVER.txt,305338,306019,681,5,N,N,-,-1,-1
GLOVER.txt,306020,306957,937,5,N,N,-,-1,-1
GLOVER.txt,306960,307656,696,5,N,N,-,-1,-1
GLOVER.txt,307657,307783,126,5,N,N,-,-1,-1
GLOVER.txt,307786,308071,285,5,N,N,-,-1,-1
GLOVER.txt,308072,308339,267,5,N,N,-,-1,-1
GLOVER.txt,308340,308894,554,5,N,N,-,-1,-1
GLOVER.txt,308895,309545,650,5,N,N,-,-1,-1
GLOVER.txt,309546,310487,941,5,N,N,-,-1,-1
GLOVER.txt,310488,310988,500,5,N,N,-,-1,-1
GLOVER.txt,310989,312115,1126,5,N,N,-,-1,-1
GLOVER.txt,312116,313037,921,5,N,N,-,-1,-1
GLOVER.txt,313040,314041,1001,5,N,N,-,-1,-1
GLOVER.txt,314044,315009,965,5,N,N,-,-1,-1
GLOVER.txt,315010,315622,612,5,N,N,-,-1,-1
GLOVER.txt,315623,316314,691,5,N,N,-,-1,-1
GLOVER.txt,316315,317026,711,5,N,N,-,-1,-1
GLOVER.txt,317027,317397,370,5,N,N,-,-1,-1
GLOVER.txt,317398,318083,685,5,N,N,-,-1,-1
GLOVER.txt,318084,318986,902,5,N,N,-,-1,-1
GLOVER.txt,318987,319113,126,5,N,N,-,-1,-1
GLOVER.txt,319114,319329,215,5,N,N,-,-1,-1
GLOVER.txt,319330,320008,678,5,N,N,-,-1,-1
GLOVER.txt,320011,320999,988,5,N,N,-,-1,-1
GLOVER.txt,321000,321438,438,5,N,N,-,-1,-1
GLOVER.txt,321439,322198,759,5,N,N,-,-1,-1
GLOVER.txt,322199,322758,559,5,N,N,-,-1,-1
GLOVER.txt,322759,324014,1255,5,N,N,-,-1,-1
GLOVER.txt,324017,325299,1282,5,N,N,-,-1,-1
GLOVER.txt,325300,326037,737,5,N,N,-,-1,-1
GLOVER.txt,326038,326730,692,5,N,N,-,-1,-1
GLOVER.txt,326731,327514,783,5,N,N,-,-1,-1
GLOVER.txt,327515,328058,543,5,N,N,-,-1,-1
GLOVER.txt,328059,329345,1286,5,N,N,-,-1,-1
GLOVER.txt,329346,330302,956,5,N,N,-,-1,-1
GLOVER.txt,330303,331220,917,5,N,N,-,-1,-1
GLOVER.txt,331222,332096,874,5,N,N,-,-1,-1
GLOVER.txt,332097,333250,1153,5,N,N,-,-1,-1
GLOVER.txt,333253,334236,983,5,N,N,-,-1,-1
GLOVER.txt,334239,335682,1443,5,N,N,-,-1,-1
GLOVER.txt,335684,337038,1354,5,N,N,-,-1,-1
GLOVER.txt,337041,337636,595,5,N,N,-,-1,-1
GLOVER.txt,337637,338044,407,5,N,N,-,-1,-1
GLOVER.txt,338045,338639,594,5,N,N,-,-1,-1
GLOVER.txt,338640,339505,865,5,N,N,-,-1,-1
GLOVER.txt,339506,339770,264,5,N,N,-,-1,-1
GLOVER.txt,339776,339883,107,5,N,N,-,-1,-1
GLOVER.txt,339885,340502,617,5,N,N,-,-1,-1
GLOVER.txt,340503,341564,1061,5,N,N,-,-1,-1
GLOVER.txt,341565,342233,668,5,N,N,-,-1,-1
GLOVER.txt,342234,342518,284,5,N,N,-,-1,-1
GLOVER.txt,342519,343486,967,5,N,N,-,-1,-1
GLOVER.txt,343487,344011,524,5,N,N,-,-1,-1
GLOVER.txt,344012,344550,538,5,N,N,-,-1,-1
GLOVER.txt,344551,345268,717,5,N,N,-,-1,-1
GLOVER.txt,345269,345949,680,5,N,N,-,-1,-1
GLOVER.txt,345950,346614,664,5,N,N,-,-1,-1
GLOVER.txt,346615,347274,659,5,N,N,-,-1,-1
GLOVER.txt,347275,347836,561,5,N,N,-,-1,-1
GLOVER.txt,347837,348693,856,5,N,N,-,-1,-1
GLOVER.txt,348694,349515,821,5,N,N,-,-1,-1
GLOVER.txt,349516,350006,490,5,N,N,-,-1,-1
GLOVER.txt,350009,350565,556,5,N,N,-,-1,-1
GLOVER.txt,350566,350994,428,5,N,Y,1437471397525,350644,351290
GLOVER.txt,350995,351769,774,5,N,Y,1437471397525,350644,351290
GLOVER.txt,351770,352240,470,5,N,Y,1437471855423,351318,351853
GLOVER.txt,352241,353067,826,5,N,Y,1437472380836,351899,352666
GLOVER.txt,353069,353700,631,5,N,N,-,-1,-1
GLOVER.txt,353701,354423,722,5,N,N,-,-1,-1
GLOVER.txt,354425,354984,559,5,N,N,-,-1,-1
GLOVER.txt,354987,355939,952,5,N,N,-,-1,-1
GLOVER.txt,355940,356707,767,5,N,N,-,-1,-1
GLOVER.txt,356708,357278,570,5,N,N,-,-1,-1
GLOVER.txt,357279,357994,715,5,N,N,-,-1,-1
GLOVER.txt,357995,358878,883,5,N,N,-,-1,-1
GLOVER.txt,358881,359057,176,5,N,N,-,-1,-1
GLOVER.txt,359060,359918,858,5,N,N,-,-1,-1
GLOVER.txt,359919,360784,865,5,N,N,-,-1,-1
GLOVER.txt,360785,361983,1198,5,Y,N,-,-1,-1
GLOVER.txt,361985,362820,835,5,N,N,-,-1,-1
GLOVER.txt,362825,363232,407,5,N,N,-,-1,-1
GLOVER.txt,363233,363689,456,5,N,N,-,-1,-1
GLOVER.txt,363690,364108,418,5,N,N,-,-1,-1
GLOVER.txt,364109,364506,397,5,N,N,-,-1,-1
GLOVER.txt,364507,365328,821,5,N,N,-,-1,-1
GLOVER.txt,365329,366103,774,5,N,N,-,-1,-1
GLOVER.txt,366104,367635,1531,5,N,N,-,-1,-1
GLOVER.txt,367638,369058,1420,5,N,N,-,-1,-1
GLOVER.txt,369059,369764,705,5,N,N,-,-1,-1
GLOVER.txt,369765,370387,622,5,N,N,-,-1,-1
GLOVER.txt,370390,371150,760,5,N,N,-,-1,-1
GLOVER.txt,371153,371943,790,5,N,N,-,-1,-1
GLOVER.txt,371946,372746,800,5,N,N,-,-1,-1
GLOVER.txt,372749,372929,180,5,N,N,-,-1,-1
GLOVER.txt,372932,373288,356,5,N,N,-,-1,-1
GLOVER.txt,373289,373969,680,5,N,N,-,-1,-1
GLOVER.txt,373970,374867,897,5,N,N,-,-1,-1
GLOVER.txt,374868,375606,738,5,N,N,-,-1,-1
GLOVER.txt,375609,376713,1104,5,N,N,-,-1,-1
GLOVER.txt,376715,377541,826,5,N,N,-,-1,-1
GLOVER.txt,377542,377882,340,5,N,N,-,-1,-1
GLOVER.txt,377883,378456,573,5,N,N,-,-1,-1
GLOVER.txt,378458,379390,932,5,N,N,-,-1,-1
GLOVER.txt,379391,380049,658,5,N,N,-,-1,-1
GLOVER.txt,380050,380915,865,5,N,N,-,-1,-1
GLOVER.txt,380916,381421,505,5,N,N,-,-1,-1
GLOVER.txt,381422,382393,971,5,N,N,-,-1,-1
GLOVER.txt,382394,383021,627,5,N,N,-,-1,-1
GLOVER.txt,383022,383555,533,5,N,N,-,-1,-1
GLOVER.txt,383556,384323,767,5,N,N,-,-1,-1
GLOVER.txt,384325,384987,662,5,N,N,-,-1,-1
GLOVER.txt,384988,386001,1013,5,N,N,-,-1,-1
GLOVER.txt,386002,386489,487,5,N,N,-,-1,-1
GLOVER.txt,386490,387291,801,5,N,N,-,-1,-1
GLOVER.txt,387292,387548,256,5,N,N,-,-1,-1
GLOVER.txt,387549,388543,994,5,N,N,-,-1,-1
GLOVER.txt,388544,389025,481,5,N,N,-,-1,-1
GLOVER.txt,389026,389444,418,5,N,N,-,-1,-1
GLOVER.txt,389445,390136,691,5,N,N,-,-1,-1
GLOVER.txt,390137,390669,532,5,N,N,-,-1,-1
GLOVER.txt,390670,391274,604,5,N,N,-,-1,-1
GLOVER.txt,391275,391997,722,5,N,N,-,-1,-1
GLOVER.txt,391998,392627,629,5,N,N,-,-1,-1
GLOVER.txt,392628,393662,1034,5,N,N,-,-1,-1
GLOVER.txt,393664,394414,750,5,N,N,-,-1,-1
GLOVER.txt,394415,395334,919,5,N,Y,1437472966198,394609,395892
GLOVER.txt,395337,395977,640,5,N,Y,1437472966198,394609,395892
GLOVER.txt,395980,396787,807,5,N,N,-,-1,-1
GLOVER.txt,396788,397360,572,5,N,N,-,-1,-1
GLOVER.txt,397361,398268,907,5,N,N,-,-1,-1
GLOVER.txt,398270,398784,514,5,N,N,-,-1,-1
GLOVER.txt,398785,399079,294,5,N,N,-,-1,-1
GLOVER.txt,399080,399664,584,5,N,N,-,-1,-1
GLOVER.txt,399665,400579,914,5,N,N,-,-1,-1
GLOVER.txt,400580,401662,1082,5,N,N,-,-1,-1
GLOVER.txt,401665,402676,1011,5,N,N,-,-1,-1
GLOVER.txt,402677,403278,601,5,N,N,-,-1,-1
GLOVER.txt,403280,404128,848,5,N,N,-,-1,-1
GLOVER.txt,404129,404961,832,5,N,N,-,-1,-1
GLOVER.txt,404962,405474,512,5,N,N,-,-1,-1
GLOVER.txt,405475,406676,1201,5,N,N,-,-1,-1
GLOVER.txt,406681,407082,401,5,N,N,-,-1,-1
GLOVER.txt,407083,407840,757,5,N,N,-,-1,-1
GLOVER.txt,407841,408440,599,5,N,N,-,-1,-1
GLOVER.txt,408442,409443,1001,5,N,N,-,-1,-1
GLOVER.txt,409446,410491,1045,5,N,N,-,-1,-1
GLOVER.txt,410492,411467,975,5,N,N,-,-1,-1
GLOVER.txt,411468,412109,641,5,N,N,-,-1,-1
GLOVER.txt,412112,412846,734,5,N,N,-,-1,-1
GLOVER.txt,412849,413660,811,5,N,N,-,-1,-1
GLOVER.txt,413661,414453,792,5,N,N,-,-1,-1
GLOVER.txt,414456,415485,1029,5,N,N,-,-1,-1
GLOVER.txt,415487,415942,455,5,N,N,-,-1,-1
GLOVER.txt,415945,416258,313,5,N,N,-,-1,-1
GLOVER.txt,416261,416503,242,5,N,N,-,-1,-1
GLOVER.txt,416506,417677,1171,5,N,N,-,-1,-1
GLOVER.txt,417678,418549,871,5,N,N,-,-1,-1
GLOVER.txt,418550,420047,1497,5,N,N,-,-1,-1
GLOVER.txt,420048,420873,825,5,N,N,-,-1,-1
GLOVER.txt,420874,421137,263,5,N,N,-,-1,-1
GLOVER.txt,421138,421259,121,5,N,N,-,-1,-1
GLOVER.txt,421262,421732,470,5,N,N,-,-1,-1
GLOVER.txt,421735,422581,846,5,N,N,-,-1,-1
GLOVER.txt,422582,423080,498,5,N,N,-,-1,-1
GLOVER.txt,423081,424141,1060,5,N,N,-,-1,-1
GLOVER.txt,424142,424679,537,5,N,N,-,-1,-1
GLOVER.txt,424680,425152,472,5,N,N,-,-1,-1
GLOVER.txt,425153,425463,310,5,N,N,-,-1,-1
GLOVER.txt,425464,425629,165,5,N,N,-,-1,-1
GLOVER.txt,425630,426017,387,5,N,N,-,-1,-1
GLOVER.txt,426018,426505,487,5,N,N,-,-1,-1
GLOVER.txt,426506,426683,177,5,N,N,-,-1,-1
GLOVER.txt,426684,426979,295,5,N,N,-,-1,-1
GLOVER.txt,426980,427238,258,5,N,N,-,-1,-1
GLOVER.txt,427239,427495,256,5,N,N,-,-1,-1
GLOVER.txt,427496,427791,295,5,N,N,-,-1,-1
GLOVER.txt,427792,428532,740,5,N,N,-,-1,-1
GLOVER.txt,428533,429039,506,5,N,N,-,-1,-1
GLOVER.txt,429040,429080,40,5,N,N,-,-1,-1
GLOVER.txt,429081,429187,106,5,N,N,-,-1,-1
GLOVER.txt,429188,429460,272,5,N,N,-,-1,-1
GLOVER.txt,429461,430567,1106,5,N,N,-,-1,-1
GLOVER.txt,430569,431413,844,5,N,N,-,-1,-1
GLOVER.txt,431416,432112,696,5,N,N,-,-1,-1
GLOVER.txt,432113,432759,646,5,N,N,-,-1,-1
GLOVER.txt,432760,433692,932,5,N,N,-,-1,-1
GLOVER.txt,433693,434326,633,5,N,N,-,-1,-1
GLOVER.txt,434328,435037,709,5,N,N,-,-1,-1
GLOVER.txt,435038,435552,514,5,N,N,-,-1,-1
GLOVER.txt,435553,436406,853,5,N,N,-,-1,-1
GLOVER.txt,436407,437002,595,5,N,N,-,-1,-1
GLOVER.txt,437003,438348,1345,5,N,N,-,-1,-1
GLOVER.txt,438351,439565,1214,5,N,N,-,-1,-1
GLOVER.txt,439566,440793,1227,5,N,N,-,-1,-1
GLOVER.txt,440793,441822,1029,5,N,N,-,-1,-1
GLOVER.txt,441823,442569,746,5,N,N,-,-1,-1
GLOVER.txt,442572,443532,960,5,N,N,-,-1,-1
GLOVER.txt,443534,444843,1309,5,N,N,-,-1,-1
GLOVER.txt,444844,445694,850,5,N,N,-,-1,-1
GLOVER.txt,445695,446378,683,5,N,N,-,-1,-1
GLOVER.txt,446379,447292,913,5,N,N,-,-1,-1
GLOVER.txt,447293,447967,674,5,N,N,-,-1,-1
GLOVER.txt,447969,448588,619,5,N,N,-,-1,-1
GLOVER.txt,448589,449274,685,5,N,N,-,-1,-1
GLOVER.txt,449277,449997,720,5,N,N,-,-1,-1
GLOVER.txt,449998,450952,954,5,N,N,-,-1,-1
GLOVER.txt,450952,451811,859,5,N,N,-,-1,-1
GLOVER.txt,451812,452635,823,5,N,N,-,-1,-1
GLOVER.txt,452638,453770,1132,5,N,N,-,-1,-1
GLOVER.txt,453772,455236,1464,5,N,N,-,-1,-1
GLOVER.txt,455238,455654,416,5,N,N,-,-1,-1
GLOVER.txt,455655,456974,1319,5,N,N,-,-1,-1
GLOVER.txt,456977,457704,727,5,N,N,-,-1,-1
GLOVER.txt,457705,458075,370,5,N,N,-,-1,-1
GLOVER.txt,458076,458526,450,5,N,N,-,-1,-1
GLOVER.txt,458527,459224,697,5,N,N,-,-1,-1
GLOVER.txt,459225,459856,631,5,N,N,-,-1,-1
GLOVER.txt,459857,460085,228,5,N,N,-,-1,-1
GLOVER.txt,460087,460829,742,5,N,N,-,-1,-1
GLOVER.txt,460830,462096,1266,5,N,N,-,-1,-1
GLOVER.txt,462099,462788,689,5,N,N,-,-1,-1
GLOVER.txt,462789,463208,419,5,N,N,-,-1,-1
GLOVER.txt,463209,463779,570,5,N,N,-,-1,-1
GLOVER.txt,463782,465054,1272,5,N,N,-,-1,-1
GLOVER.txt,465055,465945,890,5,N,N,-,-1,-1
GLOVER.txt,465946,466563,617,5,N,N,-,-1,-1
GLOVER.txt,466564,466920,356,5,N,N,-,-1,-1
GLOVER.txt,466922,467539,617,5,N,N,-,-1,-1
GLOVER.txt,467540,467906,366,5,N,N,-,-1,-1
GLOVER.txt,467907,468519,612,5,N,N,-,-1,-1
GLOVER.txt,468522,469241,719,5,N,N,-,-1,-1
GLOVER.txt,469242,470148,906,5,N,N,-,-1,-1
GLOVER.txt,470151,471442,1291,5,N,N,-,-1,-1
GLOVER.txt,471445,472660,1215,5,N,N,-,-1,-1
GLOVER.txt,472661,473014,353,5,N,N,-,-1,-1
GLOVER.txt,473017,474020,1003,5,N,N,-,-1,-1
GLOVER.txt,474021,474579,558,5,N,N,-,-1,-1
GLOVER.txt,474580,474938,358,5,N,N,-,-1,-1
GLOVER.txt,474939,475631,692,5,N,N,-,-1,-1
GLOVER.txt,475632,475812,180,5,N,N,-,-1,-1
GLOVER.txt,475813,476066,253,5,N,N,-,-1,-1
GLOVER.txt,476067,476277,210,5,N,N,-,-1,-1
GLOVER.txt,476280,476405,125,5,N,N,-,-1,-1
GLOVER.txt,476406,476588,182,5,N,N,-,-1,-1
GLOVER.txt,476591,476845,254,5,N,N,-,-1,-1
GLOVER.txt,476846,477495,649,5,N,N,-,-1,-1
GLOVER.txt,477496,478304,808,5,N,N,-,-1,-1
GLOVER.txt,478305,479012,707,5,N,N,-,-1,-1
GLOVER.txt,479014,480351,1337,5,N,N,-,-1,-1
GLOVER.txt,480354,481382,1028,5,N,N,-,-1,-1
GLOVER.txt,481387,482579,1192,5,N,N,-,-1,-1
GLOVER.txt,482580,483500,920,5,N,N,-,-1,-1
GLOVER.txt,483501,484338,837,5,N,N,-,-1,-1
GLOVER.txt,484341,484576,235,5,N,N,-,-1,-1
GLOVER.txt,484577,484723,146,5,N,N,-,-1,-1
GLOVER.txt,484726,485031,305,5,N,N,-,-1,-1
GLOVER.txt,485034,485368,334,5,N,N,-,-1,-1
GLOVER.txt,485371,485855,484,5,N,N,-,-1,-1
GLOVER.txt,485860,486515,655,5,N,N,-,-1,-1
GLOVER.txt,486516,486862,346,5,N,N,-,-1,-1
GLOVER.txt,486863,487190,327,5,N,N,-,-1,-1
GLOVER.txt,487193,487692,499,5,N,N,-,-1,-1
GLOVER.txt,487693,487815,122,5,N,N,-,-1,-1
GLOVER.txt,487816,488126,310,5,N,N,-,-1,-1
GLOVER.txt,488127,488434,307,5,N,N,-,-1,-1
GLOVER.txt,488435,488741,306,5,N,N,-,-1,-1
GLOVER.txt,488744,489010,266,5,N,N,-,-1,-1
GLOVER.txt,489011,489716,705,5,N,N,-,-1,-1
GLOVER.txt,489717,490279,562,5,N,N,-,-1,-1
GLOVER.txt,490280,490510,230,5,N,N,-,-1,-1
GLOVER.txt,490511,490715,204,5,N,N,-,-1,-1
GLOVER.txt,490716,491048,332,5,N,N,-,-1,-1
GLOVER.txt,491049,491340,291,5,N,N,-,-1,-1
GLOVER.txt,491341,491601,260,5,N,N,-,-1,-1
GLOVER.txt,491604,491790,186,5,N,N,-,-1,-1
GLOVER.txt,491791,492283,492,5,N,N,-,-1,-1
GLOVER.txt,492284,492492,208,5,N,N,-,-1,-1
GLOVER.txt,492493,492784,291,5,N,N,-,-1,-1
GLOVER.txt,492785,493082,297,5,N,N,-,-1,-1
GLOVER.txt,493083,493347,264,5,N,N,-,-1,-1
GLOVER.txt,493350,493582,232,5,N,N,-,-1,-1
GLOVER.txt,493585,493846,261,5,N,N,-,-1,-1
GLOVER.txt,493847,494078,231,5,N,N,-,-1,-1
GLOVER.txt,494079,495579,1500,5,N,N,-,-1,-1
GLOVER.txt,495580,495883,303,5,N,N,-,-1,-1
GLOVER.txt,495884,496058,174,5,N,N,-,-1,-1
GLOVER.txt,496059,496742,683,5,N,N,-,-1,-1
GLOVER.txt,496743,497222,479,5,N,N,-,-1,-1
GLOVER.txt,497227,497343,116,5,N,N,-,-1,-1
GLOVER.txt,497345,497460,115,5,N,N,-,-1,-1
GLOVER.txt,497462,497584,122,5,N,N,-,-1,-1
GLOVER.txt,497589,497727,138,5,N,N,-,-1,-1
GLOVER.txt,497730,497805,75,5,N,N,-,-1,-1
GLOVER.txt,497808,497945,137,5,N,N,-,-1,-1
GLOVER.txt,497948,498046,98,5,N,N,-,-1,-1
GLOVER.txt,498049,498130,81,5,N,N,-,-1,-1
GLOVER.txt,498133,498196,63,5,N,N,-,-1,-1
GLOVER.txt,498197,498938,741,5,N,N,-,-1,-1
GLOVER.txt,498941,499430,489,5,N,N,-,-1,-1
GLOVER.txt,499431,500682,1251,5,N,N,-,-1,-1
GLOVER.txt,500683,501408,725,5,N,N,-,-1,-1
GLOVER.txt,501409,502245,836,5,N,N,-,-1,-1
GLOVER.txt,502246,502921,675,5,N,N,-,-1,-1
GLOVER.txt,502922,503495,573,5,N,N,-,-1,-1
GLOVER.txt,503496,504379,883,5,N,N,-,-1,-1
GLOVER.txt,504380,504916,536,5,N,N,-,-1,-1
GLOVER.txt,504917,505374,457,5,N,N,-,-1,-1
GLOVER.txt,505375,506134,759,5,N,N,-,-1,-1
GLOVER.txt,506135,506980,845,5,N,N,-,-1,-1
GLOVER.txt,506985,507340,355,5,N,N,-,-1,-1
GLOVER.txt,507341,507743,402,5,N,N,-,-1,-1
GLOVER.txt,507746,508072,326,5,N,N,-,-1,-1
GLOVER.txt,508073,508343,270,5,N,N,-,-1,-1
GLOVER.txt,508344,509001,657,5,N,N,-,-1,-1
GLOVER.txt,509002,510300,1298,5,N,N,-,-1,-1
GLOVER.txt,510301,510763,462,5,N,N,-,-1,-1
GLOVER.txt,510764,511107,343,5,N,N,-,-1,-1
GLOVER.txt,511108,512095,987,5,N,N,-,-1,-1
GLOVER.txt,512096,512476,380,5,N,N,-,-1,-1
GLOVER.txt,512477,515312,2835,5,N,N,-,-1,-1
GLOVER.txt,515314,526494,11180,5,N,N,-,-1,-1
GLOVER.txt,526495,526992,497,5,N,N,-,-1,-1
GRONOW.txt,0,366,366,5,N,N,-,-1,-1
GRONOW.txt,371,599,228,5,N,N,-,-1,-1
GRONOW.txt,602,1248,646,5,N,N,-,-1,-1
GRONOW.txt,1253,1501,248,5,N,N,-,-1,-1
GRONOW.txt,1504,2152,648,5,N,N,-,-1,-1
GRONOW.txt,2155,3182,1027,5,N,N,-,-1,-1
GRONOW.txt,3183,3568,385,5,N,N,-,-1,-1
GRONOW.txt,3569,3749,180,5,N,N,-,-1,-1
GRONOW.txt,3752,4266,514,5,N,N,-,-1,-1
GRONOW.txt,4268,5540,1272,5,N,N,-,-1,-1
GRONOW.txt,5541,7547,2006,5,N,N,-,-1,-1
GRONOW.txt,7548,7993,445,5,N,N,-,-1,-1
GRONOW.txt,7994,8496,502,5,N,N,-,-1,-1
GRONOW.txt,8497,9014,517,5,N,N,-,-1,-1
GRONOW.txt,9016,9512,496,5,N,N,-,-1,-1
GRONOW.txt,9513,10632,1119,5,N,N,-,-1,-1
GRONOW.txt,10635,11248,613,5,N,N,-,-1,-1
GRONOW.txt,11249,12335,1086,5,N,N,-,-1,-1
GRONOW.txt,12338,13224,886,5,N,N,-,-1,-1
GRONOW.txt,13225,14151,926,5,N,N,-,-1,-1
GRONOW.txt,14154,15065,911,5,N,N,-,-1,-1
GRONOW.txt,15066,16326,1260,5,N,N,-,-1,-1
GRONOW.txt,16329,17279,950,5,N,N,-,-1,-1
GRONOW.txt,17282,18219,937,5,N,N,-,-1,-1
GRONOW.txt,18224,18948,724,5,N,N,-,-1,-1
GRONOW.txt,18949,20063,1114,5,N,N,-,-1,-1
GRONOW.txt,20066,20916,850,5,N,N,-,-1,-1
GRONOW.txt,20919,21877,958,5,N,N,-,-1,-1
GRONOW.txt,21878,22355,477,5,N,N,-,-1,-1
GRONOW.txt,22356,23233,877,5,N,N,-,-1,-1
GRONOW.txt,23236,23963,727,5,N,N,-,-1,-1
GRONOW.txt,23964,24848,884,5,N,N,-,-1,-1
GRONOW.txt,24849,25759,910,5,N,N,-,-1,-1
GRONOW.txt,25760,26525,765,5,N,N,-,-1,-1
GRONOW.txt,26526,27032,506,5,N,N,-,-1,-1
GRONOW.txt,27033,28008,975,5,N,N,-,-1,-1
GRONOW.txt,28009,28760,751,5,N,N,-,-1,-1
GRONOW.txt,28761,29961,1200,5,N,N,-,-1,-1
GRONOW.txt,29962,31128,1166,5,N,N,-,-1,-1
GRONOW.txt,31129,32298,1169,5,N,N,-,-1,-1
GRONOW.txt,32301,33255,954,5,N,N,-,-1,-1
GRONOW.txt,33257,34021,764,5,N,N,-,-1,-1
GRONOW.txt,34022,34911,889,5,N,N,-,-1,-1
GRONOW.txt,34916,35747,831,5,N,N,-,-1,-1
GRONOW.txt,35748,36888,1140,5,N,N,-,-1,-1
GRONOW.txt,36889,37743,854,5,N,N,-,-1,-1
GRONOW.txt,37744,38636,892,5,N,N,-,-1,-1
GRONOW.txt,38637,39703,1066,5,N,N,-,-1,-1
GRONOW.txt,39704,40144,440,5,N,N,-,-1,-1
GRONOW.txt,40145,40821,676,5,N,N,-,-1,-1
GRONOW.txt,40822,41742,920,5,N,N,-,-1,-1
GRONOW.txt,41745,42368,623,5,N,N,-,-1,-1
GRONOW.txt,42369,42706,337,5,N,N,-,-1,-1
GRONOW.txt,42707,43463,756,5,N,N,-,-1,-1
GRONOW.txt,43464,44506,1042,5,N,N,-,-1,-1
GRONOW.txt,44508,44988,480,5,N,N,-,-1,-1
GRONOW.txt,44989,45481,492,5,N,N,-,-1,-1
GRONOW.txt,45482,46001,519,5,N,N,-,-1,-1
GRONOW.txt,46002,46772,770,5,N,N,-,-1,-1
GRONOW.txt,46775,47271,496,5,N,N,-,-1,-1
GRONOW.txt,47273,47755,482,5,N,N,-,-1,-1
GRONOW.txt,47756,48548,792,5,N,N,-,-1,-1
GRONOW.txt,48549,49255,706,5,N,N,-,-1,-1
GRONOW.txt,49256,50045,789,5,N,N,-,-1,-1
GRONOW.txt,50046,50717,671,5,N,N,-,-1,-1
GRONOW.txt,50718,51487,769,5,N,N,-,-1,-1
GRONOW.txt,51488,52214,726,5,N,N,-,-1,-1
GRONOW.txt,52215,53007,792,5,N,N,-,-1,-1
GRONOW.txt,53008,53784,776,5,N,N,-,-1,-1
GRONOW.txt,53786,54619,833,5,N,N,-,-1,-1
GRONOW.txt,54622,55378,756,5,N,N,-,-1,-1
GRONOW.txt,55379,56200,821,5,N,N,-,-1,-1
GRONOW.txt,56201,57038,837,5,N,N,-,-1,-1
GRONOW.txt,57039,57889,850,5,N,N,-,-1,-1
GRONOW.txt,57890,58834,944,5,N,N,-,-1,-1
GRONOW.txt,58839,59313,474,5,N,N,-,-1,-1
GRONOW.txt,59314,59828,514,5,N,N,-,-1,-1
GRONOW.txt,59829,60825,996,5,N,N,-,-1,-1
GRONOW.txt,60826,61519,693,5,N,N,-,-1,-1
GRONOW.txt,61520,62465,945,5,N,N,-,-1,-1
GRONOW.txt,62466,63250,784,5,N,N,-,-1,-1
GRONOW.txt,63251,64091,840,5,N,N,-,-1,-1
GRONOW.txt,64094,64872,778,5,N,N,-,-1,-1
GRONOW.txt,64873,65720,847,5,N,N,-,-1,-1
GRONOW.txt,65721,66085,364,5,N,N,-,-1,-1
GRONOW.txt,66086,66591,505,5,N,N,-,-1,-1
GRONOW.txt,66592,67264,672,5,N,N,-,-1,-1
GRONOW.txt,67267,67789,522,5,N,N,-,-1,-1
GRONOW.txt,67792,68243,451,5,N,N,-,-1,-1
GRONOW.txt,68245,68660,415,5,N,N,-,-1,-1
GRONOW.txt,68662,68845,183,5,N,N,-,-1,-1
GRONOW.txt,68846,69645,799,5,N,N,-,-1,-1
GRONOW.txt,69646,70401,755,5,N,N,-,-1,-1
GRONOW.txt,70404,70900,496,5,N,N,-,-1,-1
GRONOW.txt,70901,71990,1089,5,N,N,-,-1,-1
GRONOW.txt,71993,72252,259,5,N,N,-,-1,-1
GRONOW.txt,72253,72976,723,5,N,N,-,-1,-1
GRONOW.txt,72979,73781,802,5,N,N,-,-1,-1
GRONOW.txt,73782,74804,1022,5,N,N,-,-1,-1
GRONOW.txt,74805,75210,405,5,N,N,-,-1,-1
GRONOW.txt,75211,76009,798,5,N,N,-,-1,-1
GRONOW.txt,76010,76913,903,5,N,N,-,-1,-1
GRONOW.txt,76916,77678,762,5,N,N,-,-1,-1
GRONOW.txt,77679,78668,989,5,N,N,-,-1,-1
GRONOW.txt,78669,79663,994,5,N,N,-,-1,-1
GRONOW.txt,79664,80928,1264,5,N,N,-,-1,-1
GRONOW.txt,80931,82045,1114,5,N,N,-,-1,-1
GRONOW.txt,82046,82562,516,5,N,N,-,-1,-1
GRONOW.txt,82563,83432,869,5,N,N,-,-1,-1
GRONOW.txt,83433,84277,844,5,N,N,-,-1,-1
GRONOW.txt,84278,85113,835,5,N,N,-,-1,-1
GRONOW.txt,85116,85838,722,5,N,N,-,-1,-1
GRONOW.txt,85839,87099,1260,5,N,N,-,-1,-1
GRONOW.txt,87104,87927,823,5,N,N,-,-1,-1
GRONOW.txt,87928,88559,631,5,N,N,-,-1,-1
GRONOW.txt,88560,89261,701,5,N,N,-,-1,-1
GRONOW.txt,89263,89770,507,5,N,N,-,-1,-1
GRONOW.txt,89771,90400,629,5,N,N,-,-1,-1
GRONOW.txt,90401,91377,976,5,N,N,-,-1,-1
GRONOW.txt,91378,93289,1911,5,N,N,-,-1,-1
GRONOW.txt,93290,94038,748,5,N,N,-,-1,-1
GRONOW.txt,94041,94730,689,5,N,N,-,-1,-1
GRONOW.txt,94732,95475,743,5,N,N,-,-1,-1
GRONOW.txt,95476,96113,637,5,N,N,-,-1,-1
GRONOW.txt,96114,96764,650,5,N,N,-,-1,-1
GRONOW.txt,96765,97358,593,5,N,N,-,-1,-1
GRONOW.txt,97359,98454,1095,5,N,N,-,-1,-1
GRONOW.txt,98456,99462,1006,5,N,Y,1437475017618,98942,100041
GRONOW.txt,99463,100488,1025,5,N,Y,1437475017618,98942,100041
GRONOW.txt,100489,101155,666,5,N,N,-,-1,-1
GRONOW.txt,101156,101980,824,5,N,N,-,-1,-1
GRONOW.txt,101981,102983,1002,5,N,N,-,-1,-1
GRONOW.txt,102986,103667,681,5,N,N,-,-1,-1
GRONOW.txt,103668,104361,693,5,N,N,-,-1,-1
GRONOW.txt,104364,105371,1007,5,N,N,-,-1,-1
GRONOW.txt,105373,106382,1009,5,N,N,-,-1,-1
GRONOW.txt,106383,107494,1111,5,N,N,-,-1,-1
GRONOW.txt,107499,108181,682,5,N,N,-,-1,-1
GRONOW.txt,108183,109138,955,5,N,N,-,-1,-1
GRONOW.txt,109139,109895,756,5,N,N,-,-1,-1
GRONOW.txt,109896,110780,884,5,N,N,-,-1,-1
GRONOW.txt,110781,112303,1522,5,N,N,-,-1,-1
GRONOW.txt,112304,113479,1175,5,N,N,-,-1,-1
GRONOW.txt,113480,114151,671,5,N,N,-,-1,-1
GRONOW.txt,114156,114605,449,5,N,N,-,-1,-1
GRONOW.txt,114606,115340,734,5,N,N,-,-1,-1
GRONOW.txt,115342,116495,1153,5,N,N,-,-1,-1
GRONOW.txt,116498,117633,1135,5,N,N,-,-1,-1
GRONOW.txt,117636,119001,1365,5,N,N,-,-1,-1
GRONOW.txt,119002,119823,821,5,N,N,-,-1,-1
GRONOW.txt,119824,120642,818,5,N,N,-,-1,-1
GRONOW.txt,120643,121223,580,5,N,N,-,-1,-1
GRONOW.txt,121225,122132,907,5,N,N,-,-1,-1
GRONOW.txt,122133,122738,605,5,N,N,-,-1,-1
GRONOW.txt,122739,123388,649,5,N,N,-,-1,-1
GRONOW.txt,123389,124214,825,5,N,N,-,-1,-1
GRONOW.txt,124215,124489,274,5,N,N,-,-1,-1
GRONOW.txt,124490,125056,566,5,N,N,-,-1,-1
GRONOW.txt,125057,126251,1194,5,N,N,-,-1,-1
GRONOW.txt,126252,126994,742,5,N,N,-,-1,-1
GRONOW.txt,126995,127983,988,5,N,N,-,-1,-1
GRONOW.txt,127984,128942,958,5,N,N,-,-1,-1
GRONOW.txt,128943,129912,969,5,N,N,-,-1,-1
GRONOW.txt,129915,131089,1174,5,N,N,-,-1,-1
GRONOW.txt,131092,131967,875,5,N,N,-,-1,-1
GRONOW.txt,131968,133066,1098,5,N,N,-,-1,-1
GRONOW.txt,133067,134113,1046,5,N,N,-,-1,-1
GRONOW.txt,134114,134992,878,5,N,N,-,-1,-1
GRONOW.txt,134993,135722,729,5,N,N,-,-1,-1
GRONOW.txt,135723,136639,916,5,N,N,-,-1,-1
GRONOW.txt,136640,137186,546,5,N,N,-,-1,-1
GRONOW.txt,137187,137743,556,5,N,N,-,-1,-1
GRONOW.txt,137744,138367,623,5,N,N,-,-1,-1
GRONOW.txt,138368,139206,838,5,N,N,-,-1,-1
GRONOW.txt,139207,139777,570,5,N,N,-,-1,-1
GRONOW.txt,139778,140114,336,5,N,N,-,-1,-1
GRONOW.txt,140115,140822,707,5,N,N,-,-1,-1
GRONOW.txt,140823,141874,1051,5,N,N,-,-1,-1
GRONOW.txt,141875,143180,1305,5,N,N,-,-1,-1
GRONOW.txt,143183,143636,453,5,N,N,-,-1,-1
GRONOW.txt,143637,144337,700,5,N,N,-,-1,-1
GRONOW.txt,144338,144849,511,5,N,N,-,-1,-1
GRONOW.txt,144852,146099,1247,5,N,N,-,-1,-1
GRONOW.txt,146100,146628,528,5,N,N,-,-1,-1
GRONOW.txt,146629,147915,1286,5,N,N,-,-1,-1
GRONOW.txt,147916,148877,961,5,N,N,-,-1,-1
GRONOW.txt,148879,150336,1457,5,N,N,-,-1,-1
GRONOW.txt,150339,151375,1036,5,N,N,-,-1,-1
GRONOW.txt,151376,152095,719,5,N,N,-,-1,-1
GRONOW.txt,152096,153309,1213,5,N,N,-,-1,-1
GRONOW.txt,153311,154642,1331,5,N,N,-,-1,-1
GRONOW.txt,154644,155067,423,5,N,N,-,-1,-1
GRONOW.txt,155072,156161,1089,5,N,N,-,-1,-1
GRONOW.txt,156162,156900,738,5,N,N,-,-1,-1
GRONOW.txt,156901,157885,984,5,N,N,-,-1,-1
GRONOW.txt,157886,158808,922,5,N,N,-,-1,-1
GRONOW.txt,158811,159986,1175,5,N,N,-,-1,-1
GRONOW.txt,159987,160560,573,5,N,N,-,-1,-1
GRONOW.txt,160563,161471,908,5,N,N,-,-1,-1
GRONOW.txt,161472,162552,1080,5,N,N,-,-1,-1
GRONOW.txt,162553,163144,591,5,N,N,-,-1,-1
GRONOW.txt,163145,163966,821,5,N,N,-,-1,-1
GRONOW.txt,163967,165071,1104,5,N,N,-,-1,-1
GRONOW.txt,165072,165944,872,5,N,N,-,-1,-1
GRONOW.txt,165945,167050,1105,5,N,N,-,-1,-1
GRONOW.txt,167051,167703,652,5,N,N,-,-1,-1
GRONOW.txt,167704,168601,897,5,N,N,-,-1,-1
GRONOW.txt,168602,169531,929,5,N,N,-,-1,-1
GRONOW.txt,169532,170023,491,5,N,N,-,-1,-1
GRONOW.txt,170024,170846,822,5,N,N,-,-1,-1
GRONOW.txt,170847,172192,1345,5,Y,N,-,-1,-1
GRONOW.txt,172197,173579,1382,5,N,N,-,-1,-1
GRONOW.txt,173580,174613,1033,5,N,N,-,-1,-1
GRONOW.txt,174614,175572,958,5,N,N,-,-1,-1
GRONOW.txt,175577,176744,1167,5,N,N,-,-1,-1
GRONOW.txt,176745,177657,912,5,N,N,-,-1,-1
GRONOW.txt,177659,178471,812,5,N,N,-,-1,-1
GRONOW.txt,178472,178899,427,5,N,N,-,-1,-1
GRONOW.txt,178900,179483,583,5,N,N,-,-1,-1
GRONOW.txt,179484,180363,879,5,N,N,-,-1,-1
GRONOW.txt,180364,181047,683,5,N,N,-,-1,-1
GRONOW.txt,181048,181989,941,5,N,N,-,-1,-1
GRONOW.txt,181991,182430,439,5,N,N,-,-1,-1
GRONOW.txt,182433,183385,952,5,N,N,-,-1,-1
GRONOW.txt,183386,183951,565,5,N,N,-,-1,-1
GRONOW.txt,183952,185349,1397,5,N,N,-,-1,-1
GRONOW.txt,185350,186387,1037,5,N,N,-,-1,-1
GRONOW.txt,186388,187212,824,5,N,N,-,-1,-1
GRONOW.txt,187213,187704,491,5,N,N,-,-1,-1
GRONOW.txt,187705,188859,1154,5,N,N,-,-1,-1
GRONOW.txt,188860,189544,684,5,N,N,-,-1,-1
GRONOW.txt,189545,190074,529,5,N,N,-,-1,-1
GRONOW.txt,190075,191012,937,5,N,N,-,-1,-1
GRONOW.txt,191013,192318,1305,5,N,N,-,-1,-1
GRONOW.txt,192323,193419,1096,5,N,N,-,-1,-1
GRONOW.txt,193421,194244,823,5,N,N,-,-1,-1
GRONOW.txt,194245,195788,1543,5,N,N,-,-1,-1
GRONOW.txt,195793,196495,702,5,N,N,-,-1,-1
GRONOW.txt,196498,197653,1155,5,N,N,-,-1,-1
GRONOW.txt,197654,198746,1092,5,N,N,-,-1,-1
GRONOW.txt,198749,199727,978,5,N,N,-,-1,-1
GRONOW.txt,199730,200539,809,5,N,N,-,-1,-1
GRONOW.txt,200542,201431,889,5,N,N,-,-1,-1
GRONOW.txt,201432,202241,809,5,N,N,-,-1,-1
GRONOW.txt,202242,203407,1165,5,N,N,-,-1,-1
GRONOW.txt,203408,204107,699,5,N,N,-,-1,-1
GRONOW.txt,204108,205162,1054,5,N,N,-,-1,-1
GRONOW.txt,205163,206070,907,5,N,N,-,-1,-1
GRONOW.txt,206071,206667,596,5,N,N,-,-1,-1
GRONOW.txt,206668,207583,915,5,N,N,-,-1,-1
GRONOW.txt,207584,208646,1062,5,N,N,-,-1,-1
GRONOW.txt,208648,209837,1189,5,N,N,-,-1,-1
GRONOW.txt,209838,210201,363,5,N,N,-,-1,-1
GRONOW.txt,210202,211008,806,5,N,N,-,-1,-1
GRONOW.txt,211009,211348,339,5,N,N,-,-1,-1
GRONOW.txt,211349,212254,905,5,N,N,-,-1,-1
GRONOW.txt,212257,212818,561,5,N,N,-,-1,-1
GRONOW.txt,212819,213803,984,5,N,N,-,-1,-1
GRONOW.txt,213804,214233,429,5,N,N,-,-1,-1
GRONOW.txt,214234,215149,915,5,N,N,-,-1,-1
GRONOW.txt,215150,216019,869,5,N,N,-,-1,-1
GRONOW.txt,216020,217280,1260,5,N,N,-,-1,-1
GRONOW.txt,217283,217759,476,5,N,N,-,-1,-1
GRONOW.txt,217760,218497,737,5,N,N,-,-1,-1
GRONOW.txt,218500,219244,744,5,N,N,-,-1,-1
GRONOW.txt,219249,220007,758,5,N,N,-,-1,-1
GRONOW.txt,220008,221034,1026,5,N,N,-,-1,-1
GRONOW.txt,221037,221790,753,5,N,Y,1437476486340,221621,222520
GRONOW.txt,221791,222715,924,5,N,Y,1437476486340,221621,222520
GRONOW.txt,222716,223636,920,5,N,N,-,-1,-1
GRONOW.txt,223637,224366,729,5,N,N,-,-1,-1
GRONOW.txt,224367,225902,1535,5,N,N,-,-1,-1
GRONOW.txt,225904,226711,807,5,N,N,-,-1,-1
GRONOW.txt,226713,227601,888,5,N,N,-,-1,-1
GRONOW.txt,227602,228138,536,5,N,N,-,-1,-1
GRONOW.txt,228139,228839,700,5,N,N,-,-1,-1
GRONOW.txt,228840,229510,670,5,N,N,-,-1,-1
GRONOW.txt,229513,230086,573,5,N,N,-,-1,-1
GRONOW.txt,230087,230628,541,5,N,N,-,-1,-1
GRONOW.txt,230629,231550,921,5,N,N,-,-1,-1
GRONOW.txt,231551,232285,734,5,N,N,-,-1,-1
GRONOW.txt,232286,233432,1146,5,N,N,-,-1,-1
GRONOW.txt,233433,234583,1150,5,N,N,-,-1,-1
GRONOW.txt,234584,235311,727,5,N,N,-,-1,-1
GRONOW.txt,235312,236399,1087,5,N,N,-,-1,-1
GRONOW.txt,236404,237637,1233,5,N,N,-,-1,-1
GRONOW.txt,237638,238271,633,5,N,N,-,-1,-1
GRONOW.txt,238274,239535,1261,5,N,N,-,-1,-1
GRONOW.txt,239536,240781,1245,5,N,N,-,-1,-1
GRONOW.txt,240782,241592,810,5,N,N,-,-1,-1
GRONOW.txt,241593,243023,1430,5,N,N,-,-1,-1
GRONOW.txt,243026,243692,666,5,N,N,-,-1,-1
GRONOW.txt,243693,244672,979,5,N,N,-,-1,-1
GRONOW.txt,244673,245973,1300,5,N,N,-,-1,-1
GRONOW.txt,245975,247315,1340,5,N,N,-,-1,-1
GRONOW.txt,247316,248306,990,5,N,N,-,-1,-1
GRONOW.txt,248309,249176,867,5,N,N,-,-1,-1
GRONOW.txt,249177,249744,567,5,N,N,-,-1,-1
GRONOW.txt,249745,250909,1164,5,N,N,-,-1,-1
GRONOW.txt,250910,252400,1490,5,N,N,-,-1,-1
GRONOW.txt,252403,253248,845,5,N,N,-,-1,-1
GRONOW.txt,253250,254036,786,5,N,N,-,-1,-1
GRONOW.txt,254037,255194,1157,5,N,N,-,-1,-1
GRONOW.txt,255195,256283,1088,5,N,N,-,-1,-1
GRONOW.txt,256284,257259,975,5,N,N,-,-1,-1
GRONOW.txt,257262,258426,1164,5,N,N,-,-1,-1
GRONOW.txt,258427,259295,868,5,N,N,-,-1,-1
GRONOW.txt,259296,260766,1470,5,N,N,-,-1,-1
GRONOW.txt,260769,261514,745,5,N,N,-,-1,-1
GRONOW.txt,261515,262447,932,5,N,N,-,-1,-1
GRONOW.txt,262448,263390,942,5,N,N,-,-1,-1
GRONOW.txt,263391,264740,1349,5,N,N,-,-1,-1
GRONOW.txt,264741,265498,757,5,N,N,-,-1,-1
GRONOW.txt,265500,266372,872,5,N,N,-,-1,-1
GRONOW.txt,266375,266945,570,5,N,N,-,-1,-1
GRONOW.txt,266946,267516,570,5,N,N,-,-1,-1
GRONOW.txt,267517,268257,740,5,N,N,-,-1,-1
GRONOW.txt,268260,269256,996,5,N,N,-,-1,-1
GRONOW.txt,269257,270420,1163,5,N,N,-,-1,-1
GRONOW.txt,270423,271531,1108,5,N,N,-,-1,-1
GRONOW.txt,271532,272588,1056,5,N,N,-,-1,-1
GRONOW.txt,272589,273827,1238,5,N,N,-,-1,-1
GRONOW.txt,273828,274813,985,5,N,N,-,-1,-1
GRONOW.txt,274816,275906,1090,5,N,N,-,-1,-1
GRONOW.txt,275907,276732,825,5,N,N,-,-1,-1
GRONOW.txt,276733,277616,883,5,N,N,-,-1,-1
GRONOW.txt,277619,278900,1281,5,N,N,-,-1,-1
GRONOW.txt,278901,279705,804,5,N,N,-,-1,-1
GRONOW.txt,279706,281050,1344,5,N,N,-,-1,-1
GRONOW.txt,281055,282133,1078,5,N,N,-,-1,-1
GRONOW.txt,282134,283239,1105,5,N,N,-,-1,-1
GRONOW.txt,283240,284259,1019,5,N,N,-,-1,-1
GRONOW.txt,284261,285992,1731,5,N,N,-,-1,-1
GRONOW.txt,285993,286809,816,5,N,N,-,-1,-1
GRONOW.txt,286810,288019,1209,5,N,N,-,-1,-1
GRONOW.txt,288020,289352,1332,5,N,N,-,-1,-1
GRONOW.txt,289353,290285,932,5,N,N,-,-1,-1
GRONOW.txt,290286,292019,1733,5,N,N,-,-1,-1
GRONOW.txt,292022,293120,1098,5,N,N,-,-1,-1
GRONOW.txt,293121,294853,1732,5,N,N,-,-1,-1
GRONOW.txt,294856,296224,1368,5,N,N,-,-1,-1
GRONOW.txt,296225,297135,910,5,N,N,-,-1,-1
GRONOW.txt,297136,298210,1074,5,N,N,-,-1,-1
GRONOW.txt,298213,299074,861,5,N,N,-,-1,-1
GRONOW.txt,299075,299987,912,5,N,N,-,-1,-1
GRONOW.txt,299988,301194,1206,5,N,N,-,-1,-1
GRONOW.txt,301195,302034,839,5,N,N,-,-1,-1
GRONOW.txt,302035,303172,1137,5,N,N,-,-1,-1
GRONOW.txt,303173,304135,962,5,N,N,-,-1,-1
GRONOW.txt,304136,305197,1061,5,N,N,-,-1,-1
GRONOW.txt,305202,306968,1766,5,N,N,-,-1,-1
GRONOW.txt,306969,307875,906,5,N,N,-,-1,-1
GRONOW.txt,307876,309195,1319,5,N,N,-,-1,-1
GRONOW.txt,309196,309690,494,5,N,N,-,-1,-1
GRONOW.txt,309692,310222,530,5,N,N,-,-1,-1
GRONOW.txt,310223,311433,1210,5,N,N,-,-1,-1
GRONOW.txt,311434,312772,1338,5,N,N,-,-1,-1
GRONOW.txt,312775,313606,831,5,N,N,-,-1,-1
GRONOW.txt,313607,314756,1149,5,N,N,-,-1,-1
GRONOW.txt,314757,315955,1198,5,N,N,-,-1,-1
GRONOW.txt,315956,316815,859,5,N,N,-,-1,-1
GRONOW.txt,316818,318114,1296,5,N,N,-,-1,-1
GRONOW.txt,318115,319133,1018,5,N,N,-,-1,-1
GRONOW.txt,319134,320207,1073,5,N,N,-,-1,-1
GRONOW.txt,320210,320875,665,5,N,N,-,-1,-1
GRONOW.txt,320876,321903,1027,5,N,N,-,-1,-1
GRONOW.txt,321904,323001,1097,5,N,N,-,-1,-1
GRONOW.txt,323004,323956,952,5,N,N,-,-1,-1
GRONOW.txt,323959,324580,621,5,N,N,-,-1,-1
GRONOW.txt,324581,325210,629,5,N,N,-,-1,-1
GRONOW.txt,325212,325917,705,5,N,N,-,-1,-1
GRONOW.txt,325920,326821,901,5,N,N,-,-1,-1
GRONOW.txt,326824,327666,842,5,N,N,-,-1,-1
GRONOW.txt,327667,328263,596,5,N,N,-,-1,-1
GRONOW.txt,328264,328895,631,5,N,N,-,-1,-1
GRONOW.txt,328895,329531,636,5,N,N,-,-1,-1
GRONOW.txt,329534,330225,691,5,N,N,-,-1,-1
GRONOW.txt,330226,331093,867,5,N,N,-,-1,-1
GRONOW.txt,331094,332169,1075,5,N,N,-,-1,-1
GRONOW.txt,332171,332948,777,5,N,N,-,-1,-1
GRONOW.txt,332949,333733,784,5,N,N,-,-1,-1
GRONOW.txt,333734,334646,912,5,N,N,-,-1,-1
GRONOW.txt,334647,335944,1297,5,N,N,-,-1,-1
GRONOW.txt,335947,336448,501,5,N,N,-,-1,-1
GRONOW.txt,336449,337683,1234,5,N,N,-,-1,-1
GRONOW.txt,337684,338471,787,5,N,N,-,-1,-1
GRONOW.txt,338474,339732,1258,5,N,N,-,-1,-1
GRONOW.txt,339733,340513,780,5,N,N,-,-1,-1
GRONOW.txt,340515,341600,1085,5,N,N,-,-1,-1
GRONOW.txt,341601,343035,1434,5,N,N,-,-1,-1
GRONOW.txt,343036,343654,618,5,N,N,-,-1,-1
GRONOW.txt,343655,344590,935,5,N,N,-,-1,-1
GRONOW.txt,344591,345254,663,5,N,N,-,-1,-1
GRONOW.txt,345255,346259,1004,5,N,N,-,-1,-1
GRONOW.txt,346260,346834,574,5,N,N,-,-1,-1
GRONOW.txt,346835,347662,827,5,N,N,-,-1,-1
GRONOW.txt,347663,348502,839,5,N,N,-,-1,-1
GRONOW.txt,348503,349511,1008,5,N,N,-,-1,-1
GRONOW.txt,349514,350203,689,5,N,N,-,-1,-1
GRONOW.txt,350206,351159,953,5,N,N,-,-1,-1
GRONOW.txt,351161,351895,734,5,N,N,-,-1,-1
GRONOW.txt,351896,352645,749,5,N,N,-,-1,-1
GRONOW.txt,352646,353560,914,5,N,N,-,-1,-1
GRONOW.txt,353561,354156,595,5,N,N,-,-1,-1
GRONOW.txt,354157,355280,1123,5,N,N,-,-1,-1
GRONOW.txt,355281,356098,817,5,N,N,-,-1,-1
GRONOW.txt,356100,356894,794,5,N,N,-,-1,-1
GRONOW.txt,356895,358020,1125,5,N,N,-,-1,-1
GRONOW.txt,358021,358852,831,5,N,N,-,-1,-1
GRONOW.txt,358853,360552,1699,5,N,N,-,-1,-1
GRONOW.txt,360555,361432,877,5,N,N,-,-1,-1
GRONOW.txt,361433,362250,817,5,N,N,-,-1,-1
GRONOW.txt,362251,363142,891,5,N,N,-,-1,-1
GRONOW.txt,363143,363772,629,5,N,N,-,-1,-1
GRONOW.txt,363773,364341,568,5,N,N,-,-1,-1
GRONOW.txt,364342,364883,541,5,N,N,-,-1,-1
GRONOW.txt,364884,365550,666,5,N,N,-,-1,-1
GRONOW.txt,365551,366208,657,5,N,N,-,-1,-1
GRONOW.txt,366211,367098,887,5,N,N,-,-1,-1
GRONOW.txt,367099,368438,1339,5,N,N,-,-1,-1
GRONOW.txt,368439,369059,620,5,N,N,-,-1,-1
GRONOW.txt,369060,370415,1355,5,N,N,-,-1,-1
GRONOW.txt,370416,370822,406,5,N,N,-,-1,-1
GRONOW.txt,370823,371671,848,5,N,N,-,-1,-1
GRONOW.txt,371674,372213,539,5,N,N,-,-1,-1
GRONOW.txt,372215,372818,603,5,N,N,-,-1,-1
GRONOW.txt,372819,373619,800,5,N,N,-,-1,-1
GRONOW.txt,373620,374606,986,5,N,N,-,-1,-1
GRONOW.txt,374607,375700,1093,5,N,N,-,-1,-1
GRONOW.txt,375701,376397,696,5,N,N,-,-1,-1
GRONOW.txt,376400,377243,843,5,N,N,-,-1,-1
GRONOW.txt,377245,378543,1298,5,N,N,-,-1,-1
GRONOW.txt,378546,379443,897,5,N,N,-,-1,-1
GRONOW.txt,379446,380128,682,5,N,N,-,-1,-1
GRONOW.txt,380129,380961,832,5,N,N,-,-1,-1
GRONOW.txt,380962,382130,1168,5,N,N,-,-1,-1
GRONOW.txt,382131,383407,1276,5,N,N,-,-1,-1
GRONOW.txt,383410,384175,765,5,N,N,-,-1,-1
GRONOW.txt,384176,385235,1059,5,N,N,-,-1,-1
GRONOW.txt,385236,385986,750,5,N,N,-,-1,-1
GRONOW.txt,385989,386548,559,5,N,N,-,-1,-1
GRONOW.txt,386549,387325,776,5,N,N,-,-1,-1
GRONOW.txt,387326,388176,850,5,N,N,-,-1,-1
GRONOW.txt,388179,389002,823,5,N,N,-,-1,-1
GRONOW.txt,389003,389968,965,5,N,N,-,-1,-1
GRONOW.txt,389969,390793,824,5,N,N,-,-1,-1
GRONOW.txt,390796,391762,966,5,N,N,-,-1,-1
GRONOW.txt,391765,392487,722,5,N,N,-,-1,-1
GRONOW.txt,392488,393660,1172,5,N,N,-,-1,-1
GRONOW.txt,393661,394393,732,5,N,N,-,-1,-1
GRONOW.txt,394394,395111,717,5,N,N,-,-1,-1
GRONOW.txt,395112,395759,647,5,N,N,-,-1,-1
GRONOW.txt,395761,396340,579,5,N,N,-,-1,-1
GRONOW.txt,396341,397179,838,5,N,N,-,-1,-1
GRONOW.txt,397180,397846,666,5,N,N,-,-1,-1
GRONOW.txt,397847,398820,973,5,N,N,-,-1,-1
GRONOW.txt,398823,399374,551,5,N,N,-,-1,-1
GRONOW.txt,399375,400315,940,5,N,N,-,-1,-1
GRONOW.txt,400316,401026,710,5,N,N,-,-1,-1
GRONOW.txt,401027,401763,736,5,N,N,-,-1,-1
GRONOW.txt,401764,402752,988,5,N,N,-,-1,-1
GRONOW.txt,402753,403516,763,5,N,N,-,-1,-1
GRONOW.txt,403519,404283,764,5,N,N,-,-1,-1
GRONOW.txt,404284,405002,718,5,N,N,-,-1,-1
GRONOW.txt,405003,406324,1321,5,N,N,-,-1,-1
GRONOW.txt,406325,407032,707,5,N,N,-,-1,-1
GRONOW.txt,407033,407894,861,5,N,N,-,-1,-1
GRONOW.txt,407895,408815,920,5,N,N,-,-1,-1
GRONOW.txt,408816,409421,605,5,N,N,-,-1,-1
GRONOW.txt,409422,410101,679,5,N,N,-,-1,-1
GRONOW.txt,410103,411125,1022,5,N,N,-,-1,-1
GRONOW.txt,411126,412199,1073,5,N,N,-,-1,-1
GRONOW.txt,412200,412888,688,5,N,N,-,-1,-1
GRONOW.txt,412889,413589,700,5,N,N,-,-1,-1
GRONOW.txt,413590,414395,805,5,N,N,-,-1,-1
GRONOW.txt,414396,415187,791,5,N,N,-,-1,-1
GRONOW.txt,415190,416273,1083,5,N,N,-,-1,-1
GRONOW.txt,416278,416790,512,5,N,N,-,-1,-1
GRONOW.txt,416791,418000,1209,5,N,N,-,-1,-1
GRONOW.txt,418003,419001,998,5,N,N,-,-1,-1
GRONOW.txt,419004,419841,837,5,N,N,-,-1,-1
GRONOW.txt,419842,420634,792,5,N,N,-,-1,-1
GRONOW.txt,420635,421389,754,5,N,N,-,-1,-1
GRONOW.txt,421394,422302,908,5,N,N,-,-1,-1
GRONOW.txt,422303,422793,490,5,N,N,-,-1,-1
GRONOW.txt,422794,423066,272,5,N,N,-,-1,-1
GRONOW.txt,423067,423542,475,5,N,N,-,-1,-1
GRONOW.txt,423543,424367,824,5,N,N,-,-1,-1
GRONOW.txt,424368,425044,676,5,N,Y,1437477480340,424837,425856
GRONOW.txt,425045,425887,842,5,N,Y,1437477480340,424837,425856
GRONOW.txt,425888,426562,674,5,N,N,-,-1,-1
GRONOW.txt,426563,427165,602,5,N,N,-,-1,-1
GRONOW.txt,427166,427825,659,5,N,Y,1437477878183,427206,428439
GRONOW.txt,427826,428511,685,5,N,Y,1437477878183,427206,428439
GRONOW.txt,428514,429008,494,5,N,N,-,-1,-1
GRONOW.txt,429009,429570,561,5,N,N,-,-1,-1
GRONOW.txt,429571,429982,411,5,N,N,-,-1,-1
GRONOW.txt,429983,430456,473,5,N,N,-,-1,-1
GRONOW.txt,430457,431434,977,5,N,N,-,-1,-1
GRONOW.txt,431437,432404,967,5,N,N,-,-1,-1
GRONOW.txt,432406,433557,1151,5,N,N,-,-1,-1
GRONOW.txt,433557,434104,547,5,N,N,-,-1,-1
GRONOW.txt,434105,434669,564,5,N,N,-,-1,-1
GRONOW.txt,434670,435553,883,5,N,N,-,-1,-1
GRONOW.txt,435555,436137,582,5,N,N,-,-1,-1
GRONOW.txt,436140,436567,427,5,N,N,-,-1,-1
GRONOW.txt,436568,437441,873,5,N,N,-,-1,-1
GRONOW.txt,437442,437987,545,5,N,N,-,-1,-1
GRONOW.txt,437988,438821,833,5,N,N,-,-1,-1
GRONOW.txt,438822,439491,669,5,N,N,-,-1,-1
GRONOW.txt,439492,439755,263,5,N,N,-,-1,-1
GRONOW.txt,439756,440553,797,5,N,N,-,-1,-1
GRONOW.txt,440554,441128,574,5,N,N,-,-1,-1
GRONOW.txt,441129,441934,805,5,N,N,-,-1,-1
GRONOW.txt,441935,443049,1114,5,N,N,-,-1,-1
GRONOW.txt,443050,443754,704,5,N,N,-,-1,-1
GRONOW.txt,443755,444293,538,5,N,N,-,-1,-1
GRONOW.txt,444294,445447,1153,5,N,N,-,-1,-1
GRONOW.txt,445448,446560,1112,5,N,N,-,-1,-1
GRONOW.txt,446563,447259,696,5,N,N,-,-1,-1
GRONOW.txt,447260,448234,974,5,N,N,-,-1,-1
GRONOW.txt,448235,448865,630,5,N,N,-,-1,-1
GRONOW.txt,448868,449462,594,5,N,N,-,-1,-1
GRONOW.txt,449465,450336,871,5,N,N,-,-1,-1
GRONOW.txt,450337,451274,937,5,N,N,-,-1,-1
GRONOW.txt,451275,451951,676,5,N,N,-,-1,-1
GRONOW.txt,451953,452500,547,5,N,N,-,-1,-1
GRONOW.txt,452501,453368,867,5,N,N,-,-1,-1
GRONOW.txt,453369,453981,612,5,N,N,-,-1,-1
GRONOW.txt,453984,455090,1106,5,N,N,-,-1,-1
GRONOW.txt,455095,456264,1169,5,N,N,-,-1,-1
GRONOW.txt,456267,457075,808,5,N,N,-,-1,-1
GRONOW.txt,457076,458507,1431,5,N,N,-,-1,-1
GRONOW.txt,458510,459280,770,5,N,N,-,-1,-1
GRONOW.txt,459283,460279,996,5,N,N,-,-1,-1
GRONOW.txt,460280,460653,373,5,N,N,-,-1,-1
GRONOW.txt,460654,461556,902,5,N,Y,1437490253936,460795,462238
GRONOW.txt,461558,462304,746,5,Y,Y,1437490253936,460795,462238
GRONOW.txt,462305,462950,645,5,N,N,-,-1,-1
GRONOW.txt,462951,463645,694,5,N,N,-,-1,-1
GRONOW.txt,463646,464310,664,5,N,N,-,-1,-1
GRONOW.txt,464311,465085,774,5,N,N,-,-1,-1
GRONOW.txt,465088,465560,472,5,N,N,-,-1,-1
GRONOW.txt,465562,466415,853,5,N,N,-,-1,-1
GRONOW.txt,466416,467622,1206,5,N,N,-,-1,-1
GRONOW.txt,467623,468649,1026,5,N,N,-,-1,-1
GRONOW.txt,468654,469870,1216,5,N,N,-,-1,-1
GRONOW.txt,469873,471047,1174,5,N,N,-,-1,-1
GRONOW.txt,471050,471655,605,5,N,N,-,-1,-1
GRONOW.txt,471658,472114,456,5,N,N,-,-1,-1
GRONOW.txt,472115,472525,410,5,N,N,-,-1,-1
GRONOW.txt,472526,473385,859,5,N,N,-,-1,-1
GRONOW.txt,473388,474177,789,5,N,N,-,-1,-1
GRONOW.txt,474178,474945,767,5,N,N,-,-1,-1
GRONOW.txt,474948,475913,965,5,N,N,-,-1,-1
GRONOW.txt,475914,476549,635,5,N,N,-,-1,-1
GRONOW.txt,476550,477274,724,5,N,N,-,-1,-1
GRONOW.txt,477277,478056,779,5,N,N,-,-1,-1
GRONOW.txt,478057,479315,1258,5,N,N,-,-1,-1
GRONOW.txt,479318,480203,885,5,N,N,-,-1,-1
GRONOW.txt,480204,480914,710,5,N,N,-,-1,-1
GRONOW.txt,480915,481529,614,5,N,N,-,-1,-1
GRONOW.txt,481530,482240,710,5,N,N,-,-1,-1
GRONOW.txt,482241,482872,631,5,N,N,-,-1,-1
GRONOW.txt,482873,483664,791,5,N,N,-,-1,-1
GRONOW.txt,483665,484646,981,5,N,N,-,-1,-1
GRONOW.txt,484647,485408,761,5,N,N,-,-1,-1
GRONOW.txt,485413,486397,984,5,N,N,-,-1,-1
GRONOW.txt,486398,487457,1059,5,N,N,-,-1,-1
GRONOW.txt,487458,487992,534,5,N,N,-,-1,-1
GRONOW.txt,487993,488965,972,5,N,N,-,-1,-1
GRONOW.txt,488966,490041,1075,5,N,N,-,-1,-1
GRONOW.txt,490042,491078,1036,5,N,N,-,-1,-1
GRONOW.txt,491079,492101,1022,5,N,N,-,-1,-1
GRONOW.txt,492102,492773,671,5,N,N,-,-1,-1
GRONOW.txt,492776,493829,1053,5,N,N,-,-1,-1
GRONOW.txt,493830,494478,648,5,N,N,-,-1,-1
GRONOW.txt,494479,495235,756,5,N,N,-,-1,-1
GRONOW.txt,495236,495866,630,5,N,N,-,-1,-1
GRONOW.txt,495867,496611,744,5,N,N,-,-1,-1
GRONOW.txt,496612,497300,688,5,N,N,-,-1,-1
GRONOW.txt,497301,498114,813,5,N,N,-,-1,-1
GRONOW.txt,498115,498912,797,5,N,N,-,-1,-1
GRONOW.txt,498913,499434,521,5,N,N,-,-1,-1
GRONOW.txt,499435,500513,1078,5,N,N,-,-1,-1
GRONOW.txt,500516,501095,579,5,N,N,-,-1,-1
GRONOW.txt,501096,502347,1251,5,N,N,-,-1,-1
GRONOW.txt,502350,503271,921,5,N,N,-,-1,-1
GRONOW.txt,503272,504725,1453,5,N,N,-,-1,-1
GRONOW.txt,504726,505433,707,5,N,N,-,-1,-1
GRONOW.txt,505434,506476,1042,5,N,N,-,-1,-1
GRONOW.txt,506477,507365,888,5,N,N,-,-1,-1
GRONOW.txt,507366,508155,789,5,N,N,-,-1,-1
GRONOW.txt,508156,509270,1114,5,N,N,-,-1,-1
GRONOW.txt,509273,510047,774,5,N,N,-,-1,-1
GRONOW.txt,510048,510799,751,5,N,N,-,-1,-1
GRONOW.txt,510800,511312,512,5,N,N,-,-1,-1
GRONOW.txt,511313,512211,898,5,N,N,-,-1,-1
GRONOW.txt,512212,513158,946,5,N,N,-,-1,-1
GRONOW.txt,513160,514103,943,5,N,N,-,-1,-1
GRONOW.txt,514104,514835,731,5,N,N,-,-1,-1
GRONOW.txt,514836,515880,1044,5,N,N,-,-1,-1
GRONOW.txt,515883,516584,701,5,N,N,-,-1,-1
GRONOW.txt,516585,517287,702,5,N,N,-,-1,-1
GRONOW.txt,517292,518053,761,5,N,N,-,-1,-1
GRONOW.txt,518054,518659,605,5,N,N,-,-1,-1
GRONOW.txt,518661,519191,530,5,N,N,-,-1,-1
GRONOW.txt,519193,519819,626,5,N,N,-,-1,-1
GRONOW.txt,519820,520796,976,5,N,N,-,-1,-1
GRONOW.txt,520797,521967,1170,5,N,N,-,-1,-1
GRONOW.txt,521970,522547,577,5,N,N,-,-1,-1
GRONOW.txt,522548,523217,669,5,N,N,-,-1,-1
GRONOW.txt,523218,524137,919,5,N,N,-,-1,-1
GRONOW.txt,524138,524920,782,5,N,N,-,-1,-1
GRONOW.txt,524923,525749,826,5,N,N,-,-1,-1
GRONOW.txt,525750,526186,436,5,N,N,-,-1,-1
GRONOW.txt,526187,526678,491,5,N,N,-,-1,-1
GRONOW.txt,526680,527252,572,5,N,N,-,-1,-1
GRONOW.txt,527253,528076,823,5,N,N,-,-1,-1
GRONOW.txt,528077,529110,1033,5,N,N,-,-1,-1
GRONOW.txt,529111,529827,716,5,N,N,-,-1,-1
GRONOW.txt,529830,530487,657,5,N,N,-,-1,-1
GRONOW.txt,530488,531408,920,5,N,N,-,-1,-1
GRONOW.txt,531409,532394,985,5,N,N,-,-1,-1
GRONOW.txt,532397,533453,1056,5,N,N,-,-1,-1
GRONOW.txt,533454,534511,1057,5,N,N,-,-1,-1
GRONOW.txt,534512,535223,711,5,N,N,-,-1,-1
GRONOW.txt,535224,536098,874,5,N,N,-,-1,-1
GRONOW.txt,536099,536833,734,5,N,N,-,-1,-1
GRONOW.txt,536834,537652,818,5,N,N,-,-1,-1
GRONOW.txt,537653,538466,813,5,N,N,-,-1,-1
GRONOW.txt,538467,538910,443,5,N,N,-,-1,-1
GRONOW.txt,538911,539189,278,5,N,N,-,-1,-1
GRONOW.txt,539194,539943,749,5,N,N,-,-1,-1
GRONOW.txt,539946,540416,470,5,N,N,-,-1,-1
GRONOW.txt,540417,541520,1103,5,N,N,-,-1,-1
GRONOW.txt,541521,542431,910,5,N,N,-,-1,-1
GRONOW.txt,542434,543042,608,5,N,N,-,-1,-1
GRONOW.txt,543044,544347,1303,5,N,N,-,-1,-1
GRONOW.txt,544348,545264,916,5,N,N,-,-1,-1
GRONOW.txt,545265,545796,531,5,N,N,-,-1,-1
GRONOW.txt,545799,546508,709,5,N,N,-,-1,-1
GRONOW.txt,546510,547775,1265,5,N,N,-,-1,-1
GRONOW.txt,547778,548617,839,5,N,N,-,-1,-1
GRONOW.txt,548618,549086,468,5,N,N,-,-1,-1
GRONOW.txt,549089,549474,385,5,N,N,-,-1,-1
GRONOW.txt,549475,550498,1023,5,N,N,-,-1,-1
GRONOW.txt,550501,551259,758,5,N,N,-,-1,-1
GRONOW.txt,551261,552514,1253,5,N,N,-,-1,-1
GRONOW.txt,552517,553162,645,5,N,N,-,-1,-1
GRONOW.txt,553163,554071,908,5,N,N,-,-1,-1
GRONOW.txt,554072,554858,786,5,N,N,-,-1,-1
GRONOW.txt,554859,555296,437,5,N,N,-,-1,-1
GRONOW.txt,555297,555870,573,5,N,N,-,-1,-1
GRONOW.txt,555873,556501,628,5,N,N,-,-1,-1
GRONOW.txt,556504,557387,883,5,N,N,-,-1,-1
GRONOW.txt,557392,557879,487,5,N,N,-,-1,-1
GRONOW.txt,557880,558588,708,5,N,N,-,-1,-1
GRONOW.txt,558589,559135,546,5,N,N,-,-1,-1
GRONOW.txt,559138,560015,877,5,Y,N,-,-1,-1
GRONOW.txt,560016,561007,991,5,N,N,-,-1,-1
GRONOW.txt,561008,562172,1164,5,N,N,-,-1,-1
GRONOW.txt,562173,562909,736,5,N,N,-,-1,-1
GRONOW.txt,562912,563725,813,5,N,N,-,-1,-1
GRONOW.txt,563726,563809,83,5,N,N,-,-1,-1
GRONOW.txt,563810,563882,72,5,N,N,-,-1,-1
GRONOW.txt,563883,564015,132,5,N,N,-,-1,-1
GRONOW.txt,564018,564191,173,5,N,N,-,-1,-1
GRONOW.txt,564191,564255,64,5,N,N,-,-1,-1
GRONOW.txt,564256,564367,111,5,N,N,-,-1,-1
GRONOW.txt,564370,564494,124,5,N,N,-,-1,-1
GRONOW.txt,564496,564675,179,5,N,N,-,-1,-1
GRONOW.txt,564676,564868,192,5,N,N,-,-1,-1
GRONOW.txt,564870,564985,115,5,N,N,-,-1,-1
GRONOW.txt,564986,565126,140,5,N,N,-,-1,-1
GRONOW.txt,565131,565318,187,5,N,N,-,-1,-1
GRONOW.txt,565320,565412,92,5,N,N,-,-1,-1
GRONOW.txt,565413,565499,86,5,N,N,-,-1,-1
GRONOW.txt,565500,565632,132,5,N,N,-,-1,-1
GRONOW.txt,565634,565767,133,5,N,N,-,-1,-1
MASONB.txt,0,629,629,5,N,N,-,-1,-1
MASONB.txt,632,1439,807,5,N,N,-,-1,-1
MASONB.txt,1442,2138,696,5,N,N,-,-1,-1
MASONB.txt,2139,2793,654,5,N,N,-,-1,-1
MASONB.txt,2794,3304,510,5,N,N,-,-1,-1
MASONB.txt,3309,3605,296,5,N,N,-,-1,-1
MASONB.txt,3608,4647,1039,5,N,N,-,-1,-1
MASONB.txt,4650,5538,888,5,N,N,-,-1,-1
MASONB.txt,5539,6008,469,5,N,N,-,-1,-1
MASONB.txt,6011,6669,658,5,N,N,-,-1,-1
MASONB.txt,6672,7190,518,5,N,N,-,-1,-1
MASONB.txt,7193,7807,614,5,N,N,-,-1,-1
MASONB.txt,7810,8188,378,5,N,N,-,-1,-1
MASONB.txt,8191,8333,142,5,N,N,-,-1,-1
MASONB.txt,8334,8811,477,5,N,N,-,-1,-1
MASONB.txt,8814,9388,574,5,N,N,-,-1,-1
MASONB.txt,9389,9768,379,5,N,N,-,-1,-1
MASONB.txt,9769,10495,726,5,N,N,-,-1,-1
MASONB.txt,10496,11414,918,5,N,N,-,-1,-1
MASONB.txt,11417,11846,429,5,N,N,-,-1,-1
MASONB.txt,11847,12732,885,5,N,N,-,-1,-1
MASONB.txt,12737,13385,648,5,N,N,-,-1,-1
MASONB.txt,13387,13905,518,5,N,N,-,-1,-1
MASONB.txt,13908,14396,488,5,N,Y,1448037533268,13930,15031
MASONB.txt,14397,14709,312,5,N,Y,1448037533268,13930,15031
MASONB.txt,14710,15219,509,5,N,Y,1448038101349,15101,17486
MASONB.txt,15220,15982,762,5,N,Y,1448038101349,15101,17486
MASONB.txt,15983,16370,387,5,N,Y,1448038101349,15101,17486
MASONB.txt,16371,16658,287,5,N,Y,1448038101349,15101,17486
MASONB.txt,16659,17571,912,5,N,Y,1448038101349,15101,17486
MASONB.txt,17574,18423,849,5,N,N,-,-1,-1
MASONB.txt,18426,19011,585,5,N,Y,1448038803075,18895,19670
MASONB.txt,19013,19830,817,5,N,Y,1448038803075,18895,19670
MASONB.txt,19831,20637,806,5,N,Y,1448039123601,19678,19935
MASONB.txt,20640,21032,392,5,N,Y,1448039370049,20775,21297
MASONB.txt,21033,21783,750,5,N,Y,1448039370049,20775,21297
MASONB.txt,21786,22155,369,5,N,Y,1448274783410,21836,25159
MASONB.txt,22156,22685,529,5,N,Y,1448274783410,21836,25159
MASONB.txt,22686,23426,740,5,N,Y,1448274783410,21836,25159
MASONB.txt,23427,24060,633,5,N,Y,1448274783410,21836,25159
MASONB.txt,24061,24436,375,5,N,Y,1448274783410,21836,25159
MASONB.txt,24437,24903,466,5,N,Y,1448274783410,21836,25159
MASONB.txt,24904,25472,568,5,N,Y,1448274893770,25386,26202
MASONB.txt,25473,26181,708,5,N,Y,1448274893770,25386,26202
MASONB.txt,26182,26847,665,5,N,Y,1448274893770,25386,26202
MASONB.txt,26852,27169,317,5,N,Y,1448275407308,26987,29181
MASONB.txt,27170,27767,597,5,Y,Y,1448275407308,26987,29181
MASONB.txt,27768,28914,1146,5,Y,Y,1448275407308,26987,29181
MASONB.txt,28916,29373,457,5,N,Y,1448275407308,26987,29181
MASONB.txt,29374,29840,466,5,N,N,-,-1,-1
MASONB.txt,29843,30281,438,5,N,Y,1448276340407,30017,39003
MASONB.txt,30282,32207,1925,5,Y,Y,1448276340407,30017,39003
MASONB.txt,32208,33150,942,5,N,Y,1448276340407,30017,39003
MASONB.txt,33153,34224,1071,5,Y,Y,1448276340407,30017,39003
MASONB.txt,34227,35168,941,5,N,Y,1448276340407,30017,39003
MASONB.txt,35169,36088,919,5,Y,Y,1448276340407,30017,39003
MASONB.txt,36089,36612,523,5,N,Y,1448276340407,30017,39003
MASONB.txt,36613,36899,286,5,N,Y,1448276340407,30017,39003
MASONB.txt,36902,37398,496,5,N,Y,1448276340407,30017,39003
MASONB.txt,37401,37904,503,5,Y,Y,1448276340407,30017,39003
MASONB.txt,37905,38335,430,5,N,Y,1448276340407,30017,39003
MASONB.txt,38336,38917,581,5,N,Y,1448276340407,30017,39003
MASONB.txt,38918,39938,1020,5,N,Y,1448276340407,30017,39003
MASONB.txt,39939,40685,746,5,N,N,-,-1,-1
MASONB.txt,40686,41037,351,5,N,Y,1448277167610,40886,47737
MASONB.txt,41038,41536,498,5,N,Y,1448277167610,40886,47737
MASONB.txt,41537,42127,590,5,N,Y,1448277167610,40886,47737
MASONB.txt,42128,43195,1067,5,N,Y,1448277167610,40886,47737
MASONB.txt,43198,44017,819,5,N,Y,1448277167610,40886,47737
MASONB.txt,44020,44886,866,5,Y,Y,1448277167610,40886,47737
MASONB.txt,44887,46087,1200,5,N,Y,1448277167610,40886,47737
MASONB.txt,46088,47028,940,5,N,Y,1448277167610,40886,47737
MASONB.txt,47029,47710,681,5,N,Y,1448277167610,40886,47737
MASONB.txt,47711,48041,330,5,N,Y,1448277167610,40886,47737
MASONB.txt,48046,48717,671,5,N,N,-,-1,-1
MASONB.txt,48718,49763,1045,5,N,N,-,-1,-1
MASONB.txt,49766,51111,1345,5,Y,N,-,-1,-1
MASONB.txt,51112,52494,1382,5,N,N,-,-1,-1
MASONB.txt,52497,52986,489,5,N,Y,1448277582432,52552,54595
MASONB.txt,52988,53850,862,5,N,Y,1448277582432,52552,54595
MASONB.txt,53851,54946,1095,5,Y,Y,1448277582432,52552,54595
MASONB.txt,54947,55413,466,5,N,Y,1448278147591,54631,55869
MASONB.txt,55414,56405,991,5,N,Y,1448278147591,54631,55869
MASONB.txt,56407,57207,800,5,N,N,-,-1,-1
MASONB.txt,57210,57881,671,5,N,N,-,-1,-1
MASONB.txt,57882,58640,758,5,N,N,-,-1,-1
MASONB.txt,58645,59452,807,5,N,Y,1448278279697,58861,59444
MASONB.txt,59455,60262,807,5,N,N,-,-1,-1
MASONB.txt,60263,61023,760,5,N,N,-,-1,-1
MASONB.txt,61024,61899,875,5,N,N,-,-1,-1
MASONB.txt,61900,62587,687,5,N,N,-,-1,-1
MASONB.txt,62588,63146,558,5,N,N,-,-1,-1
MASONB.txt,63148,63827,679,5,N,N,-,-1,-1
MASONB.txt,63828,64727,899,5,N,N,-,-1,-1
MASONB.txt,64730,65922,1192,5,N,Y,1448278425221,65586,65914
MASONB.txt,65922,66462,540,5,N,N,-,-1,-1
MASONB.txt,66463,67075,612,5,N,N,-,-1,-1
MASONB.txt,67076,67689,613,5,N,Y,1448279089520,67624,69991
MASONB.txt,67690,68328,638,5,N,Y,1448279089520,67624,69991
MASONB.txt,68331,68689,358,5,N,Y,1448279089520,67624,69991
MASONB.txt,68690,69172,482,5,N,Y,1448279089520,67624,69991
MASONB.txt,69174,69754,580,5,N,Y,1448279089520,67624,69991
MASONB.txt,69755,70260,505,5,N,Y,1448279620157,70041,71486
MASONB.txt,70262,71045,783,5,Y,Y,1448279620157,70041,71486
MASONB.txt,71046,71513,467,5,N,Y,1448279620157,70041,71486
MASONB.txt,71516,71895,379,5,N,Y,1448279813455,71525,72226
MASONB.txt,71896,72288,392,5,N,Y,1448279813455,71525,72226
MASONB.txt,72289,73140,851,5,N,Y,1448279941918,72406,72905
MASONB.txt,73141,73970,829,5,N,N,-,-1,-1
MASONB.txt,73973,75219,1246,5,N,N,-,-1,-1
MASONB.txt,75220,76373,1153,5,N,N,-,-1,-1
MASONB.txt,76373,77514,1141,5,N,N,-,-1,-1
MASONB.txt,77515,78545,1030,5,N,N,-,-1,-1
MASONB.txt,78546,79176,630,5,N,N,-,-1,-1
MASONB.txt,79177,80274,1097,5,N,N,-,-1,-1
MASONB.txt,80275,81327,1052,5,N,N,-,-1,-1
MASONB.txt,81328,82503,1175,5,N,N,-,-1,-1
MASONB.txt,82504,83234,730,5,N,N,-,-1,-1
MASONB.txt,83236,83633,397,5,N,N,-,-1,-1
MASONB.txt,83634,83940,306,5,N,N,-,-1,-1
MASONB.txt,83943,84831,888,5,N,Y,1448280297446,84055,84972
MASONB.txt,84832,85312,480,5,N,Y,1448280297446,84055,84972
MASONB.txt,85313,85854,541,5,N,Y,1448280423373,85694,86154
MASONB.txt,85855,86398,543,5,N,Y,1448280423373,85694,86154
MASONB.txt,86399,86972,573,5,N,N,-,-1,-1
MASONB.txt,86973,87443,470,5,N,N,-,-1,-1
MASONB.txt,87444,88133,689,5,N,Y,1448280673594,87462,88501
MASONB.txt,88134,88832,698,5,N,Y,1448280884746,88496,89294
MASONB.txt,88833,89527,694,5,N,Y,1448281320115,89144,91129
MASONB.txt,89529,89855,326,5,N,Y,1448281320115,89144,91129
MASONB.txt,89856,89949,93,5,N,Y,1448281320115,89144,91129
MASONB.txt,89950,90052,102,5,N,Y,1448281320115,89144,91129
MASONB.txt,90053,90468,415,5,N,Y,1448281320115,89144,91129
MASONB.txt,90469,90911,442,5,N,Y,1448281320115,89144,91129
MASONB.txt,90913,91420,507,5,N,Y,1448281320115,89144,91129
MASONB.txt,91421,92554,1133,5,N,N,-,-1,-1
MASONB.txt,92555,93170,615,5,N,N,-,-1,-1
MASONB.txt,93171,94343,1172,5,N,N,-,-1,-1
MASONB.txt,94344,94986,642,5,N,N,-,-1,-1
MASONB.txt,94987,95974,987,5,N,N,-,-1,-1
MASONB.txt,95975,97180,1205,5,N,N,-,-1,-1
MASONB.txt,97181,97749,568,5,N,N,-,-1,-1
MASONB.txt,97752,98313,561,5,N,Y,1448281491382,97818,98860
MASONB.txt,98314,98914,600,5,N,Y,1448281888079,98877,102290
MASONB.txt,98915,99774,859,5,N,Y,1448281888079,98877,102290
MASONB.txt,99775,100525,750,5,N,Y,1448281888079,98877,102290
MASONB.txt,100527,101545,1018,5,N,Y,1448281888079,98877,102290
MASONB.txt,101548,102096,548,5,N,Y,1448281888079,98877,102290
MASONB.txt,102097,102521,424,5,N,Y,1448281888079,98877,102290
MASONB.txt,102524,102930,406,5,N,N,-,-1,-1
MASONB.txt,102931,103519,588,5,N,Y,1448285563397,102964,108476
MASONB.txt,103520,104355,835,5,N,Y,1448285563397,102964,108476
MASONB.txt,104356,105342,986,5,N,Y,1448285563397,102964,108476
MASONB.txt,105343,106112,769,5,N,Y,1448285563397,102964,108476
MASONB.txt,106115,106867,752,5,N,Y,1448285563397,102964,108476
MASONB.txt,106868,107642,774,5,N,Y,1448285563397,102964,108476
MASONB.txt,107643,108276,633,5,N,Y,1448285563397,102964,108476
MASONB.txt,108277,108659,382,5,N,Y,1448285563397,102964,108476
MASONB.txt,108664,109245,581,5,N,Y,1448285913012,108803,110925
MASONB.txt,109246,109698,452,5,N,Y,1448285913012,108803,110925
MASONB.txt,109699,110273,574,5,N,Y,1448285913012,108803,110925
MASONB.txt,110274,111186,912,5,Y,Y,1448285913012,108803,110925
MASONB.txt,111187,111389,202,5,N,Y,1448286451685,111065,112127
MASONB.txt,111390,111575,185,5,N,Y,1448286451685,111065,112127
MASONB.txt,111578,112133,555,5,N,Y,1448286451685,111065,112127
MASONB.txt,112136,112848,712,5,Y,Y,1448286880729,112151,113274
MASONB.txt,112849,113573,724,5,N,Y,1448286880729,112151,113274
MASONB.txt,113576,114009,433,5,N,Y,1448287094676,113323,113870
MASONB.txt,114010,114947,937,5,N,Y,1448287306770,114686,120152
MASONB.txt,114949,115525,576,5,N,Y,1448287306770,114686,120152
MASONB.txt,115526,116010,484,5,N,Y,1448287306770,114686,120152
MASONB.txt,116011,116800,789,5,N,Y,1448287306770,114686,120152
MASONB.txt,116801,117413,612,5,N,Y,1448287306770,114686,120152
MASONB.txt,117414,118130,716,5,N,Y,1448287306770,114686,120152
MASONB.txt,118131,118602,471,5,N,Y,1448287306770,114686,120152
MASONB.txt,118603,119461,858,5,N,Y,1448287306770,114686,120152
MASONB.txt,119462,120672,1210,5,N,Y,1448287306770,114686,120152
MASONB.txt,120675,121195,520,5,N,Y,1448287490368,120754,123385
MASONB.txt,121196,121960,764,5,N,Y,1448287490368,120754,123385
MASONB.txt,121961,122808,847,5,N,Y,1448287490368,120754,123385
MASONB.txt,122809,123440,631,5,N,Y,1448287490368,120754,123385
MASONB.txt,123445,123896,451,5,N,N,-,-1,-1
MASONB.txt,123897,124832,935,5,N,N,-,-1,-1
MASONB.txt,124835,125598,763,5,N,N,-,-1,-1
MASONB.txt,125599,126475,876,5,N,N,-,-1,-1
MASONB.txt,126476,127468,992,5,N,N,-,-1,-1
MASONB.txt,127469,128137,668,5,N,N,-,-1,-1
MASONB.txt,128138,128712,574,5,N,N,-,-1,-1
MASONB.txt,128713,129345,632,5,N,N,-,-1,-1
MASONB.txt,129347,130001,654,5,N,N,-,-1,-1
MASONB.txt,130002,130662,660,5,N,N,-,-1,-1
MASONB.txt,130663,131446,783,5,N,N,-,-1,-1
MASONB.txt,131447,132141,694,5,N,N,-,-1,-1
MASONB.txt,132142,132654,512,5,N,N,-,-1,-1
MASONB.txt,132655,133414,759,5,N,N,-,-1,-1
MASONB.txt,133415,134311,896,5,N,N,-,-1,-1
MASONB.txt,134314,135083,769,5,N,N,-,-1,-1
MASONB.txt,135086,136110,1024,5,N,N,-,-1,-1
MASONB.txt,136113,136801,688,5,N,N,-,-1,-1
MASONB.txt,136806,137512,706,5,N,Y,1448310549245,137491,141408
MASONB.txt,137513,138224,711,5,N,Y,1448310549245,137491,141408
MASONB.txt,138225,139103,878,5,Y,Y,1448310549245,137491,141408
MASONB.txt,139106,140012,906,5,N,Y,1448310549245,137491,141408
MASONB.txt,140013,140623,610,5,N,Y,1448310549245,137491,141408
MASONB.txt,140624,141044,420,5,N,Y,1448310549245,137491,141408
MASONB.txt,141047,141478,431,5,N,Y,1448310549245,137491,141408
MASONB.txt,141479,141971,492,5,N,N,-,-1,-1
MASONB.txt,141972,143007,1035,5,N,N,-,-1,-1
MASONB.txt,143008,143726,718,5,N,Y,1448311366799,143137,146264
MASONB.txt,143729,143852,123,5,N,Y,1448311366799,143137,146264
MASONB.txt,143853,143966,113,5,N,Y,1448311366799,143137,146264
MASONB.txt,143969,144119,150,5,N,Y,1448311366799,143137,146264
MASONB.txt,144120,144332,212,5,N,Y,1448311366799,143137,146264
MASONB.txt,144333,144945,612,5,N,Y,1448311366799,143137,146264
MASONB.txt,144946,145564,618,5,N,Y,1448311366799,143137,146264
MASONB.txt,145565,146249,684,5,N,Y,1448311366799,143137,146264
MASONB.txt,146250,146797,547,5,N,Y,1448311366799,143137,146264
MASONB.txt,146798,147398,600,5,N,N,-,-1,-1
MASONB.txt,147403,147805,402,5,N,N,-,-1,-1
MASONB.txt,147807,148932,1125,5,Y,N,-,-1,-1
MASONB.txt,148934,149840,906,5,N,N,-,-1,-1
MASONB.txt,149841,150565,724,5,N,N,-,-1,-1
MASONB.txt,150567,151423,856,5,N,N,-,-1,-1
MASONB.txt,151425,152673,1248,5,Y,N,-,-1,-1
MASONB.txt,152674,153311,637,5,N,N,-,-1,-1
MASONB.txt,153314,154343,1029,5,N,N,-,-1,-1
MASONB.txt,154344,155255,911,5,N,N,-,-1,-1
MASONB.txt,155256,156325,1069,5,N,Y,1448311594480,155711,156312
MASONB.txt,156330,156681,351,5,N,N,-,-1,-1
MASONB.txt,156682,157355,673,5,N,N,-,-1,-1
MASONB.txt,157356,157787,431,5,N,Y,1448311811907,157566,161100
MASONB.txt,157788,158687,899,5,N,Y,1448311811907,157566,161100
MASONB.txt,158690,159660,970,5,N,Y,1448311811907,157566,161100
MASONB.txt,159661,160409,748,5,N,Y,1448311811907,157566,161100
MASONB.txt,160410,161185,775,5,N,Y,1448311811907,157566,161100
MASONB.txt,161188,161724,536,5,N,N,-,-1,-1
MASONB.txt,161727,162151,424,5,N,N,-,-1,-1
MASONB.txt,162151,162394,243,5,N,N,-,-1,-1
MASONB.txt,162394,162903,509,5,N,N,-,-1,-1
MASONB.txt,162904,163382,478,5,N,N,-,-1,-1
MASONB.txt,163384,164414,1030,5,N,N,-,-1,-1
MASONB.txt,164417,164964,547,5,N,N,-,-1,-1
MASONB.txt,164967,165243,276,5,N,N,-,-1,-1
MASONB.txt,165246,165760,514,5,N,N,-,-1,-1
MASONB.txt,165762,166168,406,5,N,N,-,-1,-1
MASONB.txt,166171,167185,1014,5,N,N,-,-1,-1
MASONB.txt,167186,167756,570,5,N,N,-,-1,-1
MASONB.txt,167757,168737,980,5,N,N,-,-1,-1
MASONB.txt,168738,169466,728,5,N,N,-,-1,-1
MASONB.txt,169467,169942,475,5,N,N,-,-1,-1
MASONB.txt,169945,170616,671,5,N,N,-,-1,-1
MASONB.txt,170617,171699,1082,5,N,N,-,-1,-1
MASONB.txt,171702,172352,650,5,N,N,-,-1,-1
MASONB.txt,172353,173036,683,5,N,Y,1448312128598,172353,173027
MASONB.txt,173037,173963,926,5,N,Y,1448312844411,173573,174472
MASONB.txt,173964,174565,601,5,N,Y,1448312844411,173573,174472
MASONB.txt,174566,175224,658,5,N,Y,1448312968013,174511,175025
MASONB.txt,175225,175724,499,5,N,Y,1448313123004,175370,176057
MASONB.txt,175725,176871,1146,5,Y,Y,1448313482895,176553,176862
MASONB.txt,176872,177707,835,5,Y,Y,1448313674408,176614,178600
MASONB.txt,177710,178514,804,5,N,Y,1448313674408,176614,178600
MASONB.txt,178515,179024,509,5,N,Y,1448313674408,176614,178600
MASONB.txt,179027,179483,456,5,N,Y,1448313800274,179025,179317
MASONB.txt,179485,179955,470,5,N,Y,1448314192885,179720,179950
MASONB.txt,179956,180634,678,5,N,Y,1448314503640,180207,180355
MASONB.txt,180635,181770,1135,5,N,Y,1448315012079,181380,182053
MASONB.txt,181771,182363,592,5,N,Y,1448315012079,181380,182053
MASONB.txt,182366,183224,858,5,N,N,-,-1,-1
MASONB.txt,183227,183803,576,5,N,Y,1448315841759,183531,183799
MASONB.txt,183804,184476,672,5,N,Y,1448316079788,183824,184995
MASONB.txt,184477,185158,681,5,N,Y,1448316079788,183824,184995
MASONB.txt,185163,185268,105,5,N,N,-,-1,-1
MASONB.txt,185271,185747,476,5,N,N,-,-1,-1
MASONB.txt,185748,186825,1077,5,Y,N,-,-1,-1
MASONB.txt,186826,187586,760,5,N,N,-,-1,-1
MASONB.txt,187588,188378,790,5,N,N,-,-1,-1
MASONB.txt,188379,189729,1350,5,N,N,-,-1,-1
MASONB.txt,189730,190248,518,5,N,N,-,-1,-1
MASONB.txt,190249,191319,1070,5,N,N,-,-1,-1
MASONB.txt,191320,191637,317,5,N,N,-,-1,-1
MASONB.txt,191638,192163,525,5,N,N,-,-1,-1
MASONB.txt,192164,192362,198,5,N,N,-,-1,-1
MASONB.txt,192363,192528,165,5,N,N,-,-1,-1
MASONB.txt,192529,192639,110,5,N,N,-,-1,-1
MASONB.txt,192642,192808,166,5,N,N,-,-1,-1
MASONB.txt,192811,192930,119,5,N,N,-,-1,-1
MASONB.txt,192931,193064,133,5,N,N,-,-1,-1
MASONB.txt,193065,193256,191,5,N,N,-,-1,-1
MASONB.txt,193257,193537,280,5,N,N,-,-1,-1
MASONB.txt,193540,193762,222,5,N,N,-,-1,-1
MASONB.txt,193763,194009,246,5,N,N,-,-1,-1
MASONB.txt,194012,194116,104,5,N,N,-,-1,-1
MASONB.txt,194119,194201,82,5,N,N,-,-1,-1
MASONB.txt,194202,194520,318,5,N,N,-,-1,-1
MASONB.txt,194521,194847,326,5,N,N,-,-1,-1
MASONB.txt,194848,195198,350,5,N,N,-,-1,-1
MASONB.txt,195198,195319,121,5,N,N,-,-1,-1
MASONB.txt,195320,195512,192,5,N,N,-,-1,-1
MASONB.txt,195515,195610,95,5,N,N,-,-1,-1
MASONB.txt,195613,195818,205,5,N,N,-,-1,-1
MASONB.txt,195819,195995,176,5,N,N,-,-1,-1
MASONB.txt,195998,196161,163,5,N,N,-,-1,-1
MASONB.txt,196162,197258,1096,5,N,N,-,-1,-1
MASONB.txt,197259,198814,1555,5,N,N,-,-1,-1
MASONB.txt,198815,200262,1447,5,Y,N,-,-1,-1
MASONB.txt,200263,201638,1375,5,N,N,-,-1,-1
MASONB.txt,201639,202452,813,5,N,N,-,-1,-1
MASONB.txt,202455,203876,1421,5,N,N,-,-1,-1
MASONB.txt,203877,204735,858,5,N,N,-,-1,-1
MASONB.txt,204736,205768,1032,5,N,N,-,-1,-1
MASONB.txt,205769,206392,623,5,N,N,-,-1,-1
MASONB.txt,206395,206672,277,5,N,Y,1448316411409,206556,208475
MASONB.txt,206673,207359,686,5,N,Y,1448316411409,206556,208475
MASONB.txt,207360,208121,761,5,N,Y,1448316411409,206556,208475
MASONB.txt,208122,209079,957,5,N,Y,1448316411409,206556,208475
MASONB.txt,209080,210236,1156,5,Y,Y,1448316586529,210063,210674
MASONB.txt,210239,210791,552,5,N,Y,1448316586529,210063,210674
MASONB.txt,210792,211651,859,5,N,Y,1448321627053,211159,212725
MASONB.txt,211652,212206,554,5,N,Y,1448321627053,211159,212725
MASONB.txt,212207,212973,766,5,N,Y,1448321627053,211159,212725
MASONB.txt,212976,213770,794,5,N,N,-,-1,-1
MASONB.txt,213773,214072,299,5,N,Y,1448322095209,213778,214023
MASONB.txt,214075,214313,238,5,N,N,-,-1,-1
MASONB.txt,214314,215098,784,5,N,N,-,-1,-1
MASONB.txt,215099,215904,805,5,N,N,-,-1,-1
MASONB.txt,215905,216932,1027,5,N,N,-,-1,-1
MASONB.txt,216933,219078,2145,5,N,N,-,-1,-1
MASONB.txt,219079,219937,858,5,N,Y,1448322273366,219239,219544
MASONB.txt,219938,220419,481,5,N,Y,1448322514970,220165,221397
MASONB.txt,220420,221328,908,5,N,Y,1448322514970,220165,221397
MASONB.txt,221329,221621,292,5,N,Y,1448322514970,220165,221397
MASONB.txt,221624,222179,555,5,N,Y,1448322713112,221941,223038
MASONB.txt,222180,223042,862,5,N,Y,1448322713112,221941,223038
MASONB.txt,223044,224031,987,5,Y,N,-,-1,-1
MASONB.txt,224032,224702,670,5,N,N,-,-1,-1
MASONB.txt,224704,225421,717,5,N,N,-,-1,-1
MASONB.txt,225424,226394,970,5,N,N,-,-1,-1
MASONB.txt,226395,226765,370,5,N,N,-,-1,-1
MASONB.txt,226768,227393,625,5,N,Y,1448322979449,227304,227638
MASONB.txt,227394,227964,570,5,N,Y,1448323072174,227638,227786
MASONB.txt,227965,228499,534,5,N,N,-,-1,-1
MASONB.txt,228501,229108,607,5,N,N,-,-1,-1
MASONB.txt,229109,229592,483,5,N,N,-,-1,-1
MASONB.txt,229593,230271,678,5,N,Y,1448323254416,230223,230526
MASONB.txt,230272,231022,750,5,N,Y,1448325046337,230539,231128
MASONB.txt,231023,231475,452,5,N,Y,1448325046337,230539,231128
MASONB.txt,231476,232203,727,5,Y,Y,1448357159811,231190,232925
MASONB.txt,232204,233030,826,5,N,Y,1448357159811,231190,232925
MASONB.txt,233033,234051,1018,5,N,Y,1448357431466,233540,233770
MASONB.txt,234052,234675,623,5,N,Y,1448357582358,234204,234401
MASONB.txt,234676,235099,423,5,N,Y,1448358276684,234999,235995
MASONB.txt,235100,236200,1100,5,N,Y,1448358276684,234999,235995
MASONB.txt,236201,237025,824,5,N,N,-,-1,-1
MASONB.txt,237026,237467,441,5,N,N,-,-1,-1
MASONB.txt,237470,238047,577,5,N,N,-,-1,-1
MASONB.txt,238048,238849,801,5,N,Y,1448358538400,238461,240031
MASONB.txt,238850,239531,681,5,N,Y,1448358538400,238461,240031
MASONB.txt,239532,240151,619,5,N,Y,1448358538400,238461,240031
MASONB.txt,240152,240881,729,5,N,Y,1448358806100,240524,240915
MASONB.txt,240882,241400,518,5,N,Y,1448358806100,240524,240915
MASONB.txt,241401,241713,312,5,N,N,-,-1,-1
MASONB.txt,241716,242214,498,5,N,N,-,-1,-1
MASONB.txt,242215,242972,757,5,N,N,-,-1,-1
MASONB.txt,242973,243908,935,5,N,N,-,-1,-1
MASONB.txt,243911,244664,753,5,N,N,-,-1,-1
MASONB.txt,244667,245546,879,5,N,N,-,-1,-1
MASONB.txt,245548,245921,373,5,N,N,-,-1,-1
MASONB.txt,245922,246626,704,5,N,N,-,-1,-1
MASONB.txt,246627,247023,396,5,N,N,-,-1,-1
MASONB.txt,247024,247612,588,5,N,Y,1448359079273,247104,249268
MASONB.txt,247613,248302,689,5,N,Y,1448359079273,247104,249268
MASONB.txt,248304,249193,889,5,N,Y,1448359079273,247104,249268
MASONB.txt,249194,249785,591,5,N,Y,1448359079273,247104,249268
MASONB.txt,249788,250616,828,5,N,N,-,-1,-1
MASONB.txt,250619,251284,665,5,N,N,-,-1,-1
MASONB.txt,251285,251706,421,5,N,N,-,-1,-1
MASONB.txt,251707,252024,317,5,N,N,-,-1,-1
MASONB.txt,252025,252720,695,5,N,N,-,-1,-1
MASONB.txt,252721,253129,408,5,N,N,-,-1,-1
MASONB.txt,253130,253490,360,5,N,N,-,-1,-1
MASONB.txt,253491,254046,555,5,N,N,-,-1,-1
MASONB.txt,254049,254811,762,5,N,N,-,-1,-1
MASONB.txt,254816,255363,547,5,N,N,-,-1,-1
MASONB.txt,255364,255956,592,5,N,N,-,-1,-1
MASONB.txt,255957,256762,805,5,N,N,-,-1,-1
MASONB.txt,256763,257584,821,5,N,N,-,-1,-1
MASONB.txt,257586,258005,419,5,N,N,-,-1,-1
MASONB.txt,258006,259228,1222,5,N,N,-,-1,-1
MASONB.txt,259229,259938,709,5,N,N,-,-1,-1
MASONB.txt,259939,260601,662,5,N,N,-,-1,-1
MASONB.txt,260603,260949,346,5,N,N,-,-1,-1
MASONB.txt,260950,261442,492,5,N,N,-,-1,-1
MASONB.txt,261443,261836,393,5,N,N,-,-1,-1
MASONB.txt,261839,262390,551,5,N,N,-,-1,-1
MASONB.txt,262391,263081,690,5,N,Y,1448359440819,262798,263079
MASONB.txt,263084,263496,412,5,N,N,-,-1,-1
MASONB.txt,263497,263955,458,5,N,N,-,-1,-1
MASONB.txt,263957,264662,705,5,N,N,-,-1,-1
MASONB.txt,264663,265206,543,5,N,N,-,-1,-1
MASONB.txt,265209,265782,573,5,N,Y,1448359608080,265546,265784
MASONB.txt,265783,266403,620,5,N,Y,1448359878707,265791,267089
MASONB.txt,266404,267348,944,5,N,Y,1448359878707,265791,267089
MASONB.txt,267349,267834,485,5,N,N,-,-1,-1
MASONB.txt,267836,268821,985,5,N,Y,1448360140810,268069,269800
MASONB.txt,268822,269806,984,5,N,Y,1448360140810,268069,269800
MASONB.txt,269807,270645,838,5,N,Y,1448360754961,270225,271673
MASONB.txt,270646,271577,931,5,N,Y,1448360754961,270225,271673
MASONB.txt,271578,272078,500,5,N,Y,1448366107348,271942,274308
MASONB.txt,272079,272794,715,5,N,Y,1448366107348,271942,274308
MASONB.txt,272796,273208,412,5,N,Y,1448366107348,271942,274308
MASONB.txt,273209,273748,539,5,N,Y,1448366107348,271942,274308
MASONB.txt,273749,274654,905,5,Y,Y,1448366107348,271942,274308
MASONB.txt,274655,275527,872,5,N,Y,1448366290289,275380,275651
MASONB.txt,275528,276579,1051,5,N,Y,1448366492754,275659,275884
MASONB.txt,276580,277455,875,5,N,Y,1448366833867,275966,276698
MASONB.txt,277458,278011,553,5,N,N,-,-1,-1
MASONB.txt,278016,278593,577,5,N,Y,1448367094347,278355,278591
MASONB.txt,278594,279184,590,5,N,Y,1448369133400,279084,280004
MASONB.txt,279185,279877,692,5,N,Y,1448369133400,279084,280004
MASONB.txt,279878,280497,619,5,N,Y,1448369133400,279084,280004
MASONB.txt,280500,281817,1317,5,N,Y,1448369361055,281280,281814
MASONB.txt,281819,283078,1259,5,N,Y,1448369703497,282374,282547
MASONB.txt,283081,283917,836,5,N,N,-,-1,-1
MASONB.txt,283918,284461,543,5,N,Y,1448393386565,284140,284575
MASONB.txt,284464,284884,420,5,N,Y,1448393386565,284140,284575
MASONB.txt,284885,285742,857,5,N,N,-,-1,-1
MASONB.txt,285743,286115,372,5,N,N,-,-1,-1
MASONB.txt,286116,286793,677,5,N,N,-,-1,-1
MASONB.txt,286794,287420,626,5,N,N,-,-1,-1
MASONB.txt,287422,287737,315,5,N,N,-,-1,-1
MASONB.txt,287740,288272,532,5,N,Y,1448393552252,287738,288962
MASONB.txt,288273,289018,745,5,N,Y,1448393552252,287738,288962
MASONB.txt,289021,289667,646,5,N,Y,1448393918391,289044,290517
MASONB.txt,289668,290352,684,5,N,Y,1448393918391,289044,290517
MASONB.txt,290353,290723,370,5,N,Y,1448393918391,289044,290517
MASONB.txt,290726,291096,370,5,N,Y,1448394436678,290724,292129
MASONB.txt,291097,291260,163,5,N,Y,1448394436678,290724,292129
MASONB.txt,291263,291420,157,5,N,Y,1448394436678,290724,292129
MASONB.txt,291425,291812,387,5,N,Y,1448394436678,290724,292129
MASONB.txt,291813,292539,726,5,N,Y,1448394636895,292272,293963
MASONB.txt,292540,292791,251,5,N,Y,1448394636895,292272,293963
MASONB.txt,292793,292965,172,5,N,Y,1448394636895,292272,293963
MASONB.txt,292966,293275,309,5,N,Y,1448394636895,292272,293963
MASONB.txt,293276,293972,696,5,N,Y,1448394636895,292272,293963
MASONB.txt,293975,294390,415,5,N,Y,1448394918930,293978,294297
MASONB.txt,294391,295049,658,5,N,Y,1448395538701,294934,295016
MASONB.txt,295052,295834,782,5,N,Y,1448396118064,295199,297352
MASONB.txt,295835,296762,927,5,N,Y,1448396118064,295199,297352
MASONB.txt,296765,297690,925,5,N,Y,1448396118064,295199,297352
MASONB.txt,297693,298503,810,5,N,N,-,-1,-1
MASONB.txt,298504,298975,471,5,N,Y,1448396244435,298633,299110
MASONB.txt,298978,299600,622,5,N,Y,1448396244435,298633,299110
MASONB.txt,299603,300145,542,5,N,Y,1448396441082,299649,301294
MASONB.txt,300148,300400,252,5,N,Y,1448396441082,299649,301294
MASONB.txt,300402,300584,182,5,N,Y,1448396441082,299649,301294
MASONB.txt,300585,301211,626,5,N,Y,1448396441082,299649,301294
MASONB.txt,301212,301745,533,5,N,Y,1448396441082,299649,301294
MASONB.txt,301746,302598,852,5,N,Y,1448396682588,302572,302721
MASONB.txt,302599,302841,242,5,N,Y,1448396898923,302722,302823
MASONB.txt,302844,303331,487,5,N,N,-,-1,-1
MASONB.txt,303332,303923,591,5,N,N,-,-1,-1
MASONB.txt,303924,304043,119,5,N,N,-,-1,-1
MASONB.txt,304046,304520,474,5,N,N,-,-1,-1
MASONB.txt,304521,305381,860,5,N,N,-,-1,-1
MASONB.txt,305382,306136,754,5,N,Y,1448397101672,305423,307582
MASONB.txt,306139,306788,649,5,N,Y,1448397101672,305423,307582
MASONB.txt,306789,307621,832,5,N,Y,1448397101672,305423,307582
MASONB.txt,307622,308689,1067,5,N,Y,1448397303768,308560,309010
MASONB.txt,308690,309485,795,5,N,Y,1448397303768,308560,309010
MASONB.txt,309488,310445,957,5,N,N,-,-1,-1
MASONB.txt,310446,311260,814,5,N,Y,1448397400459,310446,310619
MASONB.txt,311261,311905,644,5,N,N,-,-1,-1
MASONB.txt,311906,312718,812,5,N,Y,1448658303622,312507,313648
MASONB.txt,312720,312979,259,5,N,Y,1448658303622,312507,313648
MASONB.txt,312982,313181,199,5,N,Y,1448658303622,312507,313648
MASONB.txt,313184,314063,879,5,N,Y,1448658303622,312507,313648
MASONB.txt,314064,314791,727,5,N,N,-,-1,-1
MASONB.txt,314792,315819,1027,5,N,N,-,-1,-1
MASONB.txt,315820,316679,859,5,N,Y,1448658612805,316427,316672
MASONB.txt,316681,317455,774,5,N,Y,1448658736891,316691,317030
MASONB.txt,317458,318668,1210,5,N,Y,1448658878157,317802,318970
MASONB.txt,318669,319417,748,5,N,Y,1448659006435,318991,319718
MASONB.txt,319418,321288,1870,5,N,Y,1448659006435,318991,319718
MASONB.txt,321289,321878,589,5,N,N,-,-1,-1
MASONB.txt,321879,323110,1231,5,N,Y,1448659261066,322714,323579
MASONB.txt,323111,323747,636,5,N,Y,1448659261066,322714,323579
MASONB.txt,323748,324784,1036,5,N,Y,1448659532009,324326,325031
MASONB.txt,324785,325513,728,5,N,Y,1448659532009,324326,325031
MASONB.txt,325514,326584,1070,5,N,Y,1448660077114,325649,326955
MASONB.txt,326585,327298,713,5,N,Y,1448660077114,325649,326955
MASONB.txt,327299,328015,716,5,N,N,-,-1,-1
MASONB.txt,328016,329202,1186,5,N,Y,1448660482807,328289,328500
MASONB.txt,329203,329766,563,5,N,Y,1448660677535,329295,329761
MASONB.txt,329767,331132,1365,5,N,Y,1448706202822,330411,331016
MASONB.txt,331133,331898,765,5,N,Y,1448706327916,331732,332605
MASONB.txt,331899,333052,1153,5,N,Y,1448706327916,331732,332605
MASONB.txt,333055,333391,336,5,N,Y,1448707430181,333075,333132
MASONB.txt,333394,334265,871,5,N,Y,1448707642133,333165,333450
MASONB.txt,334266,335040,774,5,N,Y,1448709266671,335017,336316
MASONB.txt,335041,335242,201,5,N,Y,1448709266671,335017,336316
MASONB.txt,335245,335489,244,5,N,Y,1448709266671,335017,336316
MASONB.txt,335492,335641,149,5,N,Y,1448709266671,335017,336316
MASONB.txt,335644,335852,208,5,N,Y,1448709266671,335017,336316
MASONB.txt,335853,336039,186,5,N,Y,1448709266671,335017,336316
MASONB.txt,336040,336123,83,5,N,Y,1448709266671,335017,336316
MASONB.txt,336126,336220,94,5,N,Y,1448709266671,335017,336316
MASONB.txt,336221,336760,539,5,N,Y,1448709266671,335017,336316
MASONB.txt,336762,337116,354,5,N,N,-,-1,-1
MASONB.txt,337119,337435,316,5,N,Y,1448709417506,337306,338419
MASONB.txt,337437,337794,357,5,N,Y,1448709417506,337306,338419
MASONB.txt,337797,338835,1038,5,N,Y,1448709417506,337306,338419
MASONB.txt,338836,339325,489,5,N,Y,1448709670572,338913,339172
MASONB.txt,339326,340137,811,5,N,Y,1448709848065,339253,340600
MASONB.txt,340138,340782,644,5,N,Y,1448709848065,339253,340600
MASONB.txt,340784,341405,621,5,N,Y,1448835299579,341107,342636
MASONB.txt,341406,341818,412,5,N,Y,1448835299579,341107,342636
MASONB.txt,341821,342033,212,5,N,Y,1448835299579,341107,342636
MASONB.txt,342034,342580,546,5,N,Y,1448835299579,341107,342636
MASONB.txt,342583,342912,329,5,N,Y,1448835299579,341107,342636
MASONB.txt,342915,343023,108,5,N,N,-,-1,-1
MASONB.txt,343024,343128,104,5,N,N,-,-1,-1
MASONB.txt,343129,343236,107,5,N,N,-,-1,-1
MASONB.txt,343237,343351,114,5,N,N,-,-1,-1
MASONB.txt,343351,343526,175,5,N,N,-,-1,-1
MASONB.txt,343527,343671,144,5,N,N,-,-1,-1
MASONB.txt,343672,343865,193,5,N,N,-,-1,-1
MASONB.txt,343866,344031,165,5,N,N,-,-1,-1
MASONB.txt,344034,344153,119,5,N,N,-,-1,-1
MASONB.txt,344153,344280,127,5,N,N,-,-1,-1
MASONB.txt,344283,344463,180,5,N,N,-,-1,-1
MASONB.txt,344464,344599,135,5,N,N,-,-1,-1
MASONB.txt,344599,344692,93,5,N,N,-,-1,-1
MASONB.txt,344693,344859,166,5,N,N,-,-1,-1
MASONB.txt,344862,345238,376,5,N,N,-,-1,-1
MASONB.txt,345239,345540,301,5,N,N,-,-1,-1
MASONB.txt,345543,346241,698,5,N,Y,1448835409437,345709,346338
MASONB.txt,346242,346513,271,5,N,Y,1448835409437,345709,346338
MASONB.txt,346516,346767,251,5,N,N,-,-1,-1
MASONB.txt,346770,347384,614,5,N,Y,1448835650796,347315,347685
MASONB.txt,347385,348244,859,5,N,Y,1448919978818,348008,348718
MASONB.txt,348246,349005,759,5,N,Y,1448919978818,348008,348718
MASONB.txt,349010,349831,821,5,N,Y,1448920117937,349054,349858
MASONB.txt,349832,350699,867,5,N,Y,1448920117937,349054,349858
MASONB.txt,350700,351060,360,5,N,N,-,-1,-1
MASONB.txt,351063,351921,858,5,N,N,-,-1,-1
MASONB.txt,351922,352905,983,5,N,N,-,-1,-1
MASONB.txt,352910,353231,321,5,N,N,-,-1,-1
MASONB.txt,353234,354659,1425,5,N,N,-,-1,-1
MASONB.txt,354662,355020,358,5,N,N,-,-1,-1
MASONB.txt,355021,355826,805,5,N,N,-,-1,-1
MASONB.txt,355828,356775,947,5,N,N,-,-1,-1
MASONB.txt,356777,357527,750,5,N,N,-,-1,-1
MASONB.txt,357528,358433,905,5,N,Y,1448920293515,357836,358190
MASONB.txt,358436,358867,431,5,N,N,-,-1,-1
MASONB.txt,358868,360159,1291,5,N,N,-,-1,-1
MASONB.txt,360160,360626,466,5,N,N,-,-1,-1
MASONB.txt,360627,361287,660,5,N,N,-,-1,-1
MASONB.txt,361288,362257,969,5,Y,N,-,-1,-1
MASONB.txt,362258,363340,1082,5,N,Y,1448920858487,363333,364839
MASONB.txt,363341,364645,1304,5,N,Y,1448920858487,363333,364839
MASONB.txt,364646,365236,590,5,N,Y,1448920858487,363333,364839
MASONB.txt,365237,365975,738,5,N,Y,1448921066520,364890,365963
MASONB.txt,365978,366490,512,5,N,N,-,-1,-1
MASONB.txt,366491,367052,561,5,N,N,-,-1,-1
MASONB.txt,367053,368572,1519,5,N,Y,1448921338450,367291,368573
MASONB.txt,368575,369144,569,5,N,N,-,-1,-1
MASONB.txt,369145,369468,323,5,N,N,-,-1,-1
MASONB.txt,369469,370263,794,5,N,N,-,-1,-1
MASONB.txt,370264,370663,399,5,N,N,-,-1,-1
MASONB.txt,370666,371023,357,5,N,Y,1448921716519,370956,371267
MASONB.txt,371024,371725,701,5,N,Y,1448921716519,370956,371267
MASONB.txt,371726,372506,780,5,N,N,-,-1,-1
MASONB.txt,372507,373320,813,5,N,N,-,-1,-1
MASONB.txt,373321,373846,525,5,N,Y,1448922003968,373392,374323
MASONB.txt,373847,374656,809,5,N,Y,1448922003968,373392,374323
MASONB.txt,374657,375316,659,5,N,N,-,-1,-1
MASONB.txt,375317,375790,473,5,Y,N,-,-1,-1
MASONB.txt,375791,376431,640,5,N,N,-,-1,-1
MASONB.txt,376432,377123,691,5,N,N,-,-1,-1
MASONB.txt,377123,377736,613,5,N,Y,1448922458482,377161,378772
MASONB.txt,377737,378066,329,5,N,Y,1448922458482,377161,378772
MASONB.txt,378067,378864,797,5,N,Y,1448922458482,377161,378772
MASONB.txt,378865,379517,652,5,N,N,-,-1,-1
MASONB.txt,379518,380575,1057,5,N,N,-,-1,-1
MASONB.txt,380577,381233,656,5,N,Y,1448922776454,380731,381577
MASONB.txt,381235,382014,779,5,Y,Y,1448923016815,381625,382381
MASONB.txt,382015,383071,1056,5,N,Y,1448923016815,381625,382381
MASONB.txt,383072,383692,620,5,N,N,-,-1,-1
MASONB.txt,383693,384316,623,5,N,N,-,-1,-1
MASONB.txt,384317,384635,318,5,N,N,-,-1,-1
MASONB.txt,384637,384984,347,5,N,N,-,-1,-1
MASONB.txt,384985,385652,667,5,N,N,-,-1,-1
MASONB.txt,385655,386230,575,5,N,N,-,-1,-1
MASONB.txt,386231,386759,528,5,N,N,-,-1,-1
MASONB.txt,386760,387202,442,5,N,N,-,-1,-1
MASONB.txt,387203,387680,477,5,N,N,-,-1,-1
MASONB.txt,387681,388119,438,5,N,N,-,-1,-1
MASONB.txt,388120,388806,686,5,N,N,-,-1,-1
MASONB.txt,388807,389674,867,5,N,N,-,-1,-1
MASONB.txt,389677,390189,512,5,N,N,-,-1,-1
MASONB.txt,390190,391051,861,5,N,N,-,-1,-1
MASONB.txt,391052,391732,680,5,Y,N,-,-1,-1
MASONB.txt,391733,392835,1102,5,Y,N,-,-1,-1
MASONB.txt,392838,394137,1299,5,N,N,-,-1,-1
MASONB.txt,394140,394653,513,5,N,N,-,-1,-1
MASONB.txt,394653,395126,473,5,N,N,-,-1,-1
MASONB.txt,395128,395470,342,5,N,N,-,-1,-1
MASONB.txt,395472,395768,296,5,N,N,-,-1,-1
MASONB.txt,395768,396078,310,5,N,N,-,-1,-1
MASONB.txt,396078,396435,357,5,N,N,-,-1,-1
MASONB.txt,396435,396834,399,5,N,N,-,-1,-1
MASONB.txt,396837,397158,321,5,N,N,-,-1,-1
MASONB.txt,397159,397356,197,5,N,N,-,-1,-1
MASONB.txt,397357,397557,200,5,N,N,-,-1,-1
MASONB.txt,397558,397717,159,5,N,N,-,-1,-1
MASONB.txt,397720,397888,168,5,N,N,-,-1,-1
MASONB.txt,397889,398158,269,5,N,N,-,-1,-1
MASONB.txt,398158,398490,332,5,N,N,-,-1,-1
MASONB.txt,398491,398802,311,5,N,N,-,-1,-1
MASONB.txt,398803,399575,772,5,N,N,-,-1,-1
MASONB.txt,399577,400005,428,5,N,N,-,-1,-1
MASONB.txt,400008,400620,612,5,N,N,-,-1,-1
MASONB.txt,400623,401211,588,5,N,N,-,-1,-1
MASONB.txt,401212,402073,861,5,N,N,-,-1,-1
MASONB.txt,402074,402731,657,5,N,N,-,-1,-1
MASONB.txt,402732,403378,646,5,N,N,-,-1,-1
MASONB.txt,403379,403996,617,5,N,N,-,-1,-1
MASONB.txt,403997,404698,701,5,N,N,-,-1,-1
MASONB.txt,404699,405573,874,5,Y,N,-,-1,-1
MASONB.txt,405574,406269,695,5,N,N,-,-1,-1
MASONB.txt,406270,406795,525,5,N,N,-,-1,-1
MASONB.txt,406796,407413,617,5,N,N,-,-1,-1
MASONB.txt,407414,408178,764,5,N,N,-,-1,-1
MASONB.txt,408179,408574,395,5,N,N,-,-1,-1
MASONB.txt,408575,409096,521,5,N,N,-,-1,-1
MASONB.txt,409097,409681,584,5,N,N,-,-1,-1
MASONB.txt,409682,410367,685,5,N,N,-,-1,-1
MASONB.txt,410369,410769,400,5,N,N,-,-1,-1
MASONB.txt,410770,411471,701,5,Y,N,-,-1,-1
MASONB.txt,411472,412233,761,5,N,N,-,-1,-1
MASONB.txt,412234,412726,492,5,N,N,-,-1,-1
MASONB.txt,412727,413175,448,5,N,N,-,-1,-1
MASONB.txt,413176,414000,824,5,N,N,-,-1,-1
MASONB.txt,414003,414204,201,5,N,N,-,-1,-1
MASONB.txt,414205,414354,149,5,N,N,-,-1,-1
MASONB.txt,414355,414525,170,5,N,N,-,-1,-1
MASONB.txt,414526,414635,109,5,N,N,-,-1,-1
MASONB.txt,414638,414695,57,5,N,N,-,-1,-1
MASONB.txt,414696,414930,234,5,N,N,-,-1,-1
MASONB.txt,414930,415325,395,5,N,N,-,-1,-1
MASONB.txt,415325,415490,165,5,N,N,-,-1,-1
MASONB.txt,415491,415631,140,5,N,N,-,-1,-1
MASONB.txt,415632,416266,634,5,N,N,-,-1,-1
MASONB.txt,416269,416656,387,5,N,N,-,-1,-1
MASONB.txt,416657,417307,650,5,N,N,-,-1,-1
MASONB.txt,417308,417989,681,5,N,N,-,-1,-1
MASONB.txt,417990,418686,696,5,N,N,-,-1,-1
MASONB.txt,418687,419434,747,5,Y,N,-,-1,-1
MASONB.txt,419435,419803,368,5,N,N,-,-1,-1
MASONB.txt,419804,420333,529,5,N,N,-,-1,-1
MASONB.txt,420334,421223,889,5,N,N,-,-1,-1
MASONB.txt,421224,421890,666,5,N,N,-,-1,-1
MASONB.txt,421891,422458,567,5,N,N,-,-1,-1
MASONB.txt,422459,422826,367,5,N,N,-,-1,-1
MASONB.txt,422827,423604,777,5,N,N,-,-1,-1
MASONB.txt,423605,424146,541,5,N,N,-,-1,-1
MASONB.txt,424147,424743,596,5,N,N,-,-1,-1
MASONB.txt,424746,425376,630,5,N,N,-,-1,-1
MASONB.txt,425377,426109,732,5,N,N,-,-1,-1
MASONB.txt,426110,427016,906,5,N,N,-,-1,-1
MASONB.txt,427017,427208,191,5,N,N,-,-1,-1
MASONB.txt,427209,428151,942,5,N,N,-,-1,-1
MASONB.txt,428153,428812,659,5,N,N,-,-1,-1
MASONB.txt,428813,429593,780,5,N,N,-,-1,-1
MASONB.txt,429594,430389,795,5,N,N,-,-1,-1
MASONB.txt,430390,431115,725,5,Y,N,-,-1,-1
MASONB.txt,431116,431568,452,5,N,N,-,-1,-1
MASONB.txt,431569,432063,494,5,N,N,-,-1,-1
MASONB.txt,432064,432551,487,5,N,N,-,-1,-1
MASONB.txt,432552,433428,876,5,N,N,-,-1,-1
MASONB.txt,433429,434111,682,5,N,N,-,-1,-1
MASONB.txt,434112,434641,529,5,N,N,-,-1,-1
MASONB.txt,434642,435201,559,5,N,N,-,-1,-1
MASONB.txt,435202,435663,461,5,N,N,-,-1,-1
MASONB.txt,435664,436237,573,5,N,N,-,-1,-1
MASONB.txt,436238,436778,540,5,N,N,-,-1,-1
MASONB.txt,436780,438093,1313,5,N,N,-,-1,-1
MASONB.txt,438096,438724,628,5,N,N,-,-1,-1
MASONB.txt,438725,439671,946,5,N,N,-,-1,-1
MASONB.txt,439672,440566,894,5,N,N,-,-1,-1
MASONB.txt,440567,441318,751,5,N,N,-,-1,-1
MASONB.txt,441319,441964,645,5,Y,N,-,-1,-1
MASONB.txt,441965,442762,797,5,N,N,-,-1,-1
MASONB.txt,442763,443775,1012,5,N,N,-,-1,-1
MASONB.txt,443776,444556,780,5,N,N,-,-1,-1
MASONB.txt,444557,445794,1237,5,N,N,-,-1,-1
MASONB.txt,445797,446042,245,5,N,N,-,-1,-1
MASONB.txt,446043,446385,342,5,N,N,-,-1,-1
MASONB.txt,446387,446842,455,5,N,N,-,-1,-1
MASONB.txt,446843,447879,1036,5,N,N,-,-1,-1
MASONB.txt,447880,448337,457,5,N,N,-,-1,-1
MASONB.txt,448340,448730,390,5,N,N,-,-1,-1
MASONB.txt,448731,449018,287,5,N,N,-,-1,-1
MASONB.txt,449021,449159,138,5,N,N,-,-1,-1
MASONB.txt,449160,449372,212,5,N,N,-,-1,-1
MASONB.txt,449373,449595,222,5,N,N,-,-1,-1
MASONB.txt,449598,449738,140,5,N,N,-,-1,-1
MASONB.txt,449739,449956,217,5,N,N,-,-1,-1
MASONB.txt,449957,450092,135,5,N,N,-,-1,-1
MASONB.txt,450093,450425,332,5,N,N,-,-1,-1
MASONB.txt,450427,451203,776,5,N,N,-,-1,-1
MASONB.txt,451204,451561,357,5,N,N,-,-1,-1
MASONB.txt,451562,452338,776,5,N,N,-,-1,-1
MASONB.txt,452339,452807,468,5,N,N,-,-1,-1
MASONB.txt,452808,453714,906,5,N,N,-,-1,-1
MASONB.txt,453716,454149,433,5,N,N,-,-1,-1
MASONB.txt,454150,454748,598,5,N,N,-,-1,-1
MASONB.txt,454749,455422,673,5,N,N,-,-1,-1
MASONB.txt,455423,455992,569,5,N,N,-,-1,-1
MASONB.txt,455995,456541,546,5,N,N,-,-1,-1
MASONB.txt,456542,457464,922,5,N,N,-,-1,-1
MASONB.txt,457465,457900,435,5,N,N,-,-1,-1
MASONB.txt,457901,458500,599,5,N,N,-,-1,-1
MASONB.txt,458503,458854,351,5,N,N,-,-1,-1
MASONB.txt,458854,459115,261,5,N,N,-,-1,-1
MASONB.txt,459116,459473,357,5,N,N,-,-1,-1
MASONB.txt,459476,459763,287,5,N,N,-,-1,-1
MASONB.txt,459765,460116,351,5,N,N,-,-1,-1
MASONB.txt,460118,460498,380,5,N,N,-,-1,-1
MASONB.txt,460500,460819,319,5,N,N,-,-1,-1
MASONB.txt,460821,461171,350,5,N,N,-,-1,-1
MASONB.txt,461174,461365,191,5,N,N,-,-1,-1
MASONB.txt,461366,461925,559,5,N,N,-,-1,-1
MASONB.txt,461930,462370,440,5,N,N,-,-1,-1
MASONB.txt,462375,462626,251,5,N,N,-,-1,-1
MASONB.txt,462629,462903,274,5,N,N,-,-1,-1
MASONB.txt,462904,463418,514,5,N,N,-,-1,-1
MASONB.txt,463419,463962,543,5,N,N,-,-1,-1
MASONB.txt,463965,464543,578,5,N,N,-,-1,-1
MASONB.txt,464544,465286,742,5,N,N,-,-1,-1
MASONB.txt,465287,466251,964,5,N,N,-,-1,-1
MASONB.txt,466253,466385,132,5,N,N,-,-1,-1
MASONB.txt,466387,466703,316,5,N,N,-,-1,-1
MASONB.txt,466704,467366,662,5,N,N,-,-1,-1
MASONB.txt,467367,468087,720,5,N,N,-,-1,-1
MASONB.txt,468090,468244,154,5,N,N,-,-1,-1
MASONB.txt,468245,468429,184,5,N,N,-,-1,-1
MASONB.txt,468429,469197,768,5,N,N,-,-1,-1
MASONB.txt,469198,469872,674,5,N,N,-,-1,-1
MASONB.txt,469873,470104,231,5,N,N,-,-1,-1
MASONB.txt,470107,470943,836,5,N,N,-,-1,-1
MASONB.txt,470948,471317,369,5,N,Y,1448923619461,471131,472718
MASONB.txt,471318,471775,457,5,N,Y,1448923619461,471131,472718
MASONB.txt,471776,472321,545,5,N,Y,1448923619461,471131,472718
MASONB.txt,472323,472916,593,5,N,Y,1448923619461,471131,472718
MASONB.txt,472919,473611,692,5,N,Y,1449009694213,473488,474410
MASONB.txt,473612,474137,525,5,N,Y,1449009694213,473488,474410
MASONB.txt,474138,474507,369,5,N,Y,1449009694213,473488,474410
MASONB.txt,474510,474905,395,5,N,N,-,-1,-1
MASONB.txt,474907,475880,973,5,N,N,-,-1,-1
MASONB.txt,475882,476640,758,5,N,N,-,-1,-1
MASONB.txt,476643,477569,926,5,N,N,-,-1,-1
MASONB.txt,477571,478644,1073,5,N,N,-,-1,-1
MASONB.txt,478647,479156,509,5,N,N,-,-1,-1
MASONB.txt,479157,479408,251,5,N,N,-,-1,-1
MASONB.txt,479411,479724,313,5,N,N,-,-1,-1
MASONB.txt,479725,480357,632,5,N,N,-,-1,-1
MASONB.txt,480358,481492,1134,5,N,N,-,-1,-1
MASONB.txt,481493,482142,649,5,N,N,-,-1,-1
MASONB.txt,482145,482366,221,5,N,N,-,-1,-1
MASONB.txt,482367,482500,133,5,N,N,-,-1,-1
MASONB.txt,482501,482745,244,5,N,N,-,-1,-1
MASONB.txt,482746,482848,102,5,N,N,-,-1,-1
MASONB.txt,482849,482930,81,5,N,N,-,-1,-1
MASONB.txt,482930,483049,119,5,N,N,-,-1,-1
MASONB.txt,483050,483312,262,5,N,N,-,-1,-1
MASONB.txt,483313,483570,257,5,N,N,-,-1,-1
MASONB.txt,483571,483685,114,5,N,N,-,-1,-1
MASONB.txt,483690,484626,936,5,N,N,-,-1,-1
MASONB.txt,484627,485391,764,5,N,N,-,-1,-1
MASONB.txt,485392,486152,760,5,N,N,-,-1,-1
MASONB.txt,486153,486446,293,5,N,N,-,-1,-1
MASONB.txt,486449,487477,1028,5,N,N,-,-1,-1
MASONB.txt,487478,488152,674,5,N,N,-,-1,-1
MASONB.txt,488153,488240,87,5,N,N,-,-1,-1
MASONB.txt,488241,488442,201,5,N,N,-,-1,-1
MASONB.txt,488443,488602,159,5,N,N,-,-1,-1
MASONB.txt,488603,488768,165,5,N,N,-,-1,-1
MASONB.txt,488771,489055,284,5,N,N,-,-1,-1
MASONB.txt,489056,489183,127,5,N,N,-,-1,-1
MASONB.txt,489186,489406,220,5,N,N,-,-1,-1
MASONB.txt,489409,489599,190,5,N,N,-,-1,-1
MASONB.txt,489600,489789,189,5,N,N,-,-1,-1
MASONB.txt,489789,489994,205,5,N,N,-,-1,-1
MASONB.txt,489995,490972,977,5,Y,N,-,-1,-1
MASONB.txt,490972,492180,1208,5,N,N,-,-1,-1
MASONB.txt,492182,493287,1105,5,N,N,-,-1,-1
MASONB.txt,493288,493904,616,5,N,N,-,-1,-1
MASONB.txt,493905,494661,756,5,N,N,-,-1,-1
MASONB.txt,494664,495109,445,5,N,N,-,-1,-1
MASONB.txt,495110,495711,601,5,N,N,-,-1,-1
MASONB.txt,495712,496177,465,5,N,N,-,-1,-1
MASONB.txt,496179,496983,804,5,N,N,-,-1,-1
MASONB.txt,496986,498192,1206,5,N,N,-,-1,-1
MASONB.txt,498193,498638,445,5,N,N,-,-1,-1
MASONB.txt,498639,498889,250,5,N,N,-,-1,-1
MASONB.txt,498892,499238,346,5,N,N,-,-1,-1
MASONB.txt,499239,500002,763,5,N,N,-,-1,-1
MASONB.txt,500003,500452,449,5,N,N,-,-1,-1
MASONB.txt,500454,501322,868,5,Y,N,-,-1,-1
MASONB.txt,501323,502447,1124,5,N,N,-,-1,-1
MASONB.txt,502448,503088,640,5,N,N,-,-1,-1
MASONB.txt,503089,503890,801,5,N,N,-,-1,-1
MASONB.txt,503891,504628,737,5,N,N,-,-1,-1
MASONB.txt,504629,505397,768,5,N,N,-,-1,-1
MASONB.txt,505398,506231,833,5,N,N,-,-1,-1
MASONB.txt,506232,506737,505,5,N,N,-,-1,-1
MASONB.txt,506738,507351,613,5,N,N,-,-1,-1
MASONB.txt,507352,507809,457,5,N,N,-,-1,-1
MASONB.txt,507810,508226,416,5,N,N,-,-1,-1
MASONB.txt,508229,508976,747,5,N,N,-,-1,-1
MASONB.txt,508979,509338,359,5,N,N,-,-1,-1
MASONB.txt,509341,509812,471,5,N,N,-,-1,-1
MASONB.txt,509815,510061,246,5,N,N,-,-1,-1
MASONB.txt,510062,510293,231,5,N,N,-,-1,-1
MASONB.txt,510294,510487,193,5,N,N,-,-1,-1
MASONB.txt,510490,510711,221,5,N,N,-,-1,-1
MASONB.txt,510714,511027,313,5,N,N,-,-1,-1
MASONB.txt,511028,511344,316,5,N,N,-,-1,-1
MASONB.txt,511345,511914,569,5,N,N,-,-1,-1
MASONB.txt,511915,512479,564,5,N,N,-,-1,-1
MASONB.txt,512480,512803,323,5,N,N,-,-1,-1
MASONB.txt,512804,513812,1008,5,N,N,-,-1,-1
MASONB.txt,513814,514544,730,5,N,N,-,-1,-1
MASONB.txt,514547,515215,668,5,N,N,-,-1,-1
MASONB.txt,515216,516152,936,5,N,N,-,-1,-1
MASONB.txt,516153,516969,816,5,Y,N,-,-1,-1
MASONB.txt,516970,517356,386,5,N,N,-,-1,-1
MASONB.txt,517359,518011,652,5,N,N,-,-1,-1
MASONB.txt,518012,518627,615,5,N,N,-,-1,-1
MASONB.txt,518628,519123,495,5,N,N,-,-1,-1
MASONB.txt,519125,519809,684,5,N,N,-,-1,-1
MASONB.txt,519810,520167,357,5,N,N,-,-1,-1
MASONB.txt,520168,520739,571,5,N,N,-,-1,-1
MASONB.txt,520740,521087,347,5,N,N,-,-1,-1
MASONB.txt,521088,521624,536,5,N,N,-,-1,-1
MASONB.txt,521626,522164,538,5,N,N,-,-1,-1
MASONB.txt,522165,522765,600,5,N,N,-,-1,-1
MASONB.txt,522767,523363,596,5,N,N,-,-1,-1
MASONB.txt,523364,523952,588,5,N,N,-,-1,-1
MASONB.txt,523953,524557,604,5,Y,N,-,-1,-1
MASONB.txt,524558,525063,505,5,N,N,-,-1,-1
MASONB.txt,525064,525538,474,5,N,N,-,-1,-1
MASONB.txt,525539,526535,996,5,N,N,-,-1,-1
MASONB.txt,526536,526741,205,5,N,N,-,-1,-1
MASONB.txt,526742,527147,405,5,N,N,-,-1,-1
MASONB.txt,527148,527696,548,5,N,N,-,-1,-1
MASONB.txt,527697,528450,753,5,N,Y,1449011557797,528395,529262
MASONB.txt,528451,529101,650,5,N,Y,1449011557797,528395,529262
MASONB.txt,529102,529609,507,5,N,Y,1449011557797,528395,529262
MASONB.txt,529612,530035,423,5,N,N,-,-1,-1
MASONB.txt,530036,530496,460,5,N,N,-,-1,-1
MASONB.txt,530497,531359,862,5,N,N,-,-1,-1
MASONB.txt,531361,532907,1546,5,Y,N,-,-1,-1
MASONB.txt,532910,533120,210,5,N,N,-,-1,-1
MASONB.txt,533123,533794,671,5,N,Y,1449011929492,533126,533951
MASONB.txt,533796,534232,436,5,N,Y,1461670558474,533968,535655
MASONB.txt,534233,535336,1103,5,N,Y,1461670558474,533968,535655
MASONB.txt,535337,535838,501,5,N,Y,1461670707714,535735,535836
MASONB.txt,535841,536422,581,5,N,Y,1461671039271,535897,538614
MASONB.txt,536424,536934,510,5,N,Y,1461671039271,535897,538614
MASONB.txt,536935,537833,898,5,N,Y,1461671039271,535897,538614
MASONB.txt,537834,538286,452,5,N,Y,1461671039271,535897,538614
MASONB.txt,538289,538690,401,5,N,Y,1461671039271,535897,538614
MASONB.txt,538695,539237,542,5,N,Y,1461671237429,538958,540588
MASONB.txt,539238,539722,484,5,N,Y,1461671237429,538958,540588
MASONB.txt,539723,540375,652,5,N,Y,1461671237429,538958,540588
MASONB.txt,540376,540996,620,5,N,Y,1461682939139,540732,541471
MASONB.txt,540997,541587,590,5,N,Y,1461682939139,540732,541471
MASONB.txt,541595,541752,157,5,N,N,-,-1,-1
MASONB.txt,541753,542022,269,5,N,N,-,-1,-1
MASONB.txt,542025,542215,190,5,N,N,-,-1,-1
MASONB.txt,542216,542518,302,5,N,N,-,-1,-1
MASONB.txt,542521,542694,173,5,N,N,-,-1,-1
MASONB.txt,542695,543005,310,5,N,N,-,-1,-1
MASONB.txt,543006,543271,265,5,N,N,-,-1,-1
MASONB.txt,543274,543546,272,5,N,N,-,-1,-1
MASONB.txt,543547,544089,542,5,N,Y,1461777193721,543550,543984
MASONB.txt,544090,544841,751,5,N,Y,1461777612954,544164,545194
MASONB.txt,544842,545247,405,5,N,Y,1461777612954,544164,545194
MASONB.txt,545250,546070,820,5,N,N,-,-1,-1
MASONB.txt,546073,546531,458,5,N,N,-,-1,-1
MASONB.txt,546536,547048,512,5,N,Y,1461779662782,546686,549591
MASONB.txt,547049,547979,930,5,N,Y,1461779662782,546686,549591
MASONB.txt,547982,548406,424,5,N,Y,1461779662782,546686,549591
MASONB.txt,548407,549146,739,5,N,Y,1461779662782,546686,549591
MASONB.txt,549147,549690,543,5,N,Y,1461779662782,546686,549591
MASONB.txt,549693,550058,365,5,N,Y,1461790279048,549743,550180
MASONB.txt,550059,550833,774,5,N,Y,1461790554025,550059,551049
MASONB.txt,550834,551407,573,5,N,Y,1461790554025,550059,551049
MASONB.txt,551408,552121,713,5,N,Y,1461791817263,551075,551983
MASONB.txt,552124,552614,490,5,N,Y,1462035341084,552137,553334
MASONB.txt,552615,553082,467,5,N,Y,1462035341084,552137,553334
MASONB.txt,553083,553671,588,5,N,Y,1462035341084,552137,553334
MASONB.txt,553672,554436,764,5,N,N,-,-1,-1
MASONB.txt,554437,554839,402,5,N,Y,1462037372440,554649,554769
MASONB.txt,554840,555264,424,5,N,Y,1462037999108,555079,556305
MASONB.txt,555265,556425,1160,5,N,Y,1462038250768,556311,558014
MASONB.txt,556427,557292,865,5,N,Y,1462038250768,556311,558014
MASONB.txt,557294,558247,953,5,N,Y,1462038250768,556311,558014
MASONB.txt,558248,558800,552,5,N,Y,1462038377036,558101,558326
MASONB.txt,558801,559177,376,5,N,N,-,-1,-1
MASONB.txt,559178,559887,709,5,N,N,-,-1,-1
MASONB.txt,559892,560488,596,5,N,N,-,-1,-1
MASONB.txt,560493,560686,193,5,N,N,-,-1,-1
MASONB.txt,560687,560808,121,5,N,N,-,-1,-1
MASONB.txt,560809,560986,177,5,N,N,-,-1,-1
MASONB.txt,560987,561069,82,5,N,N,-,-1,-1
MASONB.txt,561070,561536,466,5,N,N,-,-1,-1
MASONB.txt,561537,562257,720,5,N,N,-,-1,-1
MASONB.txt,562262,562728,466,5,N,N,-,-1,-1
MASONB.txt,562729,563155,426,5,N,N,-,-1,-1
MASONB.txt,563156,563765,609,5,N,N,-,-1,-1
MASONB.txt,563768,564191,423,5,N,N,-,-1,-1
MASONB.txt,564192,564613,421,5,Y,N,-,-1,-1
MASONB.txt,564614,565023,409,5,N,N,-,-1,-1
MASONB.txt,565024,565684,660,5,N,N,-,-1,-1
MASONB.txt,565687,566207,520,5,N,N,-,-1,-1
MASONB.txt,566210,566684,474,5,N,N,-,-1,-1
MASONB.txt,566685,567340,655,5,N,N,-,-1,-1
MASONB.txt,567342,567919,577,5,N,N,-,-1,-1
MASONB.txt,567920,568630,710,5,N,N,-,-1,-1
MASONB.txt,568631,569622,991,5,N,N,-,-1,-1
MASONB.txt,569625,570235,610,5,N,N,-,-1,-1
MASONB.txt,570236,570967,731,5,N,N,-,-1,-1
MASONB.txt,570968,571521,553,5,N,N,-,-1,-1
MEMMUS.txt,0,5853,5853,5,Y,N,-,-1,-1
MEMMUS.txt,5856,7939,2083,5,N,N,-,-1,-1
MEMMUS.txt,7940,9716,1776,5,N,N,-,-1,-1
MEMMUS.txt,9717,11007,1290,5,N,N,-,-1,-1
MEMMUS.txt,11008,11429,421,5,N,N,-,-1,-1
MEMMUS.txt,11430,11611,181,5,N,N,-,-1,-1
MEMMUS.txt,11612,11644,32,5,N,N,-,-1,-1
MEMMUS.txt,11645,13127,1482,5,Y,N,-,-1,-1
MEMMUS.txt,13130,13834,704,5,N,N,-,-1,-1
MEMMUS.txt,13837,14807,970,5,Y,N,-,-1,-1
MEMMUS.txt,14808,15818,1010,5,Y,N,-,-1,-1
MEMMUS.txt,15821,16124,303,5,N,N,-,-1,-1
MEMMUS.txt,16126,16679,553,5,N,N,-,-1,-1
MEMMUS.txt,16680,17212,532,5,N,N,-,-1,-1
MEMMUS.txt,17213,17655,442,5,N,N,-,-1,-1
MEMMUS.txt,17656,18455,799,5,N,Y,1435840591315,18262,18851
MEMMUS.txt,18456,18840,384,5,N,Y,1435840591315,18262,18851
MEMMUS.txt,18841,19363,522,5,N,Y,1435840591315,18262,18851
MEMMUS.txt,19364,19941,577,5,N,N,-,-1,-1
MEMMUS.txt,19942,20220,278,5,N,N,-,-1,-1
MEMMUS.txt,20221,20542,321,5,N,N,-,-1,-1
MEMMUS.txt,20543,21041,498,5,N,N,-,-1,-1
MEMMUS.txt,21044,21908,864,5,Y,N,-,-1,-1
MEMMUS.txt,21909,22360,451,5,N,Y,1435915325286,22285,22827
MEMMUS.txt,22361,22934,573,5,N,Y,1435915325286,22285,22827
MEMMUS.txt,22935,23503,568,5,Y,Y,1435915676246,23230,23899
MEMMUS.txt,23504,24033,529,5,N,Y,1435915676246,23230,23899
MEMMUS.txt,24034,24851,817,5,N,Y,1435915981952,24325,25472
MEMMUS.txt,24852,25922,1070,5,N,Y,1435916345649,25766,26337
MEMMUS.txt,25923,26359,436,5,N,Y,1435916345649,25766,26337
MEMMUS.txt,26362,27487,1125,5,Y,N,-,-1,-1
MEMMUS.txt,27488,28241,753,5,N,N,-,-1,-1
MEMMUS.txt,28244,28840,596,5,N,N,-,-1,-1
MEMMUS.txt,28843,29732,889,5,Y,Y,1435916831062,28859,29721
MEMMUS.txt,29735,30543,808,5,N,N,-,-1,-1
MEMMUS.txt,30544,31063,519,5,Y,N,-,-1,-1
MEMMUS.txt,31064,31973,909,5,N,Y,1435926808950,31555,32153
MEMMUS.txt,31974,32671,697,5,N,Y,1435926808950,31555,32153
MEMMUS.txt,32672,33573,901,5,Y,N,-,-1,-1
MEMMUS.txt,33574,34195,621,5,N,Y,1435927129543,33653,34022
MEMMUS.txt,34196,35006,810,5,N,Y,1435927632749,34517,35131
MEMMUS.txt,35007,35776,769,5,N,Y,1435927632749,34517,35131
MEMMUS.txt,35777,36282,505,5,N,Y,1435928087149,36052,37379
MEMMUS.txt,36283,37431,1148,5,N,Y,1435928087149,36052,37379
MEMMUS.txt,37434,38277,843,5,N,N,-,-1,-1
MEMMUS.txt,38280,38764,484,5,N,N,-,-1,-1
MEMMUS.txt,38767,39278,511,5,N,N,-,-1,-1
MEMMUS.txt,39279,39747,468,5,N,N,-,-1,-1
MEMMUS.txt,39750,40636,886,5,Y,N,-,-1,-1
MEMMUS.txt,40639,41517,878,5,N,N,-,-1,-1
MEMMUS.txt,41520,42327,807,5,N,N,-,-1,-1
MEMMUS.txt,42330,42993,663,5,N,N,-,-1,-1
MEMMUS.txt,42995,43573,578,5,N,N,-,-1,-1
MEMMUS.txt,43574,44285,711,5,N,N,-,-1,-1
MEMMUS.txt,44286,44964,678,5,N,N,-,-1,-1
MEMMUS.txt,44965,45590,625,5,Y,N,-,-1,-1
MEMMUS.txt,45591,46067,476,5,N,N,-,-1,-1
MEMMUS.txt,46070,46460,390,5,N,Y,1435929264418,46072,46536
MEMMUS.txt,46461,46757,296,5,N,Y,1435930107895,46560,46927
MEMMUS.txt,46758,47352,594,5,N,Y,1435930107895,46560,46927
MEMMUS.txt,47353,47747,394,5,N,Y,1435930476313,46955,47602
MEMMUS.txt,47748,48514,766,5,Y,N,-,-1,-1
MEMMUS.txt,48515,49285,770,5,N,N,-,-1,-1
MEMMUS.txt,49286,50311,1025,5,Y,N,-,-1,-1
MEMMUS.txt,50314,50999,685,5,Y,N,-,-1,-1
MEMMUS.txt,51000,51963,963,5,N,N,-,-1,-1
MEMMUS.txt,51966,53347,1381,5,N,Y,1435930984335,53222,54022
MEMMUS.txt,53349,53872,523,5,Y,Y,1435930984335,53222,54022
MEMMUS.txt,53873,54642,769,5,Y,Y,1435930984335,53222,54022
MEMMUS.txt,54643,55295,652,5,N,N,-,-1,-1
MEMMUS.txt,55296,55894,598,5,N,N,-,-1,-1
MEMMUS.txt,55897,56783,886,5,N,N,-,-1,-1
MEMMUS.txt,56784,57708,924,5,N,N,-,-1,-1
MEMMUS.txt,57710,58611,901,5,N,N,-,-1,-1
MEMMUS.txt,58612,59108,496,5,N,N,-,-1,-1
MEMMUS.txt,59109,59964,855,5,N,N,-,-1,-1
MEMMUS.txt,59966,60689,723,5,N,N,-,-1,-1
MEMMUS.txt,60690,61715,1025,5,Y,N,-,-1,-1
MEMMUS.txt,61718,62574,856,5,N,N,-,-1,-1
MEMMUS.txt,62577,63059,482,5,N,N,-,-1,-1
MEMMUS.txt,63062,63653,591,5,N,N,-,-1,-1
MEMMUS.txt,63654,64299,645,5,N,N,-,-1,-1
MEMMUS.txt,64300,65142,842,5,Y,Y,1435931512268,64554,65135
MEMMUS.txt,65147,65783,636,5,N,N,-,-1,-1
MEMMUS.txt,65785,66659,874,5,N,N,-,-1,-1
MEMMUS.txt,66660,67281,621,5,N,N,-,-1,-1
MEMMUS.txt,67284,67983,699,5,N,Y,1436164309168,67698,68227
MEMMUS.txt,67984,69123,1139,5,N,Y,1436164309168,67698,68227
MEMMUS.txt,69124,69901,777,5,N,N,-,-1,-1
MEMMUS.txt,69902,70577,675,5,N,Y,1436164628291,70081,70559
MEMMUS.txt,70580,71447,867,5,N,N,-,-1,-1
MEMMUS.txt,71450,72026,576,5,N,N,-,-1,-1
MEMMUS.txt,72027,72801,774,5,N,Y,1436173608702,72553,73111
MEMMUS.txt,72804,73317,513,5,N,Y,1436173608702,72553,73111
MEMMUS.txt,73318,73607,289,5,N,N,-,-1,-1
MEMMUS.txt,73608,74201,593,5,N,N,-,-1,-1
MEMMUS.txt,74202,74986,784,5,N,N,-,-1,-1
MEMMUS.txt,74989,75851,862,5,N,N,-,-1,-1
MEMMUS.txt,75852,76623,771,5,N,Y,1436174454662,76332,76889
MEMMUS.txt,76624,77124,500,5,N,Y,1436174454662,76332,76889
MEMMUS.txt,77125,78103,978,5,N,N,-,-1,-1
MEMMUS.txt,78104,78751,647,5,N,N,-,-1,-1
MEMMUS.txt,78752,79127,375,5,N,N,-,-1,-1
MEMMUS.txt,79128,79603,475,5,N,N,-,-1,-1
MEMMUS.txt,79606,80521,915,5,N,N,-,-1,-1
MEMMUS.txt,80522,81402,880,5,N,N,-,-1,-1
MEMMUS.txt,81407,82322,915,5,Y,Y,1436174968369,81917,82485
MEMMUS.txt,82323,82959,636,5,Y,Y,1436174968369,81917,82485
MEMMUS.txt,82960,83394,434,5,N,N,-,-1,-1
MEMMUS.txt,83395,84103,708,5,N,Y,1436175572082,83734,84298
MEMMUS.txt,84104,84507,403,5,N,Y,1436175572082,83734,84298
MEMMUS.txt,84508,85368,860,5,N,Y,1436175824478,84421,85783
MEMMUS.txt,85369,86582,1213,5,N,Y,1436175824478,84421,85783
MEMMUS.txt,86585,87493,908,5,N,Y,1436176439600,86589,87384
MEMMUS.txt,87496,88485,989,5,Y,N,-,-1,-1
MEMMUS.txt,88488,89087,599,5,N,N,-,-1,-1
MEMMUS.txt,89088,89698,610,5,N,N,-,-1,-1
MEMMUS.txt,89701,89992,291,5,N,N,-,-1,-1
MEMMUS.txt,89997,90160,163,5,N,N,-,-1,-1
MEMMUS.txt,90162,90300,138,5,N,N,-,-1,-1
MEMMUS.txt,90301,90528,227,5,N,N,-,-1,-1
MEMMUS.txt,90530,91202,672,5,N,N,-,-1,-1
MEMMUS.txt,91203,91703,500,5,N,N,-,-1,-1
MEMMUS.txt,91706,92098,392,5,N,N,-,-1,-1
MEMMUS.txt,92100,92839,739,5,N,N,-,-1,-1
MEMMUS.txt,92840,93331,491,5,N,N,-,-1,-1
MEMMUS.txt,93332,94079,747,5,Y,N,-,-1,-1
MEMMUS.txt,94080,95112,1032,5,N,Y,1436178232441,94736,96568
MEMMUS.txt,95113,96130,1017,5,Y,Y,1436178232441,94736,96568
MEMMUS.txt,96131,96689,558,5,N,Y,1436178232441,94736,96568
MEMMUS.txt,96691,97384,693,5,N,Y,1436180874507,96703,97450
MEMMUS.txt,97386,98222,836,5,N,Y,1436180874507,96703,97450
MEMMUS.txt,98225,99120,895,5,N,N,-,-1,-1
MEMMUS.txt,99123,99866,743,5,N,N,-,-1,-1
MEMMUS.txt,99867,100611,744,5,Y,N,-,-1,-1
MEMMUS.txt,100614,101487,873,5,N,N,-,-1,-1
MEMMUS.txt,101490,102194,704,5,N,N,-,-1,-1
MEMMUS.txt,102196,103028,832,5,N,N,-,-1,-1
MEMMUS.txt,103029,103618,589,5,N,N,-,-1,-1
MEMMUS.txt,103621,104392,771,5,N,N,-,-1,-1
MEMMUS.txt,104393,105034,641,5,N,N,-,-1,-1
MEMMUS.txt,105035,105810,775,5,N,N,-,-1,-1
MEMMUS.txt,105811,106864,1053,5,Y,N,-,-1,-1
MEMMUS.txt,106865,107608,743,5,N,N,-,-1,-1
MEMMUS.txt,107611,108609,998,5,N,N,-,-1,-1
MEMMUS.txt,108612,109542,930,5,N,Y,1436181440816,109452,110419
MEMMUS.txt,109543,110186,643,5,N,Y,1436181440816,109452,110419
MEMMUS.txt,110187,110505,318,5,N,Y,1436181440816,109452,110419
MEMMUS.txt,110508,111276,768,5,N,N,-,-1,-1
MEMMUS.txt,111277,111753,476,5,N,N,-,-1,-1
MEMMUS.txt,111758,112627,869,5,N,N,-,-1,-1
MEMMUS.txt,112629,113199,570,5,N,N,-,-1,-1
MEMMUS.txt,113201,113629,428,5,N,N,-,-1,-1
MEMMUS.txt,113630,114109,479,5,N,N,-,-1,-1
MEMMUS.txt,114112,114772,660,5,N,N,-,-1,-1
MEMMUS.txt,114777,115548,771,5,N,N,-,-1,-1
MEMMUS.txt,115553,117177,1624,5,N,Y,1436182135916,116723,117609
MEMMUS.txt,117180,117931,751,5,N,Y,1436182498768,117674,118815
MEMMUS.txt,117934,118588,654,5,N,Y,1436182498768,117674,118815
MEMMUS.txt,118589,119393,804,5,N,Y,1436182498768,117674,118815
MEMMUS.txt,119394,120320,926,5,N,Y,1436182942743,119767,120353
MEMMUS.txt,120322,120898,576,5,Y,Y,1436182942743,119767,120353
MEMMUS.txt,120899,121541,642,5,N,Y,1436183373358,121001,122265
MEMMUS.txt,121542,122541,999,5,N,Y,1436183373358,121001,122265
MEMMUS.txt,122542,123283,741,5,N,N,-,-1,-1
MEMMUS.txt,123284,124002,718,5,N,N,-,-1,-1
MEMMUS.txt,124003,124662,659,5,N,N,-,-1,-1
MEMMUS.txt,124663,125277,614,5,Y,N,-,-1,-1
MEMMUS.txt,125278,125911,633,5,N,N,-,-1,-1
MEMMUS.txt,125912,126466,554,5,N,N,-,-1,-1
MEMMUS.txt,126467,127119,652,5,N,N,-,-1,-1
MEMMUS.txt,127120,127677,557,5,N,N,-,-1,-1
MEMMUS.txt,127679,128306,627,5,N,N,-,-1,-1
MEMMUS.txt,128307,129478,1171,5,Y,N,-,-1,-1
MEMMUS.txt,129481,130720,1239,5,Y,N,-,-1,-1
MEMMUS.txt,130723,131397,674,5,N,N,-,-1,-1
MEMMUS.txt,131400,132017,617,5,N,N,-,-1,-1
MEMMUS.txt,132018,132603,585,5,N,N,-,-1,-1
MEMMUS.txt,132604,133472,868,5,N,N,-,-1,-1
MEMMUS.txt,133474,134403,929,5,N,Y,1436192343938,134271,135042
MEMMUS.txt,134405,134950,545,5,N,Y,1436192343938,134271,135042
MEMMUS.txt,134951,135800,849,5,N,Y,1436192343938,134271,135042
MEMMUS.txt,135801,136321,520,5,N,Y,1436192694272,135876,136730
MEMMUS.txt,136322,137367,1045,5,Y,Y,1436193426140,136824,137579
MEMMUS.txt,137368,138362,994,5,Y,Y,1436193426140,136824,137579
MEMMUS.txt,138363,139287,924,5,N,Y,1436193727777,138272,139069
MEMMUS.txt,139288,140002,714,5,N,N,-,-1,-1
MEMMUS.txt,140003,140634,631,5,N,N,-,-1,-1
MEMMUS.txt,140635,141943,1308,5,N,N,-,-1,-1
MEMMUS.txt,141946,142677,731,5,N,N,-,-1,-1
MEMMUS.txt,142678,143502,824,5,N,N,-,-1,-1
MEMMUS.txt,143503,144326,823,5,N,N,-,-1,-1
MEMMUS.txt,144329,144918,589,5,N,N,-,-1,-1
MEMMUS.txt,144919,145587,668,5,N,N,-,-1,-1
MEMMUS.txt,145588,146232,644,5,N,N,-,-1,-1
MEMMUS.txt,146233,146914,681,5,N,N,-,-1,-1
MEMMUS.txt,146917,147609,692,5,N,N,-,-1,-1
MEMMUS.txt,147610,148110,500,5,N,N,-,-1,-1
MEMMUS.txt,148112,149038,926,5,N,N,-,-1,-1
MEMMUS.txt,149039,149702,663,5,Y,N,-,-1,-1
MEMMUS.txt,149703,150556,853,5,N,N,-,-1,-1
MEMMUS.txt,150557,151313,756,5,Y,N,-,-1,-1
MEMMUS.txt,151314,151886,572,5,N,N,-,-1,-1
MEMMUS.txt,151889,152650,761,5,N,N,-,-1,-1
MEMMUS.txt,152651,153273,622,5,N,N,-,-1,-1
MEMMUS.txt,153274,153928,654,5,Y,N,-,-1,-1
MEMMUS.txt,153929,154730,801,5,N,Y,1436194630719,153960,154457
MEMMUS.txt,154731,155191,460,5,N,N,-,-1,-1
MEMMUS.txt,155192,156157,965,5,N,N,-,-1,-1
MEMMUS.txt,156158,156855,697,5,N,N,-,-1,-1
MEMMUS.txt,156856,157615,759,5,N,N,-,-1,-1
MEMMUS.txt,157616,158297,681,5,N,N,-,-1,-1
MEMMUS.txt,158300,159087,787,5,N,N,-,-1,-1
MEMMUS.txt,159090,159937,847,5,N,N,-,-1,-1
MEMMUS.txt,159938,160584,646,5,N,N,-,-1,-1
MEMMUS.txt,160589,161779,1190,5,N,N,-,-1,-1
MEMMUS.txt,161780,162430,650,5,N,N,-,-1,-1
MEMMUS.txt,162433,163431,998,5,N,N,-,-1,-1
MEMMUS.txt,163432,164398,966,5,N,N,-,-1,-1
MEMMUS.txt,164401,165191,790,5,N,N,-,-1,-1
MEMMUS.txt,165192,166038,846,5,N,N,-,-1,-1
MEMMUS.txt,166039,166676,637,5,N,Y,1436195369775,166223,166802
MEMMUS.txt,166677,167320,643,5,N,Y,1436195369775,166223,166802
MEMMUS.txt,167323,168451,1128,5,Y,Y,1436195820165,167327,168540
MEMMUS.txt,168452,168975,523,5,N,Y,1436195820165,167327,168540
MEMMUS.txt,168978,169684,706,5,N,N,-,-1,-1
MEMMUS.txt,169685,170727,1042,5,Y,N,-,-1,-1
MEMMUS.txt,170730,171421,691,5,N,N,-,-1,-1
MEMMUS.txt,171422,172331,909,5,N,N,-,-1,-1
MEMMUS.txt,172332,173111,779,5,N,N,-,-1,-1
MEMMUS.txt,173112,173799,687,5,N,N,-,-1,-1
MEMMUS.txt,173800,174681,881,5,N,N,-,-1,-1
MEMMUS.txt,174682,175660,978,5,N,N,-,-1,-1
MEMMUS.txt,175661,176473,812,5,N,N,-,-1,-1
MEMMUS.txt,176474,177297,823,5,N,N,-,-1,-1
MEMMUS.txt,177303,178122,819,5,N,N,-,-1,-1
MEMMUS.txt,178123,179727,1604,5,N,N,-,-1,-1
MEMMUS.txt,179730,180884,1154,5,N,N,-,-1,-1
MEMMUS.txt,180885,181921,1036,5,N,Y,1436200836078,181418,182145
MEMMUS.txt,181922,182550,628,5,N,Y,1436200836078,181418,182145
MEMMUS.txt,182551,183304,753,5,N,N,-,-1,-1
MEMMUS.txt,183307,183911,604,5,N,Y,1436201256737,183322,184063
MEMMUS.txt,183912,184558,646,5,N,Y,1436201256737,183322,184063
MEMMUS.txt,184561,184977,416,5,N,N,-,-1,-1
MEMMUS.txt,184978,185525,547,5,N,Y,1436201856954,185075,185632
MEMMUS.txt,185526,186171,645,5,N,Y,1436201856954,185075,185632
MEMMUS.txt,186172,186938,766,5,N,Y,1436202482351,186272,186982
MEMMUS.txt,186939,187533,594,5,N,Y,1436202482351,186272,186982
MEMMUS.txt,187536,188214,678,5,Y,N,-,-1,-1
MEMMUS.txt,188217,188827,610,5,N,N,-,-1,-1
MEMMUS.txt,188828,189360,532,5,N,N,-,-1,-1
MEMMUS.txt,189361,190241,880,5,N,N,-,-1,-1
MEMMUS.txt,190243,190577,334,5,N,N,-,-1,-1
MEMMUS.txt,190580,191183,603,5,N,Y,1436250750453,190583,190982
MEMMUS.txt,191184,191775,591,5,N,Y,1436250955725,191454,191936
MEMMUS.txt,191776,192427,651,5,N,Y,1436250955725,191454,191936
MEMMUS.txt,192430,193384,954,5,Y,Y,1436251795765,192428,192905
MEMMUS.txt,193385,194007,622,5,N,Y,1436252026055,192933,193848
MEMMUS.txt,194008,194576,568,5,N,N,-,-1,-1
MEMMUS.txt,194577,195486,909,5,N,Y,1436258886793,195179,195770
MEMMUS.txt,195489,196251,762,5,Y,Y,1436258886793,195179,195770
MEMMUS.txt,196252,197102,850,5,Y,Y,1436260072528,196557,197950
MEMMUS.txt,197103,197837,734,5,N,Y,1436260072528,196557,197950
MEMMUS.txt,197838,198664,826,5,N,Y,1436260072528,196557,197950
MEMMUS.txt,198667,199386,719,5,N,Y,1436260597356,198665,199131
MEMMUS.txt,199389,200220,831,5,N,Y,1436261428542,200089,200824
MEMMUS.txt,200221,201062,841,5,N,Y,1436261428542,200089,200824
MEMMUS.txt,201064,201678,614,5,N,Y,1436262032838,201561,202518
MEMMUS.txt,201679,202421,742,5,Y,Y,1436262032838,201561,202518
MEMMUS.txt,202422,203182,760,5,N,Y,1436262032838,201561,202518
MEMMUS.txt,203183,204005,822,5,N,Y,1436262651824,202630,204072
MEMMUS.txt,204007,204677,670,5,Y,Y,1436262651824,202630,204072
MEMMUS.txt,204678,205242,564,5,N,N,-,-1,-1
MEMMUS.txt,205243,206031,788,5,N,Y,1436263043874,205904,206889
MEMMUS.txt,206032,206895,863,5,N,Y,1436263043874,205904,206889
MEMMUS.txt,206896,207160,264,5,N,Y,1436263335878,206962,209396
MEMMUS.txt,207161,207293,132,5,N,Y,1436263335878,206962,209396
MEMMUS.txt,207294,207429,135,5,N,Y,1436263335878,206962,209396
MEMMUS.txt,207430,207740,310,5,N,Y,1436263335878,206962,209396
MEMMUS.txt,207741,207955,214,5,N,Y,1436263335878,206962,209396
MEMMUS.txt,207957,208065,108,5,N,Y,1436263335878,206962,209396
MEMMUS.txt,208066,208227,161,5,N,Y,1436263335878,206962,209396
MEMMUS.txt,208228,208351,123,5,N,Y,1436263335878,206962,209396
MEMMUS.txt,208354,208427,73,5,N,Y,1436263335878,206962,209396
MEMMUS.txt,208428,208579,151,5,N,Y,1436263335878,206962,209396
MEMMUS.txt,208581,208761,180,5,N,Y,1436263335878,206962,209396
MEMMUS.txt,208764,208929,165,5,N,Y,1436263335878,206962,209396
MEMMUS.txt,208930,209244,314,5,N,Y,1436263335878,206962,209396
MEMMUS.txt,209247,209910,663,5,N,Y,1436263335878,206962,209396
MEMMUS.txt,209911,210854,943,5,N,N,-,-1,-1
MEMMUS.txt,210855,211417,562,5,N,N,-,-1,-1
MEMMUS.txt,211418,212025,607,5,N,N,-,-1,-1
MEMMUS.txt,212027,212653,626,5,N,N,-,-1,-1
MEMMUS.txt,212654,213808,1154,5,Y,N,-,-1,-1
MEMMUS.txt,213811,214358,547,5,N,Y,1436264049561,214305,214870
MEMMUS.txt,214359,215179,820,5,N,Y,1436264049561,214305,214870
MEMMUS.txt,215179,215892,713,5,N,N,-,-1,-1
MEMMUS.txt,215893,216618,725,5,N,N,-,-1,-1
MEMMUS.txt,216619,217152,533,5,N,N,-,-1,-1
MEMMUS.txt,217154,217807,653,5,N,N,-,-1,-1
MEMMUS.txt,217812,218681,869,5,N,N,-,-1,-1
MEMMUS.txt,218682,219451,769,5,N,N,-,-1,-1
MEMMUS.txt,219452,220077,625,5,N,N,-,-1,-1
MEMMUS.txt,220078,220982,904,5,N,N,-,-1,-1
MEMMUS.txt,220985,221697,712,5,N,N,-,-1,-1
MEMMUS.txt,221698,222539,841,5,Y,N,-,-1,-1
MEMMUS.txt,222540,223033,493,5,N,N,-,-1,-1
MEMMUS.txt,223034,223533,499,5,N,N,-,-1,-1
MEMMUS.txt,223534,224142,608,5,N,Y,1436265325522,223973,225467
MEMMUS.txt,224143,224719,576,5,N,Y,1436265325522,223973,225467
MEMMUS.txt,224720,225268,548,5,N,Y,1436265325522,223973,225467
MEMMUS.txt,225270,225836,566,5,N,Y,1436265822598,225579,226125
MEMMUS.txt,225839,226368,529,5,N,Y,1436265822598,225579,226125
MEMMUS.txt,226369,226916,547,5,N,Y,1436266262307,226191,228765
MEMMUS.txt,226917,227782,865,5,N,Y,1436266262307,226191,228765
MEMMUS.txt,227783,228682,899,5,N,Y,1436266262307,226191,228765
MEMMUS.txt,228685,229404,719,5,N,Y,1436266262307,226191,228765
MEMMUS.txt,229406,230123,717,5,N,N,-,-1,-1
MEMMUS.txt,230124,230610,486,5,N,N,-,-1,-1
MEMMUS.txt,230611,231370,759,5,N,N,-,-1,-1
MEMMUS.txt,231371,232255,884,5,Y,N,-,-1,-1
MEMMUS.txt,232258,232987,729,5,N,N,-,-1,-1
MEMMUS.txt,232988,233765,777,5,N,N,-,-1,-1
MEMMUS.txt,233766,234274,508,5,N,N,-,-1,-1
MEMMUS.txt,234275,235153,878,5,N,N,-,-1,-1
MEMMUS.txt,235154,235735,581,5,N,N,-,-1,-1
MEMMUS.txt,235738,236707,969,5,N,N,-,-1,-1
MEMMUS.txt,236708,237666,958,5,N,N,-,-1,-1
MEMMUS.txt,237667,239035,1368,5,N,N,-,-1,-1
MEMMUS.txt,239036,239978,942,5,N,N,-,-1,-1
MEMMUS.txt,239979,240648,669,5,N,Y,1436280456835,240521,241413
MEMMUS.txt,240649,241430,781,5,Y,Y,1436280456835,240521,241413
MEMMUS.txt,241432,242163,731,5,N,N,-,-1,-1
MEMMUS.txt,242165,242868,703,5,N,N,-,-1,-1
MEMMUS.txt,242870,243630,760,5,N,Y,1436280789561,243407,244103
MEMMUS.txt,243631,244249,618,5,N,Y,1436281042239,244109,244443
MEMMUS.txt,244250,245065,815,5,N,Y,1436281042239,244109,244443
MEMMUS.txt,245068,245864,796,5,N,Y,1436281325939,245388,246385
MEMMUS.txt,245865,246456,591,5,N,Y,1436281325939,245388,246385
MEMMUS.txt,246457,247133,676,5,N,N,-,-1,-1
MEMMUS.txt,247134,247969,835,5,N,Y,1436281535809,247698,249142
MEMMUS.txt,247970,249120,1150,5,N,Y,1436281535809,247698,249142
MEMMUS.txt,249123,249955,832,5,N,Y,1436281535809,247698,249142
MEMMUS.txt,249957,250547,590,5,N,Y,1436281897258,250318,251929
MEMMUS.txt,250548,251306,758,5,Y,Y,1436281897258,250318,251929
MEMMUS.txt,251307,252075,768,5,N,Y,1436281897258,250318,251929
MEMMUS.txt,252076,252947,871,5,N,N,-,-1,-1
MEMMUS.txt,252948,253833,885,5,N,Y,1436282192995,253074,254294
MEMMUS.txt,253834,254184,350,5,N,Y,1436282192995,253074,254294
MEMMUS.txt,254187,254819,632,5,N,Y,1436282192995,253074,254294
MEMMUS.txt,254820,255510,690,5,N,N,-,-1,-1
MEMMUS.txt,255511,256116,605,5,Y,N,-,-1,-1
MEMMUS.txt,256117,257022,905,5,Y,N,-,-1,-1
MEMMUS.txt,257025,257654,629,5,N,N,-,-1,-1
MEMMUS.txt,257655,258552,897,5,N,Y,1436282556335,257703,258387
MEMMUS.txt,258553,259594,1041,5,Y,Y,1436282832945,258754,259560
MEMMUS.txt,259595,260197,602,5,N,N,-,-1,-1
MEMMUS.txt,260200,260839,639,5,N,Y,1436283306101,260256,261072
MEMMUS.txt,260842,261469,627,5,N,Y,1436283306101,260256,261072
MEMMUS.txt,261470,262130,660,5,N,Y,1436283623047,261247,261769
MEMMUS.txt,262131,262645,514,5,N,Y,1436283967277,261773,262146
MEMMUS.txt,262648,263598,950,5,Y,Y,1436284721620,262676,264766
MEMMUS.txt,263601,264366,765,5,N,Y,1436284721620,262676,264766
MEMMUS.txt,264367,265065,698,5,N,Y,1436284721620,262676,264766
MEMMUS.txt,265066,265958,892,5,N,N,-,-1,-1
MEMMUS.txt,265959,266740,781,5,N,Y,1436423346848,266385,267054
MEMMUS.txt,266741,267480,739,5,Y,Y,1436423346848,266385,267054
MEMMUS.txt,267481,268080,599,5,N,N,-,-1,-1
MEMMUS.txt,268081,268821,740,5,N,N,-,-1,-1
MEMMUS.txt,268822,269679,857,5,N,N,-,-1,-1
MEMMUS.txt,269680,270345,665,5,N,N,-,-1,-1
MEMMUS.txt,270346,270853,507,5,N,N,-,-1,-1
MEMMUS.txt,270856,271508,652,5,N,N,-,-1,-1
MEMMUS.txt,271509,272386,877,5,N,N,-,-1,-1
MEMMUS.txt,272387,273241,854,5,N,N,-,-1,-1
MEMMUS.txt,273242,273864,622,5,N,N,-,-1,-1
MEMMUS.txt,273865,274204,339,5,N,N,-,-1,-1
MEMMUS.txt,274205,275097,892,5,N,N,-,-1,-1
MEMMUS.txt,275099,275997,898,5,N,N,-,-1,-1
MEMMUS.txt,275998,276789,791,5,N,Y,1436423891936,276321,278167
MEMMUS.txt,276790,277541,751,5,N,Y,1436423891936,276321,278167
MEMMUS.txt,277542,278240,698,5,N,Y,1436423891936,276321,278167
MEMMUS.txt,278243,278942,699,5,N,N,-,-1,-1
MEMMUS.txt,278943,279509,566,5,N,N,-,-1,-1
MEMMUS.txt,279510,280105,595,5,N,N,-,-1,-1
MEMMUS.txt,280107,281000,893,5,N,N,-,-1,-1
MEMMUS.txt,281001,281647,646,5,N,Y,1436424974663,281505,282511
MEMMUS.txt,281648,282414,766,5,Y,Y,1436424974663,281505,282511
MEMMUS.txt,282415,283411,996,5,N,Y,1436424974663,281505,282511
MEMMUS.txt,283412,284387,975,5,N,N,-,-1,-1
MEMMUS.txt,284388,285297,909,5,Y,N,-,-1,-1
MEMMUS.txt,285298,286136,838,5,N,N,-,-1,-1
MEMMUS.txt,286137,287378,1241,5,N,N,-,-1,-1
MEMMUS.txt,287379,288093,714,5,N,N,-,-1,-1
MEMMUS.txt,288094,288940,846,5,N,N,-,-1,-1
MEMMUS.txt,288943,289486,543,5,N,N,-,-1,-1
MEMMUS.txt,289488,290117,629,5,N,N,-,-1,-1
MEMMUS.txt,290118,290837,719,5,N,N,-,-1,-1
MEMMUS.txt,290838,291515,677,5,N,N,-,-1,-1
MEMMUS.txt,291516,292355,839,5,Y,N,-,-1,-1
MEMMUS.txt,292358,293163,805,5,N,N,-,-1,-1
MEMMUS.txt,293164,293713,549,5,N,N,-,-1,-1
MEMMUS.txt,293716,294370,654,5,N,N,-,-1,-1
MEMMUS.txt,294373,295172,799,5,N,N,-,-1,-1
MEMMUS.txt,295173,295598,425,5,N,N,-,-1,-1
MEMMUS.txt,295604,296215,611,5,N,N,-,-1,-1
MEMMUS.txt,296218,296890,672,5,N,N,-,-1,-1
MEMMUS.txt,296892,297225,333,5,N,N,-,-1,-1
MEMMUS.txt,297228,297722,494,5,N,N,-,-1,-1
MEMMUS.txt,297723,298181,458,5,N,N,-,-1,-1
MEMMUS.txt,298182,298757,575,5,N,N,-,-1,-1
MEMMUS.txt,298758,299488,730,5,N,N,-,-1,-1
MEMMUS.txt,299489,300407,918,5,N,N,-,-1,-1
MEMMUS.txt,300410,301058,648,5,N,N,-,-1,-1
MEMMUS.txt,301059,301559,500,5,N,N,-,-1,-1
MEMMUS.txt,301561,302069,508,5,N,N,-,-1,-1
MEMMUS.txt,302070,302613,543,5,N,N,-,-1,-1
MEMMUS.txt,302614,303095,481,5,N,N,-,-1,-1
MEMMUS.txt,303096,303733,637,5,N,N,-,-1,-1
MEMMUS.txt,303734,304265,531,5,N,Y,1436432727712,303953,304575
MEMMUS.txt,304266,304682,416,5,N,Y,1436432727712,303953,304575
MEMMUS.txt,304683,304987,304,5,N,Y,1436433150618,304772,305829
MEMMUS.txt,304989,305605,616,5,N,Y,1436433150618,304772,305829
MEMMUS.txt,305606,306192,586,5,N,Y,1436433150618,304772,305829
MEMMUS.txt,306193,306904,711,5,N,N,-,-1,-1
MEMMUS.txt,306905,307932,1027,5,N,N,-,-1,-1
MEMMUS.txt,307933,308655,722,5,N,N,-,-1,-1
MEMMUS.txt,308658,309375,717,5,N,N,-,-1,-1
MEMMUS.txt,309376,310267,891,5,N,N,-,-1,-1
MEMMUS.txt,310268,310926,658,5,N,N,-,-1,-1
MEMMUS.txt,310927,311723,796,5,N,N,-,-1,-1
MEMMUS.txt,311726,312703,977,5,N,N,-,-1,-1
MEMMUS.txt,312704,313879,1175,5,N,N,-,-1,-1
MEMMUS.txt,313880,314644,764,5,N,N,-,-1,-1
MEMMUS.txt,314647,315312,665,5,N,N,-,-1,-1
MEMMUS.txt,315314,316189,875,5,N,N,-,-1,-1
MEMMUS.txt,316190,317172,982,5,N,N,-,-1,-1
MEMMUS.txt,317173,318009,836,5,N,N,-,-1,-1
MEMMUS.txt,318010,318740,730,5,N,N,-,-1,-1
MEMMUS.txt,318743,319544,801,5,N,N,-,-1,-1
MEMMUS.txt,319545,320307,762,5,N,N,-,-1,-1
MEMMUS.txt,320310,320913,603,5,N,N,-,-1,-1
MEMMUS.txt,320914,321335,421,5,N,N,-,-1,-1
MEMMUS.txt,321337,322206,869,5,N,N,-,-1,-1
MEMMUS.txt,322207,323069,862,5,N,N,-,-1,-1
MEMMUS.txt,323072,323830,758,5,N,N,-,-1,-1
MEMMUS.txt,323831,324370,539,5,N,N,-,-1,-1
MEMMUS.txt,324371,325661,1290,5,N,N,-,-1,-1
MEMMUS.txt,325663,326486,823,5,N,N,-,-1,-1
MEMMUS.txt,326487,327369,882,5,N,N,-,-1,-1
MEMMUS.txt,327370,328439,1069,5,N,N,-,-1,-1
MEMMUS.txt,328442,329204,762,5,N,N,-,-1,-1
MEMMUS.txt,329205,329772,567,5,N,N,-,-1,-1
MEMMUS.txt,329773,330443,670,5,N,N,-,-1,-1
MEMMUS.txt,330446,331544,1098,5,N,Y,1436434376182,331404,332945
MEMMUS.txt,331545,332347,802,5,Y,Y,1436434376182,331404,332945
MEMMUS.txt,332349,332958,609,5,N,Y,1436434376182,331404,332945
MEMMUS.txt,332961,333551,590,5,N,N,-,-1,-1
MEMMUS.txt,333554,334004,450,5,N,Y,1436434595667,333552,333949
MEMMUS.txt,334007,334699,692,5,N,N,-,-1,-1
MEMMUS.txt,334700,335225,525,5,N,N,-,-1,-1
MEMMUS.txt,335226,335772,546,5,N,N,-,-1,-1
MEMMUS.txt,335773,336879,1106,5,Y,Y,1436434882802,336475,336873
MEMMUS.txt,336882,337767,885,5,N,Y,1436435221703,336880,337454
MEMMUS.txt,337768,338372,604,5,N,N,-,-1,-1
MEMMUS.txt,338375,339162,787,5,N,N,-,-1,-1
MEMMUS.txt,339163,339678,515,5,N,N,-,-1,-1
MEMMUS.txt,339679,339998,319,5,N,N,-,-1,-1
MEMMUS.txt,339999,340395,396,5,N,N,-,-1,-1
MEMMUS.txt,340396,341102,706,5,N,Y,1436435912176,340974,341737
MEMMUS.txt,341103,341998,895,5,N,Y,1436435912176,340974,341737
MEMMUS.txt,342001,342811,810,5,N,N,-,-1,-1
MEMMUS.txt,342814,343556,742,5,N,N,-,-1,-1
MEMMUS.txt,343559,344623,1064,5,N,N,-,-1,-1
MEMMUS.txt,344624,345615,991,5,Y,N,-,-1,-1
MEMMUS.txt,345616,346314,698,5,N,Y,1436436770716,345847,347230
MEMMUS.txt,346315,346932,617,5,N,Y,1436436770716,345847,347230
MEMMUS.txt,346933,347192,259,5,N,Y,1436436770716,345847,347230
MEMMUS.txt,347193,347703,510,5,N,Y,1436436770716,345847,347230
MEMMUS.txt,347704,348412,708,5,N,N,-,-1,-1
MEMMUS.txt,348413,348912,499,5,N,N,-,-1,-1
MEMMUS.txt,348913,349632,719,5,N,N,-,-1,-1
MEMMUS.txt,349633,350035,402,5,N,N,-,-1,-1
MEMMUS.txt,350038,350903,865,5,N,N,-,-1,-1
MEMMUS.txt,350904,351424,520,5,N,N,-,-1,-1
MEMMUS.txt,351425,352071,646,5,N,N,-,-1,-1
MEMMUS.txt,352072,352723,651,5,N,N,-,-1,-1
MEMMUS.txt,352726,353643,917,5,N,N,-,-1,-1
MEMMUS.txt,353644,354603,959,5,N,N,-,-1,-1
MEMMUS.txt,354605,355470,865,5,N,N,-,-1,-1
MEMMUS.txt,355471,356140,669,5,N,N,-,-1,-1
MEMMUS.txt,356141,356963,822,5,Y,N,-,-1,-1
MEMMUS.txt,356964,357800,836,5,N,N,-,-1,-1
MEMMUS.txt,357801,358632,831,5,N,N,-,-1,-1
MEMMUS.txt,358633,359233,600,5,N,N,-,-1,-1
MEMMUS.txt,359234,359847,613,5,N,N,-,-1,-1
MEMMUS.txt,359850,360664,814,5,Y,Y,1436438224836,360102,360820
MEMMUS.txt,360665,361450,785,5,N,Y,1436438224836,360102,360820
MEMMUS.txt,361451,362150,699,5,N,N,-,-1,-1
MEMMUS.txt,362151,362972,821,5,N,Y,1436438560540,362307,362847
MEMMUS.txt,362973,363494,521,5,N,N,-,-1,-1
MEMMUS.txt,363497,364258,761,5,N,N,-,-1,-1
MEMMUS.txt,364260,364876,616,5,N,N,-,-1,-1
MEMMUS.txt,364878,365663,785,5,N,N,-,-1,-1
MEMMUS.txt,365664,366168,504,5,N,N,-,-1,-1
MEMMUS.txt,366169,366603,434,5,N,N,-,-1,-1
MEMMUS.txt,366604,367193,589,5,N,Y,1436438967800,366801,367625
MEMMUS.txt,367194,367829,635,5,N,Y,1436438967800,366801,367625
MEMMUS.txt,367830,368641,811,5,N,N,-,-1,-1
MEMMUS.txt,368642,369349,707,5,N,N,-,-1,-1
MEMMUS.txt,369350,370216,866,5,Y,N,-,-1,-1
MEMMUS.txt,370219,370777,558,5,N,N,-,-1,-1
MEMMUS.txt,370779,371176,397,5,N,N,-,-1,-1
MEMMUS.txt,371177,371750,573,5,N,N,-,-1,-1
MEMMUS.txt,371751,372492,741,5,N,N,-,-1,-1
MEMMUS.txt,372494,373110,616,5,N,N,-,-1,-1
MEMMUS.txt,373111,373568,457,5,N,N,-,-1,-1
MEMMUS.txt,373571,374251,680,5,N,N,-,-1,-1
MEMMUS.txt,374253,374935,682,5,N,N,-,-1,-1
MEMMUS.txt,374936,375577,641,5,N,N,-,-1,-1
MEMMUS.txt,375578,376186,608,5,N,N,-,-1,-1
MEMMUS.txt,376188,376688,500,5,N,Y,1436444993373,376611,377536
MEMMUS.txt,376689,377403,714,5,N,Y,1436444993373,376611,377536
MEMMUS.txt,377404,378247,843,5,N,Y,1436445421219,377558,378460
MEMMUS.txt,378248,378818,570,5,N,Y,1436445421219,377558,378460
MEMMUS.txt,378819,379766,947,5,N,Y,1436445738562,378567,378998
MEMMUS.txt,379769,380651,882,5,N,N,-,-1,-1
MEMMUS.txt,380652,381467,815,5,N,N,-,-1,-1
MEMMUS.txt,381470,381913,443,5,N,N,-,-1,-1
MEMMUS.txt,381916,382806,890,5,N,N,-,-1,-1
MEMMUS.txt,382809,383742,933,5,N,N,-,-1,-1
MEMMUS.txt,383743,384519,776,5,N,N,-,-1,-1
MEMMUS.txt,384520,385213,693,5,N,N,-,-1,-1
MEMMUS.txt,385216,385872,656,5,N,N,-,-1,-1
MEMMUS.txt,385874,386900,1026,5,N,N,-,-1,-1
MEMMUS.txt,386903,387850,947,5,N,N,-,-1,-1
MEMMUS.txt,387851,388580,729,5,N,N,-,-1,-1
MEMMUS.txt,388581,389342,761,5,N,N,-,-1,-1
MEMMUS.txt,389343,389878,535,5,N,N,-,-1,-1
MEMMUS.txt,389879,390850,971,5,N,N,-,-1,-1
MEMMUS.txt,390851,391533,682,5,N,N,-,-1,-1
MEMMUS.txt,391534,392252,718,5,N,N,-,-1,-1
MEMMUS.txt,392253,393428,1175,5,N,N,-,-1,-1
MEMMUS.txt,393429,394190,761,5,N,N,-,-1,-1
MEMMUS.txt,394191,394938,747,5,Y,N,-,-1,-1
MEMMUS.txt,394940,395529,589,5,N,N,-,-1,-1
MEMMUS.txt,395530,396456,926,5,N,N,-,-1,-1
MEMMUS.txt,396457,397296,839,5,N,N,-,-1,-1
MEMMUS.txt,397297,398081,784,5,N,N,-,-1,-1
MEMMUS.txt,398082,398560,478,5,N,N,-,-1,-1
MEMMUS.txt,398561,399306,745,5,N,N,-,-1,-1
MEMMUS.txt,399307,400224,917,5,N,N,-,-1,-1
MEMMUS.txt,400226,401518,1292,5,N,N,-,-1,-1
MEMMUS.txt,401521,402133,612,5,N,N,-,-1,-1
MEMMUS.txt,402134,402708,574,5,N,N,-,-1,-1
MEMMUS.txt,402709,402982,273,5,N,N,-,-1,-1
MEMMUS.txt,402983,403068,85,5,N,N,-,-1,-1
MEMMUS.txt,403069,403132,63,5,N,N,-,-1,-1
MEMMUS.txt,403135,403743,608,5,N,N,-,-1,-1
MEMMUS.txt,403743,404959,1216,5,N,N,-,-1,-1
MEMMUS.txt,404961,406088,1127,5,N,N,-,-1,-1
MEMMUS.txt,406091,406973,882,5,N,N,-,-1,-1
MEMMUS.txt,406974,407790,816,5,N,Y,1436457314337,407582,409801
MEMMUS.txt,407791,408646,855,5,N,Y,1436457314337,407582,409801
MEMMUS.txt,408649,409438,789,5,N,Y,1436457314337,407582,409801
MEMMUS.txt,409439,410031,592,5,N,Y,1436457314337,407582,409801
MEMMUS.txt,410034,411014,980,5,N,N,-,-1,-1
MEMMUS.txt,411015,411387,372,5,N,N,-,-1,-1
MEMMUS.txt,411388,412588,1200,5,N,N,-,-1,-1
MEMMUS.txt,412589,413707,1118,5,N,N,-,-1,-1
MEMMUS.txt,413710,414811,1101,5,N,N,-,-1,-1
MEMMUS.txt,414812,415599,787,5,N,N,-,-1,-1
MEMMUS.txt,415600,416556,956,5,N,N,-,-1,-1
MEMMUS.txt,416557,417239,682,5,N,N,-,-1,-1
MEMMUS.txt,417242,417854,612,5,N,N,-,-1,-1
MEMMUS.txt,417856,418573,717,5,N,N,-,-1,-1
MEMMUS.txt,418574,419076,502,5,N,N,-,-1,-1
MEMMUS.txt,419077,419654,577,5,N,N,-,-1,-1
MEMMUS.txt,419655,420264,609,5,N,N,-,-1,-1
MEMMUS.txt,420267,420985,718,5,N,N,-,-1,-1
MEMMUS.txt,420986,421740,754,5,N,N,-,-1,-1
MEMMUS.txt,421743,422419,676,5,N,N,-,-1,-1
MEMMUS.txt,422420,423062,642,5,N,N,-,-1,-1
MEMMUS.txt,423065,423684,619,5,N,N,-,-1,-1
MEMMUS.txt,423685,424547,862,5,N,N,-,-1,-1
MEMMUS.txt,424550,425577,1027,5,N,N,-,-1,-1
MEMMUS.txt,425580,426650,1070,5,N,N,-,-1,-1
MEMMUS.txt,426651,427286,635,5,N,N,-,-1,-1
MEMMUS.txt,427289,428295,1006,5,N,N,-,-1,-1
MEMMUS.txt,428296,428827,531,5,N,N,-,-1,-1
MEMMUS.txt,428828,429281,453,5,N,N,-,-1,-1
MEMMUS.txt,429282,429766,484,5,N,N,-,-1,-1
MEMMUS.txt,429767,430136,369,5,N,N,-,-1,-1
MEMMUS.txt,430139,432025,1886,5,N,N,-,-1,-1
MEMMUS.txt,432026,432846,820,5,N,N,-,-1,-1
MEMMUS.txt,432847,433229,382,5,N,N,-,-1,-1
MEMMUS.txt,433230,433897,667,5,N,N,-,-1,-1
MEMMUS.txt,433900,434399,499,5,N,N,-,-1,-1
MEMMUS.txt,434400,435414,1014,5,N,N,-,-1,-1
MEMMUS.txt,435417,435956,539,5,N,N,-,-1,-1
MEMMUS.txt,435961,437774,1813,5,Y,Y,1436458374558,436802,437453
MEMMUS.txt,437775,438297,522,5,N,Y,1436458807940,438002,438706
MEMMUS.txt,438298,438715,417,5,N,Y,1436458807940,438002,438706
MEMMUS.txt,438721,439742,1021,5,N,Y,1436459343773,439368,440020
MEMMUS.txt,439743,440487,744,5,N,Y,1436459343773,439368,440020
MEMMUS.txt,440488,441105,617,5,N,N,-,-1,-1
MEMMUS.txt,441107,441623,516,5,N,N,-,-1,-1
MEMMUS.txt,441624,441921,297,5,N,N,-,-1,-1
MEMMUS.txt,441922,442207,285,5,N,N,-,-1,-1
MEMMUS.txt,442210,443057,847,5,N,N,-,-1,-1
MEMMUS.txt,443058,443800,742,5,N,Y,1436518466769,443385,444821
MEMMUS.txt,443803,444513,710,5,N,Y,1436518466769,443385,444821
MEMMUS.txt,444514,445551,1037,5,N,Y,1436518466769,443385,444821
MEMMUS.txt,445554,446287,733,5,N,Y,1436518097111,445361,446096
MEMMUS.txt,446290,447113,823,5,N,N,-,-1,-1
MEMMUS.txt,447116,447978,862,5,N,Y,1436519123026,447131,447676
MEMMUS.txt,447979,448666,687,5,N,N,-,-1,-1
MEMMUS.txt,448668,449338,670,5,N,Y,1436519578396,448667,449299
MEMMUS.txt,449339,450200,861,5,N,N,-,-1,-1
MEMMUS.txt,450201,450843,642,5,N,N,-,-1,-1
MEMMUS.txt,450844,451457,613,5,N,N,-,-1,-1
MEMMUS.txt,451459,452523,1064,5,N,N,-,-1,-1
MEMMUS.txt,452524,453008,484,5,N,Y,1436519953118,452615,453356
MEMMUS.txt,453009,453904,895,5,N,Y,1436519953118,452615,453356
MEMMUS.txt,453905,454759,854,5,N,N,-,-1,-1
MEMMUS.txt,454760,455774,1014,5,N,N,-,-1,-1
MEMMUS.txt,455775,456205,430,5,N,N,-,-1,-1
MEMMUS.txt,456206,456674,468,5,N,N,-,-1,-1
MEMMUS.txt,456675,457308,633,5,N,N,-,-1,-1
MEMMUS.txt,457309,457911,602,5,N,N,-,-1,-1
MEMMUS.txt,457914,458407,493,5,N,N,-,-1,-1
MEMMUS.txt,458408,459256,848,5,N,N,-,-1,-1
MEMMUS.txt,459257,459868,611,5,N,N,-,-1,-1
MEMMUS.txt,459869,461047,1178,5,N,N,-,-1,-1
MEMMUS.txt,461048,462140,1092,5,N,N,-,-1,-1
MEMMUS.txt,462145,462790,645,5,N,N,-,-1,-1
MEMMUS.txt,462791,463786,995,5,Y,N,-,-1,-1
MEMMUS.txt,463787,464387,600,5,N,N,-,-1,-1
MEMMUS.txt,464388,465212,824,5,N,N,-,-1,-1
MEMMUS.txt,465213,466432,1219,5,Y,N,-,-1,-1
MEMMUS.txt,466435,467129,694,5,N,N,-,-1,-1
MEMMUS.txt,467130,467738,608,5,N,N,-,-1,-1
MEMMUS.txt,467739,468659,920,5,N,N,-,-1,-1
MEMMUS.txt,468662,469530,868,5,N,Y,1436521270492,469143,469869
MEMMUS.txt,469531,470285,754,5,N,Y,1436521270492,469143,469869
MEMMUS.txt,470286,471298,1012,5,N,N,-,-1,-1
MEMMUS.txt,471300,472216,916,5,N,Y,1436522398418,471475,474672
MEMMUS.txt,472217,472865,648,5,N,Y,1436522398418,471475,474672
MEMMUS.txt,472866,473554,688,5,N,Y,1436522398418,471475,474672
MEMMUS.txt,473555,474535,980,5,N,Y,1436522398418,471475,474672
MEMMUS.txt,474538,475505,967,5,N,Y,1436522398418,471475,474672
MEMMUS.txt,475507,476599,1092,5,N,N,-,-1,-1
MEMMUS.txt,476602,477173,571,5,N,N,-,-1,-1
MEMMUS.txt,477174,477753,579,5,N,N,-,-1,-1
MEMMUS.txt,477754,478422,668,5,N,N,-,-1,-1
MEMMUS.txt,478423,479240,817,5,N,N,-,-1,-1
MEMMUS.txt,479241,480019,778,5,N,N,-,-1,-1
MEMMUS.txt,480022,480087,65,5,N,N,-,-1,-1
MEMMUS.txt,480090,480154,64,5,N,N,-,-1,-1
MEMMUS.txt,480155,480224,69,5,N,N,-,-1,-1
MEMMUS.txt,480225,480311,86,5,N,N,-,-1,-1
MEMMUS.txt,480312,480389,77,5,N,N,-,-1,-1
MEMMUS.txt,480390,480472,82,5,N,N,-,-1,-1
MEMMUS.txt,480475,480540,65,5,N,N,-,-1,-1
MEMMUS.txt,480543,480692,149,5,N,N,-,-1,-1
MEMMUS.txt,480695,480831,136,5,N,N,-,-1,-1
MEMMUS.txt,480834,480936,102,5,N,N,-,-1,-1
MEMMUS.txt,480939,481064,125,5,N,N,-,-1,-1
MEMMUS.txt,481067,485950,4883,5,N,N,-,-1,-1
MEMMUS.txt,485951,488061,2110,5,N,N,-,-1,-1
MEMMUS.txt,488064,491153,3089,5,N,N,-,-1,-1
MULIFE.txt,0,226,226,5,N,N,-,-1,-1
MULIFE.txt,227,799,572,5,N,N,-,-1,-1
MULIFE.txt,804,1521,717,5,N,N,-,-1,-1
MULIFE.txt,1522,1604,82,5,N,N,-,-1,-1
MULIFE.txt,1605,1711,106,5,N,N,-,-1,-1
MULIFE.txt,1712,1839,127,5,N,N,-,-1,-1
MULIFE.txt,1840,1976,136,5,N,N,-,-1,-1
MULIFE.txt,1977,2049,72,5,N,N,-,-1,-1
MULIFE.txt,2050,2145,95,5,N,N,-,-1,-1
MULIFE.txt,2146,2224,78,5,N,N,-,-1,-1
MULIFE.txt,2225,2329,104,5,N,N,-,-1,-1
MULIFE.txt,2330,2487,157,5,N,N,-,-1,-1
MULIFE.txt,2488,2594,106,5,N,N,-,-1,-1
MULIFE.txt,2595,2732,137,5,N,N,-,-1,-1
MULIFE.txt,2733,2827,94,5,N,N,-,-1,-1
MULIFE.txt,2828,2923,95,5,N,N,-,-1,-1
MULIFE.txt,2924,3019,95,5,N,N,-,-1,-1
MULIFE.txt,3020,3137,117,5,N,N,-,-1,-1
MULIFE.txt,3142,3228,86,5,N,N,-,-1,-1
MULIFE.txt,3229,3302,73,5,N,N,-,-1,-1
MULIFE.txt,3302,3366,64,5,N,N,-,-1,-1
MULIFE.txt,3367,3525,158,5,N,N,-,-1,-1
MULIFE.txt,3526,3652,126,5,N,N,-,-1,-1
MULIFE.txt,3653,3681,28,5,N,N,-,-1,-1
MULIFE.txt,3684,3752,68,5,N,N,-,-1,-1
MULIFE.txt,3753,3901,148,5,N,N,-,-1,-1
MULIFE.txt,3902,4043,141,5,N,N,-,-1,-1
MULIFE.txt,4044,4205,161,5,N,N,-,-1,-1
MULIFE.txt,4206,4347,141,5,N,N,-,-1,-1
MULIFE.txt,4348,4461,113,5,N,N,-,-1,-1
MULIFE.txt,4464,4565,101,5,N,N,-,-1,-1
MULIFE.txt,4566,4734,168,5,N,N,-,-1,-1
MULIFE.txt,4735,4819,84,5,N,N,-,-1,-1
MULIFE.txt,4820,5014,194,5,N,N,-,-1,-1
MULIFE.txt,5015,5227,212,5,N,N,-,-1,-1
MULIFE.txt,5228,5352,124,5,N,N,-,-1,-1
MULIFE.txt,5353,5505,152,5,N,N,-,-1,-1
MULIFE.txt,5506,5582,76,5,N,N,-,-1,-1
MULIFE.txt,5583,5673,90,5,N,N,-,-1,-1
MULIFE.txt,5674,5756,82,5,N,N,-,-1,-1
MULIFE.txt,5757,5875,118,5,N,N,-,-1,-1
MULIFE.txt,5876,6007,131,5,N,N,-,-1,-1
MULIFE.txt,6008,6169,161,5,N,N,-,-1,-1
MULIFE.txt,6170,6308,138,5,N,N,-,-1,-1
MULIFE.txt,6309,6470,161,5,N,N,-,-1,-1
MULIFE.txt,6470,6639,169,5,N,N,-,-1,-1
MULIFE.txt,6640,6778,138,5,N,N,-,-1,-1
MULIFE.txt,6779,6910,131,5,N,N,-,-1,-1
MULIFE.txt,6911,7076,165,5,N,N,-,-1,-1
MULIFE.txt,7077,7131,54,5,N,N,-,-1,-1
MULIFE.txt,7132,7286,154,5,N,N,-,-1,-1
MULIFE.txt,7287,7420,133,5,N,N,-,-1,-1
MULIFE.txt,7421,7571,150,5,N,N,-,-1,-1
MULIFE.txt,7572,7690,118,5,N,N,-,-1,-1
MULIFE.txt,7691,7830,139,5,N,N,-,-1,-1
MULIFE.txt,7831,8004,173,5,N,N,-,-1,-1
MULIFE.txt,8005,8060,55,5,N,N,-,-1,-1
MULIFE.txt,8061,8156,95,5,N,N,-,-1,-1
MULIFE.txt,8157,8250,93,5,N,N,-,-1,-1
MULIFE.txt,8251,8361,110,5,N,N,-,-1,-1
MULIFE.txt,8362,8521,159,5,N,N,-,-1,-1
MULIFE.txt,8522,8658,136,5,N,N,-,-1,-1
MULIFE.txt,8659,8800,141,5,N,N,-,-1,-1
MULIFE.txt,8801,8920,119,5,N,N,-,-1,-1
MULIFE.txt,8921,9074,153,5,N,N,-,-1,-1
MULIFE.txt,9075,9235,160,5,N,N,-,-1,-1
MULIFE.txt,9236,9459,223,5,N,N,-,-1,-1
MULIFE.txt,9460,9628,168,5,N,N,-,-1,-1
MULIFE.txt,9629,9823,194,5,N,N,-,-1,-1
MULIFE.txt,9824,9999,175,5,N,N,-,-1,-1
MULIFE.txt,10000,10165,165,5,N,N,-,-1,-1
MULIFE.txt,10166,10370,204,5,N,N,-,-1,-1
MULIFE.txt,10371,10505,134,5,N,N,-,-1,-1
MULIFE.txt,10506,10595,89,5,N,N,-,-1,-1
MULIFE.txt,10596,10725,129,5,N,N,-,-1,-1
MULIFE.txt,10726,10821,95,5,N,N,-,-1,-1
MULIFE.txt,10824,10886,62,5,N,N,-,-1,-1
MULIFE.txt,10887,10996,109,5,N,N,-,-1,-1
MULIFE.txt,10997,11069,72,5,N,N,-,-1,-1
MULIFE.txt,11069,11131,62,5,N,N,-,-1,-1
MULIFE.txt,11132,11283,151,5,N,N,-,-1,-1
MULIFE.txt,11283,11427,144,5,N,N,-,-1,-1
MULIFE.txt,11428,11586,158,5,N,N,-,-1,-1
MULIFE.txt,11587,11713,126,5,N,N,-,-1,-1
MULIFE.txt,11714,11834,120,5,N,N,-,-1,-1
MULIFE.txt,11835,11945,110,5,N,N,-,-1,-1
MULIFE.txt,11946,12050,104,5,N,N,-,-1,-1
MULIFE.txt,12051,12167,116,5,N,N,-,-1,-1
MULIFE.txt,12168,12282,114,5,N,N,-,-1,-1
MULIFE.txt,12283,12431,148,5,N,N,-,-1,-1
MULIFE.txt,12434,12512,78,5,N,N,-,-1,-1
MULIFE.txt,12513,12580,67,5,N,N,-,-1,-1
MULIFE.txt,12581,12750,169,5,N,N,-,-1,-1
MULIFE.txt,12751,12899,148,5,N,N,-,-1,-1
MULIFE.txt,12900,13087,187,5,N,N,-,-1,-1
MULIFE.txt,13088,13228,140,5,N,N,-,-1,-1
MULIFE.txt,13229,13380,151,5,N,N,-,-1,-1
MULIFE.txt,13381,13555,174,5,N,N,-,-1,-1
MULIFE.txt,13556,13728,172,5,N,N,-,-1,-1
MULIFE.txt,13729,13873,144,5,N,N,-,-1,-1
MULIFE.txt,13876,13990,114,5,N,N,-,-1,-1
MULIFE.txt,13991,14115,124,5,N,N,-,-1,-1
MULIFE.txt,14116,14240,124,5,N,N,-,-1,-1
MULIFE.txt,14241,14421,180,5,N,N,-,-1,-1
MULIFE.txt,14422,14562,140,5,N,N,-,-1,-1
MULIFE.txt,14563,14711,148,5,N,N,-,-1,-1
MULIFE.txt,14712,14854,142,5,N,N,-,-1,-1
MULIFE.txt,14855,14967,112,5,N,N,-,-1,-1
MULIFE.txt,14968,15092,124,5,N,N,-,-1,-1
MULIFE.txt,15093,15183,90,5,N,N,-,-1,-1
MULIFE.txt,15184,15340,156,5,N,N,-,-1,-1
MULIFE.txt,15341,15501,160,5,N,N,-,-1,-1
MULIFE.txt,15502,15632,130,5,N,N,-,-1,-1
MULIFE.txt,15633,15757,124,5,N,N,-,-1,-1
MULIFE.txt,15758,15900,142,5,N,N,-,-1,-1
MULIFE.txt,15901,16035,134,5,N,N,-,-1,-1
MULIFE.txt,16036,16203,167,5,N,N,-,-1,-1
MULIFE.txt,16204,16286,82,5,N,N,-,-1,-1
MULIFE.txt,16287,16429,142,5,N,N,-,-1,-1
MULIFE.txt,16430,16515,85,5,N,N,-,-1,-1
MULIFE.txt,16516,16677,161,5,N,N,-,-1,-1
MULIFE.txt,16678,16763,85,5,N,N,-,-1,-1
MULIFE.txt,16764,16921,157,5,N,N,-,-1,-1
MULIFE.txt,16922,17075,153,5,N,N,-,-1,-1
MULIFE.txt,17076,17174,98,5,N,N,-,-1,-1
MULIFE.txt,17175,17335,160,5,N,N,-,-1,-1
MULIFE.txt,17336,17462,126,5,N,N,-,-1,-1
MULIFE.txt,17463,17557,94,5,N,N,-,-1,-1
MULIFE.txt,17558,17675,117,5,N,N,-,-1,-1
MULIFE.txt,17676,17817,141,5,N,N,-,-1,-1
MULIFE.txt,17818,17965,147,5,N,N,-,-1,-1
MULIFE.txt,17968,18050,82,5,N,N,-,-1,-1
MULIFE.txt,18051,18209,158,5,N,N,-,-1,-1
MULIFE.txt,18210,18347,137,5,N,N,-,-1,-1
MULIFE.txt,18348,18451,103,5,N,N,-,-1,-1
MULIFE.txt,18452,18616,164,5,N,N,-,-1,-1
MULIFE.txt,18617,18746,129,5,N,N,-,-1,-1
MULIFE.txt,18749,18833,84,5,N,N,-,-1,-1
MULIFE.txt,18834,18946,112,5,N,N,-,-1,-1
MULIFE.txt,18947,19050,103,5,N,N,-,-1,-1
MULIFE.txt,19051,19194,143,5,N,N,-,-1,-1
MULIFE.txt,19195,19313,118,5,N,N,-,-1,-1
MULIFE.txt,19314,19431,117,5,N,N,-,-1,-1
MULIFE.txt,19432,19540,108,5,N,N,-,-1,-1
MULIFE.txt,19541,19658,117,5,N,N,-,-1,-1
MULIFE.txt,19659,19771,112,5,N,N,-,-1,-1
MULIFE.txt,19772,19877,105,5,N,N,-,-1,-1
MULIFE.txt,19878,19982,104,5,N,N,-,-1,-1
MULIFE.txt,19985,20129,144,5,N,N,-,-1,-1
MULIFE.txt,20130,20246,116,5,N,N,-,-1,-1
MULIFE.txt,20247,20331,84,5,N,N,-,-1,-1
MULIFE.txt,20332,20422,90,5,N,N,-,-1,-1
MULIFE.txt,20423,20600,177,5,N,N,-,-1,-1
MULIFE.txt,20601,20754,153,5,N,N,-,-1,-1
MULIFE.txt,20755,20958,203,5,N,N,-,-1,-1
MULIFE.txt,20959,21134,175,5,N,N,-,-1,-1
MULIFE.txt,21135,21294,159,5,N,N,-,-1,-1
MULIFE.txt,21295,21397,102,5,N,N,-,-1,-1
MULIFE.txt,21398,21506,108,5,N,N,-,-1,-1
MULIFE.txt,21507,21657,150,5,N,N,-,-1,-1
MULIFE.txt,21658,21852,194,5,N,N,-,-1,-1
MULIFE.txt,21853,21977,124,5,N,N,-,-1,-1
MULIFE.txt,21978,22212,234,5,N,N,-,-1,-1
MULIFE.txt,22213,22744,531,5,N,N,-,-1,-1
MULIFE.txt,22745,23027,282,5,N,N,-,-1,-1
MULIFE.txt,23028,23639,611,5,N,N,-,-1,-1
MULIFE.txt,23642,24323,681,5,N,N,-,-1,-1
MULIFE.txt,24324,24620,296,5,N,N,-,-1,-1
MULIFE.txt,24623,24952,329,5,N,N,-,-1,-1
MULIFE.txt,24955,25421,466,5,N,N,-,-1,-1
MULIFE.txt,25421,25732,311,5,N,N,-,-1,-1
MULIFE.txt,25735,26589,854,5,N,N,-,-1,-1
MULIFE.txt,26590,27265,675,5,N,N,-,-1,-1
MULIFE.txt,27268,27682,414,5,N,N,-,-1,-1
MULIFE.txt,27683,28224,541,5,N,N,-,-1,-1
MULIFE.txt,28226,28518,292,5,N,N,-,-1,-1
MULIFE.txt,28519,29060,541,5,N,N,-,-1,-1
MULIFE.txt,29061,29755,694,5,N,N,-,-1,-1
MULIFE.txt,29756,30895,1139,5,N,N,-,-1,-1
MULIFE.txt,30896,31623,727,5,N,N,-,-1,-1
MULIFE.txt,31624,31919,295,5,N,N,-,-1,-1
MULIFE.txt,31921,32737,816,5,N,N,-,-1,-1
MULIFE.txt,32738,33464,726,5,N,Y,1437637327937,33188,35197
MULIFE.txt,33465,34062,597,5,N,Y,1437637327937,33188,35197
MULIFE.txt,34063,34806,743,5,N,Y,1437637327937,33188,35197
MULIFE.txt,34807,35255,448,5,N,Y,1437637327937,33188,35197
MULIFE.txt,35256,35666,410,5,N,Y,1437642866570,35507,37282
MULIFE.txt,35667,36468,801,5,N,Y,1437642866570,35507,37282
MULIFE.txt,36469,37075,606,5,N,Y,1437642866570,35507,37282
MULIFE.txt,37076,37417,341,5,N,Y,1437642866570,35507,37282
MULIFE.txt,37418,38120,702,5,N,N,-,-1,-1
MULIFE.txt,38121,38748,627,5,N,N,-,-1,-1
MULIFE.txt,38749,39188,439,5,N,N,-,-1,-1
MULIFE.txt,39189,39817,628,5,N,Y,1437643218811,39345,39813
MULIFE.txt,39819,40240,421,5,N,N,-,-1,-1
MULIFE.txt,40241,40538,297,5,N,Y,1437643552468,40385,41243
MULIFE.txt,40539,40905,366,5,N,Y,1437643552468,40385,41243
MULIFE.txt,40906,41316,410,5,N,Y,1437643552468,40385,41243
MULIFE.txt,41317,41630,313,5,N,N,-,-1,-1
MULIFE.txt,41631,42598,967,5,N,N,-,-1,-1
MULIFE.txt,42601,43305,704,5,N,N,-,-1,-1
MULIFE.txt,43308,43967,659,5,N,N,-,-1,-1
MULIFE.txt,43968,44720,752,5,N,N,-,-1,-1
MULIFE.txt,44721,45078,357,5,N,N,-,-1,-1
MULIFE.txt,45079,45667,588,5,N,N,-,-1,-1
MULIFE.txt,45668,46317,649,5,N,N,-,-1,-1
MULIFE.txt,46319,46994,675,5,N,N,-,-1,-1
MULIFE.txt,46995,47348,353,5,N,N,-,-1,-1
MULIFE.txt,47349,47968,619,5,N,N,-,-1,-1
MULIFE.txt,47969,48292,323,5,N,N,-,-1,-1
MULIFE.txt,48293,48788,495,5,N,N,-,-1,-1
MULIFE.txt,48789,49487,698,5,N,N,-,-1,-1
MULIFE.txt,49488,49845,357,5,N,N,-,-1,-1
MULIFE.txt,49846,50622,776,5,N,Y,1437644129613,50016,51209
MULIFE.txt,50624,51275,651,5,N,Y,1437644129613,50016,51209
MULIFE.txt,51276,51592,316,5,N,N,-,-1,-1
MULIFE.txt,51593,51988,395,5,N,N,-,-1,-1
MULIFE.txt,51991,52533,542,5,N,N,-,-1,-1
MULIFE.txt,52534,53016,482,5,N,N,-,-1,-1
MULIFE.txt,53017,53632,615,5,N,N,-,-1,-1
MULIFE.txt,53633,53955,322,5,N,Y,1437644802503,53881,55535
MULIFE.txt,53956,54845,889,5,N,Y,1437644802503,53881,55535
MULIFE.txt,54846,55286,440,5,N,Y,1437644802503,53881,55535
MULIFE.txt,55288,55924,636,5,N,Y,1437670019221,55738,57876
MULIFE.txt,55925,56477,552,5,N,Y,1437670019221,55738,57876
MULIFE.txt,56478,56946,468,5,N,Y,1437670019221,55738,57876
MULIFE.txt,56948,57905,957,5,N,Y,1437670019221,55738,57876
MULIFE.txt,57906,58401,495,5,N,N,-,-1,-1
MULIFE.txt,58402,58931,529,5,N,Y,1437670482083,58835,59579
MULIFE.txt,58934,59324,390,5,N,Y,1437670482083,58835,59579
MULIFE.txt,59325,60093,768,5,N,Y,1437670482083,58835,59579
MULIFE.txt,60094,60585,491,5,N,N,-,-1,-1
MULIFE.txt,60586,61014,428,5,N,N,-,-1,-1
MULIFE.txt,61017,61192,175,5,N,N,-,-1,-1
MULIFE.txt,61193,61872,679,5,N,N,-,-1,-1
MULIFE.txt,61873,62743,870,5,N,N,-,-1,-1
MULIFE.txt,62746,63099,353,5,N,N,-,-1,-1
MULIFE.txt,63100,63571,471,5,N,N,-,-1,-1
MULIFE.txt,63572,64008,436,5,N,Y,1437671026479,63906,64392
MULIFE.txt,64009,64767,758,5,N,Y,1437671026479,63906,64392
MULIFE.txt,64770,65381,611,5,N,N,-,-1,-1
MULIFE.txt,65382,65852,470,5,N,N,-,-1,-1
MULIFE.txt,65855,66709,854,5,N,N,-,-1,-1
MULIFE.txt,66712,67852,1140,5,Y,N,-,-1,-1
MULIFE.txt,67855,68237,382,5,N,N,-,-1,-1
MULIFE.txt,68238,68552,314,5,N,N,-,-1,-1
MULIFE.txt,68557,68877,320,5,N,N,-,-1,-1
MULIFE.txt,68878,68995,117,5,N,N,-,-1,-1
MULIFE.txt,68996,69308,312,5,N,N,-,-1,-1
MULIFE.txt,69309,69742,433,5,N,N,-,-1,-1
MULIFE.txt,69743,70325,582,5,N,N,-,-1,-1
MULIFE.txt,70326,70970,644,5,N,N,-,-1,-1
MULIFE.txt,70973,71497,524,5,N,N,-,-1,-1
MULIFE.txt,71498,71991,493,5,N,N,-,-1,-1
MULIFE.txt,71992,72631,639,5,N,N,-,-1,-1
MULIFE.txt,72633,73006,373,5,N,N,-,-1,-1
MULIFE.txt,73007,73336,329,5,N,N,-,-1,-1
MULIFE.txt,73337,73645,308,5,N,N,-,-1,-1
MULIFE.txt,73647,74507,860,5,N,Y,1437671604320,74249,75453
MULIFE.txt,74510,74878,368,5,N,Y,1437671604320,74249,75453
MULIFE.txt,74879,75474,595,5,N,Y,1437671604320,74249,75453
MULIFE.txt,75475,76371,896,5,N,Y,1437672056241,76209,76827
MULIFE.txt,76374,77045,671,5,Y,Y,1437672056241,76209,76827
MULIFE.txt,77046,77666,620,5,N,N,-,-1,-1
MULIFE.txt,77667,77929,262,5,N,N,-,-1,-1
MULIFE.txt,77930,78386,456,5,N,N,-,-1,-1
MULIFE.txt,78387,79287,900,5,N,N,-,-1,-1
MULIFE.txt,79288,79976,688,5,N,N,-,-1,-1
MULIFE.txt,79979,80313,334,5,N,N,-,-1,-1
MULIFE.txt,80314,80727,413,5,N,N,-,-1,-1
MULIFE.txt,80728,81456,728,5,N,N,-,-1,-1
MULIFE.txt,81458,81849,391,5,N,N,-,-1,-1
MULIFE.txt,81850,82363,513,5,N,N,-,-1,-1
MULIFE.txt,82366,83171,805,5,N,Y,1437672626512,82770,83334
MULIFE.txt,83172,83673,501,5,N,Y,1437672626512,82770,83334
MULIFE.txt,83674,84168,494,5,N,N,-,-1,-1
MULIFE.txt,84169,84752,583,5,N,N,-,-1,-1
MULIFE.txt,84753,85247,494,5,N,N,-,-1,-1
MULIFE.txt,85248,85705,457,5,N,N,-,-1,-1
MULIFE.txt,85706,86472,766,5,N,N,-,-1,-1
MULIFE.txt,86473,87003,530,5,N,N,-,-1,-1
MULIFE.txt,87004,87413,409,5,N,N,-,-1,-1
MULIFE.txt,87414,87915,501,5,N,N,-,-1,-1
MULIFE.txt,87918,88792,874,5,N,N,-,-1,-1
MULIFE.txt,88793,89200,407,5,N,N,-,-1,-1
MULIFE.txt,89202,89577,375,5,N,N,-,-1,-1
MULIFE.txt,89578,89894,316,5,N,N,-,-1,-1
MULIFE.txt,89895,90438,543,5,N,N,-,-1,-1
MULIFE.txt,90439,91170,731,5,N,N,-,-1,-1
MULIFE.txt,91173,91715,542,5,N,N,-,-1,-1
MULIFE.txt,91716,92254,538,5,N,N,-,-1,-1
MULIFE.txt,92255,93044,789,5,N,N,-,-1,-1
MULIFE.txt,93045,93592,547,5,N,N,-,-1,-1
MULIFE.txt,93593,94202,609,5,N,N,-,-1,-1
MULIFE.txt,94203,94969,766,5,N,N,-,-1,-1
MULIFE.txt,94970,95707,737,5,N,N,-,-1,-1
MULIFE.txt,95710,96253,543,5,N,N,-,-1,-1
MULIFE.txt,96254,96707,453,5,N,N,-,-1,-1
MULIFE.txt,96708,97290,582,5,N,N,-,-1,-1
MULIFE.txt,97291,97957,666,5,N,N,-,-1,-1
MULIFE.txt,97958,98416,458,5,N,N,-,-1,-1
MULIFE.txt,98417,98664,247,5,N,N,-,-1,-1
MULIFE.txt,98665,99030,365,5,N,N,-,-1,-1
MULIFE.txt,99031,99776,745,5,N,N,-,-1,-1
MULIFE.txt,99777,100329,552,5,N,N,-,-1,-1
MULIFE.txt,100330,100805,475,5,N,N,-,-1,-1
MULIFE.txt,100806,101076,270,5,N,N,-,-1,-1
MULIFE.txt,101077,101316,239,5,N,N,-,-1,-1
MULIFE.txt,101319,101900,581,5,N,N,-,-1,-1
MULIFE.txt,101901,102127,226,5,N,N,-,-1,-1
MULIFE.txt,102128,102377,249,5,N,N,-,-1,-1
MULIFE.txt,102378,102963,585,5,N,N,-,-1,-1
MULIFE.txt,102966,103338,372,5,N,N,-,-1,-1
MULIFE.txt,103341,104107,766,5,N,N,-,-1,-1
MULIFE.txt,104108,104287,179,5,N,N,-,-1,-1
MULIFE.txt,104288,104840,552,5,N,N,-,-1,-1
MULIFE.txt,104843,105054,211,5,N,N,-,-1,-1
MULIFE.txt,105055,105398,343,5,N,N,-,-1,-1
MULIFE.txt,105401,105728,327,5,N,N,-,-1,-1
MULIFE.txt,105731,106108,377,5,N,N,-,-1,-1
MULIFE.txt,106109,106524,415,5,N,N,-,-1,-1
MULIFE.txt,106525,107055,530,5,N,N,-,-1,-1
MULIFE.txt,107056,107597,541,5,N,N,-,-1,-1
MULIFE.txt,107600,108191,591,5,N,N,-,-1,-1
MULIFE.txt,108194,108645,451,5,N,N,-,-1,-1
MULIFE.txt,108650,109018,368,5,N,N,-,-1,-1
MULIFE.txt,109020,109757,737,5,N,N,-,-1,-1
MULIFE.txt,109758,110241,483,5,N,N,-,-1,-1
MULIFE.txt,110242,110714,472,5,N,N,-,-1,-1
MULIFE.txt,110717,111659,942,5,N,N,-,-1,-1
MULIFE.txt,111662,111975,313,5,N,N,-,-1,-1
MULIFE.txt,111976,112262,286,5,N,N,-,-1,-1
MULIFE.txt,112263,112515,252,5,N,N,-,-1,-1
MULIFE.txt,112516,112864,348,5,N,N,-,-1,-1
MULIFE.txt,112866,113286,420,5,N,N,-,-1,-1
MULIFE.txt,113287,113847,560,5,N,N,-,-1,-1
MULIFE.txt,113849,114226,377,5,N,N,-,-1,-1
MULIFE.txt,114229,115033,804,5,N,Y,1437727565787,114231,114741
MULIFE.txt,115035,115484,449,5,N,Y,1437728842716,115343,116376
MULIFE.txt,115485,116213,728,5,N,Y,1437728842716,115343,116376
MULIFE.txt,116214,116866,652,5,N,Y,1437728842716,115343,116376
MULIFE.txt,116867,117160,293,5,N,N,-,-1,-1
MULIFE.txt,117161,117690,529,5,N,Y,1437729348025,117608,118272
MULIFE.txt,117691,118659,968,5,N,Y,1437729348025,117608,118272
MULIFE.txt,118660,119217,557,5,N,N,-,-1,-1
MULIFE.txt,119218,119489,271,5,N,N,-,-1,-1
MULIFE.txt,119490,120023,533,5,N,N,-,-1,-1
MULIFE.txt,120026,120397,371,5,N,N,-,-1,-1
MULIFE.txt,120398,120774,376,5,N,N,-,-1,-1
MULIFE.txt,120776,121460,684,5,N,N,-,-1,-1
MULIFE.txt,121463,122042,579,5,N,N,-,-1,-1
MULIFE.txt,122043,122418,375,5,N,N,-,-1,-1
MULIFE.txt,122419,122902,483,5,N,N,-,-1,-1
MULIFE.txt,122904,123120,216,5,N,N,-,-1,-1
MULIFE.txt,123121,123338,217,5,N,N,-,-1,-1
MULIFE.txt,123339,123500,161,5,N,N,-,-1,-1
MULIFE.txt,123501,123958,457,5,N,N,-,-1,-1
MULIFE.txt,123959,124693,734,5,N,N,-,-1,-1
MULIFE.txt,124694,125398,704,5,N,N,-,-1,-1
MULIFE.txt,125399,126111,712,5,N,N,-,-1,-1
MULIFE.txt,126112,126635,523,5,N,N,-,-1,-1
MULIFE.txt,126636,127286,650,5,N,N,-,-1,-1
MULIFE.txt,127289,127883,594,5,N,Y,1437729941282,127304,128704
MULIFE.txt,127884,128768,884,5,N,Y,1437729941282,127304,128704
MULIFE.txt,128771,129396,625,5,N,Y,1437730322242,128854,129770
MULIFE.txt,129397,129913,516,5,N,Y,1437730322242,128854,129770
MULIFE.txt,129915,130697,782,5,N,N,-,-1,-1
MULIFE.txt,130702,130805,103,5,N,N,-,-1,-1
MULIFE.txt,130806,131016,210,5,N,N,-,-1,-1
MULIFE.txt,131017,131279,262,5,N,N,-,-1,-1
MULIFE.txt,131281,131732,451,5,N,N,-,-1,-1
MULIFE.txt,131734,132305,571,5,N,N,-,-1,-1
MULIFE.txt,132306,132660,354,5,N,N,-,-1,-1
MULIFE.txt,132661,133259,598,5,N,N,-,-1,-1
MULIFE.txt,133260,133476,216,5,N,N,-,-1,-1
MULIFE.txt,133477,133958,481,5,N,N,-,-1,-1
MULIFE.txt,133959,134491,532,5,N,N,-,-1,-1
MULIFE.txt,134492,135036,544,5,N,N,-,-1,-1
MULIFE.txt,135037,136084,1047,5,N,N,-,-1,-1
MULIFE.txt,136085,136595,510,5,N,N,-,-1,-1
MULIFE.txt,136596,137126,530,5,N,Y,1437731100795,137101,140058
MULIFE.txt,137127,137243,116,5,N,Y,1437731100795,137101,140058
MULIFE.txt,137244,138030,786,5,N,Y,1437731100795,137101,140058
MULIFE.txt,138033,138884,851,5,N,Y,1437731100795,137101,140058
MULIFE.txt,138885,139875,990,5,N,Y,1437731100795,137101,140058
MULIFE.txt,139876,140441,565,5,N,Y,1437731100795,137101,140058
MULIFE.txt,140442,140953,511,5,N,Y,1437731620872,140380,141808
MULIFE.txt,140956,141942,986,5,N,Y,1437731620872,140380,141808
MULIFE.txt,141943,142141,198,5,N,Y,1437732462096,142028,144946
MULIFE.txt,142142,142589,447,5,N,Y,1437732462096,142028,144946
MULIFE.txt,142590,143118,528,5,N,Y,1437732462096,142028,144946
MULIFE.txt,143119,143481,362,5,N,Y,1437732462096,142028,144946
MULIFE.txt,143483,143746,263,5,N,Y,1437732462096,142028,144946
MULIFE.txt,143747,144571,824,5,N,Y,1437732462096,142028,144946
MULIFE.txt,144572,145405,833,5,N,Y,1437732462096,142028,144946
MULIFE.txt,145406,146085,679,5,N,N,-,-1,-1
MULIFE.txt,146086,146702,616,5,N,N,-,-1,-1
MULIFE.txt,146703,147259,556,5,N,N,-,-1,-1
MULIFE.txt,147260,147832,572,5,N,N,-,-1,-1
MULIFE.txt,147833,148412,579,5,N,N,-,-1,-1
MULIFE.txt,148413,149012,599,5,N,N,-,-1,-1
MULIFE.txt,149014,149541,527,5,N,N,-,-1,-1
MULIFE.txt,149543,150238,695,5,N,N,-,-1,-1
MULIFE.txt,150240,151142,902,5,N,N,-,-1,-1
MULIFE.txt,151145,151780,635,5,N,N,-,-1,-1
MULIFE.txt,151781,152489,708,5,N,N,-,-1,-1
MULIFE.txt,152490,152920,430,5,N,N,-,-1,-1
MULIFE.txt,152921,153387,466,5,N,N,-,-1,-1
MULIFE.txt,153388,154003,615,5,N,N,-,-1,-1
MULIFE.txt,154006,154287,281,5,N,N,-,-1,-1
MULIFE.txt,154288,155028,740,5,N,N,-,-1,-1
MULIFE.txt,155029,155155,126,5,N,N,-,-1,-1
MULIFE.txt,155156,155369,213,5,N,N,-,-1,-1
MULIFE.txt,155371,155638,267,5,N,N,-,-1,-1
MULIFE.txt,155639,156045,406,5,N,N,-,-1,-1
MULIFE.txt,156046,156515,469,5,N,N,-,-1,-1
MULIFE.txt,156516,156860,344,5,N,N,-,-1,-1
MULIFE.txt,156861,157123,262,5,N,N,-,-1,-1
MULIFE.txt,157124,157773,649,5,N,N,-,-1,-1
MULIFE.txt,157774,158647,873,5,N,N,-,-1,-1
MULIFE.txt,158649,158950,301,5,N,N,-,-1,-1
MULIFE.txt,158951,159896,945,5,N,N,-,-1,-1
MULIFE.txt,159897,160372,475,5,N,N,-,-1,-1
MULIFE.txt,160373,161114,741,5,N,N,-,-1,-1
MULIFE.txt,161116,161827,711,5,N,N,-,-1,-1
MULIFE.txt,161828,162457,629,5,N,N,-,-1,-1
MULIFE.txt,162460,162847,387,5,N,N,-,-1,-1
MULIFE.txt,162848,163232,384,5,N,N,-,-1,-1
MULIFE.txt,163233,163417,184,5,N,N,-,-1,-1
MULIFE.txt,163418,164129,711,5,N,N,-,-1,-1
MULIFE.txt,164130,164669,539,5,N,N,-,-1,-1
MULIFE.txt,164670,165539,869,5,N,N,-,-1,-1
MULIFE.txt,165540,165920,380,5,N,N,-,-1,-1
MULIFE.txt,165921,166700,779,5,N,N,-,-1,-1
MULIFE.txt,166701,167258,557,5,N,N,-,-1,-1
MULIFE.txt,167260,168048,788,5,N,N,-,-1,-1
MULIFE.txt,168051,168744,693,5,N,N,-,-1,-1
MULIFE.txt,168745,169046,301,5,N,N,-,-1,-1
MULIFE.txt,169047,170579,1532,5,N,N,-,-1,-1
MULIFE.txt,170582,171319,737,5,N,Y,1437736266658,170580,171597
MULIFE.txt,171320,171937,617,5,N,Y,1437736266658,170580,171597
MULIFE.txt,171938,172392,454,5,N,N,-,-1,-1
MULIFE.txt,172395,172774,379,5,N,N,-,-1,-1
MULIFE.txt,172775,173359,584,5,N,N,-,-1,-1
MULIFE.txt,173360,174100,740,5,N,N,-,-1,-1
MULIFE.txt,174101,175029,928,5,N,N,-,-1,-1
MULIFE.txt,175031,175812,781,5,N,N,-,-1,-1
MULIFE.txt,175815,176794,979,5,N,N,-,-1,-1
MULIFE.txt,176797,177261,464,5,N,N,-,-1,-1
MULIFE.txt,177262,177849,587,5,N,N,-,-1,-1
MULIFE.txt,177850,178159,309,5,N,N,-,-1,-1
MULIFE.txt,178160,178384,224,5,N,N,-,-1,-1
MULIFE.txt,178385,178802,417,5,N,N,-,-1,-1
MULIFE.txt,178803,179520,717,5,N,N,-,-1,-1
MULIFE.txt,179521,180182,661,5,N,N,-,-1,-1
MULIFE.txt,180183,180401,218,5,N,N,-,-1,-1
MULIFE.txt,180404,181114,710,5,N,N,-,-1,-1
MULIFE.txt,181115,181842,727,5,N,N,-,-1,-1
MULIFE.txt,181844,182650,806,5,N,N,-,-1,-1
MULIFE.txt,182653,182928,275,5,N,N,-,-1,-1
MULIFE.txt,182930,183189,259,5,N,N,-,-1,-1
MULIFE.txt,183194,183394,200,5,N,N,-,-1,-1
MULIFE.txt,183395,183971,576,5,N,N,-,-1,-1
MULIFE.txt,183972,184547,575,5,N,N,-,-1,-1
MULIFE.txt,184548,185285,737,5,N,N,-,-1,-1
MULIFE.txt,185286,185526,240,5,N,N,-,-1,-1
MULIFE.txt,185527,185915,388,5,N,N,-,-1,-1
MULIFE.txt,185916,186923,1007,5,N,N,-,-1,-1
MULIFE.txt,186925,187214,289,5,N,N,-,-1,-1
MULIFE.txt,187215,187670,455,5,N,N,-,-1,-1
MULIFE.txt,187671,188428,757,5,N,Y,1437737385709,188168,190108
MULIFE.txt,188429,188777,348,5,N,Y,1437737385709,188168,190108
MULIFE.txt,188778,189408,630,5,N,Y,1437737385709,188168,190108
MULIFE.txt,189409,189880,471,5,N,Y,1437737385709,188168,190108
MULIFE.txt,189881,190714,833,5,N,Y,1437737385709,188168,190108
MULIFE.txt,190715,191563,848,5,N,Y,1437737729211,191463,191884
MULIFE.txt,191566,191890,324,5,N,Y,1437737729211,191463,191884
MULIFE.txt,191893,192504,611,5,N,Y,1437737964896,191891,192160
MULIFE.txt,192505,192807,302,5,N,N,-,-1,-1
MULIFE.txt,192808,193358,550,5,N,N,-,-1,-1
MULIFE.txt,193359,193899,540,5,N,N,-,-1,-1
MULIFE.txt,193900,194578,678,5,N,N,-,-1,-1
MULIFE.txt,194579,195149,570,5,N,N,-,-1,-1
MULIFE.txt,195150,195969,819,5,N,N,-,-1,-1
MULIFE.txt,195970,196498,528,5,N,N,-,-1,-1
MULIFE.txt,196499,197003,504,5,N,N,-,-1,-1
MULIFE.txt,197006,197411,405,5,N,N,-,-1,-1
MULIFE.txt,197412,197968,556,5,N,N,-,-1,-1
MULIFE.txt,197969,198442,473,5,N,N,-,-1,-1
MULIFE.txt,198444,198902,458,5,N,N,-,-1,-1
MULIFE.txt,198903,199146,243,5,N,N,-,-1,-1
MULIFE.txt,199147,199912,765,5,N,N,-,-1,-1
MULIFE.txt,199915,200636,721,5,N,N,-,-1,-1
MULIFE.txt,200637,201085,448,5,N,N,-,-1,-1
MULIFE.txt,201086,201340,254,5,N,N,-,-1,-1
MULIFE.txt,201341,202184,843,5,N,N,-,-1,-1
MULIFE.txt,202185,202480,295,5,N,N,-,-1,-1
MULIFE.txt,202481,203213,732,5,N,N,-,-1,-1
MULIFE.txt,203215,203735,520,5,N,N,-,-1,-1
MULIFE.txt,203738,204398,660,5,N,N,-,-1,-1
MULIFE.txt,204399,205792,1393,5,N,N,-,-1,-1
MULIFE.txt,205793,206490,697,5,N,N,-,-1,-1
MULIFE.txt,206491,206842,351,5,N,N,-,-1,-1
MULIFE.txt,206844,206950,106,5,N,N,-,-1,-1
MULIFE.txt,206956,207740,784,5,N,N,-,-1,-1
MULIFE.txt,207741,208407,666,5,N,N,-,-1,-1
MULIFE.txt,208410,209182,772,5,N,N,-,-1,-1
MULIFE.txt,209183,209674,491,5,N,N,-,-1,-1
MULIFE.txt,209675,210405,730,5,N,N,-,-1,-1
MULIFE.txt,210408,210723,315,5,N,N,-,-1,-1
MULIFE.txt,210724,211298,574,5,N,N,-,-1,-1
MULIFE.txt,211299,211595,296,5,N,N,-,-1,-1
MULIFE.txt,211596,211874,278,5,N,N,-,-1,-1
MULIFE.txt,211875,212572,697,5,N,N,-,-1,-1
MULIFE.txt,212573,213208,635,5,N,N,-,-1,-1
MULIFE.txt,213213,213569,356,5,N,N,-,-1,-1
MULIFE.txt,213570,214029,459,5,N,N,-,-1,-1
MULIFE.txt,214029,214742,713,5,N,N,-,-1,-1
MULIFE.txt,214743,215413,670,5,N,N,-,-1,-1
MULIFE.txt,215414,215597,183,5,N,N,-,-1,-1
MULIFE.txt,215600,216115,515,5,N,N,-,-1,-1
MULIFE.txt,216116,216591,475,5,N,N,-,-1,-1
MULIFE.txt,216592,217403,811,5,N,N,-,-1,-1
MULIFE.txt,217404,217951,547,5,N,N,-,-1,-1
MULIFE.txt,217952,218392,440,5,N,N,-,-1,-1
MULIFE.txt,218395,219075,680,5,N,N,-,-1,-1
MULIFE.txt,219078,219376,298,5,N,N,-,-1,-1
MULIFE.txt,219377,219680,303,5,N,N,-,-1,-1
MULIFE.txt,219681,220319,638,5,N,N,-,-1,-1
MULIFE.txt,220320,220663,343,5,N,N,-,-1,-1
MULIFE.txt,220664,221131,467,5,N,N,-,-1,-1
MULIFE.txt,221132,221719,587,5,N,N,-,-1,-1
MULIFE.txt,221722,222110,388,5,N,N,-,-1,-1
MULIFE.txt,222111,223154,1043,5,N,N,-,-1,-1
MULIFE.txt,223155,223728,573,5,N,N,-,-1,-1
MULIFE.txt,223729,224831,1102,5,N,N,-,-1,-1
MULIFE.txt,224832,225031,199,5,N,N,-,-1,-1
MULIFE.txt,225032,225291,259,5,N,N,-,-1,-1
MULIFE.txt,225292,225739,447,5,N,N,-,-1,-1
MULIFE.txt,225740,226456,716,5,N,N,-,-1,-1
MULIFE.txt,226459,227074,615,5,N,N,-,-1,-1
MULIFE.txt,227076,227475,399,5,N,N,-,-1,-1
MULIFE.txt,227476,227587,111,5,N,N,-,-1,-1
MULIFE.txt,227587,228148,561,5,N,N,-,-1,-1
MULIFE.txt,228151,228759,608,5,N,N,-,-1,-1
MULIFE.txt,228760,229804,1044,5,N,N,-,-1,-1
MULIFE.txt,229807,231266,1459,5,N,N,-,-1,-1
MULIFE.txt,231267,231973,706,5,N,N,-,-1,-1
MULIFE.txt,231974,232758,784,5,N,N,-,-1,-1
MULIFE.txt,232759,233724,965,5,N,N,-,-1,-1
MULIFE.txt,233725,234560,835,5,N,N,-,-1,-1
MULIFE.txt,234563,234853,290,5,N,N,-,-1,-1
MULIFE.txt,234854,235744,890,5,N,N,-,-1,-1
MULIFE.txt,235745,236287,542,5,N,N,-,-1,-1
MULIFE.txt,236288,236907,619,5,N,N,-,-1,-1
MULIFE.txt,236910,237416,506,5,N,N,-,-1,-1
MULIFE.txt,237417,238110,693,5,N,N,-,-1,-1
MULIFE.txt,238111,238606,495,5,N,N,-,-1,-1
MULIFE.txt,238607,238951,344,5,N,N,-,-1,-1
MULIFE.txt,238952,239896,944,5,N,N,-,-1,-1
MULIFE.txt,239899,240189,290,5,N,N,-,-1,-1
MULIFE.txt,240190,240857,667,5,N,N,-,-1,-1
MULIFE.txt,240860,241524,664,5,N,N,-,-1,-1
MULIFE.txt,241525,241756,231,5,N,N,-,-1,-1
MULIFE.txt,241757,242415,658,5,N,N,-,-1,-1
MULIFE.txt,242418,242860,442,5,N,N,-,-1,-1
MULIFE.txt,242861,243490,629,5,N,N,-,-1,-1
MULIFE.txt,243493,244050,557,5,N,N,-,-1,-1
MULIFE.txt,244051,244644,593,5,N,N,-,-1,-1
MULIFE.txt,244645,245170,525,5,N,N,-,-1,-1
MULIFE.txt,245171,245924,753,5,N,N,-,-1,-1
MULIFE.txt,245925,246648,723,5,N,N,-,-1,-1
MULIFE.txt,246651,247345,694,5,N,N,-,-1,-1
MULIFE.txt,247346,248156,810,5,N,N,-,-1,-1
MULIFE.txt,248157,248587,430,5,N,N,-,-1,-1
MULIFE.txt,248588,249428,840,5,N,N,-,-1,-1
MULIFE.txt,249431,250181,750,5,N,N,-,-1,-1
MULIFE.txt,250182,250771,589,5,N,N,-,-1,-1
MULIFE.txt,250772,251743,971,5,N,N,-,-1,-1
MULIFE.txt,251748,252192,444,5,N,N,-,-1,-1
MULIFE.txt,252193,252866,673,5,N,N,-,-1,-1
MULIFE.txt,252867,253752,885,5,N,N,-,-1,-1
MULIFE.txt,253753,254640,887,5,N,N,-,-1,-1
MULIFE.txt,254643,255957,1314,5,N,N,-,-1,-1
MULIFE.txt,255958,256855,897,5,N,N,-,-1,-1
MULIFE.txt,256855,257742,887,5,N,N,-,-1,-1
MULIFE.txt,257743,258303,560,5,N,N,-,-1,-1
MULIFE.txt,258304,258978,674,5,N,N,-,-1,-1
MULIFE.txt,258981,259338,357,5,N,N,-,-1,-1
MULIFE.txt,259339,259710,371,5,N,N,-,-1,-1
MULIFE.txt,259711,260087,376,5,N,N,-,-1,-1
MULIFE.txt,260088,260620,532,5,N,N,-,-1,-1
MULIFE.txt,260621,261255,634,5,N,N,-,-1,-1
MULIFE.txt,261256,261791,535,5,N,N,-,-1,-1
MULIFE.txt,261792,262222,430,5,N,N,-,-1,-1
MULIFE.txt,262223,262827,604,5,N,N,-,-1,-1
MULIFE.txt,262830,263296,466,5,N,N,-,-1,-1
MULIFE.txt,263299,263685,386,5,N,N,-,-1,-1
MULIFE.txt,263686,264797,1111,5,N,N,-,-1,-1
MULIFE.txt,264798,265110,312,5,N,N,-,-1,-1
MULIFE.txt,265110,266042,932,5,N,N,-,-1,-1
MULIFE.txt,266043,266625,582,5,N,N,-,-1,-1
MULIFE.txt,266626,267651,1025,5,N,N,-,-1,-1
MULIFE.txt,267652,268383,731,5,N,N,-,-1,-1
MULIFE.txt,268384,269364,980,5,N,N,-,-1,-1
MULIFE.txt,269367,269801,434,5,N,N,-,-1,-1
MULIFE.txt,269802,270472,670,5,N,N,-,-1,-1
MULIFE.txt,270473,270725,252,5,N,N,-,-1,-1
MULIFE.txt,270726,271222,496,5,N,N,-,-1,-1
MULIFE.txt,271225,271839,614,5,N,N,-,-1,-1
MULIFE.txt,271840,272290,450,5,N,N,-,-1,-1
MULIFE.txt,272295,272869,574,5,N,N,-,-1,-1
MULIFE.txt,272872,273148,276,5,N,N,-,-1,-1
MULIFE.txt,273149,273429,280,5,N,N,-,-1,-1
MULIFE.txt,273430,273825,395,5,N,N,-,-1,-1
MULIFE.txt,273826,274622,796,5,N,N,-,-1,-1
MULIFE.txt,274624,275150,526,5,N,Y,1437748188744,274892,276661
MULIFE.txt,275153,275888,735,5,Y,Y,1437748188744,274892,276661
MULIFE.txt,275889,276904,1015,5,N,Y,1437748188744,274892,276661
MULIFE.txt,276905,277432,527,5,N,N,-,-1,-1
MULIFE.txt,277435,278285,850,5,N,N,-,-1,-1
MULIFE.txt,278288,278886,598,5,N,N,-,-1,-1
MULIFE.txt,278887,279476,589,5,N,N,-,-1,-1
MULIFE.txt,279477,280303,826,5,N,N,-,-1,-1
MULIFE.txt,280304,280743,439,5,N,N,-,-1,-1
MULIFE.txt,280744,282217,1473,5,N,N,-,-1,-1
MULIFE.txt,282218,282780,562,5,N,N,-,-1,-1
MULIFE.txt,282781,283208,427,5,N,N,-,-1,-1
MULIFE.txt,283209,283615,406,5,N,N,-,-1,-1
MULIFE.txt,283616,284414,798,5,N,N,-,-1,-1
MULIFE.txt,284415,284950,535,5,N,N,-,-1,-1
MULIFE.txt,284952,286305,1353,5,N,N,-,-1,-1
MULIFE.txt,286305,286978,673,5,N,N,-,-1,-1
MULIFE.txt,286979,287792,813,5,N,N,-,-1,-1
MULIFE.txt,287793,288171,378,5,N,N,-,-1,-1
MULIFE.txt,288172,288589,417,5,N,N,-,-1,-1
MULIFE.txt,288590,288925,335,5,N,N,-,-1,-1
MULIFE.txt,288926,289220,294,5,N,N,-,-1,-1
MULIFE.txt,289221,289929,708,5,N,N,-,-1,-1
MULIFE.txt,289932,291047,1115,5,N,N,-,-1,-1
MULIFE.txt,291050,291961,911,5,N,N,-,-1,-1
MULIFE.txt,291962,292983,1021,5,N,N,-,-1,-1
MULIFE.txt,292986,294003,1017,5,N,N,-,-1,-1
MULIFE.txt,294004,294865,861,5,N,N,-,-1,-1
MULIFE.txt,294867,295679,812,5,N,N,-,-1,-1
MULIFE.txt,295682,296389,707,5,N,N,-,-1,-1
MULIFE.txt,296390,297218,828,5,N,N,-,-1,-1
MULIFE.txt,297219,297621,402,5,N,N,-,-1,-1
MULIFE.txt,297622,298513,891,5,N,N,-,-1,-1
MULIFE.txt,298514,299642,1128,5,N,N,-,-1,-1
MULIFE.txt,299645,300304,659,5,N,N,-,-1,-1
MULIFE.txt,300305,300789,484,5,N,N,-,-1,-1
MULIFE.txt,300790,301305,515,5,N,N,-,-1,-1
MULIFE.txt,301308,301633,325,5,N,N,-,-1,-1
MULIFE.txt,301634,302048,414,5,N,N,-,-1,-1
MULIFE.txt,302048,302574,526,5,N,N,-,-1,-1
MULIFE.txt,302575,303473,898,5,N,N,-,-1,-1
MULIFE.txt,303474,304136,662,5,N,N,-,-1,-1
MULIFE.txt,304137,304786,649,5,N,N,-,-1,-1
MULIFE.txt,304788,305414,626,5,N,N,-,-1,-1
MULIFE.txt,305417,305638,221,5,N,N,-,-1,-1
MULIFE.txt,305639,306268,629,5,N,N,-,-1,-1
MULIFE.txt,306270,307413,1143,5,N,N,-,-1,-1
MULIFE.txt,307414,307860,446,5,N,N,-,-1,-1
MULIFE.txt,307861,308033,172,5,N,N,-,-1,-1
MULIFE.txt,308034,308164,130,5,N,N,-,-1,-1
MULIFE.txt,308165,308455,290,5,N,N,-,-1,-1
MULIFE.txt,308456,308984,528,5,N,N,-,-1,-1
MULIFE.txt,308985,310423,1438,5,N,N,-,-1,-1
MULIFE.txt,310426,311250,824,5,N,N,-,-1,-1
MULIFE.txt,311253,311928,675,5,N,N,-,-1,-1
MULIFE.txt,311929,312528,599,5,N,N,-,-1,-1
MULIFE.txt,312529,313617,1088,5,N,N,-,-1,-1
MULIFE.txt,313618,314240,622,5,N,N,-,-1,-1
MULIFE.txt,314241,314433,192,5,N,N,-,-1,-1
MULIFE.txt,314434,314514,80,5,N,N,-,-1,-1
MULIFE.txt,314515,315024,509,5,N,N,-,-1,-1
MULIFE.txt,315025,315710,685,5,N,N,-,-1,-1
MULIFE.txt,315711,318142,2431,5,N,N,-,-1,-1
MULIFE.txt,318143,318728,585,5,N,N,-,-1,-1
MULIFE.txt,318729,319968,1239,5,N,N,-,-1,-1
MULIFE.txt,319969,320607,638,5,N,N,-,-1,-1
MULIFE.txt,320610,321488,878,5,N,N,-,-1,-1
MULIFE.txt,321489,322513,1024,5,N,N,-,-1,-1
MULIFE.txt,322514,323194,680,5,N,N,-,-1,-1
MULIFE.txt,323195,323844,649,5,N,N,-,-1,-1
MULIFE.txt,323846,324362,516,5,N,N,-,-1,-1
MULIFE.txt,324364,325035,671,5,N,N,-,-1,-1
MULIFE.txt,325036,325843,807,5,N,N,-,-1,-1
MULIFE.txt,325844,326169,325,5,N,N,-,-1,-1
MULIFE.txt,326172,327259,1087,5,N,N,-,-1,-1
MULIFE.txt,327265,327624,359,5,N,N,-,-1,-1
MULIFE.txt,327627,328373,746,5,N,N,-,-1,-1
MULIFE.txt,328376,329166,790,5,N,N,-,-1,-1
MULIFE.txt,329168,329462,294,5,N,N,-,-1,-1
MULIFE.txt,329463,330341,878,5,N,N,-,-1,-1
MULIFE.txt,330342,330870,528,5,N,N,-,-1,-1
MULIFE.txt,330873,331814,941,5,N,N,-,-1,-1
MULIFE.txt,331815,332191,376,5,N,N,-,-1,-1
MULIFE.txt,332194,332731,537,5,N,N,-,-1,-1
MULIFE.txt,332736,333323,587,5,N,N,-,-1,-1
MULIFE.txt,333324,333708,384,5,N,N,-,-1,-1
MULIFE.txt,333709,334222,513,5,N,N,-,-1,-1
MULIFE.txt,334223,334744,521,5,N,N,-,-1,-1
MULIFE.txt,334749,334949,200,5,N,N,-,-1,-1
MULIFE.txt,334952,335647,695,5,N,N,-,-1,-1
MULIFE.txt,335648,336270,622,5,N,N,-,-1,-1
MULIFE.txt,336273,336737,464,5,N,N,-,-1,-1
MULIFE.txt,336739,337372,633,5,N,N,-,-1,-1
MULIFE.txt,337374,338235,861,5,N,N,-,-1,-1
MULIFE.txt,338236,339193,957,5,N,N,-,-1,-1
MULIFE.txt,339198,339842,644,5,N,N,-,-1,-1
MULIFE.txt,339843,340415,572,5,N,N,-,-1,-1
MULIFE.txt,340416,340795,379,5,N,N,-,-1,-1
MULIFE.txt,340797,341656,859,5,N,N,-,-1,-1
MULIFE.txt,341659,342424,765,5,N,N,-,-1,-1
MULIFE.txt,342427,343076,649,5,N,N,-,-1,-1
MULIFE.txt,343077,343629,552,5,N,N,-,-1,-1
MULIFE.txt,343630,344237,607,5,N,N,-,-1,-1
MULIFE.txt,344240,344813,573,5,N,N,-,-1,-1
MULIFE.txt,344814,345433,619,5,N,N,-,-1,-1
MULIFE.txt,345434,346196,762,5,N,N,-,-1,-1
MULIFE.txt,346197,346845,648,5,N,N,-,-1,-1
MULIFE.txt,346848,347069,221,5,N,N,-,-1,-1
MULIFE.txt,347072,347400,328,5,N,N,-,-1,-1
MULIFE.txt,347402,347986,584,5,N,N,-,-1,-1
MULIFE.txt,347989,349199,1210,5,N,N,-,-1,-1
MULIFE.txt,349200,349905,705,5,N,N,-,-1,-1
MULIFE.txt,349906,350643,737,5,N,N,-,-1,-1
MULIFE.txt,350644,351337,693,5,N,N,-,-1,-1
MULIFE.txt,351338,351981,643,5,N,N,-,-1,-1
MULIFE.txt,351982,352520,538,5,N,N,-,-1,-1
MULIFE.txt,352522,353020,498,5,N,N,-,-1,-1
MULIFE.txt,353023,353784,761,5,N,N,-,-1,-1
MULIFE.txt,353785,354250,465,5,N,N,-,-1,-1
MULIFE.txt,354253,354990,737,5,N,N,-,-1,-1
MULIFE.txt,354991,355448,457,5,N,N,-,-1,-1
MULIFE.txt,355451,356023,572,5,N,N,-,-1,-1
MULIFE.txt,356026,356472,446,5,N,N,-,-1,-1
MULIFE.txt,356475,357346,871,5,N,N,-,-1,-1
MULIFE.txt,357349,358553,1204,5,Y,N,-,-1,-1
MULIFE.txt,358554,359638,1084,5,N,N,-,-1,-1
MULIFE.txt,359639,360145,506,5,N,N,-,-1,-1
MULIFE.txt,360148,361057,909,5,N,N,-,-1,-1
MULIFE.txt,361060,361683,623,5,N,N,-,-1,-1
MULIFE.txt,361684,362150,466,5,N,N,-,-1,-1
MULIFE.txt,362153,362972,819,5,N,N,-,-1,-1
MULIFE.txt,362973,363616,643,5,N,N,-,-1,-1
MULIFE.txt,363619,364244,625,5,N,N,-,-1,-1
MULIFE.txt,364245,364606,361,5,N,N,-,-1,-1
MULIFE.txt,364607,365339,732,5,N,N,-,-1,-1
MULIFE.txt,365340,366113,773,5,N,N,-,-1,-1
MULIFE.txt,366116,366708,592,5,N,N,-,-1,-1
MULIFE.txt,366709,367593,884,5,N,N,-,-1,-1
MULIFE.txt,367594,367982,388,5,N,N,-,-1,-1
MULIFE.txt,367985,368677,692,5,N,N,-,-1,-1
MULIFE.txt,368678,369170,492,5,N,N,-,-1,-1
MULIFE.txt,369173,369415,242,5,N,N,-,-1,-1
MULIFE.txt,369416,369881,465,5,N,N,-,-1,-1
MULIFE.txt,369884,370358,474,5,N,N,-,-1,-1
MULIFE.txt,370359,371515,1156,5,Y,N,-,-1,-1
MULIFE.txt,371518,372455,937,5,N,N,-,-1,-1
MULIFE.txt,372456,373151,695,5,N,N,-,-1,-1
MULIFE.txt,373152,374081,929,5,N,N,-,-1,-1
MULIFE.txt,374084,374883,799,5,N,N,-,-1,-1
MULIFE.txt,374884,375522,638,5,N,N,-,-1,-1
MULIFE.txt,375525,376441,916,5,N,N,-,-1,-1
MULIFE.txt,376442,377008,566,5,N,N,-,-1,-1
MULIFE.txt,377011,378010,999,5,N,N,-,-1,-1
MULIFE.txt,378013,378821,808,5,N,N,-,-1,-1
MULIFE.txt,378822,379320,498,5,N,N,-,-1,-1
MULIFE.txt,379321,379748,427,5,N,N,-,-1,-1
MULIFE.txt,379749,380525,776,5,N,N,-,-1,-1
MULIFE.txt,380527,380886,359,5,N,N,-,-1,-1
MULIFE.txt,380889,381442,553,5,N,N,-,-1,-1
MULIFE.txt,381445,381989,544,5,N,N,-,-1,-1
MULIFE.txt,381990,382780,790,5,N,N,-,-1,-1
MULIFE.txt,382781,383512,731,5,N,N,-,-1,-1
MULIFE.txt,383513,384054,541,5,N,N,-,-1,-1
MULIFE.txt,384055,384908,853,5,N,N,-,-1,-1
MULIFE.txt,384909,385282,373,5,N,N,-,-1,-1
MULIFE.txt,385284,385918,634,5,N,N,-,-1,-1
MULIFE.txt,385920,386484,564,5,N,N,-,-1,-1
MULIFE.txt,386485,386946,461,5,N,N,-,-1,-1
MULIFE.txt,386947,387476,529,5,N,N,-,-1,-1
MULIFE.txt,387479,388068,589,5,N,N,-,-1,-1
MULIFE.txt,388071,388672,601,5,N,N,-,-1,-1
MULIFE.txt,388673,389342,669,5,N,N,-,-1,-1
MULIFE.txt,389344,389737,393,5,N,N,-,-1,-1
MULIFE.txt,389738,390438,700,5,N,N,-,-1,-1
MULIFE.txt,390441,390792,351,5,N,N,-,-1,-1
MULIFE.txt,390793,392233,1440,5,N,N,-,-1,-1
MULIFE.txt,392236,392788,552,5,N,N,-,-1,-1
MULIFE.txt,392789,393155,366,5,N,N,-,-1,-1
MULIFE.txt,393156,393479,323,5,N,N,-,-1,-1
MULIFE.txt,393482,394161,679,5,N,N,-,-1,-1
MULIFE.txt,394162,394573,411,5,N,N,-,-1,-1
MULIFE.txt,394576,394716,140,5,N,N,-,-1,-1
MULIFE.txt,394719,394873,154,5,N,N,-,-1,-1
MULIFE.txt,394876,395048,172,5,N,N,-,-1,-1
MULIFE.txt,395049,395153,104,5,N,N,-,-1,-1
MULIFE.txt,395156,395272,116,5,N,N,-,-1,-1
MULIFE.txt,395275,395363,88,5,N,N,-,-1,-1
MULIFE.txt,395364,395496,132,5,N,N,-,-1,-1
MULIFE.txt,395499,395620,121,5,N,N,-,-1,-1
MULIFE.txt,395623,396490,867,5,N,N,-,-1,-1
MULIFE.txt,396491,396880,389,5,N,N,-,-1,-1
MULIFE.txt,396883,397922,1039,5,N,N,-,-1,-1
MULIFE.txt,397923,398984,1061,5,N,N,-,-1,-1
MULIFE.txt,398987,399845,858,5,N,N,-,-1,-1
MULIFE.txt,399848,400215,367,5,N,N,-,-1,-1
MULIFE.txt,400217,400891,674,5,N,N,-,-1,-1
MULIFE.txt,400892,401734,842,5,N,N,-,-1,-1
MULIFE.txt,401735,402829,1094,5,N,N,-,-1,-1
MULIFE.txt,402830,403648,818,5,N,N,-,-1,-1
MULIFE.txt,403651,404629,978,5,N,N,-,-1,-1
MULIFE.txt,404631,405217,586,5,N,N,-,-1,-1
MULIFE.txt,405218,405570,352,5,N,N,-,-1,-1
MULIFE.txt,405571,406715,1144,5,Y,N,-,-1,-1
MULIFE.txt,406716,407052,336,5,N,N,-,-1,-1
MULIFE.txt,407055,407670,615,5,N,N,-,-1,-1
MULIFE.txt,407671,408706,1035,5,Y,N,-,-1,-1
MULIFE.txt,408707,409246,539,5,N,N,-,-1,-1
MULIFE.txt,409247,410210,963,5,N,N,-,-1,-1
MULIFE.txt,410211,410723,512,5,N,N,-,-1,-1
MULIFE.txt,410724,411868,1144,5,N,N,-,-1,-1
MULIFE.txt,411869,412564,695,5,N,N,-,-1,-1
MULIFE.txt,412565,413886,1321,5,N,N,-,-1,-1
MULIFE.txt,413888,414758,870,5,N,N,-,-1,-1
MULIFE.txt,414759,415156,397,5,N,N,-,-1,-1
MULIFE.txt,415158,415738,580,5,N,N,-,-1,-1
MULIFE.txt,415739,416427,688,5,N,N,-,-1,-1
MULIFE.txt,416430,417195,765,5,N,N,-,-1,-1
MULIFE.txt,417197,417738,541,5,N,N,-,-1,-1
MULIFE.txt,417740,418208,468,5,N,N,-,-1,-1
MULIFE.txt,418210,418726,516,5,N,N,-,-1,-1
MULIFE.txt,418728,419734,1006,5,N,N,-,-1,-1
MULIFE.txt,419735,420530,795,5,N,N,-,-1,-1
MULIFE.txt,420531,421557,1026,5,N,N,-,-1,-1
MULIFE.txt,421558,422685,1127,5,N,N,-,-1,-1
MULIFE.txt,422688,424028,1340,5,N,N,-,-1,-1
MULIFE.txt,424029,425315,1286,5,N,N,-,-1,-1
MULIFE.txt,425316,425839,523,5,N,N,-,-1,-1
MULIFE.txt,425842,426509,667,5,N,N,-,-1,-1
MULIFE.txt,426510,427438,928,5,N,N,-,-1,-1
MULIFE.txt,427439,428788,1349,5,N,N,-,-1,-1
MULIFE.txt,428789,429465,676,5,N,N,-,-1,-1
MULIFE.txt,429466,429819,353,5,N,N,-,-1,-1
MULIFE.txt,429820,430642,822,5,N,N,-,-1,-1
MULIFE.txt,430643,431158,515,5,N,N,-,-1,-1
MULIFE.txt,431159,431997,838,5,N,N,-,-1,-1
MULIFE.txt,432000,432532,532,5,N,N,-,-1,-1
MULIFE.txt,432534,433162,628,5,N,N,-,-1,-1
MULIFE.txt,433164,433363,199,5,N,N,-,-1,-1
MULIFE.txt,433364,433992,628,5,N,N,-,-1,-1
MULIFE.txt,433993,434478,485,5,N,N,-,-1,-1
MULIFE.txt,434479,435097,618,5,N,N,-,-1,-1
MULIFE.txt,435100,435745,645,5,N,N,-,-1,-1
MULIFE.txt,435746,436566,820,5,N,N,-,-1,-1
MULIFE.txt,436567,437380,813,5,N,N,-,-1,-1
MULIFE.txt,437383,437981,598,5,N,N,-,-1,-1
MULIFE.txt,437982,438630,648,5,N,N,-,-1,-1
MULIFE.txt,438631,439464,833,5,N,N,-,-1,-1
MULIFE.txt,439467,439681,214,5,N,N,-,-1,-1
MULIFE.txt,439682,440310,628,5,N,N,-,-1,-1
MULIFE.txt,440311,441053,742,5,N,N,-,-1,-1
MULIFE.txt,441054,441597,543,5,N,N,-,-1,-1
MULIFE.txt,441600,442213,613,5,N,N,-,-1,-1
MULIFE.txt,442213,442740,527,5,N,N,-,-1,-1
MULIFE.txt,442741,443415,674,5,N,N,-,-1,-1
MULIFE.txt,443417,443762,345,5,N,N,-,-1,-1
MULIFE.txt,443763,444258,495,5,N,N,-,-1,-1
MULIFE.txt,444259,445083,824,5,N,N,-,-1,-1
MULIFE.txt,445084,445580,496,5,N,N,-,-1,-1
MULIFE.txt,445581,446114,533,5,N,N,-,-1,-1
MULIFE.txt,446115,446692,577,5,N,N,-,-1,-1
MULIFE.txt,446694,447249,555,5,N,N,-,-1,-1
MULIFE.txt,447252,448045,793,5,N,N,-,-1,-1
MULIFE.txt,448046,448681,635,5,N,N,-,-1,-1
MULIFE.txt,448682,449383,701,5,N,N,-,-1,-1
MULIFE.txt,449384,449738,354,5,N,N,-,-1,-1
MULIFE.txt,449739,450343,604,5,N,N,-,-1,-1
MULIFE.txt,450346,450984,638,5,N,N,-,-1,-1
MULIFE.txt,450985,451543,558,5,N,N,-,-1,-1
MULIFE.txt,451544,452389,845,5,N,N,-,-1,-1
MULIFE.txt,452392,452741,349,5,N,N,-,-1,-1
MULIFE.txt,452742,453685,943,5,N,N,-,-1,-1
MULIFE.txt,453686,454308,622,5,N,N,-,-1,-1
MULIFE.txt,454309,455030,721,5,N,N,-,-1,-1
MULIFE.txt,455031,456463,1432,5,N,N,-,-1,-1
MULIFE.txt,456466,457058,592,5,N,N,-,-1,-1
MULIFE.txt,457059,457727,668,5,N,N,-,-1,-1
MULIFE.txt,457728,458131,403,5,N,N,-,-1,-1
MULIFE.txt,458132,458802,670,5,N,N,-,-1,-1
MULIFE.txt,458803,459865,1062,5,N,N,-,-1,-1
MULIFE.txt,459866,460247,381,5,N,N,-,-1,-1
MULIFE.txt,460250,461125,875,5,N,N,-,-1,-1
MULIFE.txt,461126,461893,767,5,N,N,-,-1,-1
MULIFE.txt,461894,462348,454,5,N,N,-,-1,-1
MULIFE.txt,462349,463250,901,5,N,N,-,-1,-1
MULIFE.txt,463251,464155,904,5,N,N,-,-1,-1
MULIFE.txt,464156,464465,309,5,N,N,-,-1,-1
MULIFE.txt,464466,465595,1129,5,N,N,-,-1,-1
MULIFE.txt,465598,465936,338,5,N,N,-,-1,-1
MULIFE.txt,465937,466233,296,5,N,N,-,-1,-1
MULIFE.txt,466234,466688,454,5,N,N,-,-1,-1
MULIFE.txt,466689,467207,518,5,N,N,-,-1,-1
MULIFE.txt,467208,467450,242,5,N,N,-,-1,-1
MULIFE.txt,467451,468160,709,5,N,N,-,-1,-1
MULIFE.txt,468161,468784,623,5,N,N,-,-1,-1
MULIFE.txt,468785,469566,781,5,N,N,-,-1,-1
MULIFE.txt,469567,470006,439,5,N,N,-,-1,-1
MULIFE.txt,470009,470894,885,5,N,N,-,-1,-1
MULIFE.txt,470899,471098,199,5,N,N,-,-1,-1
MULIFE.txt,471099,471597,498,5,N,N,-,-1,-1
MULIFE.txt,471598,472066,468,5,N,N,-,-1,-1
MULIFE.txt,472067,472427,360,5,N,N,-,-1,-1
MULIFE.txt,472428,472985,557,5,N,N,-,-1,-1
MULIFE.txt,472986,474053,1067,5,N,N,-,-1,-1
MULIFE.txt,474054,475331,1277,5,N,N,-,-1,-1
MULIFE.txt,475334,475649,315,5,N,N,-,-1,-1
MULIFE.txt,475651,475961,310,5,N,N,-,-1,-1
MULIFE.txt,475962,476635,673,5,N,N,-,-1,-1
MULIFE.txt,476636,476962,326,5,N,N,-,-1,-1
MULIFE.txt,476963,477345,382,5,N,N,-,-1,-1
MULIFE.txt,477348,477563,215,5,N,N,-,-1,-1
MULIFE.txt,477566,477759,193,5,N,N,-,-1,-1
MULIFE.txt,477760,478107,347,5,N,N,-,-1,-1
MULIFE.txt,478108,478630,522,5,N,N,-,-1,-1
MULIFE.txt,478633,479228,595,5,N,N,-,-1,-1
MULIFE.txt,479229,479454,225,5,N,N,-,-1,-1
MULIFE.txt,479455,479889,434,5,N,N,-,-1,-1
MULIFE.txt,479890,480443,553,5,N,N,-,-1,-1
MULIFE.txt,480446,480956,510,5,N,N,-,-1,-1
MULIFE.txt,480957,481220,263,5,N,N,-,-1,-1
MULIFE.txt,481221,481531,310,5,N,N,-,-1,-1
MULIFE.txt,481532,482197,665,5,N,N,-,-1,-1
MULIFE.txt,482198,482454,256,5,N,N,-,-1,-1
MULIFE.txt,482457,482807,350,5,N,N,-,-1,-1
MULIFE.txt,482808,483429,621,5,N,N,-,-1,-1
MULIFE.txt,483432,484008,576,5,N,N,-,-1,-1
MULIFE.txt,484009,484511,502,5,N,N,-,-1,-1
MULIFE.txt,484512,484975,463,5,N,N,-,-1,-1
MULIFE.txt,484976,485632,656,5,N,N,-,-1,-1
MULIFE.txt,485633,487120,1487,5,N,N,-,-1,-1
MULIFE.txt,487121,488024,903,5,N,N,-,-1,-1
MULIFE.txt,488027,488533,506,5,N,N,-,-1,-1
MULIFE.txt,488536,488760,224,5,N,N,-,-1,-1
MULIFE.txt,488761,488885,124,5,N,N,-,-1,-1
MULIFE.txt,488886,489152,266,5,N,N,-,-1,-1
MULIFE.txt,489155,489404,249,5,N,N,-,-1,-1
MULIFE.txt,489407,489831,424,5,N,N,-,-1,-1
MULIFE.txt,489834,490404,570,5,N,N,-,-1,-1
MULIFE.txt,490407,490584,177,5,N,N,-,-1,-1
MULIFE.txt,490585,491513,928,5,N,N,-,-1,-1
MULIFE.txt,491516,492181,665,5,N,Y,1437819193404,491891,492364
MULIFE.txt,492182,492786,604,5,N,Y,1437819193404,491891,492364
MULIFE.txt,492787,493246,459,5,N,N,-,-1,-1
MULIFE.txt,493249,493697,448,5,Y,N,-,-1,-1
MULIFE.txt,493698,494229,531,5,N,Y,1437819940135,493797,494222
MULIFE.txt,494231,494537,306,5,N,N,-,-1,-1
MULIFE.txt,494538,494702,164,5,N,N,-,-1,-1
MULIFE.txt,494703,494948,245,5,N,N,-,-1,-1
MULIFE.txt,494949,495452,503,5,N,N,-,-1,-1
MULIFE.txt,495453,496002,549,5,N,N,-,-1,-1
MULIFE.txt,496003,496706,703,5,Y,N,-,-1,-1
MULIFE.txt,496707,497214,507,5,N,N,-,-1,-1
MULIFE.txt,497215,497602,387,5,N,N,-,-1,-1
MULIFE.txt,497603,498056,453,5,N,N,-,-1,-1
MULIFE.txt,498057,498620,563,5,N,N,-,-1,-1
MULIFE.txt,498621,499136,515,5,N,N,-,-1,-1
MULIFE.txt,499139,499671,532,5,N,N,-,-1,-1
MULIFE.txt,499672,500090,418,5,N,N,-,-1,-1
MULIFE.txt,500091,500190,99,5,N,N,-,-1,-1
MULIFE.txt,500191,500875,684,5,N,N,-,-1,-1
MULIFE.txt,500878,501396,518,5,N,N,-,-1,-1
MULIFE.txt,501397,502043,646,5,N,N,-,-1,-1
MULIFE.txt,502046,503333,1287,5,N,N,-,-1,-1
MULIFE.txt,503334,504066,732,5,N,N,-,-1,-1
MULIFE.txt,504068,504443,375,5,N,N,-,-1,-1
MULIFE.txt,504446,506033,1587,5,N,N,-,-1,-1
MULIFE.txt,506034,506674,640,5,N,N,-,-1,-1
MULIFE.txt,506676,507549,873,5,N,N,-,-1,-1
MULIFE.txt,507550,508596,1046,5,N,N,-,-1,-1
MULIFE.txt,508597,509155,558,5,N,N,-,-1,-1
MULIFE.txt,509156,510008,852,5,N,N,-,-1,-1
MULIFE.txt,510011,510428,417,5,N,Y,1437821785598,510009,510542
MULIFE.txt,510429,510883,454,5,N,Y,1437821785598,510009,510542
MULIFE.txt,510884,511540,656,5,N,N,-,-1,-1
MULIFE.txt,511541,511995,454,5,N,Y,1437822193958,511750,512403
MULIFE.txt,511997,512869,872,5,N,Y,1437822193958,511750,512403
MULIFE.txt,512870,513280,410,5,N,N,-,-1,-1
MULIFE.txt,513281,513778,497,5,N,N,-,-1,-1
MULIFE.txt,513779,514559,780,5,N,N,-,-1,-1
MULIFE.txt,514562,515087,525,5,N,N,-,-1,-1
MULIFE.txt,515088,515859,771,5,N,N,-,-1,-1
MULIFE.txt,515860,516908,1048,5,N,N,-,-1,-1
MULIFE.txt,516909,517940,1031,5,N,Y,1437822538234,517368,517636
MULIFE.txt,517943,518854,911,5,N,N,-,-1,-1
MULIFE.txt,518856,520121,1265,5,N,N,-,-1,-1
MULIFE.txt,520122,520876,754,5,N,Y,1437823120662,520125,520842
MULIFE.txt,520879,521252,373,5,N,Y,1437823433827,520914,521651
MULIFE.txt,521253,521726,473,5,N,Y,1437823433827,520914,521651
MULIFE.txt,521728,522305,577,5,N,Y,1437823700026,522255,523121
MULIFE.txt,522306,523137,831,5,N,Y,1437823700026,522255,523121
MULIFE.txt,523140,524218,1078,5,N,N,-,-1,-1
MULIFE.txt,524219,525033,814,5,N,N,-,-1,-1
MULIFE.txt,525034,525706,672,5,N,N,-,-1,-1
MULIFE.txt,525708,526719,1011,5,N,N,-,-1,-1
MULIFE.txt,526720,527349,629,5,N,N,-,-1,-1
MULIFE.txt,527352,527982,630,5,N,N,-,-1,-1
MULIFE.txt,527983,528318,335,5,N,N,-,-1,-1
MULIFE.txt,528319,529180,861,5,N,N,-,-1,-1
MULIFE.txt,529181,529889,708,5,N,N,-,-1,-1
MULIFE.txt,529890,530603,713,5,N,N,-,-1,-1
MULIFE.txt,530604,531717,1113,5,N,Y,1437842085814,530652,531925
MULIFE.txt,531718,532382,664,5,N,Y,1437842085814,530652,531925
MULIFE.txt,532383,532982,599,5,N,N,-,-1,-1
MULIFE.txt,532984,533516,532,5,N,N,-,-1,-1
MULIFE.txt,533521,533991,470,5,N,N,-,-1,-1
MULIFE.txt,533992,534737,745,5,N,N,-,-1,-1
MULIFE.txt,534738,535433,695,5,N,N,-,-1,-1
MULIFE.txt,535434,536005,571,5,N,N,-,-1,-1
MULIFE.txt,536006,536720,714,5,N,N,-,-1,-1
MULIFE.txt,536721,537097,376,5,N,N,-,-1,-1
MULIFE.txt,537098,537685,587,5,N,N,-,-1,-1
MULIFE.txt,537686,538462,776,5,N,N,-,-1,-1
MULIFE.txt,538463,539004,541,5,N,N,-,-1,-1
MULIFE.txt,539005,539678,673,5,N,N,-,-1,-1
MULIFE.txt,539681,540701,1020,5,N,N,-,-1,-1
MULIFE.txt,540704,541312,608,5,N,N,-,-1,-1
MULIFE.txt,541313,541813,500,5,N,N,-,-1,-1
MULIFE.txt,541814,543081,1267,5,N,N,-,-1,-1
MULIFE.txt,543084,543791,707,5,N,N,-,-1,-1
MULIFE.txt,543794,544276,482,5,N,N,-,-1,-1
MULIFE.txt,544277,544999,722,5,N,N,-,-1,-1
MULIFE.txt,545002,545637,635,5,N,Y,1437842663182,545558,546298
MULIFE.txt,545638,546068,430,5,N,Y,1437842663182,545558,546298
MULIFE.txt,546070,546883,813,5,N,Y,1437842663182,545558,546298
MULIFE.txt,546886,547318,432,5,N,N,-,-1,-1
MULIFE.txt,547319,547612,293,5,N,N,-,-1,-1
MULIFE.txt,547615,548235,620,5,N,N,-,-1,-1
MULIFE.txt,548236,548560,324,5,N,N,-,-1,-1
MULIFE.txt,548563,549013,450,5,N,N,-,-1,-1
MULIFE.txt,549014,549563,549,5,N,Y,1437842936274,549355,550003
MULIFE.txt,549564,550126,562,5,N,Y,1437842936274,549355,550003
MULIFE.txt,550127,550396,269,5,N,N,-,-1,-1
MULIFE.txt,550397,551354,957,5,N,N,-,-1,-1
MULIFE.txt,551355,552040,685,5,N,N,-,-1,-1
MULIFE.txt,552041,552524,483,5,N,N,-,-1,-1
MULIFE.txt,552525,553200,675,5,N,Y,1437843377951,552763,553884
MULIFE.txt,553201,553607,406,5,N,Y,1437843377951,552763,553884
MULIFE.txt,553608,554310,702,5,N,Y,1437843377951,552763,553884
MULIFE.txt,554311,555249,938,5,N,N,-,-1,-1
MULIFE.txt,555250,556362,1112,5,N,N,-,-1,-1
MULIFE.txt,556363,556861,498,5,N,N,-,-1,-1
MULIFE.txt,556862,557649,787,5,N,N,-,-1,-1
MULIFE.txt,557650,558563,913,5,N,N,-,-1,-1
MULIFE.txt,558566,559148,582,5,N,N,-,-1,-1
MULIFE.txt,559150,559654,504,5,N,N,-,-1,-1
MULIFE.txt,559656,560633,977,5,N,N,-,-1,-1
MULIFE.txt,560635,561093,458,5,N,N,-,-1,-1
MULIFE.txt,561096,561511,415,5,N,N,-,-1,-1
MULIFE.txt,561512,562252,740,5,N,N,-,-1,-1
MULIFE.txt,562255,562916,661,5,N,N,-,-1,-1
MULIFE.txt,562917,563752,835,5,N,N,-,-1,-1
MULIFE.txt,563753,564110,357,5,N,N,-,-1,-1
MULIFE.txt,564113,565038,925,5,N,Y,1437843751491,564174,565427
MULIFE.txt,565039,565771,732,5,N,Y,1437843751491,564174,565427
MULIFE.txt,565772,566860,1088,5,N,N,-,-1,-1
MULIFE.txt,566861,567529,668,5,N,Y,1437844476348,567281,568945
MULIFE.txt,567530,568503,973,5,N,Y,1437844476348,567281,568945
MULIFE.txt,568504,569373,869,5,N,Y,1437844476348,567281,568945
MULIFE.txt,569374,570187,813,5,N,N,-,-1,-1
MULIFE.txt,570190,571347,1157,5,N,N,-,-1,-1
MULIFE.txt,571348,572096,748,5,N,N,-,-1,-1
MULIFE.txt,572099,572482,383,5,N,N,-,-1,-1
MULIFE.txt,572485,572940,455,5,N,N,-,-1,-1
MULIFE.txt,572941,573454,513,5,N,N,-,-1,-1
MULIFE.txt,573455,574125,670,5,N,N,-,-1,-1
MULIFE.txt,574126,574669,543,5,N,N,-,-1,-1
MULIFE.txt,574670,575045,375,5,N,N,-,-1,-1
MULIFE.txt,575046,576253,1207,5,N,N,-,-1,-1
MULIFE.txt,576256,576711,455,5,N,N,-,-1,-1
MULIFE.txt,576714,577347,633,5,N,N,-,-1,-1
MULIFE.txt,577352,577621,269,5,N,N,-,-1,-1
MULIFE.txt,577623,578430,807,5,N,N,-,-1,-1
MULIFE.txt,578433,579074,641,5,N,N,-,-1,-1
MULIFE.txt,579079,579371,292,5,N,N,-,-1,-1
MULIFE.txt,579372,579431,59,5,N,N,-,-1,-1
MULIFE.txt,579432,579915,483,5,N,N,-,-1,-1
MULIFE.txt,579916,580384,468,5,N,N,-,-1,-1
MULIFE.txt,580385,581700,1315,5,N,N,-,-1,-1
MULIFE.txt,581701,582386,685,5,N,Y,1437845266061,581723,582485
MULIFE.txt,582387,583003,616,5,N,Y,1437845266061,581723,582485
MULIFE.txt,583004,583394,390,5,N,N,-,-1,-1
MULIFE.txt,583396,584211,815,5,N,N,-,-1,-1
MULIFE.txt,584211,584734,523,5,N,N,-,-1,-1
MULIFE.txt,584735,585460,725,5,N,N,-,-1,-1
MULIFE.txt,585462,586202,740,5,N,N,-,-1,-1
MULIFE.txt,586205,586959,754,5,N,N,-,-1,-1
MULIFE.txt,586960,587661,701,5,N,N,-,-1,-1
MULIFE.txt,587662,588092,430,5,N,N,-,-1,-1
MULIFE.txt,588093,588753,660,5,N,N,-,-1,-1
MULIFE.txt,588754,589196,442,5,N,N,-,-1,-1
MULIFE.txt,589199,590082,883,5,N,N,-,-1,-1
MULIFE.txt,590085,590731,646,5,N,N,-,-1,-1
MULIFE.txt,590733,591423,690,5,N,N,-,-1,-1
MULIFE.txt,591424,592433,1009,5,N,N,-,-1,-1
MULIFE.txt,592434,593149,715,5,N,N,-,-1,-1
MULIFE.txt,593150,593846,696,5,N,N,-,-1,-1
MULIFE.txt,593847,594603,756,5,N,N,-,-1,-1
MULIFE.txt,594604,595953,1349,5,N,N,-,-1,-1
MULIFE.txt,595956,596549,593,5,N,N,-,-1,-1
MULIFE.txt,596550,597376,826,5,N,N,-,-1,-1
MULIFE.txt,597378,598364,986,5,N,N,-,-1,-1
MULIFE.txt,598365,599198,833,5,N,N,-,-1,-1
MULIFE.txt,599201,599809,608,5,N,N,-,-1,-1
MULIFE.txt,599810,600290,480,5,N,N,-,-1,-1
MULIFE.txt,600291,600996,705,5,N,N,-,-1,-1
MULIFE.txt,600997,601533,536,5,N,N,-,-1,-1
MULIFE.txt,601534,602583,1049,5,N,N,-,-1,-1
MULIFE.txt,602583,603388,805,5,N,N,-,-1,-1
MULIFE.txt,603389,604161,772,5,N,N,-,-1,-1
MULIFE.txt,604162,604449,287,5,N,N,-,-1,-1
MULIFE.txt,604450,605149,699,5,N,N,-,-1,-1
MULIFE.txt,605152,605772,620,5,N,N,-,-1,-1
MULIFE.txt,605775,606828,1053,5,Y,N,-,-1,-1
MULIFE.txt,606831,607228,397,5,N,N,-,-1,-1
MULIFE.txt,607229,608504,1275,5,N,N,-,-1,-1
MULIFE.txt,608507,609130,623,5,N,N,-,-1,-1
MULIFE.txt,609131,609915,784,5,N,N,-,-1,-1
MULIFE.txt,609918,611350,1432,5,N,N,-,-1,-1
MULIFE.txt,611351,612078,727,5,N,N,-,-1,-1
MULIFE.txt,612079,612991,912,5,N,N,-,-1,-1
MULIFE.txt,612992,613594,602,5,N,N,-,-1,-1
MULIFE.txt,613595,614488,893,5,N,N,-,-1,-1
MULIFE.txt,614491,615190,699,5,N,N,-,-1,-1
MULIFE.txt,615191,616490,1299,5,N,N,-,-1,-1
MULIFE.txt,616491,617308,817,5,N,N,-,-1,-1
MULIFE.txt,617309,617785,476,5,N,N,-,-1,-1
MULIFE.txt,617786,618985,1199,5,N,N,-,-1,-1
MULIFE.txt,618988,619928,940,5,N,N,-,-1,-1
MULIFE.txt,619929,620681,752,5,N,Y,1437986157098,620366,620948
MULIFE.txt,620682,621087,405,5,N,Y,1437986157098,620366,620948
MULIFE.txt,621088,621890,802,5,N,N,-,-1,-1
MULIFE.txt,621891,622550,659,5,N,N,-,-1,-1
MULIFE.txt,622551,623488,937,5,N,N,-,-1,-1
MULIFE.txt,623489,624121,632,5,N,N,-,-1,-1
MULIFE.txt,624122,625240,1118,5,N,N,-,-1,-1
MULIFE.txt,625241,625944,703,5,N,N,-,-1,-1
MULIFE.txt,625947,626414,467,5,N,Y,1437986573396,626278,626853
MULIFE.txt,626415,626901,486,5,N,Y,1437986573396,626278,626853
MULIFE.txt,626902,627678,776,5,N,N,-,-1,-1
MULIFE.txt,627679,628447,768,5,N,N,-,-1,-1
MULIFE.txt,628450,629955,1505,5,N,N,-,-1,-1
MULIFE.txt,629956,630443,487,5,N,N,-,-1,-1
MULIFE.txt,630446,631082,636,5,N,N,-,-1,-1
MULIFE.txt,631083,632311,1228,5,N,N,-,-1,-1
MULIFE.txt,632312,632868,556,5,N,N,-,-1,-1
MULIFE.txt,632869,633582,713,5,N,Y,1437987243903,633307,634055
MULIFE.txt,633583,634126,543,5,N,Y,1437987243903,633307,634055
MULIFE.txt,634129,635162,1033,5,N,N,-,-1,-1
MULIFE.txt,635165,636115,950,5,N,Y,1437987949897,635438,636165
MULIFE.txt,636117,636904,787,5,N,Y,1437987949897,635438,636165
MULIFE.txt,636905,637598,693,5,N,N,-,-1,-1
MULIFE.txt,637599,638211,612,5,N,N,-,-1,-1
MULIFE.txt,638212,638861,649,5,N,N,-,-1,-1
MULIFE.txt,638862,639976,1114,5,N,N,-,-1,-1
MULIFE.txt,639979,640816,837,5,N,N,-,-1,-1
MULIFE.txt,640817,642047,1230,5,N,N,-,-1,-1
MULIFE.txt,642048,642587,539,5,N,N,-,-1,-1
MULIFE.txt,642588,642878,290,5,N,N,-,-1,-1
MULIFE.txt,642879,643385,506,5,N,N,-,-1,-1
MULIFE.txt,643387,644289,902,5,N,N,-,-1,-1
MULIFE.txt,644291,644862,571,5,N,N,-,-1,-1
MULIFE.txt,644863,645401,538,5,N,N,-,-1,-1
MULIFE.txt,645404,645914,510,5,N,N,-,-1,-1
MULIFE.txt,645916,646434,518,5,N,N,-,-1,-1
MULIFE.txt,646435,647094,659,5,N,N,-,-1,-1
MULIFE.txt,647096,647296,200,5,N,N,-,-1,-1
MULIFE.txt,647299,647579,280,5,N,N,-,-1,-1
MULIFE.txt,647579,647982,403,5,N,N,-,-1,-1
MULIFE.txt,647985,648659,674,5,N,N,-,-1,-1
MULIFE.txt,648662,649269,607,5,N,N,-,-1,-1
MULIFE.txt,649270,649899,629,5,N,N,-,-1,-1
MULIFE.txt,649900,650253,353,5,N,N,-,-1,-1
MULIFE.txt,650255,650802,547,5,N,N,-,-1,-1
MULIFE.txt,650805,651190,385,5,N,N,-,-1,-1
MULIFE.txt,651191,652026,835,5,N,N,-,-1,-1
MULIFE.txt,652027,652673,646,5,N,N,-,-1,-1
MULIFE.txt,652676,653301,625,5,N,N,-,-1,-1
MULIFE.txt,653304,654008,704,5,N,N,-,-1,-1
MULIFE.txt,654011,654742,731,5,N,N,-,-1,-1
MULIFE.txt,654743,655421,678,5,N,N,-,-1,-1
MULIFE.txt,655422,655976,554,5,N,N,-,-1,-1
MULIFE.txt,655979,656519,540,5,N,N,-,-1,-1
MULIFE.txt,656522,656897,375,5,N,N,-,-1,-1
MULIFE.txt,656898,657935,1037,5,N,N,-,-1,-1
MULIFE.txt,657936,658786,850,5,N,N,-,-1,-1
MULIFE.txt,658787,659203,416,5,N,N,-,-1,-1
MULIFE.txt,659204,659673,469,5,N,Y,1437988651932,659204,659887
MULIFE.txt,659675,660291,616,5,N,Y,1437988651932,659204,659887
MULIFE.txt,660292,661013,721,5,N,N,-,-1,-1
MULIFE.txt,661014,661531,517,5,N,N,-,-1,-1
MULIFE.txt,661532,662043,511,5,N,Y,1437989149214,661990,662272
MULIFE.txt,662045,662746,701,5,N,Y,1437989149214,661990,662272
MULIFE.txt,662747,663158,411,5,N,N,-,-1,-1
MULIFE.txt,663161,664027,866,5,N,N,-,-1,-1
MULIFE.txt,664028,664564,536,5,N,Y,1437989518903,664383,664855
MULIFE.txt,664565,665248,683,5,N,Y,1437989518903,664383,664855
MULIFE.txt,665249,665996,747,5,N,Y,1437989874676,664875,665551
MULIFE.txt,665999,666289,290,5,N,N,-,-1,-1
MULIFE.txt,666291,666677,386,5,N,N,-,-1,-1
MULIFE.txt,666678,666952,274,5,N,N,-,-1,-1
MULIFE.txt,666953,667419,466,5,N,N,-,-1,-1
MULIFE.txt,667421,667619,198,5,N,N,-,-1,-1
MULIFE.txt,667620,668135,515,5,N,N,-,-1,-1
MULIFE.txt,668136,668511,375,5,N,N,-,-1,-1
MULIFE.txt,668512,668921,409,5,N,N,-,-1,-1
MULIFE.txt,668926,669221,295,5,N,Y,1437990390319,668943,669389
MULIFE.txt,669222,669611,389,5,N,Y,1437990390319,668943,669389
MULIFE.txt,669612,670308,696,5,N,N,-,-1,-1
MULIFE.txt,670313,670518,205,5,N,N,-,-1,-1
MULIFE.txt,670521,670837,316,5,N,N,-,-1,-1
MULIFE.txt,670838,671408,570,5,N,N,-,-1,-1
MULIFE.txt,671411,671798,387,5,N,N,-,-1,-1
MULIFE.txt,671799,672243,444,5,N,N,-,-1,-1
MULIFE.txt,672244,672491,247,5,N,N,-,-1,-1
MULIFE.txt,672492,672742,250,5,N,N,-,-1,-1
MULIFE.txt,672743,673131,388,5,N,N,-,-1,-1
MULIFE.txt,673134,673644,510,5,N,N,-,-1,-1
MULIFE.txt,673645,674057,412,5,N,N,-,-1,-1
MULIFE.txt,674060,674638,578,5,N,N,-,-1,-1
MULIFE.txt,674641,674994,353,5,N,N,-,-1,-1
MULIFE.txt,674995,675393,398,5,N,N,-,-1,-1
MULIFE.txt,675394,675923,529,5,N,N,-,-1,-1
MULIFE.txt,675926,676201,275,5,N,N,-,-1,-1
MULIFE.txt,676202,676726,524,5,N,N,-,-1,-1
MULIFE.txt,676727,677196,469,5,N,N,-,-1,-1
MULIFE.txt,677199,677848,649,5,N,N,-,-1,-1
MULIFE.txt,677849,678432,583,5,N,N,-,-1,-1
MULIFE.txt,678435,678966,531,5,N,N,-,-1,-1
MULIFE.txt,678967,679571,604,5,N,N,-,-1,-1
MULIFE.txt,679574,680188,614,5,N,N,-,-1,-1
MULIFE.txt,680191,680798,607,5,N,N,-,-1,-1
MULIFE.txt,680799,681399,600,5,N,N,-,-1,-1
MULIFE.txt,681400,681857,457,5,N,N,-,-1,-1
MULIFE.txt,681858,682399,541,5,N,N,-,-1,-1
MULIFE.txt,682400,682606,206,5,N,N,-,-1,-1
MULIFE.txt,682607,682904,297,5,N,N,-,-1,-1
MULIFE.txt,682907,683289,382,5,N,N,-,-1,-1
MULIFE.txt,683292,684117,825,5,N,N,-,-1,-1
MULIFE.txt,684120,684342,222,5,N,N,-,-1,-1
MULIFE.txt,684343,684942,599,5,N,N,-,-1,-1
MULIFE.txt,684944,685568,624,5,N,N,-,-1,-1
MULIFE.txt,685571,685900,329,5,N,N,-,-1,-1
MULIFE.txt,685902,687334,1432,5,N,N,-,-1,-1
MULIFE.txt,687335,687819,484,5,N,N,-,-1,-1
MULIFE.txt,687822,688104,282,5,N,N,-,-1,-1
MULIFE.txt,688105,688848,743,5,N,N,-,-1,-1
MULIFE.txt,688849,689857,1008,5,N,N,-,-1,-1
MULIFE.txt,689858,690363,505,5,N,N,-,-1,-1
MULIFE.txt,690364,691004,640,5,N,N,-,-1,-1
MULIFE.txt,691007,691635,628,5,N,N,-,-1,-1
MULIFE.txt,691636,692594,958,5,N,N,-,-1,-1
MULIFE.txt,692597,693119,522,5,N,N,-,-1,-1
MULIFE.txt,693122,693435,313,5,N,Y,1437991397891,693219,694006
MULIFE.txt,693436,693570,134,5,N,Y,1437991397891,693219,694006
MULIFE.txt,693571,694058,487,5,N,Y,1437991397891,693219,694006
MULIFE.txt,694061,694415,354,5,N,N,-,-1,-1
MULIFE.txt,694416,695143,727,5,N,Y,1437991665521,694564,695190
MULIFE.txt,695144,695399,255,5,N,Y,1437991665521,694564,695190
MULIFE.txt,695400,695849,449,5,N,N,-,-1,-1
MULIFE.txt,695854,696153,299,5,N,N,-,-1,-1
MULIFE.txt,696154,696815,661,5,N,N,-,-1,-1
MULIFE.txt,696816,697549,733,5,N,N,-,-1,-1
MULIFE.txt,697550,698218,668,5,N,N,-,-1,-1
MULIFE.txt,698219,698823,604,5,N,N,-,-1,-1
MULIFE.txt,698824,699558,734,5,N,N,-,-1,-1
MULIFE.txt,699561,700415,854,5,N,N,-,-1,-1
MULIFE.txt,700416,700848,432,5,N,N,-,-1,-1
MULIFE.txt,700849,701117,268,5,N,N,-,-1,-1
MULIFE.txt,701118,701285,167,5,N,N,-,-1,-1
MULIFE.txt,701286,701738,452,5,N,N,-,-1,-1
MULIFE.txt,701743,702082,339,5,N,Y,1437991986836,701932,703111
MULIFE.txt,702083,702425,342,5,N,Y,1437991986836,701932,703111
MULIFE.txt,702426,703040,614,5,N,Y,1437991986836,701932,703111
MULIFE.txt,703041,703555,514,5,N,Y,1437991986836,701932,703111
MULIFE.txt,703558,704209,651,5,N,N,-,-1,-1
MULIFE.txt,704211,704904,693,5,N,N,-,-1,-1
MULIFE.txt,704907,705596,689,5,N,N,-,-1,-1
MULIFE.txt,705601,706019,418,5,N,N,-,-1,-1
MULIFE.txt,706020,706782,762,5,N,N,-,-1,-1
MULIFE.txt,706783,707181,398,5,N,N,-,-1,-1
MULIFE.txt,707182,707936,754,5,N,Y,1437992265363,707653,708287
MULIFE.txt,707937,708373,436,5,N,Y,1437992265363,707653,708287
MULIFE.txt,708374,708728,354,5,N,N,-,-1,-1
MULIFE.txt,708729,709066,337,5,N,N,-,-1,-1
MULIFE.txt,709067,709571,504,5,N,N,-,-1,-1
MULIFE.txt,709574,710154,580,5,N,N,-,-1,-1
MULIFE.txt,710157,710689,532,5,N,N,-,-1,-1
MULIFE.txt,710690,710989,299,5,N,N,-,-1,-1
MULIFE.txt,710990,711488,498,5,N,N,-,-1,-1
MULIFE.txt,711491,712006,515,5,N,N,-,-1,-1
MULIFE.txt,712008,712617,609,5,N,N,-,-1,-1
MULIFE.txt,712618,713635,1017,5,N,N,-,-1,-1
MULIFE.txt,713638,714388,750,5,N,N,-,-1,-1
MULIFE.txt,714389,714971,582,5,N,N,-,-1,-1
MULIFE.txt,714973,715356,383,5,N,N,-,-1,-1
MULIFE.txt,715357,715730,373,5,N,N,-,-1,-1
MULIFE.txt,715732,716370,638,5,N,N,-,-1,-1
MULIFE.txt,716371,717093,722,5,N,N,-,-1,-1
MULIFE.txt,717094,717958,864,5,N,N,-,-1,-1
MULIFE.txt,717959,718317,358,5,N,N,-,-1,-1
MULIFE.txt,718320,718964,644,5,N,Y,1437992560557,718760,719849
MULIFE.txt,718965,719664,699,5,N,Y,1437992560557,718760,719849
MULIFE.txt,719665,720493,828,5,N,Y,1437992801449,719924,720764
MULIFE.txt,720494,720870,376,5,N,Y,1437992801449,719924,720764
MULIFE.txt,720871,721148,277,5,N,N,-,-1,-1
MULIFE.txt,721149,721642,493,5,N,N,-,-1,-1
MULIFE.txt,721643,722233,590,5,N,N,-,-1,-1
MULIFE.txt,722234,722479,245,5,N,N,-,-1,-1
MULIFE.txt,722480,722916,436,5,N,N,-,-1,-1
MULIFE.txt,722917,723529,612,5,N,N,-,-1,-1
MULIFE.txt,723530,724005,475,5,N,N,-,-1,-1
MULIFE.txt,724008,724706,698,5,N,N,-,-1,-1
MULIFE.txt,724708,725386,678,5,N,N,-,-1,-1
MULIFE.txt,725387,726144,757,5,N,N,-,-1,-1
MULIFE.txt,726147,726922,775,5,N,N,-,-1,-1
MULIFE.txt,726923,727422,499,5,N,N,-,-1,-1
MULIFE.txt,727423,728135,712,5,N,N,-,-1,-1
MULIFE.txt,728136,729216,1080,5,N,N,-,-1,-1
MULIFE.txt,729218,729677,459,5,N,N,-,-1,-1
MULIFE.txt,729680,730258,578,5,N,N,-,-1,-1
MULIFE.txt,730259,731172,913,5,N,N,-,-1,-1
MULIFE.txt,731173,731655,482,5,N,N,-,-1,-1
MULIFE.txt,731658,732165,507,5,N,N,-,-1,-1
MULIFE.txt,732166,732744,578,5,N,N,-,-1,-1
MULIFE.txt,732745,733607,862,5,N,N,-,-1,-1
MULIFE.txt,733607,734180,573,5,N,N,-,-1,-1
MULIFE.txt,734181,734722,541,5,N,N,-,-1,-1
MULIFE.txt,734723,735503,780,5,N,N,-,-1,-1
MULIFE.txt,735504,736017,513,5,N,N,-,-1,-1
MULIFE.txt,736018,736435,417,5,N,N,-,-1,-1
MULIFE.txt,736437,737071,634,5,N,N,-,-1,-1
MULIFE.txt,737074,737421,347,5,N,N,-,-1,-1
MULIFE.txt,737422,738016,594,5,N,N,-,-1,-1
MULIFE.txt,738019,738561,542,5,N,N,-,-1,-1
MULIFE.txt,738564,739184,620,5,N,N,-,-1,-1
MULIFE.txt,739189,739281,92,5,N,N,-,-1,-1
MULIFE.txt,739282,739921,639,5,N,N,-,-1,-1
MULIFE.txt,739922,740282,360,5,N,N,-,-1,-1
MULIFE.txt,740283,740851,568,5,N,Y,1437993458963,740703,741759
MULIFE.txt,740852,741394,542,5,N,Y,1437993458963,740703,741759
MULIFE.txt,741395,741839,444,5,N,Y,1437993458963,740703,741759
MULIFE.txt,741842,742341,499,5,N,N,-,-1,-1
MULIFE.txt,742342,742694,352,5,N,N,-,-1,-1
MULIFE.txt,742695,742954,259,5,N,N,-,-1,-1
MULIFE.txt,742955,743250,295,5,N,N,-,-1,-1
MULIFE.txt,743251,743489,238,5,N,N,-,-1,-1
MULIFE.txt,743490,743854,364,5,N,N,-,-1,-1
MULIFE.txt,743855,744359,504,5,N,N,-,-1,-1
MULIFE.txt,744362,745183,821,5,N,N,-,-1,-1
MULIFE.txt,745184,745791,607,5,N,N,-,-1,-1
MULIFE.txt,745792,746619,827,5,N,N,-,-1,-1
MULIFE.txt,746620,747100,480,5,N,Y,1437993739565,746751,748086
MULIFE.txt,747101,748138,1037,5,N,Y,1437993739565,746751,748086
MULIFE.txt,748143,748509,366,5,N,N,-,-1,-1
MULIFE.txt,748510,749107,597,5,N,N,-,-1,-1
MULIFE.txt,749110,749364,254,5,N,N,-,-1,-1
MULIFE.txt,749365,750514,1149,5,N,N,-,-1,-1
MULIFE.txt,750515,751117,602,5,N,N,-,-1,-1
MULIFE.txt,751118,751791,673,5,N,N,-,-1,-1
MULIFE.txt,751794,752566,772,5,N,N,-,-1,-1
MULIFE.txt,752567,753088,521,5,N,N,-,-1,-1
MULIFE.txt,753089,753911,822,5,N,N,-,-1,-1
MULIFE.txt,753912,754306,394,5,N,N,-,-1,-1
MULIFE.txt,754307,754609,302,5,N,N,-,-1,-1
MULIFE.txt,754610,755263,653,5,N,N,-,-1,-1
MULIFE.txt,755264,755628,364,5,N,N,-,-1,-1
MULIFE.txt,755629,756089,460,5,N,N,-,-1,-1
MULIFE.txt,756091,757300,1209,5,N,N,-,-1,-1
MULIFE.txt,757303,758041,738,5,N,N,-,-1,-1
MULIFE.txt,758044,758941,897,5,N,N,-,-1,-1
MULIFE.txt,758942,759819,877,5,N,N,-,-1,-1
MULIFE.txt,759822,760334,512,5,N,Y,1437994269353,759820,760565
MULIFE.txt,760335,760992,657,5,N,Y,1437994269353,759820,760565
MULIFE.txt,760993,761760,767,5,N,N,-,-1,-1
MULIFE.txt,761763,762353,590,5,N,N,-,-1,-1
MULIFE.txt,762354,763075,721,5,N,N,-,-1,-1
MULIFE.txt,763078,764037,959,5,N,N,-,-1,-1
MULIFE.txt,764040,764500,460,5,N,N,-,-1,-1
MULIFE.txt,764501,765015,514,5,N,N,-,-1,-1
MULIFE.txt,765016,765880,864,5,N,N,-,-1,-1
MULIFE.txt,765883,766417,534,5,N,N,-,-1,-1
MULIFE.txt,766420,767351,931,5,N,N,-,-1,-1
MULIFE.txt,767352,768498,1146,5,N,N,-,-1,-1
MULIFE.txt,768499,769318,819,5,N,N,-,-1,-1
MULIFE.txt,769321,770140,819,5,N,N,-,-1,-1
MULIFE.txt,770141,770340,199,5,N,N,-,-1,-1
MULIFE.txt,770342,771029,687,5,N,N,-,-1,-1
MULIFE.txt,771034,771316,282,5,N,Y,1438000608332,771119,771952
MULIFE.txt,771317,771956,639,5,N,Y,1438000608332,771119,771952
MULIFE.txt,771959,772943,984,5,N,N,-,-1,-1
MULIFE.txt,772946,773375,429,5,N,N,-,-1,-1
MULIFE.txt,773376,773978,602,5,N,N,-,-1,-1
MULIFE.txt,773979,774318,339,5,N,N,-,-1,-1
MULIFE.txt,774319,775412,1093,5,N,N,-,-1,-1
MULIFE.txt,775413,775994,581,5,N,N,-,-1,-1
MULIFE.txt,775995,776431,436,5,N,N,-,-1,-1
MULIFE.txt,776434,777034,600,5,N,N,-,-1,-1
MULIFE.txt,777035,777994,959,5,N,N,-,-1,-1
MULIFE.txt,777995,778536,541,5,N,N,-,-1,-1
MULIFE.txt,778537,778914,377,5,N,Y,1438001606981,778715,780387
MULIFE.txt,778915,779369,454,5,N,Y,1438001606981,778715,780387
MULIFE.txt,779370,780326,956,5,N,Y,1438001606981,778715,780387
MULIFE.txt,780329,780777,448,5,N,Y,1438001606981,778715,780387
MULIFE.txt,780778,781225,447,5,N,N,-,-1,-1
MULIFE.txt,781226,781661,435,5,N,N,-,-1,-1
MULIFE.txt,781664,782050,386,5,N,N,-,-1,-1
MULIFE.txt,782053,782326,273,5,N,N,-,-1,-1
MULIFE.txt,782329,782828,499,5,N,N,-,-1,-1
MULIFE.txt,782829,783268,439,5,N,N,-,-1,-1
MULIFE.txt,783269,784060,791,5,N,N,-,-1,-1
MULIFE.txt,784061,785000,939,5,N,N,-,-1,-1
MULIFE.txt,785003,785434,431,5,N,N,-,-1,-1
MULIFE.txt,785435,785839,404,5,N,N,-,-1,-1
MULIFE.txt,785840,786199,359,5,N,N,-,-1,-1
MULIFE.txt,786202,786534,332,5,N,N,-,-1,-1
MULIFE.txt,786535,787000,465,5,N,N,-,-1,-1
MULIFE.txt,787001,787511,510,5,N,N,-,-1,-1
MULIFE.txt,787512,787881,369,5,N,N,-,-1,-1
MULIFE.txt,787884,788660,776,5,N,N,-,-1,-1
MULIFE.txt,788661,789650,989,5,N,N,-,-1,-1
MULIFE.txt,789653,790692,1039,5,N,N,-,-1,-1
MULIFE.txt,790693,791247,554,5,N,N,-,-1,-1
MULIFE.txt,791250,791832,582,5,N,N,-,-1,-1
MULIFE.txt,791834,792402,568,5,N,N,-,-1,-1
MULIFE.txt,792403,793376,973,5,N,N,-,-1,-1
MULIFE.txt,793377,794040,663,5,N,N,-,-1,-1
MULIFE.txt,794041,794894,853,5,N,N,-,-1,-1
MULIFE.txt,794895,795332,437,5,N,N,-,-1,-1
MULIFE.txt,795333,796114,781,5,N,N,-,-1,-1
MULIFE.txt,796117,796380,263,5,N,N,-,-1,-1
MULIFE.txt,796381,796755,374,5,N,N,-,-1,-1
MULIFE.txt,796758,797132,374,5,N,N,-,-1,-1
MULIFE.txt,797133,799176,2043,5,N,N,-,-1,-1
MULIFE.txt,799179,800329,1150,5,N,N,-,-1,-1
MULIFE.txt,800330,801196,866,5,N,N,-,-1,-1
MULIFE.txt,801197,801947,750,5,N,N,-,-1,-1
MULIFE.txt,801949,802810,861,5,N,N,-,-1,-1
MULIFE.txt,802812,803517,705,5,N,N,-,-1,-1
MULIFE.txt,803518,804086,568,5,N,N,-,-1,-1
MULIFE.txt,804087,804878,791,5,N,N,-,-1,-1
MULIFE.txt,804879,805675,796,5,N,N,-,-1,-1
MULIFE.txt,805676,806074,398,5,N,N,-,-1,-1
MULIFE.txt,806075,806361,286,5,N,N,-,-1,-1
MULIFE.txt,806362,806941,579,5,N,N,-,-1,-1
MULIFE.txt,806942,807617,675,5,N,N,-,-1,-1
MULIFE.txt,807618,808674,1056,5,N,N,-,-1,-1
MULIFE.txt,808676,809220,544,5,N,N,-,-1,-1
MULIFE.txt,809221,809978,757,5,N,N,-,-1,-1
MULIFE.txt,809979,810693,714,5,N,N,-,-1,-1
MULIFE.txt,810694,811610,916,5,N,N,-,-1,-1
MULIFE.txt,811613,812028,415,5,N,N,-,-1,-1
MULIFE.txt,812031,812914,883,5,N,N,-,-1,-1
MULIFE.txt,812915,813601,686,5,N,N,-,-1,-1
MULIFE.txt,813602,814719,1117,5,N,N,-,-1,-1
MULIFE.txt,814720,815281,561,5,N,N,-,-1,-1
MULIFE.txt,815282,815967,685,5,N,N,-,-1,-1
MULIFE.txt,815968,816774,806,5,N,N,-,-1,-1
MULIFE.txt,816775,817327,552,5,N,N,-,-1,-1
MULIFE.txt,817328,817876,548,5,N,N,-,-1,-1
MULIFE.txt,817877,818478,601,5,N,N,-,-1,-1
MULIFE.txt,818479,819314,835,5,N,N,-,-1,-1
MULIFE.txt,819317,820071,754,5,N,N,-,-1,-1
MULIFE.txt,820072,821087,1015,5,N,N,-,-1,-1
MULIFE.txt,821092,821907,815,5,N,N,-,-1,-1
MULIFE.txt,821908,822641,733,5,N,N,-,-1,-1
MULIFE.txt,822642,823177,535,5,N,N,-,-1,-1
MULIFE.txt,823178,823646,468,5,N,N,-,-1,-1
MULIFE.txt,823647,824295,648,5,N,N,-,-1,-1
MULIFE.txt,824298,824817,519,5,N,N,-,-1,-1
MULIFE.txt,824818,825271,453,5,N,N,-,-1,-1
MULIFE.txt,825272,825974,702,5,N,N,-,-1,-1
MULIFE.txt,825977,827161,1184,5,N,N,-,-1,-1
MULIFE.txt,827166,827429,263,5,N,N,-,-1,-1
MULIFE.txt,827430,827664,234,5,N,N,-,-1,-1
MULIFE.txt,827665,828061,396,5,N,N,-,-1,-1
MULIFE.txt,828064,828623,559,5,N,N,-,-1,-1
MULIFE.txt,828624,829126,502,5,N,N,-,-1,-1
MULIFE.txt,829127,829557,430,5,N,N,-,-1,-1
MULIFE.txt,829558,829910,352,5,N,N,-,-1,-1
MULIFE.txt,829911,830444,533,5,N,N,-,-1,-1
MULIFE.txt,830445,831041,596,5,N,N,-,-1,-1
MULIFE.txt,831042,831647,605,5,N,N,-,-1,-1
MULIFE.txt,831648,832074,426,5,N,N,-,-1,-1
MULIFE.txt,832075,832341,266,5,N,N,-,-1,-1
MULIFE.txt,832342,832804,462,5,N,N,-,-1,-1
MULIFE.txt,832805,833187,382,5,N,N,-,-1,-1
MULIFE.txt,833188,833823,635,5,N,N,-,-1,-1
MULIFE.txt,833824,834243,419,5,N,N,-,-1,-1
MULIFE.txt,834244,834922,678,5,N,N,-,-1,-1
MULIFE.txt,834923,835591,668,5,N,N,-,-1,-1
MULIFE.txt,835592,836329,737,5,N,N,-,-1,-1
MULIFE.txt,836332,836752,420,5,N,N,-,-1,-1
MULIFE.txt,836753,837308,555,5,N,N,-,-1,-1
MULIFE.txt,837309,837954,645,5,N,N,-,-1,-1
MULIFE.txt,837955,838428,473,5,N,N,-,-1,-1
MULIFE.txt,838429,839283,854,5,N,N,-,-1,-1
MULIFE.txt,839285,839756,471,5,N,N,-,-1,-1
MULIFE.txt,839757,840282,525,5,N,N,-,-1,-1
MULIFE.txt,840283,840681,398,5,N,N,-,-1,-1
MULIFE.txt,840682,841049,367,5,N,N,-,-1,-1
MULIFE.txt,841052,841535,483,5,N,N,-,-1,-1
MULIFE.txt,841536,841820,284,5,N,N,-,-1,-1
MULIFE.txt,841821,842299,478,5,N,N,-,-1,-1
MULIFE.txt,842302,843311,1009,5,N,N,-,-1,-1
MULIFE.txt,843312,843993,681,5,N,N,-,-1,-1
MULIFE.txt,843994,844475,481,5,N,N,-,-1,-1
MULIFE.txt,844476,844982,506,5,N,N,-,-1,-1
MULIFE.txt,844983,845380,397,5,N,N,-,-1,-1
MULIFE.txt,845383,846449,1066,5,N,N,-,-1,-1
MULIFE.txt,846452,846923,471,5,N,N,-,-1,-1
MULIFE.txt,846924,847668,744,5,N,N,-,-1,-1
MULIFE.txt,847669,848855,1186,5,N,N,-,-1,-1
MULIFE.txt,848858,849351,493,5,N,N,-,-1,-1
MULIFE.txt,849354,850662,1308,5,N,N,-,-1,-1
MULIFE.txt,850665,851210,545,5,N,N,-,-1,-1
MULIFE.txt,851211,851765,554,5,N,N,-,-1,-1
MULIFE.txt,851766,852196,430,5,N,N,-,-1,-1
MULIFE.txt,852197,852532,335,5,N,N,-,-1,-1
MULIFE.txt,852533,852973,440,5,N,N,-,-1,-1
MULIFE.txt,852974,853505,531,5,N,N,-,-1,-1
MULIFE.txt,853506,853849,343,5,N,N,-,-1,-1
MULIFE.txt,853850,854069,219,5,N,N,-,-1,-1
MULIFE.txt,854072,854486,414,5,N,N,-,-1,-1
MULIFE.txt,854487,855033,546,5,N,N,-,-1,-1
MULIFE.txt,855035,855326,291,5,N,N,-,-1,-1
MULIFE.txt,855327,855531,204,5,N,N,-,-1,-1
MULIFE.txt,855532,855756,224,5,N,N,-,-1,-1
MULIFE.txt,855757,856173,416,5,N,N,-,-1,-1
MULIFE.txt,856176,856607,431,5,N,N,-,-1,-1
MULIFE.txt,856608,857444,836,5,N,N,-,-1,-1
MULIFE.txt,857445,858096,651,5,N,N,-,-1,-1
MULIFE.txt,858099,858679,580,5,N,N,-,-1,-1
MULIFE.txt,858680,859674,994,5,N,N,-,-1,-1
MULIFE.txt,859677,860238,561,5,N,N,-,-1,-1
MULIFE.txt,860241,860759,518,5,N,N,-,-1,-1
MULIFE.txt,860760,861218,458,5,N,N,-,-1,-1
MULIFE.txt,861219,861481,262,5,N,N,-,-1,-1
MULIFE.txt,861482,861901,419,5,N,N,-,-1,-1
MULIFE.txt,861902,862701,799,5,N,N,-,-1,-1
MULIFE.txt,862703,863574,871,5,N,N,-,-1,-1
MULIFE.txt,863575,864235,660,5,N,N,-,-1,-1
MULIFE.txt,864236,865151,915,5,N,N,-,-1,-1
MULIFE.txt,865152,865847,695,5,N,N,-,-1,-1
MULIFE.txt,865850,866477,627,5,N,N,-,-1,-1
MULIFE.txt,866478,867077,599,5,N,N,-,-1,-1
MULIFE.txt,867078,867246,168,5,N,N,-,-1,-1
MULIFE.txt,867247,867596,349,5,N,N,-,-1,-1
MULIFE.txt,867599,868271,672,5,N,N,-,-1,-1
MULIFE.txt,868272,869040,768,5,N,N,-,-1,-1
MULIFE.txt,869043,869916,873,5,N,N,-,-1,-1
MULIFE.txt,869917,870597,680,5,N,N,-,-1,-1
MULIFE.txt,870598,871140,542,5,N,N,-,-1,-1
MULIFE.txt,871141,871468,327,5,N,N,-,-1,-1
MULIFE.txt,871469,871694,225,5,N,N,-,-1,-1
MULIFE.txt,871695,871992,297,5,N,N,-,-1,-1
MULIFE.txt,871993,872585,592,5,N,N,-,-1,-1
MULIFE.txt,872588,873587,999,5,N,N,-,-1,-1
MULIFE.txt,873590,873828,238,5,N,N,-,-1,-1
MULIFE.txt,873829,874163,334,5,N,N,-,-1,-1
MULIFE.txt,874164,874990,826,5,N,N,-,-1,-1
MULIFE.txt,874993,875482,489,5,N,N,-,-1,-1
MULIFE.txt,875483,875777,294,5,N,N,-,-1,-1
MULIFE.txt,875778,875994,216,5,N,N,-,-1,-1
MULIFE.txt,875995,876359,364,5,N,N,-,-1,-1
MULIFE.txt,876360,876556,196,5,N,N,-,-1,-1
MULIFE.txt,876557,876851,294,5,N,N,-,-1,-1
MULIFE.txt,876852,877007,155,5,N,N,-,-1,-1
MULIFE.txt,877008,877402,394,5,N,N,-,-1,-1
MULIFE.txt,877403,877670,267,5,N,N,-,-1,-1
MULIFE.txt,877673,877900,227,5,N,N,-,-1,-1
MULIFE.txt,877901,878261,360,5,N,N,-,-1,-1
MULIFE.txt,878263,878503,240,5,N,N,-,-1,-1
MULIFE.txt,878504,878889,385,5,N,N,-,-1,-1
MULIFE.txt,878890,879494,604,5,N,N,-,-1,-1
MULIFE.txt,879497,879661,164,5,N,N,-,-1,-1
MULIFE.txt,879662,880018,356,5,N,N,-,-1,-1
MULIFE.txt,880019,880179,160,5,N,N,-,-1,-1
MULIFE.txt,880180,880420,240,5,N,N,-,-1,-1
MULIFE.txt,880421,880873,452,5,N,N,-,-1,-1
MULIFE.txt,880876,881474,598,5,N,N,-,-1,-1
MULIFE.txt,881477,882232,755,5,N,N,-,-1,-1
MULIFE.txt,882233,882960,727,5,N,N,-,-1,-1
MULIFE.txt,882961,883531,570,5,N,N,-,-1,-1
MULIFE.txt,883532,884503,971,5,N,N,-,-1,-1
MULIFE.txt,884504,885253,749,5,N,N,-,-1,-1
MULIFE.txt,885256,885646,390,5,N,N,-,-1,-1
MULIFE.txt,885647,885881,234,5,N,N,-,-1,-1
MULIFE.txt,885883,886040,157,5,N,N,-,-1,-1
MULIFE.txt,886041,886491,450,5,N,N,-,-1,-1
MULIFE.txt,886494,886896,402,5,N,N,-,-1,-1
MULIFE.txt,886897,887458,561,5,N,N,-,-1,-1
MULIFE.txt,887459,887771,312,5,N,N,-,-1,-1
MULIFE.txt,887772,888375,603,5,N,N,-,-1,-1
MULIFE.txt,888378,890438,2060,5,N,N,-,-1,-1
MULIFE.txt,890441,891033,592,5,N,N,-,-1,-1
MULIFE.txt,891035,891551,516,5,N,N,-,-1,-1
MULIFE.txt,891552,892556,1004,5,N,N,-,-1,-1
MULIFE.txt,892564,892659,95,5,N,N,-,-1,-1
MULIFE.txt,892660,893085,425,5,N,Y,1438002747854,892999,894161
MULIFE.txt,893088,894237,1149,5,N,Y,1438002747854,892999,894161
MULIFE.txt,894240,894745,505,5,N,N,-,-1,-1
MULIFE.txt,894748,895871,1123,5,N,N,-,-1,-1
MULIFE.txt,895874,896477,603,5,N,N,-,-1,-1
MULIFE.txt,896478,896978,500,5,N,N,-,-1,-1
MULIFE.txt,896979,897502,523,5,N,N,-,-1,-1
MULIFE.txt,897505,897957,452,5,N,N,-,-1,-1
MULIFE.txt,897958,898689,731,5,N,N,-,-1,-1
MULIFE.txt,898690,899153,463,5,N,N,-,-1,-1
MULIFE.txt,899156,899646,490,5,N,N,-,-1,-1
MULIFE.txt,899647,900227,580,5,N,N,-,-1,-1
MULIFE.txt,900230,900801,571,5,N,N,-,-1,-1
MULIFE.txt,900802,901612,810,5,N,N,-,-1,-1
MULIFE.txt,901614,902185,571,5,N,Y,1438003564102,901839,902422
MULIFE.txt,902188,902938,750,5,N,Y,1438003564102,901839,902422
MULIFE.txt,902941,903246,305,5,N,Y,1438003925285,903100,903985
MULIFE.txt,903247,903761,514,5,N,Y,1438003925285,903100,903985
MULIFE.txt,903762,904284,522,5,N,Y,1438003925285,903100,903985
MULIFE.txt,904285,904900,615,5,N,N,-,-1,-1
MULIFE.txt,904901,905248,347,5,N,N,-,-1,-1
MULIFE.txt,905249,905936,687,5,N,Y,1438004319285,905549,905936
MULIFE.txt,905939,906415,476,5,N,N,-,-1,-1
MULIFE.txt,906416,907150,734,5,N,N,-,-1,-1
MULIFE.txt,907151,907543,392,5,N,N,-,-1,-1
MULIFE.txt,907546,907945,399,5,N,N,-,-1,-1
MULIFE.txt,907946,908660,714,5,N,N,-,-1,-1
MULIFE.txt,908661,909193,532,5,N,N,-,-1,-1
MULIFE.txt,909195,909806,611,5,N,N,-,-1,-1
MULIFE.txt,909807,910590,783,5,N,N,-,-1,-1
MULIFE.txt,910591,911008,417,5,N,N,-,-1,-1
MULIFE.txt,911009,911624,615,5,N,N,-,-1,-1
MULIFE.txt,911627,912043,416,5,N,N,-,-1,-1
MULIFE.txt,912044,912509,465,5,N,N,-,-1,-1
MULIFE.txt,912510,912881,371,5,N,N,-,-1,-1
MULIFE.txt,912882,913067,185,5,N,N,-,-1,-1
MULIFE.txt,913068,913527,459,5,N,N,-,-1,-1
MULIFE.txt,913528,913927,399,5,N,N,-,-1,-1
MULIFE.txt,913930,914137,207,5,N,N,-,-1,-1
MULIFE.txt,914139,914489,350,5,N,N,-,-1,-1
MULIFE.txt,914490,914979,489,5,N,N,-,-1,-1
MULIFE.txt,914980,915213,233,5,N,N,-,-1,-1
MULIFE.txt,915214,916139,925,5,N,N,-,-1,-1
MULIFE.txt,916140,916814,674,5,N,N,-,-1,-1
MULIFE.txt,916815,917367,552,5,N,N,-,-1,-1
MULIFE.txt,917370,918194,824,5,N,N,-,-1,-1
MULIFE.txt,918197,918503,306,5,N,N,-,-1,-1
MULIFE.txt,918504,919465,961,5,N,N,-,-1,-1
MULIFE.txt,919468,919831,363,5,N,N,-,-1,-1
MULIFE.txt,919834,920471,637,5,N,N,-,-1,-1
MULIFE.txt,920474,920973,499,5,N,N,-,-1,-1
MULIFE.txt,920974,921695,721,5,N,N,-,-1,-1
MULIFE.txt,921696,922279,583,5,N,N,-,-1,-1
MULIFE.txt,922281,922679,398,5,N,N,-,-1,-1
MULIFE.txt,922681,923513,832,5,N,N,-,-1,-1
MULIFE.txt,923514,923748,234,5,N,N,-,-1,-1
MULIFE.txt,923749,925514,1765,5,N,N,-,-1,-1
MULIFE.txt,925517,926206,689,5,N,N,-,-1,-1
MULIFE.txt,926209,927006,797,5,N,N,-,-1,-1
MULIFE.txt,927007,928372,1365,5,N,N,-,-1,-1
MULIFE.txt,928373,929088,715,5,N,N,-,-1,-1
MULIFE.txt,929091,929713,622,5,N,N,-,-1,-1
MULIFE.txt,929714,930326,612,5,N,N,-,-1,-1
MULIFE.txt,930327,930925,598,5,N,N,-,-1,-1
MULIFE.txt,930926,931324,398,5,N,N,-,-1,-1
MULIFE.txt,931325,932268,943,5,N,N,-,-1,-1
MULIFE.txt,932269,932697,428,5,N,N,-,-1,-1
MULIFE.txt,932700,933088,388,5,N,N,-,-1,-1
MULIFE.txt,933091,933568,477,5,N,N,-,-1,-1
MULIFE.txt,933569,934099,530,5,N,N,-,-1,-1
MULIFE.txt,934100,934919,819,5,N,N,-,-1,-1
MULIFE.txt,934922,935899,977,5,N,N,-,-1,-1
MULIFE.txt,935902,936491,589,5,N,N,-,-1,-1
MULIFE.txt,936492,937250,758,5,N,N,-,-1,-1
MULIFE.txt,937251,937495,244,5,N,N,-,-1,-1
MULIFE.txt,937497,938336,839,5,N,N,-,-1,-1
MULIFE.txt,938337,938778,441,5,N,N,-,-1,-1
MULIFE.txt,938779,939194,415,5,N,N,-,-1,-1
MULIFE.txt,939195,939804,609,5,N,N,-,-1,-1
MULIFE.txt,939805,940190,385,5,N,N,-,-1,-1
MULIFE.txt,940191,940568,377,5,N,N,-,-1,-1
MULIFE.txt,940570,941050,480,5,N,N,-,-1,-1
MULIFE.txt,941053,941319,266,5,N,N,-,-1,-1
MULIFE.txt,941320,941781,461,5,N,N,-,-1,-1
MULIFE.txt,941786,942086,300,5,N,N,-,-1,-1
MULIFE.txt,942089,942795,706,5,N,N,-,-1,-1
MULIFE.txt,942798,943061,263,5,N,N,-,-1,-1
MULIFE.txt,943062,943592,530,5,N,N,-,-1,-1
MULIFE.txt,943593,944251,658,5,N,N,-,-1,-1
MULIFE.txt,944252,944538,286,5,N,N,-,-1,-1
MULIFE.txt,944539,945813,1274,5,N,N,-,-1,-1
MULIFE.txt,945814,946430,616,5,N,N,-,-1,-1
MULIFE.txt,946431,947066,635,5,N,N,-,-1,-1
MULIFE.txt,947069,947871,802,5,N,N,-,-1,-1
MULIFE.txt,947872,948312,440,5,N,N,-,-1,-1
MULIFE.txt,948313,948934,621,5,N,N,-,-1,-1
MULIFE.txt,948935,949491,556,5,N,N,-,-1,-1
MULIFE.txt,949492,949866,374,5,N,N,-,-1,-1
MULIFE.txt,949867,950448,581,5,N,N,-,-1,-1
MULIFE.txt,950449,951292,843,5,N,N,-,-1,-1
MULIFE.txt,951293,952241,948,5,N,N,-,-1,-1
MULIFE.txt,952242,953087,845,5,N,N,-,-1,-1
MULIFE.txt,953088,953760,672,5,N,Y,1438005303228,953665,955052
MULIFE.txt,953761,954042,281,5,N,Y,1438005303228,953665,955052
MULIFE.txt,954043,954953,910,5,N,Y,1438005303228,953665,955052
MULIFE.txt,954954,955481,527,5,N,Y,1438005724733,955431,957516
MULIFE.txt,955482,956064,582,5,N,Y,1438005724733,955431,957516
MULIFE.txt,956065,957060,995,5,N,Y,1438005724733,955431,957516
MULIFE.txt,957061,957909,848,5,N,Y,1438005724733,955431,957516
MULIFE.txt,957912,959117,1205,5,N,N,-,-1,-1
MULIFE.txt,959120,959644,524,5,N,N,-,-1,-1
MULIFE.txt,959645,960439,794,5,N,N,-,-1,-1
MULIFE.txt,960440,961316,876,5,N,N,-,-1,-1
MULIFE.txt,961319,961980,661,5,N,N,-,-1,-1
MULIFE.txt,961983,962900,917,5,N,N,-,-1,-1
MULIFE.txt,962903,963722,819,5,N,N,-,-1,-1
MULIFE.txt,963723,964594,871,5,N,N,-,-1,-1
MULIFE.txt,964595,965563,968,5,N,N,-,-1,-1
MULIFE.txt,965564,966235,671,5,N,N,-,-1,-1
MULIFE.txt,966236,966705,469,5,N,N,-,-1,-1
MULIFE.txt,966706,967112,406,5,N,N,-,-1,-1
MULIFE.txt,967115,967700,585,5,N,N,-,-1,-1
MULIFE.txt,967703,968059,356,5,N,N,-,-1,-1
MULIFE.txt,968061,968752,691,5,N,N,-,-1,-1
MULIFE.txt,968757,969092,335,5,N,N,-,-1,-1
MULIFE.txt,969094,970129,1035,5,N,N,-,-1,-1
MULIFE.txt,970130,970658,528,5,N,N,-,-1,-1
MULIFE.txt,970659,971284,625,5,N,Y,1438006506960,970689,974719
MULIFE.txt,971285,972405,1120,5,N,Y,1438006506960,970689,974719
MULIFE.txt,972406,973830,1424,5,N,Y,1438006506960,970689,974719
MULIFE.txt,973831,974826,995,5,N,Y,1438006506960,970689,974719
MULIFE.txt,974827,975481,654,5,N,N,-,-1,-1
MULIFE.txt,975482,976041,559,5,N,N,-,-1,-1
MULIFE.txt,976042,976295,253,5,N,N,-,-1,-1
MULIFE.txt,976298,976746,448,5,N,N,-,-1,-1
MULIFE.txt,976747,977369,622,5,N,N,-,-1,-1
MULIFE.txt,977370,977715,345,5,N,N,-,-1,-1
MULIFE.txt,977716,978001,285,5,N,N,-,-1,-1
MULIFE.txt,978002,978350,348,5,N,N,-,-1,-1
MULIFE.txt,978353,979021,668,5,N,N,-,-1,-1
MULIFE.txt,979022,979676,654,5,N,N,-,-1,-1
MULIFE.txt,979679,980348,669,5,N,N,-,-1,-1
MULIFE.txt,980349,980866,517,5,N,N,-,-1,-1
MULIFE.txt,980867,981282,415,5,N,N,-,-1,-1
MULIFE.txt,981285,981931,646,5,N,N,-,-1,-1
MULIFE.txt,981934,982327,393,5,N,N,-,-1,-1
MULIFE.txt,982328,982607,279,5,N,N,-,-1,-1
MULIFE.txt,982608,983393,785,5,N,N,-,-1,-1
MULIFE.txt,983396,984133,737,5,N,N,-,-1,-1
MULIFE.txt,984135,984240,105,5,N,N,-,-1,-1
MULIFE.txt,984241,984369,128,5,N,N,-,-1,-1
MULIFE.txt,984370,984462,92,5,N,N,-,-1,-1
MULIFE.txt,984463,984591,128,5,N,N,-,-1,-1
MULIFE.txt,984592,984725,133,5,N,N,-,-1,-1
MULIFE.txt,984726,984865,139,5,N,N,-,-1,-1
MULIFE.txt,984866,985075,209,5,N,N,-,-1,-1
MULIFE.txt,985076,985217,141,5,N,N,-,-1,-1
MULIFE.txt,985219,985356,137,5,N,N,-,-1,-1
MULIFE.txt,985357,985492,135,5,N,N,-,-1,-1
MULIFE.txt,985493,985617,124,5,N,N,-,-1,-1
MULIFE.txt,985618,985795,177,5,N,N,-,-1,-1
MULIFE.txt,985798,986083,285,5,N,N,-,-1,-1
MULIFE.txt,986088,986200,112,5,N,N,-,-1,-1
MULIFE.txt,986201,986334,133,5,N,N,-,-1,-1
MULIFE.txt,986335,986382,47,5,N,N,-,-1,-1
MULIFE.txt,986383,986502,119,5,N,N,-,-1,-1
MULIFE.txt,986503,986603,100,5,N,N,-,-1,-1
MULIFE.txt,986604,986673,69,5,N,N,-,-1,-1
MULIFE.txt,986674,986799,125,5,N,N,-,-1,-1
MULIFE.txt,986800,986990,190,5,N,N,-,-1,-1
MULIFE.txt,986991,987090,99,5,N,N,-,-1,-1
MULIFE.txt,987092,987363,271,5,N,N,-,-1,-1
MULIFE.txt,987366,987558,192,5,N,N,-,-1,-1
MULIFE.txt,987558,987650,92,5,N,N,-,-1,-1
MULIFE.txt,987652,987777,125,5,N,N,-,-1,-1
MULIFE.txt,987778,987952,174,5,N,N,-,-1,-1
MULIFE.txt,987953,988103,150,5,N,N,-,-1,-1
MULIFE.txt,988104,988169,65,5,N,N,-,-1,-1
MULIFE.txt,988170,988323,153,5,N,N,-,-1,-1
MULIFE.txt,988324,988342,18,5,N,N,-,-1,-1
MULIFE.txt,988344,988464,120,5,N,N,-,-1,-1
MULIFE.txt,988465,988595,130,5,N,N,-,-1,-1
MULIFE.txt,988597,988738,141,5,N,N,-,-1,-1
MULIFE.txt,988740,988854,114,5,N,N,-,-1,-1
MULIFE.txt,988855,988943,88,5,N,N,-,-1,-1
MULIFE.txt,988944,989037,93,5,N,N,-,-1,-1
MULIFE.txt,989038,989100,62,5,N,N,-,-1,-1
MULIFE.txt,989101,989155,54,5,N,N,-,-1,-1
MULIFE.txt,989160,989324,164,5,N,N,-,-1,-1
MULIFE.txt,989325,989396,71,5,N,N,-,-1,-1
MULIFE.txt,989397,989499,102,5,N,N,-,-1,-1
MULIFE.txt,989500,989546,46,5,N,N,-,-1,-1
MULIFE.txt,989547,989627,80,5,N,N,-,-1,-1
MULIFE.txt,989628,989794,166,5,N,N,-,-1,-1
MULIFE.txt,989796,989870,74,5,N,N,-,-1,-1
MULIFE.txt,989871,989927,56,5,N,N,-,-1,-1
MULIFE.txt,989930,989979,49,5,N,N,-,-1,-1
MULIFE.txt,989980,990165,185,5,N,N,-,-1,-1
MULIFE.txt,990166,990352,186,5,N,N,-,-1,-1
MULIFE.txt,990353,990539,186,5,N,N,-,-1,-1
MULIFE.txt,990540,990681,141,5,N,N,-,-1,-1
MULIFE.txt,990684,990920,236,5,N,N,-,-1,-1
MULIFE.txt,990928,991090,162,5,N,N,-,-1,-1
MULIFE.txt,991091,991258,167,5,N,N,-,-1,-1
MULIFE.txt,991259,991426,167,5,N,N,-,-1,-1
MULIFE.txt,991428,991514,86,5,N,N,-,-1,-1
MULIFE.txt,991515,991640,125,5,N,N,-,-1,-1
MULIFE.txt,991641,991705,64,5,N,N,-,-1,-1
MULIFE.txt,991708,991832,124,5,N,N,-,-1,-1
MULIFE.txt,991833,991919,86,5,N,N,-,-1,-1
MULIFE.txt,991920,992014,94,5,N,N,-,-1,-1
MULIFE.txt,992015,992180,165,5,N,N,-,-1,-1
MULIFE.txt,992182,992285,103,5,N,N,-,-1,-1
MULIFE.txt,992286,992553,267,5,N,N,-,-1,-1
MULIFE.txt,992554,992713,159,5,N,N,-,-1,-1
MULIFE.txt,992714,992756,42,5,N,N,-,-1,-1
MULIFE.txt,992757,992848,91,5,N,N,-,-1,-1
MULIFE.txt,992850,992962,112,5,N,N,-,-1,-1
MULIFE.txt,992967,993047,80,5,N,N,-,-1,-1
MULIFE.txt,993048,993119,71,5,N,N,-,-1,-1
MULIFE.txt,993119,993162,43,5,N,N,-,-1,-1
MULIFE.txt,993164,993212,48,5,N,N,-,-1,-1
MULIFE.txt,993213,993258,45,5,N,N,-,-1,-1
MULIFE.txt,993260,993428,168,5,N,N,-,-1,-1
MULIFE.txt,993429,993507,78,5,N,N,-,-1,-1
MULIFE.txt,993510,993550,40,5,N,N,-,-1,-1
MULIFE.txt,993553,993664,111,5,N,N,-,-1,-1
MULIFE.txt,993665,993852,187,5,N,N,-,-1,-1
MULIFE.txt,993855,993938,83,5,N,N,-,-1,-1
MULIFE.txt,993939,994007,68,5,N,N,-,-1,-1
MULIFE.txt,994008,994058,50,5,N,N,-,-1,-1
MULIFE.txt,994059,994163,104,5,N,N,-,-1,-1
MULIFE.txt,994164,994203,39,5,N,N,-,-1,-1
MULIFE.txt,994204,994246,42,5,N,N,-,-1,-1
MULIFE.txt,994247,994305,58,5,N,N,-,-1,-1
MULIFE.txt,994306,994359,53,5,N,N,-,-1,-1
MULIFE.txt,994360,994423,63,5,N,N,-,-1,-1
MULIFE.txt,994426,994560,134,5,N,N,-,-1,-1
MULIFE.txt,994561,994620,59,5,N,N,-,-1,-1
MULIFE.txt,994621,994731,110,5,N,N,-,-1,-1
MULIFE.txt,994732,994886,154,5,N,N,-,-1,-1
MULIFE.txt,994887,994968,81,5,N,N,-,-1,-1
MULIFE.txt,994969,995041,72,5,N,N,-,-1,-1
MULIFE.txt,995042,995131,89,5,N,N,-,-1,-1
MULIFE.txt,995132,995177,45,5,N,N,-,-1,-1
MULIFE.txt,995178,995311,133,5,N,N,-,-1,-1
MULIFE.txt,995313,995418,105,5,N,N,-,-1,-1
MULIFE.txt,995421,995574,153,5,N,N,-,-1,-1
MULIFE.txt,995577,995649,72,5,N,N,-,-1,-1
MULIFE.txt,995650,995726,76,5,N,N,-,-1,-1
MULIFE.txt,995727,995790,63,5,N,N,-,-1,-1
MULIFE.txt,995793,995934,141,5,N,N,-,-1,-1
MULIFE.txt,995937,996062,125,5,N,N,-,-1,-1
MULIFE.txt,996063,996164,101,5,N,N,-,-1,-1
MULIFE.txt,996165,996247,82,5,N,N,-,-1,-1
MULIFE.txt,996248,996462,214,5,N,N,-,-1,-1
MULIFE.txt,996463,996693,230,5,N,N,-,-1,-1
MULIFE.txt,996695,996996,301,5,N,N,-,-1,-1
MULIFE.txt,996997,997028,31,5,N,N,-,-1,-1
MULIFE.txt,997031,997178,147,5,N,N,-,-1,-1
MULIFE.txt,997179,997293,114,5,N,N,-,-1,-1
MULIFE.txt,997295,997349,54,5,N,N,-,-1,-1
MULIFE.txt,997350,997577,227,5,N,N,-,-1,-1
MULIFE.txt,997579,997653,74,5,N,N,-,-1,-1
MULIFE.txt,997654,997727,73,5,N,N,-,-1,-1
MULIFE.txt,997728,997827,99,5,N,N,-,-1,-1
MULIFE.txt,997828,997955,127,5,N,N,-,-1,-1
MULIFE.txt,997956,998113,157,5,N,N,-,-1,-1
MULIFE.txt,998114,998166,52,5,N,N,-,-1,-1
MULIFE.txt,998167,998258,91,5,N,N,-,-1,-1
MULIFE.txt,998263,998416,153,5,N,N,-,-1,-1
MULIFE.txt,998421,998605,184,5,N,N,-,-1,-1
MULIFE.txt,998607,998684,77,5,N,N,-,-1,-1
MULIFE.txt,998684,998837,153,5,N,N,-,-1,-1
MULIFE.txt,998838,998988,150,5,N,N,-,-1,-1
MULIFE.txt,998991,999099,108,5,N,N,-,-1,-1
MULIFE.txt,999099,999163,64,5,N,N,-,-1,-1
MULIFE.txt,999164,999204,40,5,N,N,-,-1,-1
MULIFE.txt,999206,999314,108,5,N,N,-,-1,-1
MULIFE.txt,999314,999463,149,5,N,N,-,-1,-1
MULIFE.txt,999464,999653,189,5,N,N,-,-1,-1
MULIFE.txt,999654,999715,61,5,N,N,-,-1,-1
MULIFE.txt,999716,999768,52,5,N,N,-,-1,-1
MULIFE.txt,999768,999817,49,5,N,N,-,-1,-1
MULIFE.txt,999818,1000004,186,5,N,N,-,-1,-1
MULIFE.txt,1000009,1000153,144,5,N,N,-,-1,-1
MULIFE.txt,1000154,1000278,124,5,N,N,-,-1,-1
MULIFE.txt,1000279,1000346,67,5,N,N,-,-1,-1
MULIFE.txt,1000347,1000435,88,5,N,N,-,-1,-1
MULIFE.txt,1000437,1000484,47,5,N,N,-,-1,-1
MULIFE.txt,1000485,1000608,123,5,N,N,-,-1,-1
MULIFE.txt,1000609,1000815,206,5,N,N,-,-1,-1
MULIFE.txt,1000816,1001108,292,5,N,N,-,-1,-1
MULIFE.txt,1001109,1001152,43,5,N,N,-,-1,-1
MULIFE.txt,1001153,1001297,144,5,N,N,-,-1,-1
MULIFE.txt,1001298,1001374,76,5,N,N,-,-1,-1
MULIFE.txt,1001377,1001461,84,5,N,N,-,-1,-1
MULIFE.txt,1001464,1001527,63,5,N,N,-,-1,-1
MULIFE.txt,1001528,1001575,47,5,N,N,-,-1,-1
MULIFE.txt,1001576,1001714,138,5,N,N,-,-1,-1
MULIFE.txt,1001715,1001760,45,5,N,N,-,-1,-1
MULIFE.txt,1001761,1001884,123,5,N,N,-,-1,-1
MULIFE.txt,1001885,1001956,71,5,N,N,-,-1,-1
MULIFE.txt,1001957,1001995,38,5,N,N,-,-1,-1
MULIFE.txt,1001996,1002127,131,5,N,N,-,-1,-1
MULIFE.txt,1002128,1002256,128,5,N,N,-,-1,-1
MULIFE.txt,1002257,1002376,119,5,N,N,-,-1,-1
MULIFE.txt,1002379,1002504,125,5,N,N,-,-1,-1
MULIFE.txt,1002507,1002650,143,5,N,N,-,-1,-1
MULIFE.txt,1002651,1002796,145,5,N,N,-,-1,-1
MULIFE.txt,1002797,1002897,100,5,N,N,-,-1,-1
MULIFE.txt,1002898,1003041,143,5,N,N,-,-1,-1
MULIFE.txt,1003042,1003088,46,5,N,N,-,-1,-1
MULIFE.txt,1003089,1003129,40,5,N,N,-,-1,-1
MULIFE.txt,1003130,1003189,59,5,N,N,-,-1,-1
MULIFE.txt,1003190,1003233,43,5,N,N,-,-1,-1
MULIFE.txt,1003236,1003327,91,5,N,N,-,-1,-1
MULIFE.txt,1003328,1003414,86,5,N,N,-,-1,-1
MULIFE.txt,1003415,1003456,41,5,N,N,-,-1,-1
MULIFE.txt,1003457,1003590,133,5,N,N,-,-1,-1
MULIFE.txt,1003591,1003705,114,5,N,N,-,-1,-1
MULIFE.txt,1003706,1003835,129,5,N,N,-,-1,-1
MULIFE.txt,1003836,1004042,206,5,N,N,-,-1,-1
MULIFE.txt,1004043,1004104,61,5,N,N,-,-1,-1
MULIFE.txt,1004105,1004269,164,5,N,N,-,-1,-1
MULIFE.txt,1004270,1004436,166,5,N,N,-,-1,-1
MULIFE.txt,1004437,1004559,122,5,N,N,-,-1,-1
MULIFE.txt,1004560,1004659,99,5,N,N,-,-1,-1
MULIFE.txt,1004660,1004825,165,5,N,N,-,-1,-1
MULIFE.txt,1004826,1004959,133,5,N,N,-,-1,-1
MULIFE.txt,1004962,1005055,93,5,N,N,-,-1,-1
MULIFE.txt,1005056,1005217,161,5,N,N,-,-1,-1
MULIFE.txt,1005218,1005366,148,5,N,N,-,-1,-1
MULIFE.txt,1005368,1005531,163,5,N,N,-,-1,-1
MULIFE.txt,1005532,1005682,150,5,N,N,-,-1,-1
MULIFE.txt,1005683,1005766,83,5,N,N,-,-1,-1
MULIFE.txt,1005767,1005874,107,5,N,N,-,-1,-1
MULIFE.txt,1005875,1005982,107,5,N,N,-,-1,-1
MULIFE.txt,1005983,1006118,135,5,N,N,-,-1,-1
MULIFE.txt,1006120,1006220,100,5,N,N,-,-1,-1
MULIFE.txt,1006225,1006343,118,5,N,N,-,-1,-1
MULIFE.txt,1006348,1006472,124,5,N,N,-,-1,-1
MULIFE.txt,1006473,1006562,89,5,N,N,-,-1,-1
MULIFE.txt,1006563,1006641,78,5,N,N,-,-1,-1
MULIFE.txt,1006642,1006776,134,5,N,N,-,-1,-1
MULIFE.txt,1006777,1006942,165,5,N,N,-,-1,-1
MULIFE.txt,1006943,1007114,171,5,N,N,-,-1,-1
MULIFE.txt,1007114,1007245,131,5,N,N,-,-1,-1
MULIFE.txt,1007246,1007350,104,5,N,N,-,-1,-1
MULIFE.txt,1007351,1007566,215,5,N,N,-,-1,-1
MULIFE.txt,1007567,1007621,54,5,N,N,-,-1,-1
MULIFE.txt,1007623,1007766,143,5,N,N,-,-1,-1
MULIFE.txt,1007769,1007858,89,5,N,N,-,-1,-1
MULIFE.txt,1007859,1007930,71,5,N,N,-,-1,-1
MULIFE.txt,1007931,1008028,97,5,N,N,-,-1,-1
MULIFE.txt,1008031,1008099,68,5,N,N,-,-1,-1
MULIFE.txt,1008099,1008157,58,5,N,N,-,-1,-1
MULIFE.txt,1008158,1008259,101,5,N,N,-,-1,-1
MULIFE.txt,1008260,1008325,65,5,N,N,-,-1,-1
MULIFE.txt,1008326,1008431,105,5,N,N,-,-1,-1
MULIFE.txt,1008431,1008498,67,5,N,N,-,-1,-1
MULIFE.txt,1008500,1008631,131,5,N,N,-,-1,-1
MULIFE.txt,1008632,1008657,25,5,N,N,-,-1,-1
MULIFE.txt,1008658,1008847,189,5,N,N,-,-1,-1
MULIFE.txt,1008848,1008996,148,5,N,N,-,-1,-1
MULIFE.txt,1008999,1009306,307,5,N,N,-,-1,-1
MULIFE.txt,1009308,1009478,170,5,N,N,-,-1,-1
MULIFE.txt,1009479,1009546,67,5,N,N,-,-1,-1
MULIFE.txt,1009547,1009656,109,5,N,N,-,-1,-1
MULIFE.txt,1009658,1009719,61,5,N,N,-,-1,-1
MULIFE.txt,1009720,1009849,129,5,N,N,-,-1,-1
MULIFE.txt,1009850,1009900,50,5,N,N,-,-1,-1
MULIFE.txt,1009901,1010000,99,5,N,N,-,-1,-1
MULIFE.txt,1010001,1010093,92,5,N,N,-,-1,-1
MULIFE.txt,1010094,1010124,30,5,N,N,-,-1,-1
MULIFE.txt,1010125,1010222,97,5,N,N,-,-1,-1
MULIFE.txt,1010223,1010354,131,5,N,N,-,-1,-1
MULIFE.txt,1010357,1010555,198,5,N,N,-,-1,-1
MULIFE.txt,1010556,1010779,223,5,N,N,-,-1,-1
MULIFE.txt,1010780,1010831,51,5,N,N,-,-1,-1
MULIFE.txt,1010833,1010901,68,5,N,N,-,-1,-1
MULIFE.txt,1010901,1010921,20,5,N,N,-,-1,-1
MULIFE.txt,1010922,1011079,157,5,N,N,-,-1,-1
MULIFE.txt,1011084,1011347,263,5,N,N,-,-1,-1
MULIFE.txt,1011348,1011548,200,5,N,N,-,-1,-1
MULIFE.txt,1011549,1011771,222,5,N,N,-,-1,-1
MULIFE.txt,1011772,1011921,149,5,N,N,-,-1,-1
MULIFE.txt,1011923,1012137,214,5,N,N,-,-1,-1
MULIFE.txt,1012138,1012209,71,5,N,N,-,-1,-1
MULIFE.txt,1012214,1012282,68,5,N,N,-,-1,-1
MULIFE.txt,1012283,1012384,101,5,N,N,-,-1,-1
MULIFE.txt,1012389,1012502,113,5,N,N,-,-1,-1
MULIFE.txt,1012503,1012571,68,5,N,N,-,-1,-1
MULIFE.txt,1012572,1012675,103,5,N,N,-,-1,-1
MULIFE.txt,1012678,1012801,123,5,N,N,-,-1,-1
MULIFE.txt,1012802,1012988,186,5,N,N,-,-1,-1
MULIFE.txt,1012989,1013312,323,5,N,N,-,-1,-1
MULIFE.txt,1013313,1013467,154,5,N,N,-,-1,-1
MULIFE.txt,1013468,1013667,199,5,N,N,-,-1,-1
MULIFE.txt,1013668,1013728,60,5,N,N,-,-1,-1
MULIFE.txt,1013729,1013907,178,5,N,N,-,-1,-1
MULIFE.txt,1013908,1014123,215,5,N,N,-,-1,-1
MULIFE.txt,1014124,1014268,144,5,N,N,-,-1,-1
MULIFE.txt,1014273,1014399,126,5,N,N,-,-1,-1
MULIFE.txt,1014399,1014602,203,5,N,N,-,-1,-1
MULIFE.txt,1014603,1014796,193,5,N,N,-,-1,-1
MULIFE.txt,1014797,1014943,146,5,N,N,-,-1,-1
MULIFE.txt,1014945,1015027,82,5,N,N,-,-1,-1
MULIFE.txt,1015028,1015233,205,5,N,N,-,-1,-1
MULIFE.txt,1015234,1015370,136,5,N,N,-,-1,-1
MULIFE.txt,1015371,1015585,214,5,N,N,-,-1,-1
MULIFE.txt,1015586,1015648,62,5,N,N,-,-1,-1
MULIFE.txt,1015649,1015964,315,5,N,N,-,-1,-1
MULIFE.txt,1015965,1015994,29,5,N,N,-,-1,-1
MULIFE.txt,1015995,1016126,131,5,N,N,-,-1,-1
MULIFE.txt,1016131,1016374,243,5,N,N,-,-1,-1
MULIFE.txt,1016375,1016584,209,5,N,N,-,-1,-1
MULIFE.txt,1016585,1016657,72,5,N,N,-,-1,-1
MULIFE.txt,1016658,1016869,211,5,N,N,-,-1,-1
MULIFE.txt,1016870,1017084,214,5,N,N,-,-1,-1
MULIFE.txt,1017085,1017301,216,5,N,N,-,-1,-1
MULIFE.txt,1017302,1017503,201,5,N,N,-,-1,-1
MULIFE.txt,1017504,1017644,140,5,N,N,-,-1,-1
MULIFE.txt,1017645,1017747,102,5,N,N,-,-1,-1
MULIFE.txt,1017750,1017961,211,5,N,N,-,-1,-1
MULIFE.txt,1017962,1017993,31,5,N,N,-,-1,-1
MULIFE.txt,1017993,1018180,187,5,N,N,-,-1,-1
MULIFE.txt,1018181,1018396,215,5,N,N,-,-1,-1
MULIFE.txt,1018397,1018430,33,5,N,N,-,-1,-1
MULIFE.txt,1018431,1018580,149,5,N,N,-,-1,-1
MULIFE.txt,1018581,1018854,273,5,N,N,-,-1,-1
MULIFE.txt,1018855,1018991,136,5,N,N,-,-1,-1
MULIFE.txt,1018991,1019186,195,5,N,N,-,-1,-1
MULIFE.txt,1019189,1019444,255,5,N,N,-,-1,-1
MULIFE.txt,1019449,1019614,165,5,N,N,-,-1,-1
MULIFE.txt,1019615,1019796,181,5,N,N,-,-1,-1
MULIFE.txt,1019797,1020019,222,5,N,N,-,-1,-1
MULIFE.txt,1020020,1020232,212,5,N,N,-,-1,-1
MULIFE.txt,1020233,1020427,194,5,N,N,-,-1,-1
MULIFE.txt,1020428,1020675,247,5,N,N,-,-1,-1
MULIFE.txt,1020676,1020840,164,5,N,N,-,-1,-1
MULIFE.txt,1020843,1021042,199,5,N,N,-,-1,-1
MULIFE.txt,1021043,1021130,87,5,N,N,-,-1,-1
MULIFE.txt,1021132,1021250,118,5,N,N,-,-1,-1
MULIFE.txt,1021250,1021437,187,5,N,N,-,-1,-1
MULIFE.txt,1021438,1021572,134,5,N,N,-,-1,-1
MULIFE.txt,1021573,1021759,186,5,N,N,-,-1,-1
MULIFE.txt,1021759,1021878,119,5,N,N,-,-1,-1
MULIFE.txt,1021879,1022053,174,5,N,N,-,-1,-1
MULIFE.txt,1022054,1022134,80,5,N,N,-,-1,-1
MULIFE.txt,1022135,1022351,216,5,N,N,-,-1,-1
MULIFE.txt,1022352,1022489,137,5,N,N,-,-1,-1
MULIFE.txt,1022492,1022828,336,5,N,N,-,-1,-1
MULIFE.txt,1022829,1023008,179,5,N,N,-,-1,-1
MULIFE.txt,1023009,1023152,143,5,N,N,-,-1,-1
MULIFE.txt,1023153,1023196,43,5,N,N,-,-1,-1
MULIFE.txt,1023196,1023303,107,5,N,N,-,-1,-1
MULIFE.txt,1023304,1023543,239,5,N,N,-,-1,-1
MULIFE.txt,1023544,1023681,137,5,N,N,-,-1,-1
MULIFE.txt,1023684,1023817,133,5,N,N,-,-1,-1
MULIFE.txt,1023820,1024048,228,5,N,N,-,-1,-1
MULIFE.txt,1024049,1024104,55,5,N,N,-,-1,-1
MULIFE.txt,1024105,1024169,64,5,N,N,-,-1,-1
MULIFE.txt,1024172,1024330,158,5,N,N,-,-1,-1
MULIFE.txt,1024333,1024504,171,5,N,N,-,-1,-1
MULIFE.txt,1024505,1024579,74,5,N,N,-,-1,-1
MULIFE.txt,1024580,1024779,199,5,N,N,-,-1,-1
MULIFE.txt,1024781,1024943,162,5,N,N,-,-1,-1
MULIFE.txt,1024943,1025125,182,5,N,N,-,-1,-1
MULIFE.txt,1025126,1025196,70,5,N,N,-,-1,-1
MULIFE.txt,1025196,1025278,82,5,N,N,-,-1,-1
MULIFE.txt,1025279,1025290,11,5,N,N,-,-1,-1
MULIFE.txt,1025291,1025411,120,5,N,N,-,-1,-1
MULIFE.txt,1025412,1025455,43,5,N,N,-,-1,-1
MULIFE.txt,1025458,1025623,165,5,N,N,-,-1,-1
MULIFE.txt,1025624,1025909,285,5,N,N,-,-1,-1
MULIFE.txt,1025910,1025985,75,5,N,N,-,-1,-1
MULIFE.txt,1025986,1026044,58,5,N,N,-,-1,-1
MULIFE.txt,1026045,1026165,120,5,N,N,-,-1,-1
MULIFE.txt,1026166,1026384,218,5,N,N,-,-1,-1
MULIFE.txt,1026385,1026457,72,5,N,N,-,-1,-1
MULIFE.txt,1026458,1026658,200,5,N,N,-,-1,-1
MULIFE.txt,1026659,1026753,94,5,N,N,-,-1,-1
MULIFE.txt,1026754,1026878,124,5,N,N,-,-1,-1
MULIFE.txt,1026881,1027031,150,5,N,N,-,-1,-1
MULIFE.txt,1027032,1027156,124,5,N,N,-,-1,-1
MULIFE.txt,1027157,1027209,52,5,N,N,-,-1,-1
MULIFE.txt,1027210,1027297,87,5,N,N,-,-1,-1
MULIFE.txt,1027299,1027435,136,5,N,N,-,-1,-1
MULIFE.txt,1027436,1027540,104,5,N,N,-,-1,-1
MULIFE.txt,1027543,1027609,66,5,N,N,-,-1,-1
MULIFE.txt,1027610,1027733,123,5,N,N,-,-1,-1
MULIFE.txt,1027734,1027757,23,5,N,N,-,-1,-1
MULIFE.txt,1027760,1027868,108,5,N,N,-,-1,-1
MULIFE.txt,1027871,1027958,87,5,N,N,-,-1,-1
MULIFE.txt,1027961,1028059,98,5,N,N,-,-1,-1
MULIFE.txt,1028060,1028133,73,5,N,N,-,-1,-1
MULIFE.txt,1028134,1028193,59,5,N,N,-,-1,-1
MULIFE.txt,1028195,1028299,104,5,N,N,-,-1,-1
MULIFE.txt,1028301,1028523,222,5,N,N,-,-1,-1
MULIFE.txt,1028524,1028783,259,5,N,N,-,-1,-1
MULIFE.txt,1028786,1028917,131,5,N,N,-,-1,-1
MULIFE.txt,1028918,1029005,87,5,N,N,-,-1,-1
MULIFE.txt,1029006,1029043,37,5,N,N,-,-1,-1
MULIFE.txt,1029044,1029201,157,5,N,N,-,-1,-1
MULIFE.txt,1029202,1029317,115,5,N,N,-,-1,-1
MULIFE.txt,1029319,1029427,108,5,N,N,-,-1,-1
MULIFE.txt,1029428,1029480,52,5,N,N,-,-1,-1
MULIFE.txt,1029481,1029596,115,5,N,N,-,-1,-1
MULIFE.txt,1029597,1029676,79,5,N,N,-,-1,-1
MULIFE.txt,1029679,1029703,24,5,N,N,-,-1,-1
MULIFE.txt,1029704,1029826,122,5,N,N,-,-1,-1
MULIFE.txt,1029827,1029880,53,5,N,N,-,-1,-1
MULIFE.txt,1029883,1030009,126,5,N,N,-,-1,-1
MULIFE.txt,1030014,1030305,291,5,N,N,-,-1,-1
MULIFE.txt,1030308,1030463,155,5,N,N,-,-1,-1
MULIFE.txt,1030466,1030692,226,5,N,N,-,-1,-1
MULIFE.txt,1030693,1030799,106,5,N,N,-,-1,-1
MULIFE.txt,1030800,1030900,100,5,N,N,-,-1,-1
MULIFE.txt,1030901,1031052,151,5,N,N,-,-1,-1
MULIFE.txt,1031055,1031226,171,5,N,N,-,-1,-1
MULIFE.txt,1031229,1031316,87,5,N,N,-,-1,-1
MULIFE.txt,1031317,1031412,95,5,N,N,-,-1,-1
MULIFE.txt,1031413,1031484,71,5,N,N,-,-1,-1
MULIFE.txt,1031485,1031619,134,5,N,N,-,-1,-1
MULIFE.txt,1031621,1031722,101,5,N,N,-,-1,-1
MULIFE.txt,1031723,1031802,79,5,N,N,-,-1,-1
MULIFE.txt,1031805,1031855,50,5,N,N,-,-1,-1
MULIFE.txt,1031856,1031949,93,5,N,N,-,-1,-1
MULIFE.txt,1031950,1031998,48,5,N,N,-,-1,-1
MULIFE.txt,1032001,1032126,125,5,N,N,-,-1,-1
MULIFE.txt,1032127,1032232,105,5,N,N,-,-1,-1
MULIFE.txt,1032233,1032399,166,5,N,N,-,-1,-1
MULIFE.txt,1032401,1032468,67,5,N,N,-,-1,-1
MULIFE.txt,1032471,1032561,90,5,N,N,-,-1,-1
MULIFE.txt,1032562,1032639,77,5,N,N,-,-1,-1
MULIFE.txt,1032640,1032767,127,5,N,N,-,-1,-1
MULIFE.txt,1032768,1032826,58,5,N,N,-,-1,-1
MULIFE.txt,1032827,1032937,110,5,N,N,-,-1,-1
MULIFE.txt,1032938,1033081,143,5,N,N,-,-1,-1
MULIFE.txt,1033084,1033198,114,5,N,N,-,-1,-1
MULIFE.txt,1033199,1033464,265,5,N,N,-,-1,-1
MULIFE.txt,1033466,1033517,51,5,N,N,-,-1,-1
MULIFE.txt,1033520,1033557,37,5,N,N,-,-1,-1
MULIFE.txt,1033559,1033624,65,5,N,N,-,-1,-1
MULIFE.txt,1033627,1033841,214,5,N,N,-,-1,-1
MULIFE.txt,1033842,1033929,87,5,N,N,-,-1,-1
MULIFE.txt,1033931,1034109,178,5,N,N,-,-1,-1
MULIFE.txt,1034112,1034244,132,5,N,N,-,-1,-1
MULIFE.txt,1034244,1034368,124,5,N,N,-,-1,-1
MULIFE.txt,1034369,1034416,47,5,N,N,-,-1,-1
MULIFE.txt,1034417,1034520,103,5,N,N,-,-1,-1
MULIFE.txt,1034520,1034625,105,5,N,N,-,-1,-1
MULIFE.txt,1034626,1034735,109,5,N,N,-,-1,-1
MULIFE.txt,1034738,1034849,111,5,N,N,-,-1,-1
MULIFE.txt,1034850,1034966,116,5,N,N,-,-1,-1
MULIFE.txt,1034967,1035067,100,5,N,N,-,-1,-1
MULIFE.txt,1035072,1035188,116,5,N,N,-,-1,-1
MULIFE.txt,1035193,1035338,145,5,N,N,-,-1,-1
MULIFE.txt,1035341,1035618,277,5,N,N,-,-1,-1
MULIFE.txt,1035619,1035672,53,5,N,N,-,-1,-1
MULIFE.txt,1035673,1035801,128,5,N,N,-,-1,-1
MULIFE.txt,1035806,1035912,106,5,N,N,-,-1,-1
MULIFE.txt,1035913,1035969,56,5,N,N,-,-1,-1
MULIFE.txt,1035970,1036052,82,5,N,N,-,-1,-1
MULIFE.txt,1036054,1036252,198,5,N,N,-,-1,-1
MULIFE.txt,1036253,1036407,154,5,N,N,-,-1,-1
MULIFE.txt,1036408,1036487,79,5,N,N,-,-1,-1
MULIFE.txt,1036489,1036576,87,5,N,N,-,-1,-1
MULIFE.txt,1036577,1036660,83,5,N,N,-,-1,-1
MULIFE.txt,1036662,1036754,92,5,N,N,-,-1,-1
MULIFE.txt,1036755,1036825,70,5,N,N,-,-1,-1
MULIFE.txt,1036826,1036894,68,5,N,N,-,-1,-1
MULIFE.txt,1036895,1036956,61,5,N,N,-,-1,-1
MULIFE.txt,1036958,1037035,77,5,N,N,-,-1,-1
MULIFE.txt,1037036,1037075,39,5,N,N,-,-1,-1
MULIFE.txt,1037076,1037125,49,5,N,N,-,-1,-1
MULIFE.txt,1037126,1037202,76,5,N,N,-,-1,-1
MULIFE.txt,1037203,1037267,64,5,N,N,-,-1,-1
MULIFE.txt,1037268,1037349,81,5,N,N,-,-1,-1
MULIFE.txt,1037350,1037541,191,5,N,N,-,-1,-1
MULIFE.txt,1037542,1037623,81,5,N,N,-,-1,-1
MULIFE.txt,1037625,1037676,51,5,N,N,-,-1,-1
MULIFE.txt,1037677,1037841,164,5,N,N,-,-1,-1
MULIFE.txt,1037844,1037965,121,5,N,N,-,-1,-1
MULIFE.txt,1037967,1038037,70,5,N,N,-,-1,-1
MULIFE.txt,1038037,1038095,58,5,N,N,-,-1,-1
MULIFE.txt,1038096,1038204,108,5,N,N,-,-1,-1
MULIFE.txt,1038206,1038315,109,5,N,N,-,-1,-1
MULIFE.txt,1038316,1038434,118,5,N,N,-,-1,-1
MULIFE.txt,1038435,1038568,133,5,N,N,-,-1,-1
MULIFE.txt,1038569,1038676,107,5,N,N,-,-1,-1
MULIFE.txt,1038679,1038799,120,5,N,N,-,-1,-1
MULIFE.txt,1038804,1039062,258,5,N,N,-,-1,-1
MULIFE.txt,1039063,1039255,192,5,N,N,-,-1,-1
MULIFE.txt,1039258,1039354,96,5,N,N,-,-1,-1
MULIFE.txt,1039355,1039481,126,5,N,N,-,-1,-1
MULIFE.txt,1039482,1039579,97,5,N,N,-,-1,-1
MULIFE.txt,1039580,1039647,67,5,N,N,-,-1,-1
MULIFE.txt,1039650,1039745,95,5,N,N,-,-1,-1
MULIFE.txt,1039750,1039959,209,5,N,N,-,-1,-1
MULIFE.txt,1039960,1040094,134,5,N,N,-,-1,-1
MULIFE.txt,1040095,1040122,27,5,N,N,-,-1,-1
MULIFE.txt,1040123,1040192,69,5,N,N,-,-1,-1
MULIFE.txt,1040193,1040234,41,5,N,N,-,-1,-1
MULIFE.txt,1040235,1040258,23,5,N,N,-,-1,-1
MULIFE.txt,1040259,1040366,107,5,N,N,-,-1,-1
MULIFE.txt,1040369,1040500,131,5,N,N,-,-1,-1
MULIFE.txt,1040501,1040671,170,5,N,N,-,-1,-1
MULIFE.txt,1040673,1040788,115,5,N,N,-,-1,-1
MULIFE.txt,1040789,1040837,48,5,N,N,-,-1,-1
MULIFE.txt,1040838,1040988,150,5,N,N,-,-1,-1
MULIFE.txt,1040989,1041086,97,5,N,N,-,-1,-1
MULIFE.txt,1041087,1041248,161,5,N,N,-,-1,-1
MULIFE.txt,1041250,1041445,195,5,N,N,-,-1,-1
MULIFE.txt,1041446,1041517,71,5,N,N,-,-1,-1
MULIFE.txt,1041520,1041664,144,5,N,N,-,-1,-1
MULIFE.txt,1041665,1041903,238,5,N,N,-,-1,-1
MULIFE.txt,1041905,1042028,123,5,N,N,-,-1,-1
MULIFE.txt,1042031,1042092,61,5,N,N,-,-1,-1
MULIFE.txt,1042093,1042174,81,5,N,N,-,-1,-1
MULIFE.txt,1042175,1042263,88,5,N,N,-,-1,-1
MULIFE.txt,1042264,1042372,108,5,N,N,-,-1,-1
MULIFE.txt,1042373,1042523,150,5,N,N,-,-1,-1
MULIFE.txt,1042524,1042674,150,5,N,N,-,-1,-1
MULIFE.txt,1042675,1042715,40,5,N,N,-,-1,-1
MULIFE.txt,1042716,1042836,120,5,N,N,-,-1,-1
MULIFE.txt,1042837,1042963,126,5,N,N,-,-1,-1
MULIFE.txt,1042964,1043061,97,5,N,N,-,-1,-1
MULIFE.txt,1043064,1043166,102,5,N,N,-,-1,-1
MULIFE.txt,1043167,1043351,184,5,N,N,-,-1,-1
MULIFE.txt,1043352,1043427,75,5,N,N,-,-1,-1
MULIFE.txt,1043432,1043532,100,5,N,N,-,-1,-1
MULIFE.txt,1043534,1043647,113,5,N,N,-,-1,-1
MULIFE.txt,1043648,1043724,76,5,N,N,-,-1,-1
MULIFE.txt,1043726,1043790,64,5,N,N,-,-1,-1
MULIFE.txt,1043793,1043846,53,5,N,N,-,-1,-1
MULIFE.txt,1043849,1043920,71,5,N,N,-,-1,-1
MULIFE.txt,1043922,1043984,62,5,N,N,-,-1,-1
MULIFE.txt,1043985,1044110,125,5,N,N,-,-1,-1
MULIFE.txt,1044111,1044230,119,5,N,N,-,-1,-1
MULIFE.txt,1044232,1044443,211,5,N,N,-,-1,-1
MULIFE.txt,1044444,1044557,113,5,N,N,-,-1,-1
MULIFE.txt,1044557,1044630,73,5,N,N,-,-1,-1
MULIFE.txt,1044631,1044782,151,5,N,N,-,-1,-1
MULIFE.txt,1044787,1045049,262,5,N,N,-,-1,-1
MULIFE.txt,1045050,1045108,58,5,N,N,-,-1,-1
MULIFE.txt,1045109,1045184,75,5,N,N,-,-1,-1
MULIFE.txt,1045185,1045283,98,5,N,N,-,-1,-1
MULIFE.txt,1045284,1045345,61,5,N,N,-,-1,-1
MULIFE.txt,1045348,1045392,44,5,N,N,-,-1,-1
MULIFE.txt,1045395,1045483,88,5,N,N,-,-1,-1
MULIFE.txt,1045483,1045623,140,5,N,N,-,-1,-1
MULIFE.txt,1045624,1045683,59,5,N,N,-,-1,-1
MULIFE.txt,1045684,1045759,75,5,N,N,-,-1,-1
MULIFE.txt,1045760,1045800,40,5,N,N,-,-1,-1
MULIFE.txt,1045802,1045848,46,5,N,N,-,-1,-1
MULIFE.txt,1045849,1045971,122,5,N,N,-,-1,-1
MULIFE.txt,1045972,1046020,48,5,N,N,-,-1,-1
MULIFE.txt,1046023,1046068,45,5,N,N,-,-1,-1
MULIFE.txt,1046069,1046132,63,5,N,N,-,-1,-1
MULIFE.txt,1046134,1046184,50,5,N,N,-,-1,-1
MULIFE.txt,1046185,1046298,113,5,N,N,-,-1,-1
MULIFE.txt,1046299,1046507,208,5,N,N,-,-1,-1
MULIFE.txt,1046508,1046673,165,5,N,N,-,-1,-1
MULIFE.txt,1046674,1046791,117,5,N,N,-,-1,-1
MULIFE.txt,1046792,1046877,85,5,N,N,-,-1,-1
MULIFE.txt,1046878,1046957,79,5,N,N,-,-1,-1
MULIFE.txt,1046958,1047030,72,5,N,N,-,-1,-1
MULIFE.txt,1047030,1047116,86,5,N,N,-,-1,-1
MULIFE.txt,1047117,1047190,73,5,N,N,-,-1,-1
MULIFE.txt,1047192,1047257,65,5,N,N,-,-1,-1
MULIFE.txt,1047258,1047410,152,5,N,N,-,-1,-1
MULIFE.txt,1047411,1047482,71,5,N,N,-,-1,-1
MULIFE.txt,1047485,1047625,140,5,N,N,-,-1,-1
MULIFE.txt,1047626,1047696,70,5,N,N,-,-1,-1
MULIFE.txt,1047697,1047760,63,5,N,N,-,-1,-1
MULIFE.txt,1047761,1047817,56,5,N,N,-,-1,-1
MULIFE.txt,1047820,1047998,178,5,N,N,-,-1,-1
MULIFE.txt,1047999,1048093,94,5,N,N,-,-1,-1
MULIFE.txt,1048094,1048218,124,5,N,N,-,-1,-1
MULIFE.txt,1048221,1048333,112,5,N,N,-,-1,-1
MULIFE.txt,1048334,1048564,230,5,N,N,-,-1,-1
MULIFE.txt,1048565,1048692,127,5,N,N,-,-1,-1
MULIFE.txt,1048693,1048801,108,5,N,N,-,-1,-1
MULIFE.txt,1048802,1048849,47,5,N,N,-,-1,-1
MULIFE.txt,1048850,1049045,195,5,N,N,-,-1,-1
MULIFE.txt,1049046,1049122,76,5,N,N,-,-1,-1
MULIFE.txt,1049123,1049255,132,5,N,N,-,-1,-1
MULIFE.txt,1049256,1049303,47,5,N,N,-,-1,-1
MULIFE.txt,1049306,1049456,150,5,N,N,-,-1,-1
MULIFE.txt,1049457,1049647,190,5,N,N,-,-1,-1
MULIFE.txt,1049648,1049738,90,5,N,N,-,-1,-1
MULIFE.txt,1049743,1049921,178,5,N,N,-,-1,-1
MULIFE.txt,1049922,1050043,121,5,N,N,-,-1,-1
MULIFE.txt,1050044,1050112,68,5,N,N,-,-1,-1
MULIFE.txt,1050115,1050236,121,5,N,N,-,-1,-1
MULIFE.txt,1050237,1050406,169,5,N,N,-,-1,-1
MULIFE.txt,1050407,1050516,109,5,N,N,-,-1,-1
MULIFE.txt,1050517,1050609,92,5,N,N,-,-1,-1
MULIFE.txt,1050612,1050717,105,5,N,N,-,-1,-1
MULIFE.txt,1050720,1050797,77,5,N,N,-,-1,-1
MULIFE.txt,1050800,1050938,138,5,N,N,-,-1,-1
MULIFE.txt,1050939,1051002,63,5,N,N,-,-1,-1
MULIFE.txt,1051003,1051078,75,5,N,N,-,-1,-1
MULIFE.txt,1051080,1051108,28,5,N,N,-,-1,-1
MULIFE.txt,1051108,1051288,180,5,N,N,-,-1,-1
MULIFE.txt,1051289,1051389,100,5,N,N,-,-1,-1
MULIFE.txt,1051390,1051459,69,5,N,N,-,-1,-1
MULIFE.txt,1051460,1051583,123,5,N,N,-,-1,-1
MULIFE.txt,1051584,1051677,93,5,N,N,-,-1,-1
MULIFE.txt,1051678,1051769,91,5,N,N,-,-1,-1
MULIFE.txt,1051770,1051873,103,5,N,N,-,-1,-1
MULIFE.txt,1051874,1052075,201,5,N,N,-,-1,-1
MULIFE.txt,1052076,1052182,106,5,N,N,-,-1,-1
MULIFE.txt,1052183,1052264,81,5,N,N,-,-1,-1
MULIFE.txt,1052265,1052304,39,5,N,N,-,-1,-1
MULIFE.txt,1052304,1052371,67,5,N,N,-,-1,-1
MULIFE.txt,1052372,1052423,51,5,N,N,-,-1,-1
MULIFE.txt,1052424,1052502,78,5,N,N,-,-1,-1
MULIFE.txt,1052505,1052600,95,5,N,N,-,-1,-1
MULIFE.txt,1052601,1052680,79,5,N,N,-,-1,-1
MULIFE.txt,1052680,1052724,44,5,N,N,-,-1,-1
MULIFE.txt,1052729,1052840,111,5,N,N,-,-1,-1
MULIFE.txt,1052843,1052910,67,5,N,N,-,-1,-1
MULIFE.txt,1052911,1052983,72,5,N,N,-,-1,-1
MULIFE.txt,1052984,1053069,85,5,N,N,-,-1,-1
MULIFE.txt,1053070,1053126,56,5,N,N,-,-1,-1
MULIFE.txt,1053128,1053210,82,5,N,N,-,-1,-1
MULIFE.txt,1053211,1053282,71,5,N,N,-,-1,-1
MULIFE.txt,1053285,1053352,67,5,N,N,-,-1,-1
MULIFE.txt,1053353,1053457,104,5,N,N,-,-1,-1
MULIFE.txt,1053460,1053530,70,5,N,N,-,-1,-1
MULIFE.txt,1053531,1053628,97,5,N,N,-,-1,-1
MULIFE.txt,1053629,1053719,90,5,N,N,-,-1,-1
MULIFE.txt,1053720,1053874,154,5,N,N,-,-1,-1
MULIFE.txt,1053875,1054002,127,5,N,N,-,-1,-1
MULIFE.txt,1054003,1054090,87,5,N,N,-,-1,-1
MULIFE.txt,1054092,1054238,146,5,N,N,-,-1,-1
MULIFE.txt,1054241,1054423,182,5,N,N,-,-1,-1
MULIFE.txt,1054424,1054496,72,5,N,N,-,-1,-1
MULIFE.txt,1054498,1054587,89,5,N,N,-,-1,-1
MULIFE.txt,1054588,1054612,24,5,N,N,-,-1,-1
MULIFE.txt,1054615,1054676,61,5,N,N,-,-1,-1
MULIFE.txt,1054677,1054726,49,5,N,N,-,-1,-1
MULIFE.txt,1054726,1054811,85,5,N,N,-,-1,-1
MULIFE.txt,1054812,1054897,85,5,N,N,-,-1,-1
MULIFE.txt,1054898,1055036,138,5,N,N,-,-1,-1
MULIFE.txt,1055037,1055181,144,5,N,N,-,-1,-1
MULIFE.txt,1055182,1055328,146,5,N,N,-,-1,-1
MULIFE.txt,1055328,1055425,97,5,N,N,-,-1,-1
MULIFE.txt,1055426,1055571,145,5,N,N,-,-1,-1
MULIFE.txt,1055574,1055661,87,5,N,N,-,-1,-1
MULIFE.txt,1055662,1055695,33,5,N,N,-,-1,-1
MULIFE.txt,1055696,1055786,90,5,N,N,-,-1,-1
MULIFE.txt,1055787,1055871,84,5,N,N,-,-1,-1
MULIFE.txt,1055873,1055968,95,5,N,N,-,-1,-1
MULIFE.txt,1055969,1056123,154,5,N,N,-,-1,-1
MULIFE.txt,1056124,1056365,241,5,N,N,-,-1,-1
MULIFE.txt,1056368,1056525,157,5,N,N,-,-1,-1
MULIFE.txt,1056526,1056664,138,5,N,N,-,-1,-1
MULIFE.txt,1056665,1056722,57,5,N,N,-,-1,-1
MULIFE.txt,1056724,1056896,172,5,N,N,-,-1,-1
MULIFE.txt,1056897,1056992,95,5,N,N,-,-1,-1
MULIFE.txt,1056994,1057090,96,5,N,N,-,-1,-1
MULIFE.txt,1057092,1057156,64,5,N,N,-,-1,-1
MULIFE.txt,1057157,1057286,129,5,N,N,-,-1,-1
MULIFE.txt,1057287,1057394,107,5,N,N,-,-1,-1
MULIFE.txt,1057396,1057446,50,5,N,N,-,-1,-1
MULIFE.txt,1057451,1057538,87,5,N,N,-,-1,-1
MULIFE.txt,1057539,1057670,131,5,N,N,-,-1,-1
MULIFE.txt,1057673,1057774,101,5,N,N,-,-1,-1
MULIFE.txt,1057775,1057909,134,5,N,N,-,-1,-1
MULIFE.txt,1057910,1057999,89,5,N,N,-,-1,-1
MULIFE.txt,1058002,1058168,166,5,N,N,-,-1,-1
MULIFE.txt,1058169,1058296,127,5,N,N,-,-1,-1
MULIFE.txt,1058297,1058357,60,5,N,N,-,-1,-1
MULIFE.txt,1058358,1058402,44,5,N,N,-,-1,-1
MULIFE.txt,1058403,1058463,60,5,N,N,-,-1,-1
MULIFE.txt,1058464,1058539,75,5,N,N,-,-1,-1
MULIFE.txt,1058542,1058610,68,5,N,N,-,-1,-1
MULIFE.txt,1058611,1058679,68,5,N,N,-,-1,-1
MULIFE.txt,1058680,1058743,63,5,N,N,-,-1,-1
MULIFE.txt,1058744,1058793,49,5,N,N,-,-1,-1
MULIFE.txt,1058796,1058852,56,5,N,N,-,-1,-1
MULIFE.txt,1058854,1058921,67,5,N,N,-,-1,-1
MULIFE.txt,1058922,1058983,61,5,N,N,-,-1,-1
MULIFE.txt,1058984,1059035,51,5,N,N,-,-1,-1
MULIFE.txt,1059038,1059080,42,5,N,N,-,-1,-1
MULIFE.txt,1059081,1059153,72,5,N,N,-,-1,-1
MULIFE.txt,1059154,1059216,62,5,N,N,-,-1,-1
MULIFE.txt,1059217,1059293,76,5,N,N,-,-1,-1
MULIFE.txt,1059294,1059366,72,5,N,N,-,-1,-1
MULIFE.txt,1059367,1059439,72,5,N,N,-,-1,-1
MULIFE.txt,1059440,1059511,71,5,N,N,-,-1,-1
MULIFE.txt,1059512,1059640,128,5,N,N,-,-1,-1
MULIFE.txt,1059643,1059845,202,5,N,N,-,-1,-1
MULIFE.txt,1059846,1059956,110,5,N,N,-,-1,-1
MULIFE.txt,1059957,1060035,78,5,N,N,-,-1,-1
MULIFE.txt,1060036,1060197,161,5,N,N,-,-1,-1
MULIFE.txt,1060198,1060321,123,5,N,N,-,-1,-1
MULIFE.txt,1060322,1060431,109,5,N,N,-,-1,-1
MULIFE.txt,1060432,1060606,174,5,N,N,-,-1,-1
MULIFE.txt,1060611,1060715,104,5,N,N,-,-1,-1
MULIFE.txt,1060716,1060824,108,5,N,N,-,-1,-1
MULIFE.txt,1060825,1060896,71,5,N,N,-,-1,-1
MULIFE.txt,1060897,1060965,68,5,N,N,-,-1,-1
MULIFE.txt,1060966,1061057,91,5,N,N,-,-1,-1
MULIFE.txt,1061059,1061175,116,5,N,N,-,-1,-1
MULIFE.txt,1061176,1061257,81,5,N,N,-,-1,-1
MULIFE.txt,1061258,1061327,69,5,N,N,-,-1,-1
MULIFE.txt,1061328,1061406,78,5,N,N,-,-1,-1
MULIFE.txt,1061407,1061486,79,5,N,N,-,-1,-1
MULIFE.txt,1061489,1061595,106,5,N,N,-,-1,-1
MULIFE.txt,1061596,1061661,65,5,N,N,-,-1,-1
MULIFE.txt,1061662,1061753,91,5,N,N,-,-1,-1
MULIFE.txt,1061756,1061972,216,5,N,N,-,-1,-1
MULIFE.txt,1061973,1062217,244,5,N,N,-,-1,-1
MULIFE.txt,1062219,1062317,98,5,N,N,-,-1,-1
MULIFE.txt,1062319,1062384,65,5,N,N,-,-1,-1
MULIFE.txt,1062385,1062485,100,5,N,N,-,-1,-1
MULIFE.txt,1062486,1062517,31,5,N,N,-,-1,-1
MULIFE.txt,1062518,1062735,217,5,N,N,-,-1,-1
MULIFE.txt,1062736,1062864,128,5,N,N,-,-1,-1
MULIFE.txt,1062867,1063049,182,5,N,N,-,-1,-1
MULIFE.txt,1063050,1063199,149,5,N,N,-,-1,-1
MULIFE.txt,1063202,1063324,122,5,N,N,-,-1,-1
MULIFE.txt,1063327,1063474,147,5,N,N,-,-1,-1
MULIFE.txt,1063477,1063564,87,5,N,N,-,-1,-1
MULIFE.txt,1063565,1063628,63,5,N,N,-,-1,-1
MULIFE.txt,1063629,1063725,96,5,N,N,-,-1,-1
MULIFE.txt,1063726,1063810,84,5,N,N,-,-1,-1
MULIFE.txt,1063811,1063882,71,5,N,N,-,-1,-1
MULIFE.txt,1063883,1063961,78,5,N,N,-,-1,-1
MULIFE.txt,1063962,1064038,76,5,N,N,-,-1,-1
MULIFE.txt,1064043,1064167,124,5,N,N,-,-1,-1
MULIFE.txt,1064168,1064314,146,5,N,N,-,-1,-1
MULIFE.txt,1064317,1064426,109,5,N,N,-,-1,-1
MULIFE.txt,1064427,1064541,114,5,N,N,-,-1,-1
MULIFE.txt,1064542,1064679,137,5,N,N,-,-1,-1
MULIFE.txt,1064679,1064750,71,5,N,N,-,-1,-1
MULIFE.txt,1064752,1064857,105,5,N,N,-,-1,-1
MULIFE.txt,1064859,1065003,144,5,N,N,-,-1,-1
MULIFE.txt,1065006,1065074,68,5,N,N,-,-1,-1
MULIFE.txt,1065075,1065391,316,5,N,N,-,-1,-1
MULIFE.txt,1065394,1065611,217,5,N,N,-,-1,-1
MULIFE.txt,1065616,1065742,126,5,N,N,-,-1,-1
MULIFE.txt,1065743,1065840,97,5,N,N,-,-1,-1
MULIFE.txt,1065843,1065981,138,5,N,N,-,-1,-1
MULIFE.txt,1065982,1066087,105,5,N,N,-,-1,-1
MULIFE.txt,1066090,1066207,117,5,N,N,-,-1,-1
MULIFE.txt,1066210,1066321,111,5,N,N,-,-1,-1
MULIFE.txt,1066322,1066432,110,5,N,N,-,-1,-1
MULIFE.txt,1066435,1066539,104,5,N,N,-,-1,-1
MULIFE.txt,1066544,1066628,84,5,N,N,-,-1,-1
MULIFE.txt,1066629,1066719,90,5,N,N,-,-1,-1
MULIFE.txt,1066720,1066849,129,5,N,N,-,-1,-1
MULIFE.txt,1066850,1066931,81,5,N,N,-,-1,-1
MULIFE.txt,1066933,1067013,80,5,N,N,-,-1,-1
MULIFE.txt,1067014,1067107,93,5,N,N,-,-1,-1
MULIFE.txt,1067108,1067215,107,5,N,N,-,-1,-1
MULIFE.txt,1067217,1067326,109,5,N,N,-,-1,-1
MULIFE.txt,1067327,1067424,97,5,N,N,-,-1,-1
MULIFE.txt,1067429,1067524,95,5,N,N,-,-1,-1
MULIFE.txt,1067525,1067623,98,5,N,N,-,-1,-1
MULIFE.txt,1067624,1067695,71,5,N,N,-,-1,-1
MULIFE.txt,1067696,1067856,160,5,N,N,-,-1,-1
MULIFE.txt,1067857,1068042,185,5,N,N,-,-1,-1
MULIFE.txt,1068043,1068128,85,5,N,N,-,-1,-1
MULIFE.txt,1068129,1068298,169,5,N,N,-,-1,-1
MULIFE.txt,1068299,1068433,134,5,N,N,-,-1,-1
MULIFE.txt,1068436,1068551,115,5,N,N,-,-1,-1
MULIFE.txt,1068554,1068645,91,5,N,N,-,-1,-1
MULIFE.txt,1068646,1068766,120,5,N,N,-,-1,-1
MULIFE.txt,1068769,1068884,115,5,N,N,-,-1,-1
MULIFE.txt,1068887,1068991,104,5,N,N,-,-1,-1
MULIFE.txt,1068992,1069073,81,5,N,N,-,-1,-1
MULIFE.txt,1069076,1069222,146,5,N,N,-,-1,-1
MULIFE.txt,1069225,1069387,162,5,N,N,-,-1,-1
MULIFE.txt,1069388,1069546,158,5,N,N,-,-1,-1
MULIFE.txt,1069549,1069703,154,5,N,N,-,-1,-1
MULIFE.txt,1069704,1069833,129,5,N,N,-,-1,-1
MULIFE.txt,1069836,1070048,212,5,N,N,-,-1,-1
MULIFE.txt,1070049,1070166,117,5,N,N,-,-1,-1
MULIFE.txt,1070167,1070335,168,5,N,N,-,-1,-1
MULIFE.txt,1070336,1070535,199,5,N,N,-,-1,-1
MULIFE.txt,1070537,1070670,133,5,N,N,-,-1,-1
MULIFE.txt,1070673,1070748,75,5,N,N,-,-1,-1
MULIFE.txt,1070748,1070834,86,5,N,N,-,-1,-1
MULIFE.txt,1070836,1070965,129,5,N,N,-,-1,-1
MULIFE.txt,1070966,1071000,34,5,N,N,-,-1,-1
MULIFE.txt,1071002,1071183,181,5,N,N,-,-1,-1
MULIFE.txt,1071184,1071220,36,5,N,N,-,-1,-1
MULIFE.txt,1071222,1071363,141,5,N,N,-,-1,-1
MULIFE.txt,1071365,1071567,202,5,N,N,-,-1,-1
MULIFE.txt,1071568,1071658,90,5,N,N,-,-1,-1
MULIFE.txt,1071660,1071838,178,5,N,N,-,-1,-1
MULIFE.txt,1071840,1071969,129,5,N,N,-,-1,-1
MULIFE.txt,1071971,1072074,103,5,N,N,-,-1,-1
MULIFE.txt,1072075,1072245,170,5,N,N,-,-1,-1
MULIFE.txt,1072246,1072323,77,5,N,N,-,-1,-1
MULIFE.txt,1072325,1072484,159,5,N,N,-,-1,-1
MULIFE.txt,1072485,1072577,92,5,N,N,-,-1,-1
MULIFE.txt,1072579,1072674,95,5,N,N,-,-1,-1
MULIFE.txt,1072677,1072892,215,5,N,N,-,-1,-1
MULIFE.txt,1072893,1072940,47,5,N,N,-,-1,-1
MULIFE.txt,1072943,1073065,122,5,N,N,-,-1,-1
MULIFE.txt,1073068,1073220,152,5,N,N,-,-1,-1
MULIFE.txt,1073223,1073382,159,5,N,N,-,-1,-1
MULIFE.txt,1073384,1073542,158,5,N,N,-,-1,-1
MULIFE.txt,1073545,1073769,224,5,N,N,-,-1,-1
MULIFE.txt,1073771,1074101,330,5,N,N,-,-1,-1
MULIFE.txt,1074102,1074285,183,5,N,N,-,-1,-1
MULIFE.txt,1074286,1074471,185,5,N,N,-,-1,-1
MULIFE.txt,1074476,1074714,238,5,N,N,-,-1,-1
MULIFE.txt,1074715,1074891,176,5,N,N,-,-1,-1
MULIFE.txt,1074894,1074985,91,5,N,N,-,-1,-1
MULIFE.txt,1074986,1075156,170,5,N,N,-,-1,-1
MULIFE.txt,1075157,1075218,61,5,N,N,-,-1,-1
MULIFE.txt,1075221,1075344,123,5,N,N,-,-1,-1
MULIFE.txt,1075345,1075472,127,5,N,N,-,-1,-1
MULIFE.txt,1075474,1075692,218,5,N,N,-,-1,-1
MULIFE.txt,1075693,1075766,73,5,N,N,-,-1,-1
MULIFE.txt,1075767,1075971,204,5,N,N,-,-1,-1
MULIFE.txt,1075973,1076009,36,5,N,N,-,-1,-1
MULIFE.txt,1076011,1076222,211,5,N,N,-,-1,-1
MULIFE.txt,1076225,1076379,154,5,N,N,-,-1,-1
MULIFE.txt,1076382,1076523,141,5,N,N,-,-1,-1
MULIFE.txt,1076524,1076746,222,5,N,N,-,-1,-1
MULIFE.txt,1076747,1076910,163,5,N,N,-,-1,-1
MULIFE.txt,1076911,1077101,190,5,N,N,-,-1,-1
MULIFE.txt,1077104,1077282,178,5,N,N,-,-1,-1
MULIFE.txt,1077283,1077427,144,5,N,N,-,-1,-1
MULIFE.txt,1077430,1077615,185,5,N,N,-,-1,-1
MULIFE.txt,1077616,1077678,62,5,N,N,-,-1,-1
MULIFE.txt,1077679,1077722,43,5,N,N,-,-1,-1
MULIFE.txt,1077724,1077845,121,5,N,N,-,-1,-1
MULIFE.txt,1077846,1077982,136,5,N,N,-,-1,-1
MULIFE.txt,1077984,1078128,144,5,N,N,-,-1,-1
MULIFE.txt,1078129,1078300,171,5,N,N,-,-1,-1
MULIFE.txt,1078303,1078443,140,5,N,N,-,-1,-1
MULIFE.txt,1078446,1078513,67,5,N,N,-,-1,-1
MULIFE.txt,1078514,1078575,61,5,N,N,-,-1,-1
MULIFE.txt,1078577,1078649,72,5,N,N,-,-1,-1
MULIFE.txt,1078650,1078689,39,5,N,N,-,-1,-1
MULIFE.txt,1078690,1078730,40,5,N,N,-,-1,-1
MULIFE.txt,1078731,1078772,41,5,N,N,-,-1,-1
MULIFE.txt,1078773,1078823,50,5,N,N,-,-1,-1
MULIFE.txt,1078824,1078879,55,5,N,N,-,-1,-1
MULIFE.txt,1078880,1078929,49,5,N,N,-,-1,-1
MULIFE.txt,1078931,1078964,33,5,N,N,-,-1,-1
MULIFE.txt,1078965,1079022,57,5,N,N,-,-1,-1
MULIFE.txt,1079023,1079109,86,5,N,N,-,-1,-1
MULIFE.txt,1079110,1079172,62,5,N,N,-,-1,-1
MULIFE.txt,1079173,1079236,63,5,N,N,-,-1,-1
MULIFE.txt,1079237,1079311,74,5,N,N,-,-1,-1
MULIFE.txt,1079312,1079417,105,5,N,N,-,-1,-1
MULIFE.txt,1079418,1079484,66,5,N,N,-,-1,-1
MULIFE.txt,1079486,1079553,67,5,N,N,-,-1,-1
MULIFE.txt,1079554,1079620,66,5,N,N,-,-1,-1
MULIFE.txt,1079621,1079697,76,5,N,N,-,-1,-1
MULIFE.txt,1079700,1079801,101,5,N,N,-,-1,-1
MULIFE.txt,1079804,1079898,94,5,N,N,-,-1,-1
MULIFE.txt,1079899,1079972,73,5,N,N,-,-1,-1
MULIFE.txt,1079973,1080064,91,5,N,N,-,-1,-1
MULIFE.txt,1080065,1080098,33,5,N,N,-,-1,-1
MULIFE.txt,1080099,1080256,157,5,N,N,-,-1,-1
MULIFE.txt,1080257,1080394,137,5,N,N,-,-1,-1
MULIFE.txt,1080395,1080465,70,5,N,N,-,-1,-1
MULIFE.txt,1080468,1080528,60,5,N,N,-,-1,-1
MULIFE.txt,1080531,1080624,93,5,N,N,-,-1,-1
MULIFE.txt,1080625,1080646,21,5,N,N,-,-1,-1
MULIFE.txt,1080649,1080725,76,5,N,N,-,-1,-1
MULIFE.txt,1080725,1080791,66,5,N,N,-,-1,-1
MULIFE.txt,1080792,1080848,56,5,N,N,-,-1,-1
MULIFE.txt,1080851,1080925,74,5,N,N,-,-1,-1
MULIFE.txt,1080926,1080976,50,5,N,N,-,-1,-1
MULIFE.txt,1080977,1081076,99,5,N,N,-,-1,-1
MULIFE.txt,1081077,1081112,35,5,N,N,-,-1,-1
MULIFE.txt,1081113,1081177,64,5,N,N,-,-1,-1
MULIFE.txt,1081178,1081228,50,5,N,N,-,-1,-1
MULIFE.txt,1081231,1081396,165,5,N,N,-,-1,-1
MULIFE.txt,1081397,1081500,103,5,N,N,-,-1,-1
MULIFE.txt,1081503,1081746,243,5,N,N,-,-1,-1
MULIFE.txt,1081751,1081964,213,5,N,N,-,-1,-1
MULIFE.txt,1081965,1082093,128,5,N,N,-,-1,-1
MULIFE.txt,1082096,1082331,235,5,N,N,-,-1,-1
MULIFE.txt,1082332,1082539,207,5,N,N,-,-1,-1
MULIFE.txt,1082540,1082794,254,5,N,N,-,-1,-1
MULIFE.txt,1082794,1082908,114,5,N,N,-,-1,-1
MULIFE.txt,1082909,1083047,138,5,N,N,-,-1,-1
MULIFE.txt,1083048,1083153,105,5,N,N,-,-1,-1
MULIFE.txt,1083154,1083265,111,5,N,N,-,-1,-1
MULIFE.txt,1083266,1083405,139,5,N,N,-,-1,-1
MULIFE.txt,1083406,1083521,115,5,N,N,-,-1,-1
MULIFE.txt,1083523,1083597,74,5,N,N,-,-1,-1
MULIFE.txt,1083598,1083747,149,5,N,N,-,-1,-1
MULIFE.txt,1083748,1083863,115,5,N,N,-,-1,-1
MULIFE.txt,1083864,1084015,151,5,N,N,-,-1,-1
MULIFE.txt,1084016,1084086,70,5,N,N,-,-1,-1
MULIFE.txt,1084087,1084162,75,5,N,N,-,-1,-1
MULIFE.txt,1084163,1084279,116,5,N,N,-,-1,-1
MULIFE.txt,1084280,1084341,61,5,N,N,-,-1,-1
MULIFE.txt,1084342,1084444,102,5,N,N,-,-1,-1
MULIFE.txt,1084445,1084555,110,5,N,N,-,-1,-1
MULIFE.txt,1084557,1084717,160,5,N,N,-,-1,-1
MULIFE.txt,1084718,1084881,163,5,N,N,-,-1,-1
MULIFE.txt,1084882,1085032,150,5,N,N,-,-1,-1
MULIFE.txt,1085033,1085127,94,5,N,N,-,-1,-1
MULIFE.txt,1085128,1085159,31,5,N,N,-,-1,-1
MULIFE.txt,1085160,1085242,82,5,N,N,-,-1,-1
MULIFE.txt,1085244,1085302,58,5,N,N,-,-1,-1
MULIFE.txt,1085303,1085384,81,5,N,N,-,-1,-1
MULIFE.txt,1085385,1085418,33,5,N,N,-,-1,-1
MULIFE.txt,1085419,1085466,47,5,N,N,-,-1,-1
MULIFE.txt,1085467,1085511,44,5,N,N,-,-1,-1
MULIFE.txt,1085512,1085592,80,5,N,N,-,-1,-1
MULIFE.txt,1085595,1085660,65,5,N,N,-,-1,-1
MULIFE.txt,1085661,1085734,73,5,N,N,-,-1,-1
MULIFE.txt,1085735,1085922,187,5,N,N,-,-1,-1
MULIFE.txt,1085923,1086067,144,5,N,N,-,-1,-1
MULIFE.txt,1086069,1086154,85,5,N,N,-,-1,-1
MULIFE.txt,1086155,1086212,57,5,N,N,-,-1,-1
MULIFE.txt,1086213,1086260,47,5,N,N,-,-1,-1
MULIFE.txt,1086261,1086311,50,5,N,N,-,-1,-1
MULIFE.txt,1086311,1086360,49,5,N,N,-,-1,-1
MULIFE.txt,1086361,1086452,91,5,N,N,-,-1,-1
MULIFE.txt,1086453,1086556,103,5,N,N,-,-1,-1
MULIFE.txt,1086559,1086660,101,5,N,N,-,-1,-1
MULIFE.txt,1086661,1086785,124,5,N,N,-,-1,-1
MULIFE.txt,1086788,1087053,265,5,N,N,-,-1,-1
MULIFE.txt,1087054,1087201,147,5,N,N,-,-1,-1
MULIFE.txt,1087202,1087336,134,5,N,N,-,-1,-1
MULIFE.txt,1087337,1087411,74,5,N,N,-,-1,-1
MULIFE.txt,1087412,1087486,74,5,N,N,-,-1,-1
MULIFE.txt,1087487,1087595,108,5,N,N,-,-1,-1
MULIFE.txt,1087595,1087680,85,5,N,N,-,-1,-1
MULIFE.txt,1087681,1087813,132,5,N,N,-,-1,-1
MULIFE.txt,1087814,1088027,213,5,N,N,-,-1,-1
MULIFE.txt,1088028,1088083,55,5,N,N,-,-1,-1
MULIFE.txt,1088084,1088138,54,5,N,N,-,-1,-1
MULIFE.txt,1088140,1088206,66,5,N,N,-,-1,-1
MULIFE.txt,1088208,1088265,57,5,N,N,-,-1,-1
MULIFE.txt,1088266,1088446,180,5,N,N,-,-1,-1
MULIFE.txt,1088447,1088757,310,5,N,N,-,-1,-1
MULIFE.txt,1088758,1088825,67,5,N,N,-,-1,-1
MULIFE.txt,1088826,1088900,74,5,N,N,-,-1,-1
MULIFE.txt,1088901,1089145,244,5,N,N,-,-1,-1
MULIFE.txt,1089146,1089365,219,5,N,N,-,-1,-1
MULIFE.txt,1089368,1089508,140,5,N,N,-,-1,-1
MULIFE.txt,1089509,1089714,205,5,N,N,-,-1,-1
MULIFE.txt,1089717,1089865,148,5,N,N,-,-1,-1
MULIFE.txt,1089868,1089959,91,5,N,N,-,-1,-1
MULIFE.txt,1089960,1090108,148,5,N,N,-,-1,-1
MULIFE.txt,1090109,1090198,89,5,N,N,-,-1,-1
MULIFE.txt,1090200,1090263,63,5,N,N,-,-1,-1
MULIFE.txt,1090264,1090440,176,5,N,N,-,-1,-1
MULIFE.txt,1090441,1090604,163,5,N,N,-,-1,-1
MULIFE.txt,1090605,1090706,101,5,N,N,-,-1,-1
MULIFE.txt,1090707,1090901,194,5,N,N,-,-1,-1
MULIFE.txt,1090902,1090966,64,5,N,N,-,-1,-1
MULIFE.txt,1090967,1091078,111,5,N,N,-,-1,-1
MULIFE.txt,1091079,1091158,79,5,N,N,-,-1,-1
MULIFE.txt,1091159,1091251,92,5,N,N,-,-1,-1
MULIFE.txt,1091254,1091316,62,5,N,N,-,-1,-1
MULIFE.txt,1091317,1091396,79,5,N,N,-,-1,-1
MULIFE.txt,1091398,1091522,124,5,N,N,-,-1,-1
MULIFE.txt,1091523,1091618,95,5,N,N,-,-1,-1
MULIFE.txt,1091619,1091824,205,5,N,N,-,-1,-1
MULIFE.txt,1091825,1092042,217,5,N,N,-,-1,-1
MULIFE.txt,1092043,1092143,100,5,N,N,-,-1,-1
MULIFE.txt,1092144,1092212,68,5,N,N,-,-1,-1
MULIFE.txt,1092213,1092269,56,5,N,N,-,-1,-1
MULIFE.txt,1092274,1092437,163,5,N,N,-,-1,-1
MULIFE.txt,1092438,1092627,189,5,N,N,-,-1,-1
MULIFE.txt,1092628,1092682,54,5,N,N,-,-1,-1
MULIFE.txt,1092683,1092716,33,5,N,N,-,-1,-1
MULIFE.txt,1092717,1093015,298,5,N,N,-,-1,-1
MULIFE.txt,1093017,1093166,149,5,N,N,-,-1,-1
MUSING.txt,0,1008,1008,5,N,N,-,-1,-1
MUSING.txt,1011,2031,1020,5,N,N,-,-1,-1
MUSING.txt,2032,3605,1573,5,N,N,-,-1,-1
MUSING.txt,3606,5332,1726,5,N,N,-,-1,-1
MUSING.txt,5334,6114,780,5,N,N,-,-1,-1
MUSING.txt,6115,6953,838,5,N,N,-,-1,-1
MUSING.txt,6955,8219,1264,5,N,N,-,-1,-1
MUSING.txt,8220,9101,881,5,N,N,-,-1,-1
MUSING.txt,9102,9828,726,5,N,N,-,-1,-1
MUSING.txt,9829,10190,361,5,N,N,-,-1,-1
MUSING.txt,10191,12155,1964,5,N,Y,1452196853462,11789,12151
MUSING.txt,12156,13362,1206,5,N,Y,1452197105481,12624,12995
MUSING.txt,13363,15556,2193,5,Y,Y,1452197298690,13035,13782
MUSING.txt,15558,16595,1037,5,N,Y,1452197697399,15543,16146
MUSING.txt,16598,18996,2398,5,N,Y,1452551988808,17987,18415
MUSING.txt,18997,20142,1145,5,N,Y,1452552834876,19293,19784
MUSING.txt,20143,21452,1309,5,Y,Y,1452552963937,20183,20500
MUSING.txt,21453,22263,810,5,N,Y,1452553595468,21457,21878
MUSING.txt,22264,23244,980,5,N,N,-,-1,-1
MUSING.txt,23245,25106,1861,5,N,Y,1452633313155,24231,24696
MUSING.txt,25107,26386,1279,5,N,N,-,-1,-1
MUSING.txt,26387,27628,1241,5,N,N,-,-1,-1
MUSING.txt,27631,28753,1122,5,N,Y,1452633925920,28052,28470
MUSING.txt,28754,30171,1417,5,Y,Y,1452634310554,28507,29379
MUSING.txt,30172,31594,1422,5,Y,Y,1452635059028,30305,30726
MUSING.txt,31597,32621,1024,5,Y,Y,1452636055684,32302,33666
MUSING.txt,32622,33910,1288,5,N,Y,1452636055684,32302,33666
MUSING.txt,33911,35333,1422,5,N,N,-,-1,-1
MUSING.txt,35334,36231,897,5,N,N,-,-1,-1
MUSING.txt,36232,36925,693,5,N,N,-,-1,-1
MUSING.txt,36926,38179,1253,5,N,N,-,-1,-1
MUSING.txt,38180,40078,1898,5,N,Y,1452636825724,38193,39614
MUSING.txt,40079,41602,1523,5,N,Y,1452637642930,39672,40424
MUSING.txt,41605,42424,819,5,N,N,-,-1,-1
MUSING.txt,42425,43113,688,5,N,N,-,-1,-1
MUSING.txt,43116,44381,1265,5,Y,Y,1452638022184,43114,43497
MUSING.txt,44384,45256,872,5,N,N,-,-1,-1
MUSING.txt,45257,46355,1098,5,N,N,-,-1,-1
MUSING.txt,46357,46914,557,5,N,N,-,-1,-1
MUSING.txt,46915,47640,725,5,N,N,-,-1,-1
MUSING.txt,47642,48504,862,5,N,N,-,-1,-1
MUSING.txt,48505,49001,496,5,N,N,-,-1,-1
MUSING.txt,49002,50303,1301,5,Y,Y,1452808243495,49009,49545
MUSING.txt,50304,51834,1530,5,Y,Y,1452809504715,50824,51388
MUSING.txt,51835,53071,1236,5,N,Y,1452809876210,52219,52571
MUSING.txt,53074,54299,1225,5,N,Y,1452810063851,53076,53440
MUSING.txt,54300,55513,1213,5,Y,N,-,-1,-1
MUSING.txt,55514,56634,1120,5,N,Y,1452810619236,55897,56755
MUSING.txt,56636,57363,727,5,N,Y,1452810619236,55897,56755
MUSING.txt,57364,57931,567,5,N,Y,1452811308084,57736,58274
MUSING.txt,57932,59012,1080,5,N,Y,1452811308084,57736,58274
MUSING.txt,59014,59990,976,5,N,N,-,-1,-1
MUSING.txt,59993,61815,1822,5,N,Y,1453045736851,60609,61623
MUSING.txt,61817,63053,1236,5,N,N,-,-1,-1
MUSING.txt,63054,64015,961,5,N,Y,1453049225205,63792,64405
MUSING.txt,64016,64633,617,5,N,Y,1453049225205,63792,64405
MUSING.txt,64635,66249,1614,5,N,N,-,-1,-1
MUSING.txt,66250,67707,1457,5,N,Y,1453050717776,66941,67842
MUSING.txt,67708,68600,892,5,N,Y,1453050717776,66941,67842
MUSING.txt,68601,69846,1245,5,Y,Y,1453051275841,69685,69839
MUSING.txt,69849,71010,1161,5,N,Y,1453051493027,69834,70210
MUSING.txt,71011,72340,1329,5,N,N,-,-1,-1
MUSING.txt,72343,73594,1251,5,N,N,-,-1,-1
MUSING.txt,73597,74686,1089,5,Y,Y,1453053339147,74161,74769
MUSING.txt,74687,75920,1233,5,Y,Y,1453053339147,74161,74769
MUSING.txt,75921,76920,999,5,N,Y,1453054180764,75925,76428
MUSING.txt,76921,78026,1105,5,N,Y,1453054446277,77703,78851
MUSING.txt,78027,79269,1242,5,N,Y,1453054446277,77703,78851
MUSING.txt,79270,80292,1022,5,N,N,-,-1,-1
MUSING.txt,80293,81323,1030,5,N,N,-,-1,-1
MUSING.txt,81324,83042,1718,5,N,N,-,-1,-1
MUSING.txt,83044,84243,1199,5,N,N,-,-1,-1
MUSING.txt,84244,85754,1510,5,N,N,-,-1,-1
MUSING.txt,85755,87168,1413,5,N,N,-,-1,-1
MUSING.txt,87169,88535,1366,5,N,N,-,-1,-1
MUSING.txt,88538,89578,1040,5,N,N,-,-1,-1
MUSING.txt,89579,90531,952,5,N,N,-,-1,-1
MUSING.txt,90532,91641,1109,5,N,N,-,-1,-1
MUSING.txt,91642,92581,939,5,N,N,-,-1,-1
MUSING.txt,92582,93242,660,5,N,N,-,-1,-1
MUSING.txt,93243,94353,1110,5,N,N,-,-1,-1
MUSING.txt,94356,95661,1305,5,N,N,-,-1,-1
MUSING.txt,95662,97202,1540,5,N,N,-,-1,-1
MUSING.txt,97205,98360,1155,5,N,N,-,-1,-1
MUSING.txt,98361,99747,1386,5,N,N,-,-1,-1
MUSING.txt,99750,100553,803,5,N,N,-,-1,-1
MUSING.txt,100554,101286,732,5,N,N,-,-1,-1
MUSING.txt,101287,102131,844,5,N,N,-,-1,-1
MUSING.txt,102132,103361,1229,5,N,N,-,-1,-1
MUSING.txt,103362,104761,1399,5,N,N,-,-1,-1
MUSING.txt,104763,106130,1367,5,Y,N,-,-1,-1
MUSING.txt,106131,107009,878,5,N,Y,1461619406602,106559,106998
MUSING.txt,107010,108459,1449,5,Y,Y,1461619728886,107422,107922
MUSING.txt,108460,109171,711,5,N,Y,1473711868958,108578,109622
MUSING.txt,109172,109976,804,5,N,Y,1473711868958,108578,109622
MUSING.txt,109977,110711,734,5,N,N,-,-1,-1
MUSING.txt,110712,111305,593,5,N,N,-,-1,-1
MUSING.txt,111306,111821,515,5,N,N,-,-1,-1
MUSING.txt,111822,112208,386,5,N,N,-,-1,-1
MUSING.txt,112209,112840,631,5,N,N,-,-1,-1
MUSING.txt,112845,113711,866,5,N,Y,1473713496783,113607,114030
MUSING.txt,113712,114566,854,5,N,Y,1473713496783,113607,114030
MUSING.txt,114568,115555,987,5,N,N,-,-1,-1
MUSING.txt,115556,116195,639,5,N,N,-,-1,-1
MUSING.txt,116196,117245,1049,5,N,N,-,-1,-1
MUSING.txt,117246,118785,1539,5,N,N,-,-1,-1
MUSING.txt,118786,119218,432,5,N,N,-,-1,-1
MUSING.txt,119219,119771,552,5,N,N,-,-1,-1
MUSING.txt,119774,120793,1019,5,N,N,-,-1,-1
MUSING.txt,120794,121414,620,5,N,N,-,-1,-1
MUSING.txt,121415,122778,1363,5,N,Y,1473715568245,121644,121983
MUSING.txt,122780,123455,675,5,N,N,-,-1,-1
MUSING.txt,123456,124535,1079,5,N,N,-,-1,-1
MUSING.txt,124536,125145,609,5,N,N,-,-1,-1
MUSING.txt,125148,125616,468,5,N,N,-,-1,-1
MUSING.txt,125619,126366,747,5,N,N,-,-1,-1
MUSING.txt,126371,126869,498,5,N,N,-,-1,-1
MUSING.txt,126870,127838,968,5,N,Y,1483014061568,126874,127277
MUSING.txt,127839,128743,904,5,N,N,-,-1,-1
MUSING.txt,128746,129587,841,5,N,N,-,-1,-1
MUSING.txt,129588,130174,586,5,N,N,-,-1,-1
MUSING.txt,130176,130518,342,5,N,N,-,-1,-1
MUSING.txt,130521,131206,685,5,N,N,-,-1,-1
MUSING.txt,131207,132124,917,5,N,N,-,-1,-1
MUSING.txt,132125,132719,594,5,N,N,-,-1,-1
MUSING.txt,132722,133428,706,5,N,N,-,-1,-1
MUSING.txt,133429,134103,674,5,N,N,-,-1,-1
MUSING.txt,134104,134840,736,5,N,N,-,-1,-1
MUSING.txt,134841,135588,747,5,N,N,-,-1,-1
MUSING.txt,135589,136560,971,5,N,N,-,-1,-1
MUSING.txt,136562,136886,324,5,N,N,-,-1,-1
MUSING.txt,136888,137318,430,5,N,N,-,-1,-1
MUSING.txt,137319,137614,295,5,N,N,-,-1,-1
MUSING.txt,137617,138082,465,5,N,N,-,-1,-1
MUSING.txt,138083,138739,656,5,N,N,-,-1,-1
MUSING.txt,138742,139306,564,5,N,N,-,-1,-1
MUSING.txt,139307,139825,518,5,N,N,-,-1,-1
MUSING.txt,139826,140608,782,5,N,N,-,-1,-1
MUSING.txt,140611,141178,567,5,N,Y,1483023499163,140609,141162
MUSING.txt,141181,141518,337,5,N,N,-,-1,-1
MUSING.txt,141519,141809,290,5,N,N,-,-1,-1
MUSING.txt,141812,142555,743,5,N,N,-,-1,-1
MUSING.txt,142556,143420,864,5,N,N,-,-1,-1
MUSING.txt,143421,143757,336,5,N,N,-,-1,-1
MUSING.txt,143759,144457,698,5,N,N,-,-1,-1
MUSING.txt,144459,145244,785,5,N,N,-,-1,-1
MUSING.txt,145245,145856,611,5,N,N,-,-1,-1
MUSING.txt,145857,147165,1308,5,N,N,-,-1,-1
MUSING.txt,147166,148888,1722,5,N,N,-,-1,-1
MUSING.txt,148892,149185,293,5,N,N,-,-1,-1
MUSING.txt,149186,149636,450,5,N,N,-,-1,-1
MUSING.txt,149637,150428,791,5,N,N,-,-1,-1
MUSING.txt,150429,151328,899,5,N,N,-,-1,-1
MUSING.txt,151329,151732,403,5,N,N,-,-1,-1
MUSING.txt,151733,152403,670,5,N,Y,1483028149168,151984,152882
MUSING.txt,152404,153020,616,5,N,Y,1483028149168,151984,152882
MUSING.txt,153023,153500,477,5,N,N,-,-1,-1
MUSING.txt,153501,153879,378,5,N,N,-,-1,-1
MUSING.txt,153882,154589,707,5,N,N,-,-1,-1
MUSING.txt,154590,155091,501,5,N,Y,1483028673856,154833,155406
MUSING.txt,155092,155507,415,5,N,Y,1483028673856,154833,155406
MUSING.txt,155509,155936,427,5,N,N,-,-1,-1
MUSING.txt,155937,156638,701,5,N,N,-,-1,-1
MUSING.txt,156639,157273,634,5,N,N,-,-1,-1
MUSING.txt,157274,158174,900,5,N,N,-,-1,-1
MUSING.txt,158175,158805,630,5,N,N,-,-1,-1
MUSING.txt,158810,159880,1070,5,N,N,-,-1,-1
MUSING.txt,159883,160919,1036,5,N,N,-,-1,-1
MUSING.txt,160922,161758,836,5,N,N,-,-1,-1
MUSING.txt,161761,163099,1338,5,N,N,-,-1,-1
MUSING.txt,163100,163857,757,5,N,N,-,-1,-1
MUSING.txt,163858,164486,628,5,N,N,-,-1,-1
MUSING.txt,164489,165427,938,5,N,N,-,-1,-1
MUSING.txt,165428,166301,873,5,N,N,-,-1,-1
MUSING.txt,166302,166831,529,5,N,N,-,-1,-1
MUSING.txt,166833,167710,877,5,N,N,-,-1,-1
MUSING.txt,167711,169516,1805,5,N,N,-,-1,-1
MUSING.txt,169519,171419,1900,5,N,N,-,-1,-1
MUSING.txt,171420,171997,577,5,N,N,-,-1,-1
MUSING.txt,172000,173067,1067,5,N,N,-,-1,-1
MUSING.txt,173068,174787,1719,5,Y,N,-,-1,-1
MUSING.txt,174788,175814,1026,5,N,N,-,-1,-1
MUSING.txt,175815,176991,1176,5,N,N,-,-1,-1
MUSING.txt,176992,177854,862,5,N,N,-,-1,-1
MUSING.txt,177857,178939,1082,5,N,N,-,-1,-1
MUSING.txt,178941,179955,1014,5,N,N,-,-1,-1
MUSING.txt,179958,182335,2377,5,N,N,-,-1,-1
MUSING.txt,182336,184121,1785,5,N,N,-,-1,-1
MUSING.txt,184123,185013,890,5,N,N,-,-1,-1
MUSING.txt,185014,186990,1976,5,N,N,-,-1,-1
MUSING.txt,186993,189163,2170,5,Y,N,-,-1,-1
MUSING.txt,189164,189894,730,5,N,N,-,-1,-1
MUSING.txt,189895,190657,762,5,N,N,-,-1,-1
MUSING.txt,190658,191129,471,5,N,N,-,-1,-1
MUSING.txt,191130,191789,659,5,N,N,-,-1,-1
MUSING.txt,191792,193046,1254,5,N,N,-,-1,-1
MUSING.txt,193049,194305,1256,5,N,N,-,-1,-1
MUSING.txt,194307,195645,1338,5,N,N,-,-1,-1
MUSING.txt,195646,197021,1375,5,N,N,-,-1,-1
MUSING.txt,197022,198215,1193,5,N,N,-,-1,-1
MUSING.txt,198216,199183,967,5,N,N,-,-1,-1
MUSING.txt,199186,201553,2367,5,N,N,-,-1,-1
MUSING.txt,201555,202282,727,5,N,N,-,-1,-1
MUSING.txt,202283,203384,1101,5,N,N,-,-1,-1
MUSING.txt,203385,204903,1518,5,N,N,-,-1,-1
MUSING.txt,204906,206537,1631,5,N,N,-,-1,-1
MUSING.txt,206538,207654,1116,5,N,N,-,-1,-1
MUSING.txt,207656,208906,1250,5,N,N,-,-1,-1
MUSING.txt,208907,210542,1635,5,Y,N,-,-1,-1
MUSING.txt,210543,211402,859,5,N,N,-,-1,-1
MUSING.txt,211403,212086,683,5,N,N,-,-1,-1
MUSING.txt,212088,213516,1428,5,N,N,-,-1,-1
MUSING.txt,213517,214468,951,5,N,N,-,-1,-1
MUSING.txt,214469,215539,1070,5,N,N,-,-1,-1
MUSING.txt,215540,216226,686,5,N,N,-,-1,-1
MUSING.txt,216228,216769,541,5,N,N,-,-1,-1
MUSING.txt,216770,218282,1512,5,N,N,-,-1,-1
MUSING.txt,218285,219481,1196,5,N,N,-,-1,-1
MUSING.txt,219482,220274,792,5,N,N,-,-1,-1
MUSING.txt,220275,221131,856,5,N,N,-,-1,-1
MUSING.txt,221132,221889,757,5,N,N,-,-1,-1
MUSING.txt,221890,223044,1154,5,N,N,-,-1,-1
MUSING.txt,223046,225074,2028,5,Y,N,-,-1,-1
MUSING.txt,225075,225905,830,5,N,N,-,-1,-1
MUSING.txt,225906,226728,822,5,N,N,-,-1,-1
MUSING.txt,226731,227482,751,5,N,N,-,-1,-1
MUSING.txt,227483,228383,900,5,N,N,-,-1,-1
MUSING.txt,228384,229246,862,5,N,N,-,-1,-1
MUSING.txt,229247,230848,1601,5,N,N,-,-1,-1
MUSING.txt,230849,231627,778,5,N,N,-,-1,-1
MUSING.txt,231628,232387,759,5,N,N,-,-1,-1
MUSING.txt,232388,233646,1258,5,Y,N,-,-1,-1
MUSING.txt,233647,234932,1285,5,N,N,-,-1,-1
MUSING.txt,234933,235828,895,5,N,N,-,-1,-1
MUSING.txt,235829,236077,248,5,N,N,-,-1,-1
MUSING.txt,236078,236876,798,5,N,N,-,-1,-1
MUSING.txt,236877,238114,1237,5,N,N,-,-1,-1
MUSING.txt,238116,239539,1423,5,N,N,-,-1,-1
MUSING.txt,239540,240718,1178,5,N,N,-,-1,-1
MUSING.txt,240721,241555,834,5,N,N,-,-1,-1
MUSING.txt,241558,242247,689,5,N,N,-,-1,-1
MUSING.txt,242248,244048,1800,5,N,N,-,-1,-1
MUSING.txt,244049,245076,1027,5,N,N,-,-1,-1
MUSING.txt,245077,245523,446,5,N,N,-,-1,-1
MUSING.txt,245525,246587,1062,5,N,N,-,-1,-1
MUSING.txt,246588,247855,1267,5,Y,N,-,-1,-1
MUSING.txt,247856,248977,1121,5,N,N,-,-1,-1
MUSING.txt,248978,250260,1282,5,N,N,-,-1,-1
MUSING.txt,250262,252286,2024,5,N,N,-,-1,-1
MUSING.txt,252287,253282,995,5,N,N,-,-1,-1
MUSING.txt,253283,254476,1193,5,N,N,-,-1,-1
MUSING.txt,254477,256209,1732,5,N,N,-,-1,-1
MUSING.txt,256210,257434,1224,5,N,N,-,-1,-1
MUSING.txt,257435,259012,1577,5,N,N,-,-1,-1
MUSING.txt,259013,260936,1923,5,N,N,-,-1,-1
MUSING.txt,260938,262395,1457,5,N,N,-,-1,-1
MUSING.txt,262396,265273,2877,5,N,N,-,-1,-1
MUSING.txt,265274,266006,732,5,N,N,-,-1,-1
MUSING.txt,266007,266722,715,5,N,N,-,-1,-1
MUSING.txt,266723,267379,656,5,N,N,-,-1,-1
MUSING.txt,267380,268347,967,5,N,N,-,-1,-1
MUSING.txt,268348,268912,564,5,N,N,-,-1,-1
MUSING.txt,268913,269334,421,5,N,N,-,-1,-1
MUSING.txt,269335,269674,339,5,N,N,-,-1,-1
MUSING.txt,269675,270070,395,5,N,N,-,-1,-1
MUSING.txt,270071,270404,333,5,N,N,-,-1,-1
MUSING.txt,270405,270923,518,5,N,N,-,-1,-1
MUSING.txt,270925,271743,818,5,Y,N,-,-1,-1
MUSING.txt,271744,272792,1048,5,N,N,-,-1,-1
MUSING.txt,272793,274058,1265,5,N,N,-,-1,-1
MUSING.txt,274059,275274,1215,5,N,N,-,-1,-1
MUSING.txt,275275,276537,1262,5,N,N,-,-1,-1
MUSING.txt,276538,276969,431,5,N,N,-,-1,-1
MUSING.txt,276971,277914,943,5,N,N,-,-1,-1
MUSING.txt,277915,279136,1221,5,Y,N,-,-1,-1
MUSING.txt,279137,279789,652,5,N,N,-,-1,-1
MUSING.txt,279792,280308,516,5,N,N,-,-1,-1
MUSING.txt,280309,280978,669,5,N,N,-,-1,-1
MUSING.txt,280979,281983,1004,5,N,N,-,-1,-1
MUSING.txt,281984,283295,1311,5,N,N,-,-1,-1
MUSING.txt,283298,284423,1125,5,N,N,-,-1,-1
MUSING.txt,284426,285420,994,5,N,N,-,-1,-1
MUSING.txt,285421,287130,1709,5,N,N,-,-1,-1
MUSING.txt,287133,288388,1255,5,N,N,-,-1,-1
MUSING.txt,288389,289509,1120,5,N,N,-,-1,-1
MUSING.txt,289510,290995,1485,5,N,N,-,-1,-1
MUSING.txt,290998,291625,627,5,N,N,-,-1,-1
MUSING.txt,291628,291991,363,5,N,N,-,-1,-1
MUSING.txt,291992,292426,434,5,N,N,-,-1,-1
MUSING.txt,292429,293368,939,5,N,N,-,-1,-1
MUSING.txt,293369,294317,948,5,N,N,-,-1,-1
MUSING.txt,294318,294787,469,5,N,N,-,-1,-1
MUSING.txt,294792,296134,1342,5,N,N,-,-1,-1
MUSING.txt,296135,297078,943,5,N,N,-,-1,-1
MUSING.txt,297081,298618,1537,5,N,N,-,-1,-1
MUSING.txt,298619,299170,551,5,N,N,-,-1,-1
MUSING.txt,299173,300033,860,5,N,N,-,-1,-1
MUSING.txt,300034,301829,1795,5,N,N,-,-1,-1
MUSING.txt,301832,303441,1609,5,N,N,-,-1,-1
MUSING.txt,303442,304975,1533,5,N,N,-,-1,-1
MUSING.txt,304976,306158,1182,5,N,N,-,-1,-1
MUSING.txt,306160,307421,1261,5,N,N,-,-1,-1
MUSING.txt,307422,308427,1005,5,N,N,-,-1,-1
MUSING.txt,308428,308858,430,5,N,N,-,-1,-1
MUSING.txt,308859,309797,938,5,N,N,-,-1,-1
MUSING.txt,309798,310095,297,5,N,N,-,-1,-1
MUSING.txt,310096,310650,554,5,N,N,-,-1,-1
MUSING.txt,310651,312100,1449,5,N,N,-,-1,-1
MUSING.txt,312101,313159,1058,5,N,N,-,-1,-1
MUSING.txt,313160,314427,1267,5,N,N,-,-1,-1
MUSING.txt,314429,315221,792,5,N,N,-,-1,-1
MUSING.txt,315223,315467,244,5,N,N,-,-1,-1
MUSING.txt,315468,315907,439,5,N,N,-,-1,-1
MUSING.txt,315908,316615,707,5,N,N,-,-1,-1
MUSING.txt,316616,317542,926,5,N,N,-,-1,-1
MUSING.txt,317544,318685,1141,5,N,N,-,-1,-1
MUSING.txt,318686,319415,729,5,N,N,-,-1,-1
MUSING.txt,319416,320250,834,5,N,N,-,-1,-1
MUSING.txt,320255,321806,1551,5,N,N,-,-1,-1
MUSING.txt,321808,323050,1242,5,N,N,-,-1,-1
MUSING.txt,323053,324923,1870,5,N,N,-,-1,-1
MUSING.txt,324924,326059,1135,5,N,N,-,-1,-1
MUSING.txt,326061,327369,1308,5,N,N,-,-1,-1
MUSING.txt,327370,328225,855,5,N,N,-,-1,-1
MUSING.txt,328226,329119,893,5,N,N,-,-1,-1
MUSING.txt,329120,330248,1128,5,N,N,-,-1,-1
MUSING.txt,330251,331208,957,5,N,N,-,-1,-1
MUSING.txt,331209,332165,956,5,N,N,-,-1,-1
MUSING.txt,332167,333155,988,5,N,N,-,-1,-1
MUSING.txt,333158,334237,1079,5,N,N,-,-1,-1
MUSING.txt,334240,335432,1192,5,N,N,-,-1,-1
MUSING.txt,335433,336994,1561,5,N,N,-,-1,-1
MUSING.txt,336995,337490,495,5,N,N,-,-1,-1
MUSING.txt,337491,337932,441,5,N,N,-,-1,-1
MUSING.txt,337937,339419,1482,5,N,N,-,-1,-1
MUSING.txt,339420,340692,1272,5,N,N,-,-1,-1
MUSING.txt,340697,341795,1098,5,N,N,-,-1,-1
MUSING.txt,341797,343136,1339,5,N,N,-,-1,-1
MUSING.txt,343137,344512,1375,5,N,N,-,-1,-1
MUSING.txt,344515,345365,850,5,N,N,-,-1,-1
MUSING.txt,345366,346509,1143,5,N,N,-,-1,-1
MUSING.txt,346510,347041,531,5,N,N,-,-1,-1
MUSING.txt,347044,348013,969,5,N,N,-,-1,-1
MUSING.txt,348015,348985,970,5,N,N,-,-1,-1
MUSING.txt,348986,349904,918,5,N,N,-,-1,-1
MUSING.txt,349905,350907,1002,5,N,N,-,-1,-1
MUSING.txt,350908,351464,556,5,N,N,-,-1,-1
MUSING.txt,351465,352359,894,5,N,N,-,-1,-1
MUSING.txt,352360,353022,662,5,N,N,-,-1,-1
MUSING.txt,353023,353963,940,5,N,N,-,-1,-1
MUSING.txt,353964,355735,1771,5,N,N,-,-1,-1
MUSING.txt,355738,356409,671,5,N,N,-,-1,-1
MUSING.txt,356410,357006,596,5,N,N,-,-1,-1
MUSING.txt,357007,358775,1768,5,N,N,-,-1,-1
MUSING.txt,358776,359443,667,5,N,N,-,-1,-1
MUSING.txt,359444,360193,749,5,N,N,-,-1,-1
MUSING.txt,360194,360946,752,5,N,N,-,-1,-1
MUSING.txt,360949,361530,581,5,N,N,-,-1,-1
MUSING.txt,361531,362227,696,5,N,N,-,-1,-1
MUSING.txt,362228,363329,1101,5,N,N,-,-1,-1
MUSING.txt,363330,364291,961,5,Y,N,-,-1,-1
MUSING.txt,364292,364924,632,5,N,N,-,-1,-1
MUSING.txt,364927,365799,872,5,N,N,-,-1,-1
MUSING.txt,365800,366458,658,5,N,N,-,-1,-1
MUSING.txt,366459,366962,503,5,N,N,-,-1,-1
MUSING.txt,366963,367904,941,5,N,N,-,-1,-1
MUSING.txt,367907,368421,514,5,N,N,-,-1,-1
MUSING.txt,368422,368834,412,5,N,N,-,-1,-1
MUSING.txt,368835,369525,690,5,N,N,-,-1,-1
MUSING.txt,369528,370564,1036,5,N,N,-,-1,-1
MUSING.txt,370567,371869,1302,5,N,N,-,-1,-1
MUSING.txt,371870,372031,161,5,N,N,-,-1,-1
MUSING.txt,372036,372167,131,5,N,N,-,-1,-1
MUSING.txt,372170,372947,777,5,N,N,-,-1,-1
MUSING.txt,372949,374076,1127,5,N,N,-,-1,-1
MUSING.txt,374077,374832,755,5,N,N,-,-1,-1
MUSING.txt,374833,375727,894,5,N,N,-,-1,-1
MUSING.txt,375728,377018,1290,5,N,N,-,-1,-1
MUSING.txt,377019,377394,375,5,N,N,-,-1,-1
MUSING.txt,377397,378231,834,5,N,N,-,-1,-1
MUSING.txt,378232,379259,1027,5,N,N,-,-1,-1
MUSING.txt,379261,380408,1147,5,N,N,-,-1,-1
MUSING.txt,380409,381186,777,5,N,N,-,-1,-1
MUSING.txt,381187,383545,2358,5,N,N,-,-1,-1
MUSING.txt,383546,384546,1000,5,N,N,-,-1,-1
MUSING.txt,384547,385632,1085,5,N,N,-,-1,-1
MUSING.txt,385633,386517,884,5,N,N,-,-1,-1
MUSING.txt,386518,387714,1196,5,N,N,-,-1,-1
MUSING.txt,387715,389543,1828,5,N,N,-,-1,-1
MUSING.txt,389544,391334,1790,5,N,N,-,-1,-1
MUSING.txt,391335,392212,877,5,N,N,-,-1,-1
MUSING.txt,392214,392983,769,5,N,N,-,-1,-1
MUSING.txt,392984,394076,1092,5,N,N,-,-1,-1
MUSING.txt,394079,394900,821,5,N,N,-,-1,-1
MUSING.txt,394901,397377,2476,5,Y,N,-,-1,-1
MUSING.txt,397378,398899,1521,5,N,N,-,-1,-1
MUSING.txt,398900,400036,1136,5,N,N,-,-1,-1
MUSING.txt,400039,400665,626,5,N,N,-,-1,-1
MUSING.txt,400666,401116,450,5,N,N,-,-1,-1
MUSING.txt,401117,402003,886,5,N,N,-,-1,-1
MUSING.txt,402008,403261,1253,5,N,N,-,-1,-1
MUSING.txt,403262,404348,1086,5,N,N,-,-1,-1
MUSING.txt,404349,405432,1083,5,N,N,-,-1,-1
MUSING.txt,405433,406295,862,5,N,N,-,-1,-1
MUSING.txt,406296,407264,968,5,N,N,-,-1,-1
MUSING.txt,407267,408294,1027,5,N,N,-,-1,-1
MUSING.txt,408295,410104,1809,5,N,N,-,-1,-1
MUSING.txt,410106,410350,244,5,N,N,-,-1,-1
MUSING.txt,410352,410542,190,5,N,N,-,-1,-1
MUSING.txt,410544,410654,110,5,N,N,-,-1,-1
MUSING.txt,410656,410801,145,5,N,N,-,-1,-1
MUSING.txt,410803,410939,136,5,N,N,-,-1,-1
MUSING.txt,410941,411025,84,5,N,N,-,-1,-1
MUSING.txt,411027,411152,125,5,N,N,-,-1,-1
MUSING.txt,411154,411229,75,5,N,N,-,-1,-1
MUSING.txt,411231,411359,128,5,N,N,-,-1,-1
MUSING.txt,411362,411515,153,5,N,N,-,-1,-1
MUSING.txt,411517,411620,103,5,N,N,-,-1,-1
MUSING.txt,411622,411779,157,5,N,N,-,-1,-1
MUSING.txt,411781,411900,119,5,N,N,-,-1,-1
MUSING.txt,411902,412044,142,5,N,N,-,-1,-1
MUSING.txt,412046,412137,91,5,N,N,-,-1,-1
MUSING.txt,412138,412235,97,5,N,N,-,-1,-1
MUSING.txt,412237,413511,1274,5,N,N,-,-1,-1
MUSING.txt,413514,414358,844,5,N,N,-,-1,-1
MUSING.txt,414359,415226,867,5,N,N,-,-1,-1
MUSING.txt,415227,415697,470,5,N,N,-,-1,-1
MUSING.txt,415698,416444,746,5,N,N,-,-1,-1
MUSING.txt,416447,416841,394,5,N,N,-,-1,-1
MUSING.txt,416844,417564,720,5,N,N,-,-1,-1
MUSING.txt,417565,418427,862,5,N,N,-,-1,-1
MUSING.txt,418428,418925,497,5,N,N,-,-1,-1
MUSING.txt,418926,419672,746,5,N,N,-,-1,-1
MUSING.txt,419673,420558,885,5,N,N,-,-1,-1
MUSING.txt,420559,421670,1111,5,N,N,-,-1,-1
MUSING.txt,421670,423456,1786,5,N,N,-,-1,-1
MUSING.txt,423457,424197,740,5,N,N,-,-1,-1
MUSING.txt,424198,424704,506,5,N,N,-,-1,-1
MUSING.txt,424706,425442,736,5,N,N,-,-1,-1
MUSING.txt,425442,426540,1098,5,N,N,-,-1,-1
MUSING.txt,426541,427603,1062,5,N,N,-,-1,-1
MUSING.txt,427604,428681,1077,5,N,N,-,-1,-1
MUSING.txt,428683,430283,1600,5,Y,N,-,-1,-1
MUSING.txt,430284,431067,783,5,N,N,-,-1,-1
MUSING.txt,431068,431348,280,5,N,N,-,-1,-1
MUSING.txt,431349,432005,656,5,N,N,-,-1,-1
MUSING.txt,432006,433018,1012,5,N,N,-,-1,-1
MUSING.txt,433019,433859,840,5,N,N,-,-1,-1
MUSING.txt,433860,434949,1089,5,N,N,-,-1,-1
MUSING.txt,434950,435658,708,5,N,N,-,-1,-1
MUSING.txt,435659,436472,813,5,N,N,-,-1,-1
MUSING.txt,436474,437472,998,5,N,N,-,-1,-1
MUSING.txt,437473,438088,615,5,N,N,-,-1,-1
MUSING.txt,438089,439134,1045,5,N,N,-,-1,-1
MUSING.txt,439135,439986,851,5,N,N,-,-1,-1
MUSING.txt,439987,440722,735,5,N,N,-,-1,-1
MUSING.txt,440725,441554,829,5,Y,N,-,-1,-1
MUSING.txt,441555,442336,781,5,N,N,-,-1,-1
MUSING.txt,442341,443284,943,5,N,N,-,-1,-1
MUSING.txt,443287,444790,1503,5,N,N,-,-1,-1
MUSING.txt,444792,445486,694,5,N,N,-,-1,-1
MUSING.txt,445487,446998,1511,5,N,N,-,-1,-1
MUSING.txt,446999,447762,763,5,N,N,-,-1,-1
MUSING.txt,447763,448440,677,5,N,N,-,-1,-1
MUSING.txt,448441,448552,111,5,N,N,-,-1,-1
MUSING.txt,448553,449538,985,5,N,N,-,-1,-1
MUSING.txt,449543,451130,1587,5,N,N,-,-1,-1
MUSING.txt,451132,452185,1053,5,N,N,-,-1,-1
MUSING.txt,452187,453304,1117,5,N,N,-,-1,-1
MUSING.txt,453305,454546,1241,5,N,N,-,-1,-1
MUSING.txt,454547,455801,1254,5,N,N,-,-1,-1
MUSING.txt,455802,457052,1250,5,N,N,-,-1,-1
MUSING.txt,457053,458711,1658,5,N,N,-,-1,-1
MUSING.txt,458716,460561,1845,5,N,N,-,-1,-1
MUSING.txt,460564,462067,1503,5,N,N,-,-1,-1
MUSING.txt,462068,463362,1294,5,N,N,-,-1,-1
MUSING.txt,463363,464729,1366,5,N,N,-,-1,-1
MUSING.txt,464730,465458,728,5,N,N,-,-1,-1
MUSING.txt,465461,465893,432,5,N,N,-,-1,-1
MUSING.txt,465894,467032,1138,5,N,N,-,-1,-1
MUSING.txt,467035,467981,946,5,N,N,-,-1,-1
MUSING.txt,467983,468870,887,5,N,N,-,-1,-1
MUSING.txt,468872,470037,1165,5,N,N,-,-1,-1
MUSING.txt,470039,471117,1078,5,N,N,-,-1,-1
MUSING.txt,471118,472485,1367,5,N,N,-,-1,-1
MUSING.txt,472488,474242,1754,5,N,N,-,-1,-1
MUSING.txt,474243,474946,703,5,N,N,-,-1,-1
MUSING.txt,474947,475878,931,5,N,N,-,-1,-1
MUSING.txt,475879,477132,1253,5,N,N,-,-1,-1
MUSING.txt,477133,477823,690,5,N,N,-,-1,-1
MUSING.txt,477828,478677,849,5,N,N,-,-1,-1
MUSING.txt,478678,479605,927,5,N,N,-,-1,-1
MUSING.txt,479606,480070,464,5,N,N,-,-1,-1
MUSING.txt,480072,480678,606,5,N,N,-,-1,-1
MUSING.txt,480679,481898,1219,5,N,N,-,-1,-1
MUSING.txt,481899,482628,729,5,N,N,-,-1,-1
MUSING.txt,482629,483447,818,5,N,N,-,-1,-1
MUSING.txt,483448,485223,1775,5,N,N,-,-1,-1
MUSING.txt,485224,486593,1369,5,N,N,-,-1,-1
MUSING.txt,486594,487798,1204,5,N,N,-,-1,-1
MUSING.txt,487799,489183,1384,5,N,N,-,-1,-1
MUSING.txt,489186,490303,1117,5,N,N,-,-1,-1
MUSING.txt,490304,490886,582,5,N,N,-,-1,-1
MUSING.txt,490888,491630,742,5,N,N,-,-1,-1
MUSING.txt,491631,492055,424,5,N,N,-,-1,-1
MUSING.txt,492056,493944,1888,5,N,N,-,-1,-1
MUSING.txt,493947,495032,1085,5,N,N,-,-1,-1
MUSING.txt,495033,495994,961,5,N,N,-,-1,-1
MUSING.txt,495995,496931,936,5,N,N,-,-1,-1
MUSING.txt,496934,497827,893,5,N,N,-,-1,-1
MUSING.txt,497828,499338,1510,5,N,N,-,-1,-1
MUSING.txt,499339,500093,754,5,N,N,-,-1,-1
MUSING.txt,500094,500910,816,5,N,N,-,-1,-1
MUSING.txt,500911,501482,571,5,N,N,-,-1,-1
MUSING.txt,501483,502457,974,5,N,N,-,-1,-1
MUSING.txt,502458,503637,1179,5,N,N,-,-1,-1
MUSING.txt,503638,504330,692,5,N,N,-,-1,-1
MUSING.txt,504332,505180,848,5,N,N,-,-1,-1
MUSING.txt,505181,506453,1272,5,N,N,-,-1,-1
MUSING.txt,506454,508225,1771,5,N,N,-,-1,-1
MUSING.txt,508228,509084,856,5,N,N,-,-1,-1
MUSING.txt,509085,509902,817,5,N,N,-,-1,-1
MUSING.txt,509903,510635,732,5,N,N,-,-1,-1
MUSREM.txt,8,316,308,5,N,N,-,-1,-1
MUSREM.txt,321,503,182,5,N,N,-,-1,-1
MUSREM.txt,506,870,364,5,N,N,-,-1,-1
MUSREM.txt,871,1107,236,5,N,N,-,-1,-1
MUSREM.txt,1110,1648,538,5,N,N,-,-1,-1
MUSREM.txt,1649,2089,440,5,N,N,-,-1,-1
MUSREM.txt,2092,2361,269,5,N,N,-,-1,-1
MUSREM.txt,2364,3533,1169,5,N,N,-,-1,-1
MUSREM.txt,3534,5022,1488,5,N,N,-,-1,-1
MUSREM.txt,5023,6163,1140,5,N,N,-,-1,-1
MUSREM.txt,6164,7149,985,5,N,N,-,-1,-1
MUSREM.txt,7152,8068,916,5,N,N,-,-1,-1
MUSREM.txt,8073,9028,955,5,N,N,-,-1,-1
MUSREM.txt,9031,9736,705,5,N,N,-,-1,-1
MUSREM.txt,9739,10488,749,5,N,Y,1445944603888,10479,11042
MUSREM.txt,10489,11056,567,5,N,Y,1445944603888,10479,11042
MUSREM.txt,11057,11638,581,5,N,Y,1445946913032,11418,11636
MUSREM.txt,11640,12228,588,5,N,N,-,-1,-1
MUSREM.txt,12231,13107,876,5,N,N,-,-1,-1
MUSREM.txt,13109,14146,1037,5,Y,N,-,-1,-1
MUSREM.txt,14147,14801,654,5,N,N,-,-1,-1
MUSREM.txt,14803,15790,987,5,Y,Y,1445947674116,15382,15779
MUSREM.txt,15793,16386,593,5,N,N,-,-1,-1
MUSREM.txt,16389,17145,756,5,Y,Y,1445948029052,16577,17138
MUSREM.txt,17146,17634,488,5,N,N,-,-1,-1
MUSREM.txt,17635,18365,730,5,N,Y,1445955109644,17888,18866
MUSREM.txt,18366,19206,840,5,Y,Y,1445955109644,17888,18866
MUSREM.txt,19207,19915,708,5,N,N,-,-1,-1
MUSREM.txt,19920,20450,530,5,N,N,-,-1,-1
MUSREM.txt,20452,21455,1003,5,N,Y,1445955591123,20528,20953
MUSREM.txt,21456,22545,1089,5,Y,N,-,-1,-1
MUSREM.txt,22546,23214,668,5,N,Y,1445955912022,23018,23382
MUSREM.txt,23215,24101,886,5,N,Y,1445955912022,23018,23382
MUSREM.txt,24102,24958,856,5,Y,Y,1445956412843,24469,24832
MUSREM.txt,24959,26010,1051,5,Y,N,-,-1,-1
MUSREM.txt,26013,26583,570,5,Y,Y,1445956802191,26011,26302
MUSREM.txt,26584,27256,672,5,N,N,-,-1,-1
MUSREM.txt,27259,27907,648,5,N,N,-,-1,-1
MUSREM.txt,27908,28823,915,5,N,Y,1445957251664,27927,28212
MUSREM.txt,28825,29590,765,5,N,N,-,-1,-1
MUSREM.txt,29591,30062,471,5,N,N,-,-1,-1
MUSREM.txt,30063,30673,610,5,N,N,-,-1,-1
MUSREM.txt,30674,31484,810,5,N,Y,1445957972281,31471,31861
MUSREM.txt,31484,32267,783,5,N,Y,1445957972281,31471,31861
MUSREM.txt,32268,33310,1042,5,Y,N,-,-1,-1
MUSREM.txt,33311,34012,701,5,N,N,-,-1,-1
MUSREM.txt,34014,34630,616,5,N,N,-,-1,-1
MUSREM.txt,34633,35318,685,5,Y,Y,1445963721474,35258,35532
MUSREM.txt,35319,36248,929,5,N,Y,1445963721474,35258,35532
MUSREM.txt,36249,36598,349,5,N,N,-,-1,-1
MUSREM.txt,36601,37398,797,5,N,Y,1445964059927,36883,37118
MUSREM.txt,37401,38154,753,5,N,Y,1445964475278,37399,37589
MUSREM.txt,38155,39060,905,5,N,N,-,-1,-1
MUSREM.txt,39063,39850,787,5,N,Y,1445964873481,39066,39377
MUSREM.txt,39851,40604,753,5,N,N,-,-1,-1
MUSREM.txt,40605,41297,692,5,Y,Y,1445965566465,40802,41605
MUSREM.txt,41298,42232,934,5,Y,Y,1445965566465,40802,41605
MUSREM.txt,42235,43021,786,5,Y,Y,1445966177296,42263,43015
MUSREM.txt,43022,43747,725,5,N,Y,1445966436521,43605,43853
MUSREM.txt,43748,44281,533,5,N,Y,1445966436521,43605,43853
MUSREM.txt,44282,44709,427,5,N,Y,1445966774127,43963,44403
MUSREM.txt,44712,45491,779,5,N,Y,1446052439741,45238,45486
MUSREM.txt,45494,46122,628,5,N,N,-,-1,-1
MUSREM.txt,46123,47146,1023,5,Y,Y,1446052861415,46803,47133
MUSREM.txt,47147,47779,632,5,N,Y,1446053342205,47195,47749
MUSREM.txt,47780,48584,804,5,Y,Y,1446053757053,48262,48584
MUSREM.txt,48585,49370,785,5,Y,Y,1446054206870,48925,49472
MUSREM.txt,49371,50111,740,5,Y,Y,1446054206870,48925,49472
MUSREM.txt,50114,50901,787,5,Y,Y,1446634843469,50295,50843
MUSREM.txt,50904,51673,769,5,N,Y,1446635157507,51003,51207
MUSREM.txt,51674,52421,747,5,N,N,-,-1,-1
MUSREM.txt,52421,53341,920,5,N,N,-,-1,-1
MUSREM.txt,53342,54132,790,5,N,N,-,-1,-1
MUSREM.txt,54135,54948,813,5,N,N,-,-1,-1
MUSREM.txt,54949,55634,685,5,N,N,-,-1,-1
MUSREM.txt,55636,56861,1225,5,Y,Y,1446636156055,56380,57523
MUSREM.txt,56862,57665,803,5,N,Y,1446636156055,56380,57523
MUSREM.txt,57666,58685,1019,5,Y,N,-,-1,-1
MUSREM.txt,58686,59162,476,5,N,N,-,-1,-1
MUSREM.txt,59165,59904,739,5,Y,N,-,-1,-1
MUSREM.txt,59905,61039,1134,5,Y,Y,1446637443845,60250,60839
MUSREM.txt,61040,61696,656,5,N,Y,1446637734026,60862,61393
MUSREM.txt,61699,62373,674,5,N,Y,1446638025744,61822,62204
MUSREM.txt,62374,63318,944,5,N,Y,1446638321422,63089,63407
MUSREM.txt,63319,64012,693,5,N,Y,1446638321422,63089,63407
MUSREM.txt,64013,64868,855,5,Y,Y,1446639780182,64006,64258
MUSREM.txt,64869,65747,878,5,N,N,-,-1,-1
MUSREM.txt,65749,66473,724,5,N,Y,1446640118196,66272,66825
MUSREM.txt,66475,67756,1281,5,Y,Y,1446640118196,66272,66825
MUSREM.txt,67758,68492,734,5,N,N,-,-1,-1
MUSREM.txt,68493,68992,499,5,N,N,-,-1,-1
MUSREM.txt,68993,70046,1053,5,N,Y,1446640889918,69534,70949
MUSREM.txt,70049,70826,777,5,N,Y,1446640889918,69534,70949
MUSREM.txt,70827,71343,516,5,Y,Y,1446640889918,69534,70949
MUSREM.txt,71344,72182,838,5,N,N,-,-1,-1
MUSREM.txt,72185,73077,892,5,N,N,-,-1,-1
MUSREM.txt,73078,74242,1164,5,N,N,-,-1,-1
MUSREM.txt,74247,74767,520,5,N,N,-,-1,-1
MUSREM.txt,74768,75644,876,5,N,N,-,-1,-1
MUSREM.txt,75646,76396,750,5,Y,N,-,-1,-1
MUSREM.txt,76397,77237,840,5,N,N,-,-1,-1
MUSREM.txt,77238,78200,962,5,Y,N,-,-1,-1
MUSREM.txt,78202,79192,990,5,Y,N,-,-1,-1
MUSREM.txt,79193,79862,669,5,N,N,-,-1,-1
MUSREM.txt,79863,80615,752,5,N,N,-,-1,-1
MUSREM.txt,80616,81193,577,5,N,N,-,-1,-1
MUSREM.txt,81196,81822,626,5,N,Y,1446647463097,81750,82066
MUSREM.txt,81825,82531,706,5,Y,Y,1446647463097,81750,82066
MUSREM.txt,82532,83121,589,5,Y,N,-,-1,-1
MUSREM.txt,83122,83825,703,5,N,N,-,-1,-1
MUSREM.txt,83828,84858,1030,5,Y,N,-,-1,-1
MUSREM.txt,84863,85572,709,5,N,N,-,-1,-1
MUSREM.txt,85574,86116,542,5,N,N,-,-1,-1
MUSREM.txt,86119,86942,823,5,N,Y,1446648222034,86772,88203
MUSREM.txt,86943,87946,1003,5,N,Y,1446648222034,86772,88203
MUSREM.txt,87949,88729,780,5,Y,Y,1446648222034,86772,88203
MUSREM.txt,88730,89340,610,5,N,N,-,-1,-1
MUSREM.txt,89341,90134,793,5,Y,Y,1446719749074,89471,89818
MUSREM.txt,90135,90908,773,5,Y,Y,1446720066011,90716,91222
MUSREM.txt,90910,91801,891,5,Y,Y,1446720066011,90716,91222
MUSREM.txt,91802,92792,990,5,N,Y,1446720539477,92682,93428
MUSREM.txt,92793,93468,675,5,Y,Y,1446720539477,92682,93428
MUSREM.txt,93471,94106,635,5,N,Y,1446721175262,93832,94969
MUSREM.txt,94107,94597,490,5,Y,Y,1446721175262,93832,94969
MUSREM.txt,94598,95087,489,5,N,Y,1446721175262,93832,94969
MUSREM.txt,95088,95713,625,5,N,Y,1446721440313,95396,95514
MUSREM.txt,95714,96297,583,5,N,Y,1446721729201,95506,95816
MUSREM.txt,96298,96855,557,5,N,N,-,-1,-1
MUSREM.txt,96856,97414,558,5,Y,Y,1446722309879,97182,97409
MUSREM.txt,97415,98093,678,5,N,Y,1446722777424,97629,98299
MUSREM.txt,98096,99019,923,5,N,Y,1446722777424,97629,98299
MUSREM.txt,99021,99924,903,5,N,Y,1446742788391,99269,99846
MUSREM.txt,99925,100849,924,5,N,Y,1446743095300,100170,100734
MUSREM.txt,100850,101494,644,5,N,N,-,-1,-1
MUSREM.txt,101495,102286,791,5,N,Y,1446743565991,102162,102827
MUSREM.txt,102287,103287,1000,5,Y,Y,1446743750418,103215,103356
MUSREM.txt,103290,104116,826,5,N,Y,1446743750418,103215,103356
MUSREM.txt,104117,104715,598,5,N,N,-,-1,-1
MUSREM.txt,104715,105623,908,5,N,Y,1446744408545,105127,106612
MUSREM.txt,105625,107260,1635,5,Y,Y,1446744408545,105127,106612
MUSREM.txt,107261,107921,660,5,N,N,-,-1,-1
MUSREM.txt,107922,108854,932,5,N,N,-,-1,-1
MUSREM.txt,108855,109630,775,5,N,N,-,-1,-1
MUSREM.txt,109633,110440,807,5,N,N,-,-1,-1
MUSREM.txt,110441,111265,824,5,N,Y,1446744877240,111104,111542
MUSREM.txt,111267,111881,614,5,N,Y,1446744877240,111104,111542
MUSREM.txt,111884,112784,900,5,Y,N,-,-1,-1
MUSREM.txt,112787,113693,906,5,N,N,-,-1,-1
MUSREM.txt,113694,114615,921,5,N,N,-,-1,-1
MUSREM.txt,114615,115792,1177,5,N,N,-,-1,-1
MUSREM.txt,115797,116649,852,5,N,N,-,-1,-1
MUSREM.txt,116652,117363,711,5,N,N,-,-1,-1
MUSREM.txt,117366,118214,848,5,N,Y,1446808893671,117606,117864
MUSREM.txt,118217,119735,1518,5,Y,N,-,-1,-1
MUSREM.txt,119736,120697,961,5,Y,Y,1446809343172,120380,120695
MUSREM.txt,120698,121536,838,5,Y,N,-,-1,-1
MUSREM.txt,121538,122049,511,5,N,N,-,-1,-1
MUSREM.txt,122050,122993,943,5,N,N,-,-1,-1
MUSREM.txt,122998,123523,525,5,N,N,-,-1,-1
MUSREM.txt,123526,124473,947,5,N,Y,1446809771688,123931,124283
MUSREM.txt,124476,125337,861,5,N,N,-,-1,-1
MUSREM.txt,125342,126034,692,5,N,N,-,-1,-1
MUSREM.txt,126037,127157,1120,5,N,N,-,-1,-1
MUSREM.txt,127160,128217,1057,5,N,N,-,-1,-1
MUSREM.txt,128218,128924,706,5,N,N,-,-1,-1
MUSREM.txt,128925,129501,576,5,N,N,-,-1,-1
MUSREM.txt,129504,130383,879,5,Y,N,-,-1,-1
MUSREM.txt,130384,131638,1254,5,Y,N,-,-1,-1
MUSREM.txt,131643,132629,986,5,Y,N,-,-1,-1
MUSREM.txt,132630,133207,577,5,N,N,-,-1,-1
MUSREM.txt,133208,133952,744,5,N,N,-,-1,-1
MUSREM.txt,133952,134746,794,5,Y,N,-,-1,-1
MUSREM.txt,134747,135706,959,5,N,N,-,-1,-1
MUSREM.txt,135708,136464,756,5,N,N,-,-1,-1
MUSREM.txt,136467,137474,1007,5,N,Y,1446810408665,136481,136987
MUSREM.txt,137475,138391,916,5,N,N,-,-1,-1
MUSREM.txt,138394,139097,703,5,N,N,-,-1,-1
MUSREM.txt,139098,140011,913,5,N,N,-,-1,-1
MUSREM.txt,140012,140868,856,5,N,N,-,-1,-1
MUSREM.txt,140869,141604,735,5,N,N,-,-1,-1
MUSREM.txt,141605,142048,443,5,N,N,-,-1,-1
MUSREM.txt,142049,143434,1385,5,N,N,-,-1,-1
MUSREM.txt,143437,144045,608,5,N,Y,1446810866600,143464,144041
MUSREM.txt,144046,144488,442,5,N,N,-,-1,-1
MUSREM.txt,144491,144916,425,5,N,Y,1446811109129,144788,145068
MUSREM.txt,144917,145974,1057,5,Y,Y,1446811109129,144788,145068
MUSREM.txt,145976,146826,850,5,N,Y,1446811471283,146801,147362
MUSREM.txt,146831,147518,687,5,Y,Y,1446811837346,147380,148123
MUSREM.txt,147519,148159,640,5,N,Y,1446811837346,147380,148123
MUSREM.txt,148160,148584,424,5,N,N,-,-1,-1
MUSREM.txt,148585,149489,904,5,N,N,-,-1,-1
MUSREM.txt,149490,150281,791,5,N,N,-,-1,-1
MUSREM.txt,150282,150969,687,5,N,N,-,-1,-1
MUSREM.txt,150972,152026,1054,5,N,Y,1446813333984,151500,152176
MUSREM.txt,152027,152740,713,5,N,Y,1446813333984,151500,152176
MUSREM.txt,152741,153148,407,5,N,N,-,-1,-1
MUSREM.txt,153151,153832,681,5,N,N,-,-1,-1
MUSREM.txt,153833,154756,923,5,Y,Y,1446813762750,154311,154910
MUSREM.txt,154757,155690,933,5,N,Y,1446813762750,154311,154910
MUSREM.txt,155692,156629,937,5,Y,Y,1446814069686,154960,156195
MUSREM.txt,156630,157643,1013,5,N,Y,1446814509617,157137,157477
MUSREM.txt,157648,158270,622,5,N,Y,1446814798626,157586,157884
MUSREM.txt,158271,158964,693,5,N,Y,1446818906646,158638,159239
MUSREM.txt,158965,159915,950,5,N,Y,1446818906646,158638,159239
MUSREM.txt,159916,160641,725,5,N,N,-,-1,-1
MUSREM.txt,160646,160788,142,5,N,N,-,-1,-1
MUSREM.txt,160791,161425,634,5,N,Y,1446819402984,161235,162017
MUSREM.txt,161426,162272,846,5,N,Y,1446819402984,161235,162017
MUSREM.txt,162273,162947,674,5,N,N,-,-1,-1
MUSREM.txt,162950,163512,562,5,N,N,-,-1,-1
MUSREM.txt,163515,164251,736,5,N,N,-,-1,-1
MUSREM.txt,164252,164910,658,5,N,N,-,-1,-1
MUSREM.txt,164911,165794,883,5,N,N,-,-1,-1
MUSREM.txt,165795,166508,713,5,N,N,-,-1,-1
MUSREM.txt,166511,167456,945,5,Y,Y,1446820062767,167097,167662
MUSREM.txt,167457,168423,966,5,Y,Y,1446820062767,167097,167662
MUSREM.txt,168426,169472,1046,5,N,N,-,-1,-1
MUSREM.txt,169473,170594,1121,5,N,Y,1446820734391,170585,172593
MUSREM.txt,170595,171536,941,5,Y,Y,1446820734391,170585,172593
MUSREM.txt,171537,172385,848,5,N,Y,1446820734391,170585,172593
MUSREM.txt,172386,172716,330,5,N,Y,1446820734391,170585,172593
MUSREM.txt,172717,173397,680,5,N,Y,1446821453239,172722,173763
MUSREM.txt,173398,174093,695,5,N,Y,1446821453239,172722,173763
MUSREM.txt,174094,174812,718,5,N,N,-,-1,-1
MUSREM.txt,174815,175562,747,5,N,N,-,-1,-1
MUSREM.txt,175563,176327,764,5,N,Y,1446821880661,175939,176466
MUSREM.txt,176328,176980,652,5,N,Y,1446821880661,175939,176466
MUSREM.txt,176981,177920,939,5,N,Y,1446823433860,177434,177715
MUSREM.txt,177921,178747,826,5,N,N,-,-1,-1
MUSREM.txt,178750,179790,1040,5,N,Y,1446823931858,179105,180424
MUSREM.txt,179795,180240,445,5,Y,Y,1446823931858,179105,180424
MUSREM.txt,180241,180824,583,5,Y,Y,1446823931858,179105,180424
MUSREM.txt,180824,181799,975,5,N,N,-,-1,-1
MUSREM.txt,181804,182543,739,5,N,N,-,-1,-1
MUSREM.txt,182543,183110,567,5,N,N,-,-1,-1
MUSREM.txt,183112,183661,549,5,N,N,-,-1,-1
MUSREM.txt,183662,184836,1174,5,N,N,-,-1,-1
MUSREM.txt,184841,185664,823,5,N,N,-,-1,-1
MUSREM.txt,185665,186538,873,5,N,N,-,-1,-1
MUSREM.txt,186539,188077,1538,5,N,N,-,-1,-1
MUSREM.txt,188078,188973,895,5,N,N,-,-1,-1
MUSREM.txt,188974,190008,1034,5,N,N,-,-1,-1
MUSREM.txt,190009,190502,493,5,N,N,-,-1,-1
MUSREM.txt,190503,191620,1117,5,N,N,-,-1,-1
MUSREM.txt,191621,192133,512,5,N,N,-,-1,-1
MUSREM.txt,192134,193212,1078,5,N,N,-,-1,-1
MUSREM.txt,193215,194476,1261,5,N,N,-,-1,-1
MUSREM.txt,194481,195487,1006,5,N,N,-,-1,-1
MUSREM.txt,195489,196325,836,5,N,N,-,-1,-1
MUSREM.txt,196326,197463,1137,5,N,N,-,-1,-1
MUSREM.txt,197464,198376,912,5,N,Y,1446824933321,197918,199597
MUSREM.txt,198377,198983,606,5,N,Y,1446824933321,197918,199597
MUSREM.txt,198985,199657,672,5,N,Y,1446824933321,197918,199597
MUSREM.txt,199658,200574,916,5,N,Y,1447063241953,200523,201321
MUSREM.txt,200575,201550,975,5,Y,Y,1447063241953,200523,201321
MUSREM.txt,201551,202011,460,5,N,N,-,-1,-1
MUSREM.txt,202012,202600,588,5,N,N,-,-1,-1
MUSREM.txt,202603,203104,501,5,N,N,-,-1,-1
MUSREM.txt,203105,203885,780,5,Y,N,-,-1,-1
MUSREM.txt,203888,204462,574,5,N,N,-,-1,-1
MUSREM.txt,204467,205052,585,5,N,N,-,-1,-1
MUSREM.txt,205053,205840,787,5,N,N,-,-1,-1
MUSREM.txt,205841,206598,757,5,N,N,-,-1,-1
MUSREM.txt,206599,207226,627,5,N,N,-,-1,-1
MUSREM.txt,207227,207781,554,5,N,Y,1447063940500,207257,208280
MUSREM.txt,207782,208300,518,5,N,Y,1447063940500,207257,208280
MUSREM.txt,208302,208884,582,5,N,N,-,-1,-1
MUSREM.txt,208885,209394,509,5,N,N,-,-1,-1
MUSREM.txt,209397,210181,784,5,N,N,-,-1,-1
MUSREM.txt,210182,210660,478,5,N,Y,1447064379607,210331,210573
MUSREM.txt,210661,211657,996,5,N,Y,1447064838733,211126,211718
MUSREM.txt,211658,212365,707,5,N,Y,1447065110339,211796,212188
MUSREM.txt,212366,213066,700,5,N,Y,1447065364515,212366,212614
MUSREM.txt,213066,213659,593,5,Y,Y,1447065659153,213218,213654
MUSREM.txt,213660,214273,613,5,N,N,-,-1,-1
MUSREM.txt,214274,215058,784,5,N,Y,1448538454094,214861,215222
MUSREM.txt,215059,215768,709,5,Y,Y,1448538803111,215417,216014
MUSREM.txt,215770,216430,660,5,N,Y,1448538803111,215417,216014
MUSREM.txt,216433,217023,590,5,N,N,-,-1,-1
MUSREM.txt,217024,217595,571,5,N,N,-,-1,-1
MUSREM.txt,217596,218106,510,5,N,Y,1448539695891,217596,217897
MUSREM.txt,218107,218761,654,5,N,Y,1448539816075,217930,218206
MUSREM.txt,218762,219385,623,5,N,Y,1448540487155,218969,220902
MUSREM.txt,219386,220119,733,5,Y,Y,1448540487155,218969,220902
MUSREM.txt,220120,220755,635,5,N,Y,1448540487155,218969,220902
MUSREM.txt,220756,221435,679,5,Y,Y,1448540487155,218969,220902
MUSREM.txt,221436,221988,552,5,N,N,-,-1,-1
MUSREM.txt,221990,222839,849,5,N,N,-,-1,-1
MUSREM.txt,222840,223920,1080,5,Y,N,-,-1,-1
MUSREM.txt,223923,224823,900,5,N,N,-,-1,-1
MUSREM.txt,224826,225280,454,5,N,N,-,-1,-1
MUSREM.txt,225283,225981,698,5,N,N,-,-1,-1
MUSREM.txt,225982,226999,1017,5,Y,N,-,-1,-1
MUSREM.txt,227000,227935,935,5,N,N,-,-1,-1
MUSREM.txt,227938,228631,693,5,N,N,-,-1,-1
MUSREM.txt,228632,229444,812,5,N,N,-,-1,-1
MUSREM.txt,229447,230211,764,5,N,N,-,-1,-1
MUSREM.txt,230216,230781,565,5,N,N,-,-1,-1
MUSREM.txt,230782,231363,581,5,N,N,-,-1,-1
MUSREM.txt,231364,232252,888,5,N,N,-,-1,-1
MUSREM.txt,232253,233065,812,5,N,N,-,-1,-1
MUSREM.txt,233066,233888,822,5,N,N,-,-1,-1
MUSREM.txt,233889,234966,1077,5,N,N,-,-1,-1
MUSREM.txt,234968,235862,894,5,N,N,-,-1,-1
MUSREM.txt,235863,236593,730,5,N,N,-,-1,-1
MUSREM.txt,236594,237224,630,5,N,N,-,-1,-1
MUSREM.txt,237226,238036,810,5,N,N,-,-1,-1
MUSREM.txt,238039,238850,811,5,N,N,-,-1,-1
MUSREM.txt,238851,239679,828,5,N,Y,1448634950635,239410,239860
MUSREM.txt,239680,240283,603,5,N,Y,1448634950635,239410,239860
MUSREM.txt,240283,240348,65,5,N,N,-,-1,-1
MUSREM.txt,240349,240484,135,5,N,N,-,-1,-1
MUSREM.txt,240489,241366,877,5,Y,N,-,-1,-1
MUSREM.txt,241367,242193,826,5,N,N,-,-1,-1
MUSREM.txt,242195,243017,822,5,N,N,-,-1,-1
MUSREM.txt,243018,243701,683,5,N,N,-,-1,-1
MUSREM.txt,243702,244952,1250,5,Y,N,-,-1,-1
MUSREM.txt,244953,245871,918,5,N,N,-,-1,-1
MUSREM.txt,245872,246910,1038,5,N,N,-,-1,-1
MUSREM.txt,246911,247780,869,5,N,N,-,-1,-1
MUSREM.txt,247781,248403,622,5,N,N,-,-1,-1
MUSREM.txt,248406,249238,832,5,N,Y,1448635413557,249132,249521
MUSREM.txt,249239,250390,1151,5,N,Y,1448635413557,249132,249521
MUSREM.txt,250391,251013,622,5,N,Y,1448635980588,250398,250825
MUSREM.txt,251014,251480,466,5,N,N,-,-1,-1
MUSREM.txt,251481,252004,523,5,N,N,-,-1,-1
MUSREM.txt,252006,253010,1004,5,N,N,-,-1,-1
MUSREM.txt,253011,253813,802,5,N,N,-,-1,-1
MUSREM.txt,253814,254417,603,5,N,N,-,-1,-1
MUSREM.txt,254420,255353,933,5,N,N,-,-1,-1
MUSREM.txt,255354,256258,904,5,N,Y,1448636605363,256225,257318
MUSREM.txt,256259,256862,603,5,N,Y,1448636605363,256225,257318
MUSREM.txt,256863,257373,510,5,N,Y,1448636605363,256225,257318
MUSREM.txt,257376,258159,783,5,N,N,-,-1,-1
MUSREM.txt,258160,258797,637,5,N,N,-,-1,-1
MUSREM.txt,258798,259738,940,5,Y,N,-,-1,-1
MUSREM.txt,259739,260456,717,5,N,Y,1448637072058,259739,260989
MUSREM.txt,260457,261235,778,5,N,Y,1448637072058,259739,260989
MUSREM.txt,261238,261832,594,5,N,N,-,-1,-1
MUSREM.txt,261833,262472,639,5,N,Y,1448637339862,262368,262868
MUSREM.txt,262473,263568,1095,5,N,Y,1448637339862,262368,262868
MUSREM.txt,263569,264449,880,5,Y,Y,1448640113228,263913,264263
MUSREM.txt,264450,264946,496,5,N,N,-,-1,-1
MUSREM.txt,264947,266073,1126,5,N,Y,1448640538484,265221,266337
MUSREM.txt,266074,266660,586,5,N,Y,1448640538484,265221,266337
MUSREM.txt,266661,267312,651,5,N,Y,1448971601346,266958,268184
MUSREM.txt,267313,267724,411,5,N,Y,1448971601346,266958,268184
MUSREM.txt,267725,268535,810,5,N,Y,1448971601346,266958,268184
MUSREM.txt,268536,268903,367,5,N,Y,1448972027684,268678,270113
MUSREM.txt,268904,269752,848,5,N,Y,1448972027684,268678,270113
MUSREM.txt,269753,270315,562,5,N,Y,1448972027684,268678,270113
MUSREM.txt,270316,270863,547,5,N,Y,1448972312196,270498,270666
MUSREM.txt,270866,271637,771,5,N,N,-,-1,-1
MUSREM.txt,271638,272433,795,5,N,Y,1448972712694,271727,272544
MUSREM.txt,272434,272883,449,5,N,Y,1448972712694,271727,272544
MUSREM.txt,272884,273612,728,5,N,N,-,-1,-1
MUSREM.txt,273613,274384,771,5,N,N,-,-1,-1
MUSREM.txt,274385,275057,672,5,N,Y,1448973059320,274486,274617
MUSREM.txt,275060,275762,702,5,N,Y,1448973292285,274886,275121
MUSREM.txt,275763,276287,524,5,N,Y,1448973653146,275855,276084
MUSREM.txt,276288,276906,618,5,N,Y,1448980124717,276863,277295
MUSREM.txt,276908,277299,391,5,N,Y,1448980124717,276863,277295
MUSREM.txt,277302,278109,807,5,N,N,-,-1,-1
MUSREM.txt,278114,278978,864,5,N,N,-,-1,-1
MUSREM.txt,278979,279936,957,5,N,Y,1448980436772,279074,279287
MUSREM.txt,279937,280567,630,5,N,Y,1448981024747,279424,280031
MUSREM.txt,280568,281246,678,5,N,Y,1448981398336,280787,280977
MUSREM.txt,281247,281723,476,5,N,N,-,-1,-1
MUSREM.txt,281724,282279,555,5,N,Y,1448981870937,282204,283086
MUSREM.txt,282280,283105,825,5,Y,Y,1448981870937,282204,283086
MUSREM.txt,283106,283637,531,5,N,N,-,-1,-1
MUSREM.txt,283639,284368,729,5,N,Y,1448982281247,283638,283867
MUSREM.txt,284369,285392,1023,5,N,Y,1448982574488,283879,284496
MUSREM.txt,285393,286196,803,5,N,Y,1448983037053,285585,285882
MUSREM.txt,286197,286852,655,5,N,N,-,-1,-1
MUSREM.txt,286854,287349,495,5,N,Y,1448988789823,287061,287381
MUSREM.txt,287350,287778,428,5,N,Y,1448988789823,287061,287381
MUSREM.txt,287779,288208,429,5,N,Y,1448989093244,287997,288526
MUSREM.txt,288209,288586,377,5,N,Y,1448989093244,287997,288526
MUSREM.txt,288588,289355,767,5,Y,Y,1448989363526,288790,289249
MUSREM.txt,289356,290239,883,5,N,Y,1448989871144,289506,290112
MUSREM.txt,290240,291207,967,5,N,N,-,-1,-1
MUSREM.txt,291208,292038,830,5,N,Y,1448990639546,291228,292408
MUSREM.txt,292040,293246,1206,5,Y,Y,1448990639546,291228,292408
MUSREM.txt,293247,294084,837,5,N,Y,1448990999695,292818,293369
MUSREM.txt,294085,294852,767,5,N,Y,1448991259482,294449,294734
MUSREM.txt,294853,296027,1174,5,N,N,-,-1,-1
MUSREM.txt,296028,296701,673,5,N,N,-,-1,-1
MUSREM.txt,296702,297736,1034,5,N,N,-,-1,-1
MUSREM.txt,297737,298318,581,5,N,N,-,-1,-1
MUSREM.txt,298319,298835,516,5,N,N,-,-1,-1
MUSREM.txt,298836,300008,1172,5,N,N,-,-1,-1
MUSREM.txt,300009,300643,634,5,N,N,-,-1,-1
MUSREM.txt,300644,301515,871,5,N,N,-,-1,-1
MUSREM.txt,301520,302591,1071,5,N,N,-,-1,-1
MUSREM.txt,302592,303359,767,5,N,N,-,-1,-1
MUSREM.txt,303359,304231,872,5,N,N,-,-1,-1
MUSREM.txt,304232,304815,583,5,N,N,-,-1,-1
MUSREM.txt,304820,305325,505,5,N,N,-,-1,-1
MUSREM.txt,305326,305988,662,5,N,N,-,-1,-1
MUSREM.txt,305989,306216,227,5,N,N,-,-1,-1
OUSELEY.txt,0,909,909,5,N,N,-,-1,-1
OUSELEY.txt,910,2717,1807,5,N,N,-,-1,-1
OUSELEY.txt,2718,5214,2496,5,N,N,-,-1,-1
OUSELEY.txt,5215,7977,2762,5,N,N,-,-1,-1
OUSELEY.txt,7978,11297,3319,5,N,N,-,-1,-1
OUSELEY.txt,11298,11499,201,5,N,N,-,-1,-1
OUSELEY.txt,11499,11538,39,5,N,N,-,-1,-1
OUSELEY.txt,11538,11884,346,5,N,N,-,-1,-1
OUSELEY.txt,11885,12747,862,5,N,N,-,-1,-1
OUSELEY.txt,12749,13030,281,5,N,N,-,-1,-1
OUSELEY.txt,13031,13772,741,5,N,N,-,-1,-1
OUSELEY.txt,13773,14592,819,5,N,N,-,-1,-1
OUSELEY.txt,14593,15052,459,5,N,N,-,-1,-1
OUSELEY.txt,15053,15276,223,5,N,N,-,-1,-1
OUSELEY.txt,15278,15923,645,5,N,N,-,-1,-1
OUSELEY.txt,15924,16358,434,5,N,N,-,-1,-1
OUSELEY.txt,16360,17115,755,5,N,N,-,-1,-1
OUSELEY.txt,17116,17625,509,5,N,N,-,-1,-1
OUSELEY.txt,17626,19249,1623,5,N,N,-,-1,-1
OUSELEY.txt,19250,20284,1034,5,N,N,-,-1,-1
OUSELEY.txt,20289,20605,316,5,N,N,-,-1,-1
OUSELEY.txt,20606,21780,1174,5,N,N,-,-1,-1
OUSELEY.txt,21783,22903,1120,5,N,N,-,-1,-1
OUSELEY.txt,22906,23987,1081,5,N,N,-,-1,-1
OUSELEY.txt,23988,25342,1354,5,N,N,-,-1,-1
OUSELEY.txt,25343,25971,628,5,N,N,-,-1,-1
OUSELEY.txt,25972,26327,355,5,N,N,-,-1,-1
OUSELEY.txt,26328,26594,266,5,N,N,-,-1,-1
OUSELEY.txt,26595,26929,334,5,N,N,-,-1,-1
OUSELEY.txt,26930,27361,431,5,N,N,-,-1,-1
OUSELEY.txt,27362,28456,1094,5,N,N,-,-1,-1
OUSELEY.txt,28457,29377,920,5,N,N,-,-1,-1
OUSELEY.txt,29380,29533,153,5,N,N,-,-1,-1
OUSELEY.txt,29535,30036,501,5,N,N,-,-1,-1
OUSELEY.txt,30037,31699,1662,5,N,N,-,-1,-1
OUSELEY.txt,31702,32106,404,5,N,N,-,-1,-1
OUSELEY.txt,32107,32656,549,5,N,N,-,-1,-1
OUSELEY.txt,32658,33459,801,5,N,N,-,-1,-1
OUSELEY.txt,33462,34283,821,5,N,N,-,-1,-1
OUSELEY.txt,34284,34856,572,5,N,N,-,-1,-1
OUSELEY.txt,34859,36135,1276,5,N,N,-,-1,-1
OUSELEY.txt,36136,36988,852,5,N,N,-,-1,-1
OUSELEY.txt,36993,38180,1187,5,N,N,-,-1,-1
OUSELEY.txt,38183,39113,930,5,N,N,-,-1,-1
OUSELEY.txt,39116,39483,367,5,N,N,-,-1,-1
OUSELEY.txt,39484,39892,408,5,N,N,-,-1,-1
OUSELEY.txt,39895,40775,880,5,N,N,-,-1,-1
OUSELEY.txt,40780,41391,611,5,N,N,-,-1,-1
OUSELEY.txt,41392,41981,589,5,N,Y,1436610229204,41646,43959
OUSELEY.txt,41982,42946,964,5,N,Y,1436610229204,41646,43959
OUSELEY.txt,42949,43849,900,5,N,Y,1436610229204,41646,43959
OUSELEY.txt,43852,44464,612,5,N,Y,1436610229204,41646,43959
OUSELEY.txt,44465,45035,570,5,N,N,-,-1,-1
OUSELEY.txt,45036,45472,436,5,N,N,-,-1,-1
OUSELEY.txt,45473,45622,149,5,N,N,-,-1,-1
OUSELEY.txt,45627,45711,84,5,N,N,-,-1,-1
OUSELEY.txt,45714,46343,629,5,N,N,-,-1,-1
OUSELEY.txt,46344,47109,765,5,N,N,-,-1,-1
OUSELEY.txt,47110,47371,261,5,N,N,-,-1,-1
OUSELEY.txt,47372,48116,744,5,N,N,-,-1,-1
OUSELEY.txt,48117,48787,670,5,N,N,-,-1,-1
OUSELEY.txt,48788,49306,518,5,N,N,-,-1,-1
OUSELEY.txt,49307,50240,933,5,N,N,-,-1,-1
OUSELEY.txt,50242,50911,669,5,N,N,-,-1,-1
OUSELEY.txt,50912,51556,644,5,N,N,-,-1,-1
OUSELEY.txt,51557,52472,915,5,N,N,-,-1,-1
OUSELEY.txt,52473,53116,643,5,N,N,-,-1,-1
OUSELEY.txt,53118,54066,948,5,N,N,-,-1,-1
OUSELEY.txt,54068,54599,531,5,N,N,-,-1,-1
OUSELEY.txt,54600,55522,922,5,N,N,-,-1,-1
OUSELEY.txt,55523,56644,1121,5,N,N,-,-1,-1
OUSELEY.txt,56645,57459,814,5,N,N,-,-1,-1
OUSELEY.txt,57460,58223,763,5,N,N,-,-1,-1
OUSELEY.txt,58226,58604,378,5,N,N,-,-1,-1
OUSELEY.txt,58605,58984,379,5,N,N,-,-1,-1
OUSELEY.txt,58985,59714,729,5,N,N,-,-1,-1
OUSELEY.txt,59715,60383,668,5,N,N,-,-1,-1
OUSELEY.txt,60384,61223,839,5,N,N,-,-1,-1
OUSELEY.txt,61225,61867,642,5,N,N,-,-1,-1
OUSELEY.txt,61868,62613,745,5,N,N,-,-1,-1
OUSELEY.txt,62616,63416,800,5,N,N,-,-1,-1
OUSELEY.txt,63418,64202,784,5,N,N,-,-1,-1
OUSELEY.txt,64203,65070,867,5,N,N,-,-1,-1
OUSELEY.txt,65071,65739,668,5,N,N,-,-1,-1
OUSELEY.txt,65740,66748,1008,5,N,N,-,-1,-1
OUSELEY.txt,66749,67887,1138,5,N,N,-,-1,-1
OUSELEY.txt,67888,68557,669,5,N,N,-,-1,-1
OUSELEY.txt,68562,69565,1003,5,N,N,-,-1,-1
OUSELEY.txt,69566,70598,1032,5,N,N,-,-1,-1
OUSELEY.txt,70600,71384,784,5,N,N,-,-1,-1
OUSELEY.txt,71385,71804,419,5,N,N,-,-1,-1
OUSELEY.txt,71809,72595,786,5,N,N,-,-1,-1
OUSELEY.txt,72596,73718,1122,5,N,N,-,-1,-1
OUSELEY.txt,73719,74090,371,5,N,N,-,-1,-1
OUSELEY.txt,74091,74729,638,5,N,N,-,-1,-1
OUSELEY.txt,74732,75370,638,5,N,N,-,-1,-1
OUSELEY.txt,75372,76170,798,5,N,N,-,-1,-1
OUSELEY.txt,76171,76974,803,5,N,N,-,-1,-1
OUSELEY.txt,76975,78037,1062,5,N,N,-,-1,-1
OUSELEY.txt,78038,78862,824,5,N,N,-,-1,-1
OUSELEY.txt,78865,79556,691,5,N,N,-,-1,-1
OUSELEY.txt,79557,79704,147,5,N,N,-,-1,-1
OUSELEY.txt,79705,80849,1144,5,N,N,-,-1,-1
OUSELEY.txt,80850,81984,1134,5,N,N,-,-1,-1
OUSELEY.txt,81989,82475,486,5,N,N,-,-1,-1
OUSELEY.txt,82476,83298,822,5,N,N,-,-1,-1
OUSELEY.txt,83299,83984,685,5,N,N,-,-1,-1
OUSELEY.txt,83987,84628,641,5,N,N,-,-1,-1
OUSELEY.txt,84629,85184,555,5,N,N,-,-1,-1
OUSELEY.txt,85185,85962,777,5,N,N,-,-1,-1
OUSELEY.txt,85963,87042,1079,5,N,N,-,-1,-1
OUSELEY.txt,87045,87693,648,5,N,N,-,-1,-1
OUSELEY.txt,87694,88622,928,5,N,N,-,-1,-1
OUSELEY.txt,88623,88959,336,5,N,N,-,-1,-1
OUSELEY.txt,88960,90232,1272,5,N,N,-,-1,-1
OUSELEY.txt,90233,91112,879,5,N,N,-,-1,-1
OUSELEY.txt,91117,92146,1029,5,N,N,-,-1,-1
OUSELEY.txt,92147,92964,817,5,N,N,-,-1,-1
OUSELEY.txt,92965,94186,1221,5,N,N,-,-1,-1
OUSELEY.txt,94187,94873,686,5,N,N,-,-1,-1
OUSELEY.txt,94874,95751,877,5,N,N,-,-1,-1
OUSELEY.txt,95752,96532,780,5,N,N,-,-1,-1
OUSELEY.txt,96535,97409,874,5,N,N,-,-1,-1
OUSELEY.txt,97410,98099,689,5,N,N,-,-1,-1
OUSELEY.txt,98100,99262,1162,5,N,N,-,-1,-1
OUSELEY.txt,99263,101036,1773,5,N,N,-,-1,-1
OUSELEY.txt,101037,103197,2160,5,N,N,-,-1,-1
OUSELEY.txt,103200,104592,1392,5,N,N,-,-1,-1
OUSELEY.txt,104593,106101,1508,5,N,N,-,-1,-1
OUSELEY.txt,106102,106929,827,5,N,N,-,-1,-1
OUSELEY.txt,106930,107778,848,5,N,N,-,-1,-1
OUSELEY.txt,107779,108082,303,5,N,N,-,-1,-1
OUSELEY.txt,108085,108314,229,5,N,N,-,-1,-1
OUSELEY.txt,108315,108710,395,5,N,N,-,-1,-1
OUSELEY.txt,108711,109233,522,5,N,N,-,-1,-1
OUSELEY.txt,109234,109749,515,5,N,N,-,-1,-1
OUSELEY.txt,109750,110248,498,5,N,N,-,-1,-1
OUSELEY.txt,110249,110800,551,5,N,N,-,-1,-1
OUSELEY.txt,110801,111688,887,5,N,N,-,-1,-1
OUSELEY.txt,111689,112272,583,5,N,N,-,-1,-1
OUSELEY.txt,112273,113233,960,5,N,N,-,-1,-1
OUSELEY.txt,113235,113993,758,5,N,N,-,-1,-1
OUSELEY.txt,113994,114901,907,5,N,N,-,-1,-1
OUSELEY.txt,114902,115738,836,5,N,N,-,-1,-1
OUSELEY.txt,115739,116180,441,5,N,N,-,-1,-1
OUSELEY.txt,116181,116523,342,5,N,N,-,-1,-1
OUSELEY.txt,116524,116832,308,5,N,N,-,-1,-1
OUSELEY.txt,116833,117182,349,5,N,N,-,-1,-1
OUSELEY.txt,117183,117422,239,5,N,N,-,-1,-1
OUSELEY.txt,117424,117709,285,5,N,N,-,-1,-1
OUSELEY.txt,117710,118054,344,5,N,N,-,-1,-1
OUSELEY.txt,118055,118332,277,5,N,N,-,-1,-1
OUSELEY.txt,118334,118858,524,5,N,N,-,-1,-1
OUSELEY.txt,118859,119609,750,5,N,N,-,-1,-1
OUSELEY.txt,119610,120106,496,5,N,N,-,-1,-1
OUSELEY.txt,120107,120692,585,5,N,N,-,-1,-1
OUSELEY.txt,120693,121633,940,5,N,N,-,-1,-1
OUSELEY.txt,121634,122869,1235,5,N,N,-,-1,-1
OUSELEY.txt,122874,123840,966,5,N,N,-,-1,-1
OUSELEY.txt,123842,124695,853,5,N,N,-,-1,-1
OUSELEY.txt,124698,125318,620,5,N,N,-,-1,-1
OUSELEY.txt,125321,125949,628,5,N,N,-,-1,-1
OUSELEY.txt,125954,126641,687,5,N,N,-,-1,-1
OUSELEY.txt,126642,127694,1052,5,N,N,-,-1,-1
OUSELEY.txt,127695,129399,1704,5,N,N,-,-1,-1
OUSELEY.txt,129400,130424,1024,5,N,N,-,-1,-1
OUSELEY.txt,130425,132019,1594,5,N,N,-,-1,-1
OUSELEY.txt,132020,133012,992,5,N,N,-,-1,-1
OUSELEY.txt,133013,134067,1054,5,N,N,-,-1,-1
OUSELEY.txt,134068,134821,753,5,N,N,-,-1,-1
OUSELEY.txt,134826,136451,1625,5,N,N,-,-1,-1
OUSELEY.txt,136454,137303,849,5,N,N,-,-1,-1
OUSELEY.txt,137304,138099,795,5,N,N,-,-1,-1
OUSELEY.txt,138100,139093,993,5,N,N,-,-1,-1
OUSELEY.txt,139095,139756,661,5,N,N,-,-1,-1
OUSELEY.txt,139757,140135,378,5,N,N,-,-1,-1
OUSELEY.txt,140136,140638,502,5,N,N,-,-1,-1
OUSELEY.txt,140639,141576,937,5,N,N,-,-1,-1
OUSELEY.txt,141577,142684,1107,5,N,N,-,-1,-1
OUSELEY.txt,142685,143442,757,5,N,N,-,-1,-1
OUSELEY.txt,143443,144294,851,5,N,N,-,-1,-1
OUSELEY.txt,144295,145220,925,5,N,N,-,-1,-1
OUSELEY.txt,145221,145683,462,5,N,N,-,-1,-1
OUSELEY.txt,145684,146392,708,5,N,N,-,-1,-1
OUSELEY.txt,146392,146857,465,5,N,N,-,-1,-1
OUSELEY.txt,146858,147938,1080,5,N,N,-,-1,-1
OUSELEY.txt,147941,148831,890,5,N,N,-,-1,-1
OUSELEY.txt,148832,149910,1078,5,N,N,-,-1,-1
OUSELEY.txt,149911,150691,780,5,N,N,-,-1,-1
OUSELEY.txt,150692,151443,751,5,N,N,-,-1,-1
OUSELEY.txt,151444,152623,1179,5,N,N,-,-1,-1
OUSELEY.txt,152624,153069,445,5,N,N,-,-1,-1
OUSELEY.txt,153074,153842,768,5,N,N,-,-1,-1
OUSELEY.txt,153843,154635,792,5,N,N,-,-1,-1
OUSELEY.txt,154636,155438,802,5,N,N,-,-1,-1
OUSELEY.txt,155439,156501,1062,5,N,N,-,-1,-1
OUSELEY.txt,156504,157899,1395,5,N,N,-,-1,-1
OUSELEY.txt,157902,159047,1145,5,N,N,-,-1,-1
OUSELEY.txt,159052,159723,671,5,N,N,-,-1,-1
OUSELEY.txt,159726,160588,862,5,N,N,-,-1,-1
OUSELEY.txt,160589,161830,1241,5,N,N,-,-1,-1
OUSELEY.txt,161831,162313,482,5,N,N,-,-1,-1
OUSELEY.txt,162316,163071,755,5,N,N,-,-1,-1
OUSELEY.txt,163073,163684,611,5,N,N,-,-1,-1
OUSELEY.txt,163685,163849,164,5,N,N,-,-1,-1
OUSELEY.txt,163851,164969,1118,5,N,N,-,-1,-1
OUSELEY.txt,164971,165784,813,5,N,N,-,-1,-1
OUSELEY.txt,165785,166549,764,5,N,N,-,-1,-1
OUSELEY.txt,166554,167057,503,5,N,N,-,-1,-1
OUSELEY.txt,167058,167474,416,5,N,N,-,-1,-1
OUSELEY.txt,167475,168119,644,5,N,N,-,-1,-1
OUSELEY.txt,168120,169098,978,5,N,N,-,-1,-1
OUSELEY.txt,169103,169983,880,5,N,N,-,-1,-1
OUSELEY.txt,169984,170816,832,5,N,N,-,-1,-1
OUSELEY.txt,170818,171396,578,5,N,N,-,-1,-1
OUSELEY.txt,171397,171843,446,5,N,N,-,-1,-1
OUSELEY.txt,171844,172880,1036,5,N,N,-,-1,-1
OUSELEY.txt,172881,173491,610,5,N,N,-,-1,-1
OUSELEY.txt,173496,174583,1087,5,N,N,-,-1,-1
OUSELEY.txt,174584,175237,653,5,N,N,-,-1,-1
OUSELEY.txt,175238,176109,871,5,N,N,-,-1,-1
OUSELEY.txt,176110,176674,564,5,N,N,-,-1,-1
OUSELEY.txt,176675,177559,884,5,N,N,-,-1,-1
OUSELEY.txt,177562,178383,821,5,N,N,-,-1,-1
OUSELEY.txt,178384,178842,458,5,N,N,-,-1,-1
OUSELEY.txt,178844,179910,1066,5,N,N,-,-1,-1
OUSELEY.txt,179912,180937,1025,5,N,N,-,-1,-1
OUSELEY.txt,180939,181871,932,5,N,N,-,-1,-1
OUSELEY.txt,181874,182848,974,5,N,N,-,-1,-1
OUSELEY.txt,182850,183417,567,5,N,N,-,-1,-1
OUSELEY.txt,183418,183880,462,5,N,N,-,-1,-1
OUSELEY.txt,183883,184728,845,5,N,N,-,-1,-1
OUSELEY.txt,184729,185674,945,5,N,N,-,-1,-1
OUSELEY.txt,185675,187029,1354,5,N,N,-,-1,-1
OUSELEY.txt,187030,187815,785,5,N,N,-,-1,-1
OUSELEY.txt,187816,188607,791,5,N,N,-,-1,-1
OUSELEY.txt,188610,188698,88,5,N,N,-,-1,-1
OUSELEY.txt,188699,188776,77,5,N,N,-,-1,-1
OUSELEY.txt,188781,189542,761,5,N,N,-,-1,-1
OUSELEY.txt,189543,190159,616,5,N,N,-,-1,-1
OUSELEY.txt,190162,191263,1101,5,N,N,-,-1,-1
OUSELEY.txt,191266,192742,1476,5,N,N,-,-1,-1
OUSELEY.txt,192745,193753,1008,5,N,N,-,-1,-1
OUSELEY.txt,193753,194610,857,5,N,N,-,-1,-1
OUSELEY.txt,194611,195908,1297,5,N,N,-,-1,-1
OUSELEY.txt,195911,196878,967,5,N,N,-,-1,-1
OUSELEY.txt,196879,197316,437,5,N,N,-,-1,-1
OUSELEY.txt,197319,198079,760,5,N,N,-,-1,-1
OUSELEY.txt,198080,198495,415,5,N,N,-,-1,-1
OUSELEY.txt,198498,199165,667,5,N,N,-,-1,-1
OUSELEY.txt,199168,199377,209,5,N,N,-,-1,-1
OUSELEY.txt,199380,199790,410,5,N,N,-,-1,-1
OUSELEY.txt,199793,200185,392,5,N,N,-,-1,-1
OUSELEY.txt,200186,201607,1421,5,N,N,-,-1,-1
OUSELEY.txt,201608,202581,973,5,N,N,-,-1,-1
OUSELEY.txt,202582,204639,2057,5,N,N,-,-1,-1
OUSELEY.txt,204640,206046,1406,5,N,N,-,-1,-1
OUSELEY.txt,206048,206723,675,5,N,N,-,-1,-1
OUSELEY.txt,206728,206925,197,5,N,N,-,-1,-1
OUSELEY.txt,206926,207400,474,5,N,N,-,-1,-1
OUSELEY.txt,207401,207978,577,5,N,N,-,-1,-1
OUSELEY.txt,207979,208830,851,5,N,N,-,-1,-1
OUSELEY.txt,208831,209436,605,5,N,N,-,-1,-1
OUSELEY.txt,209437,210227,790,5,N,N,-,-1,-1
OUSELEY.txt,210228,211091,863,5,N,N,-,-1,-1
OUSELEY.txt,211092,211888,796,5,N,N,-,-1,-1
OUSELEY.txt,211889,212486,597,5,N,N,-,-1,-1
OUSELEY.txt,212487,213120,633,5,N,N,-,-1,-1
OUSELEY.txt,213121,213619,498,5,N,N,-,-1,-1
OUSELEY.txt,213622,215034,1412,5,N,N,-,-1,-1
OUSELEY.txt,215035,215993,958,5,N,N,-,-1,-1
OUSELEY.txt,215995,216688,693,5,N,N,-,-1,-1
OUSELEY.txt,216689,217847,1158,5,N,N,-,-1,-1
OUSELEY.txt,217848,218741,893,5,N,N,-,-1,-1
OUSELEY.txt,218742,219991,1249,5,N,N,-,-1,-1
OUSELEY.txt,219992,220669,677,5,N,N,-,-1,-1
OUSELEY.txt,220670,221550,880,5,N,N,-,-1,-1
OUSELEY.txt,221551,222632,1081,5,N,N,-,-1,-1
OUSELEY.txt,222634,224328,1694,5,N,N,-,-1,-1
OUSELEY.txt,224329,225768,1439,5,N,N,-,-1,-1
OUSELEY.txt,225769,227435,1666,5,N,N,-,-1,-1
OUSELEY.txt,227436,228460,1024,5,N,N,-,-1,-1
OUSELEY.txt,228461,229418,957,5,N,N,-,-1,-1
OUSELEY.txt,229419,230308,889,5,N,N,-,-1,-1
OUSELEY.txt,230309,231094,785,5,N,N,-,-1,-1
OUSELEY.txt,231096,232064,968,5,N,N,-,-1,-1
OUSELEY.txt,232065,233064,999,5,N,N,-,-1,-1
OUSELEY.txt,233066,233938,872,5,N,N,-,-1,-1
OUSELEY.txt,233940,235049,1109,5,N,N,-,-1,-1
OUSELEY.txt,235050,236606,1556,5,N,N,-,-1,-1
OUSELEY.txt,236608,237747,1139,5,N,N,-,-1,-1
OUSELEY.txt,237748,239140,1392,5,N,N,-,-1,-1
OUSELEY.txt,239141,240049,908,5,N,N,-,-1,-1
OUSELEY.txt,240051,241587,1536,5,N,N,-,-1,-1
OUSELEY.txt,241588,242437,849,5,N,N,-,-1,-1
OUSELEY.txt,242438,243379,941,5,N,N,-,-1,-1
OUSELEY.txt,243380,244751,1371,5,N,N,-,-1,-1
OUSELEY.txt,244752,246112,1360,5,N,N,-,-1,-1
OUSELEY.txt,246115,246991,876,5,N,N,-,-1,-1
OUSELEY.txt,246992,248069,1077,5,N,N,-,-1,-1
OUSELEY.txt,248070,248994,924,5,N,N,-,-1,-1
OUSELEY.txt,248995,249824,829,5,N,N,-,-1,-1
OUSELEY.txt,249825,250965,1140,5,N,N,-,-1,-1
OUSELEY.txt,250966,252161,1195,5,N,N,-,-1,-1
OUSELEY.txt,252162,253386,1224,5,N,N,-,-1,-1
OUSELEY.txt,253387,253663,276,5,N,N,-,-1,-1
OUSELEY.txt,253666,254286,620,5,N,N,-,-1,-1
OUSELEY.txt,254287,254712,425,5,N,N,-,-1,-1
OUSELEY.txt,254713,255202,489,5,N,N,-,-1,-1
OUSELEY.txt,255203,256121,918,5,N,N,-,-1,-1
OUSELEY.txt,256122,257258,1136,5,N,N,-,-1,-1
OUSELEY.txt,257260,258429,1169,5,N,N,-,-1,-1
OUSELEY.txt,258434,258998,564,5,N,N,-,-1,-1
OUSELEY.txt,258999,259785,786,5,N,N,-,-1,-1
OUSELEY.txt,259786,260581,795,5,N,N,-,-1,-1
OUSELEY.txt,260586,261936,1350,5,N,N,-,-1,-1
OUSELEY.txt,261941,262598,657,5,N,N,-,-1,-1
OUSELEY.txt,262600,263289,689,5,N,N,-,-1,-1
OUSELEY.txt,263290,264096,806,5,N,N,-,-1,-1
OUSELEY.txt,264097,264623,526,5,N,N,-,-1,-1
OUSELEY.txt,264628,265883,1255,5,N,N,-,-1,-1
OUSELEY.txt,265886,266240,354,5,N,N,-,-1,-1
OUSELEY.txt,266241,267039,798,5,N,N,-,-1,-1
OUSELEY.txt,267040,267618,578,5,N,N,-,-1,-1
OUSELEY.txt,267619,268829,1210,5,N,N,-,-1,-1
OUSELEY.txt,268830,269357,527,5,N,N,-,-1,-1
OUSELEY.txt,269358,269943,585,5,N,N,-,-1,-1
OUSELEY.txt,269944,270678,734,5,N,N,-,-1,-1
OUSELEY.txt,270679,271427,748,5,N,N,-,-1,-1
OUSELEY.txt,271428,272055,627,5,N,N,-,-1,-1
OUSELEY.txt,272056,272550,494,5,N,N,-,-1,-1
OUSELEY.txt,272551,273300,749,5,N,N,-,-1,-1
OUSELEY.txt,273301,274037,736,5,N,N,-,-1,-1
OUSELEY.txt,274038,274840,802,5,N,N,-,-1,-1
OUSELEY.txt,274842,275493,651,5,N,N,-,-1,-1
OUSELEY.txt,275496,276194,698,5,N,N,-,-1,-1
OUSELEY.txt,276194,276809,615,5,N,N,-,-1,-1
OUSELEY.txt,276810,277418,608,5,N,N,-,-1,-1
OUSELEY.txt,277419,278045,626,5,N,N,-,-1,-1
OUSELEY.txt,278046,278746,700,5,N,N,-,-1,-1
OUSELEY.txt,278747,279789,1042,5,N,N,-,-1,-1
OUSELEY.txt,279794,280408,614,5,N,N,-,-1,-1
OUSELEY.txt,280409,281122,713,5,N,N,-,-1,-1
OUSELEY.txt,281123,281819,696,5,N,N,-,-1,-1
OUSELEY.txt,281820,282851,1031,5,N,N,-,-1,-1
OUSELEY.txt,282852,283834,982,5,N,N,-,-1,-1
OUSELEY.txt,283835,284563,728,5,N,N,-,-1,-1
OUSELEY.txt,284566,284797,231,5,N,N,-,-1,-1
OUSELEY.txt,284799,284983,184,5,N,N,-,-1,-1
OUSELEY.txt,284985,285086,101,5,N,N,-,-1,-1
OUSELEY.txt,285088,285207,119,5,N,N,-,-1,-1
OUSELEY.txt,285208,285646,438,5,N,N,-,-1,-1
OUSELEY.txt,285651,286145,494,5,N,N,-,-1,-1
OUSELEY.txt,286147,286387,240,5,N,N,-,-1,-1
OUSELEY.txt,286388,286585,197,5,N,N,-,-1,-1
OUSELEY.txt,286587,286769,182,5,N,N,-,-1,-1
OUSELEY.txt,286772,286999,227,5,N,N,-,-1,-1
OUSELEY.txt,287001,287132,131,5,N,N,-,-1,-1
OUSELEY.txt,287135,287281,146,5,N,N,-,-1,-1
OUSELEY.txt,287282,287518,236,5,N,N,-,-1,-1
OUSELEY.txt,287520,287667,147,5,N,N,-,-1,-1
OUSELEY.txt,287669,287845,176,5,N,N,-,-1,-1
OUSELEY.txt,287848,288000,152,5,N,N,-,-1,-1
OUSELEY.txt,288003,288159,156,5,N,N,-,-1,-1
OUSELEY.txt,288160,288279,119,5,N,N,-,-1,-1
OUSELEY.txt,288280,288416,136,5,N,N,-,-1,-1
OUSELEY.txt,288417,288586,169,5,N,N,-,-1,-1
OUSELEY.txt,288589,289786,1197,5,N,N,-,-1,-1
OUSELEY.txt,289786,290784,998,5,N,N,-,-1,-1
OUSELEY.txt,290784,291602,818,5,N,N,-,-1,-1
OUSELEY.txt,291603,292024,421,5,N,N,-,-1,-1
OUSELEY.txt,292027,292582,555,5,N,N,-,-1,-1
OUSELEY.txt,292585,293233,648,5,N,N,-,-1,-1
OUSELEY.txt,293236,293288,52,5,N,N,-,-1,-1
OUSELEY.txt,293289,293422,133,5,N,N,-,-1,-1
OUSELEY.txt,293423,293487,64,5,N,N,-,-1,-1
OUSELEY.txt,293488,293591,103,5,N,N,-,-1,-1
OUSELEY.txt,293594,293654,60,5,N,N,-,-1,-1
OUSELEY.txt,293657,293718,61,5,N,N,-,-1,-1
OUSELEY.txt,293719,294276,557,5,N,N,-,-1,-1
OUSELEY.txt,294277,295102,825,5,N,N,-,-1,-1
OUSELEY.txt,295103,295186,83,5,N,N,-,-1,-1
OUSELEY.txt,295187,295256,69,5,N,N,-,-1,-1
OUSELEY.txt,295257,295369,112,5,N,N,-,-1,-1
OUSELEY.txt,295371,295457,86,5,N,N,-,-1,-1
OUSELEY.txt,295459,295622,163,5,N,N,-,-1,-1
OUSELEY.txt,295623,295722,99,5,N,N,-,-1,-1
OUSELEY.txt,295723,295904,181,5,N,N,-,-1,-1
OUSELEY.txt,295905,296050,145,5,N,N,-,-1,-1
OUSELEY.txt,296051,296098,47,5,N,N,-,-1,-1
OUSELEY.txt,296101,296230,129,5,N,N,-,-1,-1
OUSELEY.txt,296231,296329,98,5,N,N,-,-1,-1
OUSELEY.txt,296330,296429,99,5,N,N,-,-1,-1
OUSELEY.txt,296430,296501,71,5,N,N,-,-1,-1
OUSELEY.txt,296506,296719,213,5,N,N,-,-1,-1
OUSELEY.txt,296720,296792,72,5,N,N,-,-1,-1
OUSELEY.txt,296793,297365,572,5,N,N,-,-1,-1
OUSELEY.txt,297366,297939,573,5,N,N,-,-1,-1
OUSELEY.txt,297941,298061,120,5,N,N,-,-1,-1
OUSELEY.txt,298062,298446,384,5,N,N,-,-1,-1
OUSELEY.txt,298449,299235,786,5,N,N,-,-1,-1
OUSELEY.txt,299236,299979,743,5,N,N,-,-1,-1
OUSELEY.txt,299980,300118,138,5,N,N,-,-1,-1
OUSELEY.txt,300119,300593,474,5,N,N,-,-1,-1
OUSELEY.txt,300594,301743,1149,5,N,N,-,-1,-1
OUSELEY.txt,301745,302282,537,5,N,N,-,-1,-1
OUSELEY.txt,302284,303035,751,5,N,N,-,-1,-1
OUSELEY.txt,303036,303542,506,5,N,N,-,-1,-1
OUSELEY.txt,303548,303975,427,5,N,N,-,-1,-1
OUSELEY.txt,303976,304394,418,5,N,N,-,-1,-1
OUSELEY.txt,304396,304750,354,5,N,N,-,-1,-1
OUSELEY.txt,304753,305204,451,5,N,N,-,-1,-1
OUSELEY.txt,305205,305820,615,5,N,N,-,-1,-1
OUSELEY.txt,305821,306599,778,5,N,N,-,-1,-1
OUSELEY.txt,306600,307416,816,5,N,N,-,-1,-1
OUSELEY.txt,307421,307759,338,5,N,N,-,-1,-1
OUSELEY.txt,307765,308063,298,5,N,N,-,-1,-1
OUSELEY.txt,308066,308684,618,5,N,N,-,-1,-1
OUSELEY.txt,308685,309723,1038,5,N,N,-,-1,-1
OUSELEY.txt,309724,310097,373,5,N,N,-,-1,-1
OUSELEY.txt,310100,311496,1396,5,N,N,-,-1,-1
OUSELEY.txt,311502,311789,287,5,N,N,-,-1,-1
OUSELEY.txt,311790,312068,278,5,N,N,-,-1,-1
OUSELEY.txt,312071,312360,289,5,N,N,-,-1,-1
OUSELEY.txt,312363,312665,302,5,N,N,-,-1,-1
OUSELEY.txt,312668,312943,275,5,N,N,-,-1,-1
PILGRIM.txt,0,81,81,5,N,N,-,-1,-1
PILGRIM.txt,86,899,813,5,N,N,-,-1,-1
PILGRIM.txt,901,1366,465,5,N,N,-,-1,-1
PILGRIM.txt,1369,1873,504,5,N,N,-,-1,-1
PILGRIM.txt,1874,2170,296,5,N,N,-,-1,-1
PILGRIM.txt,2172,2348,176,5,N,N,-,-1,-1
PILGRIM.txt,2348,3316,968,5,N,N,-,-1,-1
PILGRIM.txt,3317,3998,681,5,N,N,-,-1,-1
PILGRIM.txt,3999,5011,1012,5,N,N,-,-1,-1
PILGRIM.txt,5012,5712,700,5,N,N,-,-1,-1
PILGRIM.txt,5713,6350,637,5,N,N,-,-1,-1
PILGRIM.txt,6353,7179,826,5,N,N,-,-1,-1
PILGRIM.txt,7180,8024,844,5,N,N,-,-1,-1
PILGRIM.txt,8025,8981,956,5,N,N,-,-1,-1
PILGRIM.txt,8982,9807,825,5,N,N,-,-1,-1
PILGRIM.txt,9810,10734,924,5,N,N,-,-1,-1
PILGRIM.txt,10737,11714,977,5,N,N,-,-1,-1
PILGRIM.txt,11717,12925,1208,5,N,N,-,-1,-1
PILGRIM.txt,12928,14295,1367,5,N,N,-,-1,-1
PILGRIM.txt,14298,15542,1244,5,N,N,-,-1,-1
PILGRIM.txt,15545,16741,1196,5,N,N,-,-1,-1
PILGRIM.txt,16744,18630,1886,5,N,N,-,-1,-1
PILGRIM.txt,18633,19274,641,5,N,N,-,-1,-1
PILGRIM.txt,19275,20292,1017,5,N,N,-,-1,-1
PILGRIM.txt,20295,21481,1186,5,N,N,-,-1,-1
PILGRIM.txt,21482,22074,592,5,N,N,-,-1,-1
PILGRIM.txt,22075,22764,689,5,N,N,-,-1,-1
PILGRIM.txt,22765,23276,511,5,N,N,-,-1,-1
PILGRIM.txt,23279,23903,624,5,N,N,-,-1,-1
PILGRIM.txt,23904,24751,847,5,N,N,-,-1,-1
PILGRIM.txt,24752,25471,719,5,N,N,-,-1,-1
PILGRIM.txt,25473,26233,760,5,N,N,-,-1,-1
PILGRIM.txt,26234,26968,734,5,N,N,-,-1,-1
PILGRIM.txt,26971,28187,1216,5,N,N,-,-1,-1
PILGRIM.txt,28190,29116,926,5,N,N,-,-1,-1
PILGRIM.txt,29117,29828,711,5,N,N,-,-1,-1
PILGRIM.txt,29829,30500,671,5,N,N,-,-1,-1
PILGRIM.txt,30502,31161,659,5,N,N,-,-1,-1
PILGRIM.txt,31162,31684,522,5,N,N,-,-1,-1
PILGRIM.txt,31685,32271,586,5,N,N,-,-1,-1
PILGRIM.txt,32272,33067,795,5,N,N,-,-1,-1
PILGRIM.txt,33068,33952,884,5,N,N,-,-1,-1
PILGRIM.txt,33954,34737,783,5,N,N,-,-1,-1
PILGRIM.txt,34739,35681,942,5,N,N,-,-1,-1
PILGRIM.txt,35683,36148,465,5,N,N,-,-1,-1
PILGRIM.txt,36151,36689,538,5,N,N,-,-1,-1
PILGRIM.txt,36690,37462,772,5,N,N,-,-1,-1
PILGRIM.txt,37463,37937,474,5,N,N,-,-1,-1
PILGRIM.txt,37940,38456,516,5,N,N,-,-1,-1
PILGRIM.txt,38459,39056,597,5,Y,N,-,-1,-1
PILGRIM.txt,39057,39837,780,5,N,N,-,-1,-1
PILGRIM.txt,39839,40501,662,5,N,N,-,-1,-1
PILGRIM.txt,40502,41311,809,5,N,N,-,-1,-1
PILGRIM.txt,41312,41956,644,5,Y,N,-,-1,-1
PILGRIM.txt,41957,42530,573,5,N,N,-,-1,-1
PILGRIM.txt,42531,42966,435,5,N,N,-,-1,-1
PILGRIM.txt,42967,43685,718,5,N,N,-,-1,-1
PILGRIM.txt,43686,44278,592,5,N,N,-,-1,-1
PILGRIM.txt,44279,44903,624,5,N,N,-,-1,-1
PILGRIM.txt,44908,45811,903,5,N,N,-,-1,-1
PILGRIM.txt,45812,46317,505,5,N,N,-,-1,-1
PILGRIM.txt,46318,46908,590,5,N,N,-,-1,-1
PILGRIM.txt,46909,47588,679,5,N,N,-,-1,-1
PILGRIM.txt,47589,48633,1044,5,N,N,-,-1,-1
PILGRIM.txt,48635,49016,381,5,N,N,-,-1,-1
PILGRIM.txt,49021,49449,428,5,N,N,-,-1,-1
PILGRIM.txt,49450,49980,530,5,N,N,-,-1,-1
PILGRIM.txt,49983,50805,822,5,N,Y,1430808947621,50425,50979
PILGRIM.txt,50806,51605,799,5,N,Y,1430808947621,50425,50979
PILGRIM.txt,51606,52022,416,5,N,N,-,-1,-1
PILGRIM.txt,52025,52606,581,5,N,N,-,-1,-1
PILGRIM.txt,52607,53225,618,5,N,N,-,-1,-1
PILGRIM.txt,53226,53858,632,5,N,N,-,-1,-1
PILGRIM.txt,53859,54478,619,5,N,N,-,-1,-1
PILGRIM.txt,54479,55042,563,5,N,N,-,-1,-1
PILGRIM.txt,55043,55873,830,5,N,N,-,-1,-1
PILGRIM.txt,55875,56749,874,5,N,N,-,-1,-1
PILGRIM.txt,56751,57583,832,5,N,N,-,-1,-1
PILGRIM.txt,57584,58112,528,5,N,N,-,-1,-1
PILGRIM.txt,58113,58947,834,5,N,N,-,-1,-1
PILGRIM.txt,58948,59507,559,5,N,N,-,-1,-1
PILGRIM.txt,59508,60062,554,5,N,N,-,-1,-1
PILGRIM.txt,60063,60579,516,5,N,N,-,-1,-1
PILGRIM.txt,60580,61328,748,5,N,N,-,-1,-1
PILGRIM.txt,61331,61786,455,5,N,N,-,-1,-1
PILGRIM.txt,61787,62329,542,5,N,N,-,-1,-1
PILGRIM.txt,62332,63228,896,5,N,N,-,-1,-1
PILGRIM.txt,63231,64265,1034,5,Y,N,-,-1,-1
PILGRIM.txt,64268,64930,662,5,N,N,-,-1,-1
PILGRIM.txt,64931,65494,563,5,N,N,-,-1,-1
PILGRIM.txt,65499,66105,606,5,N,N,-,-1,-1
PILGRIM.txt,66106,66599,493,5,N,N,-,-1,-1
PILGRIM.txt,66600,67292,692,5,N,N,-,-1,-1
PILGRIM.txt,67295,67901,606,5,N,N,-,-1,-1
PILGRIM.txt,67902,68288,386,5,N,N,-,-1,-1
PILGRIM.txt,68289,68936,647,5,N,N,-,-1,-1
PILGRIM.txt,68938,69603,665,5,N,N,-,-1,-1
PILGRIM.txt,69604,70153,549,5,N,N,-,-1,-1
PILGRIM.txt,70154,70788,634,5,N,N,-,-1,-1
PILGRIM.txt,70791,71294,503,5,N,N,-,-1,-1
PILGRIM.txt,71295,72259,964,5,N,N,-,-1,-1
PILGRIM.txt,72260,72810,550,5,N,N,-,-1,-1
PILGRIM.txt,72812,73444,632,5,N,N,-,-1,-1
PILGRIM.txt,73445,73965,520,5,N,N,-,-1,-1
PILGRIM.txt,73971,74533,562,5,N,N,-,-1,-1
PILGRIM.txt,74536,75067,531,5,N,N,-,-1,-1
PILGRIM.txt,75068,75624,556,5,N,N,-,-1,-1
PILGRIM.txt,75625,76317,692,5,N,N,-,-1,-1
PILGRIM.txt,76320,77254,934,5,N,Y,1432737524261,76323,77903
PILGRIM.txt,77257,77904,647,5,N,Y,1432737524261,76323,77903
PILGRIM.txt,77905,78599,694,5,N,N,-,-1,-1
PILGRIM.txt,78600,79284,684,5,N,N,-,-1,-1
PILGRIM.txt,79285,80069,784,5,N,N,-,-1,-1
PILGRIM.txt,80072,80536,464,5,N,N,-,-1,-1
PILGRIM.txt,80539,81116,577,5,N,N,-,-1,-1
PILGRIM.txt,81117,82083,966,5,N,N,-,-1,-1
PILGRIM.txt,82084,82730,646,5,N,N,-,-1,-1
PILGRIM.txt,82731,83563,832,5,N,N,-,-1,-1
PILGRIM.txt,83568,84372,804,5,N,N,-,-1,-1
PILGRIM.txt,84375,85002,627,5,N,N,-,-1,-1
PILGRIM.txt,85004,85683,679,5,N,N,-,-1,-1
PILGRIM.txt,85684,86567,883,5,N,N,-,-1,-1
PILGRIM.txt,86568,87401,833,5,N,N,-,-1,-1
PILGRIM.txt,87402,87989,587,5,N,N,-,-1,-1
PILGRIM.txt,87990,88712,722,5,N,N,-,-1,-1
PILGRIM.txt,88713,89407,694,5,N,N,-,-1,-1
PILGRIM.txt,89408,89856,448,5,N,N,-,-1,-1
PILGRIM.txt,89857,90254,397,5,N,N,-,-1,-1
PILGRIM.txt,90255,90994,739,5,N,N,-,-1,-1
PILGRIM.txt,90995,91796,801,5,N,N,-,-1,-1
PILGRIM.txt,91797,92515,718,5,N,N,-,-1,-1
PILGRIM.txt,92518,93451,933,5,N,N,-,-1,-1
PILGRIM.txt,93452,94131,679,5,N,N,-,-1,-1
PILGRIM.txt,94136,94832,696,5,N,N,-,-1,-1
PILGRIM.txt,94833,95617,784,5,N,N,-,-1,-1
PILGRIM.txt,95618,96232,614,5,N,N,-,-1,-1
PILGRIM.txt,96233,96957,724,5,N,N,-,-1,-1
PILGRIM.txt,96958,97541,583,5,Y,N,-,-1,-1
PILGRIM.txt,97543,98658,1115,5,N,N,-,-1,-1
PILGRIM.txt,98659,99319,660,5,N,N,-,-1,-1
PILGRIM.txt,99320,100191,871,5,N,N,-,-1,-1
PILGRIM.txt,100192,100625,433,5,N,N,-,-1,-1
PILGRIM.txt,100626,101292,666,5,N,N,-,-1,-1
PILGRIM.txt,101293,102085,792,5,N,N,-,-1,-1
PILGRIM.txt,102086,102613,527,5,N,N,-,-1,-1
PILGRIM.txt,102614,103100,486,5,N,N,-,-1,-1
PILGRIM.txt,103101,103783,682,5,N,N,-,-1,-1
PILGRIM.txt,103784,104318,534,5,N,N,-,-1,-1
PILGRIM.txt,104321,105015,694,5,N,N,-,-1,-1
PILGRIM.txt,105016,105626,610,5,N,N,-,-1,-1
PILGRIM.txt,105627,106270,643,5,N,N,-,-1,-1
PILGRIM.txt,106271,106758,487,5,N,N,-,-1,-1
PILGRIM.txt,106759,107329,570,5,N,N,-,-1,-1
PILGRIM.txt,107330,107936,606,5,N,N,-,-1,-1
PILGRIM.txt,107937,108698,761,5,N,N,-,-1,-1
PILGRIM.txt,108699,109274,575,5,N,N,-,-1,-1
PILGRIM.txt,109275,109936,661,5,N,N,-,-1,-1
PILGRIM.txt,109939,110504,565,5,N,N,-,-1,-1
PILGRIM.txt,110505,111390,885,5,N,N,-,-1,-1
PILGRIM.txt,111391,111824,433,5,N,N,-,-1,-1
PILGRIM.txt,111825,112746,921,5,N,N,-,-1,-1
PILGRIM.txt,112749,113255,506,5,N,N,-,-1,-1
PILGRIM.txt,113256,114105,849,5,N,N,-,-1,-1
PILGRIM.txt,114106,114898,792,5,N,N,-,-1,-1
PILGRIM.txt,114901,115339,438,5,N,N,-,-1,-1
PILGRIM.txt,115340,116026,686,5,N,N,-,-1,-1
PILGRIM.txt,116027,116757,730,5,N,N,-,-1,-1
PILGRIM.txt,116758,117230,472,5,N,N,-,-1,-1
PILGRIM.txt,117231,118183,952,5,N,N,-,-1,-1
PILGRIM.txt,118184,119184,1000,5,N,N,-,-1,-1
PILGRIM.txt,119185,119846,661,5,N,N,-,-1,-1
PILGRIM.txt,119848,120452,604,5,N,N,-,-1,-1
PILGRIM.txt,120457,121225,768,5,N,N,-,-1,-1
PILGRIM.txt,121227,121842,615,5,N,N,-,-1,-1
PILGRIM.txt,121843,122427,584,5,N,N,-,-1,-1
PILGRIM.txt,122428,123048,620,5,N,N,-,-1,-1
PILGRIM.txt,123049,123477,428,5,N,N,-,-1,-1
PILGRIM.txt,123479,124007,528,5,N,N,-,-1,-1
PILGRIM.txt,124010,124839,829,5,N,N,-,-1,-1
PILGRIM.txt,124840,125148,308,5,N,N,-,-1,-1
PILGRIM.txt,125149,125855,706,5,N,N,-,-1,-1
PILGRIM.txt,125856,126315,459,5,N,N,-,-1,-1
PILGRIM.txt,126316,126817,501,5,N,N,-,-1,-1
PILGRIM.txt,126818,127308,490,5,N,N,-,-1,-1
PILGRIM.txt,127309,128323,1014,5,N,N,-,-1,-1
PILGRIM.txt,128324,128755,431,5,N,N,-,-1,-1
PILGRIM.txt,128756,129582,826,5,N,N,-,-1,-1
PILGRIM.txt,129583,130212,629,5,N,Y,1432747851515,129932,131402
PILGRIM.txt,130213,130726,513,5,N,Y,1432747851515,129932,131402
PILGRIM.txt,130727,131368,641,5,N,Y,1432747851515,129932,131402
PILGRIM.txt,131369,131766,397,5,N,Y,1432747851515,129932,131402
PILGRIM.txt,131767,132205,438,5,N,N,-,-1,-1
PILGRIM.txt,132206,132621,415,5,N,N,-,-1,-1
PILGRIM.txt,132622,133083,461,5,N,N,-,-1,-1
PILGRIM.txt,133084,133797,713,5,N,N,-,-1,-1
PILGRIM.txt,133800,134587,787,5,N,N,-,-1,-1
PILGRIM.txt,134588,135107,519,5,N,Y,1432792603693,134919,135643
PILGRIM.txt,135108,135651,543,5,N,Y,1432792603693,134919,135643
PILGRIM.txt,135652,136395,743,5,N,N,-,-1,-1
PILGRIM.txt,136396,136847,451,5,N,N,-,-1,-1
PILGRIM.txt,136849,137532,683,5,N,N,-,-1,-1
PILGRIM.txt,137533,137702,169,5,N,N,-,-1,-1
PILGRIM.txt,137704,138488,784,5,N,N,-,-1,-1
PILGRIM.txt,138491,139324,833,5,N,N,-,-1,-1
PILGRIM.txt,139329,140293,964,5,N,N,-,-1,-1
PILGRIM.txt,140296,141239,943,5,N,N,-,-1,-1
PILGRIM.txt,141244,141897,653,5,N,N,-,-1,-1
PILGRIM.txt,141898,142291,393,5,N,N,-,-1,-1
PILGRIM.txt,142292,142851,559,5,N,N,-,-1,-1
PILGRIM.txt,142852,143228,376,5,N,N,-,-1,-1
PILGRIM.txt,143229,143698,469,5,N,N,-,-1,-1
PILGRIM.txt,143699,144020,321,5,N,N,-,-1,-1
PILGRIM.txt,144025,145131,1106,5,N,N,-,-1,-1
PILGRIM.txt,145132,145863,731,5,N,N,-,-1,-1
PILGRIM.txt,145866,146432,566,5,N,Y,1432795431094,146203,147710
PILGRIM.txt,146433,147272,839,5,N,Y,1432795431094,146203,147710
PILGRIM.txt,147273,148030,757,5,N,Y,1432795431094,146203,147710
PILGRIM.txt,148031,148805,774,5,N,N,-,-1,-1
PILGRIM.txt,148806,149517,711,5,N,N,-,-1,-1
PILGRIM.txt,149518,150282,764,5,N,N,-,-1,-1
PILGRIM.txt,150283,150978,695,5,N,N,-,-1,-1
PILGRIM.txt,150979,151594,615,5,N,N,-,-1,-1
PILGRIM.txt,151596,152114,518,5,N,N,-,-1,-1
PILGRIM.txt,152117,153067,950,5,N,N,-,-1,-1
PILGRIM.txt,153068,153931,863,5,N,N,-,-1,-1
PILGRIM.txt,153932,154734,802,5,N,N,-,-1,-1
PILGRIM.txt,154735,155444,709,5,N,N,-,-1,-1
PILGRIM.txt,155445,156143,698,5,N,N,-,-1,-1
PILGRIM.txt,156144,156961,817,5,N,N,-,-1,-1
PILGRIM.txt,156963,157625,662,5,N,N,-,-1,-1
PILGRIM.txt,157626,158114,488,5,N,N,-,-1,-1
PILGRIM.txt,158115,158702,587,5,N,N,-,-1,-1
PILGRIM.txt,158703,159273,570,5,N,N,-,-1,-1
PILGRIM.txt,159274,159845,571,5,N,N,-,-1,-1
PILGRIM.txt,159846,160593,747,5,N,N,-,-1,-1
PILGRIM.txt,160596,161474,878,5,N,N,-,-1,-1
PILGRIM.txt,161475,162036,561,5,N,N,-,-1,-1
PILGRIM.txt,162038,162811,773,5,N,N,-,-1,-1
PILGRIM.txt,162812,163559,747,5,N,N,-,-1,-1
PILGRIM.txt,163560,164490,930,5,N,N,-,-1,-1
PILGRIM.txt,164491,165053,562,5,N,N,-,-1,-1
PILGRIM.txt,165054,165645,591,5,N,N,-,-1,-1
PILGRIM.txt,165647,166429,782,5,N,N,-,-1,-1
PILGRIM.txt,166430,167223,793,5,N,N,-,-1,-1
PILGRIM.txt,167224,167770,546,5,N,N,-,-1,-1
PILGRIM.txt,167771,168466,695,5,N,N,-,-1,-1
PILGRIM.txt,168467,168907,440,5,N,N,-,-1,-1
PILGRIM.txt,168909,169847,938,5,N,N,-,-1,-1
PILGRIM.txt,169848,170623,775,5,N,N,-,-1,-1
PILGRIM.txt,170624,171416,792,5,N,N,-,-1,-1
PILGRIM.txt,171419,172151,732,5,N,N,-,-1,-1
PILGRIM.txt,172152,172891,739,5,N,N,-,-1,-1
PILGRIM.txt,172892,174385,1493,5,N,N,-,-1,-1
PILGRIM.txt,174386,175065,679,5,N,N,-,-1,-1
PILGRIM.txt,175066,175711,645,5,N,N,-,-1,-1
PILGRIM.txt,175714,176539,825,5,N,N,-,-1,-1
PILGRIM.txt,176541,177309,768,5,N,N,-,-1,-1
PILGRIM.txt,177310,177989,679,5,N,N,-,-1,-1
PILGRIM.txt,177990,178727,737,5,N,N,-,-1,-1
PILGRIM.txt,178732,179386,654,5,N,N,-,-1,-1
PILGRIM.txt,179388,180124,736,5,N,N,-,-1,-1
PILGRIM.txt,180127,180864,737,5,N,N,-,-1,-1
PILGRIM.txt,180865,181659,794,5,N,N,-,-1,-1
PILGRIM.txt,181660,182405,745,5,N,N,-,-1,-1
PILGRIM.txt,182408,182831,423,5,N,N,-,-1,-1
PILGRIM.txt,182832,183240,408,5,N,N,-,-1,-1
PILGRIM.txt,183241,183809,568,5,N,N,-,-1,-1
PILGRIM.txt,183812,184507,695,5,N,N,-,-1,-1
PILGRIM.txt,184508,185326,818,5,N,N,-,-1,-1
PILGRIM.txt,185329,185775,446,5,N,N,-,-1,-1
PILGRIM.txt,185776,186306,530,5,N,N,-,-1,-1
PILGRIM.txt,186307,186832,525,5,N,N,-,-1,-1
PILGRIM.txt,186833,187146,313,5,N,N,-,-1,-1
PILGRIM.txt,187148,187507,359,5,N,N,-,-1,-1
PILGRIM.txt,187512,187638,126,5,N,N,-,-1,-1
PILGRIM.txt,187638,188301,663,5,N,N,-,-1,-1
PILGRIM.txt,188302,188645,343,5,N,N,-,-1,-1
PILGRIM.txt,188650,188967,317,5,N,N,-,-1,-1
PILGRIM.txt,188968,189413,445,5,N,N,-,-1,-1
PILGRIM.txt,189414,189867,453,5,N,N,-,-1,-1
PILGRIM.txt,189868,190203,335,5,N,N,-,-1,-1
PILGRIM.txt,190204,190883,679,5,N,N,-,-1,-1
PILGRIM.txt,190884,191443,559,5,N,N,-,-1,-1
PILGRIM.txt,191444,191828,384,5,N,N,-,-1,-1
PILGRIM.txt,191829,192297,468,5,N,N,-,-1,-1
PILGRIM.txt,192298,193057,759,5,N,N,-,-1,-1
PILGRIM.txt,193060,193666,606,5,N,N,-,-1,-1
PILGRIM.txt,193669,193984,315,5,N,N,-,-1,-1
PILGRIM.txt,193985,194668,683,5,N,N,-,-1,-1
PILGRIM.txt,194669,195296,627,5,N,N,-,-1,-1
PILGRIM.txt,195297,195851,554,5,N,N,-,-1,-1
PILGRIM.txt,195852,196602,750,5,N,N,-,-1,-1
PILGRIM.txt,196603,197138,535,5,N,N,-,-1,-1
PILGRIM.txt,197139,197935,796,5,N,N,-,-1,-1
PILGRIM.txt,197938,198586,648,5,N,N,-,-1,-1
PILGRIM.txt,198587,199259,672,5,N,N,-,-1,-1
PILGRIM.txt,199260,199801,541,5,N,N,-,-1,-1
PILGRIM.txt,199802,200296,494,5,N,N,-,-1,-1
PILGRIM.txt,200297,200903,606,5,N,N,-,-1,-1
PILGRIM.txt,200904,201674,770,5,N,N,-,-1,-1
PILGRIM.txt,201675,202357,682,5,N,N,-,-1,-1
PILGRIM.txt,202360,203010,650,5,N,N,-,-1,-1
PILGRIM.txt,203011,203456,445,5,N,N,-,-1,-1
PILGRIM.txt,203457,203985,528,5,N,N,-,-1,-1
PILGRIM.txt,203986,204521,535,5,N,N,-,-1,-1
PILGRIM.txt,204522,204966,444,5,N,N,-,-1,-1
PILGRIM.txt,204967,205487,520,5,N,N,-,-1,-1
PILGRIM.txt,205488,206052,564,5,N,N,-,-1,-1
PILGRIM.txt,206053,206298,245,5,N,N,-,-1,-1
PILGRIM.txt,206301,207237,936,5,N,N,-,-1,-1
PILGRIM.txt,207238,208082,844,5,N,N,-,-1,-1
PILGRIM.txt,208085,208853,768,5,N,N,-,-1,-1
PILGRIM.txt,208854,209487,633,5,N,N,-,-1,-1
PILGRIM.txt,209488,210465,977,5,N,N,-,-1,-1
PILGRIM.txt,210466,211013,547,5,N,N,-,-1,-1
PILGRIM.txt,211014,211569,555,5,N,N,-,-1,-1
PILGRIM.txt,211570,211964,394,5,N,N,-,-1,-1
PILGRIM.txt,211967,212780,813,5,N,N,-,-1,-1
PILGRIM.txt,212783,213326,543,5,N,N,-,-1,-1
PILGRIM.txt,213327,213836,509,5,N,N,-,-1,-1
PILGRIM.txt,213837,214367,530,5,N,N,-,-1,-1
PILGRIM.txt,214368,214952,584,5,N,N,-,-1,-1
PILGRIM.txt,214953,215451,498,5,N,N,-,-1,-1
PILGRIM.txt,215452,216034,582,5,N,N,-,-1,-1
PILGRIM.txt,216035,216540,505,5,N,N,-,-1,-1
PILGRIM.txt,216541,217250,709,5,N,N,-,-1,-1
PILGRIM.txt,217253,217901,648,5,N,N,-,-1,-1
PILGRIM.txt,217902,218217,315,5,N,N,-,-1,-1
PILGRIM.txt,218218,218394,176,5,N,N,-,-1,-1
PILGRIM.txt,218395,218667,272,5,N,N,-,-1,-1
PILGRIM.txt,218668,219418,750,5,N,N,-,-1,-1
PILGRIM.txt,219419,219833,414,5,N,N,-,-1,-1
PILGRIM.txt,219834,220202,368,5,N,N,-,-1,-1
PILGRIM.txt,220203,220631,428,5,N,N,-,-1,-1
PILGRIM.txt,220632,221243,611,5,N,N,-,-1,-1
PILGRIM.txt,221245,221661,416,5,N,N,-,-1,-1
PILGRIM.txt,221662,222139,477,5,N,N,-,-1,-1
PILGRIM.txt,222140,223087,947,5,N,N,-,-1,-1
PILGRIM.txt,223088,223599,511,5,N,N,-,-1,-1
PILGRIM.txt,223600,224468,868,5,N,N,-,-1,-1
PILGRIM.txt,224471,225099,628,5,N,N,-,-1,-1
PILGRIM.txt,225100,225710,610,5,N,N,-,-1,-1
PILGRIM.txt,225711,226478,767,5,N,N,-,-1,-1
PILGRIM.txt,226479,226915,436,5,N,N,-,-1,-1
PILGRIM.txt,226916,227429,513,5,N,N,-,-1,-1
PILGRIM.txt,227430,227830,400,5,N,N,-,-1,-1
PILGRIM.txt,227831,228260,429,5,N,N,-,-1,-1
PILGRIM.txt,228263,229079,816,5,N,Y,1432812913267,228270,230251
PILGRIM.txt,229080,229887,807,5,N,Y,1432812913267,228270,230251
PILGRIM.txt,229888,230557,669,5,N,Y,1432812913267,228270,230251
PILGRIM.txt,230558,231104,546,5,N,N,-,-1,-1
PILGRIM.txt,231107,232739,1632,5,N,N,-,-1,-1
PILGRIM.txt,232742,233811,1069,5,N,N,-,-1,-1
PILGRIM.txt,233814,234712,898,5,N,N,-,-1,-1
PILGRIM.txt,234713,235135,422,5,N,N,-,-1,-1
PILGRIM.txt,235136,235742,606,5,N,N,-,-1,-1
PILGRIM.txt,235744,236337,593,5,N,N,-,-1,-1
PILGRIM.txt,236340,237337,997,5,N,Y,1432826715274,237060,238022
PILGRIM.txt,237338,237779,441,5,N,Y,1432826715274,237060,238022
PILGRIM.txt,237780,238296,516,5,N,Y,1432826715274,237060,238022
PILGRIM.txt,238298,238882,584,5,N,N,-,-1,-1
PILGRIM.txt,238885,239379,494,5,N,N,-,-1,-1
PILGRIM.txt,239380,240055,675,5,N,N,-,-1,-1
PILGRIM.txt,240056,240624,568,5,N,N,-,-1,-1
PILGRIM.txt,240629,241249,620,5,N,N,-,-1,-1
PILGRIM.txt,241250,241983,733,5,N,N,-,-1,-1
PILGRIM.txt,241984,242767,783,5,N,N,-,-1,-1
PILGRIM.txt,242768,243400,632,5,N,N,-,-1,-1
PILGRIM.txt,243401,244227,826,5,N,N,-,-1,-1
PILGRIM.txt,244228,244827,599,5,N,N,-,-1,-1
PILGRIM.txt,244828,245353,525,5,N,N,-,-1,-1
PILGRIM.txt,245354,246021,667,5,N,N,-,-1,-1
PILGRIM.txt,246022,246587,565,5,N,N,-,-1,-1
PILGRIM.txt,246588,247198,610,5,N,N,-,-1,-1
PILGRIM.txt,247199,247925,726,5,N,N,-,-1,-1
PILGRIM.txt,247927,248608,681,5,N,N,-,-1,-1
PILGRIM.txt,248609,249206,597,5,N,N,-,-1,-1
PILGRIM.txt,249207,249666,459,5,N,N,-,-1,-1
PILGRIM.txt,249671,250229,558,5,N,N,-,-1,-1
PILGRIM.txt,250232,250919,687,5,N,N,-,-1,-1
PILGRIM.txt,250920,251723,803,5,N,N,-,-1,-1
PILGRIM.txt,251726,252281,555,5,N,N,-,-1,-1
PILGRIM.txt,252282,253052,770,5,N,N,-,-1,-1
PILGRIM.txt,253053,253745,692,5,N,N,-,-1,-1
PILGRIM.txt,253747,254420,673,5,N,N,-,-1,-1
PILGRIM.txt,254421,255039,618,5,N,N,-,-1,-1
PILGRIM.txt,255040,256116,1076,5,N,N,-,-1,-1
PILGRIM.txt,256117,256579,462,5,N,N,-,-1,-1
PILGRIM.txt,256580,257186,606,5,N,N,-,-1,-1
PILGRIM.txt,257187,258126,939,5,N,N,-,-1,-1
PILGRIM.txt,258129,258807,678,5,N,N,-,-1,-1
PILGRIM.txt,258808,259526,718,5,N,N,-,-1,-1
PILGRIM.txt,259527,260737,1210,5,N,Y,1432830272373,259940,261638
PILGRIM.txt,260738,261593,855,5,N,Y,1432830272373,259940,261638
PILGRIM.txt,261593,262083,490,5,N,Y,1432830272373,259940,261638
PILGRIM.txt,262084,262600,516,5,N,N,-,-1,-1
PILGRIM.txt,262601,262899,298,5,N,N,-,-1,-1
PILGRIM.txt,262904,263148,244,5,N,N,-,-1,-1
PILGRIM.txt,263149,263673,524,5,N,N,-,-1,-1
PILGRIM.txt,263674,264137,463,5,N,N,-,-1,-1
PILGRIM.txt,264138,264592,454,5,N,N,-,-1,-1
PILGRIM.txt,264593,265279,686,5,N,N,-,-1,-1
PILGRIM.txt,265280,265909,629,5,N,N,-,-1,-1
PILGRIM.txt,265910,266977,1067,5,N,N,-,-1,-1
PILGRIM.txt,266979,267672,693,5,N,N,-,-1,-1
PILGRIM.txt,267673,268269,596,5,N,N,-,-1,-1
PILGRIM.txt,268270,269117,847,5,N,N,-,-1,-1
PILGRIM.txt,269118,269951,833,5,N,N,-,-1,-1
PILGRIM.txt,269954,270489,535,5,N,N,-,-1,-1
PILGRIM.txt,270490,271227,737,5,N,N,-,-1,-1
PILGRIM.txt,271228,271729,501,5,N,N,-,-1,-1
PILGRIM.txt,271730,272455,725,5,N,N,-,-1,-1
PILGRIM.txt,272456,272952,496,5,N,N,-,-1,-1
PILGRIM.txt,272954,273394,440,5,N,N,-,-1,-1
PILGRIM.txt,273395,274240,845,5,N,N,-,-1,-1
PILGRIM.txt,274241,274894,653,5,N,N,-,-1,-1
PILGRIM.txt,274895,275452,557,5,N,N,-,-1,-1
PILGRIM.txt,275453,276266,813,5,N,N,-,-1,-1
PILGRIM.txt,276269,277210,941,5,N,N,-,-1,-1
PILGRIM.txt,277211,278062,851,5,N,N,-,-1,-1
PILGRIM.txt,278063,279195,1132,5,N,N,-,-1,-1
PILGRIM.txt,279196,280064,868,5,N,N,-,-1,-1
PILGRIM.txt,280065,280678,613,5,N,N,-,-1,-1
PILGRIM.txt,280680,281281,601,5,N,N,-,-1,-1
PILGRIM.txt,281284,281638,354,5,N,N,-,-1,-1
PILGRIM.txt,281639,282323,684,5,N,N,-,-1,-1
PILGRIM.txt,282324,282867,543,5,N,N,-,-1,-1
PILGRIM.txt,282869,283332,463,5,N,N,-,-1,-1
PILGRIM.txt,283333,284020,687,5,N,N,-,-1,-1
PILGRIM.txt,284021,284474,453,5,N,N,-,-1,-1
PILGRIM.txt,284475,285001,526,5,N,N,-,-1,-1
PILGRIM.txt,285002,285738,736,5,N,N,-,-1,-1
PILGRIM.txt,285739,286431,692,5,N,N,-,-1,-1
PILGRIM.txt,286432,287023,591,5,N,N,-,-1,-1
PILGRIM.txt,287024,287781,757,5,N,N,-,-1,-1
PILGRIM.txt,287782,288729,947,5,N,N,-,-1,-1
PILGRIM.txt,288730,289381,651,5,N,N,-,-1,-1
PILGRIM.txt,289382,289959,577,5,N,N,-,-1,-1
PILGRIM.txt,289960,290700,740,5,N,N,-,-1,-1
PILGRIM.txt,290701,291287,586,5,N,N,-,-1,-1
PILGRIM.txt,291288,292412,1124,5,N,N,-,-1,-1
PILGRIM.txt,292417,293116,699,5,N,N,-,-1,-1
PILGRIM.txt,293117,293744,627,5,N,N,-,-1,-1
PILGRIM.txt,293746,294304,558,5,N,N,-,-1,-1
PILGRIM.txt,294305,294691,386,5,N,N,-,-1,-1
PILGRIM.txt,294692,295067,375,5,N,N,-,-1,-1
PILGRIM.txt,295068,295593,525,5,N,N,-,-1,-1
PILGRIM.txt,295594,296154,560,5,N,N,-,-1,-1
PILGRIM.txt,296155,296690,535,5,N,N,-,-1,-1
PILGRIM.txt,296691,297554,863,5,N,N,-,-1,-1
PILGRIM.txt,297556,298239,683,5,N,N,-,-1,-1
PILGRIM.txt,298240,298963,723,5,N,N,-,-1,-1
PILGRIM.txt,298966,299765,799,5,N,N,-,-1,-1
PILGRIM.txt,299766,300505,739,5,N,N,-,-1,-1
PILGRIM.txt,300506,301070,564,5,N,N,-,-1,-1
PILGRIM.txt,301070,302022,952,5,N,N,-,-1,-1
PILGRIM.txt,302023,302812,789,5,N,N,-,-1,-1
PILGRIM.txt,302815,303843,1028,5,N,N,-,-1,-1
PILGRIM.txt,303844,304457,613,5,N,N,-,-1,-1
PILGRIM.txt,304458,305115,657,5,N,N,-,-1,-1
PILGRIM.txt,305118,305624,506,5,N,N,-,-1,-1
PILGRIM.txt,305626,306238,612,5,N,N,-,-1,-1
PILGRIM.txt,306239,306644,405,5,N,N,-,-1,-1
PILGRIM.txt,306645,307154,509,5,N,N,-,-1,-1
PILGRIM.txt,307155,307596,441,5,N,N,-,-1,-1
PILGRIM.txt,307597,308148,551,5,N,N,-,-1,-1
PILGRIM.txt,308151,308585,434,5,N,Y,1432919383904,308149,309945
PILGRIM.txt,308586,309255,669,5,N,Y,1432919383904,308149,309945
PILGRIM.txt,309256,309651,395,5,N,Y,1432919383904,308149,309945
PILGRIM.txt,309652,310195,543,5,N,Y,1432919383904,308149,309945
PILGRIM.txt,310196,310731,535,5,N,N,-,-1,-1
PILGRIM.txt,310732,311528,796,5,N,N,-,-1,-1
PILGRIM.txt,311529,312367,838,5,N,N,-,-1,-1
PILGRIM.txt,312368,313010,642,5,N,N,-,-1,-1
PILGRIM.txt,313012,313556,544,5,N,N,-,-1,-1
PILGRIM.txt,313557,314326,769,5,N,N,-,-1,-1
PILGRIM.txt,314327,315024,697,5,N,N,-,-1,-1
PILGRIM.txt,315025,315539,514,5,N,N,-,-1,-1
PILGRIM.txt,315540,316224,684,5,N,N,-,-1,-1
PILGRIM.txt,316225,316786,561,5,N,N,-,-1,-1
PILGRIM.txt,316787,317447,660,5,N,N,-,-1,-1
PILGRIM.txt,317450,317729,279,5,N,N,-,-1,-1
PILGRIM.txt,317732,318581,849,5,N,N,-,-1,-1
PILGRIM.txt,318583,319558,975,5,N,N,-,-1,-1
PILGRIM.txt,319559,320009,450,5,N,N,-,-1,-1
PILGRIM.txt,320012,320606,594,5,N,N,-,-1,-1
PILGRIM.txt,320607,321169,562,5,N,N,-,-1,-1
PILGRIM.txt,321170,321507,337,5,N,N,-,-1,-1
PILGRIM.txt,321508,321989,481,5,N,N,-,-1,-1
PILGRIM.txt,321992,322842,850,5,N,N,-,-1,-1
PILGRIM.txt,322845,323485,640,5,N,N,-,-1,-1
PILGRIM.txt,323486,324446,960,5,N,N,-,-1,-1
PILGRIM.txt,324447,325295,848,5,N,N,-,-1,-1
PILGRIM.txt,325296,325862,566,5,N,N,-,-1,-1
PILGRIM.txt,325863,326667,804,5,N,N,-,-1,-1
PILGRIM.txt,326668,327412,744,5,N,N,-,-1,-1
PILGRIM.txt,327413,327937,524,5,N,Y,1432976483264,327834,329881
PILGRIM.txt,327938,328774,836,5,N,Y,1432976483264,327834,329881
PILGRIM.txt,328775,329580,805,5,N,Y,1432976483264,327834,329881
PILGRIM.txt,329581,330145,564,5,N,Y,1432976483264,327834,329881
PILGRIM.txt,330146,330948,802,5,N,N,-,-1,-1
PILGRIM.txt,330951,332111,1160,5,N,N,-,-1,-1
PILGRIM.txt,332112,332943,831,5,N,N,-,-1,-1
PILGRIM.txt,332946,333368,422,5,N,N,-,-1,-1
PILGRIM.txt,333371,333827,456,5,N,N,-,-1,-1
PILGRIM.txt,333828,334621,793,5,N,N,-,-1,-1
PILGRIM.txt,334623,335853,1230,5,N,N,-,-1,-1
PILGRIM.txt,335856,336841,985,5,N,N,-,-1,-1
PILGRIM.txt,336842,337401,559,5,N,N,-,-1,-1
PILGRIM.txt,337402,338248,846,5,N,N,-,-1,-1
PILGRIM.txt,338251,339403,1152,5,N,N,-,-1,-1
PILGRIM.txt,339404,340075,671,5,N,N,-,-1,-1
PILGRIM.txt,340076,340972,896,5,N,N,-,-1,-1
PILGRIM.txt,340973,341673,700,5,N,N,-,-1,-1
PILGRIM.txt,341674,342471,797,5,N,N,-,-1,-1
PILGRIM.txt,342472,343642,1170,5,N,N,-,-1,-1
PILGRIM.txt,343647,344524,877,5,N,N,-,-1,-1
PILGRIM.txt,344525,345460,935,5,N,N,-,-1,-1
PILGRIM.txt,345462,346231,769,5,N,N,-,-1,-1
PILGRIM.txt,346232,347041,809,5,N,N,-,-1,-1
PILGRIM.txt,347042,347675,633,5,N,N,-,-1,-1
PILGRIM.txt,347676,348234,558,5,N,N,-,-1,-1
PILGRIM.txt,348236,349033,797,5,N,N,-,-1,-1
PILGRIM.txt,349034,349852,818,5,N,N,-,-1,-1
PILGRIM.txt,349853,350745,892,5,N,N,-,-1,-1
PILGRIM.txt,350746,351370,624,5,N,N,-,-1,-1
PILGRIM.txt,351371,352176,805,5,N,N,-,-1,-1
PILGRIM.txt,352177,352875,698,5,N,N,-,-1,-1
PILGRIM.txt,352876,354054,1178,5,N,N,-,-1,-1
PILGRIM.txt,354055,354931,876,5,N,N,-,-1,-1
PILGRIM.txt,354934,355520,586,5,N,N,-,-1,-1
PILGRIM.txt,355523,356348,825,5,N,N,-,-1,-1
PILGRIM.txt,356349,357119,770,5,N,N,-,-1,-1
PILGRIM.txt,357120,357835,715,5,N,N,-,-1,-1
PILGRIM.txt,357836,358418,582,5,N,N,-,-1,-1
PILGRIM.txt,358420,358813,393,5,N,N,-,-1,-1
PILGRIM.txt,358814,359423,609,5,N,N,-,-1,-1
PILGRIM.txt,359424,360236,812,5,N,N,-,-1,-1
PILGRIM.txt,360237,361034,797,5,N,N,-,-1,-1
PILGRIM.txt,361035,361543,508,5,N,N,-,-1,-1
PILGRIM.txt,361545,362105,560,5,N,Y,1432978478641,361921,364422
PILGRIM.txt,362106,363072,966,5,N,Y,1432978478641,361921,364422
PILGRIM.txt,363074,363784,710,5,N,Y,1432978478641,361921,364422
PILGRIM.txt,363785,365105,1320,5,N,Y,1432978478641,361921,364422
PILGRIM.txt,365106,365682,576,5,N,N,-,-1,-1
PILGRIM.txt,365683,366519,836,5,N,N,-,-1,-1
PILGRIM.txt,366520,367025,505,5,N,N,-,-1,-1
PILGRIM.txt,367028,367699,671,5,N,N,-,-1,-1
PILGRIM.txt,367700,368464,764,5,N,N,-,-1,-1
PILGRIM.txt,368465,369093,628,5,N,N,-,-1,-1
PILGRIM.txt,369094,369863,769,5,N,N,-,-1,-1
PILGRIM.txt,369863,370847,984,5,N,N,-,-1,-1
PILGRIM.txt,370850,371594,744,5,N,N,-,-1,-1
PILGRIM.txt,371595,372456,861,5,N,N,-,-1,-1
PILGRIM.txt,372457,373295,838,5,N,N,-,-1,-1
PILGRIM.txt,373296,373880,584,5,N,N,-,-1,-1
PILGRIM.txt,373881,374526,645,5,N,N,-,-1,-1
PILGRIM.txt,374526,375150,624,5,N,N,-,-1,-1
PILGRIM.txt,375151,376081,930,5,N,N,-,-1,-1
PILGRIM.txt,376083,376603,520,5,N,N,-,-1,-1
PILGRIM.txt,376604,376999,395,5,N,N,-,-1,-1
PILGRIM.txt,377004,377834,830,5,N,N,-,-1,-1
PILGRIM.txt,377835,378568,733,5,N,N,-,-1,-1
PILGRIM.txt,378573,379185,612,5,N,N,-,-1,-1
PILGRIM.txt,379186,379780,594,5,N,N,-,-1,-1
PILGRIM.txt,379781,380485,704,5,N,N,-,-1,-1
PILGRIM.txt,380490,381136,646,5,N,N,-,-1,-1
PILGRIM.txt,381139,382129,990,5,N,N,-,-1,-1
PILGRIM.txt,382132,382899,767,5,N,N,-,-1,-1
PILGRIM.txt,382902,383563,661,5,N,N,-,-1,-1
PILGRIM.txt,383566,384054,488,5,N,N,-,-1,-1
PILGRIM.txt,384055,385308,1253,5,N,Y,1432979435232,384507,385447
PILGRIM.txt,385309,386224,915,5,N,Y,1432979435232,384507,385447
PILGRIM.txt,386225,387389,1164,5,N,N,-,-1,-1
PILGRIM.txt,387391,388019,628,5,N,N,-,-1,-1
PILGRIM.txt,388020,388391,371,5,N,N,-,-1,-1
PILGRIM.txt,388392,389091,699,5,N,N,-,-1,-1
PILGRIM.txt,389092,389629,537,5,N,N,-,-1,-1
PILGRIM.txt,389630,390449,819,5,N,N,-,-1,-1
PILGRIM.txt,390450,391255,805,5,N,N,-,-1,-1
PILGRIM.txt,391256,392484,1228,5,N,N,-,-1,-1
PILGRIM.txt,392485,393230,745,5,N,N,-,-1,-1
PILGRIM.txt,393231,393573,342,5,N,N,-,-1,-1
PILGRIM.txt,393574,394032,458,5,N,N,-,-1,-1
PILGRIM.txt,394037,394708,671,5,N,N,-,-1,-1
PILGRIM.txt,394709,395161,452,5,N,N,-,-1,-1
PILGRIM.txt,395164,395837,673,5,N,N,-,-1,-1
PILGRIM.txt,395838,396600,762,5,N,N,-,-1,-1
PILGRIM.txt,396601,397313,712,5,N,N,-,-1,-1
PILGRIM.txt,397314,398592,1278,5,N,N,-,-1,-1
PILGRIM.txt,398595,400219,1624,5,N,Y,1432980418512,399130,400458
PILGRIM.txt,400220,401092,872,5,N,Y,1432980418512,399130,400458
PILGRIM.txt,401094,401912,818,5,N,N,-,-1,-1
PILGRIM.txt,401913,402572,659,5,N,N,-,-1,-1
PILGRIM.txt,402573,403087,514,5,N,N,-,-1,-1
PILGRIM.txt,403090,403482,392,5,N,N,-,-1,-1
PILGRIM.txt,403484,404190,706,5,N,N,-,-1,-1
PILGRIM.txt,404191,405146,955,5,N,N,-,-1,-1
PILGRIM.txt,405147,405929,782,5,N,N,-,-1,-1
PILGRIM.txt,405930,406630,700,5,N,N,-,-1,-1
PILGRIM.txt,406632,407455,823,5,N,N,-,-1,-1
PILGRIM.txt,407458,407884,426,5,N,N,-,-1,-1
PILGRIM.txt,407885,408928,1043,5,N,N,-,-1,-1
PILGRIM.txt,408929,409373,444,5,N,N,-,-1,-1
PILGRIM.txt,409376,410127,751,5,N,N,-,-1,-1
PILGRIM.txt,410132,410737,605,5,N,N,-,-1,-1
PILGRIM.txt,410740,411303,563,5,N,N,-,-1,-1
PILGRIM.txt,411304,412187,883,5,N,Y,1432982795628,411959,413612
PILGRIM.txt,412188,412861,673,5,N,Y,1432982795628,411959,413612
PILGRIM.txt,412862,413679,817,5,N,Y,1432982795628,411959,413612
PILGRIM.txt,413682,414700,1018,5,N,N,-,-1,-1
PILGRIM.txt,414701,415529,828,5,N,N,-,-1,-1
PILGRIM.txt,415530,416403,873,5,N,N,-,-1,-1
PILGRIM.txt,416404,417060,656,5,N,N,-,-1,-1
PILGRIM.txt,417063,417977,914,5,N,N,-,-1,-1
PILGRIM.txt,417979,418935,956,5,N,N,-,-1,-1
PILGRIM.txt,418938,419613,675,5,N,N,-,-1,-1
PILGRIM.txt,419614,420309,695,5,N,N,-,-1,-1
PILGRIM.txt,420311,421108,797,5,N,Y,1432984504343,420736,421597
PILGRIM.txt,421109,421993,884,5,N,Y,1432984504343,420736,421597
PILGRIM.txt,421994,422583,589,5,N,N,-,-1,-1
PILGRIM.txt,422584,423543,959,5,N,N,-,-1,-1
PILGRIM.txt,423544,424142,598,5,N,N,-,-1,-1
PILGRIM.txt,424143,424876,733,5,N,N,-,-1,-1
PILGRIM.txt,424878,425518,640,5,N,N,-,-1,-1
PILGRIM.txt,425519,426088,569,5,N,N,-,-1,-1
PILGRIM.txt,426091,427153,1062,5,N,N,-,-1,-1
PILGRIM.txt,427155,427689,534,5,N,N,-,-1,-1
PILGRIM.txt,427690,428548,858,5,N,N,-,-1,-1
PILGRIM.txt,428549,429326,777,5,N,N,-,-1,-1
PILGRIM.txt,429327,430127,800,5,N,N,-,-1,-1
PILGRIM.txt,430130,430971,841,5,N,N,-,-1,-1
PILGRIM.txt,430974,431825,851,5,N,N,-,-1,-1
PILGRIM.txt,431828,432544,716,5,N,N,-,-1,-1
PILGRIM.txt,432545,433060,515,5,N,N,-,-1,-1
PILGRIM.txt,433061,433782,721,5,N,N,-,-1,-1
PILGRIM.txt,433784,434749,965,5,N,N,-,-1,-1
PILGRIM.txt,434750,435655,905,5,N,N,-,-1,-1
PILGRIM.txt,435656,436244,588,5,N,N,-,-1,-1
PILGRIM.txt,436246,436507,261,5,N,N,-,-1,-1
PILGRIM.txt,436508,436977,469,5,N,N,-,-1,-1
PILGRIM.txt,436978,437599,621,5,N,N,-,-1,-1
PILGRIM.txt,437604,438312,708,5,N,N,-,-1,-1
PILGRIM.txt,438314,439011,697,5,N,N,-,-1,-1
PILGRIM.txt,439012,439761,749,5,N,N,-,-1,-1
PILGRIM.txt,439763,440428,665,5,N,N,-,-1,-1
PILGRIM.txt,440430,440927,497,5,N,N,-,-1,-1
PILGRIM.txt,440928,441567,639,5,N,N,-,-1,-1
PILGRIM.txt,441568,442172,604,5,N,N,-,-1,-1
PILGRIM.txt,442173,442685,512,5,N,N,-,-1,-1
PILGRIM.txt,442690,443073,383,5,N,N,-,-1,-1
PILGRIM.txt,443075,443344,269,5,N,N,-,-1,-1
PILGRIM.txt,443345,444104,759,5,N,N,-,-1,-1
PILGRIM.txt,444105,444751,646,5,N,N,-,-1,-1
PILGRIM.txt,444753,445424,671,5,N,N,-,-1,-1
PILGRIM.txt,445425,446120,695,5,N,N,-,-1,-1
PILGRIM.txt,446121,446979,858,5,N,N,-,-1,-1
PILGRIM.txt,446982,447538,556,5,N,N,-,-1,-1
PILGRIM.txt,447539,448414,875,5,N,N,-,-1,-1
PILGRIM.txt,448415,449026,611,5,N,N,-,-1,-1
PILGRIM.txt,449027,449819,792,5,N,N,-,-1,-1
PILGRIM.txt,449820,450246,426,5,N,N,-,-1,-1
PILGRIM.txt,450247,451182,935,5,N,N,-,-1,-1
PILGRIM.txt,451183,451735,552,5,N,N,-,-1,-1
PILGRIM.txt,451736,452404,668,5,N,N,-,-1,-1
PILGRIM.txt,452407,453139,732,5,N,N,-,-1,-1
PILGRIM.txt,453140,453850,710,5,N,N,-,-1,-1
PILGRIM.txt,453853,454701,848,5,N,N,-,-1,-1
PILGRIM.txt,454702,455450,748,5,N,N,-,-1,-1
PILGRIM.txt,455453,456165,712,5,N,Y,1433089799400,455451,455857
PILGRIM.txt,456166,456873,707,5,N,N,-,-1,-1
PILGRIM.txt,456874,457463,589,5,N,N,-,-1,-1
PILGRIM.txt,457464,457883,419,5,N,N,-,-1,-1
PILGRIM.txt,457884,458491,607,5,N,N,-,-1,-1
PILGRIM.txt,458493,459357,864,5,N,N,-,-1,-1
PILGRIM.txt,459358,459901,543,5,N,N,-,-1,-1
PILGRIM.txt,459902,460564,662,5,N,N,-,-1,-1
PILGRIM.txt,460565,461138,573,5,N,N,-,-1,-1
PILGRIM.txt,461141,461822,681,5,N,N,-,-1,-1
PILGRIM.txt,461824,462786,962,5,N,N,-,-1,-1
PILGRIM.txt,462789,463626,837,5,N,N,-,-1,-1
PILGRIM.txt,463627,464145,518,5,N,N,-,-1,-1
PILGRIM.txt,464146,464871,725,5,N,N,-,-1,-1
PILGRIM.txt,464874,465298,424,5,N,N,-,-1,-1
PILGRIM.txt,465301,466114,813,5,N,N,-,-1,-1
PILGRIM.txt,466116,466890,774,5,N,N,-,-1,-1
PILGRIM.txt,466891,467562,671,5,N,N,-,-1,-1
PILGRIM.txt,467565,468070,505,5,N,N,-,-1,-1
PILGRIM.txt,468071,468430,359,5,N,N,-,-1,-1
PILGRIM.txt,468433,469154,721,5,N,N,-,-1,-1
PILGRIM.txt,469155,469661,506,5,N,N,-,-1,-1
PILGRIM.txt,469662,470570,908,5,N,N,-,-1,-1
PILGRIM.txt,470573,471753,1180,5,N,Y,1433091318633,471647,472306
PILGRIM.txt,471754,472647,893,5,N,Y,1433091318633,471647,472306
PILGRIM.txt,472648,473280,632,5,N,N,-,-1,-1
PILGRIM.txt,473281,473918,637,5,N,N,-,-1,-1
PILGRIM.txt,473919,474386,467,5,N,N,-,-1,-1
PILGRIM.txt,474388,474929,541,5,N,N,-,-1,-1
PILGRIM.txt,474930,475806,876,5,N,N,-,-1,-1
PILGRIM.txt,475809,476941,1132,5,N,N,-,-1,-1
PILGRIM.txt,476944,477794,850,5,N,N,-,-1,-1
PILGRIM.txt,477795,478834,1039,5,N,N,-,-1,-1
PILGRIM.txt,478837,479796,959,5,N,N,-,-1,-1
PILGRIM.txt,479797,481015,1218,5,N,N,-,-1,-1
PILGRIM.txt,481018,481721,703,5,N,N,-,-1,-1
PILGRIM.txt,481722,482815,1093,5,N,N,-,-1,-1
PILGRIM.txt,482818,483706,888,5,N,N,-,-1,-1
PILGRIM.txt,483707,484389,682,5,N,N,-,-1,-1
PILGRIM.txt,484390,485120,730,5,N,N,-,-1,-1
PILGRIM.txt,485125,486163,1038,5,N,N,-,-1,-1
PILGRIM.txt,486166,486966,800,5,N,N,-,-1,-1
PILGRIM.txt,486967,487923,956,5,N,N,-,-1,-1
PILGRIM.txt,487924,488879,955,5,N,N,-,-1,-1
PILGRIM.txt,488880,489538,658,5,N,N,-,-1,-1
PILGRIM.txt,489539,490148,609,5,N,N,-,-1,-1
PILGRIM.txt,490149,490903,754,5,N,N,-,-1,-1
PILGRIM.txt,490905,491545,640,5,N,N,-,-1,-1
PILGRIM.txt,491546,492307,761,5,N,N,-,-1,-1
PILGRIM.txt,492308,493125,817,5,N,N,-,-1,-1
PILGRIM.txt,493126,493831,705,5,N,N,-,-1,-1
PILGRIM.txt,493832,494561,729,5,N,N,-,-1,-1
PILGRIM.txt,494562,495624,1062,5,N,N,-,-1,-1
PILGRIM.txt,495625,496613,988,5,N,Y,1433092717054,496037,497172
PILGRIM.txt,496614,497600,986,5,N,Y,1433092717054,496037,497172
PILGRIM.txt,497601,498471,870,5,N,Y,1433093250202,497882,499236
PILGRIM.txt,498473,499296,823,5,N,Y,1433093250202,497882,499236
PILGRIM.txt,499299,500250,951,5,N,N,-,-1,-1
PILGRIM.txt,500251,500991,740,5,N,N,-,-1,-1
PILGRIM.txt,500994,501855,861,5,N,N,-,-1,-1
PILGRIM.txt,501856,502931,1075,5,N,N,-,-1,-1
PILGRIM.txt,502932,503477,545,5,N,N,-,-1,-1
PILGRIM.txt,503478,504351,873,5,N,N,-,-1,-1
PILGRIM.txt,504352,505338,986,5,N,N,-,-1,-1
PILGRIM.txt,505343,505781,438,5,N,N,-,-1,-1
PILGRIM.txt,505784,506347,563,5,N,N,-,-1,-1
PILGRIM.txt,506348,507428,1080,5,N,N,-,-1,-1
PILGRIM.txt,507429,507942,513,5,N,N,-,-1,-1
PILGRIM.txt,507947,508578,631,5,N,N,-,-1,-1
PILGRIM.txt,508579,509108,529,5,N,N,-,-1,-1
PILGRIM.txt,509111,509877,766,5,N,N,-,-1,-1
PILGRIM.txt,509878,510143,265,5,N,N,-,-1,-1
PILGRIM.txt,510145,511111,966,5,N,N,-,-1,-1
PILGRIM.txt,511112,511655,543,5,N,N,-,-1,-1
PILGRIM.txt,511658,512456,798,5,N,N,-,-1,-1
PILGRIM.txt,512459,513219,760,5,N,N,-,-1,-1
PILGRIM.txt,513224,513839,615,5,N,N,-,-1,-1
PILGRIM.txt,513841,514667,826,5,N,N,-,-1,-1
PILGRIM.txt,514668,515335,667,5,N,N,-,-1,-1
PILGRIM.txt,515337,516008,671,5,N,N,-,-1,-1
PILGRIM.txt,516009,516472,463,5,N,N,-,-1,-1
PILGRIM.txt,516473,517131,658,5,N,N,-,-1,-1
PILGRIM.txt,517133,517664,531,5,N,N,-,-1,-1
PILGRIM.txt,517666,518421,755,5,N,N,-,-1,-1
PILGRIM.txt,518422,518984,562,5,N,N,-,-1,-1
PILGRIM.txt,518986,519986,1000,5,N,N,-,-1,-1
PILGRIM.txt,519988,520675,687,5,N,N,-,-1,-1
PILGRIM.txt,520680,521077,397,5,N,N,-,-1,-1
PILGRIM.txt,521080,521665,585,5,N,N,-,-1,-1
PILGRIM.txt,521667,522278,611,5,N,N,-,-1,-1
PILGRIM.txt,522279,522785,506,5,N,N,-,-1,-1
PILGRIM.txt,522786,523139,353,5,N,N,-,-1,-1
PILGRIM.txt,523142,523923,781,5,N,N,-,-1,-1
PILGRIM.txt,523925,524592,667,5,N,N,-,-1,-1
PILGRIM.txt,524593,525364,771,5,N,N,-,-1,-1
PILGRIM.txt,525365,526000,635,5,N,N,-,-1,-1
PILGRIM.txt,526001,526876,875,5,N,Y,1433140776828,526138,528487
PILGRIM.txt,526879,528553,1674,5,N,Y,1433140776828,526138,528487
PILGRIM.txt,528558,529256,698,5,N,N,-,-1,-1
PILGRIM.txt,529257,530154,897,5,N,N,-,-1,-1
PILGRIM.txt,530155,530938,783,5,N,N,-,-1,-1
PILGRIM.txt,530941,531660,719,5,N,N,-,-1,-1
PILGRIM.txt,531661,531976,315,5,N,N,-,-1,-1
PILGRIM.txt,531977,532622,645,5,N,Y,1433166467939,532258,533091
PILGRIM.txt,532623,533113,490,5,N,Y,1433166467939,532258,533091
PILGRIM.txt,533116,534188,1072,5,N,N,-,-1,-1
PILGRIM.txt,534189,535158,969,5,N,N,-,-1,-1
PILGRIM.txt,535159,535736,577,5,N,N,-,-1,-1
PILGRIM.txt,535737,536559,822,5,N,N,-,-1,-1
PILGRIM.txt,536560,537194,634,5,N,N,-,-1,-1
PILGRIM.txt,537195,538137,942,5,N,N,-,-1,-1
PILGRIM.txt,538138,538502,364,5,N,N,-,-1,-1
PILGRIM.txt,538503,538792,289,5,N,N,-,-1,-1
PILGRIM.txt,538795,539126,331,5,N,N,-,-1,-1
PILGRIM.txt,539127,539561,434,5,N,N,-,-1,-1
PILGRIM.txt,539562,540153,591,5,N,N,-,-1,-1
PILGRIM.txt,540156,540896,740,5,N,N,-,-1,-1
PILGRIM.txt,540899,541551,652,5,N,N,-,-1,-1
PILGRIM.txt,541552,542276,724,5,N,N,-,-1,-1
PILGRIM.txt,542278,543002,724,5,N,N,-,-1,-1
PILGRIM.txt,543003,543746,743,5,N,N,-,-1,-1
PILGRIM.txt,543749,544410,661,5,N,N,-,-1,-1
PILGRIM.txt,544412,545315,903,5,N,Y,1433167548802,544513,546084
PILGRIM.txt,545316,545981,665,5,N,Y,1433167548802,544513,546084
PILGRIM.txt,545982,546618,636,5,N,Y,1433167548802,544513,546084
PILGRIM.txt,546620,547496,876,5,N,N,-,-1,-1
PILGRIM.txt,547497,548618,1121,5,N,Y,1433168080595,547752,548387
PILGRIM.txt,548619,549306,687,5,N,N,-,-1,-1
PILGRIM.txt,549309,550044,735,5,N,N,-,-1,-1
PILGRIM.txt,550045,550763,718,5,N,N,-,-1,-1
PILGRIM.txt,550764,551302,538,5,N,N,-,-1,-1
PILGRIM.txt,551305,552287,982,5,N,N,-,-1,-1
PILGRIM.txt,552290,552962,672,5,N,N,-,-1,-1
PILGRIM.txt,552965,553963,998,5,N,N,-,-1,-1
PILGRIM.txt,553966,554945,979,5,N,N,-,-1,-1
PILGRIM.txt,554948,555847,899,5,N,N,-,-1,-1
PILGRIM.txt,555852,556579,727,5,N,N,-,-1,-1
PILGRIM.txt,556582,556988,406,5,N,Y,1433168856414,556592,557358
PILGRIM.txt,556990,557996,1006,5,N,Y,1433168856414,556592,557358
PILGRIM.txt,557997,558597,600,5,N,N,-,-1,-1
PILGRIM.txt,558597,559062,465,5,N,N,-,-1,-1
PILGRIM.txt,559063,559631,568,5,N,N,-,-1,-1
PILGRIM.txt,559632,560330,698,5,N,N,-,-1,-1
PILGRIM.txt,560331,560992,661,5,N,N,-,-1,-1
PILGRIM.txt,560993,562000,1007,5,N,N,-,-1,-1
PILGRIM.txt,562001,562751,750,5,N,N,-,-1,-1
PILGRIM.txt,562754,563447,693,5,N,N,-,-1,-1
PILGRIM.txt,563449,563911,462,5,N,N,-,-1,-1
PILGRIM.txt,563913,564346,433,5,N,N,-,-1,-1
PILGRIM.txt,564347,564611,264,5,N,N,-,-1,-1
PILGRIM.txt,564613,564933,320,5,N,N,-,-1,-1
PILGRIM.txt,564934,565632,698,5,N,N,-,-1,-1
PILGRIM.txt,565633,566124,491,5,N,N,-,-1,-1
PILGRIM.txt,566127,566431,304,5,N,N,-,-1,-1
PILGRIM.txt,566432,566903,471,5,N,N,-,-1,-1
PILGRIM.txt,566904,567222,318,5,N,N,-,-1,-1
PILGRIM.txt,567223,567940,717,5,N,N,-,-1,-1
PILGRIM.txt,567941,568490,549,5,N,N,-,-1,-1
PILGRIM.txt,568491,568862,371,5,N,N,-,-1,-1
PILGRIM.txt,568864,569678,814,5,N,N,-,-1,-1
PILGRIM.txt,569679,570218,539,5,N,N,-,-1,-1
PILGRIM.txt,570219,571214,995,5,N,N,-,-1,-1
PILGRIM.txt,571217,571605,388,5,N,N,-,-1,-1
PILGRIM.txt,571606,572180,574,5,N,N,-,-1,-1
PILGRIM.txt,572181,572663,482,5,N,N,-,-1,-1
PILGRIM.txt,572665,573315,650,5,N,N,-,-1,-1
PILGRIM.txt,573316,574063,747,5,N,N,-,-1,-1
PILGRIM.txt,574066,574949,883,5,N,N,-,-1,-1
PILGRIM.txt,574952,576078,1126,5,N,N,-,-1,-1
PILGRIM.txt,576081,576703,622,5,N,N,-,-1,-1
PILGRIM.txt,576704,577179,475,5,N,N,-,-1,-1
PILGRIM.txt,577180,578282,1102,5,N,N,-,-1,-1
PILGRIM.txt,578287,579017,730,5,N,N,-,-1,-1
PILGRIM.txt,579018,579821,803,5,N,N,-,-1,-1
PILGRIM.txt,579822,580549,727,5,N,N,-,-1,-1
PILGRIM.txt,580549,581975,1426,5,N,N,-,-1,-1
PILGRIM.txt,581976,582402,426,5,N,N,-,-1,-1
PILGRIM.txt,582403,583466,1063,5,N,N,-,-1,-1
PILGRIM.txt,583467,584459,992,5,N,N,-,-1,-1
PILGRIM.txt,584462,585070,608,5,N,N,-,-1,-1
PILGRIM.txt,585071,585538,467,5,N,N,-,-1,-1
PILGRIM.txt,585541,585917,376,5,N,N,-,-1,-1
PILGRIM.txt,585918,586255,337,5,N,N,-,-1,-1
PILGRIM.txt,586256,586772,516,5,N,N,-,-1,-1
PILGRIM.txt,586773,587451,678,5,N,N,-,-1,-1
PILGRIM.txt,587452,588181,729,5,N,N,-,-1,-1
PILGRIM.txt,588182,588421,239,5,N,N,-,-1,-1
PILGRIM.txt,588422,589190,768,5,N,N,-,-1,-1
PILGRIM.txt,589192,589418,226,5,N,N,-,-1,-1
PILGRIM.txt,589419,589885,466,5,N,N,-,-1,-1
PILGRIM.txt,589886,590430,544,5,N,N,-,-1,-1
PILGRIM.txt,590433,590997,564,5,N,N,-,-1,-1
PILGRIM.txt,591000,591462,462,5,N,N,-,-1,-1
PILGRIM.txt,591463,592173,710,5,N,N,-,-1,-1
PILGRIM.txt,592174,592796,622,5,N,N,-,-1,-1
PILGRIM.txt,592797,593581,784,5,N,N,-,-1,-1
PILGRIM.txt,593582,594416,834,5,N,N,-,-1,-1
PILGRIM.txt,594416,595643,1227,5,N,N,-,-1,-1
PILGRIM.txt,595644,596125,481,5,N,N,-,-1,-1
PILGRIM.txt,596126,596686,560,5,N,N,-,-1,-1
PILGRIM.txt,596689,597303,614,5,N,N,-,-1,-1
PILGRIM.txt,597304,597845,541,5,N,N,-,-1,-1
PILGRIM.txt,597846,600018,2172,5,N,N,-,-1,-1
PILGRIM.txt,600021,600499,478,5,N,N,-,-1,-1
PILGRIM.txt,600502,601782,1280,5,N,N,-,-1,-1
PILGRIM.txt,601787,602527,740,5,N,N,-,-1,-1
PILGRIM.txt,602528,603308,780,5,N,N,-,-1,-1
PILGRIM.txt,603311,603988,677,5,N,N,-,-1,-1
PILGRIM.txt,603989,604959,970,5,N,N,-,-1,-1
PILGRIM.txt,604960,605856,896,5,N,N,-,-1,-1
PILGRIM.txt,605858,606643,785,5,N,N,-,-1,-1
PILGRIM.txt,606644,607628,984,5,N,N,-,-1,-1
PILGRIM.txt,607630,609018,1388,5,N,N,-,-1,-1
PILGRIM.txt,609021,609312,291,5,N,N,-,-1,-1
PILGRIM.txt,609312,609417,105,5,N,N,-,-1,-1
PILGRIM.txt,609417,609445,28,5,N,N,-,-1,-1
PILGRIM.txt,609446,609489,43,5,N,N,-,-1,-1
PILGRIM.txt,609489,609623,134,5,N,N,-,-1,-1
PILGRIM.txt,609626,609794,168,5,N,N,-,-1,-1
PILGRIM.txt,609795,609989,194,5,N,N,-,-1,-1
PILGRIM.txt,609990,610127,137,5,N,N,-,-1,-1
PILGRIM.txt,610127,610148,21,5,N,N,-,-1,-1
PILGRIM.txt,610149,610254,105,5,N,N,-,-1,-1
PILGRIM.txt,610257,610306,49,5,N,N,-,-1,-1
PILGRIM.txt,610306,610578,272,5,N,N,-,-1,-1
PILGRIM.txt,610578,610705,127,5,N,N,-,-1,-1
PILGRIM.txt,610706,610858,152,5,N,N,-,-1,-1
PILGRIM.txt,610859,611462,603,5,N,N,-,-1,-1
PILGRIM.txt,611463,612703,1240,5,N,N,-,-1,-1
PILGRIM.txt,612704,614038,1334,5,N,N,-,-1,-1
PILGRIM.txt,614039,615188,1149,5,N,N,-,-1,-1
PILGRIM.txt,615190,616322,1132,5,N,N,-,-1,-1
PILGRIM.txt,616323,616946,623,5,N,N,-,-1,-1
PILGRIM.txt,616947,617713,766,5,N,N,-,-1,-1
PILGRIM.txt,617714,618379,665,5,N,N,-,-1,-1
PILGRIM.txt,618380,619046,666,5,N,N,-,-1,-1
PILGRIM.txt,619047,619619,572,5,N,N,-,-1,-1
PILGRIM.txt,619620,620899,1279,5,N,N,-,-1,-1
PILGRIM.txt,620904,621592,688,5,N,N,-,-1,-1
PILGRIM.txt,621595,622321,726,5,N,N,-,-1,-1
PILGRIM.txt,622323,623000,677,5,N,N,-,-1,-1
PILGRIM.txt,623003,623584,581,5,N,N,-,-1,-1
PILGRIM.txt,623585,624427,842,5,N,N,-,-1,-1
PILGRIM.txt,624429,625050,621,5,N,N,-,-1,-1
PILGRIM.txt,625051,625761,710,5,N,N,-,-1,-1
PILGRIM.txt,625762,626873,1111,5,N,N,-,-1,-1
PILGRIM.txt,626874,627837,963,5,N,N,-,-1,-1
PILGRIM.txt,627838,628616,778,5,N,N,-,-1,-1
PILGRIM.txt,628617,629068,451,5,N,N,-,-1,-1
PILGRIM.txt,629071,630137,1066,5,N,N,-,-1,-1
PILGRIM.txt,630138,630760,622,5,N,N,-,-1,-1
PILGRIM.txt,630761,631184,423,5,N,N,-,-1,-1
PILGRIM.txt,631189,632359,1170,5,N,N,-,-1,-1
PILGRIM.txt,632360,634372,2012,5,N,N,-,-1,-1
PILGRIM.txt,634377,640579,6202,5,Y,N,-,-1,-1
PILGRIM.txt,640581,642095,1514,5,N,N,-,-1,-1
PILGRIM.txt,642096,645148,3052,5,N,N,-,-1,-1
PILGRIM.txt,645151,647485,2334,5,N,N,-,-1,-1
PILGRIM.txt,647486,653558,6072,5,N,N,-,-1,-1
PILGRIM.txt,653560,659307,5747,5,N,N,-,-1,-1
PILGRIM.txt,659308,662919,3611,5,N,N,-,-1,-1
RECMUS.txt,0,261,261,5,N,N,-,-1,-1
RECMUS.txt,263,464,201,5,N,N,-,-1,-1
RECMUS.txt,465,782,317,5,N,N,-,-1,-1
RECMUS.txt,783,1082,299,5,N,N,-,-1,-1
RECMUS.txt,1083,1243,160,5,N,N,-,-1,-1
RECMUS.txt,1244,2109,865,5,N,N,-,-1,-1
RECMUS.txt,2110,2889,779,5,N,N,-,-1,-1
RECMUS.txt,2890,3406,516,5,N,N,-,-1,-1
RECMUS.txt,3411,4118,707,5,N,N,-,-1,-1
RECMUS.txt,4123,4561,438,5,N,N,-,-1,-1
RECMUS.txt,4564,5492,928,5,N,N,-,-1,-1
RECMUS.txt,5495,7245,1750,5,N,N,-,-1,-1
RECMUS.txt,7248,8111,863,5,N,N,-,-1,-1
RECMUS.txt,8114,9445,1331,5,N,N,-,-1,-1
RECMUS.txt,9448,10749,1301,5,N,N,-,-1,-1
RECMUS.txt,10750,11702,952,5,N,N,-,-1,-1
RECMUS.txt,11705,12614,909,5,N,N,-,-1,-1
RECMUS.txt,12617,13409,792,5,N,N,-,-1,-1
RECMUS.txt,13412,14274,862,5,N,N,-,-1,-1
RECMUS.txt,14275,15449,1174,5,N,N,-,-1,-1
RECMUS.txt,15452,16368,916,5,N,N,-,-1,-1
RECMUS.txt,16371,17687,1316,5,N,N,-,-1,-1
RECMUS.txt,17690,18498,808,5,N,N,-,-1,-1
RECMUS.txt,18499,18963,464,5,N,N,-,-1,-1
RECMUS.txt,18966,19928,962,5,N,N,-,-1,-1
RECMUS.txt,19933,20818,885,5,N,N,-,-1,-1
RECMUS.txt,20819,21385,566,5,N,N,-,-1,-1
RECMUS.txt,21388,22013,625,5,N,N,-,-1,-1
RECMUS.txt,22014,22600,586,5,N,N,-,-1,-1
RECMUS.txt,22603,23441,838,5,N,N,-,-1,-1
RECMUS.txt,23442,24052,610,5,N,N,-,-1,-1
RECMUS.txt,24054,24696,642,5,N,N,-,-1,-1
RECMUS.txt,24697,25446,749,5,N,N,-,-1,-1
RECMUS.txt,25447,26096,649,5,N,N,-,-1,-1
RECMUS.txt,26096,26796,700,5,N,N,-,-1,-1
RECMUS.txt,26797,27238,441,5,N,N,-,-1,-1
RECMUS.txt,27239,27690,451,5,N,N,-,-1,-1
RECMUS.txt,27692,28260,568,5,N,N,-,-1,-1
RECMUS.txt,28262,29127,865,5,N,N,-,-1,-1
RECMUS.txt,29128,29884,756,5,N,N,-,-1,-1
RECMUS.txt,29885,30466,581,5,N,N,-,-1,-1
RECMUS.txt,30467,30922,455,5,N,N,-,-1,-1
RECMUS.txt,30925,31673,748,5,N,N,-,-1,-1
RECMUS.txt,31674,32364,690,5,N,N,-,-1,-1
RECMUS.txt,32366,33065,699,5,N,N,-,-1,-1
RECMUS.txt,33066,33440,374,5,N,N,-,-1,-1
RECMUS.txt,33441,34255,814,5,N,N,-,-1,-1
RECMUS.txt,34258,35223,965,5,N,N,-,-1,-1
RECMUS.txt,35226,35581,355,5,N,N,-,-1,-1
RECMUS.txt,35583,36526,943,5,N,N,-,-1,-1
RECMUS.txt,36527,37467,940,5,N,N,-,-1,-1
RECMUS.txt,37468,38121,653,5,N,N,-,-1,-1
RECMUS.txt,38124,38573,449,5,N,N,-,-1,-1
RECMUS.txt,38576,39465,889,5,N,N,-,-1,-1
RECMUS.txt,39468,40197,729,5,N,N,-,-1,-1
RECMUS.txt,40200,40619,419,5,N,N,-,-1,-1
RECMUS.txt,40621,41393,772,5,N,N,-,-1,-1
RECMUS.txt,41396,41995,599,5,N,N,-,-1,-1
RECMUS.txt,41996,42653,657,5,N,N,-,-1,-1
RECMUS.txt,42656,43126,470,5,N,N,-,-1,-1
RECMUS.txt,43127,43668,541,5,N,N,-,-1,-1
RECMUS.txt,43669,44028,359,5,N,N,-,-1,-1
RECMUS.txt,44029,44965,936,5,Y,N,-,-1,-1
RECMUS.txt,44970,45661,691,5,N,N,-,-1,-1
RECMUS.txt,45662,46132,470,5,N,N,-,-1,-1
RECMUS.txt,46135,46689,554,5,N,N,-,-1,-1
RECMUS.txt,46690,47506,816,5,N,N,-,-1,-1
RECMUS.txt,47507,48232,725,5,N,N,-,-1,-1
RECMUS.txt,48233,48927,694,5,N,N,-,-1,-1
RECMUS.txt,48928,49811,883,5,N,N,-,-1,-1
RECMUS.txt,49816,50458,642,5,N,N,-,-1,-1
RECMUS.txt,50459,51305,846,5,N,N,-,-1,-1
RECMUS.txt,51306,52171,865,5,N,N,-,-1,-1
RECMUS.txt,52174,52537,363,5,N,N,-,-1,-1
RECMUS.txt,52539,53127,588,5,N,N,-,-1,-1
RECMUS.txt,53128,53726,598,5,N,N,-,-1,-1
RECMUS.txt,53727,54594,867,5,N,N,-,-1,-1
RECMUS.txt,54595,55340,745,5,N,N,-,-1,-1
RECMUS.txt,55341,56469,1128,5,N,N,-,-1,-1
RECMUS.txt,56470,56957,487,5,N,N,-,-1,-1
RECMUS.txt,56960,57979,1019,5,N,N,-,-1,-1
RECMUS.txt,57980,58431,451,5,N,N,-,-1,-1
RECMUS.txt,58432,58925,493,5,N,N,-,-1,-1
RECMUS.txt,58930,59741,811,5,N,N,-,-1,-1
RECMUS.txt,59742,60387,645,5,N,N,-,-1,-1
RECMUS.txt,60390,60497,107,5,N,N,-,-1,-1
RECMUS.txt,60498,60571,73,5,N,N,-,-1,-1
RECMUS.txt,60574,60683,109,5,N,N,-,-1,-1
RECMUS.txt,60684,61294,610,5,N,N,-,-1,-1
RECMUS.txt,61297,61860,563,5,N,N,-,-1,-1
RECMUS.txt,61861,62561,700,5,N,N,-,-1,-1
RECMUS.txt,62562,63159,597,5,N,N,-,-1,-1
RECMUS.txt,63160,63697,537,5,N,N,-,-1,-1
RECMUS.txt,63700,64547,847,5,N,N,-,-1,-1
RECMUS.txt,64548,65354,806,5,N,N,-,-1,-1
RECMUS.txt,65356,66204,848,5,N,N,-,-1,-1
RECMUS.txt,66205,67100,895,5,N,N,-,-1,-1
RECMUS.txt,67101,67807,706,5,N,Y,1426859941632,67129,67357
RECMUS.txt,67810,68204,394,5,N,N,-,-1,-1
RECMUS.txt,68205,69532,1327,5,N,N,-,-1,-1
RECMUS.txt,69533,70420,887,5,N,N,-,-1,-1
RECMUS.txt,70421,71236,815,5,N,N,-,-1,-1
RECMUS.txt,71237,71988,751,5,N,N,-,-1,-1
RECMUS.txt,71989,72559,570,5,N,Y,1426861072576,72354,72768
RECMUS.txt,72561,72960,399,5,N,Y,1426861072576,72354,72768
RECMUS.txt,72962,73858,896,5,N,N,-,-1,-1
RECMUS.txt,73861,74640,779,5,N,N,-,-1,-1
RECMUS.txt,74641,75040,399,5,N,N,-,-1,-1
RECMUS.txt,75041,75461,420,5,N,Y,1426861595037,75041,75166
RECMUS.txt,75464,76596,1132,5,N,N,-,-1,-1
RECMUS.txt,76597,77415,818,5,N,N,-,-1,-1
RECMUS.txt,77416,77882,466,5,N,N,-,-1,-1
RECMUS.txt,77885,78885,1000,5,N,Y,1426863415047,78494,78880
RECMUS.txt,78886,79445,559,5,N,N,-,-1,-1
RECMUS.txt,79446,80178,732,5,N,N,-,-1,-1
RECMUS.txt,80179,81018,839,5,N,N,-,-1,-1
RECMUS.txt,81019,81743,724,5,N,N,-,-1,-1
RECMUS.txt,81744,82284,540,5,N,N,-,-1,-1
RECMUS.txt,82285,82672,387,5,N,N,-,-1,-1
RECMUS.txt,82673,83185,512,5,N,N,-,-1,-1
RECMUS.txt,83186,83833,647,5,N,N,-,-1,-1
RECMUS.txt,83834,84511,677,5,N,N,-,-1,-1
RECMUS.txt,84512,84916,404,5,N,N,-,-1,-1
RECMUS.txt,84919,85593,674,5,N,N,-,-1,-1
RECMUS.txt,85594,86280,686,5,N,N,-,-1,-1
RECMUS.txt,86281,86948,667,5,N,N,-,-1,-1
RECMUS.txt,86953,87544,591,5,N,N,-,-1,-1
RECMUS.txt,87545,87854,309,5,N,N,-,-1,-1
RECMUS.txt,87856,88222,366,5,N,N,-,-1,-1
RECMUS.txt,88223,88552,329,5,N,N,-,-1,-1
RECMUS.txt,88553,89035,482,5,N,N,-,-1,-1
RECMUS.txt,89036,89726,690,5,N,N,-,-1,-1
RECMUS.txt,89729,90175,446,5,N,N,-,-1,-1
RECMUS.txt,90176,90512,336,5,N,N,-,-1,-1
RECMUS.txt,90513,91184,671,5,N,N,-,-1,-1
RECMUS.txt,91185,92102,917,5,N,N,-,-1,-1
RECMUS.txt,92103,92949,846,5,N,N,-,-1,-1
RECMUS.txt,92950,93906,956,5,N,N,-,-1,-1
RECMUS.txt,93907,94979,1072,5,N,N,-,-1,-1
RECMUS.txt,94980,95894,914,5,N,N,-,-1,-1
RECMUS.txt,95897,96382,485,5,N,N,-,-1,-1
RECMUS.txt,96383,97060,677,5,N,N,-,-1,-1
RECMUS.txt,97061,97742,681,5,N,N,-,-1,-1
RECMUS.txt,97743,98656,913,5,N,N,-,-1,-1
RECMUS.txt,98661,99422,761,5,Y,N,-,-1,-1
RECMUS.txt,99423,100063,640,5,N,N,-,-1,-1
RECMUS.txt,100066,100559,493,5,N,N,-,-1,-1
RECMUS.txt,100562,100852,290,5,N,N,-,-1,-1
RECMUS.txt,100853,101420,567,5,N,N,-,-1,-1
RECMUS.txt,101421,101820,399,5,N,N,-,-1,-1
RECMUS.txt,101821,102059,238,5,N,N,-,-1,-1
RECMUS.txt,102060,102463,403,5,N,N,-,-1,-1
RECMUS.txt,102465,103050,585,5,N,Y,1427479456712,102659,102787
RECMUS.txt,103051,103352,301,5,N,N,-,-1,-1
RECMUS.txt,103353,104168,815,5,N,N,-,-1,-1
RECMUS.txt,104169,104811,642,5,N,N,-,-1,-1
RECMUS.txt,104814,105342,528,5,N,N,-,-1,-1
RECMUS.txt,105343,105930,587,5,N,N,-,-1,-1
RECMUS.txt,105933,107110,1177,5,N,N,-,-1,-1
RECMUS.txt,107111,107761,650,5,N,N,-,-1,-1
RECMUS.txt,107764,108535,771,5,N,N,-,-1,-1
RECMUS.txt,108536,109039,503,5,N,N,-,-1,-1
RECMUS.txt,109042,109806,764,5,N,N,-,-1,-1
RECMUS.txt,109809,110362,553,5,N,N,-,-1,-1
RECMUS.txt,110363,111006,643,5,N,N,-,-1,-1
RECMUS.txt,111012,111693,681,5,N,N,-,-1,-1
RECMUS.txt,111694,112107,413,5,N,N,-,-1,-1
RECMUS.txt,112109,113359,1250,5,N,N,-,-1,-1
RECMUS.txt,113360,114110,750,5,N,N,-,-1,-1
RECMUS.txt,114111,114570,459,5,N,N,-,-1,-1
RECMUS.txt,114573,114927,354,5,N,N,-,-1,-1
RECMUS.txt,114930,115031,101,5,N,N,-,-1,-1
RECMUS.txt,115032,115096,64,5,N,N,-,-1,-1
RECMUS.txt,115099,115149,50,5,N,N,-,-1,-1
RECMUS.txt,115150,115222,72,5,N,N,-,-1,-1
RECMUS.txt,115225,115329,104,5,N,N,-,-1,-1
RECMUS.txt,115332,115416,84,5,N,N,-,-1,-1
RECMUS.txt,115421,115522,101,5,N,N,-,-1,-1
RECMUS.txt,115523,115678,155,5,N,N,-,-1,-1
RECMUS.txt,115679,115776,97,5,N,N,-,-1,-1
RECMUS.txt,115779,115929,150,5,N,N,-,-1,-1
RECMUS.txt,115930,116411,481,5,N,N,-,-1,-1
RECMUS.txt,116412,117019,607,5,N,N,-,-1,-1
RECMUS.txt,117020,117669,649,5,N,N,-,-1,-1
RECMUS.txt,117670,118313,643,5,N,N,-,-1,-1
RECMUS.txt,118314,118968,654,5,N,N,-,-1,-1
RECMUS.txt,118969,119655,686,5,N,N,-,-1,-1
RECMUS.txt,119658,120848,1190,5,N,N,-,-1,-1
RECMUS.txt,120851,121593,742,5,N,N,-,-1,-1
RECMUS.txt,121598,122140,542,5,N,N,-,-1,-1
RECMUS.txt,122143,122877,734,5,N,N,-,-1,-1
RECMUS.txt,122878,123345,467,5,N,N,-,-1,-1
RECMUS.txt,123346,124090,744,5,N,Y,1428494785912,123570,123801
RECMUS.txt,124093,125188,1095,5,N,N,-,-1,-1
RECMUS.txt,125189,126230,1041,5,N,N,-,-1,-1
RECMUS.txt,126231,126821,590,5,N,N,-,-1,-1
RECMUS.txt,126822,127830,1008,5,N,N,-,-1,-1
RECMUS.txt,127831,128412,581,5,N,N,-,-1,-1
RECMUS.txt,128413,128690,277,5,N,N,-,-1,-1
RECMUS.txt,128692,129641,949,5,N,N,-,-1,-1
RECMUS.txt,129642,130314,672,5,N,N,-,-1,-1
RECMUS.txt,130315,131038,723,5,N,N,-,-1,-1
RECMUS.txt,131039,131848,809,5,N,N,-,-1,-1
RECMUS.txt,131849,132555,706,5,N,N,-,-1,-1
RECMUS.txt,132558,133198,640,5,N,N,-,-1,-1
RECMUS.txt,133200,133882,682,5,N,N,-,-1,-1
RECMUS.txt,133883,134510,627,5,N,N,-,-1,-1
RECMUS.txt,134511,135089,578,5,N,N,-,-1,-1
RECMUS.txt,135090,135779,689,5,N,N,-,-1,-1
RECMUS.txt,135779,136151,372,5,N,N,-,-1,-1
RECMUS.txt,136154,136670,516,5,N,N,-,-1,-1
RECMUS.txt,136673,137504,831,5,N,N,-,-1,-1
RECMUS.txt,137509,137780,271,5,N,N,-,-1,-1
RECMUS.txt,137781,138439,658,5,N,N,-,-1,-1
RECMUS.txt,138440,138982,542,5,N,Y,1429002645768,138633,138684
RECMUS.txt,138983,139816,833,5,N,N,-,-1,-1
RECMUS.txt,139821,140553,732,5,N,N,-,-1,-1
RECMUS.txt,140554,140982,428,5,N,N,-,-1,-1
RECMUS.txt,140982,141785,803,5,N,N,-,-1,-1
RECMUS.txt,141786,142688,902,5,Y,N,-,-1,-1
RECMUS.txt,142689,143540,851,5,Y,N,-,-1,-1
RECMUS.txt,143542,144181,639,5,N,N,-,-1,-1
RECMUS.txt,144184,144812,628,5,N,N,-,-1,-1
RECMUS.txt,144813,145166,353,5,N,N,-,-1,-1
RECMUS.txt,145167,146059,892,5,N,N,-,-1,-1
RECMUS.txt,146060,147011,951,5,N,N,-,-1,-1
RECMUS.txt,147012,147928,916,5,N,N,-,-1,-1
RECMUS.txt,147929,148686,757,5,N,N,-,-1,-1
RECMUS.txt,148687,149300,613,5,N,N,-,-1,-1
RECMUS.txt,149303,150085,782,5,N,N,-,-1,-1
RECMUS.txt,150086,150807,721,5,N,N,-,-1,-1
RECMUS.txt,150810,151831,1021,5,N,N,-,-1,-1
RECMUS.txt,151832,152879,1047,5,N,N,-,-1,-1
RECMUS.txt,152880,153521,641,5,N,N,-,-1,-1
RECMUS.txt,153522,154108,586,5,N,N,-,-1,-1
RECMUS.txt,154111,154790,679,5,N,N,-,-1,-1
RECMUS.txt,154792,155412,620,5,N,N,-,-1,-1
RECMUS.txt,155415,156248,833,5,N,N,-,-1,-1
RECMUS.txt,156249,157045,796,5,N,N,-,-1,-1
RECMUS.txt,157046,157598,552,5,N,N,-,-1,-1
RECMUS.txt,157599,158146,547,5,N,N,-,-1,-1
RECMUS.txt,158149,158680,531,5,N,N,-,-1,-1
RECMUS.txt,158681,159297,616,5,N,N,-,-1,-1
RECMUS.txt,159297,159840,543,5,N,Y,1429102663064,159583,159924
RECMUS.txt,159841,160227,386,5,N,Y,1429102663064,159583,159924
RECMUS.txt,160228,160835,607,5,N,N,-,-1,-1
RECMUS.txt,160836,161612,776,5,N,N,-,-1,-1
RECMUS.txt,161613,162648,1035,5,N,N,-,-1,-1
RECMUS.txt,162649,163348,699,5,N,Y,1429103324122,162708,162980
RECMUS.txt,163349,163664,315,5,N,N,-,-1,-1
RECMUS.txt,163665,163848,183,5,N,N,-,-1,-1
RECMUS.txt,163851,164462,611,5,N,N,-,-1,-1
RECMUS.txt,164463,164777,314,5,N,N,-,-1,-1
RECMUS.txt,164778,165041,263,5,N,N,-,-1,-1
RECMUS.txt,165042,165534,492,5,N,N,-,-1,-1
RECMUS.txt,165535,165785,250,5,N,N,-,-1,-1
RECMUS.txt,165785,166210,425,5,N,N,-,-1,-1
RECMUS.txt,166211,166651,440,5,N,N,-,-1,-1
RECMUS.txt,166654,167600,946,5,N,N,-,-1,-1
RECMUS.txt,167603,168240,637,5,N,N,-,-1,-1
RECMUS.txt,168242,169003,761,5,N,N,-,-1,-1
RECMUS.txt,169003,169732,729,5,N,N,-,-1,-1
RECMUS.txt,169733,170389,656,5,N,N,-,-1,-1
RECMUS.txt,170392,170966,574,5,N,N,-,-1,-1
RECMUS.txt,170967,171578,611,5,N,N,-,-1,-1
RECMUS.txt,171579,172115,536,5,N,N,-,-1,-1
RECMUS.txt,172116,172498,382,5,N,N,-,-1,-1
RECMUS.txt,172499,172867,368,5,N,N,-,-1,-1
RECMUS.txt,172868,173466,598,5,N,N,-,-1,-1
RECMUS.txt,173467,174102,635,5,N,N,-,-1,-1
RECMUS.txt,174103,174492,389,5,N,N,-,-1,-1
RECMUS.txt,174493,175260,767,5,N,N,-,-1,-1
RECMUS.txt,175261,175993,732,5,N,N,-,-1,-1
RECMUS.txt,175996,176587,591,5,N,N,-,-1,-1
RECMUS.txt,176588,177098,510,5,N,N,-,-1,-1
RECMUS.txt,177099,177789,690,5,N,N,-,-1,-1
RECMUS.txt,177794,178493,699,5,N,N,-,-1,-1
RECMUS.txt,178494,179321,827,5,N,N,-,-1,-1
RECMUS.txt,179322,180084,762,5,N,N,-,-1,-1
RECMUS.txt,180085,180649,564,5,N,N,-,-1,-1
RECMUS.txt,180650,181233,583,5,N,N,-,-1,-1
RECMUS.txt,181234,182099,865,5,N,N,-,-1,-1
RECMUS.txt,182102,182796,694,5,N,N,-,-1,-1
RECMUS.txt,182797,183116,319,5,N,N,-,-1,-1
RECMUS.txt,183118,183605,487,5,N,N,-,-1,-1
RECMUS.txt,183606,183901,295,5,N,N,-,-1,-1
RECMUS.txt,183902,184448,546,5,N,N,-,-1,-1
RECMUS.txt,184449,184775,326,5,N,N,-,-1,-1
RECMUS.txt,184776,185063,287,5,N,N,-,-1,-1
RECMUS.txt,185064,185454,390,5,N,N,-,-1,-1
RECMUS.txt,185455,185972,517,5,N,N,-,-1,-1
RECMUS.txt,185973,186379,406,5,N,N,-,-1,-1
RECMUS.txt,186380,187065,685,5,N,N,-,-1,-1
RECMUS.txt,187068,187638,570,5,N,N,-,-1,-1
RECMUS.txt,187639,188358,719,5,N,N,-,-1,-1
RECMUS.txt,188359,188765,406,5,N,Y,1429532686038,188361,188583
RECMUS.txt,188766,189181,415,5,N,N,-,-1,-1
RECMUS.txt,189182,189703,521,5,N,N,-,-1,-1
RECMUS.txt,189705,190255,550,5,N,N,-,-1,-1
RECMUS.txt,190256,191203,947,5,N,N,-,-1,-1
RECMUS.txt,191204,192217,1013,5,N,N,-,-1,-1
RECMUS.txt,192220,192997,777,5,N,N,-,-1,-1
RECMUS.txt,192998,193886,888,5,Y,N,-,-1,-1
RECMUS.txt,193889,194479,590,5,N,N,-,-1,-1
RECMUS.txt,194480,195075,595,5,N,N,-,-1,-1
RECMUS.txt,195077,195353,276,5,N,N,-,-1,-1
RECMUS.txt,195356,196136,780,5,N,N,-,-1,-1
RECMUS.txt,196139,197645,1506,5,Y,Y,1429535538810,196482,199062
RECMUS.txt,197646,198393,747,5,N,Y,1429535538810,196482,199062
RECMUS.txt,198395,198736,341,5,N,Y,1429535538810,196482,199062
RECMUS.txt,198737,199182,445,5,N,Y,1429535538810,196482,199062
RECMUS.txt,199183,200097,914,5,N,N,-,-1,-1
RECMUS.txt,200098,200977,879,5,N,N,-,-1,-1
RECMUS.txt,200980,201821,841,5,N,N,-,-1,-1
RECMUS.txt,201822,202565,743,5,N,N,-,-1,-1
RECMUS.txt,202566,202952,386,5,N,N,-,-1,-1
RECMUS.txt,202953,203463,510,5,N,N,-,-1,-1
RECMUS.txt,203466,204000,534,5,N,N,-,-1,-1
RECMUS.txt,204001,204287,286,5,N,N,-,-1,-1
RECMUS.txt,204288,205308,1020,5,N,N,-,-1,-1
RECMUS.txt,205313,205773,460,5,N,N,-,-1,-1
RECMUS.txt,205776,206358,582,5,N,N,-,-1,-1
RECMUS.txt,206359,207012,653,5,N,N,-,-1,-1
RECMUS.txt,207013,207691,678,5,N,N,-,-1,-1
RECMUS.txt,207696,208510,814,5,N,N,-,-1,-1
RECMUS.txt,208512,209417,905,5,N,N,-,-1,-1
RECMUS.txt,209418,210075,657,5,N,N,-,-1,-1
RECMUS.txt,210080,210669,589,5,N,N,-,-1,-1
RECMUS.txt,210670,211226,556,5,N,N,-,-1,-1
RECMUS.txt,211227,211622,395,5,N,N,-,-1,-1
RECMUS.txt,211623,212067,444,5,N,N,-,-1,-1
RECMUS.txt,212070,212575,505,5,N,N,-,-1,-1
RECMUS.txt,212576,213253,677,5,N,N,-,-1,-1
RECMUS.txt,213256,213781,525,5,N,N,-,-1,-1
RECMUS.txt,213782,214381,599,5,N,N,-,-1,-1
RECMUS.txt,214382,215341,959,5,N,N,-,-1,-1
RECMUS.txt,215342,215932,590,5,N,N,-,-1,-1
RECMUS.txt,215937,216862,925,5,N,N,-,-1,-1
RECMUS.txt,216863,217252,389,5,N,N,-,-1,-1
RECMUS.txt,217253,218073,820,5,N,N,-,-1,-1
RECMUS.txt,218074,218860,786,5,N,N,-,-1,-1
RECMUS.txt,218861,219614,753,5,N,N,-,-1,-1
RECMUS.txt,219615,220152,537,5,N,N,-,-1,-1
RECMUS.txt,220157,221327,1170,5,N,N,-,-1,-1
RECMUS.txt,221328,222178,850,5,N,N,-,-1,-1
RECMUS.txt,222179,222718,539,5,N,N,-,-1,-1
RECMUS.txt,222719,223238,519,5,N,N,-,-1,-1
RECMUS.txt,223239,223800,561,5,N,N,-,-1,-1
RECMUS.txt,223801,224431,630,5,N,N,-,-1,-1
RECMUS.txt,224432,224959,527,5,N,N,-,-1,-1
RECMUS.txt,224964,225303,339,5,N,N,-,-1,-1
RECMUS.txt,225304,226143,839,5,N,N,-,-1,-1
RECMUS.txt,226144,226517,373,5,N,N,-,-1,-1
RECMUS.txt,226518,226984,466,5,N,N,-,-1,-1
RECMUS.txt,226985,227430,445,5,N,N,-,-1,-1
RECMUS.txt,227431,227992,561,5,N,N,-,-1,-1
RECMUS.txt,227993,228648,655,5,N,N,-,-1,-1
RECMUS.txt,228649,229287,638,5,N,N,-,-1,-1
RECMUS.txt,229288,230337,1049,5,N,N,-,-1,-1
RECMUS.txt,230338,231279,941,5,N,N,-,-1,-1
RECMUS.txt,231282,232153,871,5,N,N,-,-1,-1
RECMUS.txt,232154,232737,583,5,N,N,-,-1,-1
RECMUS.txt,232738,233003,265,5,N,N,-,-1,-1
RECMUS.txt,233004,233604,600,5,N,N,-,-1,-1
RECMUS.txt,233606,234490,884,5,N,N,-,-1,-1
RECMUS.txt,234491,235449,958,5,N,N,-,-1,-1
RECMUS.txt,235452,235933,481,5,N,N,-,-1,-1
RECMUS.txt,235934,236482,548,5,N,N,-,-1,-1
RECMUS.txt,236483,237305,822,5,N,N,-,-1,-1
RECMUS.txt,237306,237931,625,5,N,N,-,-1,-1
RECMUS.txt,237932,238372,440,5,N,N,-,-1,-1
RECMUS.txt,238373,238607,234,5,N,N,-,-1,-1
RECMUS.txt,238608,239107,499,5,N,N,-,-1,-1
RECMUS.txt,239108,239852,744,5,N,N,-,-1,-1
RECMUS.txt,239855,240189,334,5,N,N,-,-1,-1
RECMUS.txt,240192,240819,627,5,N,N,-,-1,-1
RECMUS.txt,240820,241434,614,5,N,N,-,-1,-1
RECMUS.txt,241435,242010,575,5,N,N,-,-1,-1
RECMUS.txt,242011,242588,577,5,N,N,-,-1,-1
RECMUS.txt,242593,243182,589,5,N,N,-,-1,-1
RECMUS.txt,243183,244051,868,5,N,N,-,-1,-1
RECMUS.txt,244052,244409,357,5,N,N,-,-1,-1
RECMUS.txt,244412,245088,676,5,N,N,-,-1,-1
RECMUS.txt,245089,246004,915,5,N,N,-,-1,-1
RECMUS.txt,246005,246565,560,5,N,N,-,-1,-1
RECMUS.txt,246570,247362,792,5,N,N,-,-1,-1
RECMUS.txt,247363,248113,750,5,N,N,-,-1,-1
RECMUS.txt,248114,248546,432,5,N,N,-,-1,-1
RECMUS.txt,248547,249294,747,5,N,N,-,-1,-1
RECMUS.txt,249295,250332,1037,5,N,N,-,-1,-1
RECMUS.txt,250333,250879,546,5,N,N,-,-1,-1
RECMUS.txt,250880,251465,585,5,N,N,-,-1,-1
RECMUS.txt,251466,252067,601,5,N,N,-,-1,-1
RECMUS.txt,252068,252443,375,5,N,N,-,-1,-1
RECMUS.txt,252444,252695,251,5,N,N,-,-1,-1
RECMUS.txt,252696,253043,347,5,N,N,-,-1,-1
RECMUS.txt,253044,253948,904,5,N,N,-,-1,-1
RECMUS.txt,253949,254503,554,5,N,N,-,-1,-1
RECMUS.txt,254504,254949,445,5,N,N,-,-1,-1
RECMUS.txt,254950,255425,475,5,N,N,-,-1,-1
RECMUS.txt,255430,256030,600,5,N,N,-,-1,-1
RECMUS.txt,256033,256207,174,5,N,N,-,-1,-1
RECMUS.txt,256210,256886,676,5,N,N,-,-1,-1
RECMUS.txt,256889,257442,553,5,N,N,-,-1,-1
RECMUS.txt,257445,258139,694,5,N,N,-,-1,-1
RECMUS.txt,258140,258454,314,5,N,N,-,-1,-1
RECMUS.txt,258457,259167,710,5,N,N,-,-1,-1
RECMUS.txt,259170,259598,428,5,N,N,-,-1,-1
RECMUS.txt,259601,260078,477,5,N,N,-,-1,-1
RECMUS.txt,260078,260309,231,5,N,N,-,-1,-1
RECMUS.txt,260311,261000,689,5,N,N,-,-1,-1
RECMUS.txt,261001,261830,829,5,N,N,-,-1,-1
RECMUS.txt,261831,262293,462,5,N,N,-,-1,-1
RECMUS.txt,262294,262774,480,5,N,N,-,-1,-1
RECMUS.txt,262777,263160,383,5,N,Y,1429610699650,262775,263040
RECMUS.txt,263161,264462,1301,5,N,N,-,-1,-1
RECMUS.txt,264463,264879,416,5,N,N,-,-1,-1
RECMUS.txt,264880,265631,751,5,N,N,-,-1,-1
RECMUS.txt,265632,266288,656,5,N,N,-,-1,-1
RECMUS.txt,266289,266543,254,5,N,N,-,-1,-1
RECMUS.txt,266544,267593,1049,5,N,N,-,-1,-1
RECMUS.txt,267594,269120,1526,5,N,N,-,-1,-1
RECMUS.txt,269121,270031,910,5,N,N,-,-1,-1
RECMUS.txt,270032,270700,668,5,N,N,-,-1,-1
RECMUS.txt,270701,271060,359,5,N,N,-,-1,-1
RECMUS.txt,271061,271746,685,5,N,N,-,-1,-1
RECMUS.txt,271747,272741,994,5,N,N,-,-1,-1
RECMUS.txt,272742,273174,432,5,N,N,-,-1,-1
RECMUS.txt,273175,273484,309,5,N,N,-,-1,-1
RECMUS.txt,273485,273817,332,5,N,N,-,-1,-1
RECMUS.txt,273820,274553,733,5,N,N,-,-1,-1
RECMUS.txt,274554,275480,926,5,N,N,-,-1,-1
RECMUS.txt,275481,276171,690,5,N,N,-,-1,-1
RECMUS.txt,276172,276613,441,5,N,N,-,-1,-1
RECMUS.txt,276614,277576,962,5,N,N,-,-1,-1
RECMUS.txt,277577,278030,453,5,N,N,-,-1,-1
RECMUS.txt,278031,278410,379,5,N,N,-,-1,-1
RECMUS.txt,278411,278839,428,5,N,N,-,-1,-1
RECMUS.txt,278840,279272,432,5,N,N,-,-1,-1
RECMUS.txt,279274,279851,577,5,N,N,-,-1,-1
RECMUS.txt,279852,280234,382,5,N,N,-,-1,-1
RECMUS.txt,280235,281175,940,5,N,N,-,-1,-1
RECMUS.txt,281176,282112,936,5,N,N,-,-1,-1
RECMUS.txt,282114,283677,1563,5,N,N,-,-1,-1
RECMUS.txt,283678,284801,1123,5,N,N,-,-1,-1
RECMUS.txt,284802,285522,720,5,N,N,-,-1,-1
RECMUS.txt,285523,286437,914,5,N,N,-,-1,-1
RECMUS.txt,286438,287258,820,5,N,N,-,-1,-1
RECMUS.txt,287259,287883,624,5,N,N,-,-1,-1
RECMUS.txt,287884,288543,659,5,N,N,-,-1,-1
RECMUS.txt,288544,289231,687,5,N,N,-,-1,-1
RECMUS.txt,289231,290221,990,5,N,N,-,-1,-1
RECMUS.txt,290224,291336,1112,5,N,N,-,-1,-1
RECMUS.txt,291339,291938,599,5,N,N,-,-1,-1
RECMUS.txt,291939,293141,1202,5,N,N,-,-1,-1
RECMUS.txt,293142,293681,539,5,N,N,-,-1,-1
RECMUS.txt,293683,294514,831,5,N,N,-,-1,-1
RECMUS.txt,294515,295229,714,5,N,N,-,-1,-1
RECMUS.txt,295230,295679,449,5,N,N,-,-1,-1
RECMUS.txt,295682,296188,506,5,N,N,-,-1,-1
RECMUS.txt,296188,297097,909,5,N,N,-,-1,-1
RECMUS.txt,297098,297810,712,5,N,N,-,-1,-1
RECMUS.txt,297811,298735,924,5,N,N,-,-1,-1
RECMUS.txt,298736,299634,898,5,N,N,-,-1,-1
RECMUS.txt,299636,300115,479,5,N,N,-,-1,-1
RECMUS.txt,300118,300415,297,5,N,N,-,-1,-1
RECMUS.txt,300420,300932,512,5,N,N,-,-1,-1
RECMUS.txt,300934,301212,278,5,N,N,-,-1,-1
RECMUS.txt,301215,301391,176,5,N,N,-,-1,-1
RECMUS.txt,301392,302176,784,5,N,N,-,-1,-1
RECMUS.txt,302177,302805,628,5,N,N,-,-1,-1
RECMUS.txt,302806,303396,590,5,N,N,-,-1,-1
RECMUS.txt,303399,304128,729,5,N,N,-,-1,-1
RECMUS.txt,304129,304636,507,5,N,N,-,-1,-1
RECMUS.txt,304639,305262,623,5,N,N,-,-1,-1
RECMUS.txt,305263,305870,607,5,N,N,-,-1,-1
RECMUS.txt,305871,306622,751,5,N,N,-,-1,-1
RECMUS.txt,306622,307689,1067,5,N,N,-,-1,-1
RECMUS.txt,307690,308299,609,5,N,N,-,-1,-1
RECMUS.txt,308300,309466,1166,5,N,N,-,-1,-1
RECMUS.txt,309467,310568,1101,5,N,N,-,-1,-1
RECMUS.txt,310568,311252,684,5,N,N,-,-1,-1
RECMUS.txt,311253,312286,1033,5,N,N,-,-1,-1
RECMUS.txt,312287,312848,561,5,N,N,-,-1,-1
RECMUS.txt,312849,313673,824,5,N,N,-,-1,-1
RECMUS.txt,313674,314592,918,5,N,N,-,-1,-1
RECMUS.txt,314593,315231,638,5,N,N,-,-1,-1
RECMUS.txt,315234,316159,925,5,N,N,-,-1,-1
RECMUS.txt,316161,316401,240,5,N,N,-,-1,-1
RECMUS.txt,316403,316654,251,5,N,N,-,-1,-1
RECMUS.txt,316659,317120,461,5,N,N,-,-1,-1
RECMUS.txt,317123,317672,549,5,N,Y,1429618477739,317165,317427
RECMUS.txt,317673,318147,474,5,N,N,-,-1,-1
RECMUS.txt,318148,318578,430,5,N,N,-,-1,-1
RECMUS.txt,318579,319359,780,5,N,N,-,-1,-1
RECMUS.txt,319361,320159,798,5,N,N,-,-1,-1
RECMUS.txt,320161,320757,596,5,N,N,-,-1,-1
RECMUS.txt,320757,321318,561,5,N,N,-,-1,-1
RECMUS.txt,321319,322036,717,5,N,N,-,-1,-1
RECMUS.txt,322037,322478,441,5,N,N,-,-1,-1
RECMUS.txt,322479,323554,1075,5,N,N,-,-1,-1
RECMUS.txt,323555,324153,598,5,N,N,-,-1,-1
RECMUS.txt,324154,325061,907,5,N,N,-,-1,-1
RECMUS.txt,325062,325586,524,5,N,N,-,-1,-1
RECMUS.txt,325587,326324,737,5,N,Y,1429619541244,325924,326642
RECMUS.txt,326329,326719,390,5,N,Y,1429619541244,325924,326642
RECMUS.txt,326720,327173,453,5,N,Y,1429620133235,326889,327207
RECMUS.txt,327174,327827,653,5,N,Y,1429620133235,326889,327207
RECMUS.txt,327828,328562,734,5,N,N,-,-1,-1
RECMUS.txt,328567,328833,266,5,N,N,-,-1,-1
RECMUS.txt,328834,329239,405,5,N,N,-,-1,-1
RECMUS.txt,329240,330372,1132,5,N,N,-,-1,-1
RECMUS.txt,330373,330892,519,5,N,N,-,-1,-1
RECMUS.txt,330893,331501,608,5,N,N,-,-1,-1
RECMUS.txt,331502,332195,693,5,N,N,-,-1,-1
RECMUS.txt,332196,332910,714,5,N,N,-,-1,-1
RECMUS.txt,332913,333891,978,5,N,N,-,-1,-1
RECMUS.txt,333894,334458,564,5,N,N,-,-1,-1
RECMUS.txt,334461,335079,618,5,N,N,-,-1,-1
RECMUS.txt,335080,335760,680,5,N,N,-,-1,-1
RECMUS.txt,335763,336669,906,5,N,N,-,-1,-1
RECMUS.txt,336670,337639,969,5,N,N,-,-1,-1
RECMUS.txt,337642,338438,796,5,N,N,-,-1,-1
RECMUS.txt,338441,339097,656,5,N,N,-,-1,-1
RECMUS.txt,339098,339227,129,5,N,N,-,-1,-1
RECMUS.txt,339228,339620,392,5,N,N,-,-1,-1
RECMUS.txt,339625,340067,442,5,N,N,-,-1,-1
RECMUS.txt,340068,341199,1131,5,N,N,-,-1,-1
RECMUS.txt,341202,342115,913,5,N,Y,1429621761088,341740,341892
RECMUS.txt,342116,342692,576,5,N,N,-,-1,-1
RECMUS.txt,342693,343814,1121,5,N,N,-,-1,-1
RECMUS.txt,343817,344649,832,5,N,N,-,-1,-1
RECMUS.txt,344650,345667,1017,5,N,N,-,-1,-1
RECMUS.txt,345668,346247,579,5,N,N,-,-1,-1
RECMUS.txt,346248,346795,547,5,N,N,-,-1,-1
RECMUS.txt,346798,347487,689,5,N,N,-,-1,-1
RECMUS.txt,347488,349073,1585,5,N,N,-,-1,-1
RECMUS.txt,349073,349748,675,5,N,N,-,-1,-1
RECMUS.txt,349749,350573,824,5,N,N,-,-1,-1
RECMUS.txt,350574,351245,671,5,N,N,-,-1,-1
RECMUS.txt,351246,351707,461,5,N,N,-,-1,-1
RECMUS.txt,351708,352400,692,5,N,N,-,-1,-1
RECMUS.txt,352401,353283,882,5,N,N,-,-1,-1
RECMUS.txt,353284,353684,400,5,N,N,-,-1,-1
RECMUS.txt,353685,354241,556,5,N,N,-,-1,-1
RECMUS.txt,354242,354890,648,5,N,N,-,-1,-1
RECMUS.txt,354891,355522,631,5,N,N,-,-1,-1
RECMUS.txt,355523,356186,663,5,N,N,-,-1,-1
RECMUS.txt,356189,356917,728,5,N,N,-,-1,-1
RECMUS.txt,356918,357367,449,5,N,N,-,-1,-1
RECMUS.txt,357368,358045,677,5,N,N,-,-1,-1
RECMUS.txt,358047,358391,344,5,N,N,-,-1,-1
RECMUS.txt,358392,358891,499,5,N,N,-,-1,-1
RECMUS.txt,358892,359841,949,5,N,N,-,-1,-1
RECMUS.txt,359843,360678,835,5,N,N,-,-1,-1
RECMUS.txt,360679,361557,878,5,N,N,-,-1,-1
RECMUS.txt,361558,362066,508,5,N,N,-,-1,-1
RECMUS.txt,362068,362527,459,5,N,N,-,-1,-1
RECMUS.txt,362528,363081,553,5,N,N,-,-1,-1
RECMUS.txt,363084,363722,638,5,N,N,-,-1,-1
RECMUS.txt,363723,364233,510,5,N,N,-,-1,-1
RECMUS.txt,364234,364835,601,5,N,N,-,-1,-1
RECMUS.txt,364835,365262,427,5,N,N,-,-1,-1
RECMUS.txt,365263,365796,533,5,N,N,-,-1,-1
RECMUS.txt,365797,366107,310,5,N,N,-,-1,-1
RECMUS.txt,366110,366949,839,5,N,N,-,-1,-1
RECMUS.txt,366950,367809,859,5,N,N,-,-1,-1
RECMUS.txt,367810,368614,804,5,N,N,-,-1,-1
RECMUS.txt,368615,369716,1101,5,Y,N,-,-1,-1
RECMUS.txt,369718,370879,1161,5,N,N,-,-1,-1
RECMUS.txt,370880,371153,273,5,N,N,-,-1,-1
RECMUS.txt,371154,372466,1312,5,N,N,-,-1,-1
RECMUS.txt,372467,372970,503,5,N,N,-,-1,-1
RECMUS.txt,372973,373614,641,5,N,N,-,-1,-1
RECMUS.txt,373616,374623,1007,5,N,N,-,-1,-1
RECMUS.txt,374624,375313,689,5,N,N,-,-1,-1
RECMUS.txt,375314,375823,509,5,N,N,-,-1,-1
RECMUS.txt,375824,377066,1242,5,N,N,-,-1,-1
RECMUS.txt,377068,377845,777,5,N,N,-,-1,-1
RECMUS.txt,377846,378842,996,5,N,N,-,-1,-1
RECMUS.txt,378843,379760,917,5,N,N,-,-1,-1
RECMUS.txt,379765,380466,701,5,N,N,-,-1,-1
RECMUS.txt,380469,381126,657,5,N,N,-,-1,-1
RECMUS.txt,381129,382475,1346,5,N,N,-,-1,-1
RECMUS.txt,382476,383315,839,5,N,N,-,-1,-1
RECMUS.txt,383318,384503,1185,5,N,N,-,-1,-1
RECMUS.txt,384504,384898,394,5,N,N,-,-1,-1
RECMUS.txt,384899,385371,472,5,N,N,-,-1,-1
RECMUS.txt,385372,386607,1235,5,N,Y,1429703438525,385609,386315
RECMUS.txt,386608,387152,544,5,N,N,-,-1,-1
RECMUS.txt,387154,387543,389,5,N,N,-,-1,-1
RECMUS.txt,387544,387945,401,5,N,Y,1429703659582,387900,389542
RECMUS.txt,387946,389262,1316,5,N,Y,1429703659582,387900,389542
RECMUS.txt,389263,389993,730,5,N,Y,1429703659582,387900,389542
RECMUS.txt,389994,390598,604,5,N,N,-,-1,-1
RECMUS.txt,390600,390920,320,5,N,N,-,-1,-1
RECMUS.txt,390921,391827,906,5,N,N,-,-1,-1
RECMUS.txt,391828,392716,888,5,N,N,-,-1,-1
RECMUS.txt,392719,393202,483,5,N,N,-,-1,-1
RECMUS.txt,393203,393572,369,5,N,N,-,-1,-1
RECMUS.txt,393573,394023,450,5,N,N,-,-1,-1
RECMUS.txt,394024,394639,615,5,N,N,-,-1,-1
RECMUS.txt,394640,395319,679,5,N,N,-,-1,-1
RECMUS.txt,395322,396650,1328,5,N,N,-,-1,-1
RECMUS.txt,396651,397058,407,5,N,N,-,-1,-1
RECMUS.txt,397059,398301,1242,5,N,N,-,-1,-1
RECMUS.txt,398302,398940,638,5,N,N,-,-1,-1
RECMUS.txt,398941,399535,594,5,N,N,-,-1,-1
RECMUS.txt,399536,400416,880,5,N,N,-,-1,-1
RECMUS.txt,400419,401214,795,5,N,N,-,-1,-1
RECMUS.txt,401215,401934,719,5,N,N,-,-1,-1
RECMUS.txt,401935,402953,1018,5,N,N,-,-1,-1
RECMUS.txt,402956,403959,1003,5,N,N,-,-1,-1
RECMUS.txt,403962,404779,817,5,N,N,-,-1,-1
RECMUS.txt,404780,405199,419,5,N,N,-,-1,-1
RECMUS.txt,405202,405912,710,5,N,Y,1429958746761,405220,405568
RECMUS.txt,405913,406433,520,5,N,N,-,-1,-1
RECMUS.txt,406434,406899,465,5,N,N,-,-1,-1
RECMUS.txt,406902,407746,844,5,N,N,-,-1,-1
RECMUS.txt,407747,408054,307,5,N,N,-,-1,-1
RECMUS.txt,408055,408474,419,5,N,N,-,-1,-1
RECMUS.txt,408477,409273,796,5,N,N,-,-1,-1
RECMUS.txt,409274,409675,401,5,N,N,-,-1,-1
RECMUS.txt,409675,410075,400,5,N,Y,1430061110446,409752,410058
RECMUS.txt,410076,410379,303,5,N,N,-,-1,-1
RECMUS.txt,410380,410735,355,5,N,Y,1430062095918,410386,410666
RECMUS.txt,410736,411511,775,5,N,N,-,-1,-1
RECMUS.txt,411512,412019,507,5,N,N,-,-1,-1
RECMUS.txt,412020,412786,766,5,N,N,-,-1,-1
RECMUS.txt,412788,413126,338,5,N,N,-,-1,-1
RECMUS.txt,413127,413670,543,5,N,N,-,-1,-1
RECMUS.txt,413671,414537,866,5,N,N,-,-1,-1
RECMUS.txt,414538,415609,1071,5,N,N,-,-1,-1
RECMUS.txt,415614,415967,353,5,N,N,-,-1,-1
RECMUS.txt,415968,416644,676,5,N,N,-,-1,-1
RECMUS.txt,416645,417304,659,5,N,N,-,-1,-1
RECMUS.txt,417305,418365,1060,5,N,N,-,-1,-1
RECMUS.txt,418366,419028,662,5,N,N,-,-1,-1
RECMUS.txt,419029,419356,327,5,N,N,-,-1,-1
RECMUS.txt,419357,419968,611,5,N,N,-,-1,-1
RECMUS.txt,419969,420656,687,5,N,N,-,-1,-1
RECMUS.txt,420657,421448,791,5,N,N,-,-1,-1
RECMUS.txt,421449,422089,640,5,N,N,-,-1,-1
RECMUS.txt,422090,422648,558,5,N,N,-,-1,-1
RECMUS.txt,422649,423473,824,5,N,Y,1430132370365,422842,422953
RECMUS.txt,423474,424376,902,5,N,N,-,-1,-1
RECMUS.txt,424377,424914,537,5,N,N,-,-1,-1
RECMUS.txt,424916,425608,692,5,N,N,-,-1,-1
RECMUS.txt,425609,426368,759,5,N,N,-,-1,-1
RECMUS.txt,426369,427079,710,5,N,N,-,-1,-1
RECMUS.txt,427082,427384,302,5,N,N,-,-1,-1
RECMUS.txt,427385,428447,1062,5,N,N,-,-1,-1
RECMUS.txt,428448,429145,697,5,N,N,-,-1,-1
RECMUS.txt,429146,429508,362,5,N,N,-,-1,-1
RECMUS.txt,429510,430085,575,5,N,N,-,-1,-1
RECMUS.txt,430086,430740,654,5,N,N,-,-1,-1
RECMUS.txt,430741,431387,646,5,N,N,-,-1,-1
RECMUS.txt,431388,432157,769,5,N,N,-,-1,-1
RECMUS.txt,432158,433156,998,5,N,N,-,-1,-1
RECMUS.txt,433159,433754,595,5,N,N,-,-1,-1
RECMUS.txt,433755,435060,1305,5,Y,N,-,-1,-1
RECMUS.txt,435063,435931,868,5,N,N,-,-1,-1
RECMUS.txt,435933,436751,818,5,N,N,-,-1,-1
RECMUS.txt,436752,437534,782,5,N,N,-,-1,-1
RECMUS.txt,437539,438247,708,5,N,N,-,-1,-1
RECMUS.txt,438248,438877,629,5,N,N,-,-1,-1
RECMUS.txt,438880,439198,318,5,N,N,-,-1,-1
RECMUS.txt,439199,439610,411,5,N,N,-,-1,-1
RECMUS.txt,439611,440025,414,5,N,N,-,-1,-1
RECMUS.txt,440026,440455,429,5,N,N,-,-1,-1
RECMUS.txt,440456,441156,700,5,N,N,-,-1,-1
RECMUS.txt,441157,441888,731,5,N,N,-,-1,-1
RECMUS.txt,441889,442738,849,5,N,N,-,-1,-1
RECMUS.txt,442739,443527,788,5,Y,N,-,-1,-1
RECMUS.txt,443529,444413,884,5,N,N,-,-1,-1
RECMUS.txt,444414,444863,449,5,N,Y,1430143421055,444786,444985
RECMUS.txt,444864,445828,964,5,N,Y,1430143421055,444786,444985
RECMUS.txt,445829,446899,1070,5,N,N,-,-1,-1
RECMUS.txt,446904,447834,930,5,N,N,-,-1,-1
RECMUS.txt,447835,448608,773,5,N,N,-,-1,-1
RECMUS.txt,448611,449291,680,5,N,N,-,-1,-1
RECMUS.txt,449292,450076,784,5,N,N,-,-1,-1
RECMUS.txt,450079,450676,597,5,N,N,-,-1,-1
RECMUS.txt,450677,451219,542,5,N,N,-,-1,-1
RECMUS.txt,451220,452451,1231,5,N,N,-,-1,-1
RECMUS.txt,452454,453017,563,5,N,N,-,-1,-1
RECMUS.txt,453018,453595,577,5,N,N,-,-1,-1
RECMUS.txt,453600,454273,673,5,N,N,-,-1,-1
RECMUS.txt,454276,455198,922,5,N,N,-,-1,-1
RECMUS.txt,455201,455948,747,5,N,N,-,-1,-1
RECMUS.txt,455949,456607,658,5,N,N,-,-1,-1
RECMUS.txt,456608,457046,438,5,N,N,-,-1,-1
RECMUS.txt,457047,457792,745,5,N,N,-,-1,-1
RECMUS.txt,457795,458494,699,5,N,N,-,-1,-1
RECMUS.txt,458495,459512,1017,5,N,N,-,-1,-1
RECMUS.txt,459513,460416,903,5,Y,N,-,-1,-1
RECMUS.txt,460417,461094,677,5,N,N,-,-1,-1
RECMUS.txt,461098,461235,137,5,N,N,-,-1,-1
RECMUS.txt,461236,461294,58,5,N,N,-,-1,-1
RECMUS.txt,461295,461386,91,5,N,N,-,-1,-1
RECMUS.txt,461386,461556,170,5,N,N,-,-1,-1
RECMUS.txt,461557,461656,99,5,N,N,-,-1,-1
RECMUS.txt,461657,461712,55,5,N,N,-,-1,-1
RECMUS.txt,461713,461818,105,5,N,N,-,-1,-1
RECMUS.txt,461818,462351,533,5,N,N,-,-1,-1
RECMUS.txt,462352,463299,947,5,Y,N,-,-1,-1
RECMUS.txt,463300,463820,520,5,N,N,-,-1,-1
RECMUS.txt,463821,464502,681,5,N,N,-,-1,-1
RECMUS.txt,464503,465513,1010,5,N,Y,1430146867800,465338,465502
RECMUS.txt,465514,466671,1157,5,N,N,-,-1,-1
RECMUS.txt,466672,466975,303,5,N,N,-,-1,-1
RECMUS.txt,466976,468046,1070,5,N,N,-,-1,-1
RECMUS.txt,468046,468931,885,5,N,N,-,-1,-1
RECMUS.txt,468932,469459,527,5,N,N,-,-1,-1
RECMUS.txt,469460,470181,721,5,N,N,-,-1,-1
RECMUS.txt,470182,471285,1103,5,Y,N,-,-1,-1
RECMUS.txt,471286,471966,680,5,N,N,-,-1,-1
RECMUS.txt,471967,472555,588,5,N,N,-,-1,-1
RECMUS.txt,472556,473047,491,5,N,N,-,-1,-1
RECMUS.txt,473048,473321,273,5,N,N,-,-1,-1
RECMUS.txt,473322,473942,620,5,N,N,-,-1,-1
RECMUS.txt,473943,474546,603,5,N,N,-,-1,-1
RECMUS.txt,474547,475346,799,5,N,N,-,-1,-1
RECMUS.txt,475347,476137,790,5,N,N,-,-1,-1
RECMUS.txt,476138,477172,1034,5,N,N,-,-1,-1
RECMUS.txt,477175,477865,690,5,N,N,-,-1,-1
RECMUS.txt,477866,478417,551,5,N,N,-,-1,-1
RECMUS.txt,478418,478806,388,5,N,N,-,-1,-1
RECMUS.txt,478807,479436,629,5,N,N,-,-1,-1
RECMUS.txt,479437,479897,460,5,N,N,-,-1,-1
RECMUS.txt,479898,480176,278,5,N,N,-,-1,-1
RECMUS.txt,480177,480663,486,5,N,N,-,-1,-1
RECMUS.txt,480664,481372,708,5,N,N,-,-1,-1
RECMUS.txt,481373,482188,815,5,N,N,-,-1,-1
RECMUS.txt,482189,482731,542,5,N,N,-,-1,-1
RECMUS.txt,482732,483288,556,5,N,N,-,-1,-1
RECMUS.txt,483289,483803,514,5,N,N,-,-1,-1
RECMUS.txt,483804,484372,568,5,N,N,-,-1,-1
RECMUS.txt,484373,485321,948,5,N,N,-,-1,-1
RECMUS.txt,485322,485659,337,5,N,N,-,-1,-1
RECMUS.txt,485660,486165,505,5,N,N,-,-1,-1
RECMUS.txt,486167,486450,283,5,N,N,-,-1,-1
RECMUS.txt,486451,486994,543,5,N,N,-,-1,-1
RECMUS.txt,486995,487463,468,5,N,N,-,-1,-1
RECMUS.txt,487464,488042,578,5,N,N,-,-1,-1
RECMUS.txt,488045,488290,245,5,N,N,-,-1,-1
RECMUS.txt,488291,488799,508,5,N,N,-,-1,-1
RECMUS.txt,488800,489010,210,5,N,N,-,-1,-1
RECMUS.txt,489011,489340,329,5,N,N,-,-1,-1
RECMUS.txt,489341,490022,681,5,N,N,-,-1,-1
RECMUS.txt,490024,490462,438,5,N,N,-,-1,-1
RECMUS.txt,490463,490717,254,5,N,N,-,-1,-1
RECMUS.txt,490718,491163,445,5,N,N,-,-1,-1
RECMUS.txt,491166,491472,306,5,N,N,-,-1,-1
RECMUS.txt,491473,492055,582,5,N,N,-,-1,-1
RECMUS.txt,492056,492677,621,5,N,N,-,-1,-1
RECMUS.txt,492678,493635,957,5,N,N,-,-1,-1
RECMUS.txt,493637,494312,675,5,N,N,-,-1,-1
RECMUS.txt,494313,495033,720,5,N,N,-,-1,-1
RECMUS.txt,495034,495867,833,5,N,N,-,-1,-1
RECMUS.txt,495868,497072,1204,5,N,N,-,-1,-1
RECMUS.txt,497073,497733,660,5,N,N,-,-1,-1
RECMUS.txt,497734,498289,555,5,N,N,-,-1,-1
RECMUS.txt,498292,498937,645,5,N,N,-,-1,-1
RECMUS.txt,498938,499385,447,5,N,N,-,-1,-1
RECMUS.txt,499386,500032,646,5,N,N,-,-1,-1
RECMUS.txt,500035,500705,670,5,N,N,-,-1,-1
RECMUS.txt,500708,501493,785,5,N,N,-,-1,-1
RECMUS.txt,501494,502321,827,5,N,N,-,-1,-1
RECMUS.txt,502322,503107,785,5,N,N,-,-1,-1
RECMUS.txt,503108,503990,882,5,N,N,-,-1,-1
RECMUS.txt,503990,504797,807,5,N,N,-,-1,-1
RECMUS.txt,504798,505370,572,5,N,N,-,-1,-1
RECMUS.txt,505371,505950,579,5,N,N,-,-1,-1
RECMUS.txt,505952,506774,822,5,N,Y,1430222777118,506387,506555
RECMUS.txt,506775,507291,516,5,N,N,-,-1,-1
RECMUS.txt,507292,507834,542,5,N,N,-,-1,-1
RECMUS.txt,507835,508911,1076,5,N,N,-,-1,-1
RECMUS.txt,508914,509306,392,5,N,N,-,-1,-1
RECMUS.txt,509307,510263,956,5,N,N,-,-1,-1
RECMUS.txt,510264,511132,868,5,N,N,-,-1,-1
RECMUS.txt,511133,512262,1129,5,N,N,-,-1,-1
RECMUS.txt,512263,513044,781,5,N,N,-,-1,-1
RECMUS.txt,513045,513911,866,5,N,N,-,-1,-1
RECMUS.txt,513912,514731,819,5,N,N,-,-1,-1
RECMUS.txt,514732,515263,531,5,N,N,-,-1,-1
RECMUS.txt,515264,515876,612,5,N,N,-,-1,-1
RECMUS.txt,515876,516531,655,5,N,N,-,-1,-1
RECMUS.txt,516532,517529,997,5,N,Y,1430310307659,517170,517520
RECMUS.txt,517530,518061,531,5,N,N,-,-1,-1
RECMUS.txt,518062,518494,432,5,N,N,-,-1,-1
RECMUS.txt,518495,519425,930,5,N,N,-,-1,-1
RECMUS.txt,519426,520209,783,5,N,N,-,-1,-1
RECMUS.txt,520210,521209,999,5,N,Y,1430312272173,520626,520894
RECMUS.txt,521214,522167,953,5,N,N,-,-1,-1
RECMUS.txt,522168,523079,911,5,N,N,-,-1,-1
RECMUS.txt,523080,524004,924,5,N,N,-,-1,-1
RECMUS.txt,524007,524676,669,5,N,N,-,-1,-1
RECMUS.txt,524677,525643,966,5,N,N,-,-1,-1
RECMUS.txt,525644,526346,702,5,N,N,-,-1,-1
RECMUS.txt,526349,527071,722,5,N,N,-,-1,-1
RECMUS.txt,527072,527962,890,5,N,N,-,-1,-1
RECMUS.txt,527963,528610,647,5,N,N,-,-1,-1
RECMUS.txt,528611,529595,984,5,N,N,-,-1,-1
RECMUS.txt,529596,530763,1167,5,N,N,-,-1,-1
RECMUS.txt,530764,531219,455,5,N,N,-,-1,-1
RECMUS.txt,531222,532165,943,5,N,N,-,-1,-1
RECMUS.txt,532166,533057,891,5,N,N,-,-1,-1
RECMUS.txt,533058,534379,1321,5,Y,N,-,-1,-1
RECMUS.txt,534380,535588,1208,5,N,Y,1430813590521,534892,535075
RECMUS.txt,535589,536434,845,5,N,N,-,-1,-1
RECMUS.txt,536435,537585,1150,5,Y,N,-,-1,-1
RECMUS.txt,537588,538210,622,5,N,N,-,-1,-1
RECMUS.txt,538213,539162,949,5,N,N,-,-1,-1
RECMUS.txt,539163,539851,688,5,N,N,-,-1,-1
RECMUS.txt,539852,540703,851,5,N,N,-,-1,-1
RECMUS.txt,540704,541273,569,5,N,N,-,-1,-1
RECMUS.txt,541274,541932,658,5,N,Y,1430814562699,541292,541683
RECMUS.txt,541933,543209,1276,5,N,N,-,-1,-1
RECMUS.txt,543210,543859,649,5,N,N,-,-1,-1
RECMUS.txt,543860,544533,673,5,N,N,-,-1,-1
RECMUS.txt,544534,544870,336,5,N,N,-,-1,-1
RECMUS.txt,544871,545171,300,5,N,N,-,-1,-1
RECMUS.txt,545174,545888,714,5,N,N,-,-1,-1
RECMUS.txt,545889,546550,661,5,N,N,-,-1,-1
RECMUS.txt,546551,547298,747,5,N,N,-,-1,-1
RECMUS.txt,547299,547879,580,5,N,N,-,-1,-1
RECMUS.txt,547880,548425,545,5,N,N,-,-1,-1
RECMUS.txt,548426,549542,1116,5,N,N,-,-1,-1
RECMUS.txt,549545,550488,943,5,N,N,-,-1,-1
RECMUS.txt,550491,551312,821,5,N,N,-,-1,-1
RECMUS.txt,551313,552296,983,5,N,N,-,-1,-1
RECMUS.txt,552297,552931,634,5,N,N,-,-1,-1
RECMUS.txt,552932,554189,1257,5,N,N,-,-1,-1
RECMUS.txt,554190,555106,916,5,N,N,-,-1,-1
RECMUS.txt,555107,555876,769,5,N,N,-,-1,-1
RECMUS.txt,555878,556897,1019,5,N,N,-,-1,-1
RECMUS.txt,556898,557829,931,5,N,N,-,-1,-1
RECMUS.txt,557830,559031,1201,5,N,N,-,-1,-1
RECMUS.txt,559033,559484,451,5,N,N,-,-1,-1
RECMUS.txt,559484,560397,913,5,N,N,-,-1,-1
RECMUS.txt,560398,561451,1053,5,N,N,-,-1,-1
RECMUS.txt,561452,562452,1000,5,N,N,-,-1,-1
RECMUS.txt,562454,563589,1135,5,N,N,-,-1,-1
RECMUS.txt,563591,564434,843,5,N,N,-,-1,-1
RECMUS.txt,564435,565294,859,5,N,N,-,-1,-1
RECMUS.txt,565295,566237,942,5,N,N,-,-1,-1
RECMUS.txt,566238,567268,1030,5,N,N,-,-1,-1
RECMUS.txt,567269,568037,768,5,N,N,-,-1,-1
RECMUS.txt,568040,568850,810,5,N,N,-,-1,-1
RECMUS.txt,568851,569933,1082,5,N,N,-,-1,-1
RECMUS.txt,569934,570529,595,5,N,N,-,-1,-1
RECMUS.txt,570530,571191,661,5,N,N,-,-1,-1
RECMUS.txt,571192,571876,684,5,N,N,-,-1,-1
RECMUS.txt,571877,572789,912,5,N,N,-,-1,-1
RECMUS.txt,572790,574150,1360,5,N,N,-,-1,-1
RECMUS.txt,574151,574709,558,5,N,N,-,-1,-1
RECMUS.txt,574710,575753,1043,5,N,N,-,-1,-1
RECMUS.txt,575754,576805,1051,5,N,N,-,-1,-1
RECMUS.txt,576807,577430,623,5,N,N,-,-1,-1
RECMUS.txt,577431,578327,896,5,N,N,-,-1,-1
RECMUS.txt,578328,579155,827,5,N,N,-,-1,-1
RECMUS.txt,579158,579769,611,5,N,N,-,-1,-1
RECMUS.txt,579770,580668,898,5,N,N,-,-1,-1
RECMUS.txt,580669,581114,445,5,N,N,-,-1,-1
RECMUS.txt,581116,581574,458,5,N,N,-,-1,-1
RECMUS.txt,581575,582290,715,5,N,N,-,-1,-1
RECMUS.txt,582291,582920,629,5,N,Y,1430903585194,582416,582681
RECMUS.txt,582921,583282,361,5,N,N,-,-1,-1
RECMUS.txt,583283,583897,614,5,N,N,-,-1,-1
RECMUS.txt,583898,584377,479,5,N,N,-,-1,-1
RECMUS.txt,584378,585108,730,5,N,N,-,-1,-1
RECMUS.txt,585108,585550,442,5,N,N,-,-1,-1
RECMUS.txt,585551,586205,654,5,N,Y,1430906475487,585907,586013
RECMUS.txt,586206,586664,458,5,N,N,-,-1,-1
RECMUS.txt,586665,587325,660,5,N,N,-,-1,-1
RECMUS.txt,587326,588279,953,5,N,N,-,-1,-1
RECMUS.txt,588282,589217,935,5,N,N,-,-1,-1
RECMUS.txt,589220,589793,573,5,N,N,-,-1,-1
RECMUS.txt,589794,590373,579,5,N,N,-,-1,-1
RECMUS.txt,590376,591373,997,5,N,N,-,-1,-1
RECMUS.txt,591374,592049,675,5,N,N,-,-1,-1
RECMUS.txt,592050,592749,699,5,N,N,-,-1,-1
RECMUS.txt,592750,593480,730,5,N,N,-,-1,-1
RECMUS.txt,593481,594196,715,5,N,Y,1430917862299,593970,594073
RECMUS.txt,594197,594902,705,5,N,N,-,-1,-1
RECMUS.txt,594903,595703,800,5,N,N,-,-1,-1
RECMUS.txt,595704,596372,668,5,N,N,-,-1,-1
RECMUS.txt,596374,597087,713,5,N,N,-,-1,-1
RECMUS.txt,597088,597919,831,5,N,N,-,-1,-1
RECMUS.txt,597920,598529,609,5,N,N,-,-1,-1
RECMUS.txt,598530,598905,375,5,N,N,-,-1,-1
RECMUS.txt,598906,599586,680,5,N,N,-,-1,-1
RECMUS.txt,599587,600369,782,5,N,N,-,-1,-1
RECMUS.txt,600370,600974,604,5,N,Y,1430919558858,600376,600634
RECMUS.txt,600975,601509,534,5,N,N,-,-1,-1
RECMUS.txt,601510,602108,598,5,N,N,-,-1,-1
RECMUS.txt,602109,603218,1109,5,Y,Y,1430920461435,602905,603306
RECMUS.txt,603219,603719,500,5,N,Y,1430920461435,602905,603306
RECMUS.txt,603724,604116,392,5,N,N,-,-1,-1
RECMUS.txt,604117,604694,577,5,N,N,-,-1,-1
RECMUS.txt,604697,605148,451,5,N,N,-,-1,-1
RECMUS.txt,605149,605509,360,5,N,N,-,-1,-1
RECMUS.txt,605510,605965,455,5,N,N,-,-1,-1
RECMUS.txt,605966,606756,790,5,N,N,-,-1,-1
RECMUS.txt,606757,607001,244,5,N,N,-,-1,-1
RECMUS.txt,607002,607717,715,5,N,N,-,-1,-1
RECMUS.txt,607718,608391,673,5,N,N,-,-1,-1
RECMUS.txt,608393,609080,687,5,N,N,-,-1,-1
RECMUS.txt,609081,609361,280,5,N,N,-,-1,-1
RECMUS.txt,609364,609827,463,5,N,N,-,-1,-1
RECMUS.txt,609829,610349,520,5,N,N,-,-1,-1
RECMUS.txt,610350,610749,399,5,N,N,-,-1,-1
RECMUS.txt,610750,611333,583,5,N,Y,1431164339653,610804,611223
RECMUS.txt,611334,611609,275,5,N,N,-,-1,-1
RECMUS.txt,611610,612166,556,5,N,N,-,-1,-1
RECMUS.txt,612167,612709,542,5,N,N,-,-1,-1
RECMUS.txt,612712,613255,543,5,N,N,-,-1,-1
RECMUS.txt,613256,613617,361,5,N,N,-,-1,-1
RECMUS.txt,613618,614104,486,5,N,N,-,-1,-1
RECMUS.txt,614105,614770,665,5,N,N,-,-1,-1
RECMUS.txt,614771,615274,503,5,N,N,-,-1,-1
RECMUS.txt,615279,615702,423,5,N,N,-,-1,-1
RECMUS.txt,615705,616263,558,5,N,N,-,-1,-1
RECMUS.txt,616264,616449,185,5,N,N,-,-1,-1
RECMUS.txt,616452,616681,229,5,N,N,-,-1,-1
RECMUS.txt,616682,617004,322,5,N,N,-,-1,-1
RECMUS.txt,617007,617473,466,5,N,N,-,-1,-1
RECMUS.txt,617476,618170,694,5,N,N,-,-1,-1
RECMUS.txt,618171,618940,769,5,N,N,-,-1,-1
RECMUS.txt,618941,619368,427,5,N,N,-,-1,-1
RECMUS.txt,619369,620016,647,5,N,N,-,-1,-1
RECMUS.txt,620019,621158,1139,5,N,N,-,-1,-1
RECMUS.txt,621161,622119,958,5,N,N,-,-1,-1
RECMUS.txt,622120,623134,1014,5,N,N,-,-1,-1
RECMUS.txt,623135,623516,381,5,N,N,-,-1,-1
RECMUS.txt,623521,623769,248,5,N,N,-,-1,-1
RECMUS.txt,623771,624691,920,5,N,N,-,-1,-1
RECMUS.txt,624692,625279,587,5,N,N,-,-1,-1
RECMUS.txt,625280,625944,664,5,N,N,-,-1,-1
RECMUS.txt,625945,627226,1281,5,Y,N,-,-1,-1
RECMUS.txt,627227,627885,658,5,N,N,-,-1,-1
RECMUS.txt,627890,628862,972,5,N,N,-,-1,-1
RECMUS.txt,628863,629428,565,5,N,N,-,-1,-1
RECMUS.txt,629429,630290,861,5,N,N,-,-1,-1
RECMUS.txt,630295,631004,709,5,N,N,-,-1,-1
RECMUS.txt,631005,632110,1105,5,N,N,-,-1,-1
RECMUS.txt,632111,632678,567,5,N,N,-,-1,-1
RECMUS.txt,632679,633739,1060,5,N,N,-,-1,-1
RECMUS.txt,633742,634712,970,5,N,N,-,-1,-1
RECMUS.txt,634713,635193,480,5,N,N,-,-1,-1
RECMUS.txt,635194,636048,854,5,N,N,-,-1,-1
RECMUS.txt,636049,636970,921,5,N,N,-,-1,-1
RECMUS.txt,636973,637389,416,5,N,N,-,-1,-1
RECMUS.txt,637392,638287,895,5,N,N,-,-1,-1
RECMUS.txt,638288,638918,630,5,N,N,-,-1,-1
RECMUS.txt,638919,639763,844,5,N,N,-,-1,-1
RECMUS.txt,639764,640632,868,5,N,Y,1431361104528,639924,640273
RECMUS.txt,640635,641220,585,5,N,N,-,-1,-1
RECMUS.txt,641222,641602,380,5,N,N,-,-1,-1
RECMUS.txt,641603,642052,449,5,N,N,-,-1,-1
RECMUS.txt,642053,642822,769,5,N,N,-,-1,-1
RECMUS.txt,642823,643045,222,5,N,N,-,-1,-1
RECMUS.txt,643048,643802,754,5,N,N,-,-1,-1
RECMUS.txt,643803,644199,396,5,N,N,-,-1,-1
RECMUS.txt,644200,644906,706,5,N,N,-,-1,-1
RECMUS.txt,644907,645600,693,5,N,N,-,-1,-1
RECMUS.txt,645601,646305,704,5,N,N,-,-1,-1
RECMUS.txt,646306,647281,975,5,N,N,-,-1,-1
RECMUS.txt,647282,648560,1278,5,N,N,-,-1,-1
RECMUS.txt,648562,649339,777,5,N,N,-,-1,-1
RECMUS.txt,649339,649818,479,5,N,N,-,-1,-1
RECMUS.txt,649819,650593,774,5,N,N,-,-1,-1
RECMUS.txt,650595,651616,1021,5,N,N,-,-1,-1
RECMUS.txt,651618,652878,1260,5,N,N,-,-1,-1
RECMUS.txt,652883,653693,810,5,N,N,-,-1,-1
RECMUS.txt,653694,654234,540,5,N,N,-,-1,-1
RECMUS.txt,654235,654806,571,5,N,N,-,-1,-1
RECMUS.txt,654807,655549,742,5,N,N,-,-1,-1
RECMUS.txt,655552,656571,1019,5,N,N,-,-1,-1
RECMUS.txt,656571,657017,446,5,N,N,-,-1,-1
RECMUS.txt,657018,657593,575,5,N,N,-,-1,-1
RECMUS.txt,657596,658479,883,5,N,N,-,-1,-1
RECMUS.txt,658480,659136,656,5,N,N,-,-1,-1
RECMUS.txt,659137,659824,687,5,N,N,-,-1,-1
RECMUS.txt,659825,660505,680,5,N,N,-,-1,-1
RECMUS.txt,660506,661148,642,5,N,N,-,-1,-1
RECMUS.txt,661149,661727,578,5,N,N,-,-1,-1
RECMUS.txt,661732,662304,572,5,N,N,-,-1,-1
RECMUS.txt,662306,663199,893,5,N,N,-,-1,-1
RECMUS.txt,663200,664063,863,5,N,N,-,-1,-1
RECMUS.txt,664068,665009,941,5,N,N,-,-1,-1
RECMUS.txt,665014,665630,616,5,N,N,-,-1,-1
RECMUS.txt,665631,666599,968,5,N,N,-,-1,-1
RECMUS.txt,666602,666905,303,5,N,Y,1431440815809,666612,666881
RECMUS.txt,666905,667790,885,5,N,Y,1431441360624,667425,667782
RECMUS.txt,667793,668588,795,5,N,N,-,-1,-1
RECMUS.txt,668589,669279,690,5,N,Y,1431445668256,668943,669143
RECMUS.txt,669280,669618,338,5,N,N,-,-1,-1
RECMUS.txt,669621,670515,894,5,N,Y,1431446268360,670256,670506
RECMUS.txt,670515,671501,986,5,N,N,-,-1,-1
RECMUS.txt,671502,672073,571,5,N,N,-,-1,-1
RECMUS.txt,672074,672807,733,5,N,N,-,-1,-1
RECMUS.txt,672810,673390,580,5,N,N,-,-1,-1
RECMUS.txt,673391,673676,285,5,N,N,-,-1,-1
RECMUS.txt,673677,674347,670,5,N,N,-,-1,-1
RECMUS.txt,674348,674816,468,5,N,N,-,-1,-1
RECMUS.txt,674817,675396,579,5,N,N,-,-1,-1
RECMUS.txt,675397,676091,694,5,N,N,-,-1,-1
RECMUS.txt,676092,676603,511,5,N,N,-,-1,-1
RECMUS.txt,676604,677025,421,5,N,N,-,-1,-1
RECMUS.txt,677026,677663,637,5,N,N,-,-1,-1
RECMUS.txt,677666,678074,408,5,N,N,-,-1,-1
RECMUS.txt,678075,678604,529,5,N,N,-,-1,-1
RECMUS.txt,678605,679306,701,5,N,N,-,-1,-1
RECMUS.txt,679307,680120,813,5,N,N,-,-1,-1
RECMUS.txt,680121,680652,531,5,N,Y,1431506517034,680207,680323
RECMUS.txt,680655,681357,702,5,N,N,-,-1,-1
RECMUS.txt,681358,681943,585,5,N,N,-,-1,-1
RECMUS.txt,681944,682685,741,5,N,N,-,-1,-1
RECMUS.txt,682688,683297,609,5,N,N,-,-1,-1
RECMUS.txt,683299,684012,713,5,N,N,-,-1,-1
RECMUS.txt,684013,684675,662,5,N,N,-,-1,-1
RECMUS.txt,684676,685304,628,5,N,Y,1431508066369,685259,685876
RECMUS.txt,685305,685743,438,5,N,Y,1431508066369,685259,685876
RECMUS.txt,685745,686543,798,5,N,Y,1431508066369,685259,685876
RECMUS.txt,686544,687342,798,5,N,N,-,-1,-1
RECMUS.txt,687344,687764,420,5,N,N,-,-1,-1
RECMUS.txt,687766,688545,779,5,N,N,-,-1,-1
RECMUS.txt,688546,689084,538,5,N,N,-,-1,-1
RECMUS.txt,689087,689393,306,5,N,N,-,-1,-1
RECMUS.txt,689396,689690,294,5,N,N,-,-1,-1
RECMUS.txt,689693,690238,545,5,N,Y,1431520391464,690129,690293
RECMUS.txt,690239,690525,286,5,N,Y,1431520391464,690129,690293
RECMUS.txt,690528,691406,878,5,N,N,-,-1,-1
RECMUS.txt,691407,691948,541,5,N,N,-,-1,-1
RECMUS.txt,691949,692633,684,5,N,N,-,-1,-1
RECMUS.txt,692635,693322,687,5,N,N,-,-1,-1
RECMUS.txt,693325,694143,818,5,N,N,-,-1,-1
RECMUS.txt,694144,694907,763,5,N,N,-,-1,-1
RECMUS.txt,694908,695307,399,5,N,N,-,-1,-1
RECMUS.txt,695308,696193,885,5,N,N,-,-1,-1
RECMUS.txt,696194,697357,1163,5,N,N,-,-1,-1
RECMUS.txt,697358,698028,670,5,N,N,-,-1,-1
RECMUS.txt,698029,698538,509,5,N,N,-,-1,-1
RECMUS.txt,698539,699335,796,5,N,N,-,-1,-1
RECMUS.txt,699336,700116,780,5,Y,Y,1431686580301,699502,699758
RECMUS.txt,700118,700909,791,5,N,N,-,-1,-1
RECMUS.txt,700910,701765,855,5,N,N,-,-1,-1
RECMUS.txt,701766,702852,1086,5,N,N,-,-1,-1
RECMUS.txt,702853,703984,1131,5,N,N,-,-1,-1
RECMUS.txt,703985,704651,666,5,N,N,-,-1,-1
RECMUS.txt,704652,704892,240,5,N,N,-,-1,-1
RECMUS.txt,704893,705195,302,5,N,Y,1431687599525,705104,705244
RECMUS.txt,705196,705665,469,5,N,Y,1431687599525,705104,705244
RECMUS.txt,705666,706328,662,5,N,N,-,-1,-1
RECMUS.txt,706329,706847,518,5,N,N,-,-1,-1
RECMUS.txt,706848,707074,226,5,N,N,-,-1,-1
RECMUS.txt,707075,707496,421,5,N,N,-,-1,-1
RECMUS.txt,707497,708286,789,5,N,N,-,-1,-1
RECMUS.txt,708287,708678,391,5,N,N,-,-1,-1
RECMUS.txt,708679,709450,771,5,N,N,-,-1,-1
RECMUS.txt,709451,710376,925,5,N,N,-,-1,-1
RECMUS.txt,710377,711074,697,5,N,N,-,-1,-1
RECMUS.txt,711079,712132,1053,5,N,N,-,-1,-1
RECMUS.txt,712133,712507,374,5,N,N,-,-1,-1
RECMUS.txt,712508,713257,749,5,N,N,-,-1,-1
RECMUS.txt,713262,714201,939,5,N,N,-,-1,-1
RECMUS.txt,714202,714825,623,5,N,N,-,-1,-1
RECMUS.txt,714826,715931,1105,5,N,N,-,-1,-1
RECMUS.txt,715934,716912,978,5,N,N,-,-1,-1
RECMUS.txt,716912,717928,1016,5,N,N,-,-1,-1
RECMUS.txt,717929,718870,941,5,N,N,-,-1,-1
RECMUS.txt,718872,719326,454,5,N,N,-,-1,-1
RECMUS.txt,719327,719767,440,5,N,N,-,-1,-1
RECMUS.txt,719768,720636,868,5,N,N,-,-1,-1
RECMUS.txt,720637,721690,1053,5,N,N,-,-1,-1
RECMUS.txt,721691,722136,445,5,N,N,-,-1,-1
RECMUS.txt,722137,722905,768,5,N,N,-,-1,-1
RECMUS.txt,722908,723836,928,5,N,N,-,-1,-1
RECMUS.txt,723837,724735,898,5,N,N,-,-1,-1
RECMUS.txt,724736,725322,586,5,N,N,-,-1,-1
RECMUS.txt,725323,726178,855,5,N,Y,1431697022699,725354,725864
RECMUS.txt,726181,727242,1061,5,N,N,-,-1,-1
RECMUS.txt,727243,728077,834,5,N,N,-,-1,-1
RECMUS.txt,728079,729092,1013,5,N,N,-,-1,-1
RECMUS.txt,729093,729866,773,5,N,N,-,-1,-1
RECMUS.txt,729867,730504,637,5,N,Y,1431697584022,729902,730181
RECMUS.txt,730507,730765,258,5,N,N,-,-1,-1
RECMUS.txt,730768,730893,125,5,N,N,-,-1,-1
RECMUS.txt,730896,731346,450,5,N,N,-,-1,-1
RECMUS.txt,731347,732278,931,5,N,N,-,-1,-1
RECMUS.txt,732280,733143,863,5,N,N,-,-1,-1
RECMUS.txt,733145,733798,653,5,N,Y,1431790026329,733306,733503
RECMUS.txt,733799,734457,658,5,N,N,-,-1,-1
RECMUS.txt,734458,734897,439,5,N,N,-,-1,-1
RECMUS.txt,734898,735622,724,5,N,N,-,-1,-1
RECMUS.txt,735623,736326,703,5,N,N,-,-1,-1
RECMUS.txt,736329,736539,210,5,N,Y,1431791455244,736369,736531
RECMUS.txt,736540,737441,901,5,N,N,-,-1,-1
RECMUS.txt,737443,738190,747,5,N,N,-,-1,-1
RECMUS.txt,738191,738927,736,5,N,N,-,-1,-1
RECMUS.txt,738928,739665,737,5,N,N,-,-1,-1
RECMUS.txt,739667,740432,765,5,N,N,-,-1,-1
RECMUS.txt,740434,741105,671,5,N,N,-,-1,-1
RECMUS.txt,741108,741875,767,5,N,N,-,-1,-1
RECMUS.txt,741880,742609,729,5,N,N,-,-1,-1
RECMUS.txt,742610,743472,862,5,N,Y,1431941266117,742610,743297
RECMUS.txt,743474,744125,651,5,N,N,-,-1,-1
RECMUS.txt,744127,745214,1087,5,N,Y,1431941771447,744892,745049
RECMUS.txt,745215,745730,515,5,N,N,-,-1,-1
RECMUS.txt,745732,746009,277,5,N,N,-,-1,-1
RECMUS.txt,746010,747041,1031,5,N,N,-,-1,-1
RECMUS.txt,747044,747760,716,5,N,N,-,-1,-1
RECMUS.txt,747763,748472,709,5,N,N,-,-1,-1
RECMUS.txt,748475,749038,563,5,N,N,-,-1,-1
RECMUS.txt,749039,749668,629,5,N,Y,1431943173931,749552,750043
RECMUS.txt,749669,750305,636,5,N,Y,1431943173931,749552,750043
RECMUS.txt,750307,751325,1018,5,N,N,-,-1,-1
RECMUS.txt,751330,752027,697,5,N,N,-,-1,-1
RECMUS.txt,752028,752387,359,5,N,N,-,-1,-1
RECMUS.txt,752388,752986,598,5,N,N,-,-1,-1
RECMUS.txt,752987,753452,465,5,N,N,-,-1,-1
RECMUS.txt,753455,754575,1120,5,N,N,-,-1,-1
RECMUS.txt,754576,755476,900,5,N,N,-,-1,-1
RECMUS.txt,755477,755769,292,5,N,N,-,-1,-1
RECMUS.txt,755770,756155,385,5,N,N,-,-1,-1
RECMUS.txt,756158,756820,662,5,N,N,-,-1,-1
RECMUS.txt,756821,757169,348,5,N,N,-,-1,-1
RECMUS.txt,757171,757512,341,5,N,N,-,-1,-1
RECMUS.txt,757514,757918,404,5,N,N,-,-1,-1
RECMUS.txt,757921,758719,798,5,N,N,-,-1,-1
RECMUS.txt,758720,759590,870,5,N,N,-,-1,-1
RECMUS.txt,759591,760170,579,5,N,N,-,-1,-1
RECMUS.txt,760173,760995,822,5,N,N,-,-1,-1
RECMUS.txt,760995,761842,847,5,N,N,-,-1,-1
RECMUS.txt,761843,762643,800,5,N,N,-,-1,-1
RECMUS.txt,762644,763458,814,5,N,Y,1431950693551,763304,763649
RECMUS.txt,763459,764212,753,5,N,Y,1431950693551,763304,763649
RECMUS.txt,764213,764567,354,5,N,N,-,-1,-1
RECMUS.txt,764570,764812,242,5,N,N,-,-1,-1
RECMUS.txt,764813,765420,607,5,N,N,-,-1,-1
RECMUS.txt,765422,765706,284,5,N,N,-,-1,-1
RECMUS.txt,765709,766125,416,5,N,N,-,-1,-1
RECMUS.txt,766126,766713,587,5,N,N,-,-1,-1
RECMUS.txt,766714,767226,512,5,N,N,-,-1,-1
RECMUS.txt,767228,767891,663,5,N,N,-,-1,-1
RECMUS.txt,767892,768613,721,5,N,N,-,-1,-1
RECMUS.txt,768614,769384,770,5,N,N,-,-1,-1
RECMUS.txt,769385,770093,708,5,N,N,-,-1,-1
RECMUS.txt,770094,771042,948,5,N,N,-,-1,-1
RECMUS.txt,771043,771664,621,5,N,N,-,-1,-1
RECMUS.txt,771667,772529,862,5,N,N,-,-1,-1
RECMUS.txt,772530,773335,805,5,N,N,-,-1,-1
RECMUS.txt,773336,773831,495,5,N,N,-,-1,-1
RECMUS.txt,773834,774827,993,5,N,N,-,-1,-1
RECMUS.txt,774828,775656,828,5,N,Y,1431952551670,775158,775489
RECMUS.txt,775657,776512,855,5,N,N,-,-1,-1
RECMUS.txt,776513,777173,660,5,N,N,-,-1,-1
RECMUS.txt,777174,777923,749,5,N,N,-,-1,-1
RECMUS.txt,777924,778226,302,5,N,N,-,-1,-1
RECMUS.txt,778227,778749,522,5,N,N,-,-1,-1
RECMUS.txt,778750,779448,698,5,N,N,-,-1,-1
RECMUS.txt,779449,780626,1177,5,N,N,-,-1,-1
RECMUS.txt,780631,781273,642,5,N,N,-,-1,-1
RECMUS.txt,781274,781890,616,5,N,N,-,-1,-1
RECMUS.txt,781891,782871,980,5,N,Y,1431953940995,782482,782580
RECMUS.txt,782872,783714,842,5,N,N,-,-1,-1
RECMUS.txt,783717,784314,597,5,N,N,-,-1,-1
RECMUS.txt,784315,784921,606,5,N,N,-,-1,-1
RECMUS.txt,784922,785645,723,5,N,N,-,-1,-1
RECMUS.txt,785646,786321,675,5,N,N,-,-1,-1
RECMUS.txt,786322,787059,737,5,N,N,-,-1,-1
RECMUS.txt,787061,787985,924,5,N,N,-,-1,-1
RECMUS.txt,787986,788708,722,5,N,N,-,-1,-1
RECMUS.txt,788709,789299,590,5,N,N,-,-1,-1
RECMUS.txt,789300,790192,892,5,N,N,-,-1,-1
RECMUS.txt,790193,790711,518,5,N,N,-,-1,-1
RECMUS.txt,790712,791299,587,5,N,N,-,-1,-1
RECMUS.txt,791300,791895,595,5,N,Y,1432024843245,791416,792120
RECMUS.txt,791896,792807,911,5,Y,Y,1432024843245,791416,792120
RECMUS.txt,792808,793351,543,5,N,N,-,-1,-1
RECMUS.txt,793354,793741,387,5,N,N,-,-1,-1
RECMUS.txt,793744,794670,926,5,N,N,-,-1,-1
RECMUS.txt,794673,795595,922,5,N,N,-,-1,-1
RECMUS.txt,795596,796288,692,5,N,N,-,-1,-1
RECMUS.txt,796290,797100,810,5,N,Y,1432028613565,796637,797464
RECMUS.txt,797101,797726,625,5,N,Y,1432028613565,796637,797464
RECMUS.txt,797729,798459,730,5,N,N,-,-1,-1
RECMUS.txt,798460,798916,456,5,N,N,-,-1,-1
RECMUS.txt,798919,800081,1162,5,N,N,-,-1,-1
RECMUS.txt,800082,801222,1140,5,N,N,-,-1,-1
RECMUS.txt,801225,802075,850,5,Y,N,-,-1,-1
RECMUS.txt,802076,802877,801,5,N,N,-,-1,-1
RECMUS.txt,802878,803397,519,5,N,N,-,-1,-1
RECMUS.txt,803398,804112,714,5,N,N,-,-1,-1
RECMUS.txt,804113,805019,906,5,N,N,-,-1,-1
RECMUS.txt,805020,805573,553,5,N,N,-,-1,-1
RECMUS.txt,805576,806215,639,5,N,N,-,-1,-1
RECMUS.txt,806216,807303,1087,5,N,N,-,-1,-1
RECMUS.txt,807304,807925,621,5,N,N,-,-1,-1
RECMUS.txt,807930,808752,822,5,N,N,-,-1,-1
RECMUS.txt,808753,809241,488,5,N,N,-,-1,-1
RECMUS.txt,809244,810155,911,5,N,N,-,-1,-1
RECMUS.txt,810156,811118,962,5,N,N,-,-1,-1
RECMUS.txt,811119,811715,596,5,N,N,-,-1,-1
RECMUS.txt,811716,812605,889,5,N,Y,1432129974051,812469,812989
RECMUS.txt,812606,813632,1026,5,N,Y,1432129974051,812469,812989
RECMUS.txt,813633,814155,522,5,N,N,-,-1,-1
RECMUS.txt,814156,815195,1039,5,N,N,-,-1,-1
RECMUS.txt,815196,816010,814,5,N,N,-,-1,-1
RECMUS.txt,816013,816951,938,5,Y,N,-,-1,-1
RECMUS.txt,816952,817462,510,5,N,N,-,-1,-1
RECMUS.txt,817463,818504,1041,5,N,N,-,-1,-1
RECMUS.txt,818506,819304,798,5,N,N,-,-1,-1
RECMUS.txt,819305,819708,403,5,N,N,-,-1,-1
RECMUS.txt,819713,820367,654,5,N,N,-,-1,-1
RECMUS.txt,820372,820780,408,5,N,N,-,-1,-1
RECMUS.txt,820780,821488,708,5,N,N,-,-1,-1
RECMUS.txt,821489,822449,960,5,N,N,-,-1,-1
RECMUS.txt,822450,823564,1114,5,N,N,-,-1,-1
RECMUS.txt,823565,824094,529,5,N,N,-,-1,-1
RECMUS.txt,824095,824782,687,5,N,N,-,-1,-1
RECMUS.txt,824783,825524,741,5,N,N,-,-1,-1
RECMUS.txt,825526,826161,635,5,N,N,-,-1,-1
RECMUS.txt,826162,826712,550,5,N,N,-,-1,-1
RECMUS.txt,826713,827178,465,5,N,N,-,-1,-1
RECMUS.txt,827179,827657,478,5,N,N,-,-1,-1
RECMUS.txt,827657,828250,593,5,N,Y,1432288594537,828067,828512
RECMUS.txt,828251,828914,663,5,N,Y,1432288594537,828067,828512
RECMUS.txt,828915,829904,989,5,Y,N,-,-1,-1
RECMUS.txt,829905,830313,408,5,N,N,-,-1,-1
RECMUS.txt,830315,831029,714,5,N,Y,1432289841006,830618,830976
RECMUS.txt,831030,831607,577,5,N,N,-,-1,-1
RECMUS.txt,831609,832126,517,5,N,N,-,-1,-1
RECMUS.txt,832129,833123,994,5,N,N,-,-1,-1
RECMUS.txt,833124,833862,738,5,N,N,-,-1,-1
RECMUS.txt,833863,834952,1089,5,N,N,-,-1,-1
RECMUS.txt,834953,835612,659,5,N,N,-,-1,-1
RECMUS.txt,835613,836421,808,5,N,N,-,-1,-1
RECMUS.txt,836424,837192,768,5,N,N,-,-1,-1
RECMUS.txt,837193,837844,651,5,N,N,-,-1,-1
RECMUS.txt,837845,838882,1037,5,N,N,-,-1,-1
RECMUS.txt,838882,839937,1055,5,N,Y,1432374854992,839856,840598
RECMUS.txt,839938,840316,378,5,N,Y,1432374854992,839856,840598
RECMUS.txt,840317,840843,526,5,N,Y,1432374854992,839856,840598
RECMUS.txt,840844,841045,201,5,N,N,-,-1,-1
RECMUS.txt,841046,841595,549,5,N,N,-,-1,-1
RECMUS.txt,841596,842316,720,5,N,Y,1432375899241,842288,842780
RECMUS.txt,842317,843899,1582,5,Y,Y,1432375899241,842288,842780
RECMUS.txt,843900,844614,714,5,N,N,-,-1,-1
RECMUS.txt,844615,845592,977,5,N,N,-,-1,-1
RECMUS.txt,845593,846143,550,5,N,N,-,-1,-1
RECMUS.txt,846146,846558,412,5,N,N,-,-1,-1
RECMUS.txt,846561,847054,493,5,N,N,-,-1,-1
RECMUS.txt,847055,847617,562,5,N,N,-,-1,-1
RECMUS.txt,847618,848652,1034,5,N,N,-,-1,-1
RECMUS.txt,848653,849232,579,5,N,N,-,-1,-1
RECMUS.txt,849235,850102,867,5,N,N,-,-1,-1
RECMUS.txt,850105,850900,795,5,N,N,-,-1,-1
RECMUS.txt,850905,851553,648,5,N,N,-,-1,-1
RECMUS.txt,851554,851936,382,5,N,N,-,-1,-1
RECMUS.txt,851939,853057,1118,5,N,N,-,-1,-1
RECMUS.txt,853058,854361,1303,5,N,N,-,-1,-1
RECMUS.txt,854364,855006,642,5,N,N,-,-1,-1
RECMUS.txt,855007,855308,301,5,N,N,-,-1,-1
RECMUS.txt,855310,856244,934,5,N,N,-,-1,-1
RECMUS.txt,856245,856872,627,5,N,N,-,-1,-1
RECMUS.txt,856873,857986,1113,5,N,N,-,-1,-1
RECMUS.txt,857987,858773,786,5,N,N,-,-1,-1
RECMUS.txt,858774,859368,594,5,N,N,-,-1,-1
RECMUS.txt,859369,860173,804,5,N,N,-,-1,-1
RECMUS.txt,860174,860971,797,5,N,N,-,-1,-1
RECMUS.txt,860972,861654,682,5,N,N,-,-1,-1
RECMUS.txt,861655,862394,739,5,N,N,-,-1,-1
RECMUS.txt,862397,863576,1179,5,N,N,-,-1,-1
RECMUS.txt,863577,864291,714,5,N,N,-,-1,-1
RECMUS.txt,864292,865164,872,5,N,N,-,-1,-1
RECMUS.txt,865165,865813,648,5,N,N,-,-1,-1
RECMUS.txt,865818,866880,1062,5,N,Y,1432468347198,866650,866878
RECMUS.txt,866883,867738,855,5,N,N,-,-1,-1
RECMUS.txt,867739,868302,563,5,N,N,-,-1,-1
RECMUS.txt,868303,868717,414,5,N,N,-,-1,-1
RECMUS.txt,868718,869438,720,5,N,N,-,-1,-1
RECMUS.txt,869439,870262,823,5,N,N,-,-1,-1
RECMUS.txt,870267,871038,771,5,N,N,-,-1,-1
RECMUS.txt,871039,871409,370,5,N,N,-,-1,-1
RECMUS.txt,871410,871658,248,5,N,N,-,-1,-1
RECMUS.txt,871660,871918,258,5,N,N,-,-1,-1
RECMUS.txt,871923,872653,730,5,N,N,-,-1,-1
RECMUS.txt,872654,873311,657,5,N,N,-,-1,-1
RECMUS.txt,873312,874254,942,5,N,Y,1432486376679,873579,873808
RECMUS.txt,874255,874900,645,5,N,N,-,-1,-1
RECMUS.txt,874902,875967,1065,5,N,Y,1432487662435,875600,875831
RECMUS.txt,875968,876722,754,5,N,N,-,-1,-1
RECMUS.txt,876723,877219,496,5,N,N,-,-1,-1
RECMUS.txt,877220,877912,692,5,N,N,-,-1,-1
RECMUS.txt,877913,878848,935,5,N,N,-,-1,-1
RECMUS.txt,878851,879370,519,5,N,N,-,-1,-1
RECMUS.txt,879371,880090,719,5,N,N,-,-1,-1
RECMUS.txt,880091,880795,704,5,N,N,-,-1,-1
RECMUS.txt,880796,881484,688,5,N,N,-,-1,-1
RECMUS.txt,881485,882206,721,5,N,N,-,-1,-1
RECMUS.txt,882207,882800,593,5,N,N,-,-1,-1
RECMUS.txt,882802,883426,624,5,N,N,-,-1,-1
RECMUS.txt,883427,884403,976,5,N,N,-,-1,-1
RECMUS.txt,884404,885116,712,5,N,N,-,-1,-1
RECMUS.txt,885117,885606,489,5,N,N,-,-1,-1
RECMUS.txt,885611,885831,220,5,N,N,-,-1,-1
RECMUS.txt,885832,886335,503,5,N,N,-,-1,-1
RECMUS.txt,886337,886694,357,5,N,N,-,-1,-1
RECMUS.txt,886697,886887,190,5,N,N,-,-1,-1
RECMUS.txt,886890,887119,229,5,N,N,-,-1,-1
RECMUS.txt,887122,888081,959,5,N,Y,1432546852411,887723,888158
RECMUS.txt,888082,889067,985,5,N,Y,1432546852411,887723,888158
RECMUS.txt,889068,889734,666,5,N,N,-,-1,-1
RECMUS.txt,889735,890338,603,5,N,N,-,-1,-1
RECMUS.txt,890339,890999,660,5,N,N,-,-1,-1
RECMUS.txt,891000,891646,646,5,N,N,-,-1,-1
RECMUS.txt,891647,892258,611,5,N,N,-,-1,-1
RECMUS.txt,892259,892981,722,5,N,N,-,-1,-1
RECMUS.txt,892982,893717,735,5,Y,N,-,-1,-1
RECMUS.txt,893720,894491,771,5,N,N,-,-1,-1
RECMUS.txt,894492,895573,1081,5,N,N,-,-1,-1
RECMUS.txt,895574,896522,948,5,N,N,-,-1,-1
RECMUS.txt,896525,897747,1222,5,Y,N,-,-1,-1
RECMUS.txt,897748,898706,958,5,N,N,-,-1,-1
RECMUS.txt,898711,899380,669,5,N,N,-,-1,-1
RECMUS.txt,899381,900088,707,5,N,N,-,-1,-1
RECMUS.txt,900091,900706,615,5,N,N,-,-1,-1
RECMUS.txt,900707,901175,468,5,N,N,-,-1,-1
RECMUS.txt,901176,901824,648,5,N,N,-,-1,-1
RECMUS.txt,901825,902509,684,5,N,N,-,-1,-1
RECMUS.txt,902510,903110,600,5,N,N,-,-1,-1
RECMUS.txt,903113,903686,573,5,N,N,-,-1,-1
RECMUS.txt,903687,904639,952,5,N,N,-,-1,-1
RECMUS.txt,904640,905232,592,5,N,N,-,-1,-1
RECMUS.txt,905235,905810,575,5,N,N,-,-1,-1
RECMUS.txt,905813,907037,1224,5,N,N,-,-1,-1
RECMUS.txt,907038,907931,893,5,N,N,-,-1,-1
RECMUS.txt,907934,909029,1095,5,N,N,-,-1,-1
RECMUS.txt,909030,910059,1029,5,N,N,-,-1,-1
RECMUS.txt,910060,910892,832,5,N,N,-,-1,-1
RECMUS.txt,910893,911527,634,5,N,N,-,-1,-1
RECMUS.txt,911528,912473,945,5,N,N,-,-1,-1
RECMUS.txt,912476,913608,1132,5,N,N,-,-1,-1
RECMUS.txt,913609,914929,1320,5,N,Y,1432552116295,913989,914217
RECMUS.txt,914930,915802,872,5,N,N,-,-1,-1
RECMUS.txt,915804,916594,790,5,N,N,-,-1,-1
RECMUS.txt,916595,917523,928,5,N,N,-,-1,-1
RECMUS.txt,917528,918045,517,5,N,N,-,-1,-1
RECMUS.txt,918046,919386,1340,5,N,N,-,-1,-1
RECMUS.txt,919387,920551,1164,5,N,N,-,-1,-1
RECMUS.txt,920554,921475,921,5,N,N,-,-1,-1
RECMUS.txt,921476,922085,609,5,N,N,-,-1,-1
RECMUS.txt,922086,923294,1208,5,N,N,-,-1,-1
RECMUS.txt,923295,924168,873,5,N,N,-,-1,-1
RECMUS.txt,924171,924996,825,5,N,N,-,-1,-1
RECMUS.txt,924997,926116,1119,5,Y,Y,1432554740755,925747,926238
RECMUS.txt,926117,927183,1066,5,N,Y,1432554740755,925747,926238
RECMUS.txt,927184,928187,1003,5,N,N,-,-1,-1
RECMUS.txt,928188,928911,723,5,N,N,-,-1,-1
RECMUS.txt,928916,929767,851,5,N,N,-,-1,-1
RECMUS.txt,929769,930224,455,5,N,N,-,-1,-1
RECMUS.txt,930225,930547,322,5,N,N,-,-1,-1
RECMUS.txt,930552,931175,623,5,N,N,-,-1,-1
RECMUS.txt,931176,931780,604,5,N,N,-,-1,-1
RECMUS.txt,931781,932295,514,5,N,N,-,-1,-1
RECMUS.txt,932300,932937,637,5,N,N,-,-1,-1
RECMUS.txt,932939,933675,736,5,N,N,-,-1,-1
RECMUS.txt,933678,934451,773,5,N,N,-,-1,-1
RECMUS.txt,934452,934773,321,5,N,N,-,-1,-1
RECMUS.txt,934776,934900,124,5,N,N,-,-1,-1
RECMUS.txt,934901,934982,81,5,N,N,-,-1,-1
RECMUS.txt,934983,935122,139,5,N,N,-,-1,-1
RECMUS.txt,935125,935243,118,5,N,N,-,-1,-1
RECMUS.txt,935245,935379,134,5,N,N,-,-1,-1
RECMUS.txt,935380,935474,94,5,N,N,-,-1,-1
RECMUS.txt,935475,935650,175,5,N,N,-,-1,-1
RECMUS.txt,935651,935774,123,5,N,N,-,-1,-1
RECMUS.txt,935775,935863,88,5,N,N,-,-1,-1
RECMUS.txt,935865,935937,72,5,N,N,-,-1,-1
RECMUS.txt,935938,936168,230,5,N,N,-,-1,-1
RECMUS.txt,936170,936285,115,5,N,N,-,-1,-1
RECMUS.txt,936286,936356,70,5,N,N,-,-1,-1
RECMUS.txt,936360,936389,29,5,N,N,-,-1,-1
RECMUS.txt,936393,936425,32,5,N,N,-,-1,-1
RECMUS.txt,936428,936453,25,5,N,N,-,-1,-1
RECMUS.txt,936457,936482,25,5,N,N,-,-1,-1
RECMUS.txt,936486,936597,111,5,N,N,-,-1,-1
RECMUS.txt,936599,936736,137,5,N,N,-,-1,-1
RECMUS.txt,936738,936874,136,5,N,N,-,-1,-1
RECMUS.txt,936875,936945,70,5,N,N,-,-1,-1
RECMUS.txt,936947,937091,144,5,N,N,-,-1,-1
RECMUS.txt,937092,937267,175,5,N,N,-,-1,-1
RECMUS.txt,937268,937394,126,5,N,N,-,-1,-1
RECMUS.txt,937395,937608,213,5,N,N,-,-1,-1
RECMUS.txt,937609,937728,119,5,N,N,-,-1,-1
RECMUS.txt,937730,937909,179,5,N,N,-,-1,-1
RECMUS.txt,937910,938045,135,5,N,N,-,-1,-1
RECMUS.txt,938046,938194,148,5,N,N,-,-1,-1
RECMUS.txt,938195,938329,134,5,N,N,-,-1,-1
RECMUS.txt,938330,938575,245,5,N,N,-,-1,-1
RECMUS.txt,938577,938657,80,5,N,N,-,-1,-1
RECMUS.txt,938659,938836,177,5,N,N,-,-1,-1
RECMUS.txt,938837,939018,181,5,N,N,-,-1,-1
RECMUS.txt,939019,939217,198,5,N,N,-,-1,-1
RECMUS.txt,939218,939401,183,5,N,N,-,-1,-1
RECMUS.txt,939402,939578,176,5,N,N,-,-1,-1
RECMUS.txt,939579,939683,104,5,N,N,-,-1,-1
RECMUS.txt,939685,939949,264,5,N,N,-,-1,-1
RECMUS.txt,939951,940065,114,5,N,N,-,-1,-1
RECMUS.txt,940066,940181,115,5,N,N,-,-1,-1
RECMUS.txt,940183,940358,175,5,N,N,-,-1,-1
RECMUS.txt,940359,940607,248,5,N,N,-,-1,-1
RECMUS.txt,940608,940779,171,5,N,N,-,-1,-1
RECMUS.txt,940780,940904,124,5,N,N,-,-1,-1
RECMUS.txt,940905,940990,85,5,N,N,-,-1,-1
RECMUS.txt,940992,941156,164,5,N,N,-,-1,-1
RECMUS.txt,941157,941253,96,5,N,N,-,-1,-1
RECMUS.txt,941257,941288,31,5,N,N,-,-1,-1
RECMUS.txt,941292,941330,38,5,N,N,-,-1,-1
RECMUS.txt,941334,941365,31,5,N,N,-,-1,-1
RECMUS.txt,941367,941410,43,5,N,N,-,-1,-1
RECMUS.txt,941414,941445,31,5,N,N,-,-1,-1
RECMUS.txt,941449,941487,38,5,N,N,-,-1,-1
RECMUS.txt,941489,941599,110,5,N,N,-,-1,-1
RECMUS.txt,941600,941686,86,5,N,N,-,-1,-1
RECMUS.txt,941687,941854,167,5,N,N,-,-1,-1
RECMUS.txt,941855,941962,107,5,N,N,-,-1,-1
RECMUS.txt,941963,942110,147,5,N,N,-,-1,-1
RECMUS.txt,942111,942248,137,5,N,N,-,-1,-1
RECMUS.txt,942249,942386,137,5,N,N,-,-1,-1
RECMUS.txt,942387,942465,78,5,N,N,-,-1,-1
RECMUS.txt,942466,942529,63,5,N,N,-,-1,-1
RECMUS.txt,942530,942651,121,5,N,N,-,-1,-1
RECMUS.txt,942652,942730,78,5,N,N,-,-1,-1
RECMUS.txt,942733,942867,134,5,N,N,-,-1,-1
RECMUS.txt,942868,943002,134,5,N,N,-,-1,-1
RECMUS.txt,943003,943122,119,5,N,N,-,-1,-1
RECMUS.txt,943125,943228,103,5,N,N,-,-1,-1
RECMUS.txt,943229,943350,121,5,N,N,-,-1,-1
RECMUS.txt,943351,943493,142,5,N,N,-,-1,-1
RECMUS.txt,943494,943604,110,5,N,N,-,-1,-1
RECMUS.txt,943605,943705,100,5,N,N,-,-1,-1
RECMUS.txt,943706,943794,88,5,N,N,-,-1,-1
RECMUS.txt,943795,943963,168,5,N,N,-,-1,-1
RECMUS.txt,943964,944069,105,5,N,N,-,-1,-1
RECMUS.txt,944070,944237,167,5,N,N,-,-1,-1
RECMUS.txt,944238,944430,192,5,N,N,-,-1,-1
RECMUS.txt,944433,944695,262,5,N,N,-,-1,-1
RECMUS.txt,944696,944822,126,5,N,N,-,-1,-1
RECMUS.txt,944823,944897,74,5,N,N,-,-1,-1
RECMUS.txt,944900,944999,99,5,N,N,-,-1,-1
RECMUS.txt,945000,945151,151,5,N,N,-,-1,-1
RECMUS.txt,945154,945251,97,5,N,N,-,-1,-1
RECMUS.txt,945254,945426,172,5,N,N,-,-1,-1
RECMUS.txt,945427,945684,257,5,N,N,-,-1,-1
RECMUS.txt,945685,945963,278,5,N,N,-,-1,-1
RECMUS.txt,945964,946084,120,5,N,N,-,-1,-1
RECMUS.txt,946085,946267,182,5,N,N,-,-1,-1
RECMUS.txt,946268,946351,83,5,N,N,-,-1,-1
RECMUS.txt,946352,946470,118,5,N,N,-,-1,-1
RECMUS.txt,946471,946535,64,5,N,N,-,-1,-1
RECMUS.txt,946536,946665,129,5,N,N,-,-1,-1
RECMUS.txt,946668,946722,54,5,N,N,-,-1,-1
RECMUS.txt,946723,946961,238,5,N,N,-,-1,-1
RECMUS.txt,946964,947127,163,5,N,N,-,-1,-1
RECMUS.txt,947128,947360,232,5,N,N,-,-1,-1
RECMUS.txt,947363,947493,130,5,N,N,-,-1,-1
RECMUS.txt,947494,947548,54,5,N,N,-,-1,-1
RECMUS.txt,947549,947699,150,5,N,N,-,-1,-1
RECMUS.txt,947700,947889,189,5,N,N,-,-1,-1
RECMUS.txt,947890,948006,116,5,N,N,-,-1,-1
RECMUS.txt,948009,948103,94,5,N,N,-,-1,-1
RECMUS.txt,948106,948212,106,5,N,N,-,-1,-1
RECMUS.txt,948215,948377,162,5,N,N,-,-1,-1
RECMUS.txt,948378,948435,57,5,N,N,-,-1,-1
RECMUS.txt,948438,948603,165,5,N,N,-,-1,-1
RECMUS.txt,948604,948664,60,5,N,N,-,-1,-1
RECMUS.txt,948665,948813,148,5,N,N,-,-1,-1
RECMUS.txt,948815,948918,103,5,N,N,-,-1,-1
RECMUS.txt,948921,949055,134,5,N,N,-,-1,-1
RECMUS.txt,949056,949183,127,5,N,N,-,-1,-1
RECMUS.txt,949184,949247,63,5,N,N,-,-1,-1
RECMUS.txt,949248,949368,120,5,N,N,-,-1,-1
RECMUS.txt,949369,949475,106,5,N,N,-,-1,-1
RECMUS.txt,949476,949608,132,5,N,N,-,-1,-1
RECMUS.txt,949609,949892,283,5,N,N,-,-1,-1
RECMUS.txt,949895,949979,84,5,N,N,-,-1,-1
RECMUS.txt,949980,950066,86,5,N,N,-,-1,-1
RECMUS.txt,950067,950204,137,5,N,N,-,-1,-1
RECMUS.txt,950207,950456,249,5,N,N,-,-1,-1
RECMUS.txt,950459,950598,139,5,N,N,-,-1,-1
RECMUS.txt,950599,950760,161,5,N,N,-,-1,-1
RECMUS.txt,950761,950861,100,5,N,N,-,-1,-1
RECMUS.txt,950862,950983,121,5,N,N,-,-1,-1
RECMUS.txt,950984,951126,142,5,N,N,-,-1,-1
RECMUS.txt,951129,951253,124,5,N,N,-,-1,-1
RECMUS.txt,951254,951402,148,5,N,N,-,-1,-1
RECMUS.txt,951405,951489,84,5,N,N,-,-1,-1
RECMUS.txt,951490,951686,196,5,N,N,-,-1,-1
RECMUS.txt,951687,951820,133,5,N,N,-,-1,-1
RECMUS.txt,951823,951906,83,5,N,N,-,-1,-1
RECMUS.txt,951907,952042,135,5,N,N,-,-1,-1
RECMUS.txt,952043,952164,121,5,N,N,-,-1,-1
RECMUS.txt,952165,952266,101,5,N,N,-,-1,-1
RECMUS.txt,952269,952351,82,5,N,N,-,-1,-1
RECMUS.txt,952352,952548,196,5,N,N,-,-1,-1
RECMUS.txt,952551,952677,126,5,N,N,-,-1,-1
RECMUS.txt,952678,952799,121,5,N,N,-,-1,-1
RECMUS.txt,952800,952870,70,5,N,N,-,-1,-1
RECMUS.txt,952873,953016,143,5,N,N,-,-1,-1
RECMUS.txt,953017,953178,161,5,N,N,-,-1,-1
RECMUS.txt,953179,953271,92,5,N,N,-,-1,-1
RECMUS.txt,953272,953334,62,5,N,N,-,-1,-1
RECMUS.txt,953335,953438,103,5,N,N,-,-1,-1
RECMUS.txt,953441,953521,80,5,N,N,-,-1,-1
RECMUS.txt,953522,953644,122,5,N,N,-,-1,-1
RECMUS.txt,953647,953829,182,5,N,N,-,-1,-1
RECMUS.txt,953831,953920,89,5,N,N,-,-1,-1
RECMUS.txt,953922,954043,121,5,N,N,-,-1,-1
RECMUS.txt,954045,954134,89,5,N,N,-,-1,-1
RECMUS.txt,954137,954226,89,5,N,N,-,-1,-1
RECMUS.txt,954228,954306,78,5,N,N,-,-1,-1
RECMUS.txt,954308,954414,106,5,N,N,-,-1,-1
RECMUS.txt,954416,954547,131,5,N,N,-,-1,-1
RECMUS.txt,954549,954671,122,5,N,N,-,-1,-1
RECMUS.txt,954673,954783,110,5,N,N,-,-1,-1
RECMUS.txt,954786,954864,78,5,N,N,-,-1,-1
RECMUS.txt,954867,954991,124,5,N,N,-,-1,-1
RECMUS.txt,954994,955092,98,5,N,N,-,-1,-1
RECMUS.txt,955095,955201,106,5,N,N,-,-1,-1
RECMUS.txt,955204,955316,112,5,N,N,-,-1,-1
RECMUS.txt,955319,955466,147,5,N,N,-,-1,-1
RECMUS.txt,955469,955629,160,5,N,N,-,-1,-1
RECMUS.txt,955632,955725,93,5,N,N,-,-1,-1
RECMUS.txt,955728,955879,151,5,N,N,-,-1,-1
RECMUS.txt,955882,956019,137,5,N,N,-,-1,-1
RECMUS.txt,956022,956187,165,5,N,N,-,-1,-1
RECMUS.txt,956189,956399,210,5,N,N,-,-1,-1
RECMUS.txt,956402,956499,97,5,N,N,-,-1,-1
RECMUS.txt,956502,956616,114,5,N,N,-,-1,-1
RECMUS.txt,956619,956713,94,5,N,N,-,-1,-1
RECMUS.txt,956716,956831,115,5,N,N,-,-1,-1
RECMUS.txt,956834,956935,101,5,N,N,-,-1,-1
RECMUS.txt,956937,957032,95,5,N,N,-,-1,-1
RECMUS.txt,957034,957178,144,5,N,N,-,-1,-1
RECMUS.txt,957179,957259,80,5,N,N,-,-1,-1
RECMUS.txt,957262,957343,81,5,N,N,-,-1,-1
RECMUS.txt,957346,957484,138,5,N,N,-,-1,-1
RECMUS.txt,957486,957613,127,5,N,N,-,-1,-1
RECMUS.txt,957615,957721,106,5,N,N,-,-1,-1
RECMUS.txt,957723,957811,88,5,N,N,-,-1,-1
RECMUS.txt,957813,957961,148,5,N,N,-,-1,-1
RECMUS.txt,957963,958099,136,5,N,N,-,-1,-1
RECMUS.txt,958101,958184,83,5,N,N,-,-1,-1
RECMUS.txt,958187,958299,112,5,N,N,-,-1,-1
RECMUS.txt,958301,958422,121,5,N,N,-,-1,-1
RECMUS.txt,958424,958530,106,5,N,N,-,-1,-1
RECMUS.txt,958532,958643,111,5,N,N,-,-1,-1
RECMUS.txt,958645,958743,98,5,N,N,-,-1,-1
RECMUS.txt,958744,958885,141,5,N,N,-,-1,-1
RECMUS.txt,958888,958999,111,5,N,N,-,-1,-1
RECMUS.txt,959002,959119,117,5,N,N,-,-1,-1
RECMUS.txt,959121,959229,108,5,N,N,-,-1,-1
RECMUS.txt,959231,959386,155,5,N,N,-,-1,-1
RECMUS.txt,959387,959468,81,5,N,N,-,-1,-1
RECMUS.txt,959470,959590,120,5,N,N,-,-1,-1
RECMUS.txt,959592,959712,120,5,N,N,-,-1,-1
RECMUS.txt,959714,959805,91,5,N,N,-,-1,-1
RECMUS.txt,959807,959887,80,5,N,N,-,-1,-1
RECMUS.txt,959889,959987,98,5,N,N,-,-1,-1
RECMUS.txt,959989,960109,120,5,N,N,-,-1,-1
RECMUS.txt,960111,960205,94,5,N,N,-,-1,-1
RECMUS.txt,960207,960297,90,5,N,N,-,-1,-1
RECMUS.txt,960299,960378,79,5,N,N,-,-1,-1
RECMUS.txt,960380,960459,79,5,N,N,-,-1,-1
RECMUS.txt,960461,960549,88,5,N,N,-,-1,-1
RECMUS.txt,960552,960697,145,5,N,N,-,-1,-1
RECMUS.txt,960699,960831,132,5,N,N,-,-1,-1
RECMUS.txt,960833,960948,115,5,N,N,-,-1,-1
RECMUS.txt,960950,961035,85,5,N,N,-,-1,-1
RECMUS.txt,961037,961132,95,5,N,N,-,-1,-1
RECMUS.txt,961134,961236,102,5,N,N,-,-1,-1
RECMUS.txt,961238,961353,115,5,N,N,-,-1,-1
RECMUS.txt,961355,961453,98,5,N,N,-,-1,-1
RECMUS.txt,961456,961779,323,5,N,N,-,-1,-1
RECMUS.txt,961780,961923,143,5,N,N,-,-1,-1
RECMUS.txt,961926,962022,96,5,N,N,-,-1,-1
RECMUS.txt,962025,962152,127,5,N,N,-,-1,-1
RECMUS.txt,962153,962246,93,5,N,N,-,-1,-1
RECMUS.txt,962249,962347,98,5,N,N,-,-1,-1
RECMUS.txt,962350,962462,112,5,N,N,-,-1,-1
RECMUS.txt,962465,962550,85,5,N,N,-,-1,-1
RECMUS.txt,962552,962716,164,5,N,N,-,-1,-1
RECMUS.txt,962719,962830,111,5,N,N,-,-1,-1
RECMUS.txt,962832,962928,96,5,N,N,-,-1,-1
RECMUS.txt,962933,963071,138,5,N,N,-,-1,-1
RECMUS.txt,963074,963185,111,5,N,N,-,-1,-1
RECMUS.txt,963188,963283,95,5,N,N,-,-1,-1
RECMUS.txt,963286,963391,105,5,N,N,-,-1,-1
RECMUS.txt,963394,963477,83,5,N,N,-,-1,-1
RECMUS.txt,963479,963565,86,5,N,N,-,-1,-1
RECMUS.txt,963567,963694,127,5,N,N,-,-1,-1
RECMUS.txt,963696,963795,99,5,N,N,-,-1,-1
RECMUS.txt,963797,963883,86,5,N,N,-,-1,-1
RECMUS.txt,963884,963969,85,5,N,N,-,-1,-1
RECMUS.txt,963972,964065,93,5,N,N,-,-1,-1
RECMUS.txt,964067,964170,103,5,N,N,-,-1,-1
RECMUS.txt,964172,964302,130,5,N,N,-,-1,-1
RECMUS.txt,964304,964431,127,5,N,N,-,-1,-1
RECMUS.txt,964434,964524,90,5,N,N,-,-1,-1
RECMUS.txt,964527,964618,91,5,N,N,-,-1,-1
RECMUS.txt,964621,964714,93,5,N,N,-,-1,-1
RECMUS.txt,964717,964913,196,5,N,N,-,-1,-1
RECMUS.txt,964915,965053,138,5,N,N,-,-1,-1
RECMUS.txt,965055,965197,142,5,N,N,-,-1,-1
RECMUS.txt,965199,965303,104,5,N,N,-,-1,-1
RECMUS.txt,965304,965330,26,5,N,N,-,-1,-1
RECMUS.txt,965332,965468,136,5,N,N,-,-1,-1
RECMUS.txt,965471,965584,113,5,N,N,-,-1,-1
RECMUS.txt,965586,965693,107,5,N,N,-,-1,-1
RECMUS.txt,965695,965859,164,5,N,N,-,-1,-1
RECMUS.txt,965864,966038,174,5,N,N,-,-1,-1
RECMUS.txt,966039,966112,73,5,N,N,-,-1,-1
RECMUS.txt,966114,966234,120,5,N,N,-,-1,-1
RECMUS.txt,966236,966348,112,5,N,N,-,-1,-1
RECMUS.txt,966350,966462,112,5,N,N,-,-1,-1
RECMUS.txt,966465,966628,163,5,N,N,-,-1,-1
RECMUS.txt,966630,966718,88,5,N,N,-,-1,-1
RECMUS.txt,966720,966818,98,5,N,N,-,-1,-1
RECMUS.txt,966820,966944,124,5,N,N,-,-1,-1
RECMUS.txt,966946,967052,106,5,N,N,-,-1,-1
RECMUS.txt,967055,967165,110,5,N,N,-,-1,-1
RECMUS.txt,967168,967276,108,5,N,N,-,-1,-1
RECMUS.txt,967281,967377,96,5,N,N,-,-1,-1
RECMUS.txt,967380,967501,121,5,N,N,-,-1,-1
RECMUS.txt,967504,967594,90,5,N,N,-,-1,-1
RECMUS.txt,967596,967714,118,5,N,N,-,-1,-1
RECMUS.txt,967716,967809,93,5,N,N,-,-1,-1
RECOLL.txt,0,629,629,5,N,N,-,-1,-1
RECOLL.txt,632,1439,807,5,N,N,-,-1,-1
RECOLL.txt,1442,2138,696,5,N,N,-,-1,-1
RECOLL.txt,2139,2793,654,5,N,N,-,-1,-1
RECOLL.txt,2794,3692,898,5,N,N,-,-1,-1
RECOLL.txt,3695,4732,1037,5,N,N,-,-1,-1
RECOLL.txt,4735,5038,303,5,N,N,-,-1,-1
RECOLL.txt,5038,5446,408,5,N,N,-,-1,-1
RECOLL.txt,5449,6300,851,5,N,N,-,-1,-1
RECOLL.txt,6301,7429,1128,5,N,N,-,-1,-1
RECOLL.txt,7432,8411,979,5,N,N,-,-1,-1
RECOLL.txt,8412,9517,1105,5,Y,N,-,-1,-1
RECOLL.txt,9518,13721,4203,5,Y,N,-,-1,-1
RECOLL.txt,13722,13940,218,5,N,N,-,-1,-1
RECOLL.txt,13940,14163,223,5,N,N,-,-1,-1
RECOLL.txt,14163,15432,1269,5,N,N,-,-1,-1
RECOLL.txt,15434,16461,1027,5,N,N,-,-1,-1
RECOLL.txt,16463,17038,575,5,N,N,-,-1,-1
RECOLL.txt,17039,17740,701,5,N,N,-,-1,-1
RECOLL.txt,17741,18430,689,5,N,Y,1448997318962,17781,18305
RECOLL.txt,18431,19061,630,5,Y,N,-,-1,-1
RECOLL.txt,19062,19524,462,5,N,N,-,-1,-1
RECOLL.txt,19525,20463,938,5,N,N,-,-1,-1
RECOLL.txt,20466,21357,891,5,N,N,-,-1,-1
RECOLL.txt,21358,22175,817,5,N,N,-,-1,-1
RECOLL.txt,22176,22905,729,5,N,N,-,-1,-1
RECOLL.txt,22906,23566,660,5,N,N,-,-1,-1
RECOLL.txt,23567,24416,849,5,N,N,-,-1,-1
RECOLL.txt,24419,25306,887,5,N,N,-,-1,-1
RECOLL.txt,25307,26285,978,5,N,N,-,-1,-1
RECOLL.txt,26286,27143,857,5,N,N,-,-1,-1
RECOLL.txt,27145,27967,822,5,N,N,-,-1,-1
RECOLL.txt,27968,28429,461,5,N,N,-,-1,-1
RECOLL.txt,28432,29120,688,5,N,N,-,-1,-1
RECOLL.txt,29121,29699,578,5,N,N,-,-1,-1
RECOLL.txt,29700,30151,451,5,N,N,-,-1,-1
RECOLL.txt,30152,30620,468,5,N,N,-,-1,-1
RECOLL.txt,30622,31184,562,5,N,N,-,-1,-1
RECOLL.txt,31185,31674,489,5,N,Y,1449564497346,31421,33114
RECOLL.txt,31675,32080,405,5,N,Y,1449564497346,31421,33114
RECOLL.txt,32081,32692,611,5,N,Y,1449564497346,31421,33114
RECOLL.txt,32693,33397,704,5,N,Y,1449564497346,31421,33114
RECOLL.txt,33399,34018,619,5,N,N,-,-1,-1
RECOLL.txt,34019,35045,1026,5,N,Y,1449564002703,34459,35028
RECOLL.txt,35048,35634,586,5,N,Y,1449564936771,35046,35717
RECOLL.txt,35635,36927,1292,5,Y,Y,1449564936771,35046,35717
RECOLL.txt,36930,37486,556,5,N,N,-,-1,-1
RECOLL.txt,37491,38229,738,5,Y,Y,1449565237768,37503,38152
RECOLL.txt,38231,38957,726,5,N,N,-,-1,-1
RECOLL.txt,38958,39348,390,5,N,N,-,-1,-1
RECOLL.txt,39349,40102,753,5,N,Y,1449565481530,39801,40627
RECOLL.txt,40105,40906,801,5,N,Y,1449565481530,39801,40627
RECOLL.txt,40908,41513,605,5,N,N,-,-1,-1
RECOLL.txt,41514,42016,502,5,N,N,-,-1,-1
RECOLL.txt,42017,42837,820,5,N,N,-,-1,-1
RECOLL.txt,42838,43276,438,5,N,N,-,-1,-1
RECOLL.txt,43277,43900,623,5,N,N,-,-1,-1
RECOLL.txt,43902,44272,370,5,N,N,-,-1,-1
RECOLL.txt,44273,44605,332,5,N,N,-,-1,-1
RECOLL.txt,44607,45225,618,5,N,N,-,-1,-1
RECOLL.txt,45226,46226,1000,5,N,N,-,-1,-1
RECOLL.txt,46227,46944,717,5,N,N,-,-1,-1
RECOLL.txt,46945,47380,435,5,N,N,-,-1,-1
RECOLL.txt,47381,48216,835,5,N,Y,1449566012674,47822,49423
RECOLL.txt,48217,48780,563,5,N,Y,1449566012674,47822,49423
RECOLL.txt,48781,49432,651,5,N,Y,1449566012674,47822,49423
RECOLL.txt,49435,50040,605,5,N,N,-,-1,-1
RECOLL.txt,50041,50623,582,5,N,N,-,-1,-1
RECOLL.txt,50624,51332,708,5,N,N,-,-1,-1
RECOLL.txt,51337,52154,817,5,Y,Y,1449566376755,51356,52539
RECOLL.txt,52155,52686,531,5,N,Y,1449566376755,51356,52539
RECOLL.txt,52687,53697,1010,5,N,Y,1449566781717,52623,55207
RECOLL.txt,53702,54390,688,5,N,Y,1449566781717,52623,55207
RECOLL.txt,54391,55361,970,5,N,Y,1449566781717,52623,55207
RECOLL.txt,55363,55895,532,5,N,N,-,-1,-1
RECOLL.txt,55898,56476,578,5,N,N,-,-1,-1
RECOLL.txt,56477,57295,818,5,N,N,-,-1,-1
RECOLL.txt,57297,57996,699,5,N,Y,1449567312089,57825,59193
RECOLL.txt,57998,58793,795,5,Y,Y,1449567312089,57825,59193
RECOLL.txt,58794,59273,479,5,Y,Y,1449567312089,57825,59193
RECOLL.txt,59274,59751,477,5,N,N,-,-1,-1
RECOLL.txt,59752,60446,694,5,N,N,-,-1,-1
RECOLL.txt,60447,60945,498,5,N,N,-,-1,-1
RECOLL.txt,60948,61681,733,5,N,N,-,-1,-1
RECOLL.txt,61684,62528,844,5,N,N,-,-1,-1
RECOLL.txt,62531,63615,1084,5,N,N,-,-1,-1
RECOLL.txt,63616,64091,475,5,N,Y,1449604006516,63836,64388
RECOLL.txt,64092,64847,755,5,N,Y,1449604006516,63836,64388
RECOLL.txt,64848,65352,504,5,N,Y,1449604885298,64679,65628
RECOLL.txt,65353,66191,838,5,N,Y,1449604885298,64679,65628
RECOLL.txt,66192,66372,180,5,N,N,-,-1,-1
RECOLL.txt,66373,66690,317,5,N,N,-,-1,-1
RECOLL.txt,66693,67001,308,5,N,Y,1449605311607,66740,67367
RECOLL.txt,67004,67624,620,5,N,Y,1449605311607,66740,67367
RECOLL.txt,67625,68239,614,5,N,N,-,-1,-1
RECOLL.txt,68240,68701,461,5,N,N,-,-1,-1
RECOLL.txt,68702,69750,1048,5,Y,Y,1449605831232,69255,71638
RECOLL.txt,69753,70094,341,5,N,Y,1449605831232,69255,71638
RECOLL.txt,70095,70481,386,5,N,Y,1449605831232,69255,71638
RECOLL.txt,70482,71020,538,5,N,Y,1449605831232,69255,71638
RECOLL.txt,71021,71666,645,5,N,Y,1449605831232,69255,71638
RECOLL.txt,71669,72055,386,5,N,Y,1449606203855,71875,72052
RECOLL.txt,72056,72417,361,5,N,N,-,-1,-1
RECOLL.txt,72418,72488,70,5,N,N,-,-1,-1
RECOLL.txt,72489,72621,132,5,N,N,-,-1,-1
RECOLL.txt,72623,72777,154,5,N,N,-,-1,-1
RECOLL.txt,72778,72838,60,5,N,N,-,-1,-1
RECOLL.txt,72840,73189,349,5,N,N,-,-1,-1
RECOLL.txt,73190,73625,435,5,N,N,-,-1,-1
RECOLL.txt,73626,74105,479,5,N,N,-,-1,-1
RECOLL.txt,74108,74806,698,5,N,N,-,-1,-1
RECOLL.txt,74807,75493,686,5,N,Y,1449606753172,75354,75839
RECOLL.txt,75494,75910,416,5,N,Y,1449606753172,75354,75839
RECOLL.txt,75911,76842,931,5,N,N,-,-1,-1
RECOLL.txt,76845,77376,531,5,N,Y,1449607148586,77156,77751
RECOLL.txt,77378,77973,595,5,N,Y,1449607148586,77156,77751
RECOLL.txt,77975,78713,738,5,N,N,-,-1,-1
RECOLL.txt,78714,79405,691,5,N,N,-,-1,-1
RECOLL.txt,79406,80246,840,5,N,N,-,-1,-1
RECOLL.txt,80247,80859,612,5,N,N,-,-1,-1
RECOLL.txt,80861,81491,630,5,Y,Y,1450194336026,81036,82029
RECOLL.txt,81494,82275,781,5,N,Y,1450194336026,81036,82029
RECOLL.txt,82276,83023,747,5,Y,Y,1450194570552,82429,82700
RECOLL.txt,83024,83661,637,5,N,Y,1450194991609,83440,83936
RECOLL.txt,83662,84343,681,5,N,Y,1450194991609,83440,83936
RECOLL.txt,84345,84858,513,5,N,N,-,-1,-1
RECOLL.txt,84859,85386,527,5,N,N,-,-1,-1
RECOLL.txt,85389,85940,551,5,N,Y,1450195763304,85744,87933
RECOLL.txt,85941,86886,945,5,N,Y,1450195763304,85744,87933
RECOLL.txt,86887,87549,662,5,N,Y,1450195763304,85744,87933
RECOLL.txt,87550,88274,724,5,N,Y,1450195763304,85744,87933
RECOLL.txt,88275,89069,794,5,N,N,-,-1,-1
RECOLL.txt,89070,89587,517,5,N,Y,1450196241886,89386,90252
RECOLL.txt,89588,90153,565,5,N,Y,1450196241886,89386,90252
RECOLL.txt,90154,90662,508,5,N,Y,1450196241886,89386,90252
RECOLL.txt,90663,90972,309,5,N,N,-,-1,-1
RECOLL.txt,90973,91059,86,5,N,N,-,-1,-1
RECOLL.txt,91062,91117,55,5,N,N,-,-1,-1
RECOLL.txt,91118,91224,106,5,N,N,-,-1,-1
RECOLL.txt,91225,91305,80,5,N,N,-,-1,-1
RECOLL.txt,91306,91634,328,5,N,N,-,-1,-1
RECOLL.txt,91635,92272,637,5,N,Y,1450196550118,92044,92813
RECOLL.txt,92273,92874,601,5,N,Y,1450196550118,92044,92813
RECOLL.txt,92877,93684,807,5,Y,Y,1450196865042,92875,93368
RECOLL.txt,93689,94493,804,5,N,N,-,-1,-1
RECOLL.txt,94494,95263,769,5,N,N,-,-1,-1
RECOLL.txt,95266,95771,505,5,N,N,-,-1,-1
RECOLL.txt,95774,96686,912,5,N,N,-,-1,-1
RECOLL.txt,96687,97351,664,5,N,Y,1450197272502,97289,98405
RECOLL.txt,97354,98097,743,5,N,Y,1450197272502,97289,98405
RECOLL.txt,98098,98767,669,5,N,Y,1450197272502,97289,98405
RECOLL.txt,98770,99383,613,5,N,Y,1450197570280,99142,100029
RECOLL.txt,99384,100173,789,5,Y,Y,1450197827406,100079,100567
RECOLL.txt,100174,100999,825,5,N,Y,1450197827406,100079,100567
RECOLL.txt,101002,101690,688,5,N,N,-,-1,-1
RECOLL.txt,101691,102440,749,5,N,Y,1450198228374,101899,104222
RECOLL.txt,102441,103774,1333,5,N,Y,1450198228374,101899,104222
RECOLL.txt,103776,104390,614,5,N,Y,1450198228374,101899,104222
RECOLL.txt,104392,104860,468,5,N,N,-,-1,-1
RECOLL.txt,104863,105525,662,5,N,N,-,-1,-1
RECOLL.txt,105526,106198,672,5,N,Y,1450198608392,105951,106876
RECOLL.txt,106199,106989,790,5,N,Y,1450198608392,105951,106876
RECOLL.txt,106990,107447,457,5,N,Y,1450198899921,107006,107437
RECOLL.txt,107450,107766,316,5,N,Y,1450207819934,107711,108666
RECOLL.txt,107769,108489,720,5,N,Y,1450207819934,107711,108666
RECOLL.txt,108491,108941,450,5,N,Y,1450209381136,108935,109356
RECOLL.txt,108943,109478,535,5,N,Y,1450209381136,108935,109356
RECOLL.txt,109483,110152,669,5,N,Y,1450210289855,109766,110720
RECOLL.txt,110153,111014,861,5,N,Y,1450210289855,109766,110720
RECOLL.txt,111016,111659,643,5,N,N,-,-1,-1
RECOLL.txt,111660,112283,623,5,N,N,-,-1,-1
RECOLL.txt,112284,113168,884,5,N,N,-,-1,-1
RECOLL.txt,113169,114218,1049,5,N,N,-,-1,-1
RECOLL.txt,114219,115239,1020,5,N,N,-,-1,-1
RECOLL.txt,115240,115911,671,5,N,Y,1450211094623,115807,116651
RECOLL.txt,115914,116562,648,5,N,Y,1450211094623,115807,116651
RECOLL.txt,116563,117016,453,5,N,Y,1450212524850,116654,117006
RECOLL.txt,117019,117592,573,5,N,N,-,-1,-1
RECOLL.txt,117595,118111,516,5,N,N,-,-1,-1
RECOLL.txt,118114,119146,1032,5,N,N,-,-1,-1
RECOLL.txt,119147,119687,540,5,N,N,-,-1,-1
RECOLL.txt,119688,120301,613,5,N,Y,1450213154792,119938,120294
RECOLL.txt,120304,120921,617,5,N,Y,1450213702221,120415,120909
RECOLL.txt,120924,121327,403,5,N,Y,1450214083353,120984,121752
RECOLL.txt,121328,121822,494,5,N,Y,1450214083353,120984,121752
RECOLL.txt,121823,122335,512,5,N,Y,1450214856877,122255,122760
RECOLL.txt,122336,123062,726,5,N,Y,1450214856877,122255,122760
RECOLL.txt,123063,123744,681,5,N,N,-,-1,-1
RECOLL.txt,123747,123829,82,5,N,N,-,-1,-1
RECOLL.txt,123832,123984,152,5,N,N,-,-1,-1
RECOLL.txt,123985,124082,97,5,N,N,-,-1,-1
RECOLL.txt,124083,124710,627,5,N,N,-,-1,-1
RECOLL.txt,124711,125256,545,5,N,N,-,-1,-1
RECOLL.txt,125257,125913,656,5,N,Y,1450215357428,125505,126500
RECOLL.txt,125916,126510,594,5,N,Y,1450215357428,125505,126500
RECOLL.txt,126513,127300,787,5,N,N,-,-1,-1
RECOLL.txt,127303,128141,838,5,N,N,-,-1,-1
RECOLL.txt,128142,128948,806,5,N,Y,1450215778344,128744,129064
RECOLL.txt,128949,129471,522,5,N,Y,1450215778344,128744,129064
RECOLL.txt,129472,130166,694,5,N,Y,1450216584529,129077,130051
RECOLL.txt,130167,131040,873,5,N,N,-,-1,-1
RECOLL.txt,131041,131782,741,5,N,N,-,-1,-1
RECOLL.txt,131783,132736,953,5,N,Y,1450217142535,132155,132920
RECOLL.txt,132739,133429,690,5,N,Y,1450217142535,132155,132920
RECOLL.txt,133432,134159,727,5,N,N,-,-1,-1
RECOLL.txt,134162,135025,863,5,N,N,-,-1,-1
RECOLL.txt,135026,135486,460,5,N,N,-,-1,-1
RECOLL.txt,135489,136221,732,5,N,N,-,-1,-1
RECOLL.txt,136222,136832,610,5,N,N,-,-1,-1
RECOLL.txt,136834,137256,422,5,N,N,-,-1,-1
RECOLL.txt,137257,138238,981,5,N,Y,1450265940821,137499,138662
RECOLL.txt,138240,138869,629,5,N,Y,1450265940821,137499,138662
RECOLL.txt,138872,139334,462,5,N,N,-,-1,-1
RECOLL.txt,139335,140030,695,5,N,N,-,-1,-1
RECOLL.txt,140031,140818,787,5,N,N,-,-1,-1
RECOLL.txt,140820,141258,438,5,N,N,-,-1,-1
RECOLL.txt,141261,141802,541,5,N,N,-,-1,-1
RECOLL.txt,141803,142418,615,5,N,N,-,-1,-1
RECOLL.txt,142421,143077,656,5,N,N,-,-1,-1
RECOLL.txt,143078,143409,331,5,N,N,-,-1,-1
RECOLL.txt,143410,144410,1000,5,N,N,-,-1,-1
RECOLL.txt,144413,145014,601,5,N,N,-,-1,-1
RECOLL.txt,145019,145511,492,5,N,N,-,-1,-1
RECOLL.txt,145512,146494,982,5,N,N,-,-1,-1
RECOLL.txt,146495,147099,604,5,N,N,-,-1,-1
RECOLL.txt,147100,147706,606,5,N,N,-,-1,-1
RECOLL.txt,147707,148035,328,5,N,N,-,-1,-1
RECOLL.txt,148036,148848,812,5,N,N,-,-1,-1
RECOLL.txt,148851,149395,544,5,N,N,-,-1,-1
RECOLL.txt,149400,150267,867,5,N,Y,1450266255219,149476,150064
RECOLL.txt,150268,150719,451,5,N,N,-,-1,-1
RECOLL.txt,150720,151340,620,5,N,N,-,-1,-1
RECOLL.txt,151341,152064,723,5,N,N,-,-1,-1
RECOLL.txt,152065,152643,578,5,N,N,-,-1,-1
RECOLL.txt,152644,153268,624,5,N,N,-,-1,-1
RECOLL.txt,153269,154217,948,5,N,N,-,-1,-1
RECOLL.txt,154218,154843,625,5,N,N,-,-1,-1
RECOLL.txt,154845,155800,955,5,N,Y,1450266659853,155779,156351
RECOLL.txt,155801,156444,643,5,N,Y,1450266659853,155779,156351
RECOLL.txt,156446,156945,499,5,N,N,-,-1,-1
RECOLL.txt,156946,157592,646,5,N,N,-,-1,-1
RECOLL.txt,157595,158790,1195,5,N,Y,1450267181437,158411,159424
RECOLL.txt,158791,159215,424,5,N,Y,1450267181437,158411,159424
RECOLL.txt,159217,159566,349,5,N,Y,1450267181437,158411,159424
RECOLL.txt,159567,159997,430,5,N,N,-,-1,-1
RECOLL.txt,159998,160333,335,5,N,N,-,-1,-1
RECOLL.txt,160336,161720,1384,5,N,Y,1450267451569,160340,162732
RECOLL.txt,161721,162425,704,5,N,Y,1450267451569,160340,162732
RECOLL.txt,162426,163142,716,5,N,Y,1450268185046,162966,163418
RECOLL.txt,163144,163828,684,5,N,Y,1450268185046,162966,163418
RECOLL.txt,163831,164679,848,5,N,Y,1450268661242,163528,164918
RECOLL.txt,164682,165379,697,5,N,Y,1450268661242,163528,164918
RECOLL.txt,165380,165559,179,5,N,N,-,-1,-1
RECOLL.txt,165560,166211,651,5,N,N,-,-1,-1
RECOLL.txt,166214,167064,850,5,N,N,-,-1,-1
RECOLL.txt,167065,168016,951,5,N,N,-,-1,-1
RECOLL.txt,168019,169031,1012,5,N,N,-,-1,-1
RECOLL.txt,169032,169513,481,5,N,Y,1450268978542,169359,170509
RECOLL.txt,169514,170079,565,5,N,Y,1450268978542,169359,170509
RECOLL.txt,170080,170646,566,5,N,Y,1450268978542,169359,170509
RECOLL.txt,170649,171305,656,5,N,N,-,-1,-1
RECOLL.txt,171307,171885,578,5,N,N,-,-1,-1
RECOLL.txt,171886,172534,648,5,N,N,-,-1,-1
RECOLL.txt,172535,173058,523,5,N,N,-,-1,-1
RECOLL.txt,173061,173990,929,5,N,N,-,-1,-1
RECOLL.txt,173991,174560,569,5,N,N,-,-1,-1
RECOLL.txt,174561,175457,896,5,N,Y,1450269524213,175141,176459
RECOLL.txt,175458,176075,617,5,N,Y,1450269524213,175141,176459
RECOLL.txt,176076,176828,752,5,N,Y,1450272604542,176533,177646
RECOLL.txt,176829,177800,971,5,N,Y,1450272604542,176533,177646
RECOLL.txt,177801,178569,768,5,N,N,-,-1,-1
RECOLL.txt,178570,179171,601,5,N,Y,1450273026631,178707,180918
RECOLL.txt,179172,179603,431,5,N,Y,1450273026631,178707,180918
RECOLL.txt,179604,179921,317,5,N,Y,1450273026631,178707,180918
RECOLL.txt,179922,180406,484,5,N,Y,1450273026631,178707,180918
RECOLL.txt,180409,180923,514,5,N,Y,1450273026631,178707,180918
RECOLL.txt,180926,181780,854,5,N,Y,1450273354749,181694,182351
RECOLL.txt,181782,182241,459,5,N,Y,1450273354749,181694,182351
RECOLL.txt,182242,182990,748,5,N,Y,1450273354749,181694,182351
RECOLL.txt,182991,183665,674,5,N,N,-,-1,-1
RECOLL.txt,183668,184541,873,5,N,Y,1450273729052,184450,185295
RECOLL.txt,184544,185004,460,5,N,Y,1450273729052,184450,185295
RECOLL.txt,185007,185861,854,5,N,Y,1450273729052,184450,185295
RECOLL.txt,185863,186278,415,5,N,Y,1450273943006,185542,186034
RECOLL.txt,186279,186963,684,5,N,N,-,-1,-1
RECOLL.txt,186964,187298,334,5,N,N,-,-1,-1
RECOLL.txt,187299,188087,788,5,N,N,-,-1,-1
RECOLL.txt,188088,188628,540,5,N,N,-,-1,-1
RECOLL.txt,188629,189120,491,5,N,N,-,-1,-1
RECOLL.txt,189121,189844,723,5,N,N,-,-1,-1
RECOLL.txt,189845,190511,666,5,N,N,-,-1,-1
RECOLL.txt,190513,191253,740,5,N,Y,1450274247305,190587,191139
RECOLL.txt,191256,191919,663,5,N,N,-,-1,-1
RECOLL.txt,191921,192888,967,5,N,Y,1450274641828,192265,194302
RECOLL.txt,192889,193237,348,5,N,Y,1450274641828,192265,194302
RECOLL.txt,193238,194177,939,5,N,Y,1450274641828,192265,194302
RECOLL.txt,194178,194563,385,5,N,Y,1450274641828,192265,194302
RECOLL.txt,194568,195230,662,5,N,N,-,-1,-1
RECOLL.txt,195233,195612,379,5,N,N,-,-1,-1
RECOLL.txt,195617,195992,375,5,N,N,-,-1,-1
RECOLL.txt,195993,196546,553,5,N,N,-,-1,-1
RECOLL.txt,196547,197151,604,5,N,N,-,-1,-1
RECOLL.txt,197152,198206,1054,5,N,N,-,-1,-1
RECOLL.txt,198208,198682,474,5,N,Y,1450276878994,198569,198873
RECOLL.txt,198683,199309,626,5,N,Y,1450276878994,198569,198873
RECOLL.txt,199310,200093,783,5,N,Y,1450277256048,200011,201853
RECOLL.txt,200095,200708,613,5,N,Y,1450277256048,200011,201853
RECOLL.txt,200709,201106,397,5,N,Y,1450277256048,200011,201853
RECOLL.txt,201107,201596,489,5,N,Y,1450277256048,200011,201853
RECOLL.txt,201598,202345,747,5,N,Y,1450278260874,201966,203744
RECOLL.txt,202346,202761,415,5,N,Y,1450278260874,201966,203744
RECOLL.txt,202764,203529,765,5,N,Y,1450278260874,201966,203744
RECOLL.txt,203530,204073,543,5,N,Y,1450278260874,201966,203744
RECOLL.txt,204074,204493,419,5,N,Y,1450278710609,204409,206093
RECOLL.txt,204494,205439,945,5,N,Y,1450278710609,204409,206093
RECOLL.txt,205440,205969,529,5,N,Y,1450278710609,204409,206093
RECOLL.txt,205972,206787,815,5,N,Y,1450278710609,204409,206093
RECOLL.txt,206790,207423,633,5,N,N,-,-1,-1
RECOLL.txt,207426,207863,437,5,N,Y,1450278992417,207433,208043
RECOLL.txt,207866,208577,711,5,N,Y,1450278992417,207433,208043
RECOLL.txt,208582,209245,663,5,N,N,-,-1,-1
RECOLL.txt,209248,209734,486,5,N,N,-,-1,-1
RECOLL.txt,209736,210190,454,5,N,N,-,-1,-1
RECOLL.txt,210192,210600,408,5,N,N,-,-1,-1
RECOLL.txt,210603,211346,743,5,N,N,-,-1,-1
RECOLL.txt,211347,211889,542,5,N,N,-,-1,-1
RECOLL.txt,211890,212356,466,5,N,N,-,-1,-1
RECOLL.txt,212357,212934,577,5,N,N,-,-1,-1
RECOLL.txt,212935,213913,978,5,N,N,-,-1,-1
RECOLL.txt,213915,214388,473,5,N,N,-,-1,-1
RECOLL.txt,214389,215531,1142,5,N,N,-,-1,-1
RECOLL.txt,215532,216275,743,5,N,N,-,-1,-1
RECOLL.txt,216277,217239,962,5,N,N,-,-1,-1
RECOLL.txt,217242,217884,642,5,N,Y,1450279453888,217252,218068
RECOLL.txt,217885,218745,860,5,N,Y,1450279453888,217252,218068
RECOLL.txt,218746,219510,764,5,N,N,-,-1,-1
RECOLL.txt,219511,220502,991,5,N,Y,1450279955242,219797,222549
RECOLL.txt,220505,221527,1022,5,N,Y,1450279955242,219797,222549
RECOLL.txt,221530,222454,924,5,N,Y,1450279955242,219797,222549
RECOLL.txt,222455,223226,771,5,N,Y,1450279955242,219797,222549
RECOLL.txt,223229,223881,652,5,N,N,-,-1,-1
RECOLL.txt,223882,224003,121,5,N,N,-,-1,-1
RECOLL.txt,224006,224160,154,5,N,N,-,-1,-1
RECOLL.txt,224161,224835,674,5,N,N,-,-1,-1
RECOLL.txt,224838,225541,703,5,N,N,-,-1,-1
RECOLL.txt,225542,226286,744,5,N,N,-,-1,-1
RECOLL.txt,226288,226786,498,5,N,N,-,-1,-1
RECOLL.txt,226787,227190,403,5,N,N,-,-1,-1
RECOLL.txt,227191,228055,864,5,N,N,-,-1,-1
RECOLL.txt,228056,228884,828,5,N,N,-,-1,-1
RECOLL.txt,228887,229308,421,5,N,N,-,-1,-1
RECOLL.txt,229309,229898,589,5,N,N,-,-1,-1
RECOLL.txt,229899,230526,627,5,N,N,-,-1,-1
RECOLL.txt,230529,231326,797,5,N,N,-,-1,-1
RECOLL.txt,231327,231889,562,5,N,N,-,-1,-1
RECOLL.txt,231890,232655,765,5,N,N,-,-1,-1
RECOLL.txt,232656,233254,598,5,N,N,-,-1,-1
RECOLL.txt,233255,233852,597,5,N,N,-,-1,-1
RECOLL.txt,233853,235072,1219,5,N,N,-,-1,-1
RECOLL.txt,235073,235952,879,5,N,N,-,-1,-1
RECOLL.txt,235953,236373,420,5,N,N,-,-1,-1
RECOLL.txt,236375,237246,871,5,N,N,-,-1,-1
RECOLL.txt,237247,237946,699,5,N,N,-,-1,-1
RECOLL.txt,237947,238667,720,5,N,N,-,-1,-1
RECOLL.txt,238669,239285,616,5,N,N,-,-1,-1
RECOLL.txt,239286,239853,567,5,N,N,-,-1,-1
RECOLL.txt,239854,240610,756,5,N,Y,1450280377959,240537,241310
RECOLL.txt,240611,241569,958,5,Y,Y,1450280673034,241380,241838
RECOLL.txt,241570,242286,716,5,N,Y,1450280673034,241380,241838
RECOLL.txt,242287,242855,568,5,N,N,-,-1,-1
RECOLL.txt,242858,244358,1500,5,Y,Y,1450281212744,242862,245207
RECOLL.txt,244359,244846,487,5,N,Y,1450281212744,242862,245207
RECOLL.txt,244847,245473,626,5,N,Y,1450281212744,242862,245207
RECOLL.txt,245474,246132,658,5,N,N,-,-1,-1
RECOLL.txt,246137,246530,393,5,N,N,-,-1,-1
RECOLL.txt,246531,246876,345,5,N,N,-,-1,-1
RECOLL.txt,246877,247006,129,5,N,N,-,-1,-1
RECOLL.txt,247007,247133,126,5,N,N,-,-1,-1
RECOLL.txt,247134,247344,210,5,N,N,-,-1,-1
RECOLL.txt,247347,247389,42,5,N,N,-,-1,-1
RECOLL.txt,247392,247537,145,5,N,N,-,-1,-1
RECOLL.txt,247540,247708,168,5,N,N,-,-1,-1
RECOLL.txt,247709,248299,590,5,N,N,-,-1,-1
RECOLL.txt,248302,248982,680,5,N,Y,1450281669613,248365,249575
RECOLL.txt,248983,249607,624,5,N,Y,1450281669613,248365,249575
RECOLL.txt,249610,250425,815,5,N,N,-,-1,-1
RECOLL.txt,250428,251227,799,5,Y,Y,1450281882861,250970,251409
RECOLL.txt,251228,251677,449,5,N,Y,1450281882861,250970,251409
RECOLL.txt,251680,252438,758,5,Y,Y,1450282101282,251678,252272
RECOLL.txt,252439,253265,826,5,N,N,-,-1,-1
RECOLL.txt,253266,254391,1125,5,N,N,-,-1,-1
RECOLL.txt,254394,255113,719,5,N,N,-,-1,-1
RECOLL.txt,255114,255723,609,5,N,Y,1449243316327,255345,255936
RECOLL.txt,255725,256514,789,5,N,Y,1449243316327,255345,255936
RECOLL.txt,256515,257487,972,5,N,N,-,-1,-1
RECOLL.txt,257488,258034,546,5,N,N,-,-1,-1
RECOLL.txt,258035,258520,485,5,N,Y,1449477805345,258325,259491
RECOLL.txt,258521,258942,421,5,N,Y,1449477805345,258325,259491
RECOLL.txt,258943,259516,573,5,N,Y,1449477805345,258325,259491
RECOLL.txt,259521,260201,680,5,N,N,-,-1,-1
RECOLL.txt,260202,261032,830,5,N,N,-,-1,-1
RECOLL.txt,261035,262261,1226,5,N,N,-,-1,-1
RECOLL.txt,262262,262753,491,5,N,N,-,-1,-1
RECOLL.txt,262754,263349,595,5,N,N,-,-1,-1
RECOLL.txt,263351,264017,666,5,N,N,-,-1,-1
RECOLL.txt,264020,264533,513,5,N,N,-,-1,-1
RECOLL.txt,264534,265178,644,5,N,N,-,-1,-1
RECOLL.txt,265179,265662,483,5,N,Y,1449478274965,265280,265790
RECOLL.txt,265663,266169,506,5,N,Y,1449478274965,265280,265790
RECOLL.txt,266170,266643,473,5,N,N,-,-1,-1
RECOLL.txt,266644,267145,501,5,N,N,-,-1,-1
RECOLL.txt,267146,267802,656,5,N,N,-,-1,-1
RECOLL.txt,267803,268705,902,5,N,N,-,-1,-1
RECOLL.txt,268708,269494,786,5,N,N,-,-1,-1
RECOLL.txt,269495,270106,611,5,N,N,-,-1,-1
RECOLL.txt,270107,270585,478,5,N,N,-,-1,-1
RECOLL.txt,270586,271130,544,5,N,N,-,-1,-1
RECOLL.txt,271131,271769,638,5,N,N,-,-1,-1
RECOLL.txt,271770,272414,644,5,N,Y,1449478691795,272071,273405
RECOLL.txt,272415,273199,784,5,N,Y,1449478691795,272071,273405
RECOLL.txt,273200,274092,892,5,N,Y,1449478691795,272071,273405
RECOLL.txt,274093,274727,634,5,N,N,-,-1,-1
RECOLL.txt,274728,275979,1251,5,N,N,-,-1,-1
RECOLL.txt,275980,276815,835,5,N,N,-,-1,-1
RECOLL.txt,276816,277861,1045,5,N,N,-,-1,-1
RECOLL.txt,277864,278509,645,5,N,Y,1449478940431,277862,278041
RECOLL.txt,278512,279414,902,5,N,Y,1449479202651,279288,279481
RECOLL.txt,279415,280688,1273,5,N,Y,1449479202651,279288,279481
RECOLL.txt,280691,281381,690,5,N,N,-,-1,-1
RECOLL.txt,281382,281948,566,5,N,N,-,-1,-1
RECOLL.txt,281949,282601,652,5,N,N,-,-1,-1
RECOLL.txt,282604,283754,1150,5,N,N,-,-1,-1
RECOLL.txt,283756,284313,557,5,N,N,-,-1,-1
RECOLL.txt,284314,284730,416,5,N,N,-,-1,-1
RECOLL.txt,284732,285140,408,5,N,N,-,-1,-1
RECOLL.txt,285141,285785,644,5,N,N,-,-1,-1
RECOLL.txt,285786,286447,661,5,N,N,-,-1,-1
RECOLL.txt,286448,287150,702,5,N,N,-,-1,-1
RECOLL.txt,287151,287873,722,5,N,N,-,-1,-1
RECOLL.txt,287876,288666,790,5,N,Y,1449479515559,287879,288347
RECOLL.txt,288669,289114,445,5,N,Y,1449479752042,288402,288873
RECOLL.txt,289115,289617,502,5,N,N,-,-1,-1
RECOLL.txt,289618,290031,413,5,N,Y,1449479980197,289681,290130
RECOLL.txt,290032,290698,666,5,N,Y,1449479980197,289681,290130
RECOLL.txt,290703,291306,603,5,N,N,-,-1,-1
RECOLL.txt,291307,292033,726,5,N,N,-,-1,-1
RECOLL.txt,292034,292796,762,5,N,N,-,-1,-1
RECOLL.txt,292797,293247,450,5,N,N,-,-1,-1
RECOLL.txt,293248,293939,691,5,N,N,-,-1,-1
RECOLL.txt,293939,294412,473,5,N,Y,1449480291305,294170,295182
RECOLL.txt,294413,295184,771,5,N,Y,1449480291305,294170,295182
RECOLL.txt,295187,295705,518,5,N,N,-,-1,-1
RECOLL.txt,295706,296191,485,5,N,Y,1449480505835,295854,296393
RECOLL.txt,296192,296624,432,5,N,Y,1449480505835,295854,296393
RECOLL.txt,296627,297273,646,5,N,N,-,-1,-1
RECOLL.txt,297274,297775,501,5,N,Y,1449480881121,297386,298052
RECOLL.txt,297776,298233,457,5,N,Y,1449480881121,297386,298052
RECOLL.txt,298236,299039,803,5,N,N,-,-1,-1
RECOLL.txt,299040,299581,541,5,N,N,-,-1,-1
RECOLL.txt,299582,300134,552,5,N,N,-,-1,-1
RECOLL.txt,300135,300969,834,5,N,Y,1450284116337,300339,301692
RECOLL.txt,300971,301466,495,5,N,Y,1450284116337,300339,301692
RECOLL.txt,301467,302205,738,5,N,Y,1450284116337,300339,301692
RECOLL.txt,302208,303020,812,5,N,N,-,-1,-1
RECOLL.txt,303021,303388,367,5,N,N,-,-1,-1
RECOLL.txt,303389,304261,872,5,N,N,-,-1,-1
RECOLL.txt,304262,304843,581,5,N,N,-,-1,-1
RECOLL.txt,304846,305548,702,5,N,N,-,-1,-1
RECOLL.txt,305551,306420,869,5,N,N,-,-1,-1
RECOLL.txt,306421,306943,522,5,N,N,-,-1,-1
RECOLL.txt,306944,307749,805,5,N,Y,1450350186677,307230,309481
RECOLL.txt,307750,308232,482,5,N,Y,1450350186677,307230,309481
RECOLL.txt,308233,309078,845,5,N,Y,1450350186677,307230,309481
RECOLL.txt,309079,309657,578,5,N,Y,1450350186677,307230,309481
RECOLL.txt,309658,310190,532,5,N,Y,1450350675404,309528,311486
RECOLL.txt,310191,310728,537,5,N,Y,1450350675404,309528,311486
RECOLL.txt,310729,311364,635,5,N,Y,1450350675404,309528,311486
RECOLL.txt,311366,311897,531,5,N,Y,1450350675404,309528,311486
RECOLL.txt,311898,312478,580,5,N,N,-,-1,-1
RECOLL.txt,312479,313198,719,5,N,N,-,-1,-1
RECOLL.txt,313199,313835,636,5,N,N,-,-1,-1
RECOLL.txt,313838,314573,735,5,N,N,-,-1,-1
RECOLL.txt,314574,314970,396,5,N,N,-,-1,-1
RECOLL.txt,314975,315904,929,5,N,N,-,-1,-1
RECOLL.txt,315905,316616,711,5,N,Y,1450350993349,315954,316737
RECOLL.txt,316619,317207,588,5,N,Y,1450350993349,315954,316737
RECOLL.txt,317209,317561,352,5,N,N,-,-1,-1
RECOLL.txt,317562,318353,791,5,N,N,-,-1,-1
RECOLL.txt,318354,319190,836,5,N,N,-,-1,-1
RECOLL.txt,319192,319929,737,5,N,Y,1450351323826,319770,320896
RECOLL.txt,319930,320916,986,5,N,Y,1450351323826,319770,320896
RECOLL.txt,320921,321780,859,5,N,N,-,-1,-1
RECOLL.txt,321781,322492,711,5,N,N,-,-1,-1
RECOLL.txt,322495,323254,759,5,N,N,-,-1,-1
RECOLL.txt,323255,323813,558,5,N,N,-,-1,-1
RECOLL.txt,323814,324770,956,5,N,N,-,-1,-1
RECOLL.txt,324771,325552,781,5,N,N,-,-1,-1
RECOLL.txt,325553,326189,636,5,N,N,-,-1,-1
RECOLL.txt,326190,326947,757,5,N,N,-,-1,-1
RECOLL.txt,326950,327869,919,5,N,N,-,-1,-1
RECOLL.txt,327869,328252,383,5,N,N,-,-1,-1
RECOLL.txt,328257,329885,1628,5,N,N,-,-1,-1
RECOLL.txt,329888,331063,1175,5,N,N,-,-1,-1
RECOLL.txt,331066,331908,842,5,N,N,-,-1,-1
RECOLL.txt,331909,332412,503,5,N,N,-,-1,-1
RECOLL.txt,332413,333019,606,5,N,N,-,-1,-1
RECOLL.txt,333020,333704,684,5,N,N,-,-1,-1
RECOLL.txt,333705,334451,746,5,N,N,-,-1,-1
RECOLL.txt,334454,335500,1046,5,N,N,-,-1,-1
RECOLL.txt,335503,336158,655,5,N,N,-,-1,-1
RECOLL.txt,336159,336976,817,5,N,N,-,-1,-1
RECOLL.txt,336977,337654,677,5,N,N,-,-1,-1
RECOLL.txt,337655,338555,900,5,Y,N,-,-1,-1
RECOLL.txt,338556,339315,759,5,N,N,-,-1,-1
RECOLL.txt,339316,339746,430,5,N,N,-,-1,-1
REMKEL1.txt,3,353,350,5,N,N,-,-1,-1
REMKEL1.txt,361,784,423,5,N,N,-,-1,-1
REMKEL1.txt,785,1581,796,5,N,N,-,-1,-1
REMKEL1.txt,1586,1808,222,5,N,N,-,-1,-1
REMKEL1.txt,1809,2047,238,5,N,N,-,-1,-1
REMKEL1.txt,2048,2256,208,5,N,N,-,-1,-1
REMKEL1.txt,2258,2436,178,5,N,N,-,-1,-1
REMKEL1.txt,2437,2579,142,5,N,N,-,-1,-1
REMKEL1.txt,2582,2772,190,5,N,N,-,-1,-1
REMKEL1.txt,2773,3094,321,5,N,N,-,-1,-1
REMKEL1.txt,3096,3326,230,5,N,N,-,-1,-1
REMKEL1.txt,3327,3682,355,5,N,N,-,-1,-1
REMKEL1.txt,3683,3877,194,5,N,N,-,-1,-1
REMKEL1.txt,3878,4031,153,5,N,N,-,-1,-1
REMKEL1.txt,4032,4306,274,5,N,N,-,-1,-1
REMKEL1.txt,4307,4532,225,5,N,N,-,-1,-1
REMKEL1.txt,4533,4743,210,5,N,N,-,-1,-1
REMKEL1.txt,4744,4902,158,5,N,N,-,-1,-1
REMKEL1.txt,4903,5098,195,5,N,N,-,-1,-1
REMKEL1.txt,5099,5241,142,5,N,N,-,-1,-1
REMKEL1.txt,5242,5510,268,5,N,N,-,-1,-1
REMKEL1.txt,5511,5744,233,5,N,N,-,-1,-1
REMKEL1.txt,5745,5935,190,5,N,N,-,-1,-1
REMKEL1.txt,5936,6128,192,5,N,N,-,-1,-1
REMKEL1.txt,6131,6417,286,5,N,N,-,-1,-1
REMKEL1.txt,6418,6569,151,5,N,N,-,-1,-1
REMKEL1.txt,6570,6791,221,5,N,N,-,-1,-1
REMKEL1.txt,6792,6943,151,5,N,N,-,-1,-1
REMKEL1.txt,6944,7122,178,5,N,N,-,-1,-1
REMKEL1.txt,7123,7328,205,5,N,N,-,-1,-1
REMKEL1.txt,7329,7572,243,5,N,N,-,-1,-1
REMKEL1.txt,7574,7836,262,5,N,N,-,-1,-1
REMKEL1.txt,7837,7956,119,5,N,N,-,-1,-1
REMKEL1.txt,7957,8198,241,5,N,N,-,-1,-1
REMKEL1.txt,8200,8349,149,5,N,N,-,-1,-1
REMKEL1.txt,8352,8523,171,5,N,N,-,-1,-1
REMKEL1.txt,8525,8740,215,5,N,N,-,-1,-1
REMKEL1.txt,8741,8948,207,5,N,N,-,-1,-1
REMKEL1.txt,8949,9170,221,5,N,N,-,-1,-1
REMKEL1.txt,9171,9502,331,5,N,N,-,-1,-1
REMKEL1.txt,9503,9719,216,5,N,N,-,-1,-1
REMKEL1.txt,9721,9923,202,5,N,N,-,-1,-1
REMKEL1.txt,9924,10246,322,5,N,N,-,-1,-1
REMKEL1.txt,10247,10537,290,5,N,N,-,-1,-1
REMKEL1.txt,10540,10745,205,5,N,N,-,-1,-1
REMKEL1.txt,10746,10969,223,5,N,N,-,-1,-1
REMKEL1.txt,10970,11142,172,5,N,N,-,-1,-1
REMKEL1.txt,11145,11629,484,5,N,N,-,-1,-1
REMKEL1.txt,11630,11955,325,5,N,N,-,-1,-1
REMKEL1.txt,11956,12321,365,5,N,N,-,-1,-1
REMKEL1.txt,12322,12491,169,5,N,N,-,-1,-1
REMKEL1.txt,12492,12605,113,5,N,N,-,-1,-1
REMKEL1.txt,12606,12879,273,5,N,N,-,-1,-1
REMKEL1.txt,12880,13023,143,5,N,N,-,-1,-1
REMKEL1.txt,13024,13162,138,5,N,N,-,-1,-1
REMKEL1.txt,13163,13293,130,5,N,N,-,-1,-1
REMKEL1.txt,13295,13389,94,5,N,N,-,-1,-1
REMKEL1.txt,13390,13608,218,5,N,N,-,-1,-1
REMKEL1.txt,13609,13841,232,5,N,N,-,-1,-1
REMKEL1.txt,13842,14043,201,5,N,N,-,-1,-1
REMKEL1.txt,14044,14343,299,5,N,N,-,-1,-1
REMKEL1.txt,14344,14551,207,5,N,N,-,-1,-1
REMKEL1.txt,14552,14750,198,5,N,N,-,-1,-1
REMKEL1.txt,14751,15026,275,5,N,N,-,-1,-1
REMKEL1.txt,15028,15238,210,5,N,N,-,-1,-1
REMKEL1.txt,15239,15396,157,5,N,N,-,-1,-1
REMKEL1.txt,15397,15675,278,5,N,N,-,-1,-1
REMKEL1.txt,15676,15883,207,5,N,N,-,-1,-1
REMKEL1.txt,15884,16138,254,5,N,N,-,-1,-1
REMKEL1.txt,16139,16251,112,5,N,N,-,-1,-1
REMKEL1.txt,16252,16424,172,5,N,N,-,-1,-1
REMKEL1.txt,16425,16620,195,5,N,N,-,-1,-1
REMKEL1.txt,16623,17248,625,5,N,N,-,-1,-1
REMKEL1.txt,17249,17806,557,5,N,N,-,-1,-1
REMKEL1.txt,17807,18921,1114,5,N,N,-,-1,-1
REMKEL1.txt,18923,19835,912,5,N,N,-,-1,-1
REMKEL1.txt,19836,20685,849,5,N,N,-,-1,-1
REMKEL1.txt,20686,21312,626,5,N,N,-,-1,-1
REMKEL1.txt,21313,21789,476,5,N,N,-,-1,-1
REMKEL1.txt,21791,22648,857,5,N,N,-,-1,-1
REMKEL1.txt,22651,23735,1084,5,N,N,-,-1,-1
REMKEL1.txt,23736,24644,908,5,N,N,-,-1,-1
REMKEL1.txt,24645,25658,1013,5,N,N,-,-1,-1
REMKEL1.txt,25660,27036,1376,5,Y,N,-,-1,-1
REMKEL1.txt,27037,27459,422,5,N,N,-,-1,-1
REMKEL1.txt,27460,28520,1060,5,N,N,-,-1,-1
REMKEL1.txt,28523,29264,741,5,N,N,-,-1,-1
REMKEL1.txt,29265,29837,572,5,N,N,-,-1,-1
REMKEL1.txt,29840,30378,538,5,N,N,-,-1,-1
REMKEL1.txt,30379,31689,1310,5,N,N,-,-1,-1
REMKEL1.txt,31694,32683,989,5,N,N,-,-1,-1
REMKEL1.txt,32685,33699,1014,5,N,N,-,-1,-1
REMKEL1.txt,33700,34848,1148,5,N,N,-,-1,-1
REMKEL1.txt,34849,35703,854,5,N,N,-,-1,-1
REMKEL1.txt,35706,36744,1038,5,N,N,-,-1,-1
REMKEL1.txt,36745,37436,691,5,Y,N,-,-1,-1
REMKEL1.txt,37439,38242,803,5,N,N,-,-1,-1
REMKEL1.txt,38243,38921,678,5,N,N,-,-1,-1
REMKEL1.txt,38924,39421,497,5,N,N,-,-1,-1
REMKEL1.txt,39424,40326,902,5,N,N,-,-1,-1
REMKEL1.txt,40327,41405,1078,5,N,N,-,-1,-1
REMKEL1.txt,41407,41593,186,5,N,N,-,-1,-1
REMKEL1.txt,41594,42317,723,5,N,N,-,-1,-1
REMKEL1.txt,42320,42440,120,5,N,N,-,-1,-1
REMKEL1.txt,42443,42581,138,5,N,N,-,-1,-1
REMKEL1.txt,42584,43529,945,5,N,N,-,-1,-1
REMKEL1.txt,43530,44276,746,5,N,N,-,-1,-1
REMKEL1.txt,44277,45084,807,5,N,N,-,-1,-1
REMKEL1.txt,45085,45656,571,5,N,N,-,-1,-1
REMKEL1.txt,45657,46134,477,5,N,N,-,-1,-1
REMKEL1.txt,46135,46863,728,5,N,N,-,-1,-1
REMKEL1.txt,46868,47498,630,5,N,N,-,-1,-1
REMKEL1.txt,47501,48621,1120,5,N,N,-,-1,-1
REMKEL1.txt,48624,49868,1244,5,N,N,-,-1,-1
REMKEL1.txt,49869,50643,774,5,N,Y,1427373119628,50476,51323
REMKEL1.txt,50644,51802,1158,5,Y,Y,1427373119628,50476,51323
REMKEL1.txt,51805,52795,990,5,N,N,-,-1,-1
REMKEL1.txt,52798,53880,1082,5,N,N,-,-1,-1
REMKEL1.txt,53881,54699,818,5,N,Y,1427373691557,54475,55337
REMKEL1.txt,54700,55260,560,5,N,Y,1427373691557,54475,55337
REMKEL1.txt,55261,55778,517,5,N,Y,1427373691557,54475,55337
REMKEL1.txt,55779,56639,860,5,N,N,-,-1,-1
REMKEL1.txt,56641,57325,684,5,N,N,-,-1,-1
REMKEL1.txt,57326,58193,867,5,N,N,-,-1,-1
REMKEL1.txt,58196,59173,977,5,N,N,-,-1,-1
REMKEL1.txt,59174,59836,662,5,N,N,-,-1,-1
REMKEL1.txt,59837,60770,933,5,N,N,-,-1,-1
REMKEL1.txt,60771,61666,895,5,N,N,-,-1,-1
REMKEL1.txt,61667,62444,777,5,N,N,-,-1,-1
REMKEL1.txt,62447,62967,520,5,N,N,-,-1,-1
REMKEL1.txt,62968,63787,819,5,N,N,-,-1,-1
REMKEL1.txt,63792,64746,954,5,N,N,-,-1,-1
REMKEL1.txt,64747,65318,571,5,N,N,-,-1,-1
REMKEL1.txt,65319,66136,817,5,N,N,-,-1,-1
REMKEL1.txt,66137,67032,895,5,N,N,-,-1,-1
REMKEL1.txt,67034,67976,942,5,N,N,-,-1,-1
REMKEL1.txt,67977,69358,1381,5,N,N,-,-1,-1
REMKEL1.txt,69359,69816,457,5,N,N,-,-1,-1
REMKEL1.txt,69817,70431,614,5,N,N,-,-1,-1
REMKEL1.txt,70433,71360,927,5,N,N,-,-1,-1
REMKEL1.txt,71361,72088,727,5,N,N,-,-1,-1
REMKEL1.txt,72091,72574,483,5,N,N,-,-1,-1
REMKEL1.txt,72575,73318,743,5,N,N,-,-1,-1
REMKEL1.txt,73319,74510,1191,5,N,Y,1427375995210,73781,74572
REMKEL1.txt,74511,75257,746,5,N,Y,1427375995210,73781,74572
REMKEL1.txt,75258,76191,933,5,N,Y,1427376630476,75869,76825
REMKEL1.txt,76192,77065,873,5,N,Y,1427376630476,75869,76825
REMKEL1.txt,77066,77688,622,5,N,N,-,-1,-1
REMKEL1.txt,77689,78634,945,5,N,N,-,-1,-1
REMKEL1.txt,78635,79176,541,5,N,N,-,-1,-1
REMKEL1.txt,79179,80274,1095,5,N,N,-,-1,-1
REMKEL1.txt,80277,80760,483,5,N,Y,1427377322048,80447,80948
REMKEL1.txt,80763,81521,758,5,N,Y,1427377322048,80447,80948
REMKEL1.txt,81523,82206,683,5,N,Y,1427379129074,80977,81930
REMKEL1.txt,82207,82683,476,5,Y,Y,1427379753297,81978,82676
REMKEL1.txt,82686,83002,316,5,N,N,-,-1,-1
REMKEL1.txt,83003,83268,265,5,N,N,-,-1,-1
REMKEL1.txt,83270,83568,298,5,N,N,-,-1,-1
REMKEL1.txt,83569,84160,591,5,N,N,-,-1,-1
REMKEL1.txt,84161,84696,535,5,N,Y,1427459918395,84645,85149
REMKEL1.txt,84697,85388,691,5,N,Y,1427459918395,84645,85149
REMKEL1.txt,85391,85812,421,5,N,Y,1427460086043,85397,86219
REMKEL1.txt,85813,86447,634,5,N,Y,1427460086043,85397,86219
REMKEL1.txt,86448,87235,787,5,N,N,-,-1,-1
REMKEL1.txt,87236,88070,834,5,N,N,-,-1,-1
REMKEL1.txt,88071,89379,1308,5,N,N,-,-1,-1
REMKEL1.txt,89380,90133,753,5,N,N,-,-1,-1
REMKEL1.txt,90134,91558,1424,5,N,N,-,-1,-1
REMKEL1.txt,91561,92684,1123,5,N,N,-,-1,-1
REMKEL1.txt,92687,93278,591,5,N,N,-,-1,-1
REMKEL1.txt,93279,93701,422,5,N,N,-,-1,-1
REMKEL1.txt,93702,93900,198,5,N,N,-,-1,-1
REMKEL1.txt,93901,94597,696,5,N,N,-,-1,-1
REMKEL1.txt,94598,95264,666,5,N,N,-,-1,-1
REMKEL1.txt,95265,96096,831,5,N,N,-,-1,-1
REMKEL1.txt,96097,96790,693,5,N,N,-,-1,-1
REMKEL1.txt,96791,97489,698,5,N,Y,1427461889324,97013,98033
REMKEL1.txt,97490,98504,1014,5,N,Y,1427462513930,98050,98577
REMKEL1.txt,98505,99487,982,5,N,Y,1427462513930,98050,98577
REMKEL1.txt,99488,100220,732,5,N,Y,1427462848427,99143,100650
REMKEL1.txt,100221,100937,716,5,N,Y,1427462848427,99143,100650
REMKEL1.txt,100938,102092,1154,5,N,N,-,-1,-1
REMKEL1.txt,102095,102898,803,5,N,N,-,-1,-1
REMKEL1.txt,102899,103709,810,5,N,Y,1428065655005,103366,109009
REMKEL1.txt,103710,104579,869,5,N,Y,1428065655005,103366,109009
REMKEL1.txt,104580,105311,731,5,N,Y,1428065655005,103366,109009
REMKEL1.txt,105312,105942,630,5,N,Y,1428065655005,103366,109009
REMKEL1.txt,105943,107038,1095,5,N,Y,1428065655005,103366,109009
REMKEL1.txt,107041,108070,1029,5,N,Y,1428065655005,103366,109009
REMKEL1.txt,108071,108681,610,5,N,Y,1428065655005,103366,109009
REMKEL1.txt,108682,109842,1160,5,N,Y,1428065655005,103366,109009
REMKEL1.txt,109845,110719,874,5,N,N,-,-1,-1
REMKEL1.txt,110720,111433,713,5,N,N,-,-1,-1
REMKEL1.txt,111434,112204,770,5,N,N,-,-1,-1
REMKEL1.txt,112205,112818,613,5,N,N,-,-1,-1
REMKEL1.txt,112821,113589,768,5,N,N,-,-1,-1
REMKEL1.txt,113590,114252,662,5,N,N,-,-1,-1
REMKEL1.txt,114255,114733,478,5,N,Y,1428139555093,114267,115295
REMKEL1.txt,114734,116021,1287,5,N,Y,1428139555093,114267,115295
REMKEL1.txt,116022,116704,682,5,N,N,-,-1,-1
REMKEL1.txt,116705,117343,638,5,N,N,-,-1,-1
REMKEL1.txt,117344,118222,878,5,N,N,-,-1,-1
REMKEL1.txt,118223,118893,670,5,N,N,-,-1,-1
REMKEL1.txt,118894,119677,783,5,N,Y,1428140980187,119629,120812
REMKEL1.txt,119678,120418,740,5,N,Y,1428140980187,119629,120812
REMKEL1.txt,120419,121062,643,5,N,Y,1428140980187,119629,120812
REMKEL1.txt,121063,121231,168,5,N,N,-,-1,-1
REMKEL1.txt,121232,121486,254,5,N,N,-,-1,-1
REMKEL1.txt,121487,121793,306,5,N,N,-,-1,-1
REMKEL1.txt,121794,122543,749,5,N,N,-,-1,-1
REMKEL1.txt,122546,123815,1269,5,N,N,-,-1,-1
REMKEL1.txt,123816,124527,711,5,N,N,-,-1,-1
REMKEL1.txt,124530,125384,854,5,N,Y,1428142329788,124908,125971
REMKEL1.txt,125386,126091,705,5,N,Y,1428142329788,124908,125971
REMKEL1.txt,126094,127280,1186,5,N,N,-,-1,-1
REMKEL1.txt,127283,128061,778,5,N,N,-,-1,-1
REMKEL1.txt,128062,128554,492,5,N,N,-,-1,-1
REMKEL1.txt,128555,129515,960,5,N,N,-,-1,-1
REMKEL1.txt,129517,130238,721,5,N,N,-,-1,-1
REMKEL1.txt,130239,130846,607,5,N,N,-,-1,-1
REMKEL1.txt,130847,132162,1315,5,N,N,-,-1,-1
REMKEL1.txt,132163,132942,779,5,N,N,-,-1,-1
REMKEL1.txt,132945,133658,713,5,N,N,-,-1,-1
REMKEL1.txt,133659,134682,1023,5,N,N,-,-1,-1
REMKEL1.txt,134685,135801,1116,5,N,N,-,-1,-1
REMKEL1.txt,135802,136433,631,5,N,N,-,-1,-1
REMKEL1.txt,136434,136887,453,5,N,N,-,-1,-1
REMKEL1.txt,136888,137732,844,5,N,N,-,-1,-1
REMKEL1.txt,137733,138672,939,5,N,N,-,-1,-1
REMKEL1.txt,138674,139347,673,5,N,N,-,-1,-1
REMKEL1.txt,139348,139840,492,5,N,N,-,-1,-1
REMKEL1.txt,139841,140688,847,5,N,N,-,-1,-1
REMKEL1.txt,140689,141457,768,5,N,N,-,-1,-1
REMKEL1.txt,141460,142256,796,5,N,N,-,-1,-1
REMKEL1.txt,142259,143270,1011,5,N,Y,1428143866274,142277,143444
REMKEL1.txt,143271,144247,976,5,N,Y,1428143866274,142277,143444
REMKEL1.txt,144250,144977,727,5,N,N,-,-1,-1
REMKEL1.txt,144982,145635,653,5,N,N,-,-1,-1
REMKEL1.txt,145636,146118,482,5,N,N,-,-1,-1
REMKEL1.txt,146119,147160,1041,5,N,N,-,-1,-1
REMKEL1.txt,147161,148185,1024,5,N,N,-,-1,-1
REMKEL1.txt,148186,148868,682,5,N,N,-,-1,-1
REMKEL1.txt,148871,149689,818,5,N,N,-,-1,-1
REMKEL1.txt,149692,150052,360,5,N,N,-,-1,-1
REMKEL1.txt,150053,150879,826,5,N,Y,1428144732441,150786,151788
REMKEL1.txt,150880,151803,923,5,N,Y,1428144732441,150786,151788
REMKEL1.txt,151806,152278,472,5,N,N,-,-1,-1
REMKEL1.txt,152280,153159,879,5,N,Y,1428145340599,152563,152962
REMKEL1.txt,153161,153811,650,5,Y,N,-,-1,-1
REMKEL1.txt,153812,154461,649,5,N,N,-,-1,-1
REMKEL1.txt,154462,154910,448,5,N,N,-,-1,-1
REMKEL1.txt,154911,155518,607,5,N,N,-,-1,-1
REMKEL1.txt,155519,156221,702,5,N,N,-,-1,-1
REMKEL1.txt,156224,156862,638,5,N,N,-,-1,-1
REMKEL1.txt,156865,157728,863,5,N,N,-,-1,-1
REMKEL1.txt,157729,158644,915,5,N,N,-,-1,-1
REMKEL1.txt,158645,159127,482,5,N,N,-,-1,-1
REMKEL1.txt,159128,160132,1004,5,Y,N,-,-1,-1
REMKEL1.txt,160133,161031,898,5,N,N,-,-1,-1
REMKEL1.txt,161034,161902,868,5,N,N,-,-1,-1
REMKEL1.txt,161903,162636,733,5,N,N,-,-1,-1
REMKEL1.txt,162637,163374,737,5,N,N,-,-1,-1
REMKEL1.txt,163377,164032,655,5,N,Y,1428156251387,163375,165208
REMKEL1.txt,164035,164962,927,5,N,Y,1428156251387,163375,165208
REMKEL1.txt,164963,165864,901,5,N,Y,1428156251387,163375,165208
REMKEL1.txt,165867,166400,533,5,N,Y,1428164866689,166001,167438
REMKEL1.txt,166401,167204,803,5,N,Y,1428164866689,166001,167438
REMKEL1.txt,167205,167759,554,5,N,Y,1428164866689,166001,167438
REMKEL1.txt,167761,168367,606,5,N,N,-,-1,-1
REMKEL1.txt,168370,169156,786,5,N,N,-,-1,-1
REMKEL1.txt,169157,169968,811,5,N,Y,1428166121742,169838,170346
REMKEL1.txt,169969,170840,871,5,N,Y,1428166121742,169838,170346
REMKEL1.txt,170842,171828,986,5,Y,Y,1428167038498,170602,172231
REMKEL1.txt,171831,172283,452,5,N,Y,1428167038498,170602,172231
REMKEL1.txt,172285,172928,643,5,N,N,-,-1,-1
REMKEL1.txt,172929,173922,993,5,N,N,-,-1,-1
REMKEL1.txt,173923,174980,1057,5,Y,N,-,-1,-1
REMKEL1.txt,174981,175842,861,5,N,N,-,-1,-1
REMKEL1.txt,175843,176313,470,5,N,N,-,-1,-1
REMKEL1.txt,176316,177299,983,5,N,N,-,-1,-1
REMKEL1.txt,177300,177910,610,5,N,N,-,-1,-1
REMKEL1.txt,177911,178661,750,5,N,N,-,-1,-1
REMKEL1.txt,178661,178994,333,5,N,N,-,-1,-1
REMKEL1.txt,178997,179787,790,5,N,N,-,-1,-1
REMKEL1.txt,179788,180494,706,5,N,N,-,-1,-1
REMKEL1.txt,180497,181340,843,5,N,N,-,-1,-1
REMKEL1.txt,181341,181828,487,5,N,N,-,-1,-1
REMKEL1.txt,181829,182333,504,5,N,N,-,-1,-1
REMKEL1.txt,182334,183386,1052,5,N,N,-,-1,-1
REMKEL1.txt,183387,184061,674,5,N,N,-,-1,-1
REMKEL1.txt,184062,185262,1200,5,N,N,-,-1,-1
REMKEL1.txt,185264,185788,524,5,N,N,-,-1,-1
REMKEL1.txt,185790,186607,817,5,N,Y,1429179224952,186363,187163
REMKEL1.txt,186608,187335,727,5,N,Y,1429179224952,186363,187163
REMKEL1.txt,187336,187901,565,5,N,N,-,-1,-1
REMKEL1.txt,187902,188191,289,5,N,N,-,-1,-1
REMKEL1.txt,188192,188656,464,5,N,N,-,-1,-1
REMKEL1.txt,188657,189756,1099,5,N,N,-,-1,-1
REMKEL1.txt,189759,190426,667,5,N,N,-,-1,-1
REMKEL1.txt,190429,191178,749,5,N,N,-,-1,-1
REMKEL1.txt,191179,191835,656,5,N,Y,1429180017418,191485,192427
REMKEL1.txt,191836,192308,472,5,N,Y,1429180017418,191485,192427
REMKEL1.txt,192309,193026,717,5,Y,Y,1429180740975,192464,193718
REMKEL1.txt,193028,193894,866,5,N,Y,1429180740975,192464,193718
REMKEL1.txt,193895,194891,996,5,N,N,-,-1,-1
REMKEL1.txt,194892,195727,835,5,N,N,-,-1,-1
REMKEL1.txt,195728,196796,1068,5,N,N,-,-1,-1
REMKEL1.txt,196797,197838,1041,5,N,N,-,-1,-1
REMKEL1.txt,197839,199106,1267,5,N,N,-,-1,-1
REMKEL1.txt,199109,199923,814,5,N,N,-,-1,-1
REMKEL1.txt,199926,200610,684,5,N,N,-,-1,-1
REMKEL1.txt,200611,201329,718,5,N,N,-,-1,-1
REMKEL1.txt,201332,202407,1075,5,N,N,-,-1,-1
REMKEL1.txt,202408,203963,1555,5,N,N,-,-1,-1
REMKEL1.txt,203966,204259,293,5,N,N,-,-1,-1
REMKEL1.txt,204260,204769,509,5,N,N,-,-1,-1
REMKEL1.txt,204770,205983,1213,5,N,N,-,-1,-1
REMKEL1.txt,205984,207066,1082,5,N,N,-,-1,-1
REMKEL1.txt,207067,208150,1083,5,N,N,-,-1,-1
REMKEL1.txt,208153,208760,607,5,N,Y,1429183348411,208524,209310
REMKEL1.txt,208761,209323,562,5,N,Y,1429183348411,208524,209310
REMKEL1.txt,209324,209962,638,5,N,N,-,-1,-1
REMKEL1.txt,209963,211005,1042,5,N,N,-,-1,-1
REMKEL1.txt,211006,211791,785,5,N,N,-,-1,-1
REMKEL1.txt,211794,212278,484,5,N,N,-,-1,-1
REMKEL1.txt,212279,213603,1324,5,N,N,-,-1,-1
REMKEL1.txt,213606,214114,508,5,N,Y,1429184555165,213619,214284
REMKEL1.txt,214115,214932,817,5,N,Y,1429184555165,213619,214284
REMKEL1.txt,214933,215527,594,5,N,N,-,-1,-1
REMKEL1.txt,215528,216121,593,5,N,N,-,-1,-1
REMKEL1.txt,216122,217090,968,5,N,N,-,-1,-1
REMKEL1.txt,217093,217875,782,5,N,N,-,-1,-1
REMKEL1.txt,217876,218887,1011,5,N,N,-,-1,-1
REMKEL1.txt,218890,219123,233,5,N,N,-,-1,-1
REMKEL1.txt,219126,219977,851,5,N,N,-,-1,-1
REMKEL1.txt,219978,220774,796,5,N,N,-,-1,-1
REMKEL1.txt,220775,221250,475,5,N,N,-,-1,-1
REMKEL1.txt,221251,221608,357,5,N,N,-,-1,-1
REMKEL1.txt,221609,222516,907,5,N,N,-,-1,-1
REMKEL1.txt,222517,223360,843,5,N,Y,1429478561003,223319,224140
REMKEL1.txt,223362,223912,550,5,N,Y,1429478561003,223319,224140
REMKEL1.txt,223913,224687,774,5,N,Y,1429478561003,223319,224140
REMKEL1.txt,224688,225318,630,5,N,Y,1429479695836,224360,224906
REMKEL1.txt,225320,226110,790,5,N,N,-,-1,-1
REMKEL1.txt,226111,226691,580,5,N,N,-,-1,-1
REMKEL1.txt,226692,227067,375,5,N,N,-,-1,-1
REMKEL1.txt,227068,227439,371,5,N,N,-,-1,-1
REMKEL1.txt,227440,228233,793,5,N,N,-,-1,-1
REMKEL1.txt,228236,229433,1197,5,N,N,-,-1,-1
REMKEL1.txt,229435,230671,1236,5,N,N,-,-1,-1
REMKEL1.txt,230672,232184,1512,5,N,N,-,-1,-1
REMKEL1.txt,232187,233659,1472,5,N,N,-,-1,-1
REMKEL1.txt,233662,234432,770,5,N,N,-,-1,-1
REMKEL1.txt,234433,235144,711,5,N,N,-,-1,-1
REMKEL1.txt,235145,236510,1365,5,N,N,-,-1,-1
REMKEL1.txt,236511,237428,917,5,N,N,-,-1,-1
REMKEL1.txt,237430,238362,932,5,N,N,-,-1,-1
REMKEL1.txt,238363,239257,894,5,N,N,-,-1,-1
REMKEL1.txt,239260,240295,1035,5,N,N,-,-1,-1
REMKEL1.txt,240298,241208,910,5,N,N,-,-1,-1
REMKEL1.txt,241209,242302,1093,5,N,Y,1429702947558,242053,243400
REMKEL1.txt,242303,243005,702,5,Y,Y,1429702947558,242053,243400
REMKEL1.txt,243006,243464,458,5,N,Y,1429702947558,242053,243400
REMKEL1.txt,243467,244494,1027,5,N,Y,1429703626688,244429,245446
REMKEL1.txt,244495,245338,843,5,N,Y,1429703626688,244429,245446
REMKEL1.txt,245339,246604,1265,5,N,Y,1429703626688,244429,245446
REMKEL1.txt,246605,247837,1232,5,N,N,-,-1,-1
REMKEL1.txt,247838,248579,741,5,N,N,-,-1,-1
REMKEL1.txt,248582,249522,940,5,N,N,-,-1,-1
REMKEL1.txt,249523,250298,775,5,N,N,-,-1,-1
REMKEL1.txt,250299,251835,1536,5,N,N,-,-1,-1
REMKEL1.txt,251835,253133,1298,5,N,N,-,-1,-1
REMKEL1.txt,253134,254388,1254,5,N,Y,1430585951765,253480,254126
REMKEL1.txt,254389,255724,1335,5,N,N,-,-1,-1
REMKEL1.txt,255725,256148,423,5,N,N,-,-1,-1
REMKEL1.txt,256149,257068,919,5,N,N,-,-1,-1
REMKEL1.txt,257069,258181,1112,5,N,N,-,-1,-1
REMKEL1.txt,258182,259061,879,5,N,N,-,-1,-1
REMKEL1.txt,259062,260716,1654,5,Y,Y,1430588560920,259596,260149
REMKEL1.txt,260719,261777,1058,5,N,N,-,-1,-1
REMKEL1.txt,261778,262878,1100,5,N,N,-,-1,-1
REMKEL1.txt,262879,263725,846,5,N,N,-,-1,-1
REMKEL1.txt,263726,264377,651,5,N,N,-,-1,-1
REMKEL1.txt,264378,265125,747,5,N,N,-,-1,-1
REMKEL1.txt,265126,266495,1369,5,N,N,-,-1,-1
REMKEL1.txt,266498,266989,491,5,N,N,-,-1,-1
REMKEL1.txt,266990,267445,455,5,N,N,-,-1,-1
REMKEL1.txt,267446,268854,1408,5,N,N,-,-1,-1
REMKEL1.txt,268855,269538,683,5,N,N,-,-1,-1
REMKEL1.txt,269539,270070,531,5,N,N,-,-1,-1
REMKEL1.txt,270071,270775,704,5,Y,N,-,-1,-1
REMKEL1.txt,270776,271739,963,5,N,N,-,-1,-1
REMKEL1.txt,271742,272827,1085,5,N,N,-,-1,-1
REMKEL1.txt,272828,273776,948,5,N,N,-,-1,-1
REMKEL1.txt,273777,274278,501,5,N,N,-,-1,-1
REMKEL1.txt,274279,275513,1234,5,N,N,-,-1,-1
REMKEL1.txt,275514,276198,684,5,N,Y,1430593986926,275535,275764
REMKEL1.txt,276199,277628,1429,5,Y,N,-,-1,-1
REMKEL1.txt,277629,279210,1581,5,N,N,-,-1,-1
REMKEL1.txt,279213,280661,1448,5,N,N,-,-1,-1
REMKEL1.txt,280662,281251,589,5,N,Y,1430594989217,280917,281849
REMKEL1.txt,281252,282481,1229,5,N,Y,1430594989217,280917,281849
REMKEL1.txt,282481,283098,617,5,N,N,-,-1,-1
REMKEL1.txt,283099,284255,1156,5,N,N,-,-1,-1
REMKEL1.txt,284258,285005,747,5,N,N,-,-1,-1
REMKEL1.txt,285006,285489,483,5,N,N,-,-1,-1
REMKEL1.txt,285490,286756,1266,5,N,N,-,-1,-1
REMKEL1.txt,286759,287287,528,5,N,N,-,-1,-1
REMKEL1.txt,287288,288249,961,5,N,N,-,-1,-1
REMKEL1.txt,288250,288881,631,5,N,N,-,-1,-1
REMKEL1.txt,288883,289509,626,5,N,N,-,-1,-1
REMKEL1.txt,289510,289962,452,5,N,N,-,-1,-1
REMKEL1.txt,289963,290540,577,5,N,N,-,-1,-1
REMKEL1.txt,290541,291385,844,5,N,N,-,-1,-1
REMKEL1.txt,291386,291944,558,5,N,N,-,-1,-1
REMKEL1.txt,291945,292880,935,5,N,N,-,-1,-1
REMKEL1.txt,292883,293360,477,5,N,N,-,-1,-1
REMKEL1.txt,293361,294059,698,5,N,N,-,-1,-1
REMKEL1.txt,294062,294903,841,5,N,N,-,-1,-1
REMKEL1.txt,294905,295674,769,5,N,N,-,-1,-1
REMKEL1.txt,295675,296380,705,5,N,N,-,-1,-1
REMKEL1.txt,296381,297543,1162,5,N,N,-,-1,-1
REMKEL1.txt,297546,298117,571,5,N,N,-,-1,-1
REMKEL1.txt,298120,298978,858,5,N,N,-,-1,-1
REMKEL1.txt,298979,299805,826,5,N,N,-,-1,-1
REMKEL1.txt,299806,300450,644,5,N,N,-,-1,-1
REMKEL1.txt,300451,300855,404,5,N,N,-,-1,-1
REMKEL1.txt,300856,302068,1212,5,N,N,-,-1,-1
REMKEL1.txt,302069,303444,1375,5,N,N,-,-1,-1
REMKEL1.txt,303445,304103,658,5,N,N,-,-1,-1
REMKEL1.txt,304104,304909,805,5,N,N,-,-1,-1
REMKEL1.txt,304910,305823,913,5,N,N,-,-1,-1
REMKEL1.txt,305824,307217,1393,5,N,N,-,-1,-1
REMKEL1.txt,307218,308015,797,5,N,N,-,-1,-1
REMKEL1.txt,308016,308845,829,5,N,N,-,-1,-1
REMKEL1.txt,308846,309656,810,5,N,N,-,-1,-1
REMKEL1.txt,309658,310535,877,5,N,N,-,-1,-1
REMKEL1.txt,310536,311122,586,5,N,N,-,-1,-1
REMKEL1.txt,311123,311804,681,5,N,N,-,-1,-1
REMKEL1.txt,311805,312720,915,5,N,N,-,-1,-1
REMKEL1.txt,312721,313301,580,5,N,N,-,-1,-1
REMKEL1.txt,313304,314477,1173,5,N,N,-,-1,-1
REMKEL1.txt,314480,315003,523,5,N,N,-,-1,-1
REMKEL1.txt,315005,315819,814,5,N,N,-,-1,-1
REMKEL1.txt,315824,316702,878,5,N,N,-,-1,-1
REMKEL1.txt,316704,317131,427,5,N,N,-,-1,-1
REMKEL1.txt,317132,317961,829,5,Y,N,-,-1,-1
REMKEL1.txt,317963,318982,1019,5,N,N,-,-1,-1
REMKEL1.txt,318983,319836,853,5,N,N,-,-1,-1
REMKEL1.txt,319839,320252,413,5,N,N,-,-1,-1
REMKEL1.txt,320253,321096,843,5,N,N,-,-1,-1
REMKEL1.txt,321097,322120,1023,5,N,Y,1430747238328,321121,323743
REMKEL1.txt,322121,322431,310,5,N,Y,1430747238328,321121,323743
REMKEL1.txt,322432,322773,341,5,N,Y,1430747238328,321121,323743
REMKEL1.txt,322775,323183,408,5,N,Y,1430747238328,321121,323743
REMKEL1.txt,323186,324295,1109,5,N,Y,1430747238328,321121,323743
REMKEL1.txt,324298,325139,841,5,N,N,-,-1,-1
REMKEL1.txt,325140,325720,580,5,N,N,-,-1,-1
REMKEL1.txt,325723,326197,474,5,N,Y,1430749600786,325904,327946
REMKEL1.txt,326198,326695,497,5,N,Y,1430749600786,325904,327946
REMKEL1.txt,326696,327214,518,5,N,Y,1430749600786,325904,327946
REMKEL1.txt,327217,328143,926,5,N,Y,1430749600786,325904,327946
REMKEL1.txt,328143,328192,49,5,N,N,-,-1,-1
REMKEL1.txt,328193,329304,1111,5,N,N,-,-1,-1
REMKEL1.txt,329306,329453,147,5,N,N,-,-1,-1
REMKEL1.txt,329456,330491,1035,5,N,N,-,-1,-1
REMKEL1.txt,330492,331190,698,5,N,N,-,-1,-1
REMKEL1.txt,331192,332258,1066,5,Y,Y,1430751146450,332109,333778
REMKEL1.txt,332263,332925,662,5,N,Y,1430751146450,332109,333778
REMKEL1.txt,332928,333565,637,5,N,Y,1430751146450,332109,333778
REMKEL1.txt,333566,334603,1037,5,N,Y,1430751146450,332109,333778
REMKEL1.txt,334606,335952,1346,5,N,N,-,-1,-1
REMKEL1.txt,335953,337027,1074,5,N,N,-,-1,-1
REMKEL1.txt,337028,338449,1421,5,N,N,-,-1,-1
REMKEL1.txt,338450,339042,592,5,N,N,-,-1,-1
REMKEL1.txt,339043,339880,837,5,Y,N,-,-1,-1
REMKEL1.txt,339881,341007,1126,5,N,N,-,-1,-1
REMKEL1.txt,341008,341873,865,5,N,Y,1430753605807,341769,342306
REMKEL1.txt,341874,342799,925,5,N,Y,1430753605807,341769,342306
REMKEL1.txt,342800,344045,1245,5,N,N,-,-1,-1
REMKEL1.txt,344046,344633,587,5,N,N,-,-1,-1
REMKEL1.txt,344634,345535,901,5,N,N,-,-1,-1
REMKEL1.txt,345536,346358,822,5,N,N,-,-1,-1
REMKEL1.txt,346361,346878,517,5,N,N,-,-1,-1
REMKEL1.txt,346879,347767,888,5,N,N,-,-1,-1
REMKEL1.txt,347768,348139,371,5,N,N,-,-1,-1
REMKEL1.txt,348140,348522,382,5,N,N,-,-1,-1
REMKEL1.txt,348523,349506,983,5,N,Y,1430927911131,348654,350235
REMKEL1.txt,349507,350290,783,5,N,Y,1430927911131,348654,350235
REMKEL1.txt,350293,351223,930,5,N,N,-,-1,-1
REMKEL1.txt,351224,352166,942,5,N,N,-,-1,-1
REMKEL1.txt,352167,352654,487,5,N,N,-,-1,-1
REMKEL1.txt,352654,353102,448,5,N,N,-,-1,-1
REMKEL1.txt,353104,353711,607,5,N,N,-,-1,-1
REMKEL1.txt,353712,354671,959,5,N,N,-,-1,-1
REMKEL1.txt,354672,355350,678,5,N,N,-,-1,-1
REMKEL1.txt,355353,355993,640,5,N,N,-,-1,-1
REMKEL1.txt,355994,356637,643,5,N,N,-,-1,-1
REMKEL1.txt,356638,357347,709,5,N,N,-,-1,-1
REMKEL1.txt,357347,357815,468,5,N,N,-,-1,-1
REMKEL1.txt,357818,358440,622,5,N,N,-,-1,-1
REMKEL1.txt,358441,359338,897,5,N,N,-,-1,-1
REMKEL1.txt,359340,359966,626,5,N,N,-,-1,-1
REMKEL1.txt,359967,360636,669,5,N,N,-,-1,-1
REMKEL1.txt,360639,362084,1445,5,N,N,-,-1,-1
REMKEL1.txt,362085,363000,915,5,N,N,-,-1,-1
REMKEL1.txt,363001,363349,348,5,N,Y,1431600860056,363201,364042
REMKEL1.txt,363350,364062,712,5,N,Y,1431600860056,363201,364042
REMKEL1.txt,364065,364856,791,5,N,N,-,-1,-1
REMKEL1.txt,364857,365721,864,5,N,N,-,-1,-1
REMKEL1.txt,365722,366640,918,5,Y,N,-,-1,-1
REMKEL1.txt,366641,367206,565,5,N,N,-,-1,-1
REMKEL1.txt,367211,368113,902,5,N,N,-,-1,-1
REMKEL1.txt,368114,368915,801,5,N,N,-,-1,-1
REMKEL1.txt,368916,369790,874,5,N,Y,1431602703832,369125,369571
REMKEL1.txt,369791,370403,612,5,N,N,-,-1,-1
REMKEL1.txt,370404,371428,1024,5,N,N,-,-1,-1
REMKEL1.txt,371431,372047,616,5,N,N,-,-1,-1
REMKEL1.txt,372050,372597,547,5,N,N,-,-1,-1
REMKEL1.txt,372598,373335,737,5,N,N,-,-1,-1
REMKEL1.txt,373336,373900,564,5,N,N,-,-1,-1
REMKEL1.txt,373901,374922,1021,5,N,N,-,-1,-1
REMKEL1.txt,374925,375367,442,5,N,N,-,-1,-1
REMKEL1.txt,375367,375892,525,5,N,N,-,-1,-1
REMKEL1.txt,375893,376918,1025,5,N,N,-,-1,-1
REMKEL1.txt,376919,377476,557,5,N,N,-,-1,-1
REMKEL1.txt,377479,379350,1871,5,N,N,-,-1,-1
REMKEL1.txt,379351,379912,561,5,N,N,-,-1,-1
REMKEL1.txt,379913,380472,559,5,N,N,-,-1,-1
REMKEL1.txt,380473,381324,851,5,N,N,-,-1,-1
REMKEL1.txt,381327,381883,556,5,N,N,-,-1,-1
REMKEL1.txt,381884,382530,646,5,N,N,-,-1,-1
REMKEL1.txt,382531,383062,531,5,N,N,-,-1,-1
REMKEL1.txt,383063,383685,622,5,N,N,-,-1,-1
REMKEL1.txt,383686,384259,573,5,N,N,-,-1,-1
REMKEL1.txt,384262,384746,484,5,N,N,-,-1,-1
REMKEL1.txt,384749,385351,602,5,N,N,-,-1,-1
REMKEL1.txt,385353,385964,611,5,N,N,-,-1,-1
REMKEL1.txt,385965,386659,694,5,N,N,-,-1,-1
REMKEL1.txt,386660,387121,461,5,N,N,-,-1,-1
REMKEL1.txt,387122,387796,674,5,N,N,-,-1,-1
REMKEL1.txt,387801,388641,840,5,N,N,-,-1,-1
REMKEL1.txt,388643,389633,990,5,N,N,-,-1,-1
REMKEL1.txt,389636,390316,680,5,N,N,-,-1,-1
REMKEL1.txt,390317,391195,878,5,N,N,-,-1,-1
REMKEL1.txt,391196,391999,803,5,N,N,-,-1,-1
REMKEL1.txt,392002,393021,1019,5,N,N,-,-1,-1
REMKEL1.txt,393022,393687,665,5,N,N,-,-1,-1
REMKEL1.txt,393690,394958,1268,5,N,N,-,-1,-1
REMKEL1.txt,394960,395795,835,5,N,N,-,-1,-1
REMKEL1.txt,395796,396395,599,5,N,N,-,-1,-1
REMKEL1.txt,396396,396981,585,5,N,N,-,-1,-1
REMKEL1.txt,396982,397616,634,5,N,N,-,-1,-1
REMKEL1.txt,397617,398360,743,5,N,N,-,-1,-1
REMKEL1.txt,398361,399480,1119,5,N,N,-,-1,-1
REMKEL1.txt,399482,400895,1413,5,N,Y,1431611462110,399892,400362
REMKEL1.txt,400896,401582,686,5,N,N,-,-1,-1
REMKEL1.txt,401583,402262,679,5,N,N,-,-1,-1
REMKEL1.txt,402265,403275,1010,5,N,N,-,-1,-1
REMKEL1.txt,403276,404368,1092,5,Y,N,-,-1,-1
REMKEL1.txt,404369,405350,981,5,N,Y,1431613303057,404779,405342
REMKEL1.txt,405351,406751,1400,5,N,N,-,-1,-1
REMKEL1.txt,406752,407526,774,5,N,N,-,-1,-1
REMKEL1.txt,407527,408911,1384,5,N,N,-,-1,-1
REMKEL1.txt,408913,410606,1693,5,N,N,-,-1,-1
REMKEL1.txt,410607,411747,1140,5,N,N,-,-1,-1
REMKEL1.txt,411748,412980,1232,5,N,Y,1431615187175,412407,415852
REMKEL1.txt,412981,413784,803,5,Y,Y,1431615187175,412407,415852
REMKEL1.txt,413785,414696,911,5,N,Y,1431615187175,412407,415852
REMKEL1.txt,414697,415365,668,5,Y,Y,1431615187175,412407,415852
REMKEL1.txt,415366,415882,516,5,N,Y,1431615187175,412407,415852
REMKEL1.txt,415885,416954,1069,5,N,N,-,-1,-1
REMKEL1.txt,416957,418290,1333,5,N,N,-,-1,-1
REMKEL1.txt,418293,419716,1423,5,N,N,-,-1,-1
REMKEL1.txt,419717,420605,888,5,N,N,-,-1,-1
REMKEL1.txt,420606,421465,859,5,N,N,-,-1,-1
REMKEL1.txt,421466,422149,683,5,N,N,-,-1,-1
REMKEL1.txt,422152,422873,721,5,N,N,-,-1,-1
REMKEL1.txt,422874,423707,833,5,N,Y,1432056176787,423095,424004
REMKEL1.txt,423708,424302,594,5,N,Y,1432056176787,423095,424004
REMKEL1.txt,424303,425268,965,5,N,N,-,-1,-1
REMKEL1.txt,425269,426911,1642,5,N,N,-,-1,-1
REMKEL1.txt,426912,427688,776,5,N,N,-,-1,-1
REMKEL1.txt,427691,428166,475,5,N,N,-,-1,-1
REMKEL1.txt,428171,428787,616,5,N,N,-,-1,-1
REMKEL1.txt,428788,429567,779,5,N,N,-,-1,-1
REMKEL1.txt,429569,430224,655,5,N,Y,1432060885983,429653,430653
REMKEL1.txt,430225,430901,676,5,N,Y,1432060885983,429653,430653
REMKEL1.txt,430902,432066,1164,5,N,Y,1432137873706,431575,434541
REMKEL1.txt,432067,432758,691,5,Y,Y,1432137873706,431575,434541
REMKEL1.txt,432761,433885,1124,5,Y,Y,1432137873706,431575,434541
REMKEL1.txt,433886,434688,802,5,Y,Y,1432137873706,431575,434541
REMKEL1.txt,434689,435450,761,5,N,Y,1432138360719,435276,437675
REMKEL1.txt,435453,436767,1314,5,N,Y,1432138360719,435276,437675
REMKEL1.txt,436768,437840,1072,5,N,Y,1432138360719,435276,437675
REMKEL1.txt,437842,439068,1226,5,N,N,-,-1,-1
REMKEL1.txt,439070,439920,850,5,N,N,-,-1,-1
REMKEL1.txt,439921,440083,162,5,N,N,-,-1,-1
REMKEL1.txt,440084,440558,474,5,N,Y,1432138782679,440486,440948
REMKEL1.txt,440559,441318,759,5,N,Y,1432138782679,440486,440948
REMKEL1.txt,441319,442828,1509,5,N,Y,1432138943360,440957,441390
REMKEL1.txt,442829,443906,1077,5,N,Y,1432139637153,443461,444025
REMKEL1.txt,443909,445164,1255,5,N,Y,1432139637153,443461,444025
REMKEL1.txt,445165,445634,469,5,N,Y,1432140652765,444022,446180
REMKEL1.txt,445635,446444,809,5,N,Y,1432140652765,444022,446180
REMKEL1.txt,446445,447748,1303,5,N,N,-,-1,-1
REMKEL1.txt,447749,448649,900,5,N,N,-,-1,-1
REMKEL1.txt,448650,449582,932,5,N,N,-,-1,-1
REMKEL1.txt,449585,450298,713,5,N,Y,1434304562715,449617,451671
REMKEL1.txt,450301,451178,877,5,N,Y,1434304562715,449617,451671
REMKEL1.txt,451179,452092,913,5,N,Y,1434304562715,449617,451671
REMKEL1.txt,452094,453725,1631,5,N,N,-,-1,-1
REMKEL1.txt,453726,454593,867,5,N,N,-,-1,-1
REMKEL1.txt,454595,455646,1051,5,N,N,-,-1,-1
REMKEL1.txt,455647,455858,211,5,N,N,-,-1,-1
REMKEL1.txt,455861,455935,74,5,N,N,-,-1,-1
REMKEL1.txt,455936,456535,599,5,N,N,-,-1,-1
REMKEL1.txt,456536,457054,518,5,N,Y,1435163669623,456834,458582
REMKEL1.txt,457054,457687,633,5,N,Y,1435163669623,456834,458582
REMKEL1.txt,457688,458890,1202,5,N,Y,1435164506717,458656,459229
REMKEL1.txt,458891,459528,637,5,N,Y,1435164969620,459343,460812
REMKEL1.txt,459531,459636,105,5,N,Y,1435164969620,459343,460812
REMKEL1.txt,459637,459690,53,5,N,Y,1435164969620,459343,460812
REMKEL1.txt,459693,459740,47,5,N,Y,1435164969620,459343,460812
REMKEL1.txt,459743,459840,97,5,N,Y,1435164969620,459343,460812
REMKEL1.txt,459843,460242,399,5,N,Y,1435164969620,459343,460812
REMKEL1.txt,460243,461264,1021,5,Y,Y,1435164969620,459343,460812
REMKEL1.txt,461265,461972,707,5,N,Y,1435165913179,460834,463218
REMKEL1.txt,461974,462697,723,5,N,Y,1435165913179,460834,463218
REMKEL1.txt,462699,463658,959,5,Y,Y,1435165913179,460834,463218
REMKEL1.txt,463659,464118,459,5,N,Y,1435246296080,463319,464604
REMKEL1.txt,464120,464829,709,5,N,Y,1435246296080,463319,464604
REMKEL1.txt,464830,465224,394,5,N,Y,1435246956861,465116,468674
REMKEL1.txt,465225,466281,1056,5,N,Y,1435246956861,465116,468674
REMKEL1.txt,466282,467640,1358,5,N,Y,1435246956861,465116,468674
REMKEL1.txt,467643,468613,970,5,N,Y,1435246956861,465116,468674
REMKEL1.txt,468614,469401,787,5,N,Y,1435246956861,465116,468674
REMKEL1.txt,469404,470232,828,5,N,N,-,-1,-1
REMKEL1.txt,470233,471190,957,5,N,N,-,-1,-1
REMKEL1.txt,471191,471832,641,5,N,N,-,-1,-1
REMKEL1.txt,471833,472337,504,5,N,N,-,-1,-1
REMKEL1.txt,472338,472688,350,5,N,N,-,-1,-1
REMKEL1.txt,472689,473054,365,5,N,N,-,-1,-1
REMKEL1.txt,473055,473793,738,5,N,N,-,-1,-1
REMKEL1.txt,473794,474638,844,5,N,Y,1435248772832,474122,475026
REMKEL1.txt,474641,475338,697,5,N,Y,1435248772832,474122,475026
REMKEL1.txt,475341,476339,998,5,Y,N,-,-1,-1
REMKEL1.txt,476340,477116,776,5,N,N,-,-1,-1
REMKEL1.txt,477117,477551,434,5,N,N,-,-1,-1
REMKEL1.txt,477554,478316,762,5,N,Y,1435249587702,477567,478661
REMKEL1.txt,478317,479358,1041,5,N,Y,1435249587702,477567,478661
REMKEL1.txt,479359,481102,1743,5,N,Y,1435250182755,479084,480863
REMKEL1.txt,481103,481877,774,5,N,N,-,-1,-1
REMKEL1.txt,481879,482719,840,5,N,N,-,-1,-1
REMKEL1.txt,482720,483644,924,5,N,N,-,-1,-1
REMKEL1.txt,483645,484370,725,5,N,N,-,-1,-1
REMKEL1.txt,484371,485154,783,5,N,N,-,-1,-1
REMKEL1.txt,485155,485889,734,5,N,N,-,-1,-1
REMKEL1.txt,485890,486503,613,5,N,N,-,-1,-1
REMKEL1.txt,486506,487036,530,5,N,N,-,-1,-1
REMKEL1.txt,487037,488035,998,5,N,N,-,-1,-1
REMKEL1.txt,488038,488639,601,5,N,N,-,-1,-1
REMKEL1.txt,488642,489503,861,5,N,N,-,-1,-1
REMKEL1.txt,489504,490643,1139,5,N,Y,1435312884754,489937,490626
REMKEL1.txt,490646,491546,900,5,N,N,-,-1,-1
REMKEL1.txt,491549,492346,797,5,N,N,-,-1,-1
REMKEL1.txt,492347,493107,760,5,N,N,-,-1,-1
REMKEL1.txt,493108,494324,1216,5,N,N,-,-1,-1
REMKEL1.txt,494325,495038,713,5,N,N,-,-1,-1
REMKEL1.txt,495039,495639,600,5,N,N,-,-1,-1
REMKEL1.txt,495641,496430,789,5,N,N,-,-1,-1
REMKEL1.txt,496431,497281,850,5,N,N,-,-1,-1
REMKEL1.txt,497282,498084,802,5,N,N,-,-1,-1
REMKEL1.txt,498086,498802,716,5,N,N,-,-1,-1
REMKEL1.txt,498805,499660,855,5,N,Y,1435314166443,498844,500332
REMKEL1.txt,499661,500813,1152,5,N,Y,1435314166443,498844,500332
REMKEL1.txt,500816,501308,492,5,N,N,-,-1,-1
REMKEL1.txt,501308,501417,109,5,N,N,-,-1,-1
REMKEL2.txt,0,63,63,5,N,N,-,-1,-1
REMKEL2.txt,63,528,465,5,N,N,-,-1,-1
REMKEL2.txt,530,661,131,5,N,N,-,-1,-1
REMKEL2.txt,666,923,257,5,N,N,-,-1,-1
REMKEL2.txt,925,1110,185,5,N,N,-,-1,-1
REMKEL2.txt,1111,1412,301,5,N,N,-,-1,-1
REMKEL2.txt,1413,1626,213,5,N,N,-,-1,-1
REMKEL2.txt,1627,1833,206,5,N,N,-,-1,-1
REMKEL2.txt,1834,2094,260,5,N,N,-,-1,-1
REMKEL2.txt,2095,2390,295,5,N,N,-,-1,-1
REMKEL2.txt,2391,2566,175,5,N,N,-,-1,-1
REMKEL2.txt,2568,2929,361,5,N,N,-,-1,-1
REMKEL2.txt,2930,3215,285,5,N,N,-,-1,-1
REMKEL2.txt,3216,3414,198,5,N,N,-,-1,-1
REMKEL2.txt,3415,3640,225,5,N,N,-,-1,-1
REMKEL2.txt,3642,3860,218,5,N,N,-,-1,-1
REMKEL2.txt,3861,4055,194,5,N,N,-,-1,-1
REMKEL2.txt,4056,4217,161,5,N,N,-,-1,-1
REMKEL2.txt,4218,4391,173,5,N,N,-,-1,-1
REMKEL2.txt,4394,4542,148,5,N,N,-,-1,-1
REMKEL2.txt,4544,4723,179,5,N,N,-,-1,-1
REMKEL2.txt,4724,4982,258,5,N,N,-,-1,-1
REMKEL2.txt,4983,5216,233,5,N,N,-,-1,-1
REMKEL2.txt,5217,5423,206,5,N,N,-,-1,-1
REMKEL2.txt,5424,5644,220,5,N,N,-,-1,-1
REMKEL2.txt,5645,5807,162,5,N,N,-,-1,-1
REMKEL2.txt,5808,6016,208,5,N,N,-,-1,-1
REMKEL2.txt,6017,6199,182,5,N,N,-,-1,-1
REMKEL2.txt,6200,6448,248,5,N,N,-,-1,-1
REMKEL2.txt,6450,6669,219,5,N,N,-,-1,-1
REMKEL2.txt,6669,6815,146,5,N,N,-,-1,-1
REMKEL2.txt,6816,7063,247,5,N,N,-,-1,-1
REMKEL2.txt,7064,7193,129,5,N,N,-,-1,-1
REMKEL2.txt,7194,7449,255,5,N,N,-,-1,-1
REMKEL2.txt,7450,7652,202,5,N,N,-,-1,-1
REMKEL2.txt,7653,7856,203,5,N,N,-,-1,-1
REMKEL2.txt,7857,8007,150,5,N,N,-,-1,-1
REMKEL2.txt,8008,8160,152,5,N,N,-,-1,-1
REMKEL2.txt,8163,8377,214,5,N,N,-,-1,-1
REMKEL2.txt,8378,8596,218,5,N,N,-,-1,-1
REMKEL2.txt,8599,8827,228,5,N,N,-,-1,-1
REMKEL2.txt,8828,9094,266,5,N,N,-,-1,-1
REMKEL2.txt,9095,9232,137,5,N,N,-,-1,-1
REMKEL2.txt,9233,9427,194,5,N,N,-,-1,-1
REMKEL2.txt,9428,9614,186,5,N,N,-,-1,-1
REMKEL2.txt,9615,9845,230,5,N,N,-,-1,-1
REMKEL2.txt,9846,9983,137,5,N,N,-,-1,-1
REMKEL2.txt,9984,10168,184,5,N,N,-,-1,-1
REMKEL2.txt,10169,10366,197,5,N,N,-,-1,-1
REMKEL2.txt,10368,10513,145,5,N,N,-,-1,-1
REMKEL2.txt,10516,10682,166,5,N,N,-,-1,-1
REMKEL2.txt,10684,10817,133,5,N,N,-,-1,-1
REMKEL2.txt,10818,11065,247,5,N,N,-,-1,-1
REMKEL2.txt,11067,11295,228,5,N,N,-,-1,-1
REMKEL2.txt,11296,11498,202,5,N,N,-,-1,-1
REMKEL2.txt,11499,11636,137,5,N,N,-,-1,-1
REMKEL2.txt,11637,11799,162,5,N,N,-,-1,-1
REMKEL2.txt,11800,11989,189,5,N,N,-,-1,-1
REMKEL2.txt,11990,12219,229,5,N,N,-,-1,-1
REMKEL2.txt,12220,12754,534,5,N,N,-,-1,-1
REMKEL2.txt,12755,13223,468,5,N,Y,1435351885643,13188,14403
REMKEL2.txt,13224,13775,551,5,N,Y,1435351885643,13188,14403
REMKEL2.txt,13776,14542,766,5,N,Y,1435355555620,14479,15098
REMKEL2.txt,14543,15129,586,5,N,Y,1435355555620,14479,15098
REMKEL2.txt,15130,17445,2315,5,Y,Y,1435357682797,15132,15608
REMKEL2.txt,17446,18420,974,5,N,Y,1435766521901,15849,17824
REMKEL2.txt,18421,19026,605,5,N,N,-,-1,-1
REMKEL2.txt,19031,19364,333,5,N,N,-,-1,-1
REMKEL2.txt,19367,20329,962,5,N,Y,1435769270470,19677,20071
REMKEL2.txt,20330,21074,744,5,N,N,-,-1,-1
REMKEL2.txt,21076,22438,1362,5,N,Y,1435769967749,22041,22587
REMKEL2.txt,22439,23083,644,5,N,Y,1435769967749,22041,22587
REMKEL2.txt,23084,24259,1175,5,N,Y,1435771053245,23433,25540
REMKEL2.txt,24260,24811,551,5,N,Y,1435771053245,23433,25540
REMKEL2.txt,24812,25962,1150,5,N,Y,1435771053245,23433,25540
REMKEL2.txt,25963,26727,764,5,N,N,-,-1,-1
REMKEL2.txt,26728,27908,1180,5,N,Y,1435782599159,27378,29050
REMKEL2.txt,27909,28585,676,5,N,Y,1435782599159,27378,29050
REMKEL2.txt,28586,29124,538,5,N,Y,1435782599159,27378,29050
REMKEL2.txt,29127,29545,418,5,N,N,-,-1,-1
REMKEL2.txt,29548,30252,704,5,N,N,-,-1,-1
REMKEL2.txt,30253,30660,407,5,N,N,-,-1,-1
REMKEL2.txt,30663,31270,607,5,N,N,-,-1,-1
REMKEL2.txt,31273,31872,599,5,N,Y,1435783099009,31525,31867
REMKEL2.txt,31875,33041,1166,5,N,Y,1435784346015,31918,33454
REMKEL2.txt,33044,33649,605,5,N,Y,1435784346015,31918,33454
REMKEL2.txt,33650,34360,710,5,N,N,-,-1,-1
REMKEL2.txt,34362,35592,1230,5,N,N,-,-1,-1
REMKEL2.txt,35595,36626,1031,5,N,N,-,-1,-1
REMKEL2.txt,36627,37337,710,5,N,N,-,-1,-1
REMKEL2.txt,37338,38179,841,5,N,N,-,-1,-1
REMKEL2.txt,38180,38979,799,5,N,N,-,-1,-1
REMKEL2.txt,38980,40007,1027,5,N,N,-,-1,-1
REMKEL2.txt,40008,41317,1309,5,N,N,-,-1,-1
REMKEL2.txt,41318,42532,1214,5,N,Y,1435857399186,41984,42949
REMKEL2.txt,42535,43957,1422,5,N,Y,1435857399186,41984,42949
REMKEL2.txt,43958,44591,633,5,N,N,-,-1,-1
REMKEL2.txt,44592,45384,792,5,N,N,-,-1,-1
REMKEL2.txt,45387,46572,1185,5,N,N,-,-1,-1
REMKEL2.txt,46573,47673,1100,5,N,N,-,-1,-1
REMKEL2.txt,47675,48799,1124,5,N,N,-,-1,-1
REMKEL2.txt,48802,49789,987,5,N,N,-,-1,-1
REMKEL2.txt,49792,50609,817,5,N,N,-,-1,-1
REMKEL2.txt,50612,51556,944,5,N,N,-,-1,-1
REMKEL2.txt,51557,52694,1137,5,N,N,-,-1,-1
REMKEL2.txt,52695,53408,713,5,N,N,-,-1,-1
REMKEL2.txt,53409,54036,627,5,N,Y,1435858450692,53412,54290
REMKEL2.txt,54037,54715,678,5,N,Y,1435858450692,53412,54290
REMKEL2.txt,54717,55502,785,5,N,Y,1435858990668,54337,55671
REMKEL2.txt,55503,55872,369,5,N,Y,1435858990668,54337,55671
REMKEL2.txt,55873,57100,1227,5,N,N,-,-1,-1
REMKEL2.txt,57101,57938,837,5,Y,Y,1435862440580,57258,58200
REMKEL2.txt,57939,58519,580,5,N,Y,1435862440580,57258,58200
REMKEL2.txt,58520,59729,1209,5,N,N,-,-1,-1
REMKEL2.txt,59730,60594,864,5,N,Y,1435863052573,60462,60688
REMKEL2.txt,60595,60815,220,5,N,Y,1435863052573,60462,60688
REMKEL2.txt,60816,61516,700,5,N,Y,1435863114996,60692,60989
REMKEL2.txt,61517,62192,675,5,N,N,-,-1,-1
REMKEL2.txt,62194,62818,624,5,N,N,-,-1,-1
REMKEL2.txt,62819,63568,749,5,N,N,-,-1,-1
REMKEL2.txt,63569,64416,847,5,N,N,-,-1,-1
REMKEL2.txt,64418,65294,876,5,N,N,-,-1,-1
REMKEL2.txt,65295,66504,1209,5,N,N,-,-1,-1
REMKEL2.txt,66507,67447,940,5,N,N,-,-1,-1
REMKEL2.txt,67450,68332,882,5,N,N,-,-1,-1
REMKEL2.txt,68333,68945,612,5,N,N,-,-1,-1
REMKEL2.txt,68946,69950,1004,5,N,N,-,-1,-1
REMKEL2.txt,69953,70293,340,5,N,N,-,-1,-1
REMKEL2.txt,70298,70986,688,5,N,N,-,-1,-1
REMKEL2.txt,70989,72374,1385,5,N,N,-,-1,-1
REMKEL2.txt,72375,73178,803,5,N,N,-,-1,-1
REMKEL2.txt,73179,74056,877,5,N,N,-,-1,-1
REMKEL2.txt,74057,74433,376,5,N,N,-,-1,-1
REMKEL2.txt,74434,74835,401,5,N,N,-,-1,-1
REMKEL2.txt,74836,75680,844,5,N,N,-,-1,-1
REMKEL2.txt,75681,76585,904,5,N,N,-,-1,-1
REMKEL2.txt,76586,77397,811,5,N,N,-,-1,-1
REMKEL2.txt,77398,78116,718,5,N,N,-,-1,-1
REMKEL2.txt,78117,78557,440,5,N,N,-,-1,-1
REMKEL2.txt,78559,78903,344,5,N,N,-,-1,-1
REMKEL2.txt,78905,79838,933,5,N,N,-,-1,-1
REMKEL2.txt,79839,80700,861,5,N,N,-,-1,-1
REMKEL2.txt,80703,81088,385,5,N,N,-,-1,-1
REMKEL2.txt,81090,81552,462,5,N,Y,1435865160115,81233,81988
REMKEL2.txt,81554,82316,762,5,N,Y,1435865160115,81233,81988
REMKEL2.txt,82317,83241,924,5,N,N,-,-1,-1
REMKEL2.txt,83243,84320,1077,5,N,N,-,-1,-1
REMKEL2.txt,84322,85287,965,5,N,N,-,-1,-1
REMKEL2.txt,85289,86286,997,5,N,N,-,-1,-1
REMKEL2.txt,86289,87926,1637,5,N,Y,1435865766643,87290,87654
REMKEL2.txt,87927,88524,597,5,N,N,-,-1,-1
REMKEL2.txt,88525,89804,1279,5,N,N,-,-1,-1
REMKEL2.txt,89806,90147,341,5,N,N,-,-1,-1
REMKEL2.txt,90148,90883,735,5,N,N,-,-1,-1
REMKEL2.txt,90886,91874,988,5,N,N,-,-1,-1
REMKEL2.txt,91875,93089,1214,5,N,N,-,-1,-1
REMKEL2.txt,93090,93581,491,5,N,N,-,-1,-1
REMKEL2.txt,93582,94597,1015,5,N,N,-,-1,-1
REMKEL2.txt,94598,95652,1054,5,Y,N,-,-1,-1
REMKEL2.txt,95653,96174,521,5,N,N,-,-1,-1
REMKEL2.txt,96177,96732,555,5,N,N,-,-1,-1
REMKEL2.txt,96733,97456,723,5,N,N,-,-1,-1
REMKEL2.txt,97459,98201,742,5,N,Y,1436126047679,97988,98333
REMKEL2.txt,98202,98935,733,5,N,Y,1436126047679,97988,98333
REMKEL2.txt,98937,99894,957,5,N,N,-,-1,-1
REMKEL2.txt,99897,101052,1155,5,N,Y,1436126680550,100972,101605
REMKEL2.txt,101053,101718,665,5,N,Y,1436126680550,100972,101605
REMKEL2.txt,101719,102387,668,5,N,Y,1436126929844,101615,102764
REMKEL2.txt,102388,103107,719,5,N,Y,1436126929844,101615,102764
REMKEL2.txt,103108,103702,594,5,N,N,-,-1,-1
REMKEL2.txt,103703,103828,125,5,N,N,-,-1,-1
REMKEL2.txt,103831,104680,849,5,N,Y,1436293470468,103834,104024
REMKEL2.txt,104681,105383,702,5,N,Y,1436293974870,105377,105629
REMKEL2.txt,105386,106291,905,5,N,Y,1436293974870,105377,105629
REMKEL2.txt,106292,106789,497,5,N,N,-,-1,-1
REMKEL2.txt,106790,106943,153,5,N,N,-,-1,-1
REMKEL2.txt,106946,107668,722,5,N,N,-,-1,-1
REMKEL2.txt,107670,108471,801,5,N,N,-,-1,-1
REMKEL2.txt,108474,108920,446,5,N,N,-,-1,-1
REMKEL2.txt,108921,109779,858,5,N,N,-,-1,-1
REMKEL2.txt,109782,110652,870,5,N,Y,1436297889987,109780,110435
REMKEL2.txt,110653,111584,931,5,N,Y,1436298400992,111204,111685
REMKEL2.txt,111585,112010,425,5,N,Y,1436298400992,111204,111685
REMKEL2.txt,112011,112790,779,5,N,Y,1436298772179,111746,112985
REMKEL2.txt,112795,113302,507,5,N,Y,1436298772179,111746,112985
REMKEL2.txt,113303,114513,1210,5,N,N,-,-1,-1
REMKEL2.txt,114516,115153,637,5,N,Y,1436352387119,114514,115080
REMKEL2.txt,115154,115913,759,5,N,Y,1436352571813,115777,116442
REMKEL2.txt,115914,116760,846,5,N,Y,1436352571813,115777,116442
REMKEL2.txt,116762,117527,765,5,N,Y,1436352919472,117021,119063
REMKEL2.txt,117528,118333,805,5,N,Y,1436352919472,117021,119063
REMKEL2.txt,118334,118984,650,5,N,Y,1436352919472,117021,119063
REMKEL2.txt,118985,119707,722,5,N,Y,1436352919472,117021,119063
REMKEL2.txt,119709,120052,343,5,N,N,-,-1,-1
REMKEL2.txt,120057,120364,307,5,N,N,-,-1,-1
REMKEL2.txt,120365,120873,508,5,N,N,-,-1,-1
REMKEL2.txt,120876,121373,497,5,N,N,-,-1,-1
REMKEL2.txt,121374,121598,224,5,N,N,-,-1,-1
REMKEL2.txt,121598,122359,761,5,N,Y,1436472126635,121874,122900
REMKEL2.txt,122360,123184,824,5,N,Y,1436472126635,121874,122900
REMKEL2.txt,123185,124208,1023,5,N,N,-,-1,-1
REMKEL2.txt,124209,124927,718,5,N,N,-,-1,-1
REMKEL2.txt,124928,125752,824,5,N,N,-,-1,-1
REMKEL2.txt,125754,126782,1028,5,N,N,-,-1,-1
REMKEL2.txt,126785,127779,994,5,Y,N,-,-1,-1
REMKEL2.txt,127780,128831,1051,5,N,N,-,-1,-1
REMKEL2.txt,128832,129756,924,5,N,N,-,-1,-1
REMKEL2.txt,129757,130988,1231,5,N,N,-,-1,-1
REMKEL2.txt,130991,131938,947,5,N,N,-,-1,-1
REMKEL2.txt,131941,132923,982,5,N,N,-,-1,-1
REMKEL2.txt,132924,133844,920,5,N,N,-,-1,-1
REMKEL2.txt,133845,134956,1111,5,N,Y,1436813469893,134408,134846
REMKEL2.txt,134958,135739,781,5,N,N,-,-1,-1
REMKEL2.txt,135740,136482,742,5,N,N,-,-1,-1
REMKEL2.txt,136484,137046,562,5,N,N,-,-1,-1
REMKEL2.txt,137049,137843,794,5,N,N,-,-1,-1
REMKEL2.txt,137846,138494,648,5,N,N,-,-1,-1
REMKEL2.txt,138495,138970,475,5,N,N,-,-1,-1
REMKEL2.txt,138971,140346,1375,5,N,N,-,-1,-1
REMKEL2.txt,140347,141177,830,5,N,N,-,-1,-1
REMKEL2.txt,141178,141893,715,5,N,N,-,-1,-1
REMKEL2.txt,141896,142938,1042,5,N,N,-,-1,-1
REMKEL2.txt,142941,144020,1079,5,N,N,-,-1,-1
REMKEL2.txt,144021,144143,122,5,N,N,-,-1,-1
REMKEL2.txt,144144,144751,607,5,N,N,-,-1,-1
REMKEL2.txt,144752,145340,588,5,N,N,-,-1,-1
REMKEL2.txt,145341,146456,1115,5,N,N,-,-1,-1
REMKEL2.txt,146459,147210,751,5,N,N,-,-1,-1
REMKEL2.txt,147211,148480,1269,5,N,N,-,-1,-1
REMKEL2.txt,148483,149284,801,5,N,N,-,-1,-1
REMKEL2.txt,149285,149917,632,5,N,N,-,-1,-1
REMKEL2.txt,149918,150938,1020,5,N,N,-,-1,-1
REMKEL2.txt,150939,151851,912,5,N,N,-,-1,-1
REMKEL2.txt,151854,152236,382,5,N,N,-,-1,-1
REMKEL2.txt,152238,153012,774,5,N,N,-,-1,-1
REMKEL2.txt,153014,153857,843,5,N,N,-,-1,-1
REMKEL2.txt,153858,154863,1005,5,N,N,-,-1,-1
REMKEL2.txt,154863,155481,618,5,N,N,-,-1,-1
REMKEL2.txt,155482,156088,606,5,N,N,-,-1,-1
REMKEL2.txt,156089,156865,776,5,N,N,-,-1,-1
REMKEL2.txt,156866,157991,1125,5,Y,N,-,-1,-1
REMKEL2.txt,157992,159219,1227,5,N,N,-,-1,-1
REMKEL2.txt,159222,159769,547,5,N,N,-,-1,-1
REMKEL2.txt,159770,160305,535,5,N,N,-,-1,-1
REMKEL2.txt,160310,161048,738,5,N,N,-,-1,-1
REMKEL2.txt,161051,161939,888,5,N,N,-,-1,-1
REMKEL2.txt,161939,163041,1102,5,N,N,-,-1,-1
REMKEL2.txt,163042,163674,632,5,N,N,-,-1,-1
REMKEL2.txt,163677,164571,894,5,N,N,-,-1,-1
REMKEL2.txt,164572,165789,1217,5,N,N,-,-1,-1
REMKEL2.txt,165791,166717,926,5,N,N,-,-1,-1
REMKEL2.txt,166718,168230,1512,5,N,N,-,-1,-1
REMKEL2.txt,168231,168990,759,5,N,N,-,-1,-1
REMKEL2.txt,168993,169945,952,5,N,N,-,-1,-1
REMKEL2.txt,169948,170914,966,5,N,Y,1436888170573,169972,170218
REMKEL2.txt,170915,172005,1090,5,N,N,-,-1,-1
REMKEL2.txt,172006,172671,665,5,N,N,-,-1,-1
REMKEL2.txt,172672,173510,838,5,N,N,-,-1,-1
REMKEL2.txt,173513,174400,887,5,N,N,-,-1,-1
REMKEL2.txt,174403,175856,1453,5,N,N,-,-1,-1
REMKEL2.txt,175857,176277,420,5,N,N,-,-1,-1
REMKEL2.txt,176279,177022,743,5,N,N,-,-1,-1
REMKEL2.txt,177023,177741,718,5,N,N,-,-1,-1
REMKEL2.txt,177744,178813,1069,5,N,N,-,-1,-1
REMKEL2.txt,178814,179322,508,5,N,N,-,-1,-1
REMKEL2.txt,179323,179996,673,5,N,N,-,-1,-1
REMKEL2.txt,179999,180793,794,5,N,N,-,-1,-1
REMKEL2.txt,180794,181088,294,5,N,N,-,-1,-1
REMKEL2.txt,181089,182282,1193,5,N,N,-,-1,-1
REMKEL2.txt,182283,182933,650,5,N,N,-,-1,-1
REMKEL2.txt,182936,183765,829,5,N,N,-,-1,-1
REMKEL2.txt,183766,184574,808,5,N,Y,1436889057877,184044,184421
REMKEL2.txt,184576,185354,778,5,N,N,-,-1,-1
REMKEL2.txt,185357,186050,693,5,N,N,-,-1,-1
REMKEL2.txt,186051,186772,721,5,N,N,-,-1,-1
REMKEL2.txt,186773,188032,1259,5,N,N,-,-1,-1
REMKEL2.txt,188033,188507,474,5,N,N,-,-1,-1
REMKEL2.txt,188510,189055,545,5,N,N,-,-1,-1
REMKEL2.txt,189057,189452,395,5,N,N,-,-1,-1
REMKEL2.txt,189454,190422,968,5,N,N,-,-1,-1
REMKEL2.txt,190425,191498,1073,5,N,N,-,-1,-1
REMKEL2.txt,191501,192086,585,5,N,N,-,-1,-1
REMKEL2.txt,192087,192700,613,5,N,N,-,-1,-1
REMKEL2.txt,192703,193753,1050,5,N,N,-,-1,-1
REMKEL2.txt,193754,194492,738,5,N,N,-,-1,-1
REMKEL2.txt,194493,195042,549,5,N,N,-,-1,-1
REMKEL2.txt,195043,195817,774,5,N,N,-,-1,-1
REMKEL2.txt,195820,196743,923,5,N,N,-,-1,-1
REMKEL2.txt,196744,197606,862,5,N,N,-,-1,-1
REMKEL2.txt,197607,198703,1096,5,N,N,-,-1,-1
REMKEL2.txt,198704,199165,461,5,N,N,-,-1,-1
REMKEL2.txt,199168,200519,1351,5,N,N,-,-1,-1
REMKEL2.txt,200520,201583,1063,5,N,N,-,-1,-1
REMKEL2.txt,201584,202489,905,5,N,N,-,-1,-1
REMKEL2.txt,202492,203861,1369,5,N,N,-,-1,-1
REMKEL2.txt,203864,204244,380,5,N,N,-,-1,-1
REMKEL2.txt,204247,205090,843,5,N,N,-,-1,-1
REMKEL2.txt,205091,205803,712,5,N,Y,1436891628994,205586,205983
REMKEL2.txt,205804,206571,767,5,N,Y,1436891908281,205997,206745
REMKEL2.txt,206573,207053,480,5,N,Y,1436892204871,206775,207267
REMKEL2.txt,207053,207815,762,5,N,Y,1436892204871,206775,207267
REMKEL2.txt,207818,209338,1520,5,N,N,-,-1,-1
REMKEL2.txt,209341,210334,993,5,N,N,-,-1,-1
REMKEL2.txt,210337,211310,973,5,N,N,-,-1,-1
REMKEL2.txt,211311,212453,1142,5,N,N,-,-1,-1
REMKEL2.txt,212456,214093,1637,5,N,N,-,-1,-1
REMKEL2.txt,214094,215362,1268,5,N,N,-,-1,-1
REMKEL2.txt,215364,216329,965,5,N,N,-,-1,-1
REMKEL2.txt,216330,217284,954,5,N,N,-,-1,-1
REMKEL2.txt,217287,218344,1057,5,N,N,-,-1,-1
REMKEL2.txt,218347,218926,579,5,N,N,-,-1,-1
REMKEL2.txt,218927,219745,818,5,N,N,-,-1,-1
REMKEL2.txt,219746,220760,1014,5,N,N,-,-1,-1
REMKEL2.txt,220761,221457,696,5,N,N,-,-1,-1
REMKEL2.txt,221458,222828,1370,5,Y,N,-,-1,-1
REMKEL2.txt,222831,223559,728,5,N,N,-,-1,-1
REMKEL2.txt,223562,224066,504,5,N,N,-,-1,-1
REMKEL2.txt,224069,224480,411,5,N,N,-,-1,-1
REMKEL2.txt,224481,225316,835,5,N,N,-,-1,-1
REMKEL2.txt,225317,225954,637,5,Y,N,-,-1,-1
REMKEL2.txt,225955,226760,805,5,N,N,-,-1,-1
REMKEL2.txt,226761,227321,560,5,N,N,-,-1,-1
REMKEL2.txt,227323,228221,898,5,N,N,-,-1,-1
REMKEL2.txt,228222,228777,555,5,N,N,-,-1,-1
REMKEL2.txt,228778,229443,665,5,N,N,-,-1,-1
REMKEL2.txt,229444,230128,684,5,N,N,-,-1,-1
REMKEL2.txt,230131,231054,923,5,N,Y,1436953347952,230164,230508
REMKEL2.txt,231055,231661,606,5,N,N,-,-1,-1
REMKEL2.txt,231664,232227,563,5,N,N,-,-1,-1
REMKEL2.txt,232228,233258,1030,5,N,N,-,-1,-1
REMKEL2.txt,233261,233892,631,5,N,Y,1436954082750,233291,233734
REMKEL2.txt,233893,234546,653,5,N,Y,1436954332871,233749,233924
REMKEL2.txt,234549,235377,828,5,N,N,-,-1,-1
REMKEL2.txt,235378,236313,935,5,N,N,-,-1,-1
REMKEL2.txt,236314,237223,909,5,N,N,-,-1,-1
REMKEL2.txt,237224,237963,739,5,N,N,-,-1,-1
REMKEL2.txt,237964,238600,636,5,N,N,-,-1,-1
REMKEL2.txt,238601,239337,736,5,N,N,-,-1,-1
REMKEL2.txt,239338,239926,588,5,N,N,-,-1,-1
REMKEL2.txt,239927,240674,747,5,N,N,-,-1,-1
REMKEL2.txt,240675,241331,656,5,N,Y,1436990194671,241135,241539
REMKEL2.txt,241333,241664,331,5,N,Y,1436990194671,241135,241539
REMKEL2.txt,241665,242571,906,5,N,N,-,-1,-1
REMKEL2.txt,242571,242783,212,5,N,N,-,-1,-1
REMKEL2.txt,242784,243640,856,5,N,Y,1437162662523,242944,243494
REMKEL2.txt,243643,244374,731,5,N,Y,1437164000244,243648,244317
REMKEL2.txt,244377,244972,595,5,N,N,-,-1,-1
REMKEL2.txt,244973,245743,770,5,N,N,-,-1,-1
REMKEL2.txt,245745,246377,632,5,N,N,-,-1,-1
REMKEL2.txt,246380,247157,777,5,N,N,-,-1,-1
REMKEL2.txt,247158,248227,1069,5,N,N,-,-1,-1
REMKEL2.txt,248228,249030,802,5,N,N,-,-1,-1
REMKEL2.txt,249031,249652,621,5,N,N,-,-1,-1
REMKEL2.txt,249653,250355,702,5,N,N,-,-1,-1
REMKEL2.txt,250357,250923,566,5,N,N,-,-1,-1
REMKEL2.txt,250925,251339,414,5,N,N,-,-1,-1
REMKEL2.txt,251340,252326,986,5,N,N,-,-1,-1
REMKEL2.txt,252327,253208,881,5,N,N,-,-1,-1
REMKEL2.txt,253210,254042,832,5,N,Y,1437230370982,253380,254066
REMKEL2.txt,254043,254532,489,5,N,Y,1437230370982,253380,254066
REMKEL2.txt,254533,255320,787,5,N,N,-,-1,-1
REMKEL2.txt,255321,256246,925,5,N,N,-,-1,-1
REMKEL2.txt,256247,256963,716,5,N,N,-,-1,-1
REMKEL2.txt,256964,257956,992,5,N,N,-,-1,-1
REMKEL2.txt,257957,258912,955,5,N,N,-,-1,-1
REMKEL2.txt,258913,259697,784,5,N,N,-,-1,-1
REMKEL2.txt,259698,260417,719,5,N,N,-,-1,-1
REMKEL2.txt,260420,261753,1333,5,N,N,-,-1,-1
REMKEL2.txt,261754,262396,642,5,N,N,-,-1,-1
REMKEL2.txt,262397,263219,822,5,N,Y,1437239674324,263038,263264
REMKEL2.txt,263220,264144,924,5,N,Y,1437239750517,263268,263763
REMKEL2.txt,264145,264945,800,5,N,Y,1437246845677,264808,265284
REMKEL2.txt,264946,265505,559,5,N,Y,1437246845677,264808,265284
REMKEL2.txt,265507,266081,574,5,N,Y,1437246918352,265302,265939
REMKEL2.txt,266082,266984,902,5,N,Y,1437247439363,265960,266383
REMKEL2.txt,266985,267514,529,5,N,N,-,-1,-1
REMKEL2.txt,267515,268273,758,5,N,N,-,-1,-1
REMKEL2.txt,268275,269431,1156,5,N,Y,1437247700707,268409,269169
REMKEL2.txt,269432,270076,644,5,N,Y,1437248020573,269635,269983
REMKEL2.txt,270077,270503,426,5,N,Y,1437248366748,269999,270475
REMKEL2.txt,270506,271653,1147,5,N,N,-,-1,-1
REMKEL2.txt,271654,272099,445,5,N,N,-,-1,-1
REMKEL2.txt,272100,272469,369,5,N,N,-,-1,-1
REMKEL2.txt,272470,273069,599,5,N,N,-,-1,-1
REMKEL2.txt,273072,273991,919,5,N,N,-,-1,-1
REMKEL2.txt,273994,274968,974,5,N,N,-,-1,-1
REMKEL2.txt,274969,275625,656,5,N,N,-,-1,-1
REMKEL2.txt,275626,276249,623,5,N,N,-,-1,-1
REMKEL2.txt,276251,277119,868,5,N,N,-,-1,-1
REMKEL2.txt,277122,277881,759,5,N,N,-,-1,-1
REMKEL2.txt,277881,278542,661,5,N,N,-,-1,-1
REMKEL2.txt,278543,279864,1321,5,N,N,-,-1,-1
REMKEL2.txt,279865,280592,727,5,N,N,-,-1,-1
REMKEL2.txt,280593,281378,785,5,N,N,-,-1,-1
REMKEL2.txt,281379,282524,1145,5,N,N,-,-1,-1
REMKEL2.txt,282526,283315,789,5,N,N,-,-1,-1
REMKEL2.txt,283317,283988,671,5,N,N,-,-1,-1
REMKEL2.txt,283991,284377,386,5,N,N,-,-1,-1
REMKEL2.txt,284378,285289,911,5,N,N,-,-1,-1
REMKEL2.txt,285292,286001,709,5,N,N,-,-1,-1
REMKEL2.txt,286002,286807,805,5,N,N,-,-1,-1
REMKEL2.txt,286810,287281,471,5,N,Y,1437304627219,286832,287509
REMKEL2.txt,287283,288404,1121,5,N,Y,1437304627219,286832,287509
REMKEL2.txt,288407,289352,945,5,N,N,-,-1,-1
REMKEL2.txt,289353,290016,663,5,N,N,-,-1,-1
REMKEL2.txt,290017,291277,1260,5,N,N,-,-1,-1
REMKEL2.txt,291278,292251,973,5,N,N,-,-1,-1
REMKEL2.txt,292252,292705,453,5,N,Y,1437307314987,292427,293858
REMKEL2.txt,292706,293629,923,5,N,Y,1437307314987,292427,293858
REMKEL2.txt,293631,294080,449,5,N,Y,1437307314987,292427,293858
REMKEL2.txt,294081,294669,588,5,N,Y,1437308275313,294601,295236
REMKEL2.txt,294670,295256,586,5,N,Y,1437308275313,294601,295236
REMKEL2.txt,295261,296178,917,5,N,Y,1437308845347,295831,296335
REMKEL2.txt,296179,296745,566,5,N,Y,1437308845347,295831,296335
REMKEL2.txt,296746,297475,729,5,N,N,-,-1,-1
REMKEL2.txt,297476,298087,611,5,N,N,-,-1,-1
REMKEL2.txt,298088,299159,1071,5,N,N,-,-1,-1
REMKEL2.txt,299162,299674,512,5,N,N,-,-1,-1
REMKEL2.txt,299675,300773,1098,5,N,N,-,-1,-1
REMKEL2.txt,300776,301339,563,5,N,N,-,-1,-1
REMKEL2.txt,301342,302010,668,5,N,N,-,-1,-1
REMKEL2.txt,302011,302616,605,5,N,N,-,-1,-1
REMKEL2.txt,302618,303342,724,5,N,Y,1437326732408,303180,303407
REMKEL2.txt,303343,304046,703,5,N,Y,1437326732408,303180,303407
REMKEL2.txt,304048,304786,738,5,N,N,-,-1,-1
REMKEL2.txt,304787,305277,490,5,N,N,-,-1,-1
REMKEL2.txt,305280,306089,809,5,N,N,-,-1,-1
REMKEL2.txt,306090,306843,753,5,N,N,-,-1,-1
REMKEL2.txt,306845,307582,737,5,N,N,-,-1,-1
REMKEL2.txt,307583,308487,904,5,N,N,-,-1,-1
REMKEL2.txt,308488,309141,653,5,N,N,-,-1,-1
REMKEL2.txt,309144,309744,600,5,N,N,-,-1,-1
REMKEL2.txt,309746,310699,953,5,N,N,-,-1,-1
REMKEL2.txt,310700,311373,673,5,N,Y,1437327783601,310966,311726
REMKEL2.txt,311374,311934,560,5,N,Y,1437327783601,310966,311726
REMKEL2.txt,311937,312400,463,5,N,Y,1437328064404,312197,312391
REMKEL2.txt,312403,312931,528,5,N,N,-,-1,-1
REMKEL2.txt,312932,313521,589,5,N,N,-,-1,-1
REMKEL2.txt,313524,314205,681,5,N,N,-,-1,-1
REMKEL2.txt,314206,314954,748,5,N,N,-,-1,-1
REMKEL2.txt,314957,315743,786,5,N,N,-,-1,-1
REMKEL2.txt,315745,317049,1304,5,N,N,-,-1,-1
REMKEL2.txt,317052,317720,668,5,N,N,-,-1,-1
REMKEL2.txt,317721,318927,1206,5,N,N,-,-1,-1
REMKEL2.txt,318930,319848,918,5,N,N,-,-1,-1
REMKEL2.txt,319849,320298,449,5,N,N,-,-1,-1
REMKEL2.txt,320299,320964,665,5,N,N,-,-1,-1
REMKEL2.txt,320965,321505,540,5,N,N,-,-1,-1
REMKEL2.txt,321507,322201,694,5,N,N,-,-1,-1
REMKEL2.txt,322202,322537,335,5,N,N,-,-1,-1
REMKEL2.txt,322538,322997,459,5,N,N,-,-1,-1
REMKEL2.txt,322998,323927,929,5,N,N,-,-1,-1
REMKEL2.txt,323932,324870,938,5,N,N,-,-1,-1
REMKEL2.txt,324871,325843,972,5,N,N,-,-1,-1
REMKEL2.txt,325844,326083,239,5,N,N,-,-1,-1
REMKEL2.txt,326084,326907,823,5,N,N,-,-1,-1
REMKEL2.txt,326910,327531,621,5,N,N,-,-1,-1
REMKEL2.txt,327532,328102,570,5,N,N,-,-1,-1
REMKEL2.txt,328103,328773,670,5,N,Y,1437329475190,328720,329175
REMKEL2.txt,328774,329263,489,5,N,Y,1437329475190,328720,329175
REMKEL2.txt,329264,330204,940,5,N,Y,1437329660899,329215,329510
REMKEL2.txt,330207,330811,604,5,N,Y,1437329990944,330563,331008
REMKEL2.txt,330812,331468,656,5,N,Y,1437329990944,330563,331008
REMKEL2.txt,331471,332437,966,5,N,N,-,-1,-1
REMKEL2.txt,332438,333017,579,5,N,Y,1437330221492,332568,334983
REMKEL2.txt,333020,333734,714,5,N,Y,1437330221492,332568,334983
REMKEL2.txt,333735,334154,419,5,N,Y,1437330221492,332568,334983
REMKEL2.txt,334155,335043,888,5,N,Y,1437330221492,332568,334983
REMKEL2.txt,335046,335898,852,5,N,N,-,-1,-1
REMKEL2.txt,335899,336320,421,5,N,N,-,-1,-1
REMKEL2.txt,336321,337082,761,5,N,Y,1437406606228,336576,337981
REMKEL2.txt,337083,337856,773,5,N,Y,1437406606228,336576,337981
REMKEL2.txt,337859,338381,522,5,N,Y,1437406606228,336576,337981
REMKEL2.txt,338382,338844,462,5,N,Y,1437406989981,338684,339072
REMKEL2.txt,338845,339448,603,5,N,Y,1437406989981,338684,339072
REMKEL2.txt,339449,340003,554,5,N,N,-,-1,-1
REMKEL2.txt,340004,340890,886,5,N,N,-,-1,-1
REMKEL2.txt,340893,341893,1000,5,N,Y,1437407180880,341111,341253
REMKEL2.txt,341894,342779,885,5,N,N,-,-1,-1
REMKEL2.txt,342782,343238,456,5,N,N,-,-1,-1
REMKEL2.txt,343241,343950,709,5,N,Y,1437408733806,343263,344199
REMKEL2.txt,343951,344823,872,5,N,Y,1437408733806,343263,344199
REMKEL2.txt,344824,345627,803,5,N,N,-,-1,-1
REMKEL2.txt,345628,346465,837,5,N,N,-,-1,-1
REMKEL2.txt,346466,347104,638,5,N,N,-,-1,-1
REMKEL2.txt,347105,347680,575,5,N,N,-,-1,-1
REMKEL2.txt,347683,348498,815,5,N,N,-,-1,-1
REMKEL2.txt,348503,349449,946,5,N,N,-,-1,-1
REMKEL2.txt,349450,349839,389,5,N,N,-,-1,-1
REMKEL2.txt,349840,350454,614,5,N,Y,1437411277724,350226,350749
REMKEL2.txt,350455,351496,1041,5,Y,Y,1437411366462,350764,351452
REMKEL2.txt,351499,352395,896,5,N,N,-,-1,-1
REMKEL2.txt,352396,352979,583,5,N,Y,1437415954991,352776,353698
REMKEL2.txt,352980,354311,1331,5,N,Y,1437415954991,352776,353698
REMKEL2.txt,354314,355577,1263,5,N,N,-,-1,-1
REMKEL2.txt,355578,356975,1397,5,N,N,-,-1,-1
REMKEL2.txt,356976,358092,1116,5,N,N,-,-1,-1
REMKEL2.txt,358093,358912,819,5,N,N,-,-1,-1
REMKEL2.txt,358915,359940,1025,5,N,N,-,-1,-1
REMKEL2.txt,359943,361073,1130,5,N,N,-,-1,-1
REMKEL2.txt,361074,362835,1761,5,N,Y,1437426519522,362639,362832
REMKEL2.txt,362838,363476,638,5,N,N,-,-1,-1
REMKEL2.txt,363477,364041,564,5,N,N,-,-1,-1
REMKEL2.txt,364042,364716,674,5,N,Y,1437428195505,364284,364459
REMKEL2.txt,364718,365605,887,5,N,N,-,-1,-1
REMKEL2.txt,365608,366135,527,5,N,N,-,-1,-1
REMKEL2.txt,366138,366405,267,5,N,N,-,-1,-1
REMKEL2.txt,366406,367304,898,5,N,N,-,-1,-1
REMKEL2.txt,367305,368012,707,5,N,N,-,-1,-1
REMKEL2.txt,368015,368930,915,5,N,N,-,-1,-1
REMKEL2.txt,368933,369782,849,5,N,N,-,-1,-1
REMKEL2.txt,369783,371074,1291,5,N,Y,1437429287876,369796,370314
REMKEL2.txt,371075,371751,676,5,N,N,-,-1,-1
REMKEL2.txt,371756,372520,764,5,N,Y,1437429758375,371960,372645
REMKEL2.txt,372523,372940,417,5,N,Y,1437429758375,371960,372645
REMKEL2.txt,372941,373647,706,5,N,Y,1437430014246,372712,373313
REMKEL2.txt,373648,374073,425,5,N,N,-,-1,-1
REMKEL2.txt,374076,374410,334,5,N,N,-,-1,-1
REMKEL2.txt,374411,375136,725,5,N,N,-,-1,-1
REMKEL2.txt,375139,375940,801,5,N,N,-,-1,-1
REMKEL2.txt,375941,376589,648,5,N,N,-,-1,-1
REMKEL2.txt,376590,377080,490,5,N,N,-,-1,-1
REMKEL2.txt,377081,377526,445,5,N,N,-,-1,-1
REMKEL2.txt,377529,377842,313,5,N,N,-,-1,-1
REMKEL2.txt,377845,378292,447,5,N,N,-,-1,-1
REMKEL2.txt,378294,378808,514,5,N,Y,1437430915650,378465,378654
REMKEL2.txt,378811,379365,554,5,N,Y,1437431178768,378814,379710
REMKEL2.txt,379368,380585,1217,5,N,Y,1437497691523,379511,381383
REMKEL2.txt,380586,381385,799,5,N,Y,1437497691523,379511,381383
REMKEL2.txt,381388,381856,468,5,N,Y,1437498238758,381399,381729
REMKEL2.txt,381857,382577,720,5,N,Y,1437498491403,381773,382568
REMKEL2.txt,382579,383813,1234,5,N,Y,1437499345691,382582,382870
REMKEL2.txt,383816,384906,1090,5,N,N,-,-1,-1
REMKEL2.txt,384907,386177,1270,5,N,N,-,-1,-1
REMKEL2.txt,386178,387229,1051,5,N,N,-,-1,-1
REMKEL2.txt,387230,387400,170,5,N,N,-,-1,-1
REMKEL2.txt,387401,387506,105,5,N,N,-,-1,-1
REMKEL2.txt,387508,388059,551,5,N,Y,1437499592999,387747,388053
REMKEL2.txt,388062,388897,835,5,N,Y,1437500212019,388065,389412
REMKEL2.txt,388900,389425,525,5,N,Y,1437500212019,388065,389412
REMKEL2.txt,389428,389642,214,5,N,Y,1437557057765,389552,390910
REMKEL2.txt,389643,390952,1309,5,Y,Y,1437557057765,389552,390910
REMKEL2.txt,390957,391823,866,5,N,Y,1437557985724,390983,391293
REMKEL2.txt,391826,392367,541,5,N,N,-,-1,-1
REMKEL2.txt,392368,393176,808,5,N,N,-,-1,-1
REMKEL2.txt,393179,393997,818,5,N,Y,1437558718321,393945,394737
REMKEL2.txt,393998,395578,1580,5,N,Y,1437558718321,393945,394737
REMKEL2.txt,395581,396328,747,5,N,N,-,-1,-1
REMKEL2.txt,396333,397412,1079,5,N,N,-,-1,-1
REMKEL2.txt,397413,398206,793,5,N,Y,1438688689316,397692,398374
REMKEL2.txt,398209,399508,1299,5,N,Y,1438688689316,397692,398374
REMKEL2.txt,399509,400221,712,5,N,N,-,-1,-1
REMKEL2.txt,400224,401389,1165,5,N,N,-,-1,-1
REMKEL2.txt,401390,402276,886,5,N,N,-,-1,-1
REMKEL2.txt,402277,402973,696,5,N,N,-,-1,-1
REMKEL2.txt,402976,403517,541,5,N,N,-,-1,-1
REMKEL2.txt,403518,403906,388,5,N,Y,1438689541013,403594,405079
REMKEL2.txt,403907,404556,649,5,N,Y,1438689541013,403594,405079
REMKEL2.txt,404557,404829,272,5,N,Y,1438689541013,403594,405079
REMKEL2.txt,404830,405039,209,5,N,Y,1438689541013,403594,405079
REMKEL2.txt,405040,405741,701,5,N,Y,1438689541013,403594,405079
REMKEL2.txt,405743,407043,1300,5,N,N,-,-1,-1
REMKEL2.txt,407045,407466,421,5,N,Y,1438690627657,407139,408101
REMKEL2.txt,407467,408395,928,5,N,Y,1438690627657,407139,408101
REMKEL2.txt,408398,408698,300,5,N,N,-,-1,-1
REMKEL2.txt,408699,409310,611,5,N,N,-,-1,-1
REMKEL2.txt,409311,410120,809,5,N,N,-,-1,-1
REMKEL2.txt,410121,410897,776,5,N,N,-,-1,-1
REMKEL2.txt,410900,411657,757,5,N,N,-,-1,-1
REMKEL2.txt,411658,412484,826,5,N,N,-,-1,-1
REMKEL2.txt,412486,413354,868,5,N,N,-,-1,-1
REMKEL2.txt,413355,414071,716,5,N,N,-,-1,-1
REMKEL2.txt,414072,414583,511,5,N,N,-,-1,-1
REMKEL2.txt,414584,415033,449,5,N,N,-,-1,-1
REMKEL2.txt,415034,415988,954,5,N,N,-,-1,-1
REMKEL2.txt,415989,416891,902,5,N,N,-,-1,-1
REMKEL2.txt,416896,418161,1265,5,N,N,-,-1,-1
REMKEL2.txt,418162,418937,775,5,N,Y,1438707390329,418837,419955
REMKEL2.txt,418938,419843,905,5,N,Y,1438707390329,418837,419955
REMKEL2.txt,419844,420785,941,5,Y,Y,1438707390329,418837,419955
REMKEL2.txt,420788,421728,940,5,N,N,-,-1,-1
REMKEL2.txt,421729,422702,973,5,N,Y,1438708055915,422648,423704
REMKEL2.txt,422703,423450,747,5,N,Y,1438708055915,422648,423704
REMKEL2.txt,423451,424332,881,5,N,Y,1438708497019,423911,424226
REMKEL2.txt,424335,425059,724,5,N,N,-,-1,-1
REMKEL2.txt,425061,425723,662,5,N,N,-,-1,-1
REMKEL2.txt,425724,426598,874,5,N,N,-,-1,-1
REMKEL2.txt,426601,427382,781,5,N,N,-,-1,-1
REMKEL2.txt,427383,428023,640,5,N,N,-,-1,-1
REMKEL2.txt,428024,429051,1027,5,N,N,-,-1,-1
REMKEL2.txt,429052,429853,801,5,N,N,-,-1,-1
REMKEL2.txt,429856,430894,1038,5,N,N,-,-1,-1
REMKEL2.txt,430895,431966,1071,5,N,N,-,-1,-1
REMKEL2.txt,431969,433221,1252,5,N,N,-,-1,-1
REMKEL2.txt,433222,434103,881,5,N,N,-,-1,-1
REMKEL2.txt,434106,435418,1312,5,N,N,-,-1,-1
REMKEL2.txt,435421,437428,2007,5,N,N,-,-1,-1
REMKEL2.txt,437430,438681,1251,5,N,N,-,-1,-1
REMKEL2.txt,438682,439580,898,5,N,N,-,-1,-1
REMKEL2.txt,439583,440345,762,5,N,N,-,-1,-1
REMKEL2.txt,440346,441479,1133,5,N,N,-,-1,-1
REMKEL2.txt,441479,442007,528,5,N,N,-,-1,-1
REMKEL2.txt,442010,442955,945,5,N,N,-,-1,-1
REMKEL2.txt,442956,443701,745,5,N,N,-,-1,-1
REMKEL2.txt,443702,444466,764,5,N,N,-,-1,-1
REMKEL2.txt,444467,444926,459,5,N,N,-,-1,-1
REMKEL2.txt,444929,446221,1292,5,N,N,-,-1,-1
REMKEL2.txt,446222,446520,298,5,N,N,-,-1,-1
REMKEL2.txt,446521,447066,545,5,N,N,-,-1,-1
REMKEL2.txt,447067,447847,780,5,N,N,-,-1,-1
REMKEL2.txt,447848,448299,451,5,N,N,-,-1,-1
REMKEL2.txt,448300,449261,961,5,N,N,-,-1,-1
REMKEL2.txt,449262,450302,1040,5,N,N,-,-1,-1
REMKEL2.txt,450305,451691,1386,5,N,N,-,-1,-1
REMKEL2.txt,451694,452228,534,5,N,N,-,-1,-1
REMKEL2.txt,452229,452623,394,5,N,N,-,-1,-1
REMKEL2.txt,452626,453472,846,5,N,Y,1438711328776,453254,453945
REMKEL2.txt,453473,454068,595,5,N,Y,1438711328776,453254,453945
REMKEL2.txt,454073,454245,172,5,N,N,-,-1,-1
REMKEL2.txt,454246,454373,127,5,N,N,-,-1,-1
REMKEL2.txt,454374,454463,89,5,N,N,-,-1,-1
REMKEL2.txt,454466,454844,378,5,N,N,-,-1,-1
REMKEL2.txt,454847,454931,84,5,N,N,-,-1,-1
REMKEL2.txt,454932,455042,110,5,N,N,-,-1,-1
REMKEL2.txt,455043,455089,46,5,N,N,-,-1,-1
REMKEL2.txt,455090,455155,65,5,N,N,-,-1,-1
REMKEL2.txt,455157,455458,301,5,N,N,-,-1,-1
REMKEL2.txt,455460,455505,45,5,N,N,-,-1,-1
REMKEL2.txt,455506,455700,194,5,N,N,-,-1,-1
REMKEL2.txt,455703,455734,31,5,N,N,-,-1,-1
REMKEL2.txt,455735,455985,250,5,N,N,-,-1,-1
REMKEL2.txt,455988,456065,77,5,N,N,-,-1,-1
REMKEL2.txt,456068,456184,116,5,N,N,-,-1,-1
REMKEL2.txt,456186,456285,99,5,N,N,-,-1,-1
REMKEL2.txt,456286,456350,64,5,N,N,-,-1,-1
REMKEL2.txt,456351,456451,100,5,N,N,-,-1,-1
REMKEL2.txt,456454,456480,26,5,N,N,-,-1,-1
REMKEL2.txt,456481,456800,319,5,N,N,-,-1,-1
REMKEL2.txt,456801,457131,330,5,N,N,-,-1,-1
REMKEL2.txt,457132,457204,72,5,N,N,-,-1,-1
REMKEL2.txt,457205,457325,120,5,N,N,-,-1,-1
REMKEL2.txt,457326,457417,91,5,N,N,-,-1,-1
REMKEL2.txt,457418,457523,105,5,N,N,-,-1,-1
REMKEL2.txt,457524,457674,150,5,N,N,-,-1,-1
REMKEL2.txt,457675,458495,820,5,Y,N,-,-1,-1
REMKEL2.txt,458498,459518,1020,5,N,N,-,-1,-1
REMKEL2.txt,459520,460466,946,5,N,N,-,-1,-1
REMKEL2.txt,460467,461280,813,5,N,N,-,-1,-1
REMKEL2.txt,461282,462157,875,5,N,Y,1438857102755,461608,465337
REMKEL2.txt,462159,463252,1093,5,N,Y,1438857102755,461608,465337
REMKEL2.txt,463253,464398,1145,5,N,Y,1438857102755,461608,465337
REMKEL2.txt,464399,464571,172,5,N,Y,1438857102755,461608,465337
REMKEL2.txt,464574,465519,945,5,N,Y,1438857102755,461608,465337
REMKEL2.txt,465522,466733,1211,5,N,N,-,-1,-1
REMKEL2.txt,466736,467391,655,5,N,N,-,-1,-1
REMKEL2.txt,467392,468883,1491,5,N,N,-,-1,-1
REMKEL2.txt,468884,469824,940,5,N,N,-,-1,-1
REMKEL2.txt,469827,470457,630,5,N,N,-,-1,-1
REMKEL2.txt,470458,471639,1181,5,N,N,-,-1,-1
REMKEL2.txt,471640,472486,846,5,N,N,-,-1,-1
REMKEL2.txt,472488,473108,620,5,N,N,-,-1,-1
REMKEL2.txt,473109,474342,1233,5,Y,N,-,-1,-1
REMKEL2.txt,474343,474876,533,5,N,N,-,-1,-1
REMKEL2.txt,474879,475088,209,5,N,N,-,-1,-1
REMKEL2.txt,475089,475710,621,5,N,N,-,-1,-1
REMKEL2.txt,475711,475754,43,5,N,N,-,-1,-1
REMKEL2.txt,475756,476478,722,5,N,N,-,-1,-1
REMKEL2.txt,476480,476904,424,5,N,N,-,-1,-1
REMKEL2.txt,476906,477353,447,5,N,N,-,-1,-1
REMKEL2.txt,477354,477533,179,5,N,N,-,-1,-1
REMKEL2.txt,477535,477734,199,5,N,N,-,-1,-1
REMKEL2.txt,477735,477931,196,5,N,N,-,-1,-1
REMKEL2.txt,477932,477989,57,5,N,N,-,-1,-1
REMKEL2.txt,477990,478549,559,5,N,N,-,-1,-1
REMKEL2.txt,478550,479436,886,5,N,N,-,-1,-1
REMKEL2.txt,479438,479873,435,5,N,N,-,-1,-1
REMKEL2.txt,479874,480554,680,5,N,N,-,-1,-1
REMKEL2.txt,480555,480939,384,5,N,N,-,-1,-1
REMKEL2.txt,480940,480984,44,5,N,N,-,-1,-1
REMKEL2.txt,480985,481136,151,5,N,N,-,-1,-1
REMKEL2.txt,481139,481593,454,5,N,N,-,-1,-1
REMKEL2.txt,481594,482422,828,5,N,N,-,-1,-1
REMKEL2.txt,482423,483073,650,5,N,N,-,-1,-1
REMKEL2.txt,483074,484298,1224,5,N,N,-,-1,-1
REMKEL2.txt,484299,484677,378,5,N,N,-,-1,-1
REMKEL2.txt,484678,485448,770,5,N,N,-,-1,-1
REMKEL2.txt,485449,486120,671,5,N,N,-,-1,-1
REMKEL2.txt,486121,486927,806,5,N,N,-,-1,-1
REMKEL2.txt,486929,487153,224,5,N,N,-,-1,-1
REMKEL2.txt,487154,487979,825,5,N,N,-,-1,-1
REMKEL2.txt,487980,488259,279,5,N,N,-,-1,-1
REMKEL2.txt,488260,489003,743,5,N,N,-,-1,-1
REMKEL2.txt,489004,489689,685,5,N,N,-,-1,-1
REMKEL2.txt,489690,489914,224,5,N,N,-,-1,-1
REMKEL2.txt,489915,490259,344,5,N,N,-,-1,-1
REMKEL2.txt,490260,490933,673,5,N,N,-,-1,-1
REMKEL2.txt,490934,491556,622,5,N,N,-,-1,-1
REMKEL2.txt,491557,491989,432,5,N,N,-,-1,-1
REMKEL2.txt,491990,492471,481,5,N,N,-,-1,-1
REMKEL2.txt,492472,493238,766,5,N,N,-,-1,-1
REMKEL2.txt,493239,493805,566,5,N,N,-,-1,-1
REMKEL2.txt,493806,494168,362,5,N,N,-,-1,-1
REMKEL2.txt,494169,495000,831,5,N,N,-,-1,-1
REMKEL2.txt,495001,496149,1148,5,N,N,-,-1,-1
REMKEL2.txt,496150,496850,700,5,N,N,-,-1,-1
REMKEL2.txt,496851,497327,476,5,N,N,-,-1,-1
REMKEL2.txt,497328,497745,417,5,N,N,-,-1,-1
REMKEL2.txt,497746,498614,868,5,N,N,-,-1,-1
REMKEL2.txt,498615,498948,333,5,N,N,-,-1,-1
REMKEL2.txt,498949,499460,511,5,N,N,-,-1,-1
REMKEL2.txt,499461,500066,605,5,N,N,-,-1,-1
REMKEL2.txt,500068,500272,204,5,N,N,-,-1,-1
REMKEL2.txt,500273,500395,122,5,N,N,-,-1,-1
REMKEL2.txt,500397,500750,353,5,N,N,-,-1,-1
REMKEL2.txt,500751,500894,143,5,N,N,-,-1,-1
REMKEL2.txt,500895,501282,387,5,N,N,-,-1,-1
REMKEL2.txt,501283,501689,406,5,N,N,-,-1,-1
REMKEL2.txt,501692,501837,145,5,N,N,-,-1,-1
REMKEL2.txt,501838,502039,201,5,N,N,-,-1,-1
REMKEL2.txt,502040,502103,63,5,N,N,-,-1,-1
REMKEL2.txt,502104,502298,194,5,N,N,-,-1,-1
REMKEL2.txt,502299,502423,124,5,N,N,-,-1,-1
REMKEL2.txt,502424,502568,144,5,N,N,-,-1,-1
REMKEL2.txt,502569,502795,226,5,N,N,-,-1,-1
REMKEL2.txt,502796,503011,215,5,N,N,-,-1,-1
REMKEL2.txt,503012,503234,222,5,N,N,-,-1,-1
REMKEL2.txt,503235,504254,1019,5,N,N,-,-1,-1
REMKEL2.txt,504255,504713,458,5,N,N,-,-1,-1
REMKEL2.txt,504716,505319,603,5,N,N,-,-1,-1
REMKEL2.txt,505320,506053,733,5,N,N,-,-1,-1
REMKEL2.txt,506054,506630,576,5,N,N,-,-1,-1
REMKEL2.txt,506631,506977,346,5,N,N,-,-1,-1
REMKEL2.txt,506978,507203,225,5,N,N,-,-1,-1
REMKEL2.txt,507204,507695,491,5,N,N,-,-1,-1
REMKEL2.txt,507696,508173,477,5,N,N,-,-1,-1
REMKEL2.txt,508175,508375,200,5,N,N,-,-1,-1
REMKEL2.txt,508377,508539,162,5,N,N,-,-1,-1
REMKEL2.txt,508541,509113,572,5,N,N,-,-1,-1
REMKEL2.txt,509114,509428,314,5,N,N,-,-1,-1
REMKEL2.txt,509429,509684,255,5,N,N,-,-1,-1
REMKEL2.txt,509685,510163,478,5,N,N,-,-1,-1
REMKEL2.txt,510164,510383,219,5,N,N,-,-1,-1
REMKEL2.txt,510384,510662,278,5,N,N,-,-1,-1
REMKEL2.txt,510663,510870,207,5,N,N,-,-1,-1
REMKEL2.txt,510871,511106,235,5,N,N,-,-1,-1
REMKEL2.txt,511109,511989,880,5,N,N,-,-1,-1
REMKEL2.txt,511990,512573,583,5,N,N,-,-1,-1
REMKEL2.txt,512574,513342,768,5,N,N,-,-1,-1
REMKEL2.txt,513343,513727,384,5,N,N,-,-1,-1
REMKEL2.txt,513728,514356,628,5,N,N,-,-1,-1
REMKEL2.txt,514357,514723,366,5,N,N,-,-1,-1
REMKEL2.txt,514724,515145,421,5,N,N,-,-1,-1
REMKEL2.txt,515146,515731,585,5,N,N,-,-1,-1
REMKEL2.txt,515736,516030,294,5,N,N,-,-1,-1
REMKEL2.txt,516031,516355,324,5,N,N,-,-1,-1
REMKEL2.txt,516356,516539,183,5,N,N,-,-1,-1
REMKEL2.txt,516541,516985,444,5,N,N,-,-1,-1
REMKEL2.txt,516986,517359,373,5,N,N,-,-1,-1
REMKEL2.txt,517361,517461,100,5,N,N,-,-1,-1
REMKEL2.txt,517462,517721,259,5,N,N,-,-1,-1
REMKEL2.txt,517722,517961,239,5,N,N,-,-1,-1
REMKEL2.txt,517962,518275,313,5,N,N,-,-1,-1
REMKEL2.txt,518276,518514,238,5,N,N,-,-1,-1
REMKEL2.txt,518515,518974,459,5,N,N,-,-1,-1
REMKEL2.txt,518975,519124,149,5,N,N,-,-1,-1
REMKEL2.txt,519125,519745,620,5,N,N,-,-1,-1
REMKEL2.txt,519748,520382,634,5,N,N,-,-1,-1
REOPER.txt,0,640,640,5,N,N,-,-1,-1
REOPER.txt,641,945,304,5,N,N,-,-1,-1
REOPER.txt,947,1442,495,5,N,N,-,-1,-1
REOPER.txt,1447,2690,1243,5,N,N,-,-1,-1
REOPER.txt,2691,4106,1415,5,N,N,-,-1,-1
REOPER.txt,4107,5346,1239,5,N,N,-,-1,-1
REOPER.txt,5347,6885,1538,5,N,N,-,-1,-1
REOPER.txt,6888,9358,2470,5,N,N,-,-1,-1
REOPER.txt,9361,10947,1586,5,N,N,-,-1,-1
REOPER.txt,10950,12949,1999,5,N,N,-,-1,-1
REOPER.txt,12952,15111,2159,5,N,N,-,-1,-1
REOPER.txt,15112,17298,2186,5,N,N,-,-1,-1
REOPER.txt,17301,18778,1477,5,N,N,-,-1,-1
REOPER.txt,18778,19617,839,5,N,N,-,-1,-1
REOPER.txt,19619,20729,1110,5,N,N,-,-1,-1
REOPER.txt,20732,22625,1893,5,N,N,-,-1,-1
REOPER.txt,22626,22933,307,5,N,N,-,-1,-1
REOPER.txt,22936,23956,1020,5,N,N,-,-1,-1
REOPER.txt,23959,25016,1057,5,N,N,-,-1,-1
REOPER.txt,25019,26961,1942,5,N,N,-,-1,-1
REOPER.txt,26964,27756,792,5,N,N,-,-1,-1
REOPER.txt,27757,28908,1151,5,N,N,-,-1,-1
REOPER.txt,28910,29510,600,5,N,N,-,-1,-1
REOPER.txt,29513,30945,1432,5,N,N,-,-1,-1
REOPER.txt,30946,32318,1372,5,N,N,-,-1,-1
REOPER.txt,32319,33278,959,5,N,N,-,-1,-1
REOPER.txt,33279,34376,1097,5,N,N,-,-1,-1
REOPER.txt,34379,34991,612,5,N,N,-,-1,-1
REOPER.txt,34992,36290,1298,5,N,N,-,-1,-1
REOPER.txt,36291,37588,1297,5,N,N,-,-1,-1
REOPER.txt,37589,38083,494,5,N,N,-,-1,-1
REOPER.txt,38086,39329,1243,5,N,N,-,-1,-1
REOPER.txt,39330,39915,585,5,N,N,-,-1,-1
REOPER.txt,39916,41503,1587,5,N,N,-,-1,-1
REOPER.txt,41505,42310,805,5,N,N,-,-1,-1
REOPER.txt,42311,43121,810,5,N,N,-,-1,-1
REOPER.txt,43122,43679,557,5,N,N,-,-1,-1
REOPER.txt,43680,44566,886,5,N,N,-,-1,-1
REOPER.txt,44567,45991,1424,5,N,N,-,-1,-1
REOPER.txt,45992,46756,764,5,N,N,-,-1,-1
REOPER.txt,46757,47873,1116,5,N,N,-,-1,-1
REOPER.txt,47874,48717,843,5,N,N,-,-1,-1
REOPER.txt,48718,49679,961,5,N,N,-,-1,-1
REOPER.txt,49680,50179,499,5,N,N,-,-1,-1
REOPER.txt,50180,50626,446,5,N,N,-,-1,-1
REOPER.txt,50627,50976,349,5,N,N,-,-1,-1
REOPER.txt,50977,51407,430,5,N,N,-,-1,-1
REOPER.txt,51408,51855,447,5,N,N,-,-1,-1
REOPER.txt,51857,52787,930,5,N,N,-,-1,-1
REOPER.txt,52788,53305,517,5,N,N,-,-1,-1
REOPER.txt,53306,53719,413,5,N,N,-,-1,-1
REOPER.txt,53720,54267,547,5,N,N,-,-1,-1
REOPER.txt,54268,55859,1591,5,N,N,-,-1,-1
REOPER.txt,55860,57145,1285,5,N,N,-,-1,-1
REOPER.txt,57148,58404,1256,5,N,N,-,-1,-1
REOPER.txt,58405,59379,974,5,N,N,-,-1,-1
REOPER.txt,59382,60488,1106,5,N,N,-,-1,-1
REOPER.txt,60489,61201,712,5,N,N,-,-1,-1
REOPER.txt,61202,62324,1122,5,N,N,-,-1,-1
REOPER.txt,62325,62570,245,5,N,N,-,-1,-1
REOPER.txt,62573,63649,1076,5,N,N,-,-1,-1
REOPER.txt,63650,64515,865,5,N,N,-,-1,-1
REOPER.txt,64516,64857,341,5,N,N,-,-1,-1
REOPER.txt,64860,65913,1053,5,N,N,-,-1,-1
REOPER.txt,65914,66968,1054,5,N,N,-,-1,-1
REOPER.txt,66969,67926,957,5,N,N,-,-1,-1
REOPER.txt,67928,68725,797,5,N,N,-,-1,-1
REOPER.txt,68728,69561,833,5,N,N,-,-1,-1
REOPER.txt,69563,70057,494,5,N,N,-,-1,-1
REOPER.txt,70058,70549,491,5,N,N,-,-1,-1
REOPER.txt,70550,71882,1332,5,N,N,-,-1,-1
REOPER.txt,71883,72906,1023,5,N,N,-,-1,-1
REOPER.txt,72907,73959,1052,5,N,N,-,-1,-1
REOPER.txt,73962,75107,1145,5,N,N,-,-1,-1
REOPER.txt,75110,76304,1194,5,N,N,-,-1,-1
REOPER.txt,76305,77124,819,5,N,N,-,-1,-1
REOPER.txt,77125,78261,1136,5,N,N,-,-1,-1
REOPER.txt,78262,79095,833,5,N,N,-,-1,-1
REOPER.txt,79096,80641,1545,5,N,N,-,-1,-1
REOPER.txt,80644,81314,670,5,N,N,-,-1,-1
REOPER.txt,81317,81882,565,5,N,N,-,-1,-1
REOPER.txt,81883,83034,1151,5,N,N,-,-1,-1
REOPER.txt,83035,83833,798,5,N,N,-,-1,-1
REOPER.txt,83834,84710,876,5,N,N,-,-1,-1
REOPER.txt,84713,85411,698,5,N,N,-,-1,-1
REOPER.txt,85412,85801,389,5,N,N,-,-1,-1
REOPER.txt,85802,86349,547,5,N,N,-,-1,-1
REOPER.txt,86350,87142,792,5,N,Y,1438607512684,86513,88081
REOPER.txt,87143,88089,946,5,N,Y,1438607512684,86513,88081
REOPER.txt,88090,88877,787,5,N,N,-,-1,-1
REOPER.txt,88882,89375,493,5,N,N,-,-1,-1
REOPER.txt,89378,90288,910,5,N,N,-,-1,-1
REOPER.txt,90291,91434,1143,5,N,N,-,-1,-1
REOPER.txt,91437,92570,1133,5,N,N,-,-1,-1
REOPER.txt,92572,93330,758,5,N,Y,1438607969604,92585,93513
REOPER.txt,93331,93986,655,5,N,Y,1438607969604,92585,93513
REOPER.txt,93987,95076,1089,5,N,Y,1438608430250,93743,94780
REOPER.txt,95077,95890,813,5,N,N,-,-1,-1
REOPER.txt,95891,96496,605,5,N,N,-,-1,-1
REOPER.txt,96497,97225,728,5,N,N,-,-1,-1
REOPER.txt,97226,98193,967,5,N,N,-,-1,-1
REOPER.txt,98194,98768,574,5,N,Y,1438609131672,98413,101156
REOPER.txt,98769,99171,402,5,N,Y,1438609131672,98413,101156
REOPER.txt,99173,99999,826,5,N,Y,1438609131672,98413,101156
REOPER.txt,100000,100852,852,5,N,Y,1438609131672,98413,101156
REOPER.txt,100853,101773,920,5,Y,Y,1438609131672,98413,101156
REOPER.txt,101774,102516,742,5,N,Y,1438609640620,101604,103071
REOPER.txt,102517,103230,713,5,N,Y,1438609640620,101604,103071
REOPER.txt,103231,103769,538,5,N,N,-,-1,-1
REOPER.txt,103770,104413,643,5,N,N,-,-1,-1
REOPER.txt,104414,104858,444,5,N,N,-,-1,-1
REOPER.txt,104859,105782,923,5,N,N,-,-1,-1
REOPER.txt,105783,106056,273,5,N,N,-,-1,-1
REOPER.txt,106059,106521,462,5,N,N,-,-1,-1
REOPER.txt,106523,107836,1313,5,N,N,-,-1,-1
REOPER.txt,107841,108663,822,5,N,Y,1438610692536,108268,109736
REOPER.txt,108664,109221,557,5,N,Y,1438610692536,108268,109736
REOPER.txt,109222,110267,1045,5,N,Y,1438610692536,108268,109736
REOPER.txt,110270,110713,443,5,N,N,-,-1,-1
REOPER.txt,110714,111575,861,5,N,N,-,-1,-1
REOPER.txt,111576,112507,931,5,N,N,-,-1,-1
REOPER.txt,112509,113289,780,5,N,N,-,-1,-1
REOPER.txt,113290,113660,370,5,N,N,-,-1,-1
REOPER.txt,113661,114694,1033,5,N,N,-,-1,-1
REOPER.txt,114695,115727,1032,5,N,Y,1438611798217,114785,115820
REOPER.txt,115728,116634,906,5,N,Y,1438611798217,114785,115820
REOPER.txt,116635,117504,869,5,N,N,-,-1,-1
REOPER.txt,117505,118242,737,5,N,N,-,-1,-1
REOPER.txt,118244,119268,1024,5,N,N,-,-1,-1
REOPER.txt,119269,120032,763,5,N,N,-,-1,-1
REOPER.txt,120033,120703,670,5,N,N,-,-1,-1
REOPER.txt,120704,121250,546,5,N,N,-,-1,-1
REOPER.txt,121251,121925,674,5,N,N,-,-1,-1
REOPER.txt,121927,122489,562,5,N,N,-,-1,-1
REOPER.txt,122490,123696,1206,5,N,N,-,-1,-1
REOPER.txt,123697,124841,1144,5,N,N,-,-1,-1
REOPER.txt,124843,125421,578,5,N,N,-,-1,-1
REOPER.txt,125426,125848,422,5,N,N,-,-1,-1
REOPER.txt,125849,126700,851,5,N,N,-,-1,-1
REOPER.txt,126701,127270,569,5,N,N,-,-1,-1
REOPER.txt,127271,128301,1030,5,N,N,-,-1,-1
REOPER.txt,128302,129281,979,5,N,N,-,-1,-1
REOPER.txt,129283,130126,843,5,N,N,-,-1,-1
REOPER.txt,130127,130859,732,5,N,N,-,-1,-1
REOPER.txt,130862,131800,938,5,N,N,-,-1,-1
REOPER.txt,131801,132811,1010,5,N,N,-,-1,-1
REOPER.txt,132814,133606,792,5,N,N,-,-1,-1
REOPER.txt,133607,134415,808,5,N,N,-,-1,-1
REOPER.txt,134418,135048,630,5,N,Y,1438612728607,134463,135433
REOPER.txt,135049,136083,1034,5,N,Y,1438612728607,134463,135433
REOPER.txt,136086,136711,625,5,N,N,-,-1,-1
REOPER.txt,136712,137602,890,5,N,Y,1438613292607,137557,139183
REOPER.txt,137605,138104,499,5,N,Y,1438613292607,137557,139183
REOPER.txt,138107,138568,461,5,N,Y,1438613292607,137557,139183
REOPER.txt,138571,139538,967,5,N,Y,1438613292607,137557,139183
REOPER.txt,139541,140235,694,5,N,N,-,-1,-1
REOPER.txt,140238,141048,810,5,N,N,-,-1,-1
REOPER.txt,141051,141981,930,5,N,N,-,-1,-1
REOPER.txt,141982,142691,709,5,N,N,-,-1,-1
REOPER.txt,142692,143270,578,5,N,Y,1438613865632,142946,144271
REOPER.txt,143271,143882,611,5,N,Y,1438613865632,142946,144271
REOPER.txt,143883,144595,712,5,N,Y,1438613865632,142946,144271
REOPER.txt,144597,145116,519,5,N,Y,1438614360025,144333,145484
REOPER.txt,145117,146038,921,5,N,Y,1438614360025,144333,145484
REOPER.txt,146039,146950,911,5,N,N,-,-1,-1
REOPER.txt,146951,147910,959,5,N,N,-,-1,-1
REOPER.txt,147911,149024,1113,5,N,N,-,-1,-1
REOPER.txt,149027,150132,1105,5,N,N,-,-1,-1
REOPER.txt,150135,150740,605,5,N,N,-,-1,-1
REOPER.txt,150741,151763,1022,5,N,N,-,-1,-1
REOPER.txt,151766,152548,782,5,N,N,-,-1,-1
REOPER.txt,152550,153255,705,5,N,N,-,-1,-1
REOPER.txt,153258,154250,992,5,N,N,-,-1,-1
REOPER.txt,154251,154986,735,5,N,N,-,-1,-1
REOPER.txt,154987,155974,987,5,Y,Y,1438614732055,155289,156104
REOPER.txt,155975,156557,582,5,N,Y,1438614732055,155289,156104
REOPER.txt,156558,157313,755,5,N,N,-,-1,-1
REOPER.txt,157314,158088,774,5,N,N,-,-1,-1
REOPER.txt,158089,159006,917,5,N,N,-,-1,-1
REOPER.txt,159009,160289,1280,5,N,N,-,-1,-1
REOPER.txt,160292,160851,559,5,N,N,-,-1,-1
REOPER.txt,160854,161701,847,5,N,N,-,-1,-1
REOPER.txt,161702,162275,573,5,N,N,-,-1,-1
REOPER.txt,162275,162852,577,5,N,N,-,-1,-1
REOPER.txt,162853,163773,920,5,N,N,-,-1,-1
REOPER.txt,163774,164341,567,5,N,N,-,-1,-1
REOPER.txt,164342,165107,765,5,N,N,-,-1,-1
REOPER.txt,165108,165828,720,5,N,N,-,-1,-1
REOPER.txt,165829,166702,873,5,N,N,-,-1,-1
REOPER.txt,166705,167618,913,5,N,N,-,-1,-1
REOPER.txt,167621,167967,346,5,N,N,-,-1,-1
REOPER.txt,167968,168690,722,5,N,Y,1438615349115,168230,169109
REOPER.txt,168691,169414,723,5,N,Y,1438615690871,169126,169616
REOPER.txt,169415,169825,410,5,N,Y,1438615690871,169126,169616
REOPER.txt,169826,170348,522,5,N,N,-,-1,-1
REOPER.txt,170349,171187,838,5,N,N,-,-1,-1
REOPER.txt,171188,171917,729,5,N,N,-,-1,-1
REOPER.txt,171918,172544,626,5,N,N,-,-1,-1
REOPER.txt,172545,173197,652,5,N,N,-,-1,-1
REOPER.txt,173200,173786,586,5,N,N,-,-1,-1
REOPER.txt,173789,175127,1338,5,N,Y,1438616254874,175117,176691
REOPER.txt,175130,176146,1016,5,N,Y,1438616254874,175117,176691
REOPER.txt,176147,176926,779,5,N,Y,1438616254874,175117,176691
REOPER.txt,176926,178122,1196,5,N,Y,1438616740544,177666,179189
REOPER.txt,178123,178588,465,5,N,Y,1438616740544,177666,179189
REOPER.txt,178589,179199,610,5,N,Y,1438616740544,177666,179189
REOPER.txt,179202,180186,984,5,Y,N,-,-1,-1
REOPER.txt,180188,181050,862,5,N,Y,1438617107509,180955,181678
REOPER.txt,181052,182017,965,5,N,Y,1438617107509,180955,181678
REOPER.txt,182018,182680,662,5,N,N,-,-1,-1
REOPER.txt,182681,183915,1234,5,N,N,-,-1,-1
REOPER.txt,183917,184358,441,5,N,N,-,-1,-1
REOPER.txt,184359,185161,802,5,N,N,-,-1,-1
REOPER.txt,185164,185917,753,5,N,N,-,-1,-1
REOPER.txt,185920,186426,506,5,N,N,-,-1,-1
REOPER.txt,186427,187432,1005,5,N,N,-,-1,-1
REOPER.txt,187433,188208,775,5,N,N,-,-1,-1
REOPER.txt,188209,188899,690,5,N,N,-,-1,-1
REOPER.txt,188900,189531,631,5,N,N,-,-1,-1
REOPER.txt,189534,190419,885,5,N,N,-,-1,-1
REOPER.txt,190420,191372,952,5,N,N,-,-1,-1
REOPER.txt,191377,192171,794,5,N,N,-,-1,-1
REOPER.txt,192174,192823,649,5,N,N,-,-1,-1
REOPER.txt,192824,193126,302,5,N,N,-,-1,-1
REOPER.txt,193127,193947,820,5,N,N,-,-1,-1
REOPER.txt,193948,194109,161,5,N,N,-,-1,-1
REOPER.txt,194110,194405,295,5,N,N,-,-1,-1
REOPER.txt,194406,194563,157,5,N,N,-,-1,-1
REOPER.txt,194564,194785,221,5,N,N,-,-1,-1
REOPER.txt,194786,194985,199,5,N,N,-,-1,-1
REOPER.txt,194988,195210,222,5,N,N,-,-1,-1
REOPER.txt,195211,195413,202,5,N,N,-,-1,-1
REOPER.txt,195416,195763,347,5,N,N,-,-1,-1
REOPER.txt,195766,195997,231,5,N,N,-,-1,-1
REOPER.txt,195998,196202,204,5,N,N,-,-1,-1
REOPER.txt,196203,196522,319,5,N,N,-,-1,-1
REOPER.txt,196523,196724,201,5,N,N,-,-1,-1
REOPER.txt,196725,197164,439,5,N,N,-,-1,-1
REOPER.txt,197167,198366,1199,5,N,N,-,-1,-1
REOPER.txt,198368,199073,705,5,N,N,-,-1,-1
REOPER.txt,199076,199648,572,5,N,N,-,-1,-1
REOPER.txt,199649,200480,831,5,N,N,-,-1,-1
REOPER.txt,200481,201543,1062,5,N,N,-,-1,-1
REOPER.txt,201546,202153,607,5,N,Y,1438678160825,201557,202648
REOPER.txt,202154,203214,1060,5,N,Y,1438678160825,201557,202648
REOPER.txt,203217,203841,624,5,N,N,-,-1,-1
REOPER.txt,203842,204530,688,5,N,N,-,-1,-1
REOPER.txt,204533,205256,723,5,N,Y,1438678872682,204536,204996
REOPER.txt,205257,206271,1014,5,N,Y,1438679318783,205023,206296
REOPER.txt,206274,206831,557,5,N,Y,1438679318783,205023,206296
REOPER.txt,206834,207886,1052,5,N,N,-,-1,-1
REOPER.txt,207889,208470,581,5,N,N,-,-1,-1
REOPER.txt,208471,209588,1117,5,N,N,-,-1,-1
REOPER.txt,209589,210361,772,5,N,N,-,-1,-1
REOPER.txt,210364,211351,987,5,N,N,-,-1,-1
REOPER.txt,211353,211778,425,5,N,N,-,-1,-1
REOPER.txt,211780,212532,752,5,N,N,-,-1,-1
REOPER.txt,212533,213697,1164,5,N,N,-,-1,-1
REOPER.txt,213698,214070,372,5,N,N,-,-1,-1
REOPER.txt,214071,214572,501,5,N,N,-,-1,-1
REOPER.txt,214573,215364,791,5,N,N,-,-1,-1
REOPER.txt,215365,216192,827,5,N,N,-,-1,-1
REOPER.txt,216193,216783,590,5,N,N,-,-1,-1
REOPER.txt,216784,217485,701,5,N,N,-,-1,-1
REOPER.txt,217486,218209,723,5,N,N,-,-1,-1
REOPER.txt,218210,219326,1116,5,N,N,-,-1,-1
REOPER.txt,219327,219951,624,5,N,N,-,-1,-1
REOPER.txt,219954,220775,821,5,N,N,-,-1,-1
REOPER.txt,220776,221668,892,5,N,N,-,-1,-1
REOPER.txt,221669,222547,878,5,N,N,-,-1,-1
REOPER.txt,222548,223137,589,5,N,N,-,-1,-1
REOPER.txt,223138,223770,632,5,N,N,-,-1,-1
REOPER.txt,223771,224454,683,5,N,N,-,-1,-1
REOPER.txt,224455,225309,854,5,N,N,-,-1,-1
REOPER.txt,225310,226262,952,5,N,N,-,-1,-1
REOPER.txt,226263,226785,522,5,N,N,-,-1,-1
REOPER.txt,226786,227241,455,5,N,N,-,-1,-1
REOPER.txt,227242,227843,601,5,N,N,-,-1,-1
REOPER.txt,227844,228256,412,5,N,N,-,-1,-1
REOPER.txt,228257,228655,398,5,N,N,-,-1,-1
REOPER.txt,228656,229007,351,5,N,N,-,-1,-1
REOPER.txt,229008,229512,504,5,N,N,-,-1,-1
REOPER.txt,229513,230661,1148,5,N,Y,1438680128352,229816,231640
REOPER.txt,230662,231203,541,5,N,Y,1438680128352,229816,231640
REOPER.txt,231206,232539,1333,5,N,Y,1438680128352,229816,231640
REOPER.txt,232542,232849,307,5,N,N,-,-1,-1
REOPER.txt,232851,234522,1671,5,N,N,-,-1,-1
REOPER.txt,234525,235477,952,5,N,Y,1438680995516,235335,237205
REOPER.txt,235478,236111,633,5,N,Y,1438680995516,235335,237205
REOPER.txt,236112,237292,1180,5,N,Y,1438680995516,235335,237205
REOPER.txt,237295,238643,1348,5,N,N,-,-1,-1
REOPER.txt,238644,240372,1728,5,N,N,-,-1,-1
REOPER.txt,240373,241938,1565,5,N,N,-,-1,-1
REOPER.txt,241941,242950,1009,5,N,N,-,-1,-1
REOPER.txt,242951,243694,743,5,N,N,-,-1,-1
REOPER.txt,243696,244453,757,5,N,N,-,-1,-1
REOPER.txt,244454,245607,1153,5,N,N,-,-1,-1
REOPER.txt,245610,246666,1056,5,N,N,-,-1,-1
REOPER.txt,246667,247661,994,5,N,N,-,-1,-1
REOPER.txt,247662,248809,1147,5,N,N,-,-1,-1
REOPER.txt,248810,249511,701,5,N,N,-,-1,-1
REOPER.txt,249512,250840,1328,5,N,N,-,-1,-1
REOPER.txt,250841,251776,935,5,N,N,-,-1,-1
REOPER.txt,251779,253521,1742,5,N,N,-,-1,-1
REOPER.txt,253522,255013,1491,5,N,N,-,-1,-1
REOPER.txt,255014,256178,1164,5,N,N,-,-1,-1
REOPER.txt,256179,257253,1074,5,N,N,-,-1,-1
REOPER.txt,257254,258318,1064,5,N,N,-,-1,-1
REOPER.txt,258321,258912,591,5,N,N,-,-1,-1
REOPER.txt,258913,259866,953,5,N,N,-,-1,-1
REOPER.txt,259867,260467,600,5,N,N,-,-1,-1
REOPER.txt,260468,261066,598,5,N,N,-,-1,-1
REOPER.txt,261067,261742,675,5,N,N,-,-1,-1
REOPER.txt,261743,262215,472,5,N,N,-,-1,-1
REOPER.txt,262216,262793,577,5,N,N,-,-1,-1
REOPER.txt,262795,263189,394,5,N,N,-,-1,-1
REOPER.txt,263190,263765,575,5,Y,N,-,-1,-1
REOPER.txt,263768,264313,545,5,N,N,-,-1,-1
REOPER.txt,264314,264962,648,5,N,N,-,-1,-1
REOPER.txt,264963,265816,853,5,N,N,-,-1,-1
REOPER.txt,265817,266385,568,5,N,N,-,-1,-1
REOPER.txt,266388,267112,724,5,N,N,-,-1,-1
REOPER.txt,267113,268058,945,5,N,N,-,-1,-1
REOPER.txt,268059,268923,864,5,N,N,-,-1,-1
REOPER.txt,268924,270108,1184,5,N,N,-,-1,-1
REOPER.txt,270111,270717,606,5,N,N,-,-1,-1
REOPER.txt,270718,271577,859,5,N,N,-,-1,-1
REOPER.txt,271578,272396,818,5,N,N,-,-1,-1
REOPER.txt,272397,273515,1118,5,N,N,-,-1,-1
REOPER.txt,273518,274580,1062,5,N,N,-,-1,-1
REOPER.txt,274582,275624,1042,5,N,Y,1438682217043,275162,278631
REOPER.txt,275625,276327,702,5,N,Y,1438682217043,275162,278631
REOPER.txt,276328,277149,821,5,N,Y,1438682217043,275162,278631
REOPER.txt,277151,277718,567,5,N,Y,1438682217043,275162,278631
REOPER.txt,277719,279101,1382,5,N,Y,1438682217043,275162,278631
REOPER.txt,279102,279839,737,5,N,Y,1438684753313,279476,279895
REOPER.txt,279840,280229,389,5,N,Y,1438684753313,279476,279895
REOPER.txt,280230,280985,755,5,N,Y,1438685164472,280335,281058
REOPER.txt,280986,281590,604,5,N,Y,1438685164472,280335,281058
REOPER.txt,281591,282398,807,5,N,N,-,-1,-1
REOPER.txt,282400,283030,630,5,N,Y,1438685629660,282434,284008
REOPER.txt,283031,283746,715,5,N,Y,1438685629660,282434,284008
REOPER.txt,283747,284465,718,5,N,Y,1438685960938,284054,284833
REOPER.txt,284466,285008,542,5,N,Y,1438685960938,284054,284833
REOPER.txt,285009,285757,748,5,N,N,-,-1,-1
REOPER.txt,285758,286458,700,5,N,N,-,-1,-1
REOPER.txt,286459,286801,342,5,N,N,-,-1,-1
REOPER.txt,286802,287709,907,5,N,N,-,-1,-1
REOPER.txt,287712,288459,747,5,N,N,-,-1,-1
REOPER.txt,288460,289677,1217,5,N,N,-,-1,-1
REOPER.txt,289678,290133,455,5,N,N,-,-1,-1
REOPER.txt,290136,290760,624,5,N,N,-,-1,-1
REOPER.txt,290763,291851,1088,5,N,N,-,-1,-1
REOPER.txt,291854,292876,1022,5,N,N,-,-1,-1
REOPER.txt,292879,293655,776,5,N,N,-,-1,-1
REOPER.txt,293656,294481,825,5,N,N,-,-1,-1
REOPER.txt,294482,295076,594,5,N,N,-,-1,-1
REOPER.txt,295079,296626,1547,5,N,N,-,-1,-1
REOPER.txt,296627,297564,937,5,N,N,-,-1,-1
REOPER.txt,297565,298462,897,5,N,N,-,-1,-1
REOPER.txt,298465,299187,722,5,N,N,-,-1,-1
REOPER.txt,299190,300147,957,5,N,N,-,-1,-1
REOPER.txt,300148,301405,1257,5,N,N,-,-1,-1
REOPER.txt,301406,302091,685,5,N,N,-,-1,-1
REOPER.txt,302094,302871,777,5,N,N,-,-1,-1
REOPER.txt,302872,303670,798,5,N,N,-,-1,-1
REOPER.txt,303671,304671,1000,5,N,N,-,-1,-1
REOPER.txt,304672,305350,678,5,N,N,-,-1,-1
REOPER.txt,305351,306428,1077,5,N,N,-,-1,-1
REOPER.txt,306429,307702,1273,5,N,N,-,-1,-1
REOPER.txt,307705,308539,834,5,N,N,-,-1,-1
REOPER.txt,308540,309657,1117,5,N,N,-,-1,-1
REOPER.txt,309658,311248,1590,5,N,N,-,-1,-1
REOPER.txt,311249,312195,946,5,N,N,-,-1,-1
REOPER.txt,312196,312885,689,5,N,N,-,-1,-1
REOPER.txt,312886,313683,797,5,N,N,-,-1,-1
REOPER.txt,313684,314823,1139,5,N,N,-,-1,-1
REOPER.txt,314824,315985,1161,5,N,N,-,-1,-1
REOPER.txt,315986,317233,1247,5,N,N,-,-1,-1
REOPER.txt,317234,318409,1175,5,N,N,-,-1,-1
REOPER.txt,318410,318976,566,5,N,N,-,-1,-1
REOPER.txt,318977,320493,1516,5,N,N,-,-1,-1
REOPER.txt,320494,321689,1195,5,N,N,-,-1,-1
REOPER.txt,321690,322748,1058,5,N,N,-,-1,-1
REOPER.txt,322750,323876,1126,5,N,N,-,-1,-1
REOPER.txt,323878,324454,576,5,N,N,-,-1,-1
REOPER.txt,324455,325222,767,5,N,N,-,-1,-1
REOPER.txt,325223,325941,718,5,N,Y,1438686868625,325508,327523
REOPER.txt,325942,326804,862,5,Y,Y,1438686868625,325508,327523
REOPER.txt,326805,327272,467,5,N,Y,1438686868625,325508,327523
REOPER.txt,327273,327642,369,5,N,Y,1438686868625,325508,327523
REOPER.txt,327643,328207,564,5,N,N,-,-1,-1
REOPER.txt,328208,329198,990,5,N,N,-,-1,-1
REOPER.txt,329203,330533,1330,5,N,Y,1438687348398,330268,331286
REOPER.txt,330534,331351,817,5,N,Y,1438687348398,330268,331286
REOPER.txt,331352,332338,986,5,Y,N,-,-1,-1
REOPER.txt,332339,333203,864,5,N,N,-,-1,-1
REOPER.txt,333204,333921,717,5,N,N,-,-1,-1
REOPER.txt,333922,334824,902,5,N,N,-,-1,-1
REOPER.txt,334825,336044,1219,5,N,N,-,-1,-1
REOPER.txt,336045,336529,484,5,N,N,-,-1,-1
REOPER.txt,336530,337227,697,5,N,N,-,-1,-1
REOPER.txt,337228,337548,320,5,N,N,-,-1,-1
REOPER.txt,337549,338631,1082,5,N,N,-,-1,-1
REOPER.txt,338632,339161,529,5,N,Y,1438687949932,339086,339844
REOPER.txt,339162,339927,765,5,N,Y,1438687949932,339086,339844
REOPER.txt,339928,340675,747,5,N,Y,1438702766275,340360,340868
REOPER.txt,340676,341145,469,5,N,Y,1438702766275,340360,340868
REOPER.txt,341146,341693,547,5,N,N,-,-1,-1
REOPER.txt,341696,342041,345,5,N,N,-,-1,-1
REOPER.txt,342043,342435,392,5,N,N,-,-1,-1
REOPER.txt,342436,342973,537,5,N,N,-,-1,-1
REOPER.txt,342974,343453,479,5,N,N,-,-1,-1
REOPER.txt,343454,344045,591,5,N,N,-,-1,-1
REOPER.txt,344046,344644,598,5,N,N,-,-1,-1
REOPER.txt,344645,345319,674,5,N,N,-,-1,-1
REOPER.txt,345320,346626,1306,5,N,Y,1438703676425,346475,348599
REOPER.txt,346627,347125,498,5,N,Y,1438703676425,346475,348599
REOPER.txt,347126,347790,664,5,N,Y,1438703676425,346475,348599
REOPER.txt,347791,348216,425,5,Y,Y,1438703676425,346475,348599
REOPER.txt,348217,348559,342,5,N,Y,1438703676425,346475,348599
REOPER.txt,348560,349171,611,5,N,Y,1438703676425,346475,348599
REOPER.txt,349173,350149,976,5,N,Y,1438703994435,348752,349433
REOPER.txt,350154,351441,1287,5,N,N,-,-1,-1
REOPER.txt,351442,352164,722,5,N,N,-,-1,-1
REOPER.txt,352167,352917,750,5,N,N,-,-1,-1
REOPER.txt,352918,353569,651,5,N,Y,1438704310167,353374,354086
REOPER.txt,353570,354524,954,5,N,Y,1438704734352,354115,355438
REOPER.txt,354526,355506,980,5,Y,Y,1438704734352,354115,355438
REOPER.txt,355508,356735,1227,5,N,Y,1438705014163,355515,357095
REOPER.txt,356736,357281,545,5,N,Y,1438705014163,355515,357095
REOPER.txt,357282,358117,835,5,N,N,-,-1,-1
REOPER.txt,358118,359228,1110,5,N,N,-,-1,-1
REOPER.txt,359231,359911,680,5,N,Y,1438705728692,359763,361602
REOPER.txt,359912,360614,702,5,N,Y,1438705728692,359763,361602
REOPER.txt,360615,360977,362,5,N,Y,1438705728692,359763,361602
REOPER.txt,360978,361677,699,5,N,Y,1438705728692,359763,361602
REOPER.txt,361680,362424,744,5,N,Y,1438706068692,361693,362653
REOPER.txt,362425,363014,589,5,N,Y,1438706068692,361693,362653
REOPER.txt,363015,363605,590,5,N,N,-,-1,-1
REOPER.txt,363608,364344,736,5,N,N,-,-1,-1
REOPER.txt,364346,365278,932,5,N,N,-,-1,-1
REOPER.txt,365279,366083,804,5,N,N,-,-1,-1
REOPER.txt,366084,367173,1089,5,N,N,-,-1,-1
REOPER.txt,367174,367760,586,5,N,N,-,-1,-1
REOPER.txt,367761,368718,957,5,N,N,-,-1,-1
REOPER.txt,368720,369643,923,5,N,N,-,-1,-1
REOPER.txt,369646,370476,830,5,N,N,-,-1,-1
REOPER.txt,370477,371356,879,5,N,N,-,-1,-1
REOPER.txt,371357,372174,817,5,N,N,-,-1,-1
REOPER.txt,372175,372766,591,5,N,N,-,-1,-1
REOPER.txt,372767,373298,531,5,N,N,-,-1,-1
REOPER.txt,373299,374035,736,5,N,N,-,-1,-1
REOPER.txt,374036,374755,719,5,N,N,-,-1,-1
REOPER.txt,374756,375279,523,5,N,N,-,-1,-1
REOPER.txt,375280,375774,494,5,N,N,-,-1,-1
REOPER.txt,375777,376318,541,5,N,N,-,-1,-1
REOPER.txt,376319,376911,592,5,N,N,-,-1,-1
REOPER.txt,376912,377736,824,5,N,N,-,-1,-1
REOPER.txt,377737,378531,794,5,N,N,-,-1,-1
REOPER.txt,378532,379252,720,5,N,N,-,-1,-1
REOPER.txt,379253,380053,800,5,N,N,-,-1,-1
REOPER.txt,380054,380799,745,5,N,N,-,-1,-1
REOPER.txt,380802,381844,1042,5,N,N,-,-1,-1
REOPER.txt,381845,382666,821,5,N,N,-,-1,-1
REOPER.txt,382669,383364,695,5,N,N,-,-1,-1
REOPER.txt,383365,384166,801,5,N,Y,1438706551121,383929,384620
REOPER.txt,384167,384764,597,5,N,Y,1438706551121,383929,384620
REOPER.txt,384765,385304,539,5,N,N,-,-1,-1
REOPER.txt,385306,386206,900,5,N,N,-,-1,-1
REOPER.txt,386207,386938,731,5,N,N,-,-1,-1
REOPER.txt,386941,387634,693,5,N,N,-,-1,-1
REOPER.txt,387635,388414,779,5,N,N,-,-1,-1
REOPER.txt,388415,388960,545,5,N,N,-,-1,-1
REOPER.txt,388963,389510,547,5,N,N,-,-1,-1
REOPER.txt,389511,390329,818,5,N,N,-,-1,-1
REOPER.txt,390330,391105,775,5,N,N,-,-1,-1
REOPER.txt,391106,392240,1134,5,N,N,-,-1,-1
REOPER.txt,392241,393144,903,5,N,N,-,-1,-1
REOPER.txt,393145,393972,827,5,N,N,-,-1,-1
REOPER.txt,393975,394741,766,5,N,N,-,-1,-1
REOPER.txt,394742,396047,1305,5,N,Y,1438707526102,395204,399120
REOPER.txt,396048,396659,611,5,N,Y,1438707526102,395204,399120
REOPER.txt,396660,397412,752,5,N,Y,1438707526102,395204,399120
REOPER.txt,397413,398008,595,5,N,Y,1438707526102,395204,399120
REOPER.txt,398011,398723,712,5,Y,Y,1438707526102,395204,399120
REOPER.txt,398723,399698,975,5,N,Y,1438707526102,395204,399120
REOPER.txt,399699,400234,535,5,N,N,-,-1,-1
REOPER.txt,400236,400988,752,5,N,Y,1438763811355,400311,402065
REOPER.txt,400989,401434,445,5,N,Y,1438763811355,400311,402065
REOPER.txt,401435,401998,563,5,N,Y,1438763811355,400311,402065
REOPER.txt,402000,402502,502,5,N,Y,1438763811355,400311,402065
REOPER.txt,402503,403331,828,5,N,N,-,-1,-1
REOPER.txt,403333,404188,855,5,N,N,-,-1,-1
REOPER.txt,404191,404830,639,5,N,N,-,-1,-1
REOPER.txt,404831,405010,179,5,N,N,-,-1,-1
REOPER.txt,405011,405812,801,5,N,N,-,-1,-1
REOPER.txt,405813,406841,1028,5,N,Y,1438764333941,406033,406469
REOPER.txt,406842,407505,663,5,N,Y,1438764866768,406493,408910
REOPER.txt,407508,408794,1286,5,N,Y,1438764866768,406493,408910
REOPER.txt,408795,410009,1214,5,N,Y,1438764866768,406493,408910
REOPER.txt,410010,410740,730,5,N,N,-,-1,-1
REOPER.txt,410741,411322,581,5,N,Y,1438765124421,411054,411525
REOPER.txt,411324,411917,593,5,N,Y,1438765478053,411548,412139
REOPER.txt,411918,412555,637,5,N,Y,1438765478053,411548,412139
REOPER.txt,412556,413444,888,5,N,Y,1438765812082,413195,414167
REOPER.txt,413445,414174,729,5,N,Y,1438765812082,413195,414167
REOPER.txt,414177,415370,1193,5,N,Y,1438766504799,414794,415444
REOPER.txt,415371,416093,722,5,N,Y,1438767071786,415842,416696
REOPER.txt,416094,416857,763,5,N,Y,1438767071786,415842,416696
REOPER.txt,416858,418004,1146,5,N,Y,1438767795308,417699,419098
REOPER.txt,418007,419583,1576,5,Y,Y,1438767795308,417699,419098
REOPER.txt,419586,420207,621,5,N,Y,1438768079697,419611,420712
REOPER.txt,420208,421059,851,5,N,Y,1438768079697,419611,420712
REOPER.txt,421060,421892,832,5,N,N,-,-1,-1
REOPER.txt,421894,423007,1113,5,N,N,-,-1,-1
REOPER.txt,423008,423649,641,5,N,N,-,-1,-1
REOPER.txt,423652,424683,1031,5,N,N,-,-1,-1
REOPER.txt,424684,425697,1013,5,N,N,-,-1,-1
REOPER.txt,425698,426554,856,5,N,N,-,-1,-1
REOPER.txt,426555,427534,979,5,N,N,-,-1,-1
REOPER.txt,427537,428052,515,5,N,N,-,-1,-1
REOPER.txt,428055,429133,1078,5,N,N,-,-1,-1
REOPER.txt,429136,430342,1206,5,N,N,-,-1,-1
REOPER.txt,430343,430799,456,5,N,N,-,-1,-1
REOPER.txt,430800,431501,701,5,N,N,-,-1,-1
REOPER.txt,431502,432242,740,5,N,N,-,-1,-1
REOPER.txt,432243,433395,1152,5,N,N,-,-1,-1
REOPER.txt,433396,434263,867,5,N,N,-,-1,-1
REOPER.txt,434264,435029,765,5,N,N,-,-1,-1
REOPER.txt,435030,436102,1072,5,N,N,-,-1,-1
REOPER.txt,436105,436926,821,5,N,N,-,-1,-1
REOPER.txt,436927,437987,1060,5,N,N,-,-1,-1
REOPER.txt,437988,438658,670,5,N,N,-,-1,-1
REOPER.txt,438659,439812,1153,5,N,Y,1438769202218,438794,441102
REOPER.txt,439815,440693,878,5,Y,Y,1438769202218,438794,441102
REOPER.txt,440696,440874,178,5,N,Y,1438769202218,438794,441102
REOPER.txt,440875,441769,894,5,N,Y,1438769202218,438794,441102
REOPER.txt,441771,442462,691,5,N,N,-,-1,-1
REOPER.txt,442463,443178,715,5,N,N,-,-1,-1
REOPER.txt,443183,443443,260,5,N,N,-,-1,-1
REOPER.txt,443444,443673,229,5,N,N,-,-1,-1
REOPER.txt,443674,444008,334,5,N,N,-,-1,-1
REOPER.txt,444009,444319,310,5,N,N,-,-1,-1
REOPER.txt,444320,444671,351,5,N,N,-,-1,-1
REOPER.txt,444672,445062,390,5,N,N,-,-1,-1
REOPER.txt,445063,445682,619,5,N,N,-,-1,-1
REOPER.txt,445685,445847,162,5,N,N,-,-1,-1
REOPER.txt,445848,446175,327,5,N,N,-,-1,-1
REOPER.txt,446178,446513,335,5,N,N,-,-1,-1
REOPER.txt,446514,447468,954,5,Y,N,-,-1,-1
REOPER.txt,447469,448654,1185,5,N,N,-,-1,-1
REOPER.txt,448657,449695,1038,5,Y,N,-,-1,-1
REOPER.txt,449696,450413,717,5,N,Y,1438769699545,450302,451135
REOPER.txt,450414,450970,556,5,N,Y,1438769699545,450302,451135
REOPER.txt,450971,451956,985,5,N,Y,1438769699545,450302,451135
REOPER.txt,451957,452617,660,5,N,Y,1438770178253,451891,452641
REOPER.txt,452618,453265,647,5,N,Y,1438770178253,451891,452641
REOPER.txt,453266,453618,352,5,N,N,-,-1,-1
REOPER.txt,453619,454059,440,5,N,Y,1438770629803,453971,456097
REOPER.txt,454060,454572,512,5,N,Y,1438770629803,453971,456097
REOPER.txt,454573,455262,689,5,N,Y,1438770629803,453971,456097
REOPER.txt,455263,455938,675,5,N,Y,1438770629803,453971,456097
REOPER.txt,455939,457045,1106,5,N,Y,1438771010421,456188,458240
REOPER.txt,457048,457663,615,5,N,Y,1438771010421,456188,458240
REOPER.txt,457664,458062,398,5,N,Y,1438771010421,456188,458240
REOPER.txt,458063,458979,916,5,N,Y,1438771010421,456188,458240
REOPER.txt,458980,460135,1155,5,N,Y,1438771468604,459391,461406
REOPER.txt,460137,461140,1003,5,N,Y,1438771468604,459391,461406
REOPER.txt,461141,461853,712,5,N,Y,1438771468604,459391,461406
REOPER.txt,461854,462740,886,5,N,Y,1438771823978,462479,463275
REOPER.txt,462741,463879,1138,5,N,Y,1438771823978,462479,463275
REOPER.txt,463880,464617,737,5,N,N,-,-1,-1
REOPER.txt,464620,465837,1217,5,N,N,-,-1,-1
REOPER.txt,465839,466457,618,5,N,N,-,-1,-1
REOPER.txt,466458,467644,1186,5,N,N,-,-1,-1
REOPER.txt,467645,468031,386,5,N,N,-,-1,-1
REOPER.txt,468032,468609,577,5,N,N,-,-1,-1
REOPER.txt,468610,469274,664,5,N,N,-,-1,-1
REOPER.txt,469276,469744,468,5,N,N,-,-1,-1
REOPER.txt,469745,470546,801,5,N,N,-,-1,-1
REOPER.txt,470547,471388,841,5,N,N,-,-1,-1
REOPER.txt,471389,471963,574,5,N,N,-,-1,-1
REOPER.txt,471964,472744,780,5,N,N,-,-1,-1
REOPER.txt,472745,473525,780,5,N,N,-,-1,-1
REOPER.txt,473526,474192,666,5,N,Y,1438778151735,473810,477429
REOPER.txt,474193,474753,560,5,N,Y,1438778151735,473810,477429
REOPER.txt,474754,475425,671,5,N,Y,1438778151735,473810,477429
REOPER.txt,475426,475828,402,5,N,Y,1438778151735,473810,477429
REOPER.txt,475829,476424,595,5,N,Y,1438778151735,473810,477429
REOPER.txt,476425,476973,548,5,N,Y,1438778151735,473810,477429
REOPER.txt,476974,477579,605,5,N,Y,1438778151735,473810,477429
REOPER.txt,477580,478055,475,5,N,Y,1438778406473,477978,478874
REOPER.txt,478056,478826,770,5,N,Y,1438778406473,477978,478874
REOPER.txt,478829,479705,876,5,N,Y,1438778406473,477978,478874
REOPER.txt,479706,480385,679,5,N,Y,1438778739733,480167,480764
REOPER.txt,480386,480827,441,5,N,Y,1438778739733,480167,480764
REOPER.txt,480828,481414,586,5,N,N,-,-1,-1
REOPER.txt,481415,481978,563,5,N,N,-,-1,-1
REOPER.txt,481979,482405,426,5,N,N,-,-1,-1
REOPER.txt,482408,482738,330,5,N,N,-,-1,-1
REOPER.txt,482739,483708,969,5,N,N,-,-1,-1
REOPER.txt,483709,484369,660,5,N,N,-,-1,-1
REOPER.txt,484372,485092,720,5,N,N,-,-1,-1
REOPER.txt,485094,485756,662,5,N,N,-,-1,-1
REOPER.txt,485757,486785,1028,5,N,N,-,-1,-1
REOPER.txt,486786,487517,731,5,N,N,-,-1,-1
REOPER.txt,487522,488619,1097,5,N,N,-,-1,-1
REOPER.txt,488620,489307,687,5,N,N,-,-1,-1
REOPER.txt,489308,490247,939,5,N,N,-,-1,-1
REOPER.txt,490248,490661,413,5,N,N,-,-1,-1
REOPER.txt,490662,491270,608,5,N,N,-,-1,-1
REOPER.txt,491273,492337,1064,5,N,N,-,-1,-1
REOPER.txt,492338,493105,767,5,N,N,-,-1,-1
REOPER.txt,493106,494311,1205,5,N,N,-,-1,-1
REOPER.txt,494312,495507,1195,5,N,N,-,-1,-1
REOPER.txt,495508,496863,1355,5,N,N,-,-1,-1
REOPER.txt,496864,497872,1008,5,N,N,-,-1,-1
REOPER.txt,497872,498230,358,5,N,N,-,-1,-1
REOPER.txt,498231,499150,919,5,N,N,-,-1,-1
REOPER.txt,499152,499805,653,5,N,N,-,-1,-1
REOPER.txt,499807,500322,515,5,N,N,-,-1,-1
REOPER.txt,500323,501305,982,5,N,N,-,-1,-1
REOPER.txt,501308,502287,979,5,N,N,-,-1,-1
REOPER.txt,502288,502888,600,5,N,N,-,-1,-1
REOPER.txt,502889,503871,982,5,N,N,-,-1,-1
REOPER.txt,503874,504595,721,5,N,N,-,-1,-1
REOPER.txt,504596,506035,1439,5,Y,Y,1438779843654,505464,507513
REOPER.txt,506036,506801,765,5,N,Y,1438779843654,505464,507513
REOPER.txt,506802,507585,783,5,Y,Y,1438779843654,505464,507513
REOPER.txt,507586,508618,1032,5,Y,Y,1438780085816,508364,509135
REOPER.txt,508619,509397,778,5,N,Y,1438780085816,508364,509135
REOPER.txt,509398,510338,940,5,N,N,-,-1,-1
REOPER.txt,510339,510863,524,5,N,Y,1438780706972,510534,511384
REOPER.txt,510864,511320,456,5,N,Y,1438780706972,510534,511384
REOPER.txt,511321,512069,748,5,N,Y,1438780706972,510534,511384
REOPER.txt,512070,512926,856,5,N,Y,1438781426985,512557,514085
REOPER.txt,512927,513541,614,5,N,Y,1438781426985,512557,514085
REOPER.txt,513544,514303,759,5,N,Y,1438781426985,512557,514085
REOPER.txt,514304,514931,627,5,N,N,-,-1,-1
REOPER.txt,514932,515828,896,5,N,N,-,-1,-1
REOPER.txt,515829,516664,835,5,N,N,-,-1,-1
REOPER.txt,516665,517449,784,5,N,N,-,-1,-1
REOPER.txt,517450,518333,883,5,N,N,-,-1,-1
REOPER.txt,518336,519017,681,5,N,N,-,-1,-1
REOPER.txt,519018,520114,1096,5,N,N,-,-1,-1
REOPER.txt,520115,520820,705,5,N,N,-,-1,-1
REOPER.txt,520822,521475,653,5,N,N,-,-1,-1
REOPER.txt,521476,522024,548,5,N,Y,1438782478949,521766,525299
REOPER.txt,522029,522583,554,5,N,Y,1438782478949,521766,525299
REOPER.txt,522584,522778,194,5,N,Y,1438782478949,521766,525299
REOPER.txt,522779,523335,556,5,N,Y,1438782478949,521766,525299
REOPER.txt,523338,523805,467,5,N,Y,1438782478949,521766,525299
REOPER.txt,523806,524525,719,5,N,Y,1438782478949,521766,525299
REOPER.txt,524526,525705,1179,5,N,Y,1438782478949,521766,525299
REOPER.txt,525708,526443,735,5,N,N,-,-1,-1
REOPER.txt,526444,527290,846,5,N,Y,1438783041826,526732,528338
REOPER.txt,527291,528369,1078,5,Y,Y,1438783041826,526732,528338
REOPER.txt,528372,529042,670,5,N,N,-,-1,-1
REOPER.txt,529043,529820,777,5,N,N,-,-1,-1
REOPER.txt,529821,530430,609,5,N,N,-,-1,-1
REOPER.txt,530431,531065,634,5,N,Y,1438783543267,530789,532585
REOPER.txt,531066,531639,573,5,N,Y,1438783543267,530789,532585
REOPER.txt,531640,532285,645,5,N,Y,1438783543267,530789,532585
REOPER.txt,532286,532814,528,5,N,Y,1438783543267,530789,532585
REOPER.txt,532817,533480,663,5,N,Y,1438784312899,533121,535184
REOPER.txt,533481,534342,861,5,N,Y,1438784312899,533121,535184
REOPER.txt,534343,534875,532,5,N,Y,1438784312899,533121,535184
REOPER.txt,534876,535567,691,5,N,Y,1438784652063,535262,536596
REOPER.txt,535569,536231,662,5,N,Y,1438784652063,535262,536596
REOPER.txt,536232,536927,695,5,N,Y,1438784652063,535262,536596
REOPER.txt,536928,537609,681,5,N,N,-,-1,-1
REOPER.txt,537610,538133,523,5,N,N,-,-1,-1
REOPER.txt,538134,538812,678,5,N,N,-,-1,-1
REOPER.txt,538813,539858,1045,5,N,N,-,-1,-1
REOPER.txt,539861,540784,923,5,N,N,-,-1,-1
REOPER.txt,540786,541526,740,5,N,N,-,-1,-1
REOPER.txt,541527,542169,642,5,N,N,-,-1,-1
REOPER.txt,542170,542763,593,5,N,N,-,-1,-1
REOPER.txt,542764,543560,796,5,N,N,-,-1,-1
REOPER.txt,543563,544073,510,5,N,N,-,-1,-1
REOPER.txt,544074,544832,758,5,N,N,-,-1,-1
REOPER.txt,544833,545604,771,5,N,N,-,-1,-1
REOPER.txt,545605,546558,953,5,N,N,-,-1,-1
REOPER.txt,546559,547213,654,5,N,N,-,-1,-1
REOPER.txt,547214,548009,795,5,N,N,-,-1,-1
REOPER.txt,548010,548758,748,5,N,N,-,-1,-1
REOPER.txt,548761,549432,671,5,N,N,-,-1,-1
REOPER.txt,549433,549890,457,5,N,N,-,-1,-1
REOPER.txt,549893,551022,1129,5,N,N,-,-1,-1
REOPER.txt,551023,551929,906,5,N,N,-,-1,-1
REOPER.txt,551930,552904,974,5,N,N,-,-1,-1
REOPER.txt,552905,553753,848,5,N,N,-,-1,-1
REOPER.txt,553754,554477,723,5,N,N,-,-1,-1
REOPER.txt,554478,555102,624,5,N,N,-,-1,-1
REOPER.txt,555105,555621,516,5,N,N,-,-1,-1
REOPER.txt,555623,556528,905,5,N,N,-,-1,-1
REOPER.txt,556531,557522,991,5,N,N,-,-1,-1
REOPER.txt,557523,558404,881,5,N,N,-,-1,-1
REOPER.txt,558405,559259,854,5,N,N,-,-1,-1
REOPER.txt,559260,559896,636,5,Y,N,-,-1,-1
REOPER.txt,559896,560985,1089,5,Y,N,-,-1,-1
REOPER.txt,560988,561667,679,5,N,N,-,-1,-1
REOPER.txt,561668,562611,943,5,N,N,-,-1,-1
REOPER.txt,562613,563392,779,5,N,N,-,-1,-1
REOPER.txt,563394,564304,910,5,N,N,-,-1,-1
REOPER.txt,564305,565095,790,5,Y,N,-,-1,-1
REOPER.txt,565096,565733,637,5,N,N,-,-1,-1
REOPER.txt,565734,566395,661,5,N,N,-,-1,-1
REOPER.txt,566396,567164,768,5,N,N,-,-1,-1
REOPER.txt,567165,568251,1086,5,N,N,-,-1,-1
REOPER.txt,568252,568811,559,5,N,N,-,-1,-1
REOPER.txt,568812,570028,1216,5,N,N,-,-1,-1
REOPER.txt,570029,570557,528,5,N,N,-,-1,-1
REOPER.txt,570558,571432,874,5,N,N,-,-1,-1
REOPER.txt,571433,572229,796,5,N,N,-,-1,-1
REOPER.txt,572232,573102,870,5,N,N,-,-1,-1
REOPER.txt,573103,573818,715,5,N,N,-,-1,-1
REOPER.txt,573819,574862,1043,5,N,N,-,-1,-1
REOPER.txt,574863,575451,588,5,N,N,-,-1,-1
REOPER.txt,575454,575977,523,5,N,N,-,-1,-1
REOPER.txt,575978,576629,651,5,N,N,-,-1,-1
REOPER.txt,576630,577866,1236,5,N,N,-,-1,-1
REOPER.txt,577869,578678,809,5,N,N,-,-1,-1
REOPER.txt,578679,579719,1040,5,N,N,-,-1,-1
REOPER.txt,579721,580875,1154,5,N,N,-,-1,-1
REOPER.txt,580876,581877,1001,5,N,N,-,-1,-1
REOPER.txt,581878,582732,854,5,N,N,-,-1,-1
REOPER.txt,582735,583536,801,5,N,N,-,-1,-1
REOPER.txt,583539,584293,754,5,N,N,-,-1,-1
REOPER.txt,584294,584702,408,5,N,N,-,-1,-1
REOPER.txt,584703,585339,636,5,N,N,-,-1,-1
REOPER.txt,585340,585752,412,5,N,N,-,-1,-1
REOPER.txt,585753,586540,787,5,N,N,-,-1,-1
REOPER.txt,586542,586995,453,5,N,N,-,-1,-1
REOPER.txt,586996,587502,506,5,N,N,-,-1,-1
REOPER.txt,587503,587844,341,5,N,N,-,-1,-1
REOPER.txt,587847,588859,1012,5,N,N,-,-1,-1
REOPER.txt,588860,589726,866,5,N,N,-,-1,-1
REOPER.txt,589727,590131,404,5,N,N,-,-1,-1
REOPER.txt,590133,591217,1084,5,N,N,-,-1,-1
REOPER.txt,591218,592011,793,5,N,N,-,-1,-1
REOPER.txt,592012,592860,848,5,N,N,-,-1,-1
REOPER.txt,592861,593522,661,5,N,N,-,-1,-1
REOPER.txt,593523,594392,869,5,Y,N,-,-1,-1
REOPER.txt,594393,595312,919,5,N,N,-,-1,-1
REOPER.txt,595313,596512,1199,5,N,N,-,-1,-1
REOPER.txt,596514,597256,742,5,N,N,-,-1,-1
REOPER.txt,597257,598189,932,5,N,N,-,-1,-1
REOPER.txt,598190,598966,776,5,N,N,-,-1,-1
REOPER.txt,598967,599562,595,5,N,N,-,-1,-1
REOPER.txt,599563,600641,1078,5,N,N,-,-1,-1
REOPER.txt,600642,601617,975,5,N,N,-,-1,-1
REOPER.txt,601618,602698,1080,5,N,N,-,-1,-1
REOPER.txt,602703,603449,746,5,N,N,-,-1,-1
REOPER.txt,603450,604374,924,5,N,N,-,-1,-1
REOPER.txt,604375,605222,847,5,N,N,-,-1,-1
REOPER.txt,605223,605768,545,5,N,N,-,-1,-1
REOPER.txt,605769,606971,1202,5,N,N,-,-1,-1
REOPER.txt,606974,607797,823,5,N,N,-,-1,-1
REOPER.txt,607798,608902,1104,5,N,N,-,-1,-1
REOPER.txt,608903,609462,559,5,N,N,-,-1,-1
REOPER.txt,609463,610268,805,5,N,N,-,-1,-1
REOPER.txt,610269,610907,638,5,N,N,-,-1,-1
REOPER.txt,610908,611640,732,5,N,N,-,-1,-1
REOPER.txt,611643,612531,888,5,N,N,-,-1,-1
REOPER.txt,612532,613292,760,5,N,N,-,-1,-1
REOPER.txt,613293,614068,775,5,N,N,-,-1,-1
REOPER.txt,614069,614847,778,5,N,N,-,-1,-1
REOPER.txt,614848,615379,531,5,N,N,-,-1,-1
REOPER.txt,615380,615986,606,5,N,N,-,-1,-1
REOPER.txt,615987,616859,872,5,N,N,-,-1,-1
REOPER.txt,616860,617993,1133,5,N,N,-,-1,-1
REOPER.txt,617996,619093,1097,5,N,N,-,-1,-1
REOPER.txt,619094,619827,733,5,N,N,-,-1,-1
REOPER.txt,619828,620695,867,5,N,N,-,-1,-1
REOPER.txt,620697,621458,761,5,N,N,-,-1,-1
REOPER.txt,621463,622209,746,5,N,N,-,-1,-1
REOPER.txt,622210,623313,1103,5,N,N,-,-1,-1
REOPER.txt,623318,624208,890,5,N,N,-,-1,-1
REOPER.txt,624209,625067,858,5,N,N,-,-1,-1
REOPER.txt,625070,625738,668,5,N,N,-,-1,-1
REOPER.txt,625741,626426,685,5,N,N,-,-1,-1
REOPER.txt,626427,627269,842,5,N,N,-,-1,-1
REOPER.txt,627270,627779,509,5,N,N,-,-1,-1
REOPER.txt,627780,628910,1130,5,N,N,-,-1,-1
REOPER.txt,628911,629363,452,5,N,N,-,-1,-1
REOPER.txt,629364,630163,799,5,N,N,-,-1,-1
REOPER.txt,630166,630663,497,5,N,N,-,-1,-1
REOPER.txt,630664,631223,559,5,N,N,-,-1,-1
REOPER.txt,631224,632266,1042,5,N,N,-,-1,-1
REOPER.txt,632269,632781,512,5,N,N,-,-1,-1
REOPER.txt,632782,633753,971,5,N,N,-,-1,-1
REOPER.txt,633753,634586,833,5,N,N,-,-1,-1
REOPER.txt,634587,635272,685,5,N,N,-,-1,-1
REOPER.txt,635273,635977,704,5,N,N,-,-1,-1
REOPER.txt,635978,636839,861,5,N,N,-,-1,-1
REOPER.txt,636840,637732,892,5,N,N,-,-1,-1
REOPER.txt,637733,638664,931,5,N,N,-,-1,-1
REOPER.txt,638665,639506,841,5,N,N,-,-1,-1
REOPER.txt,639509,640414,905,5,N,N,-,-1,-1
REOPER.txt,640415,641162,747,5,N,N,-,-1,-1
REOPER.txt,641163,642103,940,5,N,N,-,-1,-1
REOPER.txt,642104,643036,932,5,N,N,-,-1,-1
REOPER.txt,643036,643426,390,5,N,N,-,-1,-1
REOPER.txt,643427,644504,1077,5,N,N,-,-1,-1
REOPER.txt,644506,645393,887,5,N,N,-,-1,-1
REOPER.txt,645394,646600,1206,5,N,N,-,-1,-1
REOPER.txt,646601,648495,1894,5,N,N,-,-1,-1
REOPER.txt,648496,649239,743,5,N,N,-,-1,-1
REOPER.txt,649242,650481,1239,5,N,N,-,-1,-1
REOPER.txt,650482,651291,809,5,N,N,-,-1,-1
REOPER.txt,651292,651782,490,5,N,N,-,-1,-1
REOPER.txt,651783,652185,402,5,N,N,-,-1,-1
REOPER.txt,652188,652958,770,5,N,N,-,-1,-1
REOPER.txt,652961,653889,928,5,N,N,-,-1,-1
REOPER.txt,653892,654795,903,5,N,N,-,-1,-1
REOPER.txt,654796,655704,908,5,N,N,-,-1,-1
REOPER.txt,655707,656269,562,5,N,N,-,-1,-1
REOPER.txt,656270,657149,879,5,N,N,-,-1,-1
REOPER.txt,657151,658443,1292,5,N,N,-,-1,-1
REOPER.txt,658444,659150,706,5,N,N,-,-1,-1
REOPER.txt,659152,659685,533,5,N,N,-,-1,-1
REOPER.txt,659686,660483,797,5,N,N,-,-1,-1
REOPER.txt,660486,661267,781,5,N,N,-,-1,-1
REOPER.txt,661268,661752,484,5,N,N,-,-1,-1
REOPER.txt,661753,662554,801,5,N,N,-,-1,-1
REOPER.txt,662555,663305,750,5,N,N,-,-1,-1
REOPER.txt,663306,664111,805,5,N,N,-,-1,-1
REOPER.txt,664112,665496,1384,5,N,N,-,-1,-1
REOPER.txt,665497,666441,944,5,N,N,-,-1,-1
REOPER.txt,666444,667464,1020,5,N,N,-,-1,-1
REOPER.txt,667465,668549,1084,5,N,N,-,-1,-1
REOPER.txt,668549,669331,782,5,N,N,-,-1,-1
REOPER.txt,669332,670172,840,5,N,N,-,-1,-1
REOPER.txt,670174,671003,829,5,N,N,-,-1,-1
REOPER.txt,671004,671317,313,5,N,N,-,-1,-1
REOPER.txt,671317,671884,567,5,N,N,-,-1,-1
REOPER.txt,671885,672700,815,5,N,N,-,-1,-1
REOPER.txt,672701,673073,372,5,N,N,-,-1,-1
REOPER.txt,673074,673982,908,5,N,N,-,-1,-1
REOPER.txt,673983,674603,620,5,N,N,-,-1,-1
REOPER.txt,674604,675253,649,5,N,N,-,-1,-1
REOPER.txt,675254,675858,604,5,N,N,-,-1,-1
REOPER.txt,675861,676048,187,5,N,N,-,-1,-1
REOPER.txt,676051,677014,963,5,N,N,-,-1,-1
REOPER.txt,677015,677724,709,5,N,N,-,-1,-1
REOPER.txt,677725,678012,287,5,N,N,-,-1,-1
REOPER.txt,678013,678568,555,5,N,N,-,-1,-1
REOPER.txt,678569,679540,971,5,N,N,-,-1,-1
REOPER.txt,679541,680362,821,5,N,N,-,-1,-1
REOPER.txt,680363,681174,811,5,N,N,-,-1,-1
REOPER.txt,681175,681625,450,5,N,N,-,-1,-1
REOPER.txt,681626,682628,1002,5,N,N,-,-1,-1
REOPER.txt,682629,683249,620,5,N,N,-,-1,-1
REOPER.txt,683250,684065,815,5,N,N,-,-1,-1
REOPER.txt,684067,685262,1195,5,N,N,-,-1,-1
REOPER.txt,685265,685876,611,5,N,N,-,-1,-1
REOPER.txt,685878,686594,716,5,N,N,-,-1,-1
REOPER.txt,686595,687340,745,5,N,N,-,-1,-1
REOPER.txt,687341,688046,705,5,N,N,-,-1,-1
REOPER.txt,688047,688385,338,5,N,N,-,-1,-1
REOPER.txt,688386,689124,738,5,N,N,-,-1,-1
REOPER.txt,689127,689970,843,5,N,N,-,-1,-1
REOPER.txt,689971,690713,742,5,N,N,-,-1,-1
REOPER.txt,690713,691617,904,5,N,N,-,-1,-1
REOPER.txt,691619,692241,622,5,N,N,-,-1,-1
REOPER.txt,692242,693258,1016,5,N,N,-,-1,-1
REOPER.txt,693261,693614,353,5,N,N,-,-1,-1
REOPER.txt,693615,694192,577,5,N,N,-,-1,-1
REOPER.txt,694193,694681,488,5,N,N,-,-1,-1
REOPER.txt,694682,695239,557,5,N,N,-,-1,-1
REOPER.txt,695240,695582,342,5,N,N,-,-1,-1
REOPER.txt,695584,696283,699,5,N,N,-,-1,-1
REOPER.txt,696284,696516,232,5,N,N,-,-1,-1
REOPER.txt,696517,696981,464,5,N,N,-,-1,-1
REOPER.txt,696984,697209,225,5,N,N,-,-1,-1
REOPER.txt,697210,697602,392,5,N,N,-,-1,-1
REOPER.txt,697605,698566,961,5,N,N,-,-1,-1
REOPER.txt,698567,699385,818,5,N,N,-,-1,-1
REOPER.txt,699386,700599,1213,5,N,N,-,-1,-1
REOPER.txt,700600,701040,440,5,N,N,-,-1,-1
REOPER.txt,701041,701543,502,5,N,N,-,-1,-1
REOPER.txt,701543,702094,551,5,N,N,-,-1,-1
REOPER.txt,702095,703215,1120,5,N,N,-,-1,-1
REOPER.txt,703216,703798,582,5,N,N,-,-1,-1
REOPER.txt,703799,704626,827,5,N,N,-,-1,-1
REOPER.txt,704627,705144,517,5,N,N,-,-1,-1
REOPER.txt,705145,705571,426,5,N,N,-,-1,-1
REOPER.txt,705572,706347,775,5,N,N,-,-1,-1
REOPER.txt,706348,706976,628,5,N,N,-,-1,-1
REOPER.txt,706978,707967,989,5,N,N,-,-1,-1
REOPER.txt,707968,708625,657,5,N,N,-,-1,-1
REOPER.txt,708626,709287,661,5,N,N,-,-1,-1
REOPER.txt,709288,710455,1167,5,N,N,-,-1,-1
REOPER.txt,710456,710902,446,5,N,N,-,-1,-1
REOPER.txt,710903,711262,359,5,N,N,-,-1,-1
REOPER.txt,711263,711721,458,5,N,N,-,-1,-1
REOPER.txt,711722,712340,618,5,N,N,-,-1,-1
REOPER.txt,712342,712796,454,5,N,N,-,-1,-1
REOPER.txt,712797,713368,571,5,N,N,-,-1,-1
REOPER.txt,713369,713955,586,5,N,N,-,-1,-1
REOPER.txt,713957,714556,599,5,N,N,-,-1,-1
REOPER.txt,714558,715158,600,5,N,N,-,-1,-1
REOPER.txt,715159,715978,819,5,N,N,-,-1,-1
REOPER.txt,715979,716660,681,5,N,N,-,-1,-1
REOPER.txt,716662,717207,545,5,N,N,-,-1,-1
REOPER.txt,717208,717836,628,5,N,N,-,-1,-1
REOPER.txt,717839,718723,884,5,N,N,-,-1,-1
REOPER.txt,718724,719659,935,5,N,N,-,-1,-1
REOPER.txt,719662,720027,365,5,N,N,-,-1,-1
REOPER.txt,720029,720847,818,5,N,N,-,-1,-1
REOPER.txt,720849,721396,547,5,N,N,-,-1,-1
REOPER.txt,721397,722696,1299,5,N,N,-,-1,-1
REOPER.txt,722697,723611,914,5,N,N,-,-1,-1
REOPER.txt,723612,724784,1172,5,N,N,-,-1,-1
REOPER.txt,724785,725206,421,5,N,N,-,-1,-1
REOPER.txt,725207,726102,895,5,N,N,-,-1,-1
REOPER.txt,726103,726825,722,5,N,N,-,-1,-1
REOPER.txt,726828,727565,737,5,N,N,-,-1,-1
REOPER.txt,727568,728091,523,5,N,N,-,-1,-1
REOPER.txt,728092,728381,289,5,N,N,-,-1,-1
REOPER.txt,728382,728826,444,5,N,N,-,-1,-1
REOPER.txt,728827,730155,1328,5,N,N,-,-1,-1
REOPER.txt,730155,730680,525,5,N,N,-,-1,-1
REOPER.txt,730681,731206,525,5,N,N,-,-1,-1
REOPER.txt,731207,731725,518,5,N,N,-,-1,-1
REOPER.txt,731726,732336,610,5,N,N,-,-1,-1
REOPER.txt,732338,732913,575,5,N,N,-,-1,-1
REOPER.txt,732913,733644,731,5,N,N,-,-1,-1
REOPER.txt,733644,734595,951,5,N,N,-,-1,-1
REOPER.txt,734596,735361,765,5,N,N,-,-1,-1
REOPER.txt,735366,736339,973,5,N,N,-,-1,-1
REOPER.txt,736340,737250,910,5,N,N,-,-1,-1
REOPER.txt,737251,737816,565,5,N,N,-,-1,-1
REOPER.txt,737817,739153,1336,5,N,N,-,-1,-1
REOPER.txt,739154,739499,345,5,N,N,-,-1,-1
REOPER.txt,739500,740298,798,5,N,N,-,-1,-1
REOPER.txt,740299,741016,717,5,N,N,-,-1,-1
REOPER.txt,741017,742027,1010,5,N,N,-,-1,-1
REOPER.txt,742028,743082,1054,5,N,N,-,-1,-1
REOPER.txt,743085,743900,815,5,N,N,-,-1,-1
REOPER.txt,743901,744808,907,5,N,N,-,-1,-1
REOPER.txt,744809,745408,599,5,N,N,-,-1,-1
REOPER.txt,745409,746100,691,5,N,N,-,-1,-1
REOPER.txt,746101,746551,450,5,N,N,-,-1,-1
REOPER.txt,746552,747162,610,5,N,N,-,-1,-1
REOPER.txt,747163,747595,432,5,N,N,-,-1,-1
REOPER.txt,747597,748618,1021,5,N,N,-,-1,-1
REOPER.txt,748619,749265,646,5,N,N,-,-1,-1
REOPER.txt,749267,750375,1108,5,Y,N,-,-1,-1
REOPER.txt,750378,751344,966,5,N,N,-,-1,-1
REOPER.txt,751345,752232,887,5,N,N,-,-1,-1
REOPER.txt,752235,753008,773,5,N,N,-,-1,-1
REOPER.txt,753009,753966,957,5,N,N,-,-1,-1
REOPER.txt,753967,754887,920,5,N,N,-,-1,-1
REOPER.txt,754888,755632,744,5,N,N,-,-1,-1
REOPER.txt,755633,756151,518,5,N,N,-,-1,-1
REOPER.txt,756152,756880,728,5,N,N,-,-1,-1
REOPER.txt,756881,757392,511,5,N,N,-,-1,-1
REOPER.txt,757393,757781,388,5,N,N,-,-1,-1
REOPER.txt,757782,758910,1128,5,N,N,-,-1,-1
REOPER.txt,758911,759330,419,5,N,N,-,-1,-1
REOPER.txt,759332,760135,803,5,N,N,-,-1,-1
REOPER.txt,760136,761007,871,5,N,N,-,-1,-1
REOPER.txt,761010,761603,593,5,N,N,-,-1,-1
REOPER.txt,761604,762774,1170,5,N,N,-,-1,-1
REOPER.txt,762775,763276,501,5,N,N,-,-1,-1
REOPER.txt,763277,764319,1042,5,N,N,-,-1,-1
REOPER.txt,764320,765169,849,5,N,N,-,-1,-1
REOPER.txt,765170,765822,652,5,N,N,-,-1,-1
REOPER.txt,765823,766505,682,5,N,N,-,-1,-1
REOPER.txt,766506,767116,610,5,N,N,-,-1,-1
REOPER.txt,767117,767915,798,5,N,N,-,-1,-1
REOPER.txt,767917,768454,537,5,N,N,-,-1,-1
REOPER.txt,768455,769827,1372,5,N,N,-,-1,-1
REOPER.txt,769828,770343,515,5,N,N,-,-1,-1
REOPER.txt,770344,770674,330,5,N,N,-,-1,-1
REOPER.txt,770674,771366,692,5,N,N,-,-1,-1
REOPER.txt,771367,771987,620,5,N,N,-,-1,-1
REOPER.txt,771988,772608,620,5,N,N,-,-1,-1
REOPER.txt,772609,773224,615,5,N,N,-,-1,-1
REOPER.txt,773225,773851,626,5,N,N,-,-1,-1
REOPER.txt,773853,774636,783,5,N,N,-,-1,-1
REOPER.txt,774637,775920,1283,5,N,N,-,-1,-1
REOPER.txt,775921,776667,746,5,N,N,-,-1,-1
REOPER.txt,776668,777367,699,5,N,N,-,-1,-1
REOPER.txt,777368,777972,604,5,N,N,-,-1,-1
REOPER.txt,777973,778664,691,5,N,N,-,-1,-1
REOPER.txt,778665,779213,548,5,N,N,-,-1,-1
REOPER.txt,779214,779441,227,5,N,N,-,-1,-1
REOPER.txt,779442,779961,519,5,N,N,-,-1,-1
REOPER.txt,779962,780553,591,5,N,N,-,-1,-1
REOPER.txt,780554,781369,815,5,N,N,-,-1,-1
REOPER.txt,781370,781918,548,5,N,N,-,-1,-1
REOPER.txt,781919,782687,768,5,N,N,-,-1,-1
REOPER.txt,782688,783475,787,5,N,N,-,-1,-1
REOPER.txt,783478,784204,726,5,N,N,-,-1,-1
REOPER.txt,784205,784954,749,5,N,N,-,-1,-1
REOPER.txt,784955,785357,402,5,N,N,-,-1,-1
REOPER.txt,785358,785485,127,5,N,N,-,-1,-1
REOPER.txt,785486,785620,134,5,N,N,-,-1,-1
REOPER.txt,785622,786553,931,5,N,N,-,-1,-1
REOPER.txt,786554,787408,854,5,N,N,-,-1,-1
REOPER.txt,787409,788266,857,5,N,N,-,-1,-1
REOPER.txt,788269,789480,1211,5,N,N,-,-1,-1
REOPER.txt,789483,790443,960,5,N,N,-,-1,-1
REOPER.txt,790446,791390,944,5,N,N,-,-1,-1
REOPER.txt,791393,792020,627,5,Y,N,-,-1,-1
REOPER.txt,792023,792658,635,5,N,N,-,-1,-1
REOPER.txt,792660,793628,968,5,N,N,-,-1,-1
REOPER.txt,793629,794206,577,5,N,N,-,-1,-1
REOPER.txt,794207,794523,316,5,N,N,-,-1,-1
REOPER.txt,794524,795319,795,5,N,N,-,-1,-1
REOPER.txt,795322,795933,611,5,N,N,-,-1,-1
REOPER.txt,795934,796969,1035,5,N,N,-,-1,-1
REOPER.txt,796969,797558,589,5,N,N,-,-1,-1
REOPER.txt,797563,798402,839,5,N,N,-,-1,-1
REOPER.txt,798405,799864,1459,5,N,N,-,-1,-1
REOPER.txt,799865,800838,973,5,N,N,-,-1,-1
REOPER.txt,800839,801488,649,5,N,N,-,-1,-1
REOPER.txt,801489,802389,900,5,N,N,-,-1,-1
REOPER.txt,802390,802879,489,5,N,N,-,-1,-1
REOPER.txt,802880,803782,902,5,N,N,-,-1,-1
REOPER.txt,803783,804259,476,5,N,N,-,-1,-1
REOPER.txt,804260,804816,556,5,N,N,-,-1,-1
REOPER.txt,804817,805431,614,5,N,N,-,-1,-1
REOPER.txt,805432,806010,578,5,N,N,-,-1,-1
REOPER.txt,806011,806838,827,5,N,N,-,-1,-1
REOPER.txt,806839,807511,672,5,N,N,-,-1,-1
REOPER.txt,807512,808092,580,5,N,N,-,-1,-1
REOPER.txt,808093,808419,326,5,N,N,-,-1,-1
REOPER.txt,808420,809267,847,5,N,N,-,-1,-1
REOPER.txt,809268,810169,901,5,N,N,-,-1,-1
REOPER.txt,810170,811006,836,5,N,N,-,-1,-1
REOPER.txt,811007,812054,1047,5,N,N,-,-1,-1
REOPER.txt,812055,812762,707,5,N,N,-,-1,-1
REOPER.txt,812763,813338,575,5,N,N,-,-1,-1
REOPER.txt,813339,814029,690,5,N,N,-,-1,-1
REOPER.txt,814030,814587,557,5,N,N,-,-1,-1
REOPER.txt,814588,815677,1089,5,N,N,-,-1,-1
REOPER.txt,815678,816201,523,5,N,N,-,-1,-1
REOPER.txt,816201,816971,770,5,N,N,-,-1,-1
REOPER.txt,816972,817831,859,5,N,N,-,-1,-1
REOPER.txt,817836,818236,400,5,N,N,-,-1,-1
REOPER.txt,818239,819325,1086,5,N,N,-,-1,-1
REOPER.txt,819326,820196,870,5,N,N,-,-1,-1
REOPER.txt,820199,820695,496,5,N,N,-,-1,-1
REOPER.txt,820696,821426,730,5,N,N,-,-1,-1
REOPER.txt,821429,821950,521,5,N,N,-,-1,-1
REOPER.txt,821950,823080,1130,5,N,N,-,-1,-1
REOPER.txt,823081,823561,480,5,N,N,-,-1,-1
REOPER.txt,823562,823962,400,5,N,N,-,-1,-1
REOPER.txt,823963,825692,1729,5,N,N,-,-1,-1
REOPER.txt,825693,827256,1563,5,N,N,-,-1,-1
REOPER.txt,827257,827582,325,5,N,N,-,-1,-1
THIRTY.txt,1,999,998,5,N,N,-,-1,-1
THIRTY.txt,1000,2895,1895,5,N,N,-,-1,-1
THIRTY.txt,2896,4268,1372,5,Y,N,-,-1,-1
THIRTY.txt,4269,5988,1719,5,N,N,-,-1,-1
THIRTY.txt,5989,7085,1096,5,N,N,-,-1,-1
THIRTY.txt,7086,8155,1069,5,N,N,-,-1,-1
THIRTY.txt,8156,9748,1592,5,N,N,-,-1,-1
THIRTY.txt,9749,10867,1118,5,N,N,-,-1,-1
THIRTY.txt,10868,12059,1191,5,N,N,-,-1,-1
THIRTY.txt,12062,13405,1343,5,N,N,-,-1,-1
THIRTY.txt,13408,13850,442,5,N,N,-,-1,-1
THIRTY.txt,13851,14866,1015,5,N,N,-,-1,-1
THIRTY.txt,14867,15854,987,5,N,N,-,-1,-1
THIRTY.txt,15857,16620,763,5,N,N,-,-1,-1
THIRTY.txt,16621,17521,900,5,N,Y,1438157398793,16921,17950
THIRTY.txt,17522,18320,798,5,N,Y,1438157398793,16921,17950
THIRTY.txt,18321,19029,708,5,N,Y,1438159538620,18153,19649
THIRTY.txt,19030,20395,1365,5,Y,Y,1438159538620,18153,19649
THIRTY.txt,20396,21139,743,5,N,N,-,-1,-1
THIRTY.txt,21139,22054,915,5,N,N,-,-1,-1
THIRTY.txt,22057,22737,680,5,N,N,-,-1,-1
THIRTY.txt,22738,23745,1007,5,N,N,-,-1,-1
THIRTY.txt,23746,24401,655,5,N,N,-,-1,-1
THIRTY.txt,24404,25360,956,5,N,N,-,-1,-1
THIRTY.txt,25362,25780,418,5,N,N,-,-1,-1
THIRTY.txt,25781,26264,483,5,N,N,-,-1,-1
THIRTY.txt,26265,26874,609,5,N,N,-,-1,-1
THIRTY.txt,26875,27743,868,5,N,N,-,-1,-1
THIRTY.txt,27745,28446,701,5,N,N,-,-1,-1
THIRTY.txt,28448,29371,923,5,N,Y,1438160199087,28565,29351
THIRTY.txt,29374,30026,652,5,N,Y,1438161059126,29508,30161
THIRTY.txt,30027,31031,1004,5,N,Y,1438161059126,29508,30161
THIRTY.txt,31032,32129,1097,5,N,Y,1438161785448,31562,32150
THIRTY.txt,32130,32801,671,5,N,Y,1438161785448,31562,32150
THIRTY.txt,32802,33359,557,5,N,Y,1438162296864,32161,34110
THIRTY.txt,33360,33867,507,5,N,Y,1438162296864,32161,34110
THIRTY.txt,33870,34610,740,5,N,Y,1438162296864,32161,34110
THIRTY.txt,34611,35407,796,5,N,N,-,-1,-1
THIRTY.txt,35408,36194,786,5,N,N,-,-1,-1
THIRTY.txt,36196,37641,1445,5,Y,N,-,-1,-1
THIRTY.txt,37642,38481,839,5,N,N,-,-1,-1
THIRTY.txt,38482,39188,706,5,N,N,-,-1,-1
THIRTY.txt,39189,39911,722,5,N,N,-,-1,-1
THIRTY.txt,39912,40860,948,5,N,Y,1438162931556,40152,41509
THIRTY.txt,40861,41514,653,5,N,Y,1438162931556,40152,41509
THIRTY.txt,41517,42550,1033,5,N,Y,1438163419525,41973,43188
THIRTY.txt,42551,43208,657,5,N,Y,1438163419525,41973,43188
THIRTY.txt,43211,43788,577,5,N,Y,1438164083045,43381,44787
THIRTY.txt,43789,44325,536,5,N,Y,1438164083045,43381,44787
THIRTY.txt,44326,44894,568,5,N,Y,1438165222216,44881,46194
THIRTY.txt,44895,46154,1259,5,N,Y,1438165222216,44881,46194
THIRTY.txt,46155,46762,607,5,N,Y,1438165222216,44881,46194
THIRTY.txt,46763,47529,766,5,N,N,-,-1,-1
THIRTY.txt,47532,48225,693,5,N,N,-,-1,-1
THIRTY.txt,48226,48673,447,5,N,N,-,-1,-1
THIRTY.txt,48676,49400,724,5,N,N,-,-1,-1
THIRTY.txt,49401,49786,385,5,N,N,-,-1,-1
THIRTY.txt,49787,50342,555,5,N,N,-,-1,-1
THIRTY.txt,50345,51179,834,5,N,N,-,-1,-1
THIRTY.txt,51180,52233,1053,5,N,N,-,-1,-1
THIRTY.txt,52236,53435,1199,5,N,N,-,-1,-1
THIRTY.txt,53436,54098,662,5,N,N,-,-1,-1
THIRTY.txt,54099,54911,812,5,N,N,-,-1,-1
THIRTY.txt,54912,55498,586,5,N,Y,1438165920566,55062,56456
THIRTY.txt,55503,56226,723,5,N,Y,1438165920566,55062,56456
THIRTY.txt,56227,56718,491,5,N,Y,1438165920566,55062,56456
THIRTY.txt,56719,57609,890,5,N,N,-,-1,-1
THIRTY.txt,57610,58100,490,5,N,N,-,-1,-1
THIRTY.txt,58101,59083,982,5,N,N,-,-1,-1
THIRTY.txt,59086,59593,507,5,N,Y,1438166902193,59219,61464
THIRTY.txt,59594,60568,974,5,Y,Y,1438166902193,59219,61464
THIRTY.txt,60571,61482,911,5,N,Y,1438166902193,59219,61464
THIRTY.txt,61483,62434,951,5,N,Y,1438167435224,61729,62292
THIRTY.txt,62435,63346,911,5,N,N,-,-1,-1
THIRTY.txt,63348,64211,863,5,N,N,-,-1,-1
THIRTY.txt,64212,64964,752,5,N,N,-,-1,-1
THIRTY.txt,64965,65407,442,5,N,N,-,-1,-1
THIRTY.txt,65410,66297,887,5,N,N,-,-1,-1
THIRTY.txt,66298,66967,669,5,N,N,-,-1,-1
THIRTY.txt,66968,68084,1116,5,N,N,-,-1,-1
THIRTY.txt,68085,68588,503,5,N,N,-,-1,-1
THIRTY.txt,68589,69204,615,5,N,N,-,-1,-1
THIRTY.txt,69205,69833,628,5,N,N,-,-1,-1
THIRTY.txt,69834,70933,1099,5,N,N,-,-1,-1
THIRTY.txt,70936,72054,1118,5,N,N,-,-1,-1
THIRTY.txt,72055,73102,1047,5,N,N,-,-1,-1
THIRTY.txt,73103,74218,1115,5,N,N,-,-1,-1
THIRTY.txt,74221,75056,835,5,N,Y,1438169169141,74247,75379
THIRTY.txt,75057,76134,1077,5,Y,Y,1438169169141,74247,75379
THIRTY.txt,76135,77214,1079,5,N,N,-,-1,-1
THIRTY.txt,77215,78072,857,5,N,N,-,-1,-1
THIRTY.txt,78073,78743,670,5,N,N,-,-1,-1
THIRTY.txt,78744,79214,470,5,N,N,-,-1,-1
THIRTY.txt,79215,79861,646,5,N,N,-,-1,-1
THIRTY.txt,79863,80929,1066,5,N,N,-,-1,-1
THIRTY.txt,80930,81249,319,5,N,N,-,-1,-1
THIRTY.txt,81252,81810,558,5,N,N,-,-1,-1
THIRTY.txt,81812,82267,455,5,N,N,-,-1,-1
THIRTY.txt,82272,83244,972,5,Y,Y,1438170164484,82295,83217
THIRTY.txt,83247,84094,847,5,N,N,-,-1,-1
THIRTY.txt,84095,84938,843,5,N,N,-,-1,-1
THIRTY.txt,84939,86001,1062,5,N,N,-,-1,-1
THIRTY.txt,86002,87332,1330,5,N,N,-,-1,-1
THIRTY.txt,87333,88114,781,5,N,N,-,-1,-1
THIRTY.txt,88117,88938,821,5,N,N,-,-1,-1
THIRTY.txt,88940,89472,532,5,N,N,-,-1,-1
THIRTY.txt,89473,90084,611,5,N,N,-,-1,-1
THIRTY.txt,90085,90459,374,5,N,N,-,-1,-1
THIRTY.txt,90461,90849,388,5,N,N,-,-1,-1
THIRTY.txt,90852,91490,638,5,N,N,-,-1,-1
THIRTY.txt,91491,92165,674,5,N,N,-,-1,-1
THIRTY.txt,92168,92903,735,5,N,Y,1438189723317,92178,95121
THIRTY.txt,92906,93681,775,5,N,Y,1438189723317,92178,95121
THIRTY.txt,93682,94237,555,5,N,Y,1438189723317,92178,95121
THIRTY.txt,94238,95011,773,5,N,Y,1438189723317,92178,95121
THIRTY.txt,95012,95593,581,5,N,Y,1438189723317,92178,95121
THIRTY.txt,95594,95980,386,5,N,N,-,-1,-1
THIRTY.txt,95981,96734,753,5,N,N,-,-1,-1
THIRTY.txt,96737,97301,564,5,N,N,-,-1,-1
THIRTY.txt,97302,97925,623,5,N,N,-,-1,-1
THIRTY.txt,97927,98999,1072,5,N,N,-,-1,-1
THIRTY.txt,99002,99728,726,5,N,N,-,-1,-1
THIRTY.txt,99730,100579,849,5,N,N,-,-1,-1
THIRTY.txt,100580,101395,815,5,N,N,-,-1,-1
THIRTY.txt,101395,101931,536,5,N,N,-,-1,-1
THIRTY.txt,101934,102435,501,5,N,Y,1438190510320,101962,103008
THIRTY.txt,102436,103249,813,5,N,Y,1438190510320,101962,103008
THIRTY.txt,103252,104082,830,5,N,Y,1438191374996,103260,104214
THIRTY.txt,104083,104863,780,5,N,Y,1438191374996,103260,104214
THIRTY.txt,104864,105330,466,5,N,N,-,-1,-1
THIRTY.txt,105333,106231,898,5,N,N,-,-1,-1
THIRTY.txt,106232,107095,863,5,N,N,-,-1,-1
THIRTY.txt,107096,107881,785,5,N,Y,1438246777986,107205,109556
THIRTY.txt,107882,108630,748,5,N,Y,1438246777986,107205,109556
THIRTY.txt,108631,109560,929,5,N,Y,1438246777986,107205,109556
THIRTY.txt,109563,110302,739,5,N,N,-,-1,-1
THIRTY.txt,110303,111694,1391,5,N,N,-,-1,-1
THIRTY.txt,111695,112600,905,5,N,N,-,-1,-1
THIRTY.txt,112601,113594,993,5,N,N,-,-1,-1
THIRTY.txt,113595,114197,602,5,N,N,-,-1,-1
THIRTY.txt,114198,114800,602,5,N,N,-,-1,-1
THIRTY.txt,114801,115082,281,5,N,N,-,-1,-1
THIRTY.txt,115085,115834,749,5,N,Y,1438247270881,115104,115832
THIRTY.txt,115837,116656,819,5,N,N,-,-1,-1
THIRTY.txt,116657,117474,817,5,N,Y,1438247568627,117001,117471
THIRTY.txt,117475,118316,841,5,N,Y,1438247916111,118197,118881
THIRTY.txt,118317,119037,720,5,N,Y,1438247916111,118197,118881
THIRTY.txt,119040,119843,803,5,N,Y,1438248640511,119038,120318
THIRTY.txt,119844,120578,734,5,N,Y,1438248640511,119038,120318
THIRTY.txt,120579,121095,516,5,N,N,-,-1,-1
THIRTY.txt,121096,121869,773,5,N,N,-,-1,-1
THIRTY.txt,121870,123134,1264,5,N,N,-,-1,-1
THIRTY.txt,123135,123972,837,5,N,Y,1438249161833,123571,124012
THIRTY.txt,123973,124563,590,5,N,Y,1438249161833,123571,124012
THIRTY.txt,124564,125406,842,5,N,N,-,-1,-1
THIRTY.txt,125409,126775,1366,5,N,N,-,-1,-1
THIRTY.txt,126778,127577,799,5,N,N,-,-1,-1
THIRTY.txt,127580,128344,764,5,N,N,-,-1,-1
THIRTY.txt,128347,129021,674,5,N,N,-,-1,-1
THIRTY.txt,129023,130034,1011,5,N,N,-,-1,-1
THIRTY.txt,130035,130705,670,5,N,N,-,-1,-1
THIRTY.txt,130706,131582,876,5,N,N,-,-1,-1
THIRTY.txt,131585,132080,495,5,N,N,-,-1,-1
THIRTY.txt,132081,132927,846,5,N,N,-,-1,-1
THIRTY.txt,132928,133975,1047,5,N,N,-,-1,-1
THIRTY.txt,133976,135091,1115,5,N,N,-,-1,-1
THIRTY.txt,135092,135648,556,5,N,N,-,-1,-1
THIRTY.txt,135649,136023,374,5,N,N,-,-1,-1
THIRTY.txt,136025,136192,167,5,N,N,-,-1,-1
THIRTY.txt,136193,136279,86,5,N,N,-,-1,-1
THIRTY.txt,136284,136498,214,5,N,N,-,-1,-1
THIRTY.txt,136501,136525,24,5,N,N,-,-1,-1
THIRTY.txt,136525,136581,56,5,N,N,-,-1,-1
THIRTY.txt,136581,136622,41,5,N,N,-,-1,-1
THIRTY.txt,136627,136676,49,5,N,N,-,-1,-1
THIRTY.txt,136677,136785,108,5,N,N,-,-1,-1
THIRTY.txt,136787,136850,63,5,N,N,-,-1,-1
THIRTY.txt,136852,136945,93,5,N,N,-,-1,-1
THIRTY.txt,136950,137005,55,5,N,N,-,-1,-1
THIRTY.txt,137005,137092,87,5,N,N,-,-1,-1
THIRTY.txt,137092,138283,1191,5,N,N,-,-1,-1
THIRTY.txt,138284,139191,907,5,N,N,-,-1,-1
THIRTY.txt,139192,139671,479,5,N,N,-,-1,-1
THIRTY.txt,139674,140293,619,5,N,N,-,-1,-1
THIRTY.txt,140294,141023,729,5,N,N,-,-1,-1
THIRTY.txt,141023,141950,927,5,N,N,-,-1,-1
THIRTY.txt,141953,142856,903,5,N,N,-,-1,-1
THIRTY.txt,142857,143630,773,5,N,N,-,-1,-1
THIRTY.txt,143630,144557,927,5,N,N,-,-1,-1
THIRTY.txt,144558,145592,1034,5,N,N,-,-1,-1
THIRTY.txt,145593,146066,473,5,N,Y,1438250592994,145798,147831
THIRTY.txt,146069,146744,675,5,N,Y,1438250592994,145798,147831
THIRTY.txt,146745,147851,1106,5,N,Y,1438250592994,145798,147831
THIRTY.txt,147854,149301,1447,5,N,N,-,-1,-1
THIRTY.txt,149304,150517,1213,5,N,N,-,-1,-1
THIRTY.txt,150518,151050,532,5,N,N,-,-1,-1
THIRTY.txt,151053,151946,893,5,N,Y,1438251442654,151139,153995
THIRTY.txt,151947,152906,959,5,N,Y,1438251442654,151139,153995
THIRTY.txt,152907,153507,600,5,N,Y,1438251442654,151139,153995
THIRTY.txt,153510,154244,734,5,N,Y,1438251442654,151139,153995
THIRTY.txt,154247,154872,625,5,N,Y,1438251999106,154831,155580
THIRTY.txt,154873,155821,948,5,N,Y,1438251999106,154831,155580
THIRTY.txt,155822,156831,1009,5,N,N,-,-1,-1
THIRTY.txt,156834,157395,561,5,N,N,-,-1,-1
THIRTY.txt,157396,158187,791,5,N,N,-,-1,-1
THIRTY.txt,158188,159078,890,5,N,N,-,-1,-1
THIRTY.txt,159079,159858,779,5,N,N,-,-1,-1
THIRTY.txt,159859,160863,1004,5,N,N,-,-1,-1
THIRTY.txt,160864,161631,767,5,N,N,-,-1,-1
THIRTY.txt,161632,162153,521,5,N,N,-,-1,-1
THIRTY.txt,162154,163021,867,5,N,N,-,-1,-1
THIRTY.txt,163022,163696,674,5,N,N,-,-1,-1
THIRTY.txt,163697,164021,324,5,N,N,-,-1,-1
THIRTY.txt,164022,164603,581,5,N,N,-,-1,-1
THIRTY.txt,164604,165494,890,5,N,N,-,-1,-1
THIRTY.txt,165497,166232,735,5,N,N,-,-1,-1
THIRTY.txt,166235,166809,574,5,N,Y,1438252600776,166233,167088
THIRTY.txt,166810,167262,452,5,N,Y,1438252600776,166233,167088
THIRTY.txt,167263,168327,1064,5,N,N,-,-1,-1
THIRTY.txt,168328,169036,708,5,N,N,-,-1,-1
THIRTY.txt,169036,169876,840,5,N,N,-,-1,-1
THIRTY.txt,169877,171011,1134,5,N,N,-,-1,-1
THIRTY.txt,171012,171921,909,5,N,N,-,-1,-1
THIRTY.txt,171922,172927,1005,5,N,Y,1438253344818,172096,173864
THIRTY.txt,172928,173650,722,5,N,Y,1438253344818,172096,173864
THIRTY.txt,173651,174234,583,5,N,Y,1438253344818,172096,173864
THIRTY.txt,174235,174583,348,5,N,N,-,-1,-1
THIRTY.txt,174586,175205,619,5,N,Y,1438253717853,174584,175030
THIRTY.txt,175208,176134,926,5,N,N,-,-1,-1
THIRTY.txt,176137,177025,888,5,N,N,-,-1,-1
THIRTY.txt,177026,177759,733,5,N,Y,1438259777575,177381,178262
THIRTY.txt,177761,178843,1082,5,N,Y,1438260340275,178702,179144
THIRTY.txt,178844,179472,628,5,N,Y,1438260340275,178702,179144
THIRTY.txt,179474,180682,1208,5,N,Y,1438260662836,180296,180671
THIRTY.txt,180683,181446,763,5,N,N,-,-1,-1
THIRTY.txt,181447,182419,972,5,N,N,-,-1,-1
THIRTY.txt,182420,183782,1362,5,N,Y,1438261222496,182454,183438
THIRTY.txt,183785,184502,717,5,N,N,-,-1,-1
THIRTY.txt,184503,185071,568,5,N,N,-,-1,-1
THIRTY.txt,185072,185528,456,5,N,N,-,-1,-1
THIRTY.txt,185529,186162,633,5,N,N,-,-1,-1
THIRTY.txt,186163,186590,427,5,N,N,-,-1,-1
THIRTY.txt,186591,187162,571,5,N,N,-,-1,-1
THIRTY.txt,187163,187674,511,5,N,N,-,-1,-1
THIRTY.txt,187674,188648,974,5,N,N,-,-1,-1
THIRTY.txt,188649,189291,642,5,N,N,-,-1,-1
THIRTY.txt,189292,189675,383,5,N,N,-,-1,-1
THIRTY.txt,189677,190263,586,5,N,N,-,-1,-1
THIRTY.txt,190264,190754,490,5,N,N,-,-1,-1
THIRTY.txt,190755,191221,466,5,N,N,-,-1,-1
THIRTY.txt,191222,191774,552,5,N,N,-,-1,-1
THIRTY.txt,191775,192226,451,5,N,N,-,-1,-1
THIRTY.txt,192227,192699,472,5,N,N,-,-1,-1
THIRTY.txt,192700,193471,771,5,N,N,-,-1,-1
THIRTY.txt,193472,193945,473,5,N,N,-,-1,-1
THIRTY.txt,193946,194694,748,5,Y,N,-,-1,-1
THIRTY.txt,194695,195109,414,5,N,N,-,-1,-1
THIRTY.txt,195110,195561,451,5,Y,N,-,-1,-1
THIRTY.txt,195561,196230,669,5,N,N,-,-1,-1
THIRTY.txt,196231,196697,466,5,N,N,-,-1,-1
THIRTY.txt,196697,197380,683,5,N,N,-,-1,-1
THIRTY.txt,197381,197986,605,5,N,N,-,-1,-1
THIRTY.txt,197987,198950,963,5,N,N,-,-1,-1
THIRTY.txt,198951,200233,1282,5,N,N,-,-1,-1
THIRTY.txt,200234,200701,467,5,N,N,-,-1,-1
THIRTY.txt,200702,201355,653,5,N,N,-,-1,-1
THIRTY.txt,201357,202059,702,5,N,N,-,-1,-1
THIRTY.txt,202062,202806,744,5,N,Y,1438261922656,202060,202369
THIRTY.txt,202808,203362,554,5,N,Y,1438262221763,203293,203654
THIRTY.txt,203363,204054,691,5,N,Y,1438262221763,203293,203654
THIRTY.txt,204056,204583,527,5,N,N,-,-1,-1
THIRTY.txt,204586,205057,471,5,N,N,-,-1,-1
THIRTY.txt,205060,205684,624,5,N,N,-,-1,-1
THIRTY.txt,205685,206549,864,5,N,N,-,-1,-1
THIRTY.txt,206552,207223,671,5,N,N,-,-1,-1
THIRTY.txt,207224,208075,851,5,N,N,-,-1,-1
THIRTY.txt,208076,209113,1037,5,N,N,-,-1,-1
THIRTY.txt,209114,210135,1021,5,N,Y,1438262649189,209904,210317
THIRTY.txt,210136,211074,938,5,N,Y,1438262649189,209904,210317
THIRTY.txt,211076,211837,761,5,N,Y,1438262963296,210744,211823
THIRTY.txt,211840,212562,722,5,N,Y,1438263571731,212203,213237
THIRTY.txt,212563,213491,928,5,N,Y,1438263571731,212203,213237
THIRTY.txt,213492,214290,798,5,N,Y,1438263912656,213329,214672
THIRTY.txt,214291,214841,550,5,N,Y,1438264301777,214763,216915
THIRTY.txt,214842,215500,658,5,N,Y,1438264301777,214763,216915
THIRTY.txt,215501,216110,609,5,N,Y,1438264301777,214763,216915
THIRTY.txt,216111,217072,961,5,N,Y,1438264301777,214763,216915
THIRTY.txt,217073,218099,1026,5,N,N,-,-1,-1
THIRTY.txt,218100,218974,874,5,N,N,-,-1,-1
THIRTY.txt,218977,219744,767,5,N,Y,1438264789808,219545,219984
THIRTY.txt,219745,220564,819,5,N,Y,1438265344157,220057,220486
THIRTY.txt,220565,221511,946,5,N,N,-,-1,-1
THIRTY.txt,221514,222116,602,5,N,N,-,-1,-1
THIRTY.txt,222119,222994,875,5,N,N,-,-1,-1
THIRTY.txt,222995,223749,754,5,N,N,-,-1,-1
THIRTY.txt,223750,224636,886,5,N,N,-,-1,-1
THIRTY.txt,224639,225160,521,5,N,N,-,-1,-1
THIRTY.txt,225160,225932,772,5,N,N,-,-1,-1
THIRTY.txt,225933,226781,848,5,N,N,-,-1,-1
THIRTY.txt,226783,227769,986,5,N,N,-,-1,-1
THIRTY.txt,227771,228582,811,5,N,Y,1438266059280,228002,229500
THIRTY.txt,228583,229501,918,5,N,Y,1438266059280,228002,229500
THIRTY.txt,229504,230242,738,5,N,N,-,-1,-1
THIRTY.txt,230247,230711,464,5,N,N,-,-1,-1
THIRTY.txt,230712,231261,549,5,N,N,-,-1,-1
THIRTY.txt,231262,231581,319,5,N,N,-,-1,-1
THIRTY.txt,231584,232206,622,5,N,N,-,-1,-1
THIRTY.txt,232207,232819,612,5,N,N,-,-1,-1
THIRTY.txt,232820,233666,846,5,N,N,-,-1,-1
THIRTY.txt,233667,234286,619,5,N,N,-,-1,-1
THIRTY.txt,234287,234634,347,5,N,N,-,-1,-1
THIRTY.txt,234635,235830,1195,5,N,N,-,-1,-1
THIRTY.txt,235831,236603,772,5,N,N,-,-1,-1
THIRTY.txt,236604,237062,458,5,N,N,-,-1,-1
THIRTY.txt,237062,237879,817,5,N,N,-,-1,-1
THIRTY.txt,237880,238632,752,5,N,N,-,-1,-1
THIRTY.txt,238633,239317,684,5,N,N,-,-1,-1
THIRTY.txt,239320,239760,440,5,N,N,-,-1,-1
THIRTY.txt,239761,240365,604,5,N,N,-,-1,-1
THIRTY.txt,240366,240992,626,5,N,N,-,-1,-1
THIRTY.txt,240993,241865,872,5,N,N,-,-1,-1
THIRTY.txt,241866,242327,461,5,N,N,-,-1,-1
THIRTY.txt,242328,242652,324,5,N,N,-,-1,-1
THIRTY.txt,242653,243284,631,5,N,N,-,-1,-1
THIRTY.txt,243285,244302,1017,5,N,N,-,-1,-1
THIRTY.txt,244303,245222,919,5,N,N,-,-1,-1
THIRTY.txt,245223,245863,640,5,N,N,-,-1,-1
THIRTY.txt,245864,246497,633,5,N,N,-,-1,-1
THIRTY.txt,246500,247047,547,5,N,N,-,-1,-1
THIRTY.txt,247050,247744,694,5,N,N,-,-1,-1
THIRTY.txt,247747,248265,518,5,N,N,-,-1,-1
THIRTY.txt,248266,248779,513,5,N,N,-,-1,-1
THIRTY.txt,248780,249258,478,5,N,N,-,-1,-1
THIRTY.txt,249259,249725,466,5,N,N,-,-1,-1
THIRTY.txt,249726,250102,376,5,N,N,-,-1,-1
THIRTY.txt,250104,250901,797,5,N,N,-,-1,-1
THIRTY.txt,250904,251653,749,5,N,Y,1438423300058,250954,251876
THIRTY.txt,251654,252274,620,5,N,Y,1438423300058,250954,251876
THIRTY.txt,252275,252968,693,5,N,N,-,-1,-1
THIRTY.txt,252969,253923,954,5,N,N,-,-1,-1
THIRTY.txt,253924,254961,1037,5,N,N,-,-1,-1
THIRTY.txt,254962,255914,952,5,N,N,-,-1,-1
THIRTY.txt,255915,256760,845,5,N,N,-,-1,-1
THIRTY.txt,256763,257467,704,5,N,Y,1438423663362,256945,257426
THIRTY.txt,257468,258558,1090,5,N,N,-,-1,-1
THIRTY.txt,258559,259296,737,5,N,N,-,-1,-1
THIRTY.txt,259297,260155,858,5,N,N,-,-1,-1
THIRTY.txt,260157,261204,1047,5,N,Y,1438424184434,260766,262372
THIRTY.txt,261206,261733,527,5,N,Y,1438424184434,260766,262372
THIRTY.txt,261734,262498,764,5,N,Y,1438424184434,260766,262372
THIRTY.txt,262499,262904,405,5,N,N,-,-1,-1
THIRTY.txt,262905,263382,477,5,N,N,-,-1,-1
THIRTY.txt,263383,263701,318,5,N,N,-,-1,-1
THIRTY.txt,263702,264278,576,5,N,N,-,-1,-1
THIRTY.txt,264279,264856,577,5,N,N,-,-1,-1
THIRTY.txt,264857,265503,646,5,N,N,-,-1,-1
THIRTY.txt,265504,266214,710,5,N,N,-,-1,-1
THIRTY.txt,266217,267085,868,5,N,N,-,-1,-1
THIRTY.txt,267088,267554,466,5,N,N,-,-1,-1
THIRTY.txt,267555,268213,658,5,N,N,-,-1,-1
THIRTY.txt,268218,268672,454,5,N,N,-,-1,-1
THIRTY.txt,268673,269539,866,5,N,N,-,-1,-1
THIRTY.txt,269540,270331,791,5,N,N,-,-1,-1
THIRTY.txt,270336,271318,982,5,N,N,-,-1,-1
THIRTY.txt,271320,272338,1018,5,N,N,-,-1,-1
THIRTY.txt,272339,273200,861,5,N,N,-,-1,-1
THIRTY.txt,273200,274322,1122,5,N,N,-,-1,-1
THIRTY.txt,274323,275130,807,5,N,Y,1438425910414,274750,276774
THIRTY.txt,275131,275892,761,5,N,Y,1438425910414,274750,276774
THIRTY.txt,275893,276728,835,5,N,Y,1438425910414,274750,276774
THIRTY.txt,276729,277743,1014,5,N,Y,1438425910414,274750,276774
THIRTY.txt,277744,278408,664,5,N,Y,1438426336365,278251,279327
THIRTY.txt,278409,279331,922,5,N,Y,1438426336365,278251,279327
THIRTY.txt,279334,279940,606,5,N,N,-,-1,-1
THIRTY.txt,279942,280484,542,5,N,N,-,-1,-1
THIRTY.txt,280485,281174,689,5,N,N,-,-1,-1
THIRTY.txt,281177,281744,567,5,N,Y,1438426775375,281224,282800
THIRTY.txt,281745,282704,959,5,N,Y,1438426775375,281224,282800
THIRTY.txt,282705,283772,1067,5,N,Y,1438426775375,281224,282800
THIRTY.txt,283774,284834,1060,5,N,N,-,-1,-1
THIRTY.txt,284835,285393,558,5,N,N,-,-1,-1
THIRTY.txt,285394,286138,744,5,N,N,-,-1,-1
THIRTY.txt,286139,286566,427,5,N,N,-,-1,-1
THIRTY.txt,286571,287313,742,5,N,Y,1438427296305,286896,287713
THIRTY.txt,287316,287762,446,5,N,Y,1438427296305,286896,287713
THIRTY.txt,287765,288637,872,5,N,N,-,-1,-1
THIRTY.txt,288638,289198,560,5,N,N,-,-1,-1
THIRTY.txt,289199,289886,687,5,N,N,-,-1,-1
THIRTY.txt,289887,290385,498,5,N,N,-,-1,-1
THIRTY.txt,290385,291627,1242,5,N,N,-,-1,-1
THIRTY.txt,291628,292298,670,5,N,N,-,-1,-1
THIRTY.txt,292299,292845,546,5,N,N,-,-1,-1
THIRTY.txt,292847,293217,370,5,N,N,-,-1,-1
THIRTY.txt,293218,293691,473,5,N,N,-,-1,-1
THIRTY.txt,293694,294463,769,5,N,N,-,-1,-1
THIRTY.txt,294465,295067,602,5,N,N,-,-1,-1
THIRTY.txt,295068,295929,861,5,N,N,-,-1,-1
THIRTY.txt,295930,296220,290,5,N,N,-,-1,-1
THIRTY.txt,296223,297314,1091,5,N,N,-,-1,-1
THIRTY.txt,297319,298465,1146,5,N,N,-,-1,-1
THIRTY.txt,298466,299286,820,5,N,N,-,-1,-1
THIRTY.txt,299288,300143,855,5,Y,N,-,-1,-1
THIRTY.txt,300144,300848,704,5,N,N,-,-1,-1
THIRTY.txt,300849,301643,794,5,N,Y,1438427933753,301337,301636
THIRTY.txt,301644,302435,791,5,N,N,-,-1,-1
THIRTY.txt,302438,303245,807,5,N,Y,1438428449081,302448,305774
THIRTY.txt,303246,304119,873,5,N,Y,1438428449081,302448,305774
THIRTY.txt,304120,305061,941,5,N,Y,1438428449081,302448,305774
THIRTY.txt,305062,305875,813,5,N,Y,1438428449081,302448,305774
THIRTY.txt,305876,306320,444,5,N,Y,1438436113840,305935,306928
THIRTY.txt,306321,307109,788,5,N,Y,1438436113840,305935,306928
THIRTY.txt,307111,307910,799,5,N,N,-,-1,-1
THIRTY.txt,307911,308448,537,5,N,N,-,-1,-1
THIRTY.txt,308449,309146,697,5,N,N,-,-1,-1
THIRTY.txt,309147,310114,967,5,N,N,-,-1,-1
THIRTY.txt,310115,311090,975,5,N,N,-,-1,-1
THIRTY.txt,311093,311949,856,5,N,N,-,-1,-1
THIRTY.txt,311952,312453,501,5,N,N,-,-1,-1
THIRTY.txt,312454,313048,594,5,N,N,-,-1,-1
THIRTY.txt,313051,313668,617,5,N,N,-,-1,-1
THIRTY.txt,313669,314650,981,5,N,Y,1438436621227,314360,314649
THIRTY.txt,314651,315307,656,5,N,Y,1438436987445,314654,315248
THIRTY.txt,315308,316287,979,5,N,N,-,-1,-1
THIRTY.txt,316288,317130,842,5,N,Y,1438437740936,316545,317774
THIRTY.txt,317131,318366,1235,5,N,Y,1438437740936,316545,317774
THIRTY.txt,318367,319231,864,5,N,Y,1438438056880,318703,319615
THIRTY.txt,319232,320101,869,5,N,Y,1438438056880,318703,319615
THIRTY.txt,320102,320699,597,5,N,N,-,-1,-1
THIRTY.txt,320702,321694,992,5,N,N,-,-1,-1
THIRTY.txt,321695,322266,571,5,N,N,-,-1,-1
THIRTY.txt,322267,323439,1172,5,N,N,-,-1,-1
THIRTY.txt,323442,323962,520,5,N,N,-,-1,-1
THIRTY.txt,323963,324693,730,5,N,N,-,-1,-1
THIRTY.txt,324694,325336,642,5,N,N,-,-1,-1
THIRTY.txt,325337,325772,435,5,N,N,-,-1,-1
THIRTY.txt,325773,326681,908,5,N,Y,1438438506460,326211,326819
THIRTY.txt,326682,327494,812,5,N,Y,1438438506460,326211,326819
THIRTY.txt,327500,328130,630,5,N,Y,1438442320678,327770,328126
THIRTY.txt,328135,329108,973,5,N,N,-,-1,-1
THIRTY.txt,329110,329900,790,5,N,N,-,-1,-1
THIRTY.txt,329901,330547,646,5,N,Y,1438442848699,330488,331687
THIRTY.txt,330548,331477,929,5,N,Y,1438442848699,330488,331687
THIRTY.txt,331478,332226,748,5,N,Y,1438442848699,330488,331687
THIRTY.txt,332227,332983,756,5,N,N,-,-1,-1
THIRTY.txt,332984,333911,927,5,N,N,-,-1,-1
THIRTY.txt,333914,334395,481,5,N,N,-,-1,-1
THIRTY.txt,334396,334844,448,5,N,N,-,-1,-1
THIRTY.txt,334847,335620,773,5,N,Y,1438443458585,334890,335870
THIRTY.txt,335621,336598,977,5,N,Y,1438443458585,334890,335870
THIRTY.txt,336599,337157,558,5,N,Y,1438443842388,336005,338631
THIRTY.txt,337158,337846,688,5,N,Y,1438443842388,336005,338631
THIRTY.txt,337847,338418,571,5,N,Y,1438443842388,336005,338631
THIRTY.txt,338419,339156,737,5,N,Y,1438443842388,336005,338631
THIRTY.txt,339156,340019,863,5,N,Y,1438444169457,339222,340309
THIRTY.txt,340020,341139,1119,5,N,Y,1438444169457,339222,340309
THIRTY.txt,341140,342076,936,5,N,N,-,-1,-1
THIRTY.txt,342077,343013,936,5,N,N,-,-1,-1
THIRTY.txt,343016,343786,770,5,N,N,-,-1,-1
THIRTY.txt,343789,344607,818,5,N,Y,1438444885260,343875,346542
THIRTY.txt,344608,345419,811,5,N,Y,1438444885260,343875,346542
THIRTY.txt,345420,346217,797,5,N,Y,1438444885260,343875,346542
THIRTY.txt,346218,346913,695,5,N,Y,1438444885260,343875,346542
THIRTY.txt,346914,347695,781,5,N,Y,1438445209833,347185,347720
THIRTY.txt,347696,348614,918,5,N,Y,1438445991237,347950,348352
THIRTY.txt,348614,349240,626,5,N,N,-,-1,-1
THIRTY.txt,349241,350306,1065,5,N,N,-,-1,-1
THIRTY.txt,350307,351179,872,5,N,N,-,-1,-1
THIRTY.txt,351180,352026,846,5,N,Y,1438446807342,351574,353976
THIRTY.txt,352027,352698,671,5,N,Y,1438446807342,351574,353976
THIRTY.txt,352699,353192,493,5,N,Y,1438446807342,351574,353976
THIRTY.txt,353195,353662,467,5,N,Y,1438446807342,351574,353976
THIRTY.txt,353663,354253,590,5,N,Y,1438446807342,351574,353976
THIRTY.txt,354253,355352,1099,5,N,N,-,-1,-1
THIRTY.txt,355354,356423,1069,5,N,N,-,-1,-1
THIRTY.txt,356424,357762,1338,5,N,N,-,-1,-1
THIRTY.txt,357763,358473,710,5,N,N,-,-1,-1
THIRTY.txt,358475,359278,803,5,N,N,-,-1,-1
THIRTY.txt,359279,359663,384,5,N,N,-,-1,-1
THIRTY.txt,359664,360691,1027,5,N,N,-,-1,-1
THIRTY.txt,360693,361320,627,5,N,N,-,-1,-1
THIRTY.txt,361323,362035,712,5,N,N,-,-1,-1
THIRTY.txt,362036,362783,747,5,N,N,-,-1,-1
THIRTY.txt,362788,363413,625,5,N,N,-,-1,-1
THIRTY.txt,363414,364207,793,5,N,N,-,-1,-1
THIRTY.txt,364208,364876,668,5,N,N,-,-1,-1
THIRTY.txt,364877,365407,530,5,N,N,-,-1,-1
THIRTY.txt,365408,366044,636,5,N,N,-,-1,-1
THIRTY.txt,366047,366463,416,5,N,N,-,-1,-1
THIRTY.txt,366464,366999,535,5,N,N,-,-1,-1
THIRTY.txt,367000,367842,842,5,N,N,-,-1,-1
THIRTY.txt,367845,368328,483,5,N,N,-,-1,-1
THIRTY.txt,368331,369373,1042,5,N,N,-,-1,-1
THIRTY.txt,369376,370356,980,5,N,Y,1438447751146,369829,370680
THIRTY.txt,370358,371520,1162,5,N,Y,1438447751146,369829,370680
THIRTY.txt,371521,372307,786,5,N,N,-,-1,-1
THIRTY.txt,372308,373094,786,5,N,Y,1438448043481,372740,373741
THIRTY.txt,373095,373761,666,5,N,Y,1438448043481,372740,373741
THIRTY.txt,373764,374418,654,5,N,N,-,-1,-1
THIRTY.txt,374421,375102,681,5,N,N,-,-1,-1
THIRTY.txt,375102,375954,852,5,N,N,-,-1,-1
THIRTY.txt,375959,376525,566,5,N,N,-,-1,-1
THIRTY.txt,376526,377068,542,5,Y,N,-,-1,-1
THIRTY.txt,377069,377990,921,5,N,N,-,-1,-1
THIRTY.txt,377991,379058,1067,5,N,N,-,-1,-1
THIRTY.txt,379059,380086,1027,5,N,N,-,-1,-1
THIRTY.txt,380087,380709,622,5,N,N,-,-1,-1
THIRTY.txt,380710,381758,1048,5,N,N,-,-1,-1
THIRTY.txt,381759,382080,321,5,N,N,-,-1,-1
THIRTY.txt,382081,382394,313,5,N,N,-,-1,-1
THIRTY.txt,382399,383192,793,5,N,N,-,-1,-1
THIRTY.txt,383194,384119,925,5,N,N,-,-1,-1
THIRTY.txt,384124,384708,584,5,N,N,-,-1,-1
THIRTY.txt,384709,385348,639,5,N,N,-,-1,-1
THIRTY.txt,385349,386210,861,5,N,N,-,-1,-1
THIRTY.txt,386211,387148,937,5,N,N,-,-1,-1
THIRTY.txt,387149,387802,653,5,N,N,-,-1,-1
THIRTY.txt,387804,388198,394,5,N,N,-,-1,-1
THIRTY.txt,388199,388912,713,5,N,N,-,-1,-1
THIRTY.txt,388913,389956,1043,5,N,N,-,-1,-1
THIRTY.txt,389958,391009,1051,5,N,N,-,-1,-1
THIRTY.txt,391012,391577,565,5,N,N,-,-1,-1
THIRTY.txt,391581,392251,670,5,N,N,-,-1,-1
THIRTY.txt,392252,392739,487,5,N,Y,1438520691591,392603,394020
THIRTY.txt,392741,393289,548,5,N,Y,1438520691591,392603,394020
THIRTY.txt,393294,393862,568,5,N,Y,1438520691591,392603,394020
THIRTY.txt,393862,394451,589,5,N,Y,1438520691591,392603,394020
THIRTY.txt,394452,395668,1216,5,N,Y,1438521312859,395053,395651
THIRTY.txt,395671,396613,942,5,N,Y,1438521743713,395976,397187
THIRTY.txt,396613,397591,978,5,N,Y,1438521743713,395976,397187
THIRTY.txt,397592,398462,870,5,N,Y,1438522094902,397281,398089
THIRTY.txt,398464,399276,812,5,N,N,-,-1,-1
THIRTY.txt,399277,399748,471,5,N,N,-,-1,-1
THIRTY.txt,399749,400176,427,5,N,Y,1438522453832,399958,400307
THIRTY.txt,400177,400687,510,5,N,Y,1438522453832,399958,400307
THIRTY.txt,400688,401226,538,5,N,N,-,-1,-1
THIRTY.txt,401227,401805,578,5,N,N,-,-1,-1
THIRTY.txt,401806,402737,931,5,Y,N,-,-1,-1
THIRTY.txt,402738,403333,595,5,N,N,-,-1,-1
THIRTY.txt,403334,403988,654,5,N,N,-,-1,-1
THIRTY.txt,403988,404916,928,5,N,N,-,-1,-1
THIRTY.txt,404918,405598,680,5,N,N,-,-1,-1
THIRTY.txt,405599,406523,924,5,N,N,-,-1,-1
THIRTY.txt,406525,407081,556,5,N,N,-,-1,-1
THIRTY.txt,407082,408007,925,5,N,Y,1438523309595,407082,408026
THIRTY.txt,408008,408767,759,5,N,Y,1438523309595,407082,408026
THIRTY.txt,408769,409188,419,5,N,N,-,-1,-1
THIRTY.txt,409189,409613,424,5,N,N,-,-1,-1
THIRTY.txt,409614,409982,368,5,N,N,-,-1,-1
THIRTY.txt,409985,410399,414,5,N,N,-,-1,-1
THIRTY.txt,410400,411890,1490,5,N,N,-,-1,-1
THIRTY.txt,411891,412763,872,5,N,Y,1438524170239,412054,412585
THIRTY.txt,412764,413539,775,5,N,N,-,-1,-1
THIRTY.txt,413540,414397,857,5,N,Y,1438524762496,413657,414319
THIRTY.txt,414400,415432,1032,5,N,N,-,-1,-1
THIRTY.txt,415437,416175,738,5,N,N,-,-1,-1
THIRTY.txt,416176,417004,828,5,N,N,-,-1,-1
THIRTY.txt,417009,417725,716,5,N,N,-,-1,-1
THIRTY.txt,417726,418421,695,5,N,N,-,-1,-1
THIRTY.txt,418422,419027,605,5,N,N,-,-1,-1
THIRTY.txt,419028,419631,603,5,N,Y,1438525236574,419169,419622
THIRTY.txt,419632,420378,746,5,N,Y,1438525660625,420215,421606
THIRTY.txt,420378,421196,818,5,N,Y,1438525660625,420215,421606
THIRTY.txt,421197,421635,438,5,N,Y,1438525660625,420215,421606
THIRTY.txt,421640,422707,1067,5,N,Y,1438525989298,421681,422296
THIRTY.txt,422707,423297,590,5,N,N,-,-1,-1
THIRTY.txt,423298,424645,1347,5,N,N,-,-1,-1
THIRTY.txt,424646,425292,646,5,N,N,-,-1,-1
THIRTY.txt,425293,426255,962,5,N,N,-,-1,-1
THIRTY.txt,426256,426881,625,5,N,N,-,-1,-1
THIRTY.txt,426882,427794,912,5,N,Y,1438526435174,427361,428109
THIRTY.txt,427795,428829,1034,5,N,Y,1438526435174,427361,428109
THIRTY.txt,428830,430111,1281,5,N,N,-,-1,-1
THIRTY.txt,430112,431123,1011,5,N,N,-,-1,-1
THIRTY.txt,431126,432540,1414,5,N,N,-,-1,-1
THIRTY.txt,432541,433610,1069,5,N,N,-,-1,-1
THIRTY.txt,433611,434462,851,5,N,N,-,-1,-1
THIRTY.txt,434463,435466,1003,5,N,N,-,-1,-1
THIRTY.txt,435467,436245,778,5,N,Y,1438527042090,435881,437111
THIRTY.txt,436246,437304,1058,5,N,Y,1438527042090,435881,437111
THIRTY.txt,437305,438227,922,5,Y,Y,1438527366609,437721,438431
THIRTY.txt,438229,438989,760,5,N,Y,1438527366609,437721,438431
THIRTY.txt,438992,439627,635,5,N,Y,1438532103693,439032,440498
THIRTY.txt,439628,440432,804,5,N,Y,1438532103693,439032,440498
THIRTY.txt,440433,441510,1077,5,N,Y,1438532103693,439032,440498
THIRTY.txt,441511,442452,941,5,N,N,-,-1,-1
THIRTY.txt,442454,443218,764,5,N,N,-,-1,-1
THIRTY.txt,443219,444086,867,5,N,N,-,-1,-1
THIRTY.txt,444087,444784,697,5,N,N,-,-1,-1
THIRTY.txt,444785,445559,774,5,N,N,-,-1,-1
THIRTY.txt,445562,445868,306,5,N,N,-,-1,-1
THIRTY.txt,445869,446362,493,5,N,N,-,-1,-1
THIRTY.txt,446363,447076,713,5,N,Y,1438532730981,446979,448516
THIRTY.txt,447077,447836,759,5,N,Y,1438532730981,446979,448516
THIRTY.txt,447837,448585,748,5,N,Y,1438532730981,446979,448516
THIRTY.txt,448586,449365,779,5,N,Y,1438533206356,448586,449872
THIRTY.txt,449368,450616,1248,5,N,Y,1438533206356,448586,449872
THIRTY.txt,450617,451439,822,5,N,N,-,-1,-1
THIRTY.txt,451440,451957,517,5,N,N,-,-1,-1
THIRTY.txt,451960,452631,671,5,N,N,-,-1,-1
THIRTY.txt,452633,453310,677,5,N,N,-,-1,-1
THIRTY.txt,453313,453680,367,5,N,N,-,-1,-1
THIRTY.txt,453681,454486,805,5,N,N,-,-1,-1
THIRTY.txt,454487,455401,914,5,Y,N,-,-1,-1
THIRTY.txt,455404,456352,948,5,N,N,-,-1,-1
THIRTY.txt,456353,457773,1420,5,N,Y,1438533757046,457288,458186
THIRTY.txt,457774,458539,765,5,Y,Y,1438533757046,457288,458186
THIRTY.txt,458540,459616,1076,5,N,N,-,-1,-1
THIRTY.txt,459617,461041,1424,5,N,N,-,-1,-1
THIRTY.txt,461042,462170,1128,5,N,N,-,-1,-1
THIRTY.txt,462170,463334,1164,5,N,N,-,-1,-1
THIRTY.txt,463335,464178,843,5,N,Y,1438534266920,463977,464515
THIRTY.txt,464179,464828,649,5,N,Y,1438534266920,463977,464515
THIRTY.txt,464833,465772,939,5,N,N,-,-1,-1
THIRTY.txt,465774,466934,1160,5,N,N,-,-1,-1
THIRTY.txt,466937,467621,684,5,N,N,-,-1,-1
THIRTY.txt,467622,468440,818,5,N,N,-,-1,-1
THIRTY.txt,468441,469460,1019,5,N,N,-,-1,-1
THIRTY.txt,469461,470291,830,5,N,N,-,-1,-1
THIRTY.txt,470293,470857,564,5,N,N,-,-1,-1
THIRTY.txt,470858,471717,859,5,N,N,-,-1,-1
THIRTY.txt,471720,472442,722,5,N,Y,1438535069627,471751,472764
THIRTY.txt,472443,473588,1145,5,N,Y,1438589777282,472848,474072
THIRTY.txt,473589,474381,792,5,N,Y,1438589777282,472848,474072
THIRTY.txt,474382,475069,687,5,N,Y,1438590330949,474159,475584
THIRTY.txt,475070,475613,543,5,N,Y,1438590330949,474159,475584
THIRTY.txt,475613,476543,930,5,N,N,-,-1,-1
THIRTY.txt,476544,477326,782,5,N,N,-,-1,-1
THIRTY.txt,477327,478102,775,5,N,N,-,-1,-1
THIRTY.txt,478104,478884,780,5,N,N,-,-1,-1
THIRTY.txt,478887,479479,592,5,N,Y,1438591228595,478885,480708
THIRTY.txt,479480,480114,634,5,N,Y,1438591228595,478885,480708
THIRTY.txt,480115,480476,361,5,N,Y,1438591228595,478885,480708
THIRTY.txt,480479,481357,878,5,N,Y,1438591228595,478885,480708
THIRTY.txt,481358,482315,957,5,N,N,-,-1,-1
THIRTY.txt,482316,483292,976,5,N,Y,1438591711956,482503,483088
THIRTY.txt,483293,484336,1043,5,N,Y,1438592214311,484044,484590
THIRTY.txt,484337,485320,983,5,N,Y,1438592530594,484631,485560
THIRTY.txt,485322,486465,1143,5,N,Y,1438592530594,484631,485560
THIRTY.txt,486468,487271,803,5,N,N,-,-1,-1
THIRTY.txt,487272,487907,635,5,N,N,-,-1,-1
THIRTY.txt,487908,488778,870,5,N,N,-,-1,-1
THIRTY.txt,488779,489263,484,5,N,Y,1438592996577,488903,489682
THIRTY.txt,489264,489770,506,5,N,Y,1438592996577,488903,489682
THIRTY.txt,489771,490868,1097,5,N,Y,1438593512176,489782,492138
THIRTY.txt,490869,491700,831,5,N,Y,1438593512176,489782,492138
THIRTY.txt,491701,492558,857,5,N,Y,1438593512176,489782,492138
THIRTY.txt,492559,493175,616,5,N,N,-,-1,-1
THIRTY.txt,493176,493671,495,5,N,N,-,-1,-1
THIRTY.txt,493672,494432,760,5,N,N,-,-1,-1
THIRTY.txt,494433,495135,702,5,N,N,-,-1,-1
THIRTY.txt,495136,495992,856,5,N,N,-,-1,-1
THIRTY.txt,495993,497168,1175,5,N,N,-,-1,-1
THIRTY.txt,497169,497976,807,5,N,N,-,-1,-1
THIRTY.txt,497977,498907,930,5,N,Y,1438594174047,498899,500136
THIRTY.txt,498908,499748,840,5,N,Y,1438594174047,498899,500136
THIRTY.txt,499749,500873,1124,5,N,Y,1438594174047,498899,500136
THIRTY.txt,500874,502359,1485,5,N,Y,1438596375620,500735,501901
THIRTY.txt,502360,503220,860,5,N,N,-,-1,-1
THIRTY.txt,503221,504005,784,5,N,N,-,-1,-1
THIRTY.txt,504006,505073,1067,5,N,N,-,-1,-1
THIRTY.txt,505076,505902,826,5,N,Y,1438596889671,505129,506172
THIRTY.txt,505903,506755,852,5,N,Y,1438596889671,505129,506172
THIRTY.txt,506758,507677,919,5,N,N,-,-1,-1
THIRTY.txt,507679,508290,611,5,N,N,-,-1,-1
THIRTY.txt,508291,509266,975,5,N,N,-,-1,-1
THIRTY.txt,509267,510466,1199,5,N,N,-,-1,-1
THIRTY.txt,510467,511285,818,5,N,N,-,-1,-1
THIRTY.txt,511286,512170,884,5,N,Y,1438597622333,511659,513933
THIRTY.txt,512173,512787,614,5,N,Y,1438597622333,511659,513933
THIRTY.txt,512788,514037,1249,5,N,Y,1438597622333,511659,513933
THIRTY.txt,514040,514568,528,5,N,N,-,-1,-1
THIRTY.txt,514569,515284,715,5,N,N,-,-1,-1
THIRTY.txt,515285,516064,779,5,N,N,-,-1,-1
THIRTY.txt,516066,516981,915,5,N,N,-,-1,-1
THIRTY.txt,516982,517750,768,5,N,N,-,-1,-1
THIRTY.txt,517753,518342,589,5,N,N,-,-1,-1
THIRTY.txt,518344,519274,930,5,N,N,-,-1,-1
THIRTY.txt,519275,519966,691,5,N,Y,1438598288957,519286,519820
THIRTY.txt,519967,520772,805,5,N,N,-,-1,-1
THIRTY.txt,520773,521635,862,5,N,N,-,-1,-1
THIRTY.txt,521636,522470,834,5,N,Y,1438598938260,522322,523335
THIRTY.txt,522471,523344,873,5,N,Y,1438598938260,522322,523335
THIRTY.txt,523345,524720,1375,5,Y,N,-,-1,-1
THIRTY.txt,524721,525929,1208,5,N,Y,1438599418291,525144,526021
THIRTY.txt,525930,526663,733,5,N,Y,1438599418291,525144,526021
THIRTY.txt,526664,527021,357,5,N,N,-,-1,-1
THIRTY.txt,527022,527236,214,5,N,N,-,-1,-1
THIRTY.txt,527237,527895,658,5,N,N,-,-1,-1
THIRTY.txt,527896,529188,1292,5,N,N,-,-1,-1
THIRTY.txt,529189,529779,590,5,N,Y,1438599831167,529511,530072
THIRTY.txt,529780,530553,773,5,N,Y,1438599831167,529511,530072
THIRTY.txt,530554,531108,554,5,N,N,-,-1,-1
THIRTY.txt,531109,531939,830,5,N,N,-,-1,-1
THIRTY.txt,531940,532792,852,5,N,N,-,-1,-1
THIRTY.txt,532793,533135,342,5,N,N,-,-1,-1
THIRTY.txt,533140,533916,776,5,N,N,-,-1,-1
THIRTY.txt,533917,535100,1183,5,Y,Y,1438600198307,534335,534790
THIRTY.txt,535101,536040,939,5,N,N,-,-1,-1
THIRTY.txt,536041,537134,1093,5,N,N,-,-1,-1
THIRTY.txt,537135,538675,1540,5,N,N,-,-1,-1
THIRTY.txt,538676,539527,851,5,N,N,-,-1,-1
THIRTY.txt,539532,540397,865,5,N,N,-,-1,-1
THIRTY.txt,540398,543587,3189,5,N,N,-,-1,-1
THIRTY.txt,543588,545939,2351,5,N,N,-,-1,-1
THIRTY.txt,545940,556923,10983,5,N,N,-,-1,-1
THIRTY.txt,556924,559079,2155,5,N,N,-,-1,-1
THIRTY.txt,559080,570720,11640,5,N,N,-,-1,-1
THIRTY.txt,570722,575368,4646,5,N,N,-,-1,-1
TWOMEN.txt,2,1592,1590,5,N,N,-,-1,-1
TWOMEN.txt,1593,3380,1787,5,N,N,-,-1,-1
TWOMEN.txt,3381,4501,1120,5,N,N,-,-1,-1
TWOMEN.txt,4506,4697,191,5,N,N,-,-1,-1
TWOMEN.txt,4698,4908,210,5,N,N,-,-1,-1
TWOMEN.txt,4909,5059,150,5,N,N,-,-1,-1
TWOMEN.txt,5061,5274,213,5,N,N,-,-1,-1
TWOMEN.txt,5276,5784,508,5,N,N,-,-1,-1
TWOMEN.txt,5785,6776,991,5,N,N,-,-1,-1
TWOMEN.txt,6777,7601,824,5,N,N,-,-1,-1
TWOMEN.txt,7603,8367,764,5,N,N,-,-1,-1
TWOMEN.txt,8368,8865,497,5,N,N,-,-1,-1
TWOMEN.txt,8867,9768,901,5,N,N,-,-1,-1
TWOMEN.txt,9770,10749,979,5,N,Y,1433438168945,10115,10944
TWOMEN.txt,10750,11543,793,5,N,Y,1433438168945,10115,10944
TWOMEN.txt,11544,12850,1306,5,N,N,-,-1,-1
TWOMEN.txt,12851,13531,680,5,N,N,-,-1,-1
TWOMEN.txt,13532,14827,1295,5,Y,N,-,-1,-1
TWOMEN.txt,14829,15858,1029,5,N,N,-,-1,-1
TWOMEN.txt,15859,16923,1064,5,N,N,-,-1,-1
TWOMEN.txt,16924,17767,843,5,N,N,-,-1,-1
TWOMEN.txt,17768,18472,704,5,N,N,-,-1,-1
TWOMEN.txt,18473,19850,1377,5,N,N,-,-1,-1
TWOMEN.txt,19851,20202,351,5,N,N,-,-1,-1
TWOMEN.txt,20204,20849,645,5,N,N,-,-1,-1
TWOMEN.txt,20850,21325,475,5,N,N,-,-1,-1
TWOMEN.txt,21326,21813,487,5,N,N,-,-1,-1
TWOMEN.txt,21815,22550,735,5,N,N,-,-1,-1
TWOMEN.txt,22551,23352,801,5,N,N,-,-1,-1
TWOMEN.txt,23354,23802,448,5,N,N,-,-1,-1
TWOMEN.txt,23804,23976,172,5,N,N,-,-1,-1
TWOMEN.txt,23977,24257,280,5,N,N,-,-1,-1
TWOMEN.txt,24258,24446,188,5,N,N,-,-1,-1
TWOMEN.txt,24447,24653,206,5,N,N,-,-1,-1
TWOMEN.txt,24656,25250,594,5,N,N,-,-1,-1
TWOMEN.txt,25251,25601,350,5,N,N,-,-1,-1
TWOMEN.txt,25602,25969,367,5,N,N,-,-1,-1
TWOMEN.txt,25971,26676,705,5,N,N,-,-1,-1
TWOMEN.txt,26677,27672,995,5,N,N,-,-1,-1
TWOMEN.txt,27674,28734,1060,5,N,N,-,-1,-1
TWOMEN.txt,28735,29496,761,5,N,N,-,-1,-1
TWOMEN.txt,29497,30020,523,5,N,N,-,-1,-1
TWOMEN.txt,30020,30150,130,5,N,N,-,-1,-1
TWOMEN.txt,30152,30397,245,5,N,N,-,-1,-1
TWOMEN.txt,30400,30515,115,5,N,N,-,-1,-1
TWOMEN.txt,30516,30616,100,5,N,N,-,-1,-1
TWOMEN.txt,30617,30684,67,5,N,N,-,-1,-1
TWOMEN.txt,30686,31127,441,5,N,N,-,-1,-1
TWOMEN.txt,31129,31397,268,5,N,N,-,-1,-1
TWOMEN.txt,31398,31642,244,5,N,N,-,-1,-1
TWOMEN.txt,31644,31959,315,5,N,N,-,-1,-1
TWOMEN.txt,31960,32022,62,5,N,N,-,-1,-1
TWOMEN.txt,32027,32599,572,5,N,N,-,-1,-1
TWOMEN.txt,32601,32878,277,5,N,N,-,-1,-1
TWOMEN.txt,32879,33201,322,5,N,N,-,-1,-1
TWOMEN.txt,33202,33995,793,5,N,N,-,-1,-1
TWOMEN.txt,33998,34362,364,5,N,N,-,-1,-1
TWOMEN.txt,34364,34638,274,5,N,N,-,-1,-1
TWOMEN.txt,34639,34870,231,5,N,N,-,-1,-1
TWOMEN.txt,34873,35014,141,5,N,N,-,-1,-1
TWOMEN.txt,35016,35312,296,5,N,N,-,-1,-1
TWOMEN.txt,35313,35432,119,5,N,N,-,-1,-1
TWOMEN.txt,35433,35765,332,5,N,N,-,-1,-1
TWOMEN.txt,35766,36003,237,5,N,N,-,-1,-1
TWOMEN.txt,36005,36253,248,5,N,N,-,-1,-1
TWOMEN.txt,36254,36420,166,5,N,N,-,-1,-1
TWOMEN.txt,36421,36904,483,5,N,N,-,-1,-1
TWOMEN.txt,36906,37140,234,5,N,N,-,-1,-1
TWOMEN.txt,37142,37318,176,5,N,N,-,-1,-1
TWOMEN.txt,37319,37674,355,5,N,N,-,-1,-1
TWOMEN.txt,37676,37916,240,5,N,N,-,-1,-1
TWOMEN.txt,37918,38158,240,5,N,N,-,-1,-1
TWOMEN.txt,38160,38760,600,5,N,N,-,-1,-1
TWOMEN.txt,38762,39062,300,5,N,N,-,-1,-1
TWOMEN.txt,39063,40034,971,5,N,N,-,-1,-1
TWOMEN.txt,40035,40974,939,5,N,N,-,-1,-1
TWOMEN.txt,40976,41270,294,5,N,N,-,-1,-1
TWOMEN.txt,41272,41864,592,5,N,N,-,-1,-1
TWOMEN.txt,41865,42190,325,5,N,N,-,-1,-1
TWOMEN.txt,42191,42244,53,5,N,N,-,-1,-1
TWOMEN.txt,42246,42684,438,5,N,N,-,-1,-1
TWOMEN.txt,42685,43176,491,5,N,N,-,-1,-1
TWOMEN.txt,43177,43678,501,5,N,N,-,-1,-1
TWOMEN.txt,43680,43880,200,5,N,N,-,-1,-1
TWOMEN.txt,43883,44316,433,5,N,N,-,-1,-1
TWOMEN.txt,44317,45351,1034,5,N,N,-,-1,-1
TWOMEN.txt,45352,46227,875,5,N,N,-,-1,-1
TWOMEN.txt,46228,47210,982,5,N,N,-,-1,-1
TWOMEN.txt,47212,48438,1226,5,N,N,-,-1,-1
TWOMEN.txt,48440,48869,429,5,N,N,-,-1,-1
TWOMEN.txt,48870,49571,701,5,N,N,-,-1,-1
TWOMEN.txt,49573,49825,252,5,N,N,-,-1,-1
TWOMEN.txt,49827,50139,312,5,N,N,-,-1,-1
TWOMEN.txt,50140,50262,122,5,N,N,-,-1,-1
TWOMEN.txt,50264,50417,153,5,N,N,-,-1,-1
TWOMEN.txt,50418,50652,234,5,N,N,-,-1,-1
TWOMEN.txt,50653,51412,759,5,N,N,-,-1,-1
TWOMEN.txt,51417,52155,738,5,N,N,-,-1,-1
TWOMEN.txt,52156,52697,541,5,N,N,-,-1,-1
TWOMEN.txt,52698,53349,651,5,N,N,-,-1,-1
TWOMEN.txt,53354,55321,1967,5,N,N,-,-1,-1
TWOMEN.txt,55322,56554,1232,5,N,N,-,-1,-1
TWOMEN.txt,56555,57404,849,5,N,N,-,-1,-1
TWOMEN.txt,57405,58347,942,5,N,N,-,-1,-1
TWOMEN.txt,58348,58919,571,5,N,N,-,-1,-1
TWOMEN.txt,58920,59510,590,5,N,N,-,-1,-1
TWOMEN.txt,59511,60321,810,5,N,N,-,-1,-1
TWOMEN.txt,60323,60778,455,5,N,N,-,-1,-1
TWOMEN.txt,60780,60941,161,5,N,N,-,-1,-1
TWOMEN.txt,60943,61188,245,5,N,N,-,-1,-1
TWOMEN.txt,61189,61444,255,5,N,N,-,-1,-1
TWOMEN.txt,61444,61838,394,5,N,N,-,-1,-1
TWOMEN.txt,61840,62150,310,5,N,N,-,-1,-1
TWOMEN.txt,62152,62924,772,5,N,N,-,-1,-1
TWOMEN.txt,62925,63653,728,5,N,N,-,-1,-1
TWOMEN.txt,63654,64639,985,5,N,N,-,-1,-1
TWOMEN.txt,64640,65167,527,5,N,N,-,-1,-1
TWOMEN.txt,65168,65592,424,5,N,N,-,-1,-1
TWOMEN.txt,65594,66427,833,5,N,N,-,-1,-1
TWOMEN.txt,66429,66997,568,5,N,N,-,-1,-1
TWOMEN.txt,66998,67622,624,5,N,N,-,-1,-1
TWOMEN.txt,67622,67949,327,5,N,N,-,-1,-1
TWOMEN.txt,67951,68500,549,5,N,N,-,-1,-1
TWOMEN.txt,68501,68840,339,5,N,N,-,-1,-1
TWOMEN.txt,68841,69619,778,5,N,Y,1435165746603,69147,70419
TWOMEN.txt,69620,70381,761,5,N,Y,1435165746603,69147,70419
TWOMEN.txt,70382,71537,1155,5,N,Y,1435165746603,69147,70419
TWOMEN.txt,71539,72365,826,5,N,N,-,-1,-1
TWOMEN.txt,72366,73010,644,5,N,N,-,-1,-1
TWOMEN.txt,73011,73539,528,5,N,N,-,-1,-1
TWOMEN.txt,73541,74203,662,5,N,N,-,-1,-1
TWOMEN.txt,74204,74838,634,5,N,N,-,-1,-1
TWOMEN.txt,74839,75287,448,5,N,N,-,-1,-1
TWOMEN.txt,75288,75588,300,5,N,N,-,-1,-1
TWOMEN.txt,75589,75979,390,5,N,N,-,-1,-1
TWOMEN.txt,75980,76575,595,5,N,N,-,-1,-1
TWOMEN.txt,76578,76986,408,5,N,N,-,-1,-1
TWOMEN.txt,76987,77480,493,5,N,N,-,-1,-1
TWOMEN.txt,77481,77903,422,5,N,N,-,-1,-1
TWOMEN.txt,77905,78313,408,5,N,N,-,-1,-1
TWOMEN.txt,78314,79056,742,5,N,N,-,-1,-1
TWOMEN.txt,79057,79965,908,5,N,N,-,-1,-1
TWOMEN.txt,79966,80436,470,5,N,N,-,-1,-1
TWOMEN.txt,80438,80799,361,5,N,N,-,-1,-1
TWOMEN.txt,80800,81410,610,5,N,N,-,-1,-1
TWOMEN.txt,81411,81828,417,5,N,N,-,-1,-1
TWOMEN.txt,81829,82457,628,5,N,N,-,-1,-1
TWOMEN.txt,82457,82680,223,5,N,N,-,-1,-1
TWOMEN.txt,82685,83205,520,5,N,N,-,-1,-1
TWOMEN.txt,83206,83827,621,5,N,N,-,-1,-1
TWOMEN.txt,83828,84199,371,5,N,N,-,-1,-1
TWOMEN.txt,84201,84961,760,5,N,N,-,-1,-1
TWOMEN.txt,84963,85234,271,5,N,N,-,-1,-1
TWOMEN.txt,85235,85914,679,5,N,N,-,-1,-1
TWOMEN.txt,85918,86372,454,5,N,N,-,-1,-1
TWOMEN.txt,86373,86872,499,5,N,N,-,-1,-1
TWOMEN.txt,86874,87473,599,5,N,N,-,-1,-1
TWOMEN.txt,87475,87681,206,5,N,N,-,-1,-1
TWOMEN.txt,87683,88219,536,5,N,N,-,-1,-1
TWOMEN.txt,88220,88929,709,5,N,N,-,-1,-1
TWOMEN.txt,88932,89129,197,5,N,N,-,-1,-1
TWOMEN.txt,89131,89398,267,5,N,N,-,-1,-1
TWOMEN.txt,89399,90038,639,5,N,N,-,-1,-1
TWOMEN.txt,90039,90139,100,5,N,N,-,-1,-1
TWOMEN.txt,90140,90334,194,5,N,N,-,-1,-1
TWOMEN.txt,90335,90442,107,5,N,N,-,-1,-1
TWOMEN.txt,90443,90787,344,5,N,N,-,-1,-1
TWOMEN.txt,90788,91950,1162,5,N,N,-,-1,-1
TWOMEN.txt,91951,92688,737,5,N,N,-,-1,-1
TWOMEN.txt,92690,93020,330,5,N,N,-,-1,-1
TWOMEN.txt,93021,93232,211,5,N,N,-,-1,-1
TWOMEN.txt,93233,93846,613,5,N,N,-,-1,-1
TWOMEN.txt,93847,94241,394,5,N,N,-,-1,-1
TWOMEN.txt,94242,94564,322,5,N,N,-,-1,-1
TWOMEN.txt,94565,94910,345,5,N,N,-,-1,-1
TWOMEN.txt,94912,95289,377,5,N,N,-,-1,-1
TWOMEN.txt,95291,95845,554,5,N,N,-,-1,-1
TWOMEN.txt,95846,96536,690,5,N,N,-,-1,-1
TWOMEN.txt,96537,97250,713,5,N,N,-,-1,-1
TWOMEN.txt,97251,97820,569,5,N,N,-,-1,-1
TWOMEN.txt,97821,98063,242,5,N,N,-,-1,-1
TWOMEN.txt,98064,98760,696,5,N,N,-,-1,-1
TWOMEN.txt,98761,99653,892,5,N,N,-,-1,-1
TWOMEN.txt,99653,99728,75,5,N,N,-,-1,-1
TWOMEN.txt,99729,100719,990,5,N,N,-,-1,-1
TWOMEN.txt,100720,101066,346,5,N,N,-,-1,-1
TWOMEN.txt,101068,101412,344,5,N,N,-,-1,-1
TWOMEN.txt,101413,101954,541,5,N,N,-,-1,-1
TWOMEN.txt,101956,102429,473,5,N,N,-,-1,-1
TWOMEN.txt,102434,102843,409,5,N,N,-,-1,-1
TWOMEN.txt,102845,103263,418,5,N,N,-,-1,-1
TWOMEN.txt,103264,103773,509,5,N,N,-,-1,-1
TWOMEN.txt,103775,104414,639,5,N,N,-,-1,-1
TWOMEN.txt,104415,105286,871,5,N,N,-,-1,-1
TWOMEN.txt,105287,106456,1169,5,N,N,-,-1,-1
TWOMEN.txt,106458,107006,548,5,N,N,-,-1,-1
TWOMEN.txt,107007,107813,806,5,N,N,-,-1,-1
TWOMEN.txt,107814,108957,1143,5,N,N,-,-1,-1
TWOMEN.txt,108959,109591,632,5,N,N,-,-1,-1
TWOMEN.txt,109596,110162,566,5,N,N,-,-1,-1
TWOMEN.txt,110164,111163,999,5,N,N,-,-1,-1
TWOMEN.txt,111168,111380,212,5,N,N,-,-1,-1
TWOMEN.txt,111384,111703,319,5,N,N,-,-1,-1
TWOMEN.txt,111705,112125,420,5,N,N,-,-1,-1
TWOMEN.txt,112127,112869,742,5,N,N,-,-1,-1
TWOMEN.txt,112871,113300,429,5,N,N,-,-1,-1
TWOMEN.txt,113301,113383,82,5,N,N,-,-1,-1
TWOMEN.txt,113385,114112,727,5,N,N,-,-1,-1
TWOMEN.txt,114113,114715,602,5,N,N,-,-1,-1
TWOMEN.txt,114716,115506,790,5,N,N,-,-1,-1
TWOMEN.txt,115507,116173,666,5,N,N,-,-1,-1
TWOMEN.txt,116174,116732,558,5,N,N,-,-1,-1
TWOMEN.txt,116734,117324,590,5,N,N,-,-1,-1
TWOMEN.txt,117326,118052,726,5,N,N,-,-1,-1
TWOMEN.txt,118054,118772,718,5,N,N,-,-1,-1
TWOMEN.txt,118773,119401,628,5,N,N,-,-1,-1
TWOMEN.txt,119402,120523,1121,5,N,N,-,-1,-1
TWOMEN.txt,120524,121107,583,5,N,N,-,-1,-1
TWOMEN.txt,121108,121929,821,5,N,N,-,-1,-1
TWOMEN.txt,121931,122735,804,5,N,Y,1435248397073,122627,123247
TWOMEN.txt,122736,123313,577,5,N,Y,1435248397073,122627,123247
TWOMEN.txt,123314,124096,782,5,N,N,-,-1,-1
TWOMEN.txt,124097,124926,829,5,N,N,-,-1,-1
TWOMEN.txt,124928,125629,701,5,N,Y,1435251420562,125574,126313
TWOMEN.txt,125630,125894,264,5,N,Y,1435251420562,125574,126313
TWOMEN.txt,125895,126232,337,5,N,Y,1435251420562,125574,126313
TWOMEN.txt,126233,126740,507,5,N,Y,1435251420562,125574,126313
TWOMEN.txt,126742,127594,852,5,N,N,-,-1,-1
TWOMEN.txt,127595,128275,680,5,N,N,-,-1,-1
TWOMEN.txt,128277,128640,363,5,N,N,-,-1,-1
TWOMEN.txt,128640,129333,693,5,N,N,-,-1,-1
TWOMEN.txt,129335,129978,643,5,N,N,-,-1,-1
TWOMEN.txt,129979,130356,377,5,N,N,-,-1,-1
TWOMEN.txt,130357,130892,535,5,N,N,-,-1,-1
TWOMEN.txt,130893,131604,711,5,N,N,-,-1,-1
TWOMEN.txt,131606,131806,200,5,N,N,-,-1,-1
TWOMEN.txt,131806,133460,1654,5,N,N,-,-1,-1
TWOMEN.txt,133462,134462,1000,5,N,N,-,-1,-1
TWOMEN.txt,134464,135088,624,5,N,N,-,-1,-1
TWOMEN.txt,135090,135648,558,5,N,N,-,-1,-1
TWOMEN.txt,135649,135951,302,5,N,N,-,-1,-1
TWOMEN.txt,135952,136459,507,5,N,N,-,-1,-1
TWOMEN.txt,136460,137217,757,5,N,N,-,-1,-1
TWOMEN.txt,137218,137964,746,5,N,N,-,-1,-1
TWOMEN.txt,137965,138472,507,5,N,N,-,-1,-1
TWOMEN.txt,138473,138810,337,5,N,N,-,-1,-1
TWOMEN.txt,138811,139390,579,5,N,N,-,-1,-1
TWOMEN.txt,139395,139599,204,5,N,N,-,-1,-1
TWOMEN.txt,139601,139863,262,5,N,N,-,-1,-1
TWOMEN.txt,139865,140107,242,5,N,N,-,-1,-1
TWOMEN.txt,140108,140347,239,5,N,N,-,-1,-1
TWOMEN.txt,140350,140891,541,5,N,N,-,-1,-1
TWOMEN.txt,140892,141138,246,5,N,N,-,-1,-1
TWOMEN.txt,141139,141513,374,5,N,N,-,-1,-1
TWOMEN.txt,141514,141870,356,5,N,N,-,-1,-1
TWOMEN.txt,141873,142093,220,5,N,N,-,-1,-1
TWOMEN.txt,142096,142910,814,5,N,N,-,-1,-1
TWOMEN.txt,142911,142994,83,5,N,N,-,-1,-1
TWOMEN.txt,142994,143416,422,5,N,N,-,-1,-1
TWOMEN.txt,143417,143803,386,5,N,N,-,-1,-1
TWOMEN.txt,143805,144393,588,5,N,N,-,-1,-1
TWOMEN.txt,144395,144692,297,5,N,Y,1435252280553,144644,145005
TWOMEN.txt,144693,145057,364,5,N,Y,1435252280553,144644,145005
TWOMEN.txt,145058,145311,253,5,N,N,-,-1,-1
TWOMEN.txt,145313,145716,403,5,N,N,-,-1,-1
TWOMEN.txt,145717,146067,350,5,N,N,-,-1,-1
TWOMEN.txt,146067,146529,462,5,N,N,-,-1,-1
TWOMEN.txt,146530,146636,106,5,N,N,-,-1,-1
TWOMEN.txt,146637,146943,306,5,N,N,-,-1,-1
TWOMEN.txt,146944,147307,363,5,N,N,-,-1,-1
TWOMEN.txt,147308,147671,363,5,N,N,-,-1,-1
TWOMEN.txt,147674,147932,258,5,N,N,-,-1,-1
TWOMEN.txt,147934,148054,120,5,N,N,-,-1,-1
TWOMEN.txt,148054,148692,638,5,N,N,-,-1,-1
TWOMEN.txt,148694,148765,71,5,N,N,-,-1,-1
TWOMEN.txt,148766,149342,576,5,N,N,-,-1,-1
TWOMEN.txt,149343,149609,266,5,N,N,-,-1,-1
TWOMEN.txt,149614,149798,184,5,N,N,-,-1,-1
TWOMEN.txt,149799,149964,165,5,N,N,-,-1,-1
TWOMEN.txt,149965,150472,507,5,N,N,-,-1,-1
TWOMEN.txt,150474,150882,408,5,N,N,-,-1,-1
TWOMEN.txt,150883,151132,249,5,N,N,-,-1,-1
TWOMEN.txt,151133,151659,526,5,N,N,-,-1,-1
TWOMEN.txt,151660,151978,318,5,N,N,-,-1,-1
TWOMEN.txt,151979,152068,89,5,N,N,-,-1,-1
TWOMEN.txt,152070,152488,418,5,N,N,-,-1,-1
TWOMEN.txt,152493,152715,222,5,N,N,-,-1,-1
TWOMEN.txt,152716,153132,416,5,N,N,-,-1,-1
TWOMEN.txt,153135,153385,250,5,N,N,-,-1,-1
TWOMEN.txt,153389,153507,118,5,N,N,-,-1,-1
TWOMEN.txt,153508,153989,481,5,N,N,-,-1,-1
TWOMEN.txt,153990,154349,359,5,N,N,-,-1,-1
TWOMEN.txt,154351,154632,281,5,N,N,-,-1,-1
TWOMEN.txt,154634,155130,496,5,N,N,-,-1,-1
TWOMEN.txt,155131,155813,682,5,N,N,-,-1,-1
TWOMEN.txt,155814,155992,178,5,N,N,-,-1,-1
TWOMEN.txt,155993,156311,318,5,N,N,-,-1,-1
TWOMEN.txt,156311,156513,202,5,N,N,-,-1,-1
TWOMEN.txt,156513,156845,332,5,N,N,-,-1,-1
TWOMEN.txt,156847,157515,668,5,N,N,-,-1,-1
TWOMEN.txt,157517,157919,402,5,N,N,-,-1,-1
TWOMEN.txt,157920,158426,506,5,N,N,-,-1,-1
TWOMEN.txt,158428,159086,658,5,N,N,-,-1,-1
TWOMEN.txt,159087,159502,415,5,N,N,-,-1,-1
TWOMEN.txt,159504,159992,488,5,N,Y,1435252717170,159519,160234
TWOMEN.txt,159993,160541,548,5,N,Y,1435252717170,159519,160234
TWOMEN.txt,160543,161076,533,5,N,N,-,-1,-1
TWOMEN.txt,161078,161523,445,5,N,N,-,-1,-1
TWOMEN.txt,161526,161596,70,5,N,N,-,-1,-1
TWOMEN.txt,161598,162056,458,5,N,N,-,-1,-1
TWOMEN.txt,162058,162751,693,5,N,N,-,-1,-1
TWOMEN.txt,162752,163358,606,5,N,N,-,-1,-1
TWOMEN.txt,163359,164111,752,5,N,N,-,-1,-1
TWOMEN.txt,164113,164611,498,5,N,N,-,-1,-1
TWOMEN.txt,164616,164737,121,5,N,N,-,-1,-1
TWOMEN.txt,164737,165114,377,5,N,N,-,-1,-1
TWOMEN.txt,165116,165391,275,5,N,N,-,-1,-1
TWOMEN.txt,165394,165704,310,5,N,N,-,-1,-1
TWOMEN.txt,165706,165947,241,5,N,N,-,-1,-1
TWOMEN.txt,165948,166052,104,5,N,N,-,-1,-1
TWOMEN.txt,166054,166473,419,5,N,N,-,-1,-1
TWOMEN.txt,166474,166626,152,5,N,N,-,-1,-1
TWOMEN.txt,166628,167441,813,5,N,N,-,-1,-1
TWOMEN.txt,167442,167875,433,5,N,N,-,-1,-1
TWOMEN.txt,167876,168275,399,5,N,N,-,-1,-1
TWOMEN.txt,168276,168913,637,5,N,N,-,-1,-1
TWOMEN.txt,168914,169524,610,5,N,N,-,-1,-1
TWOMEN.txt,169527,169646,119,5,N,N,-,-1,-1
TWOMEN.txt,169648,170208,560,5,N,N,-,-1,-1
TWOMEN.txt,170209,171005,796,5,N,N,-,-1,-1
TWOMEN.txt,171006,171192,186,5,N,N,-,-1,-1
TWOMEN.txt,171193,171466,273,5,N,N,-,-1,-1
TWOMEN.txt,171468,171920,452,5,N,N,-,-1,-1
TWOMEN.txt,171923,172385,462,5,N,N,-,-1,-1
TWOMEN.txt,172386,172819,433,5,N,N,-,-1,-1
TWOMEN.txt,172820,173212,392,5,N,N,-,-1,-1
TWOMEN.txt,173214,173577,363,5,N,N,-,-1,-1
TWOMEN.txt,173578,173984,406,5,N,N,-,-1,-1
TWOMEN.txt,173988,174334,346,5,N,N,-,-1,-1
TWOMEN.txt,174335,174736,401,5,N,N,-,-1,-1
TWOMEN.txt,174737,175650,913,5,N,N,-,-1,-1
TWOMEN.txt,175655,176133,478,5,N,N,-,-1,-1
TWOMEN.txt,176135,176504,369,5,N,N,-,-1,-1
TWOMEN.txt,176505,177037,532,5,N,N,-,-1,-1
TWOMEN.txt,177038,177378,340,5,N,N,-,-1,-1
TWOMEN.txt,177380,178351,971,5,N,N,-,-1,-1
TWOMEN.txt,178352,178661,309,5,N,N,-,-1,-1
TWOMEN.txt,178663,179474,811,5,N,N,-,-1,-1
TWOMEN.txt,179476,179899,423,5,N,N,-,-1,-1
TWOMEN.txt,179900,180253,353,5,N,N,-,-1,-1
TWOMEN.txt,180255,180511,256,5,N,N,-,-1,-1
TWOMEN.txt,180513,181261,748,5,N,N,-,-1,-1
TWOMEN.txt,181261,181803,542,5,N,N,-,-1,-1
TWOMEN.txt,181804,182178,374,5,N,N,-,-1,-1
TWOMEN.txt,182181,182724,543,5,N,N,-,-1,-1
TWOMEN.txt,182725,183820,1095,5,N,N,-,-1,-1
TWOMEN.txt,183821,184237,416,5,N,N,-,-1,-1
TWOMEN.txt,184238,184724,486,5,N,N,-,-1,-1
TWOMEN.txt,184725,185318,593,5,N,N,-,-1,-1
TWOMEN.txt,185319,185791,472,5,N,N,-,-1,-1
TWOMEN.txt,185793,186531,738,5,N,N,-,-1,-1
TWOMEN.txt,186532,187229,697,5,N,N,-,-1,-1
TWOMEN.txt,187230,187715,485,5,N,N,-,-1,-1
TWOMEN.txt,187716,188057,341,5,N,N,-,-1,-1
TWOMEN.txt,188060,188496,436,5,N,N,-,-1,-1
TWOMEN.txt,188497,189273,776,5,N,N,-,-1,-1
TWOMEN.txt,189278,189769,491,5,N,N,-,-1,-1
TWOMEN.txt,189771,190253,482,5,N,N,-,-1,-1
TWOMEN.txt,190256,190491,235,5,N,N,-,-1,-1
TWOMEN.txt,190492,191028,536,5,N,N,-,-1,-1
TWOMEN.txt,191030,191710,680,5,N,N,-,-1,-1
TWOMEN.txt,191712,192414,702,5,N,N,-,-1,-1
TWOMEN.txt,192416,193181,765,5,N,N,-,-1,-1
TWOMEN.txt,193182,193457,275,5,N,N,-,-1,-1
TWOMEN.txt,193458,194043,585,5,N,N,-,-1,-1
TWOMEN.txt,194045,194287,242,5,N,N,-,-1,-1
TWOMEN.txt,194289,194402,113,5,N,N,-,-1,-1
TWOMEN.txt,194405,194538,133,5,N,N,-,-1,-1
TWOMEN.txt,194539,194713,174,5,N,N,-,-1,-1
TWOMEN.txt,194714,194808,94,5,N,N,-,-1,-1
TWOMEN.txt,194811,195088,277,5,N,N,-,-1,-1
TWOMEN.txt,195090,195712,622,5,N,N,-,-1,-1
TWOMEN.txt,195714,196057,343,5,N,N,-,-1,-1
TWOMEN.txt,196059,196502,443,5,N,N,-,-1,-1
TWOMEN.txt,196503,196856,353,5,N,N,-,-1,-1
TWOMEN.txt,196858,197685,827,5,N,N,-,-1,-1
TWOMEN.txt,197688,197762,74,5,N,N,-,-1,-1
TWOMEN.txt,197764,198476,712,5,N,N,-,-1,-1
TWOMEN.txt,198476,198953,477,5,N,N,-,-1,-1
TWOMEN.txt,198954,199314,360,5,N,N,-,-1,-1
TWOMEN.txt,199316,199534,218,5,N,N,-,-1,-1
TWOMEN.txt,199537,199645,108,5,N,N,-,-1,-1
TWOMEN.txt,199646,200036,390,5,N,N,-,-1,-1
TWOMEN.txt,200037,200400,363,5,N,N,-,-1,-1
TWOMEN.txt,200401,201057,656,5,N,Y,1435559512755,200724,201031
TWOMEN.txt,201058,201260,202,5,N,N,-,-1,-1
TWOMEN.txt,201262,201651,389,5,N,N,-,-1,-1
TWOMEN.txt,201653,201867,214,5,N,N,-,-1,-1
TWOMEN.txt,201868,202102,234,5,N,N,-,-1,-1
TWOMEN.txt,202103,202755,652,5,N,N,-,-1,-1
TWOMEN.txt,202756,203454,698,5,N,N,-,-1,-1
TWOMEN.txt,203459,203891,432,5,N,N,-,-1,-1
TWOMEN.txt,203893,204388,495,5,N,N,-,-1,-1
TWOMEN.txt,204389,204797,408,5,N,N,-,-1,-1
TWOMEN.txt,204798,205308,510,5,N,N,-,-1,-1
TWOMEN.txt,205311,205515,204,5,N,N,-,-1,-1
TWOMEN.txt,205516,205703,187,5,N,N,-,-1,-1
TWOMEN.txt,205706,205969,263,5,N,N,-,-1,-1
TWOMEN.txt,205974,206073,99,5,N,N,-,-1,-1
TWOMEN.txt,206073,206657,584,5,N,N,-,-1,-1
TWOMEN.txt,206658,206857,199,5,N,N,-,-1,-1
TWOMEN.txt,206858,207214,356,5,N,N,-,-1,-1
TWOMEN.txt,207217,207709,492,5,N,N,-,-1,-1
TWOMEN.txt,207711,207969,258,5,N,N,-,-1,-1
TWOMEN.txt,207970,208654,684,5,N,N,-,-1,-1
TWOMEN.txt,208655,209089,434,5,N,N,-,-1,-1
TWOMEN.txt,209090,209706,616,5,N,N,-,-1,-1
TWOMEN.txt,209708,210428,720,5,N,N,-,-1,-1
TWOMEN.txt,210429,211044,615,5,N,N,-,-1,-1
TWOMEN.txt,211045,211207,162,5,N,N,-,-1,-1
TWOMEN.txt,211207,211969,762,5,N,N,-,-1,-1
TWOMEN.txt,211970,212876,906,5,N,N,-,-1,-1
TWOMEN.txt,212877,213517,640,5,N,N,-,-1,-1
TWOMEN.txt,213520,213987,467,5,N,N,-,-1,-1
TWOMEN.txt,213988,214454,466,5,N,N,-,-1,-1
TWOMEN.txt,214456,214920,464,5,N,N,-,-1,-1
TWOMEN.txt,214922,215468,546,5,N,N,-,-1,-1
TWOMEN.txt,215469,215952,483,5,N,N,-,-1,-1
TWOMEN.txt,215953,216299,346,5,N,N,-,-1,-1
TWOMEN.txt,216304,217494,1190,5,N,N,-,-1,-1
TWOMEN.txt,217495,217979,484,5,N,N,-,-1,-1
TWOMEN.txt,217980,218484,504,5,N,N,-,-1,-1
TWOMEN.txt,218485,218686,201,5,N,N,-,-1,-1
TWOMEN.txt,218687,219855,1168,5,N,N,-,-1,-1
TWOMEN.txt,219856,220275,419,5,N,N,-,-1,-1
TWOMEN.txt,220276,220752,476,5,N,N,-,-1,-1
TWOMEN.txt,220753,221115,362,5,N,N,-,-1,-1
TWOMEN.txt,221116,221643,527,5,N,N,-,-1,-1
TWOMEN.txt,221644,222040,396,5,N,N,-,-1,-1
TWOMEN.txt,222041,222739,698,5,N,N,-,-1,-1
TWOMEN.txt,222740,223254,514,5,N,Y,1435560377740,223014,223315
TWOMEN.txt,223255,223766,511,5,N,Y,1435560377740,223014,223315
TWOMEN.txt,223768,224132,364,5,N,N,-,-1,-1
TWOMEN.txt,224135,224420,285,5,N,N,-,-1,-1
TWOMEN.txt,224425,224960,535,5,N,N,-,-1,-1
TWOMEN.txt,224961,225241,280,5,N,N,-,-1,-1
TWOMEN.txt,225242,225470,228,5,N,N,-,-1,-1
TWOMEN.txt,225471,225753,282,5,N,N,-,-1,-1
TWOMEN.txt,225754,226026,272,5,N,N,-,-1,-1
TWOMEN.txt,226027,226287,260,5,N,N,-,-1,-1
TWOMEN.txt,226289,227027,738,5,N,N,-,-1,-1
TWOMEN.txt,227028,227455,427,5,N,N,-,-1,-1
TWOMEN.txt,227456,227608,152,5,N,N,-,-1,-1
TWOMEN.txt,227609,227782,173,5,N,N,-,-1,-1
TWOMEN.txt,227783,228226,443,5,N,N,-,-1,-1
TWOMEN.txt,228228,228970,742,5,N,N,-,-1,-1
TWOMEN.txt,228972,229144,172,5,N,N,-,-1,-1
TWOMEN.txt,229146,229467,321,5,N,N,-,-1,-1
TWOMEN.txt,229468,229819,351,5,N,N,-,-1,-1
TWOMEN.txt,229820,230464,644,5,N,N,-,-1,-1
TWOMEN.txt,230466,230722,256,5,N,N,-,-1,-1
TWOMEN.txt,230724,230990,266,5,N,N,-,-1,-1
TWOMEN.txt,230992,231561,569,5,N,N,-,-1,-1
TWOMEN.txt,231562,232336,774,5,N,N,-,-1,-1
TWOMEN.txt,232338,232470,132,5,N,N,-,-1,-1
TWOMEN.txt,232472,232681,209,5,N,N,-,-1,-1
TWOMEN.txt,232683,232809,126,5,N,N,-,-1,-1
TWOMEN.txt,232810,233104,294,5,N,N,-,-1,-1
TWOMEN.txt,233105,233492,387,5,N,N,-,-1,-1
TWOMEN.txt,233493,233656,163,5,N,N,-,-1,-1
TWOMEN.txt,233657,234201,544,5,N,N,-,-1,-1
TWOMEN.txt,234202,234555,353,5,N,N,-,-1,-1
TWOMEN.txt,234557,234687,130,5,N,N,-,-1,-1
TWOMEN.txt,234688,235201,513,5,N,N,-,-1,-1
TWOMEN.txt,235202,235396,194,5,N,N,-,-1,-1
TWOMEN.txt,235402,235542,140,5,N,N,-,-1,-1
TWOMEN.txt,235543,235880,337,5,N,N,-,-1,-1
TWOMEN.txt,235882,236531,649,5,N,N,-,-1,-1
TWOMEN.txt,236533,236878,345,5,N,N,-,-1,-1
TWOMEN.txt,236879,237373,494,5,N,Y,1435569753505,236911,237277
TWOMEN.txt,237375,237966,591,5,N,N,-,-1,-1
TWOMEN.txt,237967,238227,260,5,N,N,-,-1,-1
TWOMEN.txt,238228,238355,127,5,N,N,-,-1,-1
TWOMEN.txt,238357,239099,742,5,N,N,-,-1,-1
TWOMEN.txt,239100,239691,591,5,N,N,-,-1,-1
TWOMEN.txt,239692,240195,503,5,N,N,-,-1,-1
TWOMEN.txt,240196,240629,433,5,N,N,-,-1,-1
TWOMEN.txt,240631,241223,592,5,N,N,-,-1,-1
TWOMEN.txt,241225,241602,377,5,N,N,-,-1,-1
TWOMEN.txt,241603,242093,490,5,N,N,-,-1,-1
TWOMEN.txt,242095,242586,491,5,N,Y,1435570787049,242195,242945
TWOMEN.txt,242588,242985,397,5,N,Y,1435570787049,242195,242945
TWOMEN.txt,242986,243375,389,5,N,N,-,-1,-1
TWOMEN.txt,243380,243752,372,5,N,N,-,-1,-1
TWOMEN.txt,243753,243803,50,5,N,N,-,-1,-1
TWOMEN.txt,243804,244424,620,5,N,N,-,-1,-1
TWOMEN.txt,244426,244759,333,5,N,N,-,-1,-1
TWOMEN.txt,244761,245439,678,5,N,N,-,-1,-1
TWOMEN.txt,245440,245607,167,5,N,N,-,-1,-1
TWOMEN.txt,245609,246160,551,5,N,N,-,-1,-1
TWOMEN.txt,246162,246686,524,5,N,N,-,-1,-1
TWOMEN.txt,246686,247047,361,5,N,N,-,-1,-1
TWOMEN.txt,247049,247466,417,5,N,N,-,-1,-1
TWOMEN.txt,247469,247870,401,5,N,N,-,-1,-1
TWOMEN.txt,247871,248404,533,5,N,N,-,-1,-1
TWOMEN.txt,248405,249429,1024,5,N,N,-,-1,-1
TWOMEN.txt,249430,250471,1041,5,N,N,-,-1,-1
TWOMEN.txt,250473,250785,312,5,N,N,-,-1,-1
TWOMEN.txt,250786,251317,531,5,N,N,-,-1,-1
TWOMEN.txt,251318,251687,369,5,N,N,-,-1,-1
TWOMEN.txt,251688,252439,751,5,N,N,-,-1,-1
TWOMEN.txt,252440,252853,413,5,N,N,-,-1,-1
TWOMEN.txt,252855,253549,694,5,N,N,-,-1,-1
TWOMEN.txt,253551,253968,417,5,N,N,-,-1,-1
TWOMEN.txt,253970,254290,320,5,N,N,-,-1,-1
TWOMEN.txt,254291,254661,370,5,N,N,-,-1,-1
TWOMEN.txt,254661,255083,422,5,N,N,-,-1,-1
TWOMEN.txt,255086,255244,158,5,N,N,-,-1,-1
TWOMEN.txt,255245,255897,652,5,N,N,-,-1,-1
TWOMEN.txt,255898,256393,495,5,N,N,-,-1,-1
TWOMEN.txt,256394,256749,355,5,N,N,-,-1,-1
TWOMEN.txt,256750,257296,546,5,N,N,-,-1,-1
TWOMEN.txt,257297,257775,478,5,N,N,-,-1,-1
TWOMEN.txt,257777,258586,809,5,N,N,-,-1,-1
TWOMEN.txt,258588,259113,525,5,N,N,-,-1,-1
TWOMEN.txt,259114,259830,716,5,N,N,-,-1,-1
TWOMEN.txt,259832,260311,479,5,N,N,-,-1,-1
TWOMEN.txt,260312,260745,433,5,N,N,-,-1,-1
TWOMEN.txt,260750,261265,515,5,N,N,-,-1,-1
TWOMEN.txt,261266,262220,954,5,N,N,-,-1,-1
TWOMEN.txt,262222,262530,308,5,N,N,-,-1,-1
TWOMEN.txt,262531,262974,443,5,N,N,-,-1,-1
TWOMEN.txt,262975,263207,232,5,N,N,-,-1,-1
TWOMEN.txt,263208,263758,550,5,N,N,-,-1,-1
TWOMEN.txt,263760,264089,329,5,N,N,-,-1,-1
TWOMEN.txt,264090,264675,585,5,N,N,-,-1,-1
TWOMEN.txt,264676,265433,757,5,N,N,-,-1,-1
TWOMEN.txt,265434,265950,516,5,N,N,-,-1,-1
TWOMEN.txt,265951,266092,141,5,N,N,-,-1,-1
TWOMEN.txt,266093,266796,703,5,N,N,-,-1,-1
TWOMEN.txt,266798,267225,427,5,N,N,-,-1,-1
TWOMEN.txt,267226,267526,300,5,N,N,-,-1,-1
TWOMEN.txt,267529,268503,974,5,N,N,-,-1,-1
TWOMEN.txt,268505,268930,425,5,N,N,-,-1,-1
TWOMEN.txt,268931,269533,602,5,N,N,-,-1,-1
TWOMEN.txt,269534,269926,392,5,N,N,-,-1,-1
TWOMEN.txt,269927,270290,363,5,N,N,-,-1,-1
TWOMEN.txt,270292,271015,723,5,N,N,-,-1,-1
TWOMEN.txt,271016,271696,680,5,N,N,-,-1,-1
TWOMEN.txt,271697,272367,670,5,N,N,-,-1,-1
TWOMEN.txt,272368,272893,525,5,N,N,-,-1,-1
TWOMEN.txt,272900,273573,673,5,N,N,-,-1,-1
TWOMEN.txt,273575,274010,435,5,N,N,-,-1,-1
TWOMEN.txt,274012,275037,1025,5,N,N,-,-1,-1
TWOMEN.txt,275038,275339,301,5,N,N,-,-1,-1
TWOMEN.txt,275340,275501,161,5,N,N,-,-1,-1
TWOMEN.txt,275502,276277,775,5,N,N,-,-1,-1
TWOMEN.txt,276283,276689,406,5,N,N,-,-1,-1
TWOMEN.txt,276691,277088,397,5,N,N,-,-1,-1
TWOMEN.txt,277089,277809,720,5,N,N,-,-1,-1
TWOMEN.txt,277810,278316,506,5,N,N,-,-1,-1
TWOMEN.txt,278319,278747,428,5,N,N,-,-1,-1
TWOMEN.txt,278748,279194,446,5,N,N,-,-1,-1
TWOMEN.txt,279196,279829,633,5,N,N,-,-1,-1
TWOMEN.txt,279830,280075,245,5,N,N,-,-1,-1
TWOMEN.txt,280076,280403,327,5,N,N,-,-1,-1
TWOMEN.txt,280405,281224,819,5,N,N,-,-1,-1
TWOMEN.txt,281229,281495,266,5,N,N,-,-1,-1
TWOMEN.txt,281496,282017,521,5,N,N,-,-1,-1
TWOMEN.txt,282018,282897,879,5,N,N,-,-1,-1
TWOMEN.txt,282898,283162,264,5,N,N,-,-1,-1
TWOMEN.txt,283163,283543,380,5,N,N,-,-1,-1
TWOMEN.txt,283544,283744,200,5,N,N,-,-1,-1
TWOMEN.txt,283745,283887,142,5,N,N,-,-1,-1
TWOMEN.txt,283887,284089,202,5,N,N,-,-1,-1
TWOMEN.txt,284091,284477,386,5,N,N,-,-1,-1
TWOMEN.txt,284478,284996,518,5,N,N,-,-1,-1
TWOMEN.txt,284999,285355,356,5,N,N,-,-1,-1
TWOMEN.txt,285356,285829,473,5,N,N,-,-1,-1
TWOMEN.txt,285830,286471,641,5,N,N,-,-1,-1
TWOMEN.txt,286476,287439,963,5,N,N,-,-1,-1
TWOMEN.txt,287441,287683,242,5,N,N,-,-1,-1
TWOMEN.txt,287684,288162,478,5,N,N,-,-1,-1
TWOMEN.txt,288167,288803,636,5,N,N,-,-1,-1
TWOMEN.txt,288803,289305,502,5,N,N,-,-1,-1
TWOMEN.txt,289306,289867,561,5,N,N,-,-1,-1
TWOMEN.txt,289868,290180,312,5,N,N,-,-1,-1
TWOMEN.txt,290180,290884,704,5,N,N,-,-1,-1
TWOMEN.txt,290885,291496,611,5,N,N,-,-1,-1
TWOMEN.txt,291497,292791,1294,5,N,N,-,-1,-1
TWOMEN.txt,292794,293105,311,5,N,N,-,-1,-1
TWOMEN.txt,293106,293828,722,5,N,N,-,-1,-1
TWOMEN.txt,293830,294420,590,5,N,N,-,-1,-1
TWOMEN.txt,294422,294614,192,5,N,N,-,-1,-1
TWOMEN.txt,294614,295218,604,5,N,N,-,-1,-1
TWOMEN.txt,295219,295607,388,5,N,N,-,-1,-1
TWOMEN.txt,295609,296108,499,5,N,N,-,-1,-1
TWOMEN.txt,296110,296421,311,5,N,N,-,-1,-1
TWOMEN.txt,296422,297343,921,5,N,N,-,-1,-1
TWOMEN.txt,297344,297678,334,5,N,N,-,-1,-1
TWOMEN.txt,297680,298226,546,5,N,N,-,-1,-1
TWOMEN.txt,298227,298940,713,5,N,N,-,-1,-1
TWOMEN.txt,298940,299232,292,5,N,N,-,-1,-1
TWOMEN.txt,299233,299594,361,5,N,N,-,-1,-1
TWOMEN.txt,299595,300237,642,5,N,N,-,-1,-1
TWOMEN.txt,300240,300691,451,5,N,N,-,-1,-1
TWOMEN.txt,300693,301055,362,5,N,N,-,-1,-1
TWOMEN.txt,301057,301869,812,5,N,N,-,-1,-1
TWOMEN.txt,301870,302279,409,5,N,N,-,-1,-1
TWOMEN.txt,302281,302484,203,5,N,N,-,-1,-1
TWOMEN.txt,302485,303019,534,5,N,N,-,-1,-1
TWOMEN.txt,303021,303688,667,5,N,N,-,-1,-1
TWOMEN.txt,303690,304212,522,5,N,N,-,-1,-1
TWOMEN.txt,304214,304427,213,5,N,N,-,-1,-1
TWOMEN.txt,304428,304944,516,5,N,N,-,-1,-1
TWOMEN.txt,304945,305652,707,5,N,N,-,-1,-1
TWOMEN.txt,305653,306642,989,5,N,N,-,-1,-1
TWOMEN.txt,306648,307144,496,5,N,N,-,-1,-1
TWOMEN.txt,307145,307339,194,5,N,N,-,-1,-1
TWOMEN.txt,307341,308076,735,5,N,N,-,-1,-1
TWOMEN.txt,308080,308338,258,5,N,N,-,-1,-1
TWOMEN.txt,308343,308777,434,5,N,N,-,-1,-1
TWOMEN.txt,308778,309572,794,5,N,N,-,-1,-1
TWOMEN.txt,309574,310620,1046,5,N,N,-,-1,-1
TWOMEN.txt,310621,311151,530,5,N,N,-,-1,-1
TWOMEN.txt,311152,311363,211,5,N,N,-,-1,-1
TWOMEN.txt,311365,311462,97,5,N,N,-,-1,-1
TWOMEN.txt,311463,311531,68,5,N,N,-,-1,-1
TWOMEN.txt,311532,311819,287,5,N,N,-,-1,-1
TWOMEN.txt,311821,312406,585,5,N,N,-,-1,-1
TWOMEN.txt,312409,312699,290,5,N,N,-,-1,-1
TWOMEN.txt,312701,313377,676,5,N,N,-,-1,-1
TWOMEN.txt,313378,313811,433,5,N,N,-,-1,-1
TWOMEN.txt,313812,314125,313,5,N,N,-,-1,-1
TWOMEN.txt,314127,315129,1002,5,N,N,-,-1,-1
TWOMEN.txt,315131,315326,195,5,N,N,-,-1,-1
TWOMEN.txt,315327,316300,973,5,N,N,-,-1,-1
TWOMEN.txt,316301,316954,653,5,N,N,-,-1,-1
TWOMEN.txt,316955,317406,451,5,N,N,-,-1,-1
TWOMEN.txt,317408,318116,708,5,N,N,-,-1,-1
TWOMEN.txt,318117,318436,319,5,N,N,-,-1,-1
TWOMEN.txt,318437,319008,571,5,N,N,-,-1,-1
TWOMEN.txt,319010,319506,496,5,N,N,-,-1,-1
TWOMEN.txt,319507,319922,415,5,N,N,-,-1,-1
TWOMEN.txt,319924,320439,515,5,N,N,-,-1,-1
TWOMEN.txt,320441,320982,541,5,N,N,-,-1,-1
TWOMEN.txt,320983,321392,409,5,N,N,-,-1,-1
TWOMEN.txt,321395,321783,388,5,N,N,-,-1,-1
TWOMEN.txt,321784,322316,532,5,N,N,-,-1,-1
TWOMEN.txt,322317,322905,588,5,N,N,-,-1,-1
TWOMEN.txt,322907,323235,328,5,N,N,-,-1,-1
TWOMEN.txt,323236,323432,196,5,N,N,-,-1,-1
TWOMEN.txt,323433,323922,489,5,N,N,-,-1,-1
TWOMEN.txt,323924,324347,423,5,N,N,-,-1,-1
TWOMEN.txt,324348,324702,354,5,N,N,-,-1,-1
TWOMEN.txt,324704,325118,414,5,N,N,-,-1,-1
TWOMEN.txt,325120,325621,501,5,N,N,-,-1,-1
TWOMEN.txt,325622,326010,388,5,N,N,-,-1,-1
TWOMEN.txt,326011,326208,197,5,N,N,-,-1,-1
TWOMEN.txt,326209,326740,531,5,N,N,-,-1,-1
TWOMEN.txt,326745,327157,412,5,N,N,-,-1,-1
TWOMEN.txt,327158,327547,389,5,N,N,-,-1,-1
TWOMEN.txt,327549,328050,501,5,N,N,-,-1,-1
TWOMEN.txt,328052,328482,430,5,N,N,-,-1,-1
TWOMEN.txt,328483,328873,390,5,N,N,-,-1,-1
TWOMEN.txt,328874,329330,456,5,N,N,-,-1,-1
TWOMEN.txt,329332,330088,756,5,N,N,-,-1,-1
TWOMEN.txt,330089,330554,465,5,N,N,-,-1,-1
TWOMEN.txt,330555,331431,876,5,N,N,-,-1,-1
TWOMEN.txt,331432,332219,787,5,N,N,-,-1,-1
TWOMEN.txt,332221,332816,595,5,N,N,-,-1,-1
TWOMEN.txt,332817,333278,461,5,N,N,-,-1,-1
TWOMEN.txt,333281,333710,429,5,N,N,-,-1,-1
TWOMEN.txt,333711,334049,338,5,N,N,-,-1,-1
TWOMEN.txt,334050,334325,275,5,N,N,-,-1,-1
TWOMEN.txt,334328,334677,349,5,N,N,-,-1,-1
TWOMEN.txt,334678,335203,525,5,N,N,-,-1,-1
TWOMEN.txt,335204,336010,806,5,N,N,-,-1,-1
TWOMEN.txt,336011,336696,685,5,N,N,-,-1,-1
TWOMEN.txt,336697,337020,323,5,N,N,-,-1,-1
TWOMEN.txt,337021,337408,387,5,N,N,-,-1,-1
TWOMEN.txt,337410,337698,288,5,N,N,-,-1,-1
TWOMEN.txt,337701,338047,346,5,N,N,-,-1,-1
TWOMEN.txt,338048,338413,365,5,N,N,-,-1,-1
TWOMEN.txt,338414,338959,545,5,N,N,-,-1,-1
TWOMEN.txt,338962,339331,369,5,N,N,-,-1,-1
TWOMEN.txt,339332,339599,267,5,N,N,-,-1,-1
TWOMEN.txt,339600,340028,428,5,N,N,-,-1,-1
TWOMEN.txt,340029,340333,304,5,N,N,-,-1,-1
TWOMEN.txt,340334,340559,225,5,N,N,-,-1,-1
TWOMEN.txt,340560,340848,288,5,N,N,-,-1,-1
TWOMEN.txt,340849,340975,126,5,N,N,-,-1,-1
TWOMEN.txt,340978,341157,179,5,N,N,-,-1,-1
TWOMEN.txt,341158,341404,246,5,N,N,-,-1,-1
TWOMEN.txt,341405,341562,157,5,N,N,-,-1,-1
TWOMEN.txt,341563,342088,525,5,N,N,-,-1,-1
TWOMEN.txt,342089,342971,882,5,N,N,-,-1,-1
TWOMEN.txt,342973,343154,181,5,N,N,-,-1,-1
TWOMEN.txt,343155,343379,224,5,N,N,-,-1,-1
TWOMEN.txt,343380,343680,300,5,N,N,-,-1,-1
TWOMEN.txt,343681,343942,261,5,N,N,-,-1,-1
TWOMEN.txt,343943,344008,65,5,N,N,-,-1,-1
TWOMEN.txt,344009,344178,169,5,N,N,-,-1,-1
TWOMEN.txt,344179,344437,258,5,N,N,-,-1,-1
TWOMEN.txt,344439,344816,377,5,N,N,-,-1,-1
TWOMEN.txt,344819,345213,394,5,N,N,-,-1,-1
TWOMEN.txt,345215,345729,514,5,N,N,-,-1,-1
TWOMEN.txt,345730,346026,296,5,N,N,-,-1,-1
TWOMEN.txt,346028,346392,364,5,N,N,-,-1,-1
TWOMEN.txt,346393,347428,1035,5,N,N,-,-1,-1
TWOMEN.txt,347431,347778,347,5,N,N,-,-1,-1
TWOMEN.txt,347780,348211,431,5,N,N,-,-1,-1
TWOMEN.txt,348211,348521,310,5,N,N,-,-1,-1
TWOMEN.txt,348521,348970,449,5,N,N,-,-1,-1
TWOMEN.txt,348971,349346,375,5,N,N,-,-1,-1
TWOMEN.txt,349348,349780,432,5,N,N,-,-1,-1
TWOMEN.txt,349782,350174,392,5,N,N,-,-1,-1
TWOMEN.txt,350175,350387,212,5,N,N,-,-1,-1
TWOMEN.txt,350389,350691,302,5,N,N,-,-1,-1
TWOMEN.txt,350692,350936,244,5,N,N,-,-1,-1
TWOMEN.txt,350937,351354,417,5,N,N,-,-1,-1
TWOMEN.txt,351356,351919,563,5,N,N,-,-1,-1
TWOMEN.txt,351924,352048,124,5,N,N,-,-1,-1
TWOMEN.txt,352050,352332,282,5,N,N,-,-1,-1
TWOMEN.txt,352332,352707,375,5,N,N,-,-1,-1
TWOMEN.txt,352708,352899,191,5,N,N,-,-1,-1
TWOMEN.txt,352899,353377,478,5,N,N,-,-1,-1
TWOMEN.txt,353378,353840,462,5,N,N,-,-1,-1
TWOMEN.txt,353840,354225,385,5,N,N,-,-1,-1
TWOMEN.txt,354227,354709,482,5,N,N,-,-1,-1
TWOMEN.txt,354710,355103,393,5,N,N,-,-1,-1
TWOMEN.txt,355103,355739,636,5,N,N,-,-1,-1
TWOMEN.txt,355740,355971,231,5,N,N,-,-1,-1
TWOMEN.txt,355973,356350,377,5,N,N,-,-1,-1
TWOMEN.txt,356352,356557,205,5,N,N,-,-1,-1
TWOMEN.txt,356558,357029,471,5,N,N,-,-1,-1
TWOMEN.txt,357034,357479,445,5,N,N,-,-1,-1
TWOMEN.txt,357481,357623,142,5,N,N,-,-1,-1
TWOMEN.txt,357625,358025,400,5,N,N,-,-1,-1
TWOMEN.txt,358027,358381,354,5,N,N,-,-1,-1
TWOMEN.txt,358383,358904,521,5,N,N,-,-1,-1
TWOMEN.txt,358905,359326,421,5,N,N,-,-1,-1
TWOMEN.txt,359327,359707,380,5,N,N,-,-1,-1
TWOMEN.txt,359708,360315,607,5,N,N,-,-1,-1
TWOMEN.txt,360316,360636,320,5,N,N,-,-1,-1
TWOMEN.txt,360637,361218,581,5,N,N,-,-1,-1
TWOMEN.txt,361220,361853,633,5,N,N,-,-1,-1
TWOMEN.txt,361854,362082,228,5,N,N,-,-1,-1
TWOMEN.txt,362087,362397,310,5,N,N,-,-1,-1
TWOMEN.txt,362398,363070,672,5,N,N,-,-1,-1
TWOMEN.txt,363071,363610,539,5,N,N,-,-1,-1
TWOMEN.txt,363611,364087,476,5,N,N,-,-1,-1
TWOMEN.txt,364088,364365,277,5,N,N,-,-1,-1
TWOMEN.txt,364366,364598,232,5,N,N,-,-1,-1
TWOMEN.txt,364599,364726,127,5,N,N,-,-1,-1
TWOMEN.txt,364727,364930,203,5,N,N,-,-1,-1
TWOMEN.txt,364931,365226,295,5,N,N,-,-1,-1
TWOMEN.txt,365227,365401,174,5,N,N,-,-1,-1
TWOMEN.txt,365403,365928,525,5,N,N,-,-1,-1
TWOMEN.txt,365930,366377,447,5,N,N,-,-1,-1
TWOMEN.txt,366378,366556,178,5,N,N,-,-1,-1
TWOMEN.txt,366556,367090,534,5,N,N,-,-1,-1
TWOMEN.txt,367091,367528,437,5,N,N,-,-1,-1
TWOMEN.txt,367529,367886,357,5,N,N,-,-1,-1
TWOMEN.txt,367888,368706,818,5,N,N,-,-1,-1
TWOMEN.txt,368707,369045,338,5,N,N,-,-1,-1
TWOMEN.txt,369046,369288,242,5,N,N,-,-1,-1
TWOMEN.txt,369289,369592,303,5,N,N,-,-1,-1
TWOMEN.txt,369595,369657,62,5,N,N,-,-1,-1
TWOMEN.txt,369659,370111,452,5,N,N,-,-1,-1
TWOMEN.txt,370112,370357,245,5,N,N,-,-1,-1
TWOMEN.txt,370358,370550,192,5,N,N,-,-1,-1
TWOMEN.txt,370551,370946,395,5,N,N,-,-1,-1
TWOMEN.txt,370949,371067,118,5,N,N,-,-1,-1
TWOMEN.txt,371070,371414,344,5,N,N,-,-1,-1
TWOMEN.txt,371419,371935,516,5,N,N,-,-1,-1
TWOMEN.txt,371936,372222,286,5,N,N,-,-1,-1
TWOMEN.txt,372225,372651,426,5,N,N,-,-1,-1
TWOMEN.txt,372652,373065,413,5,N,N,-,-1,-1
TWOMEN.txt,373066,373575,509,5,N,N,-,-1,-1
TWOMEN.txt,373576,374158,582,5,N,N,-,-1,-1
TWOMEN.txt,374161,374495,334,5,N,N,-,-1,-1
TWOMEN.txt,374496,374914,418,5,N,N,-,-1,-1
TWOMEN.txt,374915,375253,338,5,N,N,-,-1,-1
TWOMEN.txt,375255,375763,508,5,N,N,-,-1,-1
TWOMEN.txt,375764,376268,504,5,N,N,-,-1,-1
TWOMEN.txt,376272,376537,265,5,N,N,-,-1,-1
TWOMEN.txt,376538,377411,873,5,N,N,-,-1,-1
TWOMEN.txt,377412,377831,419,5,N,N,-,-1,-1
TWOMEN.txt,377836,378431,595,5,N,N,-,-1,-1
TWOMEN.txt,378434,378564,130,5,N,N,-,-1,-1
TWOMEN.txt,378565,379111,546,5,N,N,-,-1,-1
TWOMEN.txt,379113,379492,379,5,N,N,-,-1,-1
TWOMEN.txt,379494,379735,241,5,N,N,-,-1,-1
TWOMEN.txt,379737,380350,613,5,N,N,-,-1,-1
TWOMEN.txt,380351,380600,249,5,N,N,-,-1,-1
TWOMEN.txt,380602,381248,646,5,N,N,-,-1,-1
TWOMEN.txt,381249,382155,906,5,N,Y,1435574979068,381547,381864
TWOMEN.txt,382157,382585,428,5,N,N,-,-1,-1
TWOMEN.txt,382586,383075,489,5,N,N,-,-1,-1
TWOMEN.txt,383076,383441,365,5,N,N,-,-1,-1
TWOMEN.txt,383442,383726,284,5,N,N,-,-1,-1
TWOMEN.txt,383728,384257,529,5,N,N,-,-1,-1
TWOMEN.txt,384258,385183,925,5,N,N,-,-1,-1
TWOMEN.txt,385184,385658,474,5,N,N,-,-1,-1
TWOMEN.txt,385659,385865,206,5,N,N,-,-1,-1
TWOMEN.txt,385867,386322,455,5,N,N,-,-1,-1
TWOMEN.txt,386323,386537,214,5,N,N,-,-1,-1
TWOMEN.txt,386539,387078,539,5,N,N,-,-1,-1
TWOMEN.txt,387080,387611,531,5,N,N,-,-1,-1
TWOMEN.txt,387616,388026,410,5,N,N,-,-1,-1
TWOMEN.txt,388027,388750,723,5,N,N,-,-1,-1
TWOMEN.txt,388751,389330,579,5,N,N,-,-1,-1
TWOMEN.txt,389331,389792,461,5,N,N,-,-1,-1
TWOMEN.txt,389793,390572,779,5,N,N,-,-1,-1
TWOMEN.txt,390574,391048,474,5,N,N,-,-1,-1
TWOMEN.txt,391051,391393,342,5,N,N,-,-1,-1
TWOMEN.txt,391394,391839,445,5,N,N,-,-1,-1
TWOMEN.txt,391840,392350,510,5,N,N,-,-1,-1
TWOMEN.txt,392351,392829,478,5,N,N,-,-1,-1
TWOMEN.txt,392830,393085,255,5,N,N,-,-1,-1
TWOMEN.txt,393087,393527,440,5,N,N,-,-1,-1
TWOMEN.txt,393527,393982,455,5,N,N,-,-1,-1
TWOMEN.txt,393983,394120,137,5,N,N,-,-1,-1
TWOMEN.txt,394121,394445,324,5,N,N,-,-1,-1
TWOMEN.txt,394446,394643,197,5,N,N,-,-1,-1
TWOMEN.txt,394645,395161,516,5,N,N,-,-1,-1
TWOMEN.txt,395166,395401,235,5,N,N,-,-1,-1
TWOMEN.txt,395402,395880,478,5,N,N,-,-1,-1
TWOMEN.txt,395881,396467,586,5,N,N,-,-1,-1
TWOMEN.txt,396468,397041,573,5,N,N,-,-1,-1
TWOMEN.txt,397042,397657,615,5,N,N,-,-1,-1
TWOMEN.txt,397658,398018,360,5,N,N,-,-1,-1
TWOMEN.txt,398019,398489,470,5,N,N,-,-1,-1
TWOMEN.txt,398490,398716,226,5,N,N,-,-1,-1
TWOMEN.txt,398718,398946,228,5,N,N,-,-1,-1
TWOMEN.txt,398946,399390,444,5,N,N,-,-1,-1
TWOMEN.txt,399392,399616,224,5,N,N,-,-1,-1
TWOMEN.txt,399617,399791,174,5,N,N,-,-1,-1
TWOMEN.txt,399792,400395,603,5,N,N,-,-1,-1
TWOMEN.txt,400397,400635,238,5,N,N,-,-1,-1
TWOMEN.txt,400635,401360,725,5,N,N,-,-1,-1
TWOMEN.txt,401361,401848,487,5,N,N,-,-1,-1
TWOMEN.txt,401849,402352,503,5,N,N,-,-1,-1
TWOMEN.txt,402354,402814,460,5,N,N,-,-1,-1
TWOMEN.txt,402815,403634,819,5,N,N,-,-1,-1
TWOMEN.txt,403635,404227,592,5,N,N,-,-1,-1
TWOMEN.txt,404228,404535,307,5,N,N,-,-1,-1
TWOMEN.txt,404536,405256,720,5,N,N,-,-1,-1
TWOMEN.txt,405257,405576,319,5,N,N,-,-1,-1
TWOMEN.txt,405577,405902,325,5,N,N,-,-1,-1
TWOMEN.txt,405904,406974,1070,5,N,N,-,-1,-1
TWOMEN.txt,406975,407260,285,5,N,N,-,-1,-1
TWOMEN.txt,407261,407676,415,5,N,N,-,-1,-1
TWOMEN.txt,407677,407956,279,5,N,N,-,-1,-1
TWOMEN.txt,407957,408550,593,5,N,N,-,-1,-1
TWOMEN.txt,408552,408979,427,5,N,N,-,-1,-1
TWOMEN.txt,408980,409241,261,5,N,N,-,-1,-1
TWOMEN.txt,409243,409732,489,5,N,N,-,-1,-1
TWOMEN.txt,409733,410059,326,5,N,N,-,-1,-1
TWOMEN.txt,410062,410341,279,5,N,N,-,-1,-1
TWOMEN.txt,410342,410407,65,5,N,N,-,-1,-1
TWOMEN.txt,410410,410732,322,5,N,N,-,-1,-1
TWOMEN.txt,410734,410966,232,5,N,N,-,-1,-1
TWOMEN.txt,410967,411125,158,5,N,N,-,-1,-1
TWOMEN.txt,411126,411380,254,5,N,N,-,-1,-1
TWOMEN.txt,411381,412155,774,5,N,N,-,-1,-1
TWOMEN.txt,412157,412864,707,5,N,N,-,-1,-1
TWOMEN.txt,412867,413236,369,5,N,N,-,-1,-1
TWOMEN.txt,413237,415102,1865,5,N,N,-,-1,-1
TWOMEN.txt,415104,415305,201,5,N,N,-,-1,-1
TWOMEN.txt,415307,415645,338,5,N,N,-,-1,-1
TWOMEN.txt,415646,415992,346,5,N,N,-,-1,-1
TWOMEN.txt,415993,416338,345,5,N,N,-,-1,-1
TWOMEN.txt,416343,416691,348,5,N,N,-,-1,-1
TWOMEN.txt,416692,417447,755,5,N,N,-,-1,-1
TWOMEN.txt,417448,417760,312,5,N,N,-,-1,-1
TWOMEN.txt,417762,417952,190,5,N,N,-,-1,-1
TWOMEN.txt,417954,418281,327,5,N,N,-,-1,-1
TWOMEN.txt,418283,418773,490,5,N,N,-,-1,-1
TWOMEN.txt,418775,419289,514,5,N,N,-,-1,-1
TWOMEN.txt,419291,419756,465,5,N,N,-,-1,-1
TWOMEN.txt,419758,420169,411,5,N,N,-,-1,-1
TWOMEN.txt,420170,420995,825,5,N,N,-,-1,-1
TWOMEN.txt,420997,421368,371,5,N,N,-,-1,-1
TWOMEN.txt,421369,421859,490,5,N,N,-,-1,-1
TWOMEN.txt,421862,422358,496,5,N,N,-,-1,-1
TWOMEN.txt,422362,423103,741,5,N,N,-,-1,-1
TWOMEN.txt,423104,423612,508,5,N,N,-,-1,-1
TWOMEN.txt,423613,424170,557,5,N,N,-,-1,-1
TWOMEN.txt,424171,424606,435,5,N,N,-,-1,-1
TWOMEN.txt,424607,425463,856,5,N,N,-,-1,-1
TWOMEN.txt,425464,425942,478,5,N,N,-,-1,-1
TWOMEN.txt,425943,426856,913,5,N,N,-,-1,-1
TWOMEN.txt,426858,427198,340,5,N,N,-,-1,-1
TWOMEN.txt,427198,427658,460,5,N,N,-,-1,-1
TWOMEN.txt,427659,428410,751,5,N,N,-,-1,-1
TWOMEN.txt,428411,428923,512,5,N,N,-,-1,-1
TWOMEN.txt,428924,429288,364,5,N,N,-,-1,-1
TWOMEN.txt,429289,429709,420,5,N,N,-,-1,-1
TWOMEN.txt,429710,430393,683,5,N,N,-,-1,-1
TWOMEN.txt,430395,431363,968,5,N,N,-,-1,-1
TWOMEN.txt,431364,431720,356,5,N,N,-,-1,-1
TWOMEN.txt,431721,432271,550,5,N,N,-,-1,-1
TWOMEN.txt,432272,432905,633,5,N,N,-,-1,-1
TWOMEN.txt,432906,433830,924,5,N,N,-,-1,-1
TWOMEN.txt,433831,434170,339,5,N,N,-,-1,-1
TWOMEN.txt,434172,435150,978,5,N,N,-,-1,-1
TWOMEN.txt,435151,435495,344,5,N,N,-,-1,-1
TWOMEN.txt,435496,436066,570,5,N,N,-,-1,-1
TWOMEN.txt,436067,436500,433,5,N,N,-,-1,-1
TWOMEN.txt,436501,437333,832,5,N,N,-,-1,-1
TWOMEN.txt,437334,438090,756,5,N,N,-,-1,-1
TWOMEN.txt,438091,438215,124,5,N,N,-,-1,-1
TWOMEN.txt,438216,439150,934,5,N,N,-,-1,-1
TWOMEN.txt,439152,439897,745,5,N,N,-,-1,-1
TWOMEN.txt,439898,440247,349,5,N,N,-,-1,-1
TWOMEN.txt,440248,440737,489,5,N,N,-,-1,-1
TWOMEN.txt,440738,441444,706,5,N,N,-,-1,-1
TWOMEN.txt,441445,441841,396,5,N,N,-,-1,-1
TWOMEN.txt,441842,442985,1143,5,N,N,-,-1,-1
TWOMEN.txt,442987,443339,352,5,N,N,-,-1,-1
TWOMEN.txt,443340,443922,582,5,N,N,-,-1,-1
TWOMEN.txt,443923,444316,393,5,N,Y,1435577123675,444026,444632
TWOMEN.txt,444317,444903,586,5,N,Y,1435577123675,444026,444632
TWOMEN.txt,444904,445473,569,5,N,N,-,-1,-1
TWOMEN.txt,445474,445596,122,5,N,N,-,-1,-1
TWOMEN.txt,445597,446077,480,5,N,N,-,-1,-1
TWOMEN.txt,446078,446703,625,5,N,N,-,-1,-1
TWOMEN.txt,446704,446996,292,5,N,N,-,-1,-1
TWOMEN.txt,446998,447388,390,5,N,N,-,-1,-1
TWOMEN.txt,447389,447705,316,5,N,N,-,-1,-1
TWOMEN.txt,447707,448321,614,5,N,N,-,-1,-1
TWOMEN.txt,448323,448962,639,5,N,N,-,-1,-1
TWOMEN.txt,448965,449204,239,5,N,N,-,-1,-1
TWOMEN.txt,449205,450112,907,5,N,N,-,-1,-1
TWOMEN.txt,450114,450589,475,5,N,N,-,-1,-1
TWOMEN.txt,450591,451063,472,5,N,N,-,-1,-1
TWOMEN.txt,451066,451228,162,5,N,N,-,-1,-1
TWOMEN.txt,451229,451848,619,5,N,N,-,-1,-1
TWOMEN.txt,451848,452045,197,5,N,N,-,-1,-1
TWOMEN.txt,452046,452242,196,5,N,N,-,-1,-1
TWOMEN.txt,452242,452632,390,5,N,N,-,-1,-1
TWOMEN.txt,452634,453345,711,5,N,N,-,-1,-1
TWOMEN.txt,453347,454100,753,5,N,N,-,-1,-1
TWOMEN.txt,454101,454801,700,5,N,N,-,-1,-1
TWOMEN.txt,454802,455127,325,5,N,N,-,-1,-1
TWOMEN.txt,455129,455346,217,5,N,N,-,-1,-1
TWOMEN.txt,455347,455687,340,5,N,N,-,-1,-1
TWOMEN.txt,455689,456316,627,5,N,N,-,-1,-1
TWOMEN.txt,456317,456843,526,5,N,N,-,-1,-1
TWOMEN.txt,456843,457418,575,5,N,N,-,-1,-1
TWOMEN.txt,457419,457762,343,5,N,N,-,-1,-1
TWOMEN.txt,457763,457899,136,5,N,N,-,-1,-1
TWOMEN.txt,457901,458407,506,5,N,N,-,-1,-1
TWOMEN.txt,458409,459186,777,5,N,N,-,-1,-1
TWOMEN.txt,459187,459739,552,5,N,N,-,-1,-1
TWOMEN.txt,459740,460805,1065,5,N,N,-,-1,-1
TWOMEN.txt,460806,461463,657,5,N,N,-,-1,-1
TWOMEN.txt,461464,462086,622,5,N,N,-,-1,-1
TWOMEN.txt,462087,462776,689,5,N,N,-,-1,-1
TWOMEN.txt,462778,463213,435,5,N,N,-,-1,-1
TWOMEN.txt,463214,463505,291,5,N,N,-,-1,-1
TWOMEN.txt,463507,464442,935,5,N,N,-,-1,-1
TWOMEN.txt,464443,465311,868,5,N,N,-,-1,-1
TWOMEN.txt,465312,465694,382,5,N,N,-,-1,-1
TWOMEN.txt,465695,466216,521,5,N,N,-,-1,-1
TWOMEN.txt,466216,466564,348,5,N,N,-,-1,-1
TWOMEN.txt,466565,467585,1020,5,N,N,-,-1,-1
TWOMEN.txt,467587,468169,582,5,N,N,-,-1,-1
TWOMEN.txt,468171,468616,445,5,N,N,-,-1,-1
TWOMEN.txt,468618,469356,738,5,N,N,-,-1,-1
TWOMEN.txt,469357,469637,280,5,N,N,-,-1,-1
TWOMEN.txt,469639,470005,366,5,N,N,-,-1,-1
TWOMEN.txt,470005,470105,100,5,N,N,-,-1,-1
TWOMEN.txt,470106,470515,409,5,N,N,-,-1,-1
TWOMEN.txt,470516,471494,978,5,N,N,-,-1,-1
TWOMEN.txt,471496,472296,800,5,N,N,-,-1,-1
TWOMEN.txt,472297,473140,843,5,N,N,-,-1,-1
TWOMEN.txt,473141,474017,876,5,N,N,-,-1,-1
TWOMEN.txt,474017,474730,713,5,N,N,-,-1,-1
TWOMEN.txt,474731,475105,374,5,N,N,-,-1,-1
TWOMEN.txt,475106,476094,988,5,N,N,-,-1,-1
TWOMEN.txt,476095,476567,472,5,N,N,-,-1,-1
TWOMEN.txt,476569,477246,677,5,N,N,-,-1,-1
TWOMEN.txt,477247,478088,841,5,N,N,-,-1,-1
TWOMEN.txt,478089,478498,409,5,N,N,-,-1,-1
TWOMEN.txt,478499,478526,27,5,N,N,-,-1,-1
TWOMEN.txt,478527,478806,279,5,N,N,-,-1,-1
TWOMEN.txt,478807,478983,176,5,N,N,-,-1,-1
TWOMEN.txt,478984,479530,546,5,N,N,-,-1,-1
TWOMEN.txt,479534,479945,411,5,N,N,-,-1,-1
TWOMEN.txt,479947,480326,379,5,N,N,-,-1,-1
TWOMEN.txt,480327,480908,581,5,N,N,-,-1,-1
TWOMEN.txt,480911,481206,295,5,N,N,-,-1,-1
TWOMEN.txt,481207,481736,529,5,N,N,-,-1,-1
TWOMEN.txt,481736,481994,258,5,N,N,-,-1,-1
TWOMEN.txt,481996,482490,494,5,N,N,-,-1,-1
TWOMEN.txt,482490,483027,537,5,N,N,-,-1,-1
TWOMEN.txt,483028,483441,413,5,N,N,-,-1,-1
TWOMEN.txt,483442,484018,576,5,N,N,-,-1,-1
TWOMEN.txt,484019,484530,511,5,N,N,-,-1,-1
TWOMEN.txt,484531,484816,285,5,N,N,-,-1,-1
TWOMEN.txt,484819,485365,546,5,N,N,-,-1,-1
TWOMEN.txt,485366,485792,426,5,N,N,-,-1,-1
TWOMEN.txt,485794,486757,963,5,N,N,-,-1,-1
TWOMEN.txt,486758,487613,855,5,N,N,-,-1,-1
TWOMEN.txt,487614,488249,635,5,N,N,-,-1,-1
TWOMEN.txt,488254,488745,491,5,N,N,-,-1,-1
TWOMEN.txt,488746,489325,579,5,N,N,-,-1,-1
TWOMEN.txt,489326,489962,636,5,N,N,-,-1,-1
TWOMEN.txt,489963,490280,317,5,N,N,-,-1,-1
TWOMEN.txt,490281,491456,1175,5,N,N,-,-1,-1
TWOMEN.txt,491457,492132,675,5,N,N,-,-1,-1
TWOMEN.txt,492133,492809,676,5,N,N,-,-1,-1
TWOMEN.txt,492810,493702,892,5,N,N,-,-1,-1
WESLEY.txt,1,1044,1043,5,N,N,-,-1,-1
WESLEY.txt,1045,3981,2936,5,N,N,-,-1,-1
WESLEY.txt,3982,6281,2299,5,N,N,-,-1,-1
WESLEY.txt,6282,9161,2879,5,N,N,-,-1,-1
WESLEY.txt,9162,11330,2168,5,N,N,-,-1,-1
WESLEY.txt,11331,14013,2682,5,N,N,-,-1,-1
WESLEY.txt,14014,14612,598,5,N,N,-,-1,-1
WESLEY.txt,14613,15087,474,5,N,N,-,-1,-1
WESLEY.txt,15088,15427,339,5,N,N,-,-1,-1
WESLEY.txt,15428,16895,1467,5,N,N,-,-1,-1
WESLEY.txt,16896,17593,697,5,N,N,-,-1,-1
WESLEY.txt,17594,18249,655,5,N,N,-,-1,-1
WESLEY.txt,18250,18979,729,5,N,N,-,-1,-1
WESLEY.txt,18980,19695,715,5,N,N,-,-1,-1
WESLEY.txt,19696,20243,547,5,N,N,-,-1,-1
WESLEY.txt,20244,20832,588,5,N,N,-,-1,-1
WESLEY.txt,20833,21355,522,5,N,N,-,-1,-1
WESLEY.txt,21356,22037,681,5,N,N,-,-1,-1
WESLEY.txt,22038,22537,499,5,N,N,-,-1,-1
WESLEY.txt,22538,23027,489,5,N,N,-,-1,-1
WESLEY.txt,23028,23730,702,5,N,N,-,-1,-1
WESLEY.txt,23731,24691,960,5,N,N,-,-1,-1
WESLEY.txt,24692,25858,1166,5,N,N,-,-1,-1
WESLEY.txt,25859,26608,749,5,N,N,-,-1,-1
WESLEY.txt,26609,27796,1187,5,N,N,-,-1,-1
WESLEY.txt,27797,28627,830,5,N,N,-,-1,-1
WESLEY.txt,28628,29124,496,5,N,N,-,-1,-1
WESLEY.txt,29125,29636,511,5,N,N,-,-1,-1
WESLEY.txt,29637,30463,826,5,N,N,-,-1,-1
WESLEY.txt,30464,30892,428,5,N,N,-,-1,-1
WESLEY.txt,30893,31617,724,5,N,N,-,-1,-1
WESLEY.txt,31618,32192,574,5,N,N,-,-1,-1
WESLEY.txt,32193,32697,504,5,N,N,-,-1,-1
WESLEY.txt,32698,33516,818,5,N,N,-,-1,-1
WESLEY.txt,33517,34436,919,5,N,N,-,-1,-1
WESLEY.txt,34437,35212,775,5,N,N,-,-1,-1
WESLEY.txt,35213,35679,466,5,N,N,-,-1,-1
WESLEY.txt,35680,36269,589,5,N,N,-,-1,-1
WESLEY.txt,36270,37279,1009,5,N,N,-,-1,-1
WESLEY.txt,37280,37810,530,5,N,N,-,-1,-1
WESLEY.txt,37811,38241,430,5,N,N,-,-1,-1
WESLEY.txt,38242,38778,536,5,N,N,-,-1,-1
WESLEY.txt,38779,39452,673,5,N,N,-,-1,-1
WESLEY.txt,39453,40591,1138,5,N,N,-,-1,-1
WESLEY.txt,40592,41030,438,5,N,N,-,-1,-1
WESLEY.txt,41031,41696,665,5,N,N,-,-1,-1
WESLEY.txt,41697,42163,466,5,N,N,-,-1,-1
WESLEY.txt,42164,42938,774,5,N,N,-,-1,-1
WESLEY.txt,42939,43626,687,5,N,N,-,-1,-1
WESLEY.txt,43626,44248,622,5,N,N,-,-1,-1
WESLEY.txt,44249,44718,469,5,N,N,-,-1,-1
WESLEY.txt,44719,45312,593,5,N,N,-,-1,-1
WESLEY.txt,45314,46015,701,5,N,N,-,-1,-1
WESLEY.txt,46017,46761,744,5,N,N,-,-1,-1
WESLEY.txt,46762,47192,430,5,N,N,-,-1,-1
WESLEY.txt,47193,47975,782,5,N,N,-,-1,-1
WESLEY.txt,47976,48449,473,5,N,N,-,-1,-1
WESLEY.txt,48450,49191,741,5,N,N,-,-1,-1
WESLEY.txt,49192,49655,463,5,N,N,-,-1,-1
WESLEY.txt,49656,50588,932,5,N,N,-,-1,-1
WESLEY.txt,50589,51242,653,5,N,N,-,-1,-1
WESLEY.txt,51243,51967,724,5,N,N,-,-1,-1
WESLEY.txt,51968,52459,491,5,N,N,-,-1,-1
WESLEY.txt,52460,52903,443,5,N,N,-,-1,-1
WESLEY.txt,52904,53364,460,5,N,N,-,-1,-1
WESLEY.txt,53365,53824,459,5,N,N,-,-1,-1
WESLEY.txt,53825,54590,765,5,N,N,-,-1,-1
WESLEY.txt,54591,55157,566,5,N,N,-,-1,-1
WESLEY.txt,55158,56031,873,5,N,N,-,-1,-1
WESLEY.txt,56032,56800,768,5,N,N,-,-1,-1
WESLEY.txt,56801,57385,584,5,N,N,-,-1,-1
WESLEY.txt,57386,58189,803,5,N,N,-,-1,-1
WESLEY.txt,58190,59563,1373,5,N,N,-,-1,-1
WESLEY.txt,59564,60689,1125,5,N,N,-,-1,-1
WESLEY.txt,60690,61279,589,5,N,N,-,-1,-1
WESLEY.txt,61279,61808,529,5,N,N,-,-1,-1
WESLEY.txt,61809,62061,252,5,N,N,-,-1,-1
WESLEY.txt,62062,62420,358,5,N,N,-,-1,-1
WESLEY.txt,62421,62928,507,5,N,N,-,-1,-1
WESLEY.txt,62929,63529,600,5,N,N,-,-1,-1
WESLEY.txt,63530,63809,279,5,N,N,-,-1,-1
WESLEY.txt,63810,64185,375,5,N,N,-,-1,-1
WESLEY.txt,64186,64693,507,5,N,N,-,-1,-1
WESLEY.txt,64694,64994,300,5,N,N,-,-1,-1
WESLEY.txt,64994,65516,522,5,N,N,-,-1,-1
WESLEY.txt,65517,65827,310,5,N,N,-,-1,-1
WESLEY.txt,65828,66329,501,5,N,N,-,-1,-1
WESLEY.txt,66330,66495,165,5,N,N,-,-1,-1
WESLEY.txt,66496,67108,612,5,N,N,-,-1,-1
WESLEY.txt,67109,67586,477,5,N,N,-,-1,-1
WESLEY.txt,67587,67836,249,5,N,N,-,-1,-1
WESLEY.txt,67837,68186,349,5,N,N,-,-1,-1
WESLEY.txt,68187,68573,386,5,N,N,-,-1,-1
WESLEY.txt,68574,68901,327,5,N,N,-,-1,-1
WESLEY.txt,68902,69257,355,5,N,N,-,-1,-1
WESLEY.txt,69258,69538,280,5,N,N,-,-1,-1
WESLEY.txt,69540,69728,188,5,N,N,-,-1,-1
WESLEY.txt,69729,70209,480,5,N,N,-,-1,-1
WESLEY.txt,70210,70651,441,5,N,N,-,-1,-1
WESLEY.txt,70652,71025,373,5,N,N,-,-1,-1
WESLEY.txt,71026,72322,1296,5,N,N,-,-1,-1
WESLEY.txt,72322,72709,387,5,N,N,-,-1,-1
WESLEY.txt,72710,73261,551,5,N,N,-,-1,-1
WESLEY.txt,73262,74225,963,5,N,N,-,-1,-1
WESLEY.txt,74226,74650,424,5,N,N,-,-1,-1
WESLEY.txt,74650,75028,378,5,N,N,-,-1,-1
WESLEY.txt,75029,75366,337,5,N,N,-,-1,-1
WESLEY.txt,75367,75919,552,5,N,N,-,-1,-1
WESLEY.txt,75920,76291,371,5,N,N,-,-1,-1
WESLEY.txt,76292,76459,167,5,N,N,-,-1,-1
WESLEY.txt,76461,76928,467,5,N,N,-,-1,-1
WESLEY.txt,76929,77302,373,5,N,N,-,-1,-1
WESLEY.txt,77303,77791,488,5,N,N,-,-1,-1
WESLEY.txt,77792,78439,647,5,N,N,-,-1,-1
WESLEY.txt,78440,79080,640,5,N,N,-,-1,-1
WESLEY.txt,79081,79751,670,5,N,N,-,-1,-1
WESLEY.txt,79752,80291,539,5,N,N,-,-1,-1
WESLEY.txt,80292,81194,902,5,N,N,-,-1,-1
WESLEY.txt,81195,81842,647,5,N,N,-,-1,-1
WESLEY.txt,81843,82710,867,5,N,N,-,-1,-1
WESLEY.txt,82711,83101,390,5,N,N,-,-1,-1
WESLEY.txt,83101,83562,461,5,N,N,-,-1,-1
WESLEY.txt,83562,84315,753,5,N,N,-,-1,-1
WESLEY.txt,84316,85161,845,5,N,N,-,-1,-1
WESLEY.txt,85162,85611,449,5,N,N,-,-1,-1
WESLEY.txt,85612,85934,322,5,N,N,-,-1,-1
WESLEY.txt,85935,86684,749,5,N,N,-,-1,-1
WESLEY.txt,86685,86823,138,5,N,N,-,-1,-1
WESLEY.txt,86824,87273,449,5,N,N,-,-1,-1
WESLEY.txt,87273,87676,403,5,N,N,-,-1,-1
WESLEY.txt,87677,88329,652,5,N,N,-,-1,-1
WESLEY.txt,88330,88937,607,5,N,N,-,-1,-1
WESLEY.txt,88938,89649,711,5,N,N,-,-1,-1
WESLEY.txt,89650,90542,892,5,N,N,-,-1,-1
WESLEY.txt,90543,91016,473,5,N,N,-,-1,-1
WESLEY.txt,91017,91167,150,5,N,N,-,-1,-1
WESLEY.txt,91168,91371,203,5,N,N,-,-1,-1
WESLEY.txt,91372,91600,228,5,N,N,-,-1,-1
WESLEY.txt,91601,91947,346,5,N,N,-,-1,-1
WESLEY.txt,91948,92803,855,5,N,N,-,-1,-1
WESLEY.txt,92804,93511,707,5,N,N,-,-1,-1
WESLEY.txt,93512,94503,991,5,N,N,-,-1,-1
WESLEY.txt,94504,95117,613,5,N,N,-,-1,-1
WESLEY.txt,95118,95503,385,5,N,N,-,-1,-1
WESLEY.txt,95504,95948,444,5,N,N,-,-1,-1
WESLEY.txt,95949,96401,452,5,N,N,-,-1,-1
WESLEY.txt,96402,97512,1110,5,N,N,-,-1,-1
WESLEY.txt,97513,98151,638,5,N,N,-,-1,-1
WESLEY.txt,98152,98716,564,5,N,N,-,-1,-1
WESLEY.txt,98716,99485,769,5,N,N,-,-1,-1
WESLEY.txt,99486,99993,507,5,N,N,-,-1,-1
WESLEY.txt,99994,100786,792,5,N,N,-,-1,-1
WESLEY.txt,100787,101151,364,5,N,N,-,-1,-1
WESLEY.txt,101152,101744,592,5,N,N,-,-1,-1
WESLEY.txt,101745,102169,424,5,N,N,-,-1,-1
WESLEY.txt,102170,102423,253,5,N,N,-,-1,-1
WESLEY.txt,102424,102883,459,5,N,N,-,-1,-1
WESLEY.txt,102884,103339,455,5,N,N,-,-1,-1
WESLEY.txt,103340,103886,546,5,N,N,-,-1,-1
WESLEY.txt,103886,104277,391,5,N,N,-,-1,-1
WESLEY.txt,104278,104861,583,5,N,N,-,-1,-1
WESLEY.txt,104862,105184,322,5,N,N,-,-1,-1
WESLEY.txt,105185,105447,262,5,N,N,-,-1,-1
WESLEY.txt,105448,105570,122,5,N,N,-,-1,-1
WESLEY.txt,105571,106382,811,5,N,N,-,-1,-1
WESLEY.txt,106382,107201,819,5,N,N,-,-1,-1
WESLEY.txt,107202,107759,557,5,N,N,-,-1,-1
WESLEY.txt,107760,108287,527,5,N,N,-,-1,-1
WESLEY.txt,108288,108775,487,5,N,N,-,-1,-1
WESLEY.txt,108776,109239,463,5,N,N,-,-1,-1
WESLEY.txt,109240,109779,539,5,N,N,-,-1,-1
WESLEY.txt,109780,110118,338,5,N,N,-,-1,-1
WESLEY.txt,110120,110567,447,5,N,N,-,-1,-1
WESLEY.txt,110568,110895,327,5,N,N,-,-1,-1
WESLEY.txt,110895,111154,259,5,N,N,-,-1,-1
WESLEY.txt,111155,111624,469,5,N,N,-,-1,-1
WESLEY.txt,111625,112136,511,5,N,N,-,-1,-1
WESLEY.txt,112137,112478,341,5,N,N,-,-1,-1
WESLEY.txt,112478,112819,341,5,N,N,-,-1,-1
WESLEY.txt,112820,113517,697,5,N,N,-,-1,-1
WESLEY.txt,113518,113742,224,5,N,N,-,-1,-1
WESLEY.txt,113743,114354,611,5,N,N,-,-1,-1
WESLEY.txt,114355,114631,276,5,N,N,-,-1,-1
WESLEY.txt,114632,115129,497,5,N,N,-,-1,-1
WESLEY.txt,115130,115373,243,5,N,N,-,-1,-1
WESLEY.txt,115374,115759,385,5,N,N,-,-1,-1
WESLEY.txt,115760,116431,671,5,N,N,-,-1,-1
WESLEY.txt,116432,116930,498,5,N,N,-,-1,-1
WESLEY.txt,116931,117692,761,5,N,N,-,-1,-1
WESLEY.txt,117694,118432,738,5,N,N,-,-1,-1
WESLEY.txt,118433,118928,495,5,N,N,-,-1,-1
WESLEY.txt,118929,119305,376,5,N,N,-,-1,-1
WESLEY.txt,119306,120057,751,5,N,N,-,-1,-1
WESLEY.txt,120058,120470,412,5,N,N,-,-1,-1
WESLEY.txt,120471,121040,569,5,N,N,-,-1,-1
WESLEY.txt,121041,121674,633,5,N,N,-,-1,-1
WESLEY.txt,121675,122189,514,5,N,N,-,-1,-1
WESLEY.txt,122190,122711,521,5,N,N,-,-1,-1
WESLEY.txt,122712,123292,580,5,N,N,-,-1,-1
WESLEY.txt,123293,123770,477,5,N,N,-,-1,-1
WESLEY.txt,123771,124651,880,5,N,N,-,-1,-1
WESLEY.txt,124652,125280,628,5,N,N,-,-1,-1
WESLEY.txt,125281,125599,318,5,N,N,-,-1,-1
WESLEY.txt,125600,126000,400,5,N,N,-,-1,-1
WESLEY.txt,126001,126329,328,5,N,N,-,-1,-1
WESLEY.txt,126330,126822,492,5,N,N,-,-1,-1
WESLEY.txt,126823,127127,304,5,N,N,-,-1,-1
WESLEY.txt,127127,127652,525,5,N,N,-,-1,-1
WESLEY.txt,127653,128146,493,5,N,N,-,-1,-1
WESLEY.txt,128147,128758,611,5,N,N,-,-1,-1
WESLEY.txt,128759,129368,609,5,N,N,-,-1,-1
WESLEY.txt,129369,129980,611,5,N,N,-,-1,-1
WESLEY.txt,129981,130274,293,5,N,N,-,-1,-1
WESLEY.txt,130274,130839,565,5,N,N,-,-1,-1
WESLEY.txt,130840,131322,482,5,N,N,-,-1,-1
WESLEY.txt,131323,131906,583,5,N,N,-,-1,-1
WESLEY.txt,131907,132473,566,5,N,N,-,-1,-1
WESLEY.txt,132474,132752,278,5,N,N,-,-1,-1
WESLEY.txt,132753,133113,360,5,N,N,-,-1,-1
WESLEY.txt,133114,133498,384,5,N,N,-,-1,-1
WESLEY.txt,133498,134286,788,5,N,N,-,-1,-1
WESLEY.txt,134287,134600,313,5,N,N,-,-1,-1
WESLEY.txt,134601,135305,704,5,N,N,-,-1,-1
WESLEY.txt,135305,136010,705,5,N,N,-,-1,-1
WESLEY.txt,136010,136353,343,5,N,N,-,-1,-1
WESLEY.txt,136354,137005,651,5,N,N,-,-1,-1
WESLEY.txt,137006,137558,552,5,N,N,-,-1,-1
WESLEY.txt,137558,138501,943,5,N,N,-,-1,-1
WESLEY.txt,138502,139631,1129,5,N,N,-,-1,-1
WESLEY.txt,139632,140458,826,5,N,N,-,-1,-1
WESLEY.txt,140459,141276,817,5,N,N,-,-1,-1
WESLEY.txt,141278,141771,493,5,N,N,-,-1,-1
WESLEY.txt,141772,142629,857,5,N,N,-,-1,-1
WESLEY.txt,142630,143507,877,5,N,N,-,-1,-1
WESLEY.txt,143508,144184,676,5,N,N,-,-1,-1
WESLEY.txt,144185,144834,649,5,N,N,-,-1,-1
WESLEY.txt,144835,145220,385,5,N,N,-,-1,-1
WESLEY.txt,145221,145430,209,5,N,N,-,-1,-1
WESLEY.txt,145431,145902,471,5,N,N,-,-1,-1
WESLEY.txt,145903,146402,499,5,N,N,-,-1,-1
WESLEY.txt,146403,146907,504,5,N,N,-,-1,-1
WESLEY.txt,146908,147573,665,5,N,N,-,-1,-1
WESLEY.txt,147574,148288,714,5,N,N,-,-1,-1
WESLEY.txt,148289,149158,869,5,N,N,-,-1,-1
WESLEY.txt,149159,149646,487,5,N,N,-,-1,-1
WESLEY.txt,149647,150302,655,5,N,N,-,-1,-1
WESLEY.txt,150303,151109,806,5,N,N,-,-1,-1
WESLEY.txt,151110,151729,619,5,N,N,-,-1,-1
WESLEY.txt,151730,152378,648,5,N,N,-,-1,-1
WESLEY.txt,152379,152893,514,5,N,N,-,-1,-1
WESLEY.txt,152894,153163,269,5,N,N,-,-1,-1
WESLEY.txt,153164,153526,362,5,N,N,-,-1,-1
WESLEY.txt,153526,154342,816,5,N,N,-,-1,-1
WESLEY.txt,154343,154854,511,5,N,N,-,-1,-1
WESLEY.txt,154855,155165,310,5,N,N,-,-1,-1
WESLEY.txt,155165,155529,364,5,N,N,-,-1,-1
WESLEY.txt,155530,156061,531,5,N,N,-,-1,-1
WESLEY.txt,156062,156724,662,5,N,N,-,-1,-1
WESLEY.txt,156725,157138,413,5,N,N,-,-1,-1
WESLEY.txt,157139,157851,712,5,N,N,-,-1,-1
WESLEY.txt,157852,158617,765,5,N,N,-,-1,-1
WESLEY.txt,158619,159332,713,5,N,N,-,-1,-1
WESLEY.txt,159333,159650,317,5,N,N,-,-1,-1
WESLEY.txt,159650,160357,707,5,N,N,-,-1,-1
WESLEY.txt,160358,160825,467,5,N,N,-,-1,-1
WESLEY.txt,160826,161281,455,5,N,N,-,-1,-1
WESLEY.txt,161282,161645,363,5,N,N,-,-1,-1
WESLEY.txt,161646,162320,674,5,N,N,-,-1,-1
WESLEY.txt,162321,163052,731,5,N,N,-,-1,-1
WESLEY.txt,163054,163854,800,5,N,N,-,-1,-1
WESLEY.txt,163855,164212,357,5,N,N,-,-1,-1
WESLEY.txt,164212,164751,539,5,N,N,-,-1,-1
WESLEY.txt,164752,165034,282,5,N,N,-,-1,-1
WESLEY.txt,165034,165400,366,5,N,N,-,-1,-1
WESLEY.txt,165401,165645,244,5,N,N,-,-1,-1
WESLEY.txt,165646,165998,352,5,N,N,-,-1,-1
WESLEY.txt,165999,166113,114,5,N,N,-,-1,-1
WESLEY.txt,166114,166220,106,5,N,N,-,-1,-1
WESLEY.txt,166221,166373,152,5,N,N,-,-1,-1
WESLEY.txt,166374,166623,249,5,N,N,-,-1,-1
WESLEY.txt,166624,166857,233,5,N,N,-,-1,-1
WESLEY.txt,166858,166976,118,5,N,N,-,-1,-1
WESLEY.txt,166977,167426,449,5,N,N,-,-1,-1
WESLEY.txt,167426,167870,444,5,N,N,-,-1,-1
WESLEY.txt,167871,168219,348,5,N,N,-,-1,-1
WESLEY.txt,168220,168597,377,5,N,N,-,-1,-1
WESLEY.txt,168598,169117,519,5,N,N,-,-1,-1
WESLEY.txt,169118,169553,435,5,N,N,-,-1,-1
WESLEY.txt,169554,169888,334,5,N,N,-,-1,-1
WESLEY.txt,169889,170171,282,5,N,N,-,-1,-1
WESLEY.txt,170172,170252,80,5,N,N,-,-1,-1
WESLEY.txt,170253,171097,844,5,N,N,-,-1,-1
WESLEY.txt,171098,171456,358,5,N,N,-,-1,-1
WESLEY.txt,171457,171829,372,5,N,N,-,-1,-1
WESLEY.txt,171830,172816,986,5,N,N,-,-1,-1
WESLEY.txt,172817,173347,530,5,N,N,-,-1,-1
WESLEY.txt,173348,173858,510,5,N,N,-,-1,-1
WESLEY.txt,173859,174440,581,5,N,N,-,-1,-1
WESLEY.txt,174441,175085,644,5,N,N,-,-1,-1
WESLEY.txt,175086,175534,448,5,N,N,-,-1,-1
WESLEY.txt,175535,175887,352,5,N,N,-,-1,-1
WESLEY.txt,175888,176389,501,5,N,N,-,-1,-1
WESLEY.txt,176389,177047,658,5,N,N,-,-1,-1
WESLEY.txt,177047,177553,506,5,N,N,-,-1,-1
WESLEY.txt,177554,178048,494,5,N,N,-,-1,-1
WESLEY.txt,178048,178691,643,5,N,N,-,-1,-1
WESLEY.txt,178691,179494,803,5,N,N,-,-1,-1
WESLEY.txt,179496,179741,245,5,N,N,-,-1,-1
WESLEY.txt,179742,179986,244,5,N,N,-,-1,-1
WESLEY.txt,179986,180514,528,5,N,N,-,-1,-1
WESLEY.txt,180515,181156,641,5,N,N,-,-1,-1
WESLEY.txt,181157,181418,261,5,N,N,-,-1,-1
WESLEY.txt,181419,182033,614,5,N,N,-,-1,-1
WESLEY.txt,182034,182632,598,5,N,N,-,-1,-1
WESLEY.txt,182633,182978,345,5,N,N,-,-1,-1
WESLEY.txt,182979,183603,624,5,N,N,-,-1,-1
WESLEY.txt,183604,184074,470,5,N,N,-,-1,-1
WESLEY.txt,184075,184485,410,5,N,N,-,-1,-1
WESLEY.txt,184486,184899,413,5,N,N,-,-1,-1
WESLEY.txt,184901,185486,585,5,N,N,-,-1,-1
WESLEY.txt,185487,185909,422,5,N,N,-,-1,-1
WESLEY.txt,185910,186487,577,5,N,N,-,-1,-1
WESLEY.txt,186488,186982,494,5,N,N,-,-1,-1
WESLEY.txt,186982,187356,374,5,N,N,-,-1,-1
WESLEY.txt,187357,187812,455,5,N,N,-,-1,-1
WESLEY.txt,187813,188474,661,5,N,N,-,-1,-1
WESLEY.txt,188475,188953,478,5,N,N,-,-1,-1
WESLEY.txt,188954,189683,729,5,N,N,-,-1,-1
WESLEY.txt,189683,190198,515,5,N,N,-,-1,-1
WESLEY.txt,190199,190471,272,5,N,N,-,-1,-1
WESLEY.txt,190472,190816,344,5,N,N,-,-1,-1
WESLEY.txt,190817,191326,509,5,N,N,-,-1,-1
WESLEY.txt,191327,191629,302,5,N,N,-,-1,-1
WESLEY.txt,191630,192392,762,5,N,N,-,-1,-1
WESLEY.txt,192393,193052,659,5,N,N,-,-1,-1
WESLEY.txt,193053,193582,529,5,N,N,-,-1,-1
WESLEY.txt,193583,194287,704,5,N,N,-,-1,-1
WESLEY.txt,194288,195114,826,5,N,N,-,-1,-1
WESLEY.txt,195114,195905,791,5,N,N,-,-1,-1
WESLEY.txt,195906,196631,725,5,N,N,-,-1,-1
WESLEY.txt,196631,197050,419,5,N,N,-,-1,-1
WESLEY.txt,197051,197730,679,5,N,N,-,-1,-1
WESLEY.txt,197731,198187,456,5,N,N,-,-1,-1
WESLEY.txt,198187,198633,446,5,N,N,-,-1,-1
WESLEY.txt,198634,199061,427,5,N,N,-,-1,-1
WESLEY.txt,199062,199744,682,5,N,N,-,-1,-1
WESLEY.txt,199745,200217,472,5,N,N,-,-1,-1
WESLEY.txt,200218,200927,709,5,N,N,-,-1,-1
WESLEY.txt,200928,201386,458,5,N,N,-,-1,-1
WESLEY.txt,201387,201948,561,5,N,N,-,-1,-1
WESLEY.txt,201949,202197,248,5,N,N,-,-1,-1
WESLEY.txt,202198,202536,338,5,N,N,-,-1,-1
WESLEY.txt,202537,203262,725,5,N,N,-,-1,-1
WESLEY.txt,203263,203827,564,5,N,N,-,-1,-1
WESLEY.txt,203828,204161,333,5,N,N,-,-1,-1
WESLEY.txt,204162,204687,525,5,N,N,-,-1,-1
WESLEY.txt,204688,205138,450,5,N,N,-,-1,-1
WESLEY.txt,205139,205833,694,5,N,N,-,-1,-1
WESLEY.txt,205834,206557,723,5,N,N,-,-1,-1
WESLEY.txt,206558,206831,273,5,N,N,-,-1,-1
WESLEY.txt,206832,207353,521,5,N,N,-,-1,-1
WESLEY.txt,207353,208272,919,5,N,N,-,-1,-1
WESLEY.txt,208273,208897,624,5,N,N,-,-1,-1
WESLEY.txt,208898,210331,1433,5,N,N,-,-1,-1
WESLEY.txt,210332,210942,610,5,N,N,-,-1,-1
WESLEY.txt,210944,211680,736,5,N,N,-,-1,-1
WESLEY.txt,211681,212161,480,5,N,N,-,-1,-1
WESLEY.txt,212163,212620,457,5,N,N,-,-1,-1
WESLEY.txt,212621,212960,339,5,N,N,-,-1,-1
WESLEY.txt,212961,213355,394,5,N,N,-,-1,-1
WESLEY.txt,213356,214360,1004,5,N,N,-,-1,-1
WESLEY.txt,214361,215281,920,5,N,N,-,-1,-1
WESLEY.txt,215282,215900,618,5,N,N,-,-1,-1
WESLEY.txt,215901,216978,1077,5,N,N,-,-1,-1
WESLEY.txt,216979,217884,905,5,N,N,-,-1,-1
WESLEY.txt,217885,218794,909,5,N,N,-,-1,-1
WESLEY.txt,218795,219580,785,5,N,N,-,-1,-1
WESLEY.txt,219581,220556,975,5,N,N,-,-1,-1
WESLEY.txt,220557,221269,712,5,N,N,-,-1,-1
WESLEY.txt,221270,222446,1176,5,N,N,-,-1,-1
WESLEY.txt,222447,223395,948,5,N,N,-,-1,-1
WESLEY.txt,223396,224077,681,5,N,N,-,-1,-1
WESLEY.txt,224078,224980,902,5,N,N,-,-1,-1
WESLEY.txt,224981,225886,905,5,N,N,-,-1,-1
WESLEY.txt,225887,226418,531,5,N,N,-,-1,-1
WESLEY.txt,226419,226908,489,5,N,N,-,-1,-1
WESLEY.txt,226909,227645,736,5,N,N,-,-1,-1
WESLEY.txt,227646,228294,648,5,N,N,-,-1,-1
WESLEY.txt,228295,228721,426,5,N,N,-,-1,-1
WESLEY.txt,228722,229419,697,5,N,N,-,-1,-1
WESLEY.txt,229419,229819,400,5,N,N,-,-1,-1
WESLEY.txt,229820,230284,464,5,N,N,-,-1,-1
WESLEY.txt,230285,230757,472,5,N,N,-,-1,-1
WESLEY.txt,230757,231278,521,5,N,N,-,-1,-1
WESLEY.txt,231279,231778,499,5,N,N,-,-1,-1
WESLEY.txt,231779,232061,282,5,N,N,-,-1,-1
WESLEY.txt,232062,232259,197,5,N,N,-,-1,-1
WESLEY.txt,232260,232577,317,5,N,N,-,-1,-1
WESLEY.txt,232578,232937,359,5,N,N,-,-1,-1
WESLEY.txt,232938,233381,443,5,N,N,-,-1,-1
WESLEY.txt,233382,234156,774,5,N,N,-,-1,-1
WESLEY.txt,234157,234484,327,5,N,N,-,-1,-1
WESLEY.txt,234484,234903,419,5,N,N,-,-1,-1
WESLEY.txt,234904,235558,654,5,N,N,-,-1,-1
WESLEY.txt,235560,236124,564,5,N,N,-,-1,-1
WESLEY.txt,236124,236814,690,5,N,N,-,-1,-1
WESLEY.txt,236815,237097,282,5,N,N,-,-1,-1
WESLEY.txt,237098,237661,563,5,N,N,-,-1,-1
WESLEY.txt,237662,238296,634,5,N,N,-,-1,-1
WESLEY.txt,238297,238827,530,5,N,N,-,-1,-1
WESLEY.txt,238828,239279,451,5,N,N,-,-1,-1
WESLEY.txt,239280,239610,330,5,N,N,-,-1,-1
WESLEY.txt,239611,240170,559,5,N,N,-,-1,-1
WESLEY.txt,240171,241042,871,5,N,N,-,-1,-1
WESLEY.txt,241043,241385,342,5,N,N,-,-1,-1
WESLEY.txt,241386,241643,257,5,N,N,-,-1,-1
WESLEY.txt,241644,241952,308,5,N,N,-,-1,-1
WESLEY.txt,241954,242374,420,5,N,Y,1432378713402,242169,242662
WESLEY.txt,242375,243179,804,5,N,Y,1432378713402,242169,242662
WESLEY.txt,243180,243752,572,5,N,N,-,-1,-1
WESLEY.txt,243753,244303,550,5,N,N,-,-1,-1
WESLEY.txt,244304,244671,367,5,N,N,-,-1,-1
WESLEY.txt,244672,245316,644,5,N,N,-,-1,-1
WESLEY.txt,245317,245576,259,5,N,N,-,-1,-1
WESLEY.txt,245577,245918,341,5,N,N,-,-1,-1
WESLEY.txt,245919,246506,587,5,N,Y,1432379217690,245991,246965
WESLEY.txt,246507,247207,700,5,N,Y,1432379217690,245991,246965
WESLEY.txt,247208,248018,810,5,N,N,-,-1,-1
WESLEY.txt,248019,248663,644,5,N,N,-,-1,-1
WESLEY.txt,248664,249138,474,5,N,N,-,-1,-1
WESLEY.txt,249140,249622,482,5,N,N,-,-1,-1
WESLEY.txt,249623,249897,274,5,N,N,-,-1,-1
WESLEY.txt,249898,250284,386,5,N,N,-,-1,-1
WESLEY.txt,250284,250826,542,5,N,N,-,-1,-1
WESLEY.txt,250827,251297,470,5,N,N,-,-1,-1
WESLEY.txt,251298,251703,405,5,N,N,-,-1,-1
WESLEY.txt,251704,252163,459,5,N,N,-,-1,-1
WESLEY.txt,252164,252577,413,5,N,N,-,-1,-1
WESLEY.txt,252578,252877,299,5,N,N,-,-1,-1
WESLEY.txt,252878,253217,339,5,N,N,-,-1,-1
WESLEY.txt,253218,253740,522,5,N,N,-,-1,-1
WESLEY.txt,253741,254426,685,5,N,N,-,-1,-1
WESLEY.txt,254427,254672,245,5,N,N,-,-1,-1
WESLEY.txt,254674,255163,489,5,N,N,-,-1,-1
WESLEY.txt,255164,255688,524,5,N,N,-,-1,-1
WESLEY.txt,255689,256644,955,5,N,N,-,-1,-1
WESLEY.txt,256645,257067,422,5,N,N,-,-1,-1
WESLEY.txt,257068,257988,920,5,N,N,-,-1,-1
WESLEY.txt,257989,258877,888,5,N,N,-,-1,-1
WESLEY.txt,258878,259244,366,5,N,N,-,-1,-1
WESLEY.txt,259245,259810,565,5,N,N,-,-1,-1
WESLEY.txt,259811,260594,783,5,N,N,-,-1,-1
WESLEY.txt,260595,260897,302,5,N,N,-,-1,-1
WESLEY.txt,260898,261318,420,5,N,N,-,-1,-1
WESLEY.txt,261319,262844,1525,5,N,N,-,-1,-1
WESLEY.txt,262845,263579,734,5,N,N,-,-1,-1
WESLEY.txt,263580,264378,798,5,N,N,-,-1,-1
WESLEY.txt,264379,264665,286,5,N,N,-,-1,-1
WESLEY.txt,264665,265409,744,5,N,N,-,-1,-1
WESLEY.txt,265410,265949,539,5,N,N,-,-1,-1
WESLEY.txt,265950,266435,485,5,N,N,-,-1,-1
WESLEY.txt,266436,267007,571,5,N,N,-,-1,-1
WESLEY.txt,267008,267484,476,5,N,N,-,-1,-1
WESLEY.txt,267485,267766,281,5,N,N,-,-1,-1
WESLEY.txt,267766,267940,174,5,N,N,-,-1,-1
WESLEY.txt,267941,268556,615,5,N,N,-,-1,-1
WESLEY.txt,268557,268986,429,5,N,N,-,-1,-1
WESLEY.txt,268987,269557,570,5,N,N,-,-1,-1
WESLEY.txt,269558,270025,467,5,N,N,-,-1,-1
WESLEY.txt,270026,270502,476,5,N,N,-,-1,-1
WESLEY.txt,270503,271002,499,5,N,N,-,-1,-1
WESLEY.txt,271003,271861,858,5,N,N,-,-1,-1
WESLEY.txt,271862,272248,386,5,N,N,-,-1,-1
WESLEY.txt,272249,273187,938,5,N,N,-,-1,-1
WESLEY.txt,273188,273693,505,5,N,N,-,-1,-1
WESLEY.txt,273694,273960,266,5,N,N,-,-1,-1
WESLEY.txt,273961,274429,468,5,N,N,-,-1,-1
WESLEY.txt,274430,274698,268,5,N,N,-,-1,-1
WESLEY.txt,274699,275087,388,5,N,N,-,-1,-1
WESLEY.txt,275088,275547,459,5,N,N,-,-1,-1
WESLEY.txt,275547,276118,571,5,N,N,-,-1,-1
WESLEY.txt,276119,276724,605,5,N,N,-,-1,-1
WESLEY.txt,276726,277274,548,5,N,N,-,-1,-1
WESLEY.txt,277275,277718,443,5,N,N,-,-1,-1
WESLEY.txt,277719,278072,353,5,N,N,-,-1,-1
WESLEY.txt,278073,278419,346,5,N,N,-,-1,-1
WESLEY.txt,278420,278847,427,5,N,N,-,-1,-1
WESLEY.txt,278848,279089,241,5,N,N,-,-1,-1
WESLEY.txt,279090,279545,455,5,N,N,-,-1,-1
WESLEY.txt,279546,279885,339,5,N,N,-,-1,-1
WESLEY.txt,279886,280485,599,5,N,N,-,-1,-1
WESLEY.txt,280486,281187,701,5,N,N,-,-1,-1
WESLEY.txt,281188,281424,236,5,N,N,-,-1,-1
WESLEY.txt,281425,281820,395,5,N,N,-,-1,-1
WESLEY.txt,281821,282175,354,5,N,N,-,-1,-1
WESLEY.txt,282176,282498,322,5,N,N,-,-1,-1
WESLEY.txt,282499,282945,446,5,N,N,-,-1,-1
WESLEY.txt,282946,283182,236,5,N,N,-,-1,-1
WESLEY.txt,283183,283632,449,5,N,N,-,-1,-1
WESLEY.txt,283633,283898,265,5,N,N,-,-1,-1
WESLEY.txt,283899,284022,123,5,N,N,-,-1,-1
WESLEY.txt,284023,284673,650,5,N,N,-,-1,-1
WESLEY.txt,284674,285680,1006,5,N,N,-,-1,-1
WESLEY.txt,285681,286173,492,5,N,N,-,-1,-1
WESLEY.txt,286174,286580,406,5,N,N,-,-1,-1
WESLEY.txt,286581,287273,692,5,N,N,-,-1,-1
WESLEY.txt,287274,287795,521,5,N,N,-,-1,-1
WESLEY.txt,287796,288511,715,5,N,N,-,-1,-1
WESLEY.txt,288511,288887,376,5,N,N,-,-1,-1
WESLEY.txt,288888,289249,361,5,N,N,-,-1,-1
WESLEY.txt,289250,289835,585,5,N,N,-,-1,-1
WESLEY.txt,289836,290178,342,5,N,N,-,-1,-1
WESLEY.txt,290178,290515,337,5,N,N,-,-1,-1
WESLEY.txt,290516,290968,452,5,N,N,-,-1,-1
WESLEY.txt,290969,291269,300,5,N,N,-,-1,-1
WESLEY.txt,291270,291771,501,5,N,N,-,-1,-1
WESLEY.txt,291772,292215,443,5,N,N,-,-1,-1
WESLEY.txt,292216,292777,561,5,N,N,-,-1,-1
WESLEY.txt,292778,293598,820,5,N,N,-,-1,-1
WESLEY.txt,293599,294041,442,5,N,N,-,-1,-1
WESLEY.txt,294042,294411,369,5,N,N,-,-1,-1
WESLEY.txt,294412,294863,451,5,N,N,-,-1,-1
WESLEY.txt,294864,295325,461,5,N,N,-,-1,-1
WESLEY.txt,295326,296054,728,5,N,N,-,-1,-1
WESLEY.txt,296055,296530,475,5,N,N,-,-1,-1
WESLEY.txt,296531,297062,531,5,N,N,-,-1,-1
WESLEY.txt,297063,297996,933,5,N,N,-,-1,-1
WESLEY.txt,297997,298550,553,5,N,N,-,-1,-1
WESLEY.txt,298551,299120,569,5,N,N,-,-1,-1
WESLEY.txt,299120,299880,760,5,N,N,-,-1,-1
WESLEY.txt,299881,300582,701,5,N,N,-,-1,-1
WESLEY.txt,300583,300974,391,5,N,N,-,-1,-1
WESLEY.txt,300975,301543,568,5,N,N,-,-1,-1
WESLEY.txt,301544,302144,600,5,N,N,-,-1,-1
WESLEY.txt,302145,302712,567,5,N,N,-,-1,-1
WESLEY.txt,302713,303220,507,5,N,N,-,-1,-1
WESLEY.txt,303221,303603,382,5,N,N,-,-1,-1
WESLEY.txt,303604,303944,340,5,N,N,-,-1,-1
WESLEY.txt,303945,304438,493,5,N,N,-,-1,-1
WESLEY.txt,304440,304754,314,5,N,N,-,-1,-1
WESLEY.txt,304755,305288,533,5,N,N,-,-1,-1
WESLEY.txt,305289,305670,381,5,N,N,-,-1,-1
WESLEY.txt,305671,306090,419,5,N,N,-,-1,-1
WESLEY.txt,306091,306451,360,5,N,N,-,-1,-1
WESLEY.txt,306452,306918,466,5,N,N,-,-1,-1
WESLEY.txt,306919,307392,473,5,N,N,-,-1,-1
WESLEY.txt,307393,308047,654,5,N,N,-,-1,-1
WESLEY.txt,308048,308406,358,5,N,N,-,-1,-1
WESLEY.txt,308406,308800,394,5,N,N,-,-1,-1
WESLEY.txt,308801,309311,510,5,N,N,-,-1,-1
WESLEY.txt,309311,309691,380,5,N,N,-,-1,-1
WESLEY.txt,309692,310197,505,5,N,N,-,-1,-1
WESLEY.txt,310197,310486,289,5,N,N,-,-1,-1
WESLEY.txt,310488,310870,382,5,N,N,-,-1,-1
WESLEY.txt,310871,311544,673,5,N,N,-,-1,-1
WESLEY.txt,311545,311969,424,5,N,N,-,-1,-1
WESLEY.txt,311970,312511,541,5,N,N,-,-1,-1
WESLEY.txt,312512,312860,348,5,N,N,-,-1,-1
WESLEY.txt,312861,313401,540,5,N,N,-,-1,-1
WESLEY.txt,313402,313725,323,5,N,N,-,-1,-1
WESLEY.txt,313725,314087,362,5,N,N,-,-1,-1
WESLEY.txt,314088,314391,303,5,N,N,-,-1,-1
WESLEY.txt,314392,314762,370,5,N,N,-,-1,-1
WESLEY.txt,314763,315181,418,5,N,N,-,-1,-1
WESLEY.txt,315183,315791,608,5,N,N,-,-1,-1
WESLEY.txt,315792,316233,441,5,N,Y,1433324150625,315900,316317
WESLEY.txt,316234,316824,590,5,N,Y,1433324150625,315900,316317
WESLEY.txt,316826,317389,563,5,N,N,-,-1,-1
WESLEY.txt,317390,317745,355,5,N,N,-,-1,-1
WESLEY.txt,317747,318326,579,5,N,N,-,-1,-1
WESLEY.txt,318326,318738,412,5,N,N,-,-1,-1
WESLEY.txt,318739,319210,471,5,N,N,-,-1,-1
WESLEY.txt,319211,319974,763,5,N,N,-,-1,-1
WESLEY.txt,319975,320824,849,5,N,N,-,-1,-1
WESLEY.txt,320825,320968,143,5,N,N,-,-1,-1
WESLEY.txt,320969,321509,540,5,N,N,-,-1,-1
WESLEY.txt,321510,322171,661,5,N,N,-,-1,-1
WESLEY.txt,322172,322461,289,5,N,N,-,-1,-1
WESLEY.txt,322462,322916,454,5,N,N,-,-1,-1
WESLEY.txt,322917,323285,368,5,N,N,-,-1,-1
WESLEY.txt,323285,323854,569,5,N,N,-,-1,-1
WESLEY.txt,323855,324508,653,5,N,N,-,-1,-1
WESLEY.txt,324509,325014,505,5,N,N,-,-1,-1
WESLEY.txt,325015,325406,391,5,N,N,-,-1,-1
WESLEY.txt,325407,325806,399,5,N,N,-,-1,-1
WESLEY.txt,325807,326372,565,5,N,N,-,-1,-1
WESLEY.txt,326373,326813,440,5,N,N,-,-1,-1
WESLEY.txt,326814,327103,289,5,N,N,-,-1,-1
WESLEY.txt,327104,327505,401,5,N,N,-,-1,-1
WESLEY.txt,327506,328122,616,5,N,N,-,-1,-1
WESLEY.txt,328123,328394,271,5,N,N,-,-1,-1
WESLEY.txt,328395,328800,405,5,N,N,-,-1,-1
WESLEY.txt,328800,329311,511,5,N,N,-,-1,-1
WESLEY.txt,329311,329712,401,5,N,N,-,-1,-1
WESLEY.txt,329713,329976,263,5,N,N,-,-1,-1
WESLEY.txt,329977,330388,411,5,N,N,-,-1,-1
WESLEY.txt,330389,330920,531,5,N,N,-,-1,-1
WESLEY.txt,330921,332197,1276,5,N,N,-,-1,-1
WESLEY.txt,332198,332923,725,5,N,N,-,-1,-1
WESLEY.txt,332924,334000,1076,5,N,N,-,-1,-1
WESLEY.txt,334001,334524,523,5,N,N,-,-1,-1
WESLEY.txt,334525,335102,577,5,N,N,-,-1,-1
WESLEY.txt,335103,335504,401,5,N,N,-,-1,-1
WESLEY.txt,335505,336166,661,5,N,N,-,-1,-1
WESLEY.txt,336167,336797,630,5,N,N,-,-1,-1
WESLEY.txt,336798,337417,619,5,N,N,-,-1,-1
WESLEY.txt,337418,338005,587,5,N,N,-,-1,-1
WESLEY.txt,338006,338424,418,5,N,N,-,-1,-1
WESLEY.txt,338425,338942,517,5,N,N,-,-1,-1
WESLEY.txt,338943,339274,331,5,N,N,-,-1,-1
WESLEY.txt,339275,339683,408,5,N,N,-,-1,-1
WESLEY.txt,339684,340027,343,5,N,N,-,-1,-1
WESLEY.txt,340027,340503,476,5,N,N,-,-1,-1
WESLEY.txt,340504,340877,373,5,N,N,-,-1,-1
WESLEY.txt,340878,341060,182,5,N,N,-,-1,-1
WESLEY.txt,341061,341370,309,5,N,N,-,-1,-1
WESLEY.txt,341371,341719,348,5,N,N,-,-1,-1
WESLEY.txt,341720,342243,523,5,N,N,-,-1,-1
WESLEY.txt,342244,342759,515,5,N,N,-,-1,-1
WESLEY.txt,342760,343265,505,5,N,N,-,-1,-1
WESLEY.txt,343267,343734,467,5,N,N,-,-1,-1
WESLEY.txt,343735,344287,552,5,N,N,-,-1,-1
WESLEY.txt,344288,344686,398,5,N,N,-,-1,-1
WESLEY.txt,344687,344911,224,5,N,N,-,-1,-1
WESLEY.txt,344912,345341,429,5,N,N,-,-1,-1
WESLEY.txt,345342,345695,353,5,N,N,-,-1,-1
WESLEY.txt,345695,346040,345,5,N,N,-,-1,-1
WESLEY.txt,346040,346491,451,5,N,N,-,-1,-1
WESLEY.txt,346492,346999,507,5,N,N,-,-1,-1
WESLEY.txt,347000,347434,434,5,N,N,-,-1,-1
WESLEY.txt,347435,348289,854,5,N,N,-,-1,-1
WESLEY.txt,348289,348719,430,5,N,N,-,-1,-1
WESLEY.txt,348720,349023,303,5,N,N,-,-1,-1
WESLEY.txt,349024,349400,376,5,N,N,-,-1,-1
WESLEY.txt,349401,349910,509,5,N,N,-,-1,-1
WESLEY.txt,349911,350331,420,5,N,N,-,-1,-1
WESLEY.txt,350332,350886,554,5,N,N,-,-1,-1
WESLEY.txt,350887,351461,574,5,N,N,-,-1,-1
WESLEY.txt,351462,351789,327,5,N,N,-,-1,-1
WESLEY.txt,351790,352259,469,5,N,N,-,-1,-1
WESLEY.txt,352260,352686,426,5,N,N,-,-1,-1
WESLEY.txt,352687,353043,356,5,N,N,-,-1,-1
WESLEY.txt,353044,353696,652,5,N,N,-,-1,-1
WESLEY.txt,353697,354194,497,5,N,N,-,-1,-1
WESLEY.txt,354195,354909,714,5,N,N,-,-1,-1
WESLEY.txt,354910,355177,267,5,N,N,-,-1,-1
WESLEY.txt,355178,355663,485,5,N,N,-,-1,-1
WESLEY.txt,355664,356047,383,5,N,N,-,-1,-1
WESLEY.txt,356048,356721,673,5,N,N,-,-1,-1
WESLEY.txt,356722,357083,361,5,N,N,-,-1,-1
WESLEY.txt,357084,357614,530,5,N,N,-,-1,-1
WESLEY.txt,357615,357990,375,5,N,N,-,-1,-1
WESLEY.txt,357990,358588,598,5,N,N,-,-1,-1
WESLEY.txt,358589,358960,371,5,N,N,-,-1,-1
WESLEY.txt,358961,359338,377,5,N,N,-,-1,-1
WESLEY.txt,359340,359782,442,5,N,N,-,-1,-1
WESLEY.txt,359782,360458,676,5,N,N,-,-1,-1
WESLEY.txt,360459,360869,410,5,N,N,-,-1,-1
WESLEY.txt,360870,361494,624,5,N,N,-,-1,-1
WESLEY.txt,361495,362021,526,5,N,N,-,-1,-1
WESLEY.txt,362022,362393,371,5,N,N,-,-1,-1
WESLEY.txt,362394,363123,729,5,N,N,-,-1,-1
WESLEY.txt,363124,363574,450,5,N,N,-,-1,-1
WESLEY.txt,363575,364161,586,5,N,N,-,-1,-1
WESLEY.txt,364162,364528,366,5,N,N,-,-1,-1
WESLEY.txt,364529,364862,333,5,N,N,-,-1,-1
WESLEY.txt,364863,365555,692,5,N,N,-,-1,-1
WESLEY.txt,365556,365970,414,5,N,N,-,-1,-1
WESLEY.txt,365971,366173,202,5,N,N,-,-1,-1
WESLEY.txt,366175,366497,322,5,N,N,-,-1,-1
WESLEY.txt,366498,366900,402,5,N,N,-,-1,-1
WESLEY.txt,366901,367532,631,5,N,Y,1435058414135,367148,369648
WESLEY.txt,367534,367798,264,5,N,Y,1435058414135,367148,369648
WESLEY.txt,367799,368279,480,5,N,Y,1435058414135,367148,369648
WESLEY.txt,368280,368893,613,5,N,Y,1435058414135,367148,369648
WESLEY.txt,368894,369982,1088,5,N,Y,1435058414135,367148,369648
WESLEY.txt,369983,370405,422,5,N,N,-,-1,-1
WESLEY.txt,370406,371039,633,5,N,N,-,-1,-1
WESLEY.txt,371040,371638,598,5,N,N,-,-1,-1
WESLEY.txt,371639,372272,633,5,N,N,-,-1,-1
WESLEY.txt,372273,372636,363,5,N,N,-,-1,-1
WESLEY.txt,372637,373275,638,5,N,N,-,-1,-1
WESLEY.txt,373275,373663,388,5,N,N,-,-1,-1
WESLEY.txt,373664,374178,514,5,N,N,-,-1,-1
WESLEY.txt,374179,374834,655,5,N,N,-,-1,-1
WESLEY.txt,374834,375399,565,5,N,N,-,-1,-1
WESLEY.txt,375400,375860,460,5,N,N,-,-1,-1
WESLEY.txt,375861,376293,432,5,N,N,-,-1,-1
WESLEY.txt,376294,376806,512,5,N,N,-,-1,-1
WESLEY.txt,376807,377350,543,5,N,N,-,-1,-1
WESLEY.txt,377351,377779,428,5,N,N,-,-1,-1
WESLEY.txt,377780,378372,592,5,N,N,-,-1,-1
WESLEY.txt,378373,378698,325,5,N,N,-,-1,-1
WESLEY.txt,378699,379202,503,5,N,N,-,-1,-1
WESLEY.txt,379203,379792,589,5,N,N,-,-1,-1
WESLEY.txt,379793,380256,463,5,N,N,-,-1,-1
WESLEY.txt,380257,380509,252,5,N,N,-,-1,-1
WESLEY.txt,380510,380783,273,5,N,N,-,-1,-1
WESLEY.txt,380784,381222,438,5,N,N,-,-1,-1
WESLEY.txt,381223,381665,442,5,N,N,-,-1,-1
WESLEY.txt,381666,381906,240,5,N,N,-,-1,-1
WESLEY.txt,381907,382234,327,5,N,N,-,-1,-1
WESLEY.txt,382235,382535,300,5,N,N,-,-1,-1
WESLEY.txt,382536,382986,450,5,N,N,-,-1,-1
WESLEY.txt,382986,383394,408,5,N,N,-,-1,-1
WESLEY.txt,383395,383745,350,5,N,N,-,-1,-1
WESLEY.txt,383746,384002,256,5,N,N,-,-1,-1
WESLEY.txt,384003,384516,513,5,N,N,-,-1,-1
WESLEY.txt,384517,385113,596,5,N,N,-,-1,-1
WESLEY.txt,385114,385697,583,5,N,N,-,-1,-1
WESLEY.txt,385699,385875,176,5,N,N,-,-1,-1
WESLEY.txt,385876,386503,627,5,N,N,-,-1,-1
WESLEY.txt,386504,386967,463,5,N,N,-,-1,-1
WESLEY.txt,386968,387630,662,5,N,N,-,-1,-1
WESLEY.txt,387631,388158,527,5,N,N,-,-1,-1
WESLEY.txt,388158,388703,545,5,N,N,-,-1,-1
WESLEY.txt,388704,389083,379,5,N,N,-,-1,-1
WESLEY.txt,389084,389583,499,5,N,N,-,-1,-1
WESLEY.txt,389584,390079,495,5,N,N,-,-1,-1
WESLEY.txt,390080,390521,441,5,N,N,-,-1,-1
WESLEY.txt,390522,390756,234,5,N,N,-,-1,-1
WESLEY.txt,390757,391339,582,5,N,N,-,-1,-1
WESLEY.txt,391340,391779,439,5,N,N,-,-1,-1
WESLEY.txt,391780,392339,559,5,N,N,-,-1,-1
WESLEY.txt,392340,393111,771,5,N,N,-,-1,-1
WESLEY.txt,393112,393607,495,5,N,N,-,-1,-1
WESLEY.txt,393608,393863,255,5,N,N,-,-1,-1
WESLEY.txt,393864,394300,436,5,N,N,-,-1,-1
WESLEY.txt,394300,394872,572,5,N,N,-,-1,-1
WESLEY.txt,394873,395314,441,5,N,N,-,-1,-1
WESLEY.txt,395315,395941,626,5,N,N,-,-1,-1
WESLEY.txt,395942,396579,637,5,N,N,-,-1,-1
WESLEY.txt,396580,397035,455,5,N,N,-,-1,-1
WESLEY.txt,397036,397436,400,5,N,N,-,-1,-1
WESLEY.txt,397437,397836,399,5,N,N,-,-1,-1
WESLEY.txt,397837,398305,468,5,N,N,-,-1,-1
WESLEY.txt,398306,398736,430,5,N,N,-,-1,-1
WESLEY.txt,398736,399582,846,5,N,N,-,-1,-1
WESLEY.txt,399583,399893,310,5,N,N,-,-1,-1
WESLEY.txt,399894,400248,354,5,N,N,-,-1,-1
WESLEY.txt,400249,400712,463,5,N,N,-,-1,-1
WESLEY.txt,400713,401405,692,5,N,N,-,-1,-1
WESLEY.txt,401406,401761,355,5,N,N,-,-1,-1
WESLEY.txt,401762,402125,363,5,N,N,-,-1,-1
WESLEY.txt,402126,402501,375,5,N,N,-,-1,-1
WESLEY.txt,402501,402810,309,5,N,N,-,-1,-1
WESLEY.txt,402811,403145,334,5,N,N,-,-1,-1
WESLEY.txt,403146,403598,452,5,N,N,-,-1,-1
WESLEY.txt,403599,404236,637,5,N,N,-,-1,-1
WESLEY.txt,404237,404591,354,5,N,N,-,-1,-1
WESLEY.txt,404592,405092,500,5,N,N,-,-1,-1
WESLEY.txt,405093,405437,344,5,N,N,-,-1,-1
WESLEY.txt,405438,405939,501,5,N,N,-,-1,-1
WESLEY.txt,405940,406347,407,5,N,N,-,-1,-1
WESLEY.txt,406348,406743,395,5,N,N,-,-1,-1
WESLEY.txt,406743,407127,384,5,N,N,-,-1,-1
WESLEY.txt,407129,407732,603,5,N,N,-,-1,-1
WESLEY.txt,407733,408456,723,5,N,N,-,-1,-1
WESLEY.txt,408457,408890,433,5,N,N,-,-1,-1
WESLEY.txt,408890,409309,419,5,N,N,-,-1,-1
WESLEY.txt,409309,409735,426,5,N,N,-,-1,-1
WESLEY.txt,409737,410094,357,5,N,N,-,-1,-1
WESLEY.txt,410094,410798,704,5,N,N,-,-1,-1
WESLEY.txt,410799,411272,473,5,N,N,-,-1,-1
WESLEY.txt,411273,411904,631,5,N,N,-,-1,-1
WESLEY.txt,411905,412381,476,5,N,N,-,-1,-1
WESLEY.txt,412381,412882,501,5,N,N,-,-1,-1
WESLEY.txt,412883,413654,771,5,N,N,-,-1,-1
WESLEY.txt,413655,414095,440,5,N,N,-,-1,-1
WESLEY.txt,414096,414663,567,5,N,N,-,-1,-1
WESLEY.txt,414664,415155,491,5,N,N,-,-1,-1
WESLEY.txt,415156,415436,280,5,N,N,-,-1,-1
WESLEY.txt,415437,415905,468,5,N,N,-,-1,-1
WESLEY.txt,415907,416770,863,5,N,N,-,-1,-1
WESLEY.txt,416771,417353,582,5,N,N,-,-1,-1
WESLEY.txt,417354,417817,463,5,N,N,-,-1,-1
WESLEY.txt,417818,418528,710,5,N,N,-,-1,-1
WESLEY.txt,418529,419124,595,5,N,N,-,-1,-1
WESLEY.txt,419125,419761,636,5,N,N,-,-1,-1
WESLEY.txt,419762,420030,268,5,N,N,-,-1,-1
WESLEY.txt,420031,420645,614,5,N,N,-,-1,-1
WESLEY.txt,420646,420936,290,5,N,N,-,-1,-1
WESLEY.txt,420936,421308,372,5,N,N,-,-1,-1
WESLEY.txt,421308,421663,355,5,N,N,-,-1,-1
WESLEY.txt,421664,422131,467,5,N,N,-,-1,-1
WESLEY.txt,422132,422501,369,5,N,N,-,-1,-1
WESLEY.txt,422501,422972,471,5,N,N,-,-1,-1
WESLEY.txt,422973,423498,525,5,N,N,-,-1,-1
WESLEY.txt,423499,423985,486,5,N,N,-,-1,-1
WESLEY.txt,423986,424302,316,5,N,N,-,-1,-1
WESLEY.txt,424303,424556,253,5,N,N,-,-1,-1
WESLEY.txt,424557,424898,341,5,N,N,-,-1,-1
WESLEY.txt,424899,425192,293,5,N,N,-,-1,-1
WESLEY.txt,425193,425766,573,5,N,N,-,-1,-1
WESLEY.txt,425767,426214,447,5,N,N,-,-1,-1
WESLEY.txt,426215,426851,636,5,N,N,-,-1,-1
WESLEY.txt,426852,427309,457,5,N,N,-,-1,-1
WESLEY.txt,427310,427575,265,5,N,N,-,-1,-1
WESLEY.txt,427576,427909,333,5,N,N,-,-1,-1
WESLEY.txt,427910,428111,201,5,N,N,-,-1,-1
WESLEY.txt,428112,428527,415,5,N,N,-,-1,-1
WESLEY.txt,428527,428938,411,5,N,N,-,-1,-1
WESLEY.txt,428939,429268,329,5,N,N,-,-1,-1
WESLEY.txt,429269,429686,417,5,N,N,-,-1,-1
WESLEY.txt,429687,430140,453,5,N,N,-,-1,-1
WESLEY.txt,430141,430664,523,5,N,N,-,-1,-1
WESLEY.txt,430665,431562,897,5,N,N,-,-1,-1
WESLEY.txt,431563,432024,461,5,N,N,-,-1,-1
WESLEY.txt,432025,432389,364,5,N,N,-,-1,-1
WESLEY.txt,432390,432882,492,5,N,N,-,-1,-1
WESLEY.txt,432883,433286,403,5,N,N,-,-1,-1
WESLEY.txt,433287,434254,967,5,N,N,-,-1,-1
WESLEY.txt,434255,434706,451,5,N,N,-,-1,-1
WESLEY.txt,434707,435010,303,5,N,N,-,-1,-1
WESLEY.txt,435011,435572,561,5,N,N,-,-1,-1
WESLEY.txt,435573,436016,443,5,N,N,-,-1,-1
WESLEY.txt,436016,436699,683,5,N,N,-,-1,-1
WESLEY.txt,436700,437363,663,5,N,N,-,-1,-1
WESLEY.txt,437364,437900,536,5,N,N,-,-1,-1
WESLEY.txt,437900,438359,459,5,N,N,-,-1,-1
WESLEY.txt,438360,438875,515,5,N,N,-,-1,-1
WESLEY.txt,438876,439491,615,5,N,N,-,-1,-1
WESLEY.txt,439493,440041,548,5,N,N,-,-1,-1
WESLEY.txt,440042,440291,249,5,N,N,-,-1,-1
WESLEY.txt,440292,440645,353,5,N,N,-,-1,-1
WESLEY.txt,440645,440992,347,5,N,N,-,-1,-1
WESLEY.txt,440993,441373,380,5,N,N,-,-1,-1
WESLEY.txt,441374,441737,363,5,N,N,-,-1,-1
WESLEY.txt,441738,442046,308,5,N,N,-,-1,-1
WESLEY.txt,442047,442346,299,5,N,N,-,-1,-1
WESLEY.txt,442347,442889,542,5,N,N,-,-1,-1
WESLEY.txt,442890,443324,434,5,N,N,-,-1,-1
WESLEY.txt,443324,443791,467,5,N,N,-,-1,-1
WESLEY.txt,443792,444156,364,5,N,N,-,-1,-1
WESLEY.txt,444157,444837,680,5,N,N,-,-1,-1
WESLEY.txt,444838,445319,481,5,N,N,-,-1,-1
WESLEY.txt,445320,445857,537,5,N,N,-,-1,-1
WESLEY.txt,445858,446007,149,5,N,N,-,-1,-1
WESLEY.txt,446008,446391,383,5,N,N,-,-1,-1
WESLEY.txt,446393,446775,382,5,N,N,-,-1,-1
WESLEY.txt,446776,447152,376,5,N,N,-,-1,-1
WESLEY.txt,447153,447427,274,5,N,N,-,-1,-1
WESLEY.txt,447428,447884,456,5,N,N,-,-1,-1
WESLEY.txt,447885,448417,532,5,N,N,-,-1,-1
WESLEY.txt,448418,448823,405,5,N,N,-,-1,-1
WESLEY.txt,448824,449351,527,5,N,N,-,-1,-1
WESLEY.txt,449352,449818,466,5,N,N,-,-1,-1
WESLEY.txt,449820,450278,458,5,N,N,-,-1,-1
WESLEY.txt,450280,450717,437,5,N,N,-,-1,-1
WESLEY.txt,450717,451154,437,5,N,N,-,-1,-1
WESLEY.txt,451155,451816,661,5,N,N,-,-1,-1
WESLEY.txt,451817,452327,510,5,N,N,-,-1,-1
WESLEY.txt,452328,452869,541,5,N,N,-,-1,-1
WESLEY.txt,452870,453710,840,5,N,N,-,-1,-1
WESLEY.txt,453711,454078,367,5,N,N,-,-1,-1
WESLEY.txt,454079,454789,710,5,N,N,-,-1,-1
WESLEY.txt,454790,455327,537,5,N,N,-,-1,-1
WESLEY.txt,455327,455703,376,5,N,N,-,-1,-1
WESLEY.txt,455704,456118,414,5,N,N,-,-1,-1
WESLEY.txt,456119,456371,252,5,N,N,-,-1,-1
WESLEY.txt,456371,456749,378,5,N,N,-,-1,-1
WESLEY.txt,456750,457140,390,5,N,N,-,-1,-1
WESLEY.txt,457141,457738,597,5,N,N,-,-1,-1
WESLEY.txt,457739,458237,498,5,N,N,-,-1,-1
WESLEY.txt,458238,458601,363,5,N,N,-,-1,-1
WESLEY.txt,458602,458956,354,5,N,N,-,-1,-1
WESLEY.txt,458956,459377,421,5,N,N,-,-1,-1
WESLEY.txt,459378,459877,499,5,N,N,-,-1,-1
WESLEY.txt,459877,460901,1024,5,N,N,-,-1,-1
WESLEY.txt,460902,461506,604,5,N,N,-,-1,-1
WESLEY.txt,461507,462012,505,5,N,N,-,-1,-1
WESLEY.txt,462012,462453,441,5,N,N,-,-1,-1
WESLEY.txt,462454,462998,544,5,N,N,-,-1,-1
WESLEY.txt,462999,463577,578,5,N,N,-,-1,-1
WESLEY.txt,463578,464007,429,5,N,N,-,-1,-1
WESLEY.txt,464008,464392,384,5,N,N,-,-1,-1
WESLEY.txt,464393,465018,625,5,N,N,-,-1,-1
WESLEY.txt,465019,465531,512,5,N,N,-,-1,-1
WESLEY.txt,465532,465959,427,5,N,N,-,-1,-1
WESLEY.txt,465960,466352,392,5,N,N,-,-1,-1
WESLEY.txt,466353,466958,605,5,N,N,-,-1,-1
WESLEY.txt,466959,467617,658,5,N,N,-,-1,-1
WESLEY.txt,467618,467981,363,5,N,N,-,-1,-1
WESLEY.txt,467982,468351,369,5,N,N,-,-1,-1
WESLEY.txt,468352,468942,590,5,N,N,-,-1,-1
WESLEY.txt,468943,469138,195,5,N,N,-,-1,-1
WESLEY.txt,469139,469728,589,5,N,N,-,-1,-1
WESLEY.txt,469729,470089,360,5,N,N,-,-1,-1
WESLEY.txt,470090,470649,559,5,N,N,-,-1,-1
WESLEY.txt,470650,470993,343,5,N,N,-,-1,-1
WESLEY.txt,470994,471460,466,5,N,N,-,-1,-1
WESLEY.txt,471461,472020,559,5,N,N,-,-1,-1
WESLEY.txt,472021,472327,306,5,N,N,-,-1,-1
WESLEY.txt,472328,472736,408,5,N,N,-,-1,-1
WESLEY.txt,472737,473152,415,5,N,N,-,-1,-1
WESLEY.txt,473153,473613,460,5,N,N,-,-1,-1
WESLEY.txt,473614,474137,523,5,N,N,-,-1,-1
WESLEY.txt,474138,474673,535,5,N,N,-,-1,-1
WESLEY.txt,474674,475202,528,5,N,N,-,-1,-1
WESLEY.txt,475203,475957,754,5,N,N,-,-1,-1
WESLEY.txt,475957,476463,506,5,N,N,-,-1,-1
WESLEY.txt,476464,476837,373,5,N,N,-,-1,-1
WESLEY.txt,476838,477169,331,5,N,N,-,-1,-1
WESLEY.txt,477169,477906,737,5,N,N,-,-1,-1
WESLEY.txt,477907,478240,333,5,N,N,-,-1,-1
WESLEY.txt,478241,478688,447,5,N,N,-,-1,-1
WESLEY.txt,478689,479232,543,5,N,N,-,-1,-1
WESLEY.txt,479233,479764,531,5,N,N,-,-1,-1
WESLEY.txt,479765,480457,692,5,N,N,-,-1,-1
WESLEY.txt,480458,480966,508,5,N,Y,1435062319127,480703,480943
WESLEY.txt,480966,481372,406,5,N,N,-,-1,-1
WESLEY.txt,481373,481861,488,5,N,N,-,-1,-1
WESLEY.txt,481862,482464,602,5,N,N,-,-1,-1
WESLEY.txt,482464,483085,621,5,N,N,-,-1,-1
WESLEY.txt,483086,483496,410,5,N,N,-,-1,-1
WESLEY.txt,483497,483849,352,5,N,N,-,-1,-1
WESLEY.txt,483850,484201,351,5,N,N,-,-1,-1
WESLEY.txt,484202,484840,638,5,N,N,-,-1,-1
WESLEY.txt,484841,485120,279,5,N,N,-,-1,-1
WESLEY.txt,485121,485985,864,5,N,N,-,-1,-1
WESLEY.txt,485986,486534,548,5,N,N,-,-1,-1
WESLEY.txt,486535,487005,470,5,N,N,-,-1,-1
WESLEY.txt,487006,487576,570,5,N,N,-,-1,-1
WESLEY.txt,487577,488041,464,5,N,N,-,-1,-1
WESLEY.txt,488042,488517,475,5,N,N,-,-1,-1
WESLEY.txt,488518,488900,382,5,N,N,-,-1,-1
WESLEY.txt,488901,489253,352,5,N,N,-,-1,-1
WESLEY.txt,489254,489685,431,5,N,N,-,-1,-1
WESLEY.txt,489686,490115,429,5,N,N,-,-1,-1
WESLEY.txt,490116,490588,472,5,N,N,-,-1,-1
WESLEY.txt,490589,491089,500,5,N,N,-,-1,-1
WESLEY.txt,491089,491564,475,5,N,N,-,-1,-1
WESLEY.txt,491565,491941,376,5,N,N,-,-1,-1
WESLEY.txt,491942,492375,433,5,N,N,-,-1,-1
WESLEY.txt,492376,492725,349,5,N,N,-,-1,-1
WESLEY.txt,492726,493348,622,5,N,N,-,-1,-1
WESLEY.txt,493349,493741,392,5,N,N,-,-1,-1
WESLEY.txt,493742,494598,856,5,N,Y,1435062617921,494000,496406
WESLEY.txt,494599,495078,479,5,N,Y,1435062617921,494000,496406
WESLEY.txt,495079,495752,673,5,N,Y,1435062617921,494000,496406
WESLEY.txt,495753,495967,214,5,N,Y,1435062617921,494000,496406
WESLEY.txt,495968,496128,160,5,N,Y,1435062617921,494000,496406
WESLEY.txt,496129,496528,399,5,N,Y,1435062617921,494000,496406
WESLEY.txt,496528,497026,498,5,N,N,-,-1,-1
WESLEY.txt,497027,497725,698,5,N,N,-,-1,-1
WESLEY.txt,497726,498138,412,5,N,N,-,-1,-1
WESLEY.txt,498139,498760,621,5,N,N,-,-1,-1
WESLEY.txt,498761,499382,621,5,N,N,-,-1,-1
WESLEY.txt,499382,499754,372,5,N,N,-,-1,-1
WESLEY.txt,499755,500032,277,5,N,N,-,-1,-1
WESLEY.txt,500033,500408,375,5,N,N,-,-1,-1
WESLEY.txt,500409,500794,385,5,N,N,-,-1,-1
WESLEY.txt,500794,501204,410,5,N,N,-,-1,-1
WESLEY.txt,501205,501988,783,5,N,N,-,-1,-1
WESLEY.txt,501989,502569,580,5,N,N,-,-1,-1
WESLEY.txt,502570,503068,498,5,N,N,-,-1,-1
WESLEY.txt,503069,503460,391,5,N,N,-,-1,-1
WESLEY.txt,503461,503968,507,5,N,N,-,-1,-1
WESLEY.txt,503969,505085,1116,5,N,N,-,-1,-1
WESLEY.txt,505086,505591,505,5,N,N,-,-1,-1
WESLEY.txt,505592,506021,429,5,N,N,-,-1,-1
WESLEY.txt,506021,506673,652,5,N,N,-,-1,-1
WESLEY.txt,506674,507062,388,5,N,N,-,-1,-1
WESLEY.txt,507062,507765,703,5,N,N,-,-1,-1
WESLEY.txt,507766,508376,610,5,N,N,-,-1,-1
WESLEY.txt,508377,508990,613,5,N,N,-,-1,-1
WESLEY.txt,508991,509546,555,5,N,N,-,-1,-1
WESLEY.txt,509547,510017,470,5,N,N,-,-1,-1
WESLEY.txt,510018,510671,653,5,N,N,-,-1,-1
WESLEY.txt,510672,511110,438,5,N,N,-,-1,-1
WESLEY.txt,511111,511399,288,5,N,N,-,-1,-1
WESLEY.txt,511400,511908,508,5,N,N,-,-1,-1
WESLEY.txt,511909,512380,471,5,N,N,-,-1,-1
WESLEY.txt,512381,512870,489,5,N,N,-,-1,-1
WESLEY.txt,512870,513173,303,5,N,N,-,-1,-1
WESLEY.txt,513174,513757,583,5,N,N,-,-1,-1
WESLEY.txt,513758,514133,375,5,N,N,-,-1,-1
WESLEY.txt,514134,514674,540,5,N,N,-,-1,-1
WESLEY.txt,514675,515202,527,5,N,N,-,-1,-1
WESLEY.txt,515203,515628,425,5,N,N,-,-1,-1
WESLEY.txt,515629,516009,380,5,N,N,-,-1,-1
WESLEY.txt,516010,516431,421,5,N,N,-,-1,-1
WESLEY.txt,516431,517093,662,5,N,N,-,-1,-1
WESLEY.txt,517094,517600,506,5,N,N,-,-1,-1
WESLEY.txt,517601,518490,889,5,N,N,-,-1,-1
WESLEY.txt,518491,519046,555,5,N,N,-,-1,-1
WESLEY.txt,519047,519312,265,5,N,N,-,-1,-1
WESLEY.txt,519313,519721,408,5,N,N,-,-1,-1
WESLEY.txt,519722,520053,331,5,N,N,-,-1,-1
WESLEY.txt,520054,520419,365,5,N,N,-,-1,-1
WESLEY.txt,520420,521051,631,5,N,N,-,-1,-1
WESLEY.txt,521052,521431,379,5,N,N,-,-1,-1
WESLEY.txt,521432,522015,583,5,N,N,-,-1,-1
WESLEY.txt,522016,522531,515,5,N,N,-,-1,-1
WESLEY.txt,522532,522914,382,5,N,N,-,-1,-1
WESLEY.txt,522915,523289,374,5,N,N,-,-1,-1
WESLEY.txt,523290,523859,569,5,N,N,-,-1,-1
WESLEY.txt,523860,524282,422,5,N,N,-,-1,-1
WESLEY.txt,524283,524885,602,5,N,N,-,-1,-1
WESLEY.txt,524885,525370,485,5,N,N,-,-1,-1
WESLEY.txt,525371,525826,455,5,N,N,-,-1,-1
WESLEY.txt,525827,526225,398,5,N,N,-,-1,-1
WESLEY.txt,526226,526742,516,5,N,N,-,-1,-1
WESLEY.txt,526743,527210,467,5,N,N,-,-1,-1
WESLEY.txt,527211,527459,248,5,N,N,-,-1,-1
WESLEY.txt,527460,528171,711,5,N,N,-,-1,-1
WESLEY.txt,528172,528627,455,5,N,N,-,-1,-1
WESLEY.txt,528628,529117,489,5,N,N,-,-1,-1
WESLEY.txt,529118,529681,563,5,N,N,-,-1,-1
WESLEY.txt,529682,530109,427,5,N,N,-,-1,-1
WESLEY.txt,530110,530727,617,5,N,N,-,-1,-1
WESLEY.txt,530728,531147,419,5,N,N,-,-1,-1
WESLEY.txt,531148,531651,503,5,N,N,-,-1,-1
WESLEY.txt,531652,532001,349,5,N,N,-,-1,-1
WESLEY.txt,532001,532512,511,5,N,N,-,-1,-1
WESLEY.txt,532512,533252,740,5,N,N,-,-1,-1
WESLEY.txt,533253,533733,480,5,N,N,-,-1,-1
WESLEY.txt,533734,534433,699,5,N,N,-,-1,-1
WESLEY.txt,534434,534851,417,5,N,N,-,-1,-1
WESLEY.txt,534852,535323,471,5,N,N,-,-1,-1
WESLEY.txt,535324,535838,514,5,N,N,-,-1,-1
WESLEY.txt,535839,536068,229,5,N,N,-,-1,-1
WESLEY.txt,536069,536523,454,5,N,N,-,-1,-1
WESLEY.txt,536524,536961,437,5,N,Y,1435063028928,536935,537559
WESLEY.txt,536961,537305,344,5,N,Y,1435063028928,536935,537559
WESLEY.txt,537306,537685,379,5,N,Y,1435063028928,536935,537559
WESLEY.txt,537685,537992,307,5,N,N,-,-1,-1
WESLEY.txt,537993,538614,621,5,N,N,-,-1,-1
WESLEY.txt,538615,539122,507,5,N,N,-,-1,-1
WESLEY.txt,539123,539815,692,5,N,N,-,-1,-1
WESLEY.txt,539816,540513,697,5,N,N,-,-1,-1
WESLEY.txt,540514,540889,375,5,N,N,-,-1,-1
WESLEY.txt,540890,541418,528,5,N,N,-,-1,-1
WESLEY.txt,541419,541924,505,5,N,N,-,-1,-1
WESLEY.txt,541925,542654,729,5,N,N,-,-1,-1
WESLEY.txt,542655,543340,685,5,N,N,-,-1,-1
WESLEY.txt,543341,543904,563,5,N,N,-,-1,-1
WESLEY.txt,543905,544453,548,5,N,N,-,-1,-1
WESLEY.txt,544454,545049,595,5,N,N,-,-1,-1
WESLEY.txt,545050,545672,622,5,N,N,-,-1,-1
WESLEY.txt,545673,546096,423,5,N,N,-,-1,-1
WESLEY.txt,546097,546380,283,5,N,N,-,-1,-1
WESLEY.txt,546381,547030,649,5,N,N,-,-1,-1
WESLEY.txt,547031,547572,541,5,N,N,-,-1,-1
WESLEY.txt,547573,548118,545,5,N,N,-,-1,-1
WESLEY.txt,548119,548575,456,5,N,N,-,-1,-1
WESLEY.txt,548576,548900,324,5,N,N,-,-1,-1
WESLEY.txt,548901,549306,405,5,N,N,-,-1,-1
WESLEY.txt,549307,549815,508,5,N,N,-,-1,-1
WESLEY.txt,549816,550094,278,5,N,N,-,-1,-1
WESLEY.txt,550095,550761,666,5,N,N,-,-1,-1
WESLEY.txt,550762,551176,414,5,N,N,-,-1,-1
WESLEY.txt,551177,551800,623,5,N,N,-,-1,-1
WESLEY.txt,551801,552186,385,5,N,N,-,-1,-1
WESLEY.txt,552187,552575,388,5,N,N,-,-1,-1
WESLEY.txt,552576,553233,657,5,N,N,-,-1,-1
WESLEY.txt,553234,553669,435,5,N,N,-,-1,-1
WESLEY.txt,553670,554179,509,5,N,N,-,-1,-1
WESLEY.txt,554180,554943,763,5,N,N,-,-1,-1
WESLEY.txt,554944,555431,487,5,N,N,-,-1,-1
WESLEY.txt,555432,555943,511,5,N,N,-,-1,-1
WESLEY.txt,555944,556266,322,5,N,N,-,-1,-1
WESLEY.txt,556267,556668,401,5,N,N,-,-1,-1
WESLEY.txt,556669,557254,585,5,N,N,-,-1,-1
WESLEY.txt,557255,557702,447,5,N,N,-,-1,-1
WESLEY.txt,557702,557912,210,5,N,N,-,-1,-1
WESLEY.txt,557913,558598,685,5,N,N,-,-1,-1
WESLEY.txt,558599,559037,438,5,N,N,-,-1,-1
WESLEY.txt,559038,559353,315,5,N,N,-,-1,-1
WESLEY.txt,559354,559931,577,5,N,N,-,-1,-1
WESLEY.txt,559932,560510,578,5,N,Y,1435063804274,560047,562154
WESLEY.txt,560511,560846,335,5,N,Y,1435063804274,560047,562154
WESLEY.txt,560847,561500,653,5,N,Y,1435063804274,560047,562154
WESLEY.txt,561501,561914,413,5,N,Y,1435063804274,560047,562154
WESLEY.txt,561915,562277,362,5,N,Y,1435063804274,560047,562154
WESLEY.txt,562277,562807,530,5,N,N,-,-1,-1
WESLEY.txt,562808,563593,785,5,N,N,-,-1,-1
WESLEY.txt,563594,564353,759,5,N,N,-,-1,-1
WESLEY.txt,564354,564896,542,5,N,N,-,-1,-1
WESLEY.txt,564897,565584,687,5,N,N,-,-1,-1
WESLEY.txt,565585,565941,356,5,N,N,-,-1,-1
WESLEY.txt,565942,566353,411,5,N,N,-,-1,-1
WESLEY.txt,566354,566765,411,5,N,N,-,-1,-1
WESLEY.txt,566766,567283,517,5,N,N,-,-1,-1
WESLEY.txt,567283,567762,479,5,N,N,-,-1,-1
WESLEY.txt,567763,568144,381,5,N,N,-,-1,-1
WESLEY.txt,568145,568545,400,5,N,N,-,-1,-1
WESLEY.txt,568546,569046,500,5,N,N,-,-1,-1
WESLEY.txt,569047,569232,185,5,N,N,-,-1,-1
WESLEY.txt,569233,569501,268,5,N,N,-,-1,-1
WESLEY.txt,569502,570006,504,5,N,N,-,-1,-1
WESLEY.txt,570007,570467,460,5,N,N,-,-1,-1
WESLEY.txt,570468,570860,392,5,N,N,-,-1,-1
WESLEY.txt,570861,571086,225,5,N,N,-,-1,-1
WESLEY.txt,571087,571706,619,5,N,N,-,-1,-1
WESLEY.txt,571707,571998,291,5,N,N,-,-1,-1
WESLEY.txt,571999,572524,525,5,N,N,-,-1,-1
WESLEY.txt,572525,572975,450,5,N,N,-,-1,-1
WESLEY.txt,572976,573622,646,5,N,N,-,-1,-1
WESLEY.txt,573623,574201,578,5,N,N,-,-1,-1
WESLEY.txt,574202,574743,541,5,N,N,-,-1,-1
WESLEY.txt,574744,575299,555,5,N,N,-,-1,-1
WESLEY.txt,575300,575801,501,5,N,N,-,-1,-1
WESLEY.txt,575802,576154,352,5,N,N,-,-1,-1
WESLEY.txt,576155,576542,387,5,N,N,-,-1,-1
WESLEY.txt,576543,576984,441,5,N,N,-,-1,-1
WESLEY.txt,576985,577402,417,5,N,N,-,-1,-1
WESLEY.txt,577403,578091,688,5,N,N,-,-1,-1
WESLEY.txt,578092,578340,248,5,N,N,-,-1,-1
WESLEY.txt,578341,578707,366,5,N,N,-,-1,-1
WESLEY.txt,578707,579545,838,5,N,N,-,-1,-1
WESLEY.txt,579546,579824,278,5,N,N,-,-1,-1
WESLEY.txt,579825,580239,414,5,N,N,-,-1,-1
WESLEY.txt,580240,580519,279,5,N,N,-,-1,-1
WESLEY.txt,580519,580925,406,5,N,N,-,-1,-1
WESLEY.txt,580926,581236,310,5,N,N,-,-1,-1
WESLEY.txt,581236,581960,724,5,N,N,-,-1,-1
WESLEY.txt,581961,582442,481,5,N,N,-,-1,-1
WESLEY.txt,582443,583072,629,5,N,N,-,-1,-1
WESLEY.txt,583073,583505,432,5,N,N,-,-1,-1
WESLEY.txt,583506,584091,585,5,N,N,-,-1,-1
WESLEY.txt,584092,584632,540,5,N,N,-,-1,-1
WESLEY.txt,584633,585067,434,5,N,N,-,-1,-1
WESLEY.txt,585068,585603,535,5,N,N,-,-1,-1
WESLEY.txt,585604,586264,660,5,N,N,-,-1,-1
WESLEY.txt,586265,586719,454,5,N,N,-,-1,-1
WESLEY.txt,586720,587210,490,5,N,N,-,-1,-1
WESLEY.txt,587211,587553,342,5,N,N,-,-1,-1
WESLEY.txt,587554,588192,638,5,N,N,-,-1,-1
WESLEY.txt,588193,588717,524,5,N,N,-,-1,-1
WESLEY.txt,588718,589145,427,5,N,N,-,-1,-1
WESLEY.txt,589146,589603,457,5,N,N,-,-1,-1
WESLEY.txt,589604,589968,364,5,N,N,-,-1,-1
WESLEY.txt,589969,590295,326,5,N,N,-,-1,-1
WESLEY.txt,590296,590594,298,5,N,N,-,-1,-1
WESLEY.txt,590595,591030,435,5,N,N,-,-1,-1
WESLEY.txt,591031,591482,451,5,N,N,-,-1,-1
WESLEY.txt,591483,592193,710,5,N,N,-,-1,-1
WESLEY.txt,592194,592705,511,5,N,N,-,-1,-1
WESLEY.txt,592706,593324,618,5,N,N,-,-1,-1
WESLEY.txt,593325,594006,681,5,N,N,-,-1,-1
WESLEY.txt,594007,594582,575,5,N,N,-,-1,-1
WESLEY.txt,594583,595051,468,5,N,N,-,-1,-1
WESLEY.txt,595052,595629,577,5,N,N,-,-1,-1
WESLEY.txt,595629,596059,430,5,N,N,-,-1,-1
WESLEY.txt,596060,596581,521,5,N,N,-,-1,-1
WESLEY.txt,596582,597344,762,5,N,N,-,-1,-1
WESLEY.txt,597345,597957,612,5,N,N,-,-1,-1
WESLEY.txt,597958,598383,425,5,N,N,-,-1,-1
WESLEY.txt,598383,599009,626,5,N,N,-,-1,-1
WESLEY.txt,599010,599583,573,5,N,N,-,-1,-1
WESLEY.txt,599584,600075,491,5,N,N,-,-1,-1
WESLEY.txt,600076,600477,401,5,N,N,-,-1,-1
WESLEY.txt,600478,600903,425,5,N,N,-,-1,-1
WESLEY.txt,600904,601249,345,5,N,N,-,-1,-1
WESLEY.txt,601249,601818,569,5,N,N,-,-1,-1
WESLEY.txt,601819,602208,389,5,N,N,-,-1,-1
WESLEY.txt,602209,602937,728,5,N,N,-,-1,-1
WESLEY.txt,602938,603382,444,5,N,N,-,-1,-1
WESLEY.txt,603383,603752,369,5,N,N,-,-1,-1
WESLEY.txt,603752,604194,442,5,N,N,-,-1,-1
WESLEY.txt,604195,604362,167,5,N,N,-,-1,-1
WESLEY.txt,604363,604875,512,5,N,N,-,-1,-1
WESLEY.txt,604876,605193,317,5,N,N,-,-1,-1
WESLEY.txt,605194,606142,948,5,N,N,-,-1,-1
WESLEY.txt,606143,606854,711,5,N,N,-,-1,-1
WESLEY.txt,606855,607355,500,5,N,N,-,-1,-1
WESLEY.txt,607356,607959,603,5,N,N,-,-1,-1
WESLEY.txt,607960,608478,518,5,N,N,-,-1,-1
WESLEY.txt,608479,609027,548,5,N,N,-,-1,-1
WESLEY.txt,609028,609458,430,5,N,N,-,-1,-1
WESLEY.txt,609458,609915,457,5,N,N,-,-1,-1
WESLEY.txt,609916,610159,243,5,N,N,-,-1,-1
WESLEY.txt,610160,610802,642,5,N,N,-,-1,-1
WESLEY.txt,610803,611163,360,5,N,N,-,-1,-1
WESLEY.txt,611164,611680,516,5,N,N,-,-1,-1
WESLEY.txt,611681,612186,505,5,N,N,-,-1,-1
WESLEY.txt,612187,612446,259,5,N,N,-,-1,-1
WESLEY.txt,612447,613019,572,5,N,N,-,-1,-1
WESLEY.txt,613020,613365,345,5,N,N,-,-1,-1
WESLEY.txt,613366,613736,370,5,N,N,-,-1,-1
WESLEY.txt,613737,614461,724,5,N,N,-,-1,-1
WESLEY.txt,614461,614711,250,5,N,N,-,-1,-1
WESLEY.txt,614712,615164,452,5,N,N,-,-1,-1
WESLEY.txt,615165,615507,342,5,N,N,-,-1,-1
WESLEY.txt,615508,615890,382,5,N,N,-,-1,-1
WESLEY.txt,615891,616296,405,5,N,N,-,-1,-1
WESLEY.txt,616296,617030,734,5,N,N,-,-1,-1
WESLEY.txt,617031,618079,1048,5,N,N,-,-1,-1
WESLEY.txt,618080,618382,302,5,N,N,-,-1,-1
WESLEY.txt,618383,618765,382,5,N,N,-,-1,-1
WESLEY.txt,618766,619105,339,5,N,N,-,-1,-1
WESLEY.txt,619106,619833,727,5,N,N,-,-1,-1
WESLEY.txt,619834,620418,584,5,N,N,-,-1,-1
WESLEY.txt,620419,620884,465,5,N,N,-,-1,-1
WESLEY.txt,620885,621392,507,5,N,N,-,-1,-1
WESLEY.txt,621393,621985,592,5,N,N,-,-1,-1
WESLEY.txt,621986,622369,383,5,N,N,-,-1,-1
WESLEY.txt,622370,622852,482,5,N,N,-,-1,-1
WESLEY.txt,622853,623481,628,5,N,N,-,-1,-1
WESLEY.txt,623482,623885,403,5,N,N,-,-1,-1
WESLEY.txt,623886,624154,268,5,N,N,-,-1,-1
WESLEY.txt,624155,624749,594,5,N,N,-,-1,-1
WESLEY.txt,624749,625193,444,5,N,N,-,-1,-1
WESLEY.txt,625194,625511,317,5,N,N,-,-1,-1
WESLEY.txt,625512,625826,314,5,N,N,-,-1,-1
WESLEY.txt,625827,626414,587,5,N,N,-,-1,-1
WESLEY.txt,626414,626732,318,5,N,N,-,-1,-1
WESLEY.txt,626733,627229,496,5,N,N,-,-1,-1
WESLEY.txt,627230,627626,396,5,N,N,-,-1,-1
WESLEY.txt,627627,627928,301,5,N,N,-,-1,-1
WESLEY.txt,627929,628178,249,5,N,N,-,-1,-1
WESLEY.txt,628179,628692,513,5,N,N,-,-1,-1
WESLEY.txt,628692,629049,357,5,N,N,-,-1,-1
WESLEY.txt,629050,629500,450,5,N,N,-,-1,-1
WESLEY.txt,629501,629952,451,5,N,N,-,-1,-1
WESLEY.txt,629953,630208,255,5,N,N,-,-1,-1
WESLEY.txt,630209,630767,558,5,N,N,-,-1,-1
WESLEY.txt,630768,631078,310,5,N,N,-,-1,-1
WESLEY.txt,631079,631708,629,5,N,N,-,-1,-1
WESLEY.txt,631709,632021,312,5,N,N,-,-1,-1
WESLEY.txt,632022,632937,915,5,N,N,-,-1,-1
WESLEY.txt,632938,633309,371,5,N,N,-,-1,-1
WESLEY.txt,633309,633907,598,5,N,N,-,-1,-1
WESLEY.txt,633907,634436,529,5,N,N,-,-1,-1
WESLEY.txt,634437,634880,443,5,N,N,-,-1,-1
WESLEY.txt,634881,635508,627,5,N,N,-,-1,-1
WESLEY.txt,635509,636032,523,5,N,N,-,-1,-1
WESLEY.txt,636033,636244,211,5,N,N,-,-1,-1
WESLEY.txt,636245,636650,405,5,N,N,-,-1,-1
WESLEY.txt,636650,637023,373,5,N,N,-,-1,-1
WESLEY.txt,637023,637491,468,5,N,N,-,-1,-1
WESLEY.txt,637492,637833,341,5,N,N,-,-1,-1
WESLEY.txt,637834,638327,493,5,N,N,-,-1,-1
WESLEY.txt,638327,638834,507,5,N,N,-,-1,-1
WESLEY.txt,638835,639251,416,5,N,N,-,-1,-1
WESLEY.txt,639252,639486,234,5,N,N,-,-1,-1
WESLEY.txt,639486,639896,410,5,N,N,-,-1,-1
WESLEY.txt,639897,640280,383,5,N,N,-,-1,-1
WESLEY.txt,640281,640623,342,5,N,N,-,-1,-1
WESLEY.txt,640624,640884,260,5,N,N,-,-1,-1
WESLEY.txt,640884,641420,536,5,N,N,-,-1,-1
WESLEY.txt,641421,641818,397,5,N,N,-,-1,-1
WESLEY.txt,641819,642158,339,5,N,N,-,-1,-1
WESLEY.txt,642159,642717,558,5,N,N,-,-1,-1
WESLEY.txt,642718,642984,266,5,N,N,-,-1,-1
WESLEY.txt,642985,643542,557,5,N,N,-,-1,-1
WESLEY.txt,643543,644220,677,5,N,N,-,-1,-1
WESLEY.txt,644221,644807,586,5,N,N,-,-1,-1
WESLEY.txt,644808,644983,175,5,N,N,-,-1,-1
WESLEY.txt,644984,645381,397,5,N,N,-,-1,-1
WESLEY.txt,645382,645690,308,5,N,N,-,-1,-1
WESLEY.txt,645691,646142,451,5,N,N,-,-1,-1
WESLEY.txt,646143,646621,478,5,N,N,-,-1,-1
WESLEY.txt,646621,646871,250,5,N,N,-,-1,-1
WESLEY.txt,646872,647059,187,5,N,N,-,-1,-1
WESLEY.txt,647060,647578,518,5,N,N,-,-1,-1
WESLEY.txt,647579,648015,436,5,N,N,-,-1,-1
WESLEY.txt,648016,648703,687,5,N,N,-,-1,-1
WESLEY.txt,648704,648947,243,5,N,N,-,-1,-1
WESLEY.txt,648948,649338,390,5,N,N,-,-1,-1
WESLEY.txt,649339,649855,516,5,N,N,-,-1,-1
WESLEY.txt,649855,650230,375,5,N,N,-,-1,-1
WESLEY.txt,650231,650722,491,5,N,N,-,-1,-1
WESLEY.txt,650723,651120,397,5,N,N,-,-1,-1
WESLEY.txt,651120,651619,499,5,N,N,-,-1,-1
WESLEY.txt,651620,652055,435,5,N,N,-,-1,-1
WESLEY.txt,652056,652923,867,5,N,N,-,-1,-1
WESLEY.txt,652924,653129,205,5,N,N,-,-1,-1
WESLEY.txt,653130,653931,801,5,N,N,-,-1,-1
WESLEY.txt,653932,654449,517,5,N,N,-,-1,-1
WESLEY.txt,654450,654701,251,5,N,N,-,-1,-1
WESLEY.txt,654702,655015,313,5,N,N,-,-1,-1
WESLEY.txt,655016,655644,628,5,N,N,-,-1,-1
WESLEY.txt,655645,656092,447,5,N,N,-,-1,-1
WESLEY.txt,656093,656499,406,5,N,N,-,-1,-1
WESLEY.txt,656500,656795,295,5,N,N,-,-1,-1
WESLEY.txt,656796,657370,574,5,N,N,-,-1,-1
WESLEY.txt,657371,657990,619,5,N,N,-,-1,-1
WESLEY.txt,657991,658265,274,5,N,N,-,-1,-1
WESLEY.txt,658266,658777,511,5,N,N,-,-1,-1
WESLEY.txt,658778,659273,495,5,N,N,-,-1,-1
WESLEY.txt,659273,659804,531,5,N,N,-,-1,-1
WESLEY.txt,659805,660267,462,5,N,N,-,-1,-1
WESLEY.txt,660268,660735,467,5,N,N,-,-1,-1
WESLEY.txt,660736,661060,324,5,N,N,-,-1,-1
WESLEY.txt,661061,661396,335,5,N,N,-,-1,-1
WESLEY.txt,661397,661709,312,5,N,N,-,-1,-1
WESLEY.txt,661710,662041,331,5,N,N,-,-1,-1
WESLEY.txt,662042,662433,391,5,N,N,-,-1,-1
WESLEY.txt,662434,662804,370,5,N,N,-,-1,-1
WESLEY.txt,662805,663513,708,5,N,N,-,-1,-1
WESLEY.txt,663514,664020,506,5,N,N,-,-1,-1
WESLEY.txt,664021,664292,271,5,N,N,-,-1,-1
WESLEY.txt,664292,665002,710,5,N,N,-,-1,-1
WESLEY.txt,665003,665303,300,5,N,N,-,-1,-1
WESLEY.txt,665304,665659,355,5,N,N,-,-1,-1
WESLEY.txt,665660,666047,387,5,N,N,-,-1,-1
WESLEY.txt,666048,666380,332,5,N,N,-,-1,-1
WESLEY.txt,666381,666842,461,5,N,N,-,-1,-1
WESLEY.txt,666843,667185,342,5,N,N,-,-1,-1
WESLEY.txt,667186,667609,423,5,N,N,-,-1,-1
WESLEY.txt,667609,668221,612,5,N,N,-,-1,-1
WESLEY.txt,668222,668640,418,5,N,N,-,-1,-1
WESLEY.txt,668641,669288,647,5,N,N,-,-1,-1
WESLEY.txt,669289,669750,461,5,N,N,-,-1,-1
WESLEY.txt,669751,670187,436,5,N,N,-,-1,-1
WESLEY.txt,670188,670632,444,5,N,N,-,-1,-1
WESLEY.txt,670633,671039,406,5,N,N,-,-1,-1
WESLEY.txt,671040,671474,434,5,N,N,-,-1,-1
WESLEY.txt,671475,671896,421,5,N,N,-,-1,-1
WESLEY.txt,671897,672568,671,5,N,N,-,-1,-1
WESLEY.txt,672569,673284,715,5,N,N,-,-1,-1
WESLEY.txt,673284,673731,447,5,N,N,-,-1,-1
WESLEY.txt,673732,673988,256,5,N,N,-,-1,-1
WESLEY.txt,673989,674380,391,5,N,N,-,-1,-1
WESLEY.txt,674381,674700,319,5,N,N,-,-1,-1
WESLEY.txt,674701,675106,405,5,N,N,-,-1,-1
WESLEY.txt,675107,675562,455,5,N,N,-,-1,-1
WESLEY.txt,675563,675908,345,5,N,N,-,-1,-1
WESLEY.txt,675909,676426,517,5,N,N,-,-1,-1
WESLEY.txt,676427,676802,375,5,N,N,-,-1,-1
WESLEY.txt,676803,677327,524,5,N,N,-,-1,-1
WESLEY.txt,677328,677735,407,5,N,N,-,-1,-1
WESLEY.txt,677736,678221,485,5,N,N,-,-1,-1
WESLEY.txt,678222,678595,373,5,N,N,-,-1,-1
WESLEY.txt,678596,678861,265,5,N,N,-,-1,-1
WESLEY.txt,678862,679281,419,5,N,N,-,-1,-1
WESLEY.txt,679282,679700,418,5,N,N,-,-1,-1
WESLEY.txt,679701,679932,231,5,N,N,-,-1,-1
WESLEY.txt,679933,680332,399,5,N,N,-,-1,-1
WESLEY.txt,680333,680783,450,5,N,N,-,-1,-1
WESLEY.txt,680784,681446,662,5,N,N,-,-1,-1
WESLEY.txt,681447,682001,554,5,N,N,-,-1,-1
WESLEY.txt,682002,682728,726,5,N,N,-,-1,-1
WESLEY.txt,682729,683049,320,5,N,N,-,-1,-1
WESLEY.txt,683050,683532,482,5,N,N,-,-1,-1
WESLEY.txt,683533,683924,391,5,N,N,-,-1,-1
WESLEY.txt,683925,684360,435,5,N,N,-,-1,-1
WESLEY.txt,684361,684753,392,5,N,N,-,-1,-1
WESLEY.txt,684754,685089,335,5,N,N,-,-1,-1
WESLEY.txt,685090,685451,361,5,N,N,-,-1,-1
WESLEY.txt,685452,685923,471,5,N,N,-,-1,-1
WESLEY.txt,685924,686339,415,5,N,N,-,-1,-1
WESLEY.txt,686340,686989,649,5,N,N,-,-1,-1
WESLEY.txt,686990,687277,287,5,N,N,-,-1,-1
WESLEY.txt,687278,687570,292,5,N,N,-,-1,-1
WESLEY.txt,687571,688045,474,5,N,N,-,-1,-1
WESLEY.txt,688045,688414,369,5,N,N,-,-1,-1
WESLEY.txt,688415,688998,583,5,N,N,-,-1,-1
WESLEY.txt,688999,689264,265,5,N,N,-,-1,-1
WESLEY.txt,689265,689661,396,5,N,N,-,-1,-1
WESLEY.txt,689662,689833,171,5,N,N,-,-1,-1
WESLEY.txt,689834,690244,410,5,N,N,-,-1,-1
WESLEY.txt,690245,690764,519,5,N,N,-,-1,-1
WESLEY.txt,690765,691294,529,5,N,N,-,-1,-1
WESLEY.txt,691295,691488,193,5,N,N,-,-1,-1
WESLEY.txt,691488,691894,406,5,N,N,-,-1,-1
WESLEY.txt,691895,692330,435,5,N,N,-,-1,-1
WESLEY.txt,692331,692808,477,5,N,N,-,-1,-1
WESLEY.txt,692809,693207,398,5,N,N,-,-1,-1
WESLEY.txt,693207,693927,720,5,N,N,-,-1,-1
WESLEY.txt,693928,694582,654,5,N,N,-,-1,-1
WESLEY.txt,694583,695003,420,5,N,N,-,-1,-1
WESLEY.txt,695004,695403,399,5,N,N,-,-1,-1
WESLEY.txt,695403,695651,248,5,N,N,-,-1,-1
WESLEY.txt,695652,696206,554,5,N,N,-,-1,-1
WESLEY.txt,696207,696579,372,5,N,N,-,-1,-1
WESLEY.txt,696580,697069,489,5,N,N,-,-1,-1
WESLEY.txt,697069,697395,326,5,N,N,-,-1,-1
WESLEY.txt,697396,698086,690,5,N,N,-,-1,-1
WESLEY.txt,698087,698674,587,5,N,N,-,-1,-1
WESLEY.txt,698675,699063,388,5,N,N,-,-1,-1
WESLEY.txt,699063,699487,424,5,N,N,-,-1,-1
WESLEY.txt,699488,699817,329,5,N,N,-,-1,-1
WESLEY.txt,699817,700174,357,5,N,N,-,-1,-1
WESLEY.txt,700175,700468,293,5,N,N,-,-1,-1
WESLEY.txt,700469,700836,367,5,N,N,-,-1,-1
WESLEY.txt,700836,701374,538,5,N,N,-,-1,-1
WESLEY.txt,701375,701797,422,5,N,N,-,-1,-1
WESLEY.txt,701798,702383,585,5,N,N,-,-1,-1
WESLEY.txt,702384,702785,401,5,N,N,-,-1,-1
WESLEY.txt,702786,703694,908,5,N,N,-,-1,-1
WESLEY.txt,703695,704166,471,5,N,N,-,-1,-1
WESLEY.txt,704167,704659,492,5,N,N,-,-1,-1
WESLEY.txt,704660,705313,653,5,N,N,-,-1,-1
WESLEY.txt,705314,705690,376,5,N,N,-,-1,-1
WESLEY.txt,705691,706136,445,5,N,N,-,-1,-1
WESLEY.txt,706137,706562,425,5,N,N,-,-1,-1
WESLEY.txt,706563,706806,243,5,N,N,-,-1,-1
WESLEY.txt,706807,707181,374,5,N,N,-,-1,-1
WESLEY.txt,707182,707455,273,5,N,N,-,-1,-1
WESLEY.txt,707456,707953,497,5,N,N,-,-1,-1
WESLEY.txt,707954,708684,730,5,N,N,-,-1,-1
WESLEY.txt,708685,710026,1341,5,N,N,-,-1,-1
WESLEY.txt,710027,710393,366,5,N,N,-,-1,-1
WESLEY.txt,710394,710772,378,5,N,N,-,-1,-1
WESLEY.txt,710773,711132,359,5,N,N,-,-1,-1
WESLEY.txt,711133,711564,431,5,N,N,-,-1,-1
WESLEY.txt,711564,711815,251,5,N,N,-,-1,-1
WESLEY.txt,711816,712340,524,5,N,N,-,-1,-1
WESLEY.txt,712341,712870,529,5,N,N,-,-1,-1
WESLEY.txt,712871,713146,275,5,N,N,-,-1,-1
WESLEY.txt,713147,713627,480,5,N,N,-,-1,-1
WESLEY.txt,713628,713974,346,5,N,N,-,-1,-1
WESLEY.txt,713975,714661,686,5,N,N,-,-1,-1
WESLEY.txt,714661,715168,507,5,N,N,-,-1,-1
WESLEY.txt,715169,716130,961,5,N,N,-,-1,-1
WESLEY.txt,716130,716617,487,5,N,N,-,-1,-1
WESLEY.txt,716618,717022,404,5,N,N,-,-1,-1
WESLEY.txt,717023,717580,557,5,N,N,-,-1,-1
WESLEY.txt,717581,718082,501,5,N,N,-,-1,-1
WESLEY.txt,718083,718547,464,5,N,N,-,-1,-1
WESLEY.txt,718548,719217,669,5,N,N,-,-1,-1
WESLEY.txt,719218,719401,183,5,N,N,-,-1,-1
WESLEY.txt,719402,719830,428,5,N,N,-,-1,-1
WESLEY.txt,719831,720111,280,5,N,N,-,-1,-1
WESLEY.txt,720112,720600,488,5,N,N,-,-1,-1
WESLEY.txt,720601,721280,679,5,N,N,-,-1,-1
WESLEY.txt,721281,721499,218,5,N,N,-,-1,-1
WESLEY.txt,721500,721780,280,5,N,N,-,-1,-1
WESLEY.txt,721781,722216,435,5,N,N,-,-1,-1
WESLEY.txt,722217,722647,430,5,N,N,-,-1,-1
WESLEY.txt,722647,723072,425,5,N,N,-,-1,-1
WESLEY.txt,723073,723965,892,5,N,N,-,-1,-1
WESLEY.txt,723966,724438,472,5,N,N,-,-1,-1
WESLEY.txt,724438,725047,609,5,N,N,-,-1,-1
WESLEY.txt,725048,725339,291,5,N,N,-,-1,-1
WESLEY.txt,725340,725964,624,5,N,N,-,-1,-1
WESLEY.txt,725965,726249,284,5,N,N,-,-1,-1
WESLEY.txt,726250,726920,670,5,N,N,-,-1,-1
WESLEY.txt,726921,727241,320,5,N,N,-,-1,-1
WESLEY.txt,727241,727734,493,5,N,N,-,-1,-1
WESLEY.txt,727735,728095,360,5,N,N,-,-1,-1
WESLEY.txt,728096,728479,383,5,N,N,-,-1,-1
WESLEY.txt,728480,729169,689,5,N,N,-,-1,-1
WESLEY.txt,729170,729701,531,5,N,N,-,-1,-1
WESLEY.txt,729702,730057,355,5,N,N,-,-1,-1
WESLEY.txt,730058,730517,459,5,N,N,-,-1,-1
WESLEY.txt,730518,730859,341,5,N,N,-,-1,-1
WESLEY.txt,730860,731319,459,5,N,N,-,-1,-1
WESLEY.txt,731320,731646,326,5,N,N,-,-1,-1
WESLEY.txt,731647,732098,451,5,N,N,-,-1,-1
WESLEY.txt,732099,732425,326,5,N,N,-,-1,-1
WESLEY.txt,732425,733099,674,5,N,N,-,-1,-1
WESLEY.txt,733100,733633,533,5,N,N,-,-1,-1
WESLEY.txt,733634,734310,676,5,N,N,-,-1,-1
WESLEY.txt,734311,734576,265,5,N,N,-,-1,-1
WESLEY.txt,734577,734950,373,5,N,N,-,-1,-1
WESLEY.txt,734951,735475,524,5,N,N,-,-1,-1
WESLEY.txt,735476,735897,421,5,N,N,-,-1,-1
WESLEY.txt,735897,736609,712,5,N,N,-,-1,-1
WESLEY.txt,736610,737004,394,5,N,N,-,-1,-1
WESLEY.txt,737005,737511,506,5,N,N,-,-1,-1
WESLEY.txt,737512,738179,667,5,N,N,-,-1,-1
WESLEY.txt,738180,738595,415,5,N,N,-,-1,-1
WESLEY.txt,738596,739156,560,5,N,N,-,-1,-1
WESLEY.txt,739156,739804,648,5,N,N,-,-1,-1
WESLEY.txt,739805,740530,725,5,N,N,-,-1,-1
WESLEY.txt,740530,740790,260,5,N,N,-,-1,-1
WESLEY.txt,740791,741188,397,5,N,N,-,-1,-1
WESLEY.txt,741189,741540,351,5,N,N,-,-1,-1
WESLEY.txt,741541,742009,468,5,N,N,-,-1,-1
WESLEY.txt,742010,742353,343,5,N,N,-,-1,-1
WESLEY.txt,742354,742591,237,5,N,N,-,-1,-1
WESLEY.txt,742592,743342,750,5,N,N,-,-1,-1
WESLEY.txt,743343,743857,514,5,N,N,-,-1,-1
WESLEY.txt,743858,744290,432,5,N,N,-,-1,-1
WESLEY.txt,744291,744576,285,5,N,N,-,-1,-1
WESLEY.txt,744577,744927,350,5,N,N,-,-1,-1
WESLEY.txt,744928,745513,585,5,N,N,-,-1,-1
WESLEY.txt,745514,745905,391,5,N,N,-,-1,-1
WESLEY.txt,745906,746295,389,5,N,N,-,-1,-1
WESLEY.txt,746296,747414,1118,5,N,N,-,-1,-1
WESLEY.txt,747415,748154,739,5,N,N,-,-1,-1
WESLEY.txt,748155,748556,401,5,N,N,-,-1,-1
WESLEY.txt,748557,749065,508,5,N,N,-,-1,-1
WESLEY.txt,749066,749659,593,5,N,N,-,-1,-1
WESLEY.txt,749660,750589,929,5,N,N,-,-1,-1
WESLEY.txt,750590,751302,712,5,N,N,-,-1,-1
WESLEY.txt,751303,751653,350,5,N,N,-,-1,-1
WESLEY.txt,751654,751962,308,5,N,N,-,-1,-1
WESLEY.txt,751963,752446,483,5,N,N,-,-1,-1
WESLEY.txt,752447,752869,422,5,N,N,-,-1,-1
WESLEY.txt,752870,753539,669,5,N,N,-,-1,-1
WESLEY.txt,753540,753916,376,5,N,N,-,-1,-1
WESLEY.txt,753917,754548,631,5,N,N,-,-1,-1
WESLEY.txt,754549,755160,611,5,N,N,-,-1,-1
WESLEY.txt,755161,755570,409,5,N,N,-,-1,-1
WESLEY.txt,755571,755905,334,5,N,N,-,-1,-1
WESLEY.txt,755906,756227,321,5,N,N,-,-1,-1
WESLEY.txt,756228,756670,442,5,N,N,-,-1,-1
WESLEY.txt,756671,757250,579,5,N,N,-,-1,-1
WESLEY.txt,757251,757718,467,5,N,N,-,-1,-1
WESLEY.txt,757719,758190,471,5,N,N,-,-1,-1
WESLEY.txt,758191,758885,694,5,N,N,-,-1,-1
WESLEY.txt,758886,759306,420,5,N,N,-,-1,-1
WESLEY.txt,759307,759575,268,5,N,N,-,-1,-1
WESLEY.txt,759576,760000,424,5,N,N,-,-1,-1
WESLEY.txt,760001,760315,314,5,N,N,-,-1,-1
WESLEY.txt,760316,760858,542,5,N,N,-,-1,-1
WESLEY.txt,760859,761329,470,5,N,N,-,-1,-1
WESLEY.txt,761329,761838,509,5,N,N,-,-1,-1
WESLEY.txt,761839,762246,407,5,N,N,-,-1,-1
WESLEY.txt,762247,762699,452,5,N,N,-,-1,-1
WESLEY.txt,762700,763252,552,5,N,N,-,-1,-1
WESLEY.txt,763253,763655,402,5,N,N,-,-1,-1
WESLEY.txt,763655,764222,567,5,N,N,-,-1,-1
WESLEY.txt,764223,764478,255,5,N,N,-,-1,-1
WESLEY.txt,764479,764852,373,5,N,N,-,-1,-1
WESLEY.txt,764853,765223,370,5,N,N,-,-1,-1
WESLEY.txt,765224,765778,554,5,N,N,-,-1,-1
WESLEY.txt,765779,766261,482,5,N,N,-,-1,-1
WESLEY.txt,766262,766607,345,5,N,N,-,-1,-1
WESLEY.txt,766608,767031,423,5,N,N,-,-1,-1
WESLEY.txt,767032,767437,405,5,N,N,-,-1,-1
WESLEY.txt,767438,767882,444,5,N,N,-,-1,-1
WESLEY.txt,767883,768320,437,5,N,N,-,-1,-1
WESLEY.txt,768321,768597,276,5,N,N,-,-1,-1
WESLEY.txt,768598,768929,331,5,N,N,-,-1,-1
WESLEY.txt,768930,769388,458,5,N,N,-,-1,-1
WESLEY.txt,769389,769834,445,5,N,N,-,-1,-1
WESLEY.txt,769835,770128,293,5,N,N,-,-1,-1
WESLEY.txt,770129,771031,902,5,N,N,-,-1,-1
WESLEY.txt,771032,771658,626,5,N,N,-,-1,-1
WESLEY.txt,771659,772356,697,5,N,N,-,-1,-1
WESLEY.txt,772357,772914,557,5,N,N,-,-1,-1
WESLEY.txt,772915,773249,334,5,N,N,-,-1,-1
WESLEY.txt,773250,773607,357,5,N,N,-,-1,-1
WESLEY.txt,773608,773949,341,5,N,N,-,-1,-1
WESLEY.txt,773950,774359,409,5,N,N,-,-1,-1
WESLEY.txt,774360,774765,405,5,N,N,-,-1,-1
WESLEY.txt,774766,775212,446,5,N,N,-,-1,-1
WESLEY.txt,775213,775637,424,5,N,N,-,-1,-1
WESLEY.txt,775637,776131,494,5,N,N,-,-1,-1
WESLEY.txt,776132,776527,395,5,N,N,-,-1,-1
WESLEY.txt,776528,776957,429,5,N,N,-,-1,-1
WESLEY.txt,776958,777252,294,5,N,N,-,-1,-1
WESLEY.txt,777252,777937,685,5,N,N,-,-1,-1
WESLEY.txt,777938,778456,518,5,N,N,-,-1,-1
WESLEY.txt,778457,778853,396,5,N,N,-,-1,-1
WESLEY.txt,778854,779028,174,5,N,N,-,-1,-1
WESLEY.txt,779029,779310,281,5,N,N,-,-1,-1
WESLEY.txt,779310,779715,405,5,N,N,-,-1,-1
WESLEY.txt,779716,780155,439,5,N,N,-,-1,-1
WESLEY.txt,780156,780536,380,5,N,N,-,-1,-1
WESLEY.txt,780537,780801,264,5,N,N,-,-1,-1
WESLEY.txt,780802,781112,310,5,N,N,-,-1,-1
WESLEY.txt,781113,781334,221,5,N,N,-,-1,-1
WESLEY.txt,781335,781735,400,5,N,N,-,-1,-1
WESLEY.txt,781736,782242,506,5,N,N,-,-1,-1
WESLEY.txt,782243,783017,774,5,N,N,-,-1,-1
WESLEY.txt,783018,783392,374,5,N,N,-,-1,-1
WESLEY.txt,783392,783679,287,5,N,N,-,-1,-1
WESLEY.txt,783680,784272,592,5,N,N,-,-1,-1
WESLEY.txt,784273,784692,419,5,N,N,-,-1,-1
WESLEY.txt,784693,785192,499,5,N,N,-,-1,-1
WESLEY.txt,785193,785800,607,5,N,N,-,-1,-1
WESLEY.txt,785801,786179,378,5,N,N,-,-1,-1
WESLEY.txt,786180,786802,622,5,N,N,-,-1,-1
WESLEY.txt,786803,787209,406,5,N,N,-,-1,-1
WESLEY.txt,787210,787773,563,5,N,N,-,-1,-1
WESLEY.txt,787774,788132,358,5,N,N,-,-1,-1
WESLEY.txt,788133,788566,433,5,N,N,-,-1,-1
WESLEY.txt,788567,789004,437,5,N,N,-,-1,-1
WESLEY.txt,789005,789564,559,5,N,N,-,-1,-1
WESLEY.txt,789565,789993,428,5,N,N,-,-1,-1
WESLEY.txt,789994,790600,606,5,N,N,-,-1,-1
WESLEY.txt,790601,790773,172,5,N,N,-,-1,-1
WESLEY.txt,790774,791049,275,5,N,N,-,-1,-1
WESLEY.txt,791050,791394,344,5,N,N,-,-1,-1
WESLEY.txt,791395,791731,336,5,N,N,-,-1,-1
WESLEY.txt,791732,792048,316,5,N,N,-,-1,-1
WESLEY.txt,792048,792626,578,5,N,N,-,-1,-1
WESLEY.txt,792627,793172,545,5,N,N,-,-1,-1
WESLEY.txt,793173,793716,543,5,N,N,-,-1,-1
WESLEY.txt,793717,794303,586,5,N,N,-,-1,-1
WESLEY.txt,794304,794636,332,5,N,N,-,-1,-1
WESLEY.txt,794637,795086,449,5,N,N,-,-1,-1
WESLEY.txt,795087,795509,422,5,N,N,-,-1,-1
WESLEY.txt,795510,795801,291,5,N,N,-,-1,-1
WESLEY.txt,795802,796301,499,5,N,N,-,-1,-1
WESLEY.txt,796302,796757,455,5,N,N,-,-1,-1
WESLEY.txt,796758,797259,501,5,N,N,-,-1,-1
WESLEY.txt,797260,797651,391,5,N,N,-,-1,-1
WESLEY.txt,797652,798090,438,5,N,N,-,-1,-1
WESLEY.txt,798090,798624,534,5,N,N,-,-1,-1
WESLEY.txt,798625,799133,508,5,N,N,-,-1,-1
WESLEY.txt,799134,799571,437,5,N,N,-,-1,-1
WESLEY.txt,799572,799786,214,5,N,N,-,-1,-1
WESLEY.txt,799787,800225,438,5,N,N,-,-1,-1
WESLEY.txt,800226,800730,504,5,N,N,-,-1,-1
WESLEY.txt,800731,801354,623,5,N,N,-,-1,-1
WESLEY.txt,801355,801682,327,5,N,N,-,-1,-1
WESLEY.txt,801683,802041,358,5,N,N,-,-1,-1
WESLEY.txt,802042,802550,508,5,N,N,-,-1,-1
WESLEY.txt,802551,802775,224,5,N,N,-,-1,-1
WESLEY.txt,802775,803200,425,5,N,N,-,-1,-1
WESLEY.txt,803201,803400,199,5,N,N,-,-1,-1
WESLEY.txt,803400,803772,372,5,N,N,-,-1,-1
WESLEY.txt,803773,804203,430,5,N,N,-,-1,-1
WESLEY.txt,804204,804646,442,5,N,N,-,-1,-1
WESLEY.txt,804647,804939,292,5,N,N,-,-1,-1
WESLEY.txt,804939,805321,382,5,N,N,-,-1,-1
WESLEY.txt,805321,805809,488,5,N,N,-,-1,-1
WESLEY.txt,805810,806077,267,5,N,N,-,-1,-1
WESLEY.txt,806077,806567,490,5,N,N,-,-1,-1
WESLEY.txt,806568,806922,354,5,N,N,-,-1,-1
WESLEY.txt,806923,807297,374,5,N,N,-,-1,-1
WESLEY.txt,807298,807699,401,5,N,N,-,-1,-1
WESLEY.txt,807700,807998,298,5,N,N,-,-1,-1
WESLEY.txt,807999,808364,365,5,N,N,-,-1,-1
WESLEY.txt,808364,808914,550,5,N,N,-,-1,-1
WESLEY.txt,808915,809398,483,5,N,N,-,-1,-1
WESLEY.txt,809399,810396,997,5,N,N,-,-1,-1
WESLEY.txt,810397,810646,249,5,N,N,-,-1,-1
WESLEY.txt,810647,811004,357,5,N,N,-,-1,-1
WESLEY.txt,811005,811391,386,5,N,N,-,-1,-1
WESLEY.txt,811392,811800,408,5,N,N,-,-1,-1
WESLEY.txt,811801,812364,563,5,N,N,-,-1,-1
WESLEY.txt,812365,812815,450,5,N,N,-,-1,-1
WESLEY.txt,812815,813374,559,5,N,N,-,-1,-1
WESLEY.txt,813375,814275,900,5,N,N,-,-1,-1
WESLEY.txt,814276,814754,478,5,N,N,-,-1,-1
WESLEY.txt,814754,815024,270,5,N,N,-,-1,-1
WESLEY.txt,815025,815371,346,5,N,N,-,-1,-1
WESLEY.txt,815372,816079,707,5,N,N,-,-1,-1
WESLEY.txt,816080,816777,697,5,N,N,-,-1,-1
WESLEY.txt,816778,817219,441,5,N,N,-,-1,-1
WESLEY.txt,817220,817720,500,5,N,N,-,-1,-1
WESLEY.txt,817721,818442,721,5,N,N,-,-1,-1
WESLEY.txt,818443,818652,209,5,N,N,-,-1,-1
WESLEY.txt,818653,819309,656,5,N,N,-,-1,-1
WESLEY.txt,819310,819632,322,5,N,N,-,-1,-1
WESLEY.txt,819633,820074,441,5,N,N,-,-1,-1
WESLEY.txt,820075,820417,342,5,N,N,-,-1,-1
WESLEY.txt,820418,820878,460,5,N,N,-,-1,-1
WESLEY.txt,820879,821357,478,5,N,N,-,-1,-1
WESLEY.txt,821358,821836,478,5,N,N,-,-1,-1
WESLEY.txt,821837,822263,426,5,N,N,-,-1,-1
WESLEY.txt,822264,822611,347,5,N,N,-,-1,-1
WESLEY.txt,822612,822974,362,5,N,N,-,-1,-1
WESLEY.txt,822975,823394,419,5,N,N,-,-1,-1
WESLEY.txt,823395,823770,375,5,N,N,-,-1,-1
WESLEY.txt,823771,824350,579,5,N,N,-,-1,-1
WESLEY.txt,824351,824735,384,5,N,N,-,-1,-1
WESLEY.txt,824736,825296,560,5,N,N,-,-1,-1
WESLEY.txt,825296,825614,318,5,N,N,-,-1,-1
WESLEY.txt,825614,826311,697,5,N,N,-,-1,-1
WESLEY.txt,826312,827179,867,5,N,N,-,-1,-1
WESLEY.txt,827180,827736,556,5,N,N,-,-1,-1
WESLEY.txt,827737,828164,427,5,N,N,-,-1,-1
WESLEY.txt,828165,828590,425,5,N,N,-,-1,-1
WESLEY.txt,828590,828997,407,5,N,N,-,-1,-1
WESLEY.txt,828998,829374,376,5,N,N,-,-1,-1
WESLEY.txt,829375,829766,391,5,N,N,-,-1,-1
WESLEY.txt,829767,830203,436,5,N,N,-,-1,-1
WESLEY.txt,830204,830649,445,5,N,N,-,-1,-1
WESLEY.txt,830650,831049,399,5,N,N,-,-1,-1
WESLEY.txt,831050,831523,473,5,N,N,-,-1,-1
WESLEY.txt,831523,831919,396,5,N,N,-,-1,-1
WESLEY.txt,831920,832269,349,5,N,N,-,-1,-1
WESLEY.txt,832270,832996,726,5,N,N,-,-1,-1
WESLEY.txt,832997,833402,405,5,N,N,-,-1,-1
WESLEY.txt,833403,833735,332,5,N,N,-,-1,-1
WESLEY.txt,833736,834083,347,5,N,N,-,-1,-1
WESLEY.txt,834084,834448,364,5,N,N,-,-1,-1
WESLEY.txt,834448,834838,390,5,N,N,-,-1,-1
WESLEY.txt,834839,835284,445,5,N,N,-,-1,-1
WESLEY.txt,835285,835894,609,5,N,N,-,-1,-1
WESLEY.txt,835895,836251,356,5,N,N,-,-1,-1
WESLEY.txt,836252,836820,568,5,N,N,-,-1,-1
WESLEY.txt,836820,837230,410,5,N,N,-,-1,-1
WESLEY.txt,837231,837719,488,5,N,N,-,-1,-1
WESLEY.txt,837720,838354,634,5,N,N,-,-1,-1
WESLEY.txt,838355,838692,337,5,N,N,-,-1,-1
WESLEY.txt,838693,839090,397,5,N,N,-,-1,-1
WESLEY.txt,839091,839430,339,5,N,N,-,-1,-1
WESLEY.txt,839430,839774,344,5,N,N,-,-1,-1
WESLEY.txt,839775,840468,693,5,N,N,-,-1,-1
WESLEY.txt,840468,840934,466,5,N,N,-,-1,-1
WESLEY.txt,840935,841154,219,5,N,N,-,-1,-1
WESLEY.txt,841155,841563,408,5,N,N,-,-1,-1
WESLEY.txt,841563,842080,517,5,N,N,-,-1,-1
WESLEY.txt,842081,842553,472,5,N,N,-,-1,-1
WESLEY.txt,842554,842815,261,5,N,N,-,-1,-1
WESLEY.txt,842816,843153,337,5,N,N,-,-1,-1
WESLEY.txt,843154,843480,326,5,N,N,-,-1,-1
WESLEY.txt,843481,843884,403,5,N,N,-,-1,-1
WESLEY.txt,843885,844501,616,5,N,N,-,-1,-1
WESLEY.txt,844501,844756,255,5,N,N,-,-1,-1
WESLEY.txt,844757,845313,556,5,N,N,-,-1,-1
WESLEY.txt,845314,845697,383,5,N,N,-,-1,-1
WESLEY.txt,845698,845994,296,5,N,N,-,-1,-1
WESLEY.txt,845995,846520,525,5,N,N,-,-1,-1
WESLEY.txt,846521,846931,410,5,N,N,-,-1,-1
WESLEY.txt,846932,847408,476,5,N,N,-,-1,-1
WESLEY.txt,847409,847856,447,5,N,N,-,-1,-1
WESLEY.txt,847857,848387,530,5,N,N,-,-1,-1
WESLEY.txt,848387,849091,704,5,N,N,-,-1,-1
WESLEY.txt,849092,849650,558,5,N,N,-,-1,-1
WESLEY.txt,849651,850168,517,5,N,N,-,-1,-1
WESLEY.txt,850169,850578,409,5,N,N,-,-1,-1
WESLEY.txt,850579,851373,794,5,N,N,-,-1,-1
WESLEY.txt,851374,851788,414,5,N,N,-,-1,-1
WESLEY.txt,851789,852376,587,5,N,N,-,-1,-1
WESLEY.txt,852377,852786,409,5,N,N,-,-1,-1
WESLEY.txt,852787,853239,452,5,N,N,-,-1,-1
WESLEY.txt,853240,853558,318,5,N,N,-,-1,-1
WESLEY.txt,853559,854064,505,5,N,N,-,-1,-1
WESLEY.txt,854065,854569,504,5,N,N,-,-1,-1
WESLEY.txt,854570,855206,636,5,N,N,-,-1,-1
WESLEY.txt,855207,855460,253,5,N,N,-,-1,-1
WESLEY.txt,855461,855875,414,5,N,N,-,-1,-1
WESLEY.txt,855875,856447,572,5,N,N,-,-1,-1
WESLEY.txt,856448,856818,370,5,N,N,-,-1,-1
WESLEY.txt,856819,857444,625,5,N,N,-,-1,-1
WESLEY.txt,857445,857820,375,5,N,N,-,-1,-1
WESLEY.txt,857821,858452,631,5,N,N,-,-1,-1
WESLEY.txt,858453,858904,451,5,N,N,-,-1,-1
WESLEY.txt,858905,859382,477,5,N,N,-,-1,-1
WESLEY.txt,859383,860079,696,5,N,N,-,-1,-1
WESLEY.txt,860079,860369,290,5,N,N,-,-1,-1
WESLEY.txt,860370,861044,674,5,N,N,-,-1,-1
WESLEY.txt,861045,861556,511,5,N,N,-,-1,-1
WESLEY.txt,861557,862454,897,5,N,N,-,-1,-1
WESLEY.txt,862455,862792,337,5,N,N,-,-1,-1
WESLEY.txt,862793,863083,290,5,N,N,-,-1,-1
WESLEY.txt,863084,863374,290,5,N,N,-,-1,-1
WESLEY.txt,863375,864098,723,5,N,N,-,-1,-1
WESLEY.txt,864099,864493,394,5,N,N,-,-1,-1
WESLEY.txt,864494,865033,539,5,N,N,-,-1,-1
WESLEY.txt,865034,865421,387,5,N,N,-,-1,-1
WESLEY.txt,865422,865982,560,5,N,N,-,-1,-1
WESLEY.txt,865983,866357,374,5,N,N,-,-1,-1
WESLEY.txt,866358,867117,759,5,N,N,-,-1,-1
WESLEY.txt,867117,867480,363,5,N,N,-,-1,-1
WESLEY.txt,867481,868147,666,5,N,N,-,-1,-1
WESLEY.txt,868148,868512,364,5,N,N,-,-1,-1
WESLEY.txt,868513,868898,385,5,N,N,-,-1,-1
WESLEY.txt,868899,869322,423,5,N,N,-,-1,-1
WESLEY.txt,869323,869804,481,5,N,N,-,-1,-1
WESLEY.txt,869805,870277,472,5,N,N,-,-1,-1
WESLEY.txt,870278,870611,333,5,N,N,-,-1,-1
WESLEY.txt,870612,870945,333,5,N,N,-,-1,-1
WESLEY.txt,870945,871179,234,5,N,N,-,-1,-1
WESLEY.txt,871180,871798,618,5,N,N,-,-1,-1
WESLEY.txt,871799,872208,409,5,N,N,-,-1,-1
WESLEY.txt,872209,873318,1109,5,N,N,-,-1,-1
WESLEY.txt,873319,874361,1042,5,N,N,-,-1,-1
WESLEY.txt,874362,874774,412,5,N,N,-,-1,-1
WESLEY.txt,874775,875295,520,5,N,N,-,-1,-1
WESLEY.txt,875295,875695,400,5,N,N,-,-1,-1
WESLEY.txt,875696,875942,246,5,N,N,-,-1,-1
WESLEY.txt,875942,876251,309,5,N,N,-,-1,-1
WESLEY.txt,876251,876653,402,5,N,N,-,-1,-1
WESLEY.txt,876654,876936,282,5,N,N,-,-1,-1
WESLEY.txt,876937,877430,493,5,N,N,-,-1,-1
WESLEY.txt,877431,877778,347,5,N,N,-,-1,-1
WESLEY.txt,877779,878175,396,5,N,N,-,-1,-1
WESLEY.txt,878175,878463,288,5,N,N,-,-1,-1
WESLEY.txt,878463,878835,372,5,N,N,-,-1,-1
WESLEY.txt,878836,879098,262,5,N,N,-,-1,-1
WESLEY.txt,879099,879397,298,5,N,N,-,-1,-1
WESLEY.txt,879398,879873,475,5,N,N,-,-1,-1
WESLEY.txt,879874,880541,667,5,N,N,-,-1,-1
WESLEY.txt,880542,880764,222,5,N,N,-,-1,-1
WESLEY.txt,880765,881221,456,5,N,N,-,-1,-1
WESLEY.txt,881222,881660,438,5,N,N,-,-1,-1
WESLEY.txt,881661,881983,322,5,N,N,-,-1,-1
WESLEY.txt,881984,882331,347,5,N,N,-,-1,-1
WESLEY.txt,882332,882736,404,5,N,N,-,-1,-1
WESLEY.txt,882736,882955,219,5,N,N,-,-1,-1
WESLEY.txt,882955,883448,493,5,N,N,-,-1,-1
WESLEY.txt,883449,883942,493,5,N,N,-,-1,-1
WESLEY.txt,883943,884509,566,5,N,N,-,-1,-1
WESLEY.txt,884510,884808,298,5,N,N,-,-1,-1
WESLEY.txt,884808,885408,600,5,N,N,-,-1,-1
WESLEY.txt,885409,886287,878,5,N,N,-,-1,-1
WESLEY.txt,886288,886931,643,5,N,N,-,-1,-1
WESLEY.txt,886932,887716,784,5,N,N,-,-1,-1
WESLEY.txt,887717,888753,1036,5,N,N,-,-1,-1
WESLEY.txt,888754,889699,945,5,N,N,-,-1,-1
WESLEY.txt,889700,890635,935,5,N,N,-,-1,-1
WESLEY.txt,890636,891936,1300,5,N,N,-,-1,-1
WESLEY.txt,891937,892400,463,5,N,N,-,-1,-1
WESLEY.txt,892401,894507,2106,5,N,N,-,-1,-1
WESLEY.txt,894508,894981,473,5,N,N,-,-1,-1
WESLEY.txt,894982,895571,589,5,N,N,-,-1,-1
WESLEY.txt,895572,896164,592,5,N,N,-,-1,-1
WESLEY.txt,896165,896713,548,5,N,N,-,-1,-1
