GLOVER.txt,0,3994,3994,20,N,N,-,-1,-1
GLOVER.txt,3995,16363,12368,20,N,N,-,-1,-1
GLOVER.txt,16364,20786,4422,20,N,N,-,-1,-1
GLOVER.txt,20789,24428,3639,20,N,N,-,-1,-1
GLOVER.txt,24429,27271,2842,20,N,N,-,-1,-1
GLOVER.txt,27272,31921,4649,20,N,N,-,-1,-1
GLOVER.txt,31922,35169,3247,20,N,N,-,-1,-1
GLOVER.txt,35171,38824,3653,20,N,N,-,-1,-1
GLOVER.txt,38825,42834,4009,20,N,N,-,-1,-1
GLOVER.txt,42834,45108,2274,20,N,N,-,-1,-1
GLOVER.txt,45109,46321,1212,20,N,N,-,-1,-1
GLOVER.txt,46322,47632,1310,20,N,N,-,-1,-1
GLOVER.txt,47633,51487,3854,20,N,N,-,-1,-1
GLOVER.txt,51490,54018,2528,20,N,N,-,-1,-1
GLOVER.txt,54019,56585,2566,20,N,N,-,-1,-1
GLOVER.txt,56586,59931,3345,20,N,N,-,-1,-1
GLOVER.txt,59934,64142,4208,20,N,N,-,-1,-1
GLOVER.txt,64143,67838,3695,20,N,N,-,-1,-1
GLOVER.txt,67839,72139,4300,20,N,N,-,-1,-1
GLOVER.txt,72142,76383,4241,20,N,N,-,-1,-1
GLOVER.txt,76384,81497,5113,20,N,N,-,-1,-1
GLOVER.txt,81500,86480,4980,20,N,N,-,-1,-1
GLOVER.txt,86481,89144,2663,20,N,N,-,-1,-1
GLOVER.txt,89144,93266,4122,20,N,N,-,-1,-1
GLOVER.txt,93267,96552,3285,20,N,N,-,-1,-1
GLOVER.txt,96554,100433,3879,20,N,N,-,-1,-1
GLOVER.txt,100434,102765,2331,20,N,N,-,-1,-1
GLOVER.txt,102768,107082,4314,20,N,Y,1436867017136,105674,106651
GLOVER.txt,107083,110511,3428,20,N,N,-,-1,-1
GLOVER.txt,110514,113817,3303,20,N,N,-,-1,-1
GLOVER.txt,113818,117354,3536,20,N,N,-,-1,-1
GLOVER.txt,117357,120141,2784,20,N,N,-,-1,-1
GLOVER.txt,120144,123497,3353,20,N,Y,1437028092146,121457,123204
GLOVER.txt,123502,126669,3167,20,N,N,-,-1,-1
GLOVER.txt,126670,130778,4108,20,N,N,-,-1,-1
GLOVER.txt,130779,134743,3964,20,N,N,-,-1,-1
GLOVER.txt,134744,138576,3832,20,N,N,-,-1,-1
GLOVER.txt,138577,140141,1564,20,N,N,-,-1,-1
GLOVER.txt,140142,143963,3821,20,N,N,-,-1,-1
GLOVER.txt,143964,146650,2686,20,N,N,-,-1,-1
GLOVER.txt,146651,148185,1534,20,N,N,-,-1,-1
GLOVER.txt,148186,150116,1930,20,N,N,-,-1,-1
GLOVER.txt,150117,152510,2393,20,N,Y,1437470299748,152207,152889
GLOVER.txt,152511,154241,1730,20,N,Y,1437470299748,152207,152889
GLOVER.txt,154243,158980,4737,20,N,N,-,-1,-1
GLOVER.txt,158981,162023,3042,20,N,N,-,-1,-1
GLOVER.txt,162025,166069,4044,20,N,N,-,-1,-1
GLOVER.txt,166072,169547,3475,20,N,N,-,-1,-1
GLOVER.txt,169548,173316,3768,20,N,N,-,-1,-1
GLOVER.txt,173318,176589,3271,20,N,N,-,-1,-1
GLOVER.txt,176592,179719,3127,20,N,N,-,-1,-1
GLOVER.txt,179720,182253,2533,20,N,N,-,-1,-1
GLOVER.txt,182256,184751,2495,20,N,N,-,-1,-1
GLOVER.txt,184752,187924,3172,20,N,N,-,-1,-1
GLOVER.txt,187925,190178,2253,20,N,N,-,-1,-1
GLOVER.txt,190179,193895,3716,20,N,N,-,-1,-1
GLOVER.txt,193898,197145,3247,20,N,N,-,-1,-1
GLOVER.txt,197146,199632,2486,20,N,N,-,-1,-1
GLOVER.txt,199633,203710,4077,20,N,N,-,-1,-1
GLOVER.txt,203711,207737,4026,20,N,N,-,-1,-1
GLOVER.txt,207740,211375,3635,20,N,N,-,-1,-1
GLOVER.txt,211378,213392,2014,20,N,N,-,-1,-1
GLOVER.txt,213393,214864,1471,20,N,N,-,-1,-1
GLOVER.txt,214865,218180,3315,20,N,N,-,-1,-1
GLOVER.txt,218181,221599,3418,20,N,N,-,-1,-1
GLOVER.txt,221600,225508,3908,20,N,N,-,-1,-1
GLOVER.txt,225509,228587,3078,20,N,N,-,-1,-1
GLOVER.txt,228588,231285,2697,20,N,N,-,-1,-1
GLOVER.txt,231286,233799,2513,20,N,N,-,-1,-1
GLOVER.txt,233802,236569,2767,20,N,N,-,-1,-1
GLOVER.txt,236570,240133,3563,20,N,N,-,-1,-1
GLOVER.txt,240136,243299,3163,20,N,N,-,-1,-1
GLOVER.txt,243300,245271,1971,20,N,N,-,-1,-1
GLOVER.txt,245274,249393,4119,20,N,N,-,-1,-1
GLOVER.txt,249394,252290,2896,20,N,N,-,-1,-1
GLOVER.txt,252293,255329,3036,20,N,N,-,-1,-1
GLOVER.txt,255330,258594,3264,20,N,N,-,-1,-1
GLOVER.txt,258597,261105,2508,20,N,N,-,-1,-1
GLOVER.txt,261106,264184,3078,20,N,N,-,-1,-1
GLOVER.txt,264185,267049,2864,20,N,N,-,-1,-1
GLOVER.txt,267050,269800,2750,20,N,N,-,-1,-1
GLOVER.txt,269803,272070,2267,20,N,N,-,-1,-1
GLOVER.txt,272071,275341,3270,20,N,N,-,-1,-1
GLOVER.txt,275342,277942,2600,20,N,N,-,-1,-1
GLOVER.txt,277943,279807,1864,20,N,N,-,-1,-1
GLOVER.txt,279808,281705,1897,20,N,N,-,-1,-1
GLOVER.txt,281707,285316,3609,20,N,N,-,-1,-1
GLOVER.txt,285317,288918,3601,20,N,N,-,-1,-1
GLOVER.txt,288919,291876,2957,20,N,N,-,-1,-1
GLOVER.txt,291877,293047,1170,20,N,N,-,-1,-1
GLOVER.txt,293049,294164,1115,20,N,N,-,-1,-1
GLOVER.txt,294165,296691,2526,20,N,N,-,-1,-1
GLOVER.txt,296691,298719,2028,20,N,N,-,-1,-1
GLOVER.txt,298721,300167,1446,20,N,N,-,-1,-1
GLOVER.txt,300168,302277,2109,20,N,N,-,-1,-1
GLOVER.txt,302278,304644,2366,20,N,N,-,-1,-1
GLOVER.txt,304645,307656,3011,20,Y,N,-,-1,-1
GLOVER.txt,307657,308894,1237,20,N,N,-,-1,-1
GLOVER.txt,308895,312115,3220,20,N,N,-,-1,-1
GLOVER.txt,312116,315622,3506,20,N,N,-,-1,-1
GLOVER.txt,315623,318083,2460,20,Y,N,-,-1,-1
GLOVER.txt,318084,320008,1924,20,N,N,-,-1,-1
GLOVER.txt,320011,322758,2747,20,N,N,-,-1,-1
GLOVER.txt,322759,326730,3971,20,N,N,-,-1,-1
GLOVER.txt,326731,330302,3571,20,Y,N,-,-1,-1
GLOVER.txt,330303,334236,3933,20,N,N,-,-1,-1
GLOVER.txt,334239,338044,3805,20,N,N,-,-1,-1
GLOVER.txt,338045,339883,1838,20,N,N,-,-1,-1
GLOVER.txt,339885,342518,2633,20,N,N,-,-1,-1
GLOVER.txt,342519,345268,2749,20,N,N,-,-1,-1
GLOVER.txt,345269,347836,2567,20,N,N,-,-1,-1
GLOVER.txt,347837,350565,2728,20,N,N,-,-1,-1
GLOVER.txt,350566,353067,2501,20,N,Y,1437471397525,350644,351290
GLOVER.txt,353069,355939,2870,20,N,N,-,-1,-1
GLOVER.txt,355940,358878,2938,20,N,N,-,-1,-1
GLOVER.txt,358881,361983,3102,20,N,N,-,-1,-1
GLOVER.txt,361985,364108,2123,20,N,N,-,-1,-1
GLOVER.txt,364109,367635,3526,20,N,N,-,-1,-1
GLOVER.txt,367638,371150,3512,20,N,N,-,-1,-1
GLOVER.txt,371153,373288,2135,20,N,N,-,-1,-1
GLOVER.txt,373289,376713,3424,20,N,N,-,-1,-1
GLOVER.txt,376715,379390,2675,20,N,N,-,-1,-1
GLOVER.txt,379391,382393,3002,20,N,N,-,-1,-1
GLOVER.txt,382394,384987,2593,20,N,N,-,-1,-1
GLOVER.txt,384988,387548,2560,20,N,N,-,-1,-1
GLOVER.txt,387549,390136,2587,20,N,N,-,-1,-1
GLOVER.txt,390137,392627,2490,20,N,N,-,-1,-1
GLOVER.txt,392628,395977,3349,20,N,Y,1437472966198,394609,395892
GLOVER.txt,395980,398784,2804,20,N,N,-,-1,-1
GLOVER.txt,398785,401662,2877,20,N,N,-,-1,-1
GLOVER.txt,401665,404961,3296,20,N,N,-,-1,-1
GLOVER.txt,404962,407840,2878,20,N,N,-,-1,-1
GLOVER.txt,407841,411467,3626,20,N,N,-,-1,-1
GLOVER.txt,411468,414453,2985,20,N,N,-,-1,-1
GLOVER.txt,414456,416503,2047,20,N,N,-,-1,-1
GLOVER.txt,416506,420873,4367,20,N,N,-,-1,-1
GLOVER.txt,420874,422581,1707,20,N,N,-,-1,-1
GLOVER.txt,422582,425152,2570,20,N,N,-,-1,-1
GLOVER.txt,425153,426505,1352,20,N,N,-,-1,-1
GLOVER.txt,426506,427495,989,20,N,N,-,-1,-1
GLOVER.txt,427496,429080,1584,20,N,N,-,-1,-1
GLOVER.txt,429081,431413,2332,20,N,N,-,-1,-1
GLOVER.txt,431416,434326,2910,20,N,N,-,-1,-1
GLOVER.txt,434328,437002,2674,20,Y,N,-,-1,-1
GLOVER.txt,437003,441822,4819,20,N,N,-,-1,-1
GLOVER.txt,441823,445694,3871,20,N,N,-,-1,-1
GLOVER.txt,445695,448588,2893,20,N,N,-,-1,-1
GLOVER.txt,448589,451811,3222,20,N,N,-,-1,-1
GLOVER.txt,451812,455654,3842,20,N,N,-,-1,-1
GLOVER.txt,455655,458526,2871,20,N,N,-,-1,-1
GLOVER.txt,458527,460829,2302,20,N,N,-,-1,-1
GLOVER.txt,460830,463779,2949,20,N,N,-,-1,-1
GLOVER.txt,463782,466920,3138,20,N,N,-,-1,-1
GLOVER.txt,466922,469241,2319,20,N,N,-,-1,-1
GLOVER.txt,469242,473014,3772,20,N,N,-,-1,-1
GLOVER.txt,473017,475631,2614,20,N,N,-,-1,-1
GLOVER.txt,475632,476405,773,20,N,N,-,-1,-1
GLOVER.txt,476406,478304,1898,20,N,N,-,-1,-1
GLOVER.txt,478305,482579,4274,20,N,N,-,-1,-1
GLOVER.txt,482580,484723,2143,20,N,N,-,-1,-1
GLOVER.txt,484726,486515,1789,20,N,N,-,-1,-1
GLOVER.txt,486516,487815,1299,20,N,N,-,-1,-1
GLOVER.txt,487816,489010,1194,20,N,N,-,-1,-1
GLOVER.txt,489011,490715,1704,20,N,N,-,-1,-1
GLOVER.txt,490716,491790,1074,20,N,N,-,-1,-1
GLOVER.txt,491791,493082,1291,20,N,N,-,-1,-1
GLOVER.txt,493083,494078,995,20,N,N,-,-1,-1
GLOVER.txt,494079,496742,2663,20,N,N,-,-1,-1
GLOVER.txt,496743,497584,841,20,N,N,-,-1,-1
GLOVER.txt,497589,498046,457,20,N,N,-,-1,-1
GLOVER.txt,498049,499430,1381,20,N,N,-,-1,-1
GLOVER.txt,499431,502921,3490,20,N,N,-,-1,-1
GLOVER.txt,502922,505374,2452,20,N,N,-,-1,-1
GLOVER.txt,505375,507743,2368,20,N,N,-,-1,-1
GLOVER.txt,507746,510300,2554,20,N,N,-,-1,-1
GLOVER.txt,510301,512476,2175,20,N,N,-,-1,-1
GRONOW.txt,0,1501,1501,20,N,N,-,-1,-1
GRONOW.txt,1504,3749,2245,20,N,N,-,-1,-1
GRONOW.txt,3752,7993,4241,20,N,N,-,-1,-1
GRONOW.txt,7994,10632,2638,20,N,N,-,-1,-1
GRONOW.txt,10635,14151,3516,20,N,N,-,-1,-1
GRONOW.txt,14154,18219,4065,20,N,N,-,-1,-1
GRONOW.txt,18224,21877,3653,20,N,N,-,-1,-1
GRONOW.txt,21878,24848,2970,20,N,N,-,-1,-1
GRONOW.txt,24849,28008,3159,20,N,N,-,-1,-1
GRONOW.txt,28009,32298,4289,20,N,N,-,-1,-1
GRONOW.txt,32301,35747,3446,20,N,N,-,-1,-1
GRONOW.txt,35748,39703,3955,20,N,N,-,-1,-1
GRONOW.txt,39704,42368,2664,20,N,N,-,-1,-1
GRONOW.txt,42369,44988,2619,20,N,N,-,-1,-1
GRONOW.txt,44989,47271,2282,20,N,N,-,-1,-1
GRONOW.txt,47273,50045,2772,20,N,N,-,-1,-1
GRONOW.txt,50046,53007,2961,20,N,N,-,-1,-1
GRONOW.txt,53008,56200,3192,20,N,N,-,-1,-1
GRONOW.txt,56201,59313,3112,20,N,N,-,-1,-1
GRONOW.txt,59314,62465,3151,20,N,N,-,-1,-1
GRONOW.txt,62466,65720,3254,20,N,N,-,-1,-1
GRONOW.txt,65721,67789,2068,20,N,N,-,-1,-1
GRONOW.txt,67792,69645,1853,20,N,N,-,-1,-1
GRONOW.txt,69646,72252,2606,20,N,N,-,-1,-1
GRONOW.txt,72253,75210,2957,20,N,N,-,-1,-1
GRONOW.txt,75211,78668,3457,20,N,N,-,-1,-1
GRONOW.txt,78669,82562,3893,20,N,N,-,-1,-1
GRONOW.txt,82563,85838,3275,20,N,N,-,-1,-1
GRONOW.txt,85839,89261,3422,20,N,N,-,-1,-1
GRONOW.txt,89263,93289,4026,20,N,N,-,-1,-1
GRONOW.txt,93290,96113,2823,20,N,N,-,-1,-1
GRONOW.txt,96114,99462,3348,20,N,Y,1437475017618,98942,100041
GRONOW.txt,99463,102983,3520,20,N,Y,1437475017618,98942,100041
GRONOW.txt,102986,106382,3396,20,N,N,-,-1,-1
GRONOW.txt,106383,109895,3512,20,N,N,-,-1,-1
GRONOW.txt,109896,114151,4255,20,N,N,-,-1,-1
GRONOW.txt,114156,117633,3477,20,N,N,-,-1,-1
GRONOW.txt,117636,121223,3587,20,N,N,-,-1,-1
GRONOW.txt,121225,124214,2989,20,N,N,-,-1,-1
GRONOW.txt,124215,126994,2779,20,N,N,-,-1,-1
GRONOW.txt,126995,131089,4094,20,N,N,-,-1,-1
GRONOW.txt,131092,134992,3900,20,N,N,-,-1,-1
GRONOW.txt,134993,137743,2750,20,N,N,-,-1,-1
GRONOW.txt,137744,140114,2370,20,N,N,-,-1,-1
GRONOW.txt,140115,143636,3521,20,N,N,-,-1,-1
GRONOW.txt,143637,146628,2991,20,N,N,-,-1,-1
GRONOW.txt,146629,151375,4746,20,N,N,-,-1,-1
GRONOW.txt,151376,155067,3691,20,N,N,-,-1,-1
GRONOW.txt,155072,158808,3736,20,N,N,-,-1,-1
GRONOW.txt,158811,162552,3741,20,N,N,-,-1,-1
GRONOW.txt,162553,165944,3391,20,N,N,-,-1,-1
GRONOW.txt,165945,169531,3586,20,N,N,-,-1,-1
GRONOW.txt,169532,173579,4047,20,N,N,-,-1,-1
GRONOW.txt,173580,177657,4077,20,N,N,-,-1,-1
GRONOW.txt,177659,180363,2704,20,N,N,-,-1,-1
GRONOW.txt,180364,183385,3021,20,N,N,-,-1,-1
GRONOW.txt,183386,187212,3826,20,N,N,-,-1,-1
GRONOW.txt,187213,190074,2861,20,N,N,-,-1,-1
GRONOW.txt,190075,194244,4169,20,N,N,-,-1,-1
GRONOW.txt,194245,198746,4501,20,N,N,-,-1,-1
GRONOW.txt,198749,202241,3492,20,N,N,-,-1,-1
GRONOW.txt,202242,206070,3828,20,N,N,-,-1,-1
GRONOW.txt,206071,209837,3766,20,N,N,-,-1,-1
GRONOW.txt,209838,212254,2416,20,N,N,-,-1,-1
GRONOW.txt,212257,215149,2892,20,N,N,-,-1,-1
GRONOW.txt,215150,218497,3347,20,N,N,-,-1,-1
GRONOW.txt,218500,221790,3290,20,N,Y,1437476486340,221621,222520
GRONOW.txt,221791,225902,4111,20,N,Y,1437476486340,221621,222520
GRONOW.txt,225904,228839,2935,20,N,N,-,-1,-1
GRONOW.txt,228840,231550,2710,20,N,N,-,-1,-1
GRONOW.txt,231551,235311,3760,20,N,N,-,-1,-1
GRONOW.txt,235312,239535,4223,20,N,N,-,-1,-1
GRONOW.txt,239536,243692,4156,20,N,N,-,-1,-1
GRONOW.txt,243693,248306,4613,20,N,N,-,-1,-1
GRONOW.txt,248309,252400,4091,20,N,N,-,-1,-1
GRONOW.txt,252403,256283,3880,20,N,N,-,-1,-1
GRONOW.txt,256284,260766,4482,20,N,N,-,-1,-1
GRONOW.txt,260769,264740,3971,20,N,N,-,-1,-1
GRONOW.txt,264741,267516,2775,20,N,N,-,-1,-1
GRONOW.txt,267517,271531,4014,20,N,N,-,-1,-1
GRONOW.txt,271532,275906,4374,20,N,N,-,-1,-1
GRONOW.txt,275907,279705,3798,20,N,N,-,-1,-1
GRONOW.txt,279706,284259,4553,20,N,N,-,-1,-1
GRONOW.txt,284261,289352,5091,20,N,N,-,-1,-1
GRONOW.txt,289353,294853,5500,20,N,N,-,-1,-1
GRONOW.txt,294856,299074,4218,20,N,N,-,-1,-1
GRONOW.txt,299075,303172,4097,20,N,N,-,-1,-1
GRONOW.txt,303173,307875,4702,20,N,N,-,-1,-1
GRONOW.txt,307876,311433,3557,20,N,N,-,-1,-1
GRONOW.txt,311434,315955,4521,20,N,N,-,-1,-1
GRONOW.txt,315956,320207,4251,20,N,N,-,-1,-1
GRONOW.txt,320210,323956,3746,20,N,N,-,-1,-1
GRONOW.txt,323959,326821,2862,20,N,N,-,-1,-1
GRONOW.txt,326824,329531,2707,20,N,N,-,-1,-1
GRONOW.txt,329534,332948,3414,20,N,N,-,-1,-1
GRONOW.txt,332949,336448,3499,20,N,N,-,-1,-1
GRONOW.txt,336449,340513,4064,20,N,N,-,-1,-1
GRONOW.txt,340515,344590,4075,20,N,N,-,-1,-1
GRONOW.txt,344591,347662,3071,20,N,N,-,-1,-1
GRONOW.txt,347663,351159,3496,20,N,N,-,-1,-1
GRONOW.txt,351161,354156,2995,20,N,N,-,-1,-1
GRONOW.txt,354157,358020,3863,20,N,N,-,-1,-1
GRONOW.txt,358021,362250,4229,20,N,N,-,-1,-1
GRONOW.txt,362251,364883,2632,20,N,N,-,-1,-1
GRONOW.txt,364884,368438,3554,20,N,N,-,-1,-1
GRONOW.txt,368439,371671,3232,20,N,N,-,-1,-1
GRONOW.txt,371674,374606,2932,20,N,N,-,-1,-1
GRONOW.txt,374607,378543,3936,20,N,N,-,-1,-1
GRONOW.txt,378546,382130,3584,20,N,N,-,-1,-1
GRONOW.txt,382131,385986,3855,20,N,N,-,-1,-1
GRONOW.txt,385989,389002,3013,20,N,N,-,-1,-1
GRONOW.txt,389003,392487,3484,20,N,N,-,-1,-1
GRONOW.txt,392488,395759,3271,20,N,N,-,-1,-1
GRONOW.txt,395761,398820,3059,20,N,N,-,-1,-1
GRONOW.txt,398823,401763,2940,20,N,N,-,-1,-1
GRONOW.txt,401764,405002,3238,20,N,N,-,-1,-1
GRONOW.txt,405003,408815,3812,20,N,N,-,-1,-1
GRONOW.txt,408816,412199,3383,20,N,N,-,-1,-1
GRONOW.txt,412200,415187,2987,20,N,N,-,-1,-1
GRONOW.txt,415190,419001,3811,20,N,N,-,-1,-1
GRONOW.txt,419004,422302,3298,20,N,N,-,-1,-1
GRONOW.txt,422303,424367,2064,20,N,N,-,-1,-1
GRONOW.txt,424368,427165,2797,20,N,Y,1437477480340,424837,425856
GRONOW.txt,427166,429570,2404,20,N,Y,1437477878183,427206,428439
GRONOW.txt,429571,432404,2833,20,N,N,-,-1,-1
GRONOW.txt,432406,435553,3147,20,N,N,-,-1,-1
GRONOW.txt,435555,437987,2432,20,N,N,-,-1,-1
GRONOW.txt,437988,440553,2565,20,N,N,-,-1,-1
GRONOW.txt,440554,443754,3200,20,N,N,-,-1,-1
GRONOW.txt,443755,447259,3504,20,N,N,-,-1,-1
GRONOW.txt,447260,450336,3076,20,N,N,-,-1,-1
GRONOW.txt,450337,453368,3031,20,N,N,-,-1,-1
GRONOW.txt,453369,457075,3706,20,N,N,-,-1,-1
GRONOW.txt,457076,460653,3577,20,N,N,-,-1,-1
GRONOW.txt,460654,463645,2991,20,Y,Y,1437490253936,460795,462238
GRONOW.txt,463646,466415,2769,20,N,N,-,-1,-1
GRONOW.txt,466416,471047,4631,20,N,N,-,-1,-1
GRONOW.txt,471050,473385,2335,20,N,N,-,-1,-1
GRONOW.txt,473388,476549,3161,20,N,N,-,-1,-1
GRONOW.txt,476550,480203,3653,20,N,N,-,-1,-1
GRONOW.txt,480204,482872,2668,20,N,N,-,-1,-1
GRONOW.txt,482873,486397,3524,20,N,N,-,-1,-1
GRONOW.txt,486398,490041,3643,20,N,N,-,-1,-1
GRONOW.txt,490042,493829,3787,20,Y,N,-,-1,-1
GRONOW.txt,493830,496611,2781,20,N,N,-,-1,-1
GRONOW.txt,496612,499434,2822,20,N,N,-,-1,-1
GRONOW.txt,499435,503271,3836,20,N,N,-,-1,-1
GRONOW.txt,503272,507365,4093,20,N,N,-,-1,-1
GRONOW.txt,507366,510799,3433,20,N,N,-,-1,-1
GRONOW.txt,510800,514103,3303,20,N,N,-,-1,-1
GRONOW.txt,514104,517287,3183,20,N,N,-,-1,-1
GRONOW.txt,517292,519819,2527,20,N,N,-,-1,-1
GRONOW.txt,519820,523217,3397,20,N,N,-,-1,-1
GRONOW.txt,523218,526186,2968,20,N,N,-,-1,-1
GRONOW.txt,526187,529110,2923,20,N,N,-,-1,-1
GRONOW.txt,529111,532394,3283,20,N,N,-,-1,-1
GRONOW.txt,532397,536098,3701,20,N,N,-,-1,-1
GRONOW.txt,536099,538910,2811,20,N,N,-,-1,-1
GRONOW.txt,538911,541520,2609,20,N,N,-,-1,-1
GRONOW.txt,541521,545264,3743,20,N,N,-,-1,-1
GRONOW.txt,545265,548617,3352,20,N,N,-,-1,-1
GRONOW.txt,548618,551259,2641,20,N,N,-,-1,-1
GRONOW.txt,551261,554858,3597,20,N,N,-,-1,-1
GRONOW.txt,554859,557387,2528,20,N,N,-,-1,-1
GRONOW.txt,557392,560015,2623,20,N,N,-,-1,-1
GRONOW.txt,560016,563725,3709,20,N,N,-,-1,-1
GRONOW.txt,563726,564191,465,20,N,N,-,-1,-1
GRONOW.txt,564191,564675,484,20,N,N,-,-1,-1
GRONOW.txt,564676,565318,642,20,N,N,-,-1,-1
GRONOW.txt,565320,565767,447,20,N,N,-,-1,-1
MASONB.txt,0,2793,2793,20,N,N,-,-1,-1
MASONB.txt,2794,5538,2744,20,N,N,-,-1,-1
MASONB.txt,5539,7807,2268,20,N,N,-,-1,-1
MASONB.txt,7810,9388,1578,20,N,N,-,-1,-1
MASONB.txt,9389,11846,2457,20,N,N,-,-1,-1
MASONB.txt,11847,14396,2549,20,N,Y,1448037533268,13930,15031
MASONB.txt,14397,16370,1973,20,N,Y,1448038101349,15101,17486
MASONB.txt,16371,19011,2640,20,N,Y,1448038803075,18895,19670
MASONB.txt,19013,21783,2770,20,N,Y,1448038803075,18895,19670
MASONB.txt,21786,24060,2274,20,N,Y,1448274783410,21836,25159
MASONB.txt,24061,26181,2120,20,N,Y,1448274893770,25386,26202
MASONB.txt,26182,28914,2732,20,N,Y,1448275407308,26987,29181
MASONB.txt,28916,32207,3291,20,Y,Y,1448275407308,26987,29181
MASONB.txt,32208,36088,3880,20,N,Y,1448276340407,30017,39003
MASONB.txt,36089,37904,1815,20,N,Y,1448276340407,30017,39003
MASONB.txt,37905,40685,2780,20,N,Y,1448276340407,30017,39003
MASONB.txt,40686,43195,2509,20,N,Y,1448277167610,40886,47737
MASONB.txt,43198,47028,3830,20,Y,Y,1448277167610,40886,47737
MASONB.txt,47029,49763,2734,20,N,Y,1448277167610,40886,47737
MASONB.txt,49766,53850,4084,20,Y,Y,1448277582432,52552,54595
MASONB.txt,53851,57207,3356,20,Y,Y,1448277582432,52552,54595
MASONB.txt,57210,60262,3052,20,N,Y,1448278279697,58861,59444
MASONB.txt,60263,63146,2883,20,Y,N,-,-1,-1
MASONB.txt,63148,66462,3314,20,N,Y,1448278425221,65586,65914
MASONB.txt,66463,68689,2226,20,N,Y,1448279089520,67624,69991
MASONB.txt,68690,71045,2355,20,Y,Y,1448279620157,70041,71486
MASONB.txt,71046,73140,2094,20,Y,Y,1448279620157,70041,71486
MASONB.txt,73141,77514,4373,20,N,N,-,-1,-1
MASONB.txt,77515,81327,3812,20,Y,N,-,-1,-1
MASONB.txt,81328,83940,2612,20,N,N,-,-1,-1
MASONB.txt,83943,86398,2455,20,N,Y,1448280423373,85694,86154
MASONB.txt,86399,88832,2433,20,N,Y,1448280884746,88496,89294
MASONB.txt,88833,90052,1219,20,N,Y,1448281320115,89144,91129
MASONB.txt,90053,92554,2501,20,N,Y,1448281320115,89144,91129
MASONB.txt,92555,95974,3419,20,N,N,-,-1,-1
MASONB.txt,95975,98914,2939,20,Y,Y,1448281888079,98877,102290
MASONB.txt,98915,102096,3181,20,Y,Y,1448281888079,98877,102290
MASONB.txt,102097,104355,2258,20,Y,Y,1448281888079,98877,102290
MASONB.txt,104356,107642,3286,20,N,Y,1448285563397,102964,108476
MASONB.txt,107643,109698,2055,20,Y,Y,1448285913012,108803,110925
MASONB.txt,109699,111575,1876,20,N,Y,1448285913012,108803,110925
MASONB.txt,111578,114009,2431,20,Y,Y,1448286451685,111065,112127
MASONB.txt,114010,116800,2790,20,N,Y,1448287306770,114686,120152
MASONB.txt,116801,119461,2660,20,N,Y,1448287306770,114686,120152
MASONB.txt,119462,122808,3346,20,N,Y,1448287306770,114686,120152
MASONB.txt,122809,125598,2789,20,N,Y,1448287490368,120754,123385
MASONB.txt,125599,128712,3113,20,N,N,-,-1,-1
MASONB.txt,128713,131446,2733,20,N,N,-,-1,-1
MASONB.txt,131447,134311,2864,20,N,N,-,-1,-1
MASONB.txt,134314,137512,3198,20,N,Y,1448310549245,137491,141408
MASONB.txt,137513,140623,3110,20,Y,Y,1448310549245,137491,141408
MASONB.txt,140624,143007,2383,20,N,Y,1448310549245,137491,141408
MASONB.txt,143008,144119,1111,20,N,Y,1448311366799,143137,146264
MASONB.txt,144120,146249,2129,20,N,Y,1448311366799,143137,146264
MASONB.txt,146250,148932,2682,20,Y,Y,1448311366799,143137,146264
MASONB.txt,148934,152673,3739,20,N,N,-,-1,-1
MASONB.txt,152674,156325,3651,20,N,Y,1448311594480,155711,156312
MASONB.txt,156330,158687,2357,20,N,Y,1448311811907,157566,161100
MASONB.txt,158690,161724,3034,20,N,Y,1448311811907,157566,161100
MASONB.txt,161727,163382,1655,20,N,N,-,-1,-1
MASONB.txt,163384,165760,2376,20,N,N,-,-1,-1
MASONB.txt,165762,168737,2975,20,Y,N,-,-1,-1
MASONB.txt,168738,171699,2961,20,Y,N,-,-1,-1
MASONB.txt,171702,174565,2863,20,Y,Y,1448312844411,173573,174472
MASONB.txt,174566,177707,3141,20,N,Y,1448313482895,176553,176862
MASONB.txt,177710,179955,2245,20,N,Y,1448313800274,179025,179317
MASONB.txt,179956,183224,3268,20,N,Y,1448315012079,181380,182053
MASONB.txt,183227,185268,2041,20,Y,Y,1448316079788,183824,184995
MASONB.txt,185271,188378,3107,20,N,N,-,-1,-1
MASONB.txt,188379,191637,3258,20,N,N,-,-1,-1
MASONB.txt,191638,192639,1001,20,N,N,-,-1,-1
MASONB.txt,192642,193256,614,20,N,N,-,-1,-1
MASONB.txt,193257,194116,859,20,N,N,-,-1,-1
MASONB.txt,194119,195198,1079,20,N,N,-,-1,-1
MASONB.txt,195198,195818,620,20,N,N,-,-1,-1
MASONB.txt,195819,198814,2995,20,N,N,-,-1,-1
MASONB.txt,198815,203876,5061,20,N,N,-,-1,-1
MASONB.txt,203877,206672,2795,20,N,Y,1448316411409,206556,208475
MASONB.txt,206673,210236,3563,20,N,Y,1448316586529,210063,210674
MASONB.txt,210239,212973,2734,20,N,Y,1448316586529,210063,210674
MASONB.txt,212976,215098,2122,20,N,Y,1448322095209,213778,214023
MASONB.txt,215099,219937,4838,20,N,Y,1448322273366,219239,219544
MASONB.txt,219938,222179,2241,20,Y,Y,1448322514970,220165,221397
MASONB.txt,222180,225421,3241,20,N,Y,1448322713112,221941,223038
MASONB.txt,225424,227964,2540,20,N,Y,1448323072174,227638,227786
MASONB.txt,227965,230271,2306,20,N,Y,1448323254416,230223,230526
MASONB.txt,230272,233030,2758,20,N,Y,1448325046337,230539,231128
MASONB.txt,233033,236200,3167,20,N,Y,1448357582358,234204,234401
MASONB.txt,236201,238849,2648,20,N,Y,1448358538400,238461,240031
MASONB.txt,238850,241400,2550,20,N,Y,1448358538400,238461,240031
MASONB.txt,241401,243908,2507,20,Y,N,-,-1,-1
MASONB.txt,243911,246626,2715,20,N,N,-,-1,-1
MASONB.txt,246627,249193,2566,20,Y,Y,1448359079273,247104,249268
MASONB.txt,249194,251706,2512,20,Y,Y,1448359079273,247104,249268
MASONB.txt,251707,253490,1783,20,N,N,-,-1,-1
MASONB.txt,253491,255956,2465,20,N,N,-,-1,-1
MASONB.txt,255957,259228,3271,20,N,N,-,-1,-1
MASONB.txt,259229,261442,2213,20,N,N,-,-1,-1
MASONB.txt,261443,263496,2053,20,N,Y,1448359440819,262798,263079
MASONB.txt,263497,265782,2285,20,N,Y,1448359608080,265546,265784
MASONB.txt,265783,268821,3038,20,N,Y,1448359878707,265791,267089
MASONB.txt,268822,272078,3256,20,N,Y,1448366107348,271942,274308
MASONB.txt,272079,274654,2575,20,Y,Y,1448366107348,271942,274308
MASONB.txt,274655,278011,3356,20,Y,Y,1448366492754,275659,275884
MASONB.txt,278016,280497,2481,20,N,Y,1448367094347,278355,278591
MASONB.txt,280500,284461,3961,20,Y,Y,1448393386565,284140,284575
MASONB.txt,284464,286793,2329,20,N,Y,1448393386565,284140,284575
MASONB.txt,286794,289018,2224,20,N,Y,1448393552252,287738,288962
MASONB.txt,289021,291096,2075,20,N,Y,1448393918391,289044,290517
MASONB.txt,291097,292539,1442,20,N,Y,1448394636895,292272,293963
MASONB.txt,292540,293972,1432,20,N,Y,1448394636895,292272,293963
MASONB.txt,293975,296762,2787,20,N,Y,1448396118064,295199,297352
MASONB.txt,296765,299600,2835,20,N,Y,1448396118064,295199,297352
MASONB.txt,299603,301211,1608,20,N,Y,1448396441082,299649,301294
MASONB.txt,301212,303331,2119,20,N,Y,1448396441082,299649,301294
MASONB.txt,303332,305381,2049,20,N,N,-,-1,-1
MASONB.txt,305382,308689,3307,20,N,Y,1448397101672,305423,307582
MASONB.txt,308690,311905,3215,20,N,Y,1448397400459,310446,310619
MASONB.txt,311906,314063,2157,20,N,Y,1448658303622,312507,313648
MASONB.txt,314064,317455,3391,20,N,Y,1448658612805,316427,316672
MASONB.txt,317458,321878,4420,20,N,Y,1448659006435,318991,319718
MASONB.txt,321879,325513,3634,20,N,Y,1448659532009,324326,325031
MASONB.txt,325514,329202,3688,20,N,Y,1448660077114,325649,326955
MASONB.txt,329203,333052,3849,20,N,Y,1448706327916,331732,332605
MASONB.txt,333055,335242,2187,20,N,Y,1448707430181,333075,333132
MASONB.txt,335245,336039,794,20,N,Y,1448709266671,335017,336316
MASONB.txt,336040,337116,1076,20,N,Y,1448709266671,335017,336316
MASONB.txt,337119,339325,2206,20,N,Y,1448709670572,338913,339172
MASONB.txt,339326,341818,2492,20,N,Y,1448835299579,341107,342636
MASONB.txt,341821,343023,1202,20,N,Y,1448835299579,341107,342636
MASONB.txt,343024,343526,502,20,N,N,-,-1,-1
MASONB.txt,343527,344153,626,20,N,N,-,-1,-1
MASONB.txt,344153,344692,539,20,N,N,-,-1,-1
MASONB.txt,344693,346241,1548,20,N,Y,1448835409437,345709,346338
MASONB.txt,346242,348244,2002,20,N,Y,1448835409437,345709,346338
MASONB.txt,348246,351060,2814,20,N,Y,1448919978818,348008,348718
MASONB.txt,351063,354659,3596,20,N,N,-,-1,-1
MASONB.txt,354662,357527,2865,20,N,N,-,-1,-1
MASONB.txt,357528,360626,3098,20,N,Y,1448920293515,357836,358190
MASONB.txt,360627,364645,4018,20,N,Y,1448920858487,363333,364839
MASONB.txt,364646,367052,2406,20,N,Y,1448920858487,363333,364839
MASONB.txt,367053,370263,3210,20,N,Y,1448921338450,367291,368573
MASONB.txt,370264,372506,2242,20,N,Y,1448921716519,370956,371267
MASONB.txt,372507,375316,2809,20,N,Y,1448922003968,373392,374323
MASONB.txt,375317,377736,2419,20,N,Y,1448922458482,377161,378772
MASONB.txt,377737,380575,2838,20,N,Y,1448922458482,377161,378772
MASONB.txt,380577,383692,3115,20,N,Y,1448923016815,381625,382381
MASONB.txt,383693,385652,1959,20,N,N,-,-1,-1
MASONB.txt,385655,387680,2025,20,N,N,-,-1,-1
MASONB.txt,387681,390189,2508,20,N,N,-,-1,-1
MASONB.txt,390190,394137,3947,20,N,N,-,-1,-1
MASONB.txt,394140,395768,1628,20,N,N,-,-1,-1
MASONB.txt,395768,397158,1390,20,N,N,-,-1,-1
MASONB.txt,397159,397888,729,20,N,N,-,-1,-1
MASONB.txt,397889,399575,1686,20,N,N,-,-1,-1
MASONB.txt,399577,402073,2496,20,N,N,-,-1,-1
MASONB.txt,402074,404698,2624,20,N,N,-,-1,-1
MASONB.txt,404699,407413,2714,20,N,N,-,-1,-1
MASONB.txt,407414,409681,2267,20,N,N,-,-1,-1
MASONB.txt,409682,412233,2551,20,N,N,-,-1,-1
MASONB.txt,412234,414204,1970,20,N,N,-,-1,-1
MASONB.txt,414205,414695,490,20,N,N,-,-1,-1
MASONB.txt,414696,415631,935,20,N,N,-,-1,-1
MASONB.txt,415632,417989,2357,20,N,N,-,-1,-1
MASONB.txt,417990,420333,2343,20,N,N,-,-1,-1
MASONB.txt,420334,422826,2492,20,N,N,-,-1,-1
MASONB.txt,422827,425376,2549,20,N,N,-,-1,-1
MASONB.txt,425377,428151,2774,20,N,N,-,-1,-1
MASONB.txt,428153,431115,2962,20,N,N,-,-1,-1
MASONB.txt,431116,433428,2312,20,N,N,-,-1,-1
MASONB.txt,433429,435663,2234,20,N,N,-,-1,-1
MASONB.txt,435664,438724,3060,20,N,N,-,-1,-1
MASONB.txt,438725,441964,3239,20,N,N,-,-1,-1
MASONB.txt,441965,445794,3829,20,Y,N,-,-1,-1
MASONB.txt,445797,447879,2082,20,N,N,-,-1,-1
MASONB.txt,447880,449159,1279,20,N,N,-,-1,-1
MASONB.txt,449160,449956,796,20,N,N,-,-1,-1
MASONB.txt,449957,451561,1604,20,N,N,-,-1,-1
MASONB.txt,451562,454149,2587,20,N,N,-,-1,-1
MASONB.txt,454150,456541,2391,20,Y,N,-,-1,-1
MASONB.txt,456542,458854,2312,20,N,N,-,-1,-1
MASONB.txt,458854,460116,1262,20,N,N,-,-1,-1
MASONB.txt,460118,461365,1247,20,N,N,-,-1,-1
MASONB.txt,461366,462903,1537,20,N,N,-,-1,-1
MASONB.txt,462904,465286,2382,20,N,N,-,-1,-1
MASONB.txt,465287,467366,2079,20,N,N,-,-1,-1
MASONB.txt,467367,469197,1830,20,N,N,-,-1,-1
MASONB.txt,469198,471317,2119,20,N,Y,1448923619461,471131,472718
MASONB.txt,471318,473611,2293,20,N,Y,1448923619461,471131,472718
MASONB.txt,473612,475880,2268,20,N,Y,1449009694213,473488,474410
MASONB.txt,475882,479156,3274,20,N,N,-,-1,-1
MASONB.txt,479157,481492,2335,20,N,N,-,-1,-1
MASONB.txt,481493,482745,1252,20,N,N,-,-1,-1
MASONB.txt,482746,483312,566,20,N,N,-,-1,-1
MASONB.txt,483313,485391,2078,20,N,N,-,-1,-1
MASONB.txt,485392,488152,2760,20,N,N,-,-1,-1
MASONB.txt,488153,488768,615,20,N,N,-,-1,-1
MASONB.txt,488771,489599,828,20,N,N,-,-1,-1
MASONB.txt,489600,492180,2580,20,Y,N,-,-1,-1
MASONB.txt,492182,495109,2927,20,Y,N,-,-1,-1
MASONB.txt,495110,498192,3082,20,N,N,-,-1,-1
MASONB.txt,498193,500002,1809,20,N,N,-,-1,-1
MASONB.txt,500003,503088,3085,20,N,N,-,-1,-1
MASONB.txt,503089,506231,3142,20,Y,N,-,-1,-1
MASONB.txt,506232,508226,1994,20,N,N,-,-1,-1
MASONB.txt,508229,510061,1832,20,N,N,-,-1,-1
MASONB.txt,510062,511027,965,20,N,N,-,-1,-1
MASONB.txt,511028,512803,1775,20,N,N,-,-1,-1
MASONB.txt,512804,516152,3348,20,N,N,-,-1,-1
MASONB.txt,516153,518627,2474,20,N,N,-,-1,-1
MASONB.txt,518628,520739,2111,20,N,N,-,-1,-1
MASONB.txt,520740,522765,2025,20,N,N,-,-1,-1
MASONB.txt,522767,525063,2296,20,N,N,-,-1,-1
MASONB.txt,525064,527147,2083,20,N,N,-,-1,-1
MASONB.txt,527148,529609,2461,20,N,Y,1449011557797,528395,529262
MASONB.txt,529612,532907,3295,20,N,N,-,-1,-1
MASONB.txt,532910,535336,2426,20,N,Y,1461670558474,533968,535655
MASONB.txt,535337,537833,2496,20,N,Y,1461670707714,535735,535836
MASONB.txt,537834,539722,1888,20,N,Y,1461671039271,535897,538614
MASONB.txt,539723,541752,2029,20,N,Y,1461682939139,540732,541471
MASONB.txt,541753,542694,941,20,N,N,-,-1,-1
MASONB.txt,542695,544089,1394,20,N,Y,1461777193721,543550,543984
MASONB.txt,544090,546531,2441,20,N,Y,1461777612954,544164,545194
MASONB.txt,546536,549146,2610,20,N,Y,1461779662782,546686,549591
MASONB.txt,549147,551407,2260,20,N,Y,1461790554025,550059,551049
MASONB.txt,551408,553671,2263,20,N,Y,1461791817263,551075,551983
MASONB.txt,553672,556425,2753,20,N,Y,1462038250768,556311,558014
MASONB.txt,556427,559177,2750,20,N,Y,1462038250768,556311,558014
MASONB.txt,559178,560808,1630,20,N,N,-,-1,-1
MASONB.txt,560809,562257,1448,20,Y,N,-,-1,-1
MASONB.txt,562262,564191,1929,20,N,N,-,-1,-1
MASONB.txt,564192,566207,2015,20,N,N,-,-1,-1
MASONB.txt,566210,568630,2420,20,N,N,-,-1,-1
MASONB.txt,568631,571521,2890,20,N,N,-,-1,-1
MEMMUS.txt,0,11007,11007,20,Y,N,-,-1,-1
MEMMUS.txt,11008,13127,2119,20,N,N,-,-1,-1
MEMMUS.txt,13130,16124,2994,20,N,N,-,-1,-1
MEMMUS.txt,16126,18455,2329,20,N,Y,1435840591315,18262,18851
MEMMUS.txt,18456,20220,1764,20,N,Y,1435840591315,18262,18851
MEMMUS.txt,20221,22360,2139,20,N,Y,1435915325286,22285,22827
MEMMUS.txt,22361,24851,2490,20,N,Y,1435915981952,24325,25472
MEMMUS.txt,24852,28241,3389,20,N,Y,1435916345649,25766,26337
MEMMUS.txt,28244,31063,2819,20,N,Y,1435916831062,28859,29721
MEMMUS.txt,31064,34195,3131,20,N,Y,1435927129543,33653,34022
MEMMUS.txt,34196,37431,3235,20,N,Y,1435928087149,36052,37379
MEMMUS.txt,37434,39747,2313,20,N,N,-,-1,-1
MEMMUS.txt,39750,42993,3243,20,Y,N,-,-1,-1
MEMMUS.txt,42995,45590,2595,20,Y,N,-,-1,-1
MEMMUS.txt,45591,47352,1761,20,N,Y,1435930107895,46560,46927
MEMMUS.txt,47353,50311,2958,20,Y,Y,1435930476313,46955,47602
MEMMUS.txt,50314,53872,3558,20,Y,Y,1435930984335,53222,54022
MEMMUS.txt,53873,56783,2910,20,N,Y,1435930984335,53222,54022
MEMMUS.txt,56784,59964,3180,20,N,N,-,-1,-1
MEMMUS.txt,59966,63059,3093,20,Y,N,-,-1,-1
MEMMUS.txt,63062,65783,2721,20,N,Y,1435931512268,64554,65135
MEMMUS.txt,65785,69123,3338,20,N,Y,1436164309168,67698,68227
MEMMUS.txt,69124,72026,2902,20,N,Y,1436164628291,70081,70559
MEMMUS.txt,72027,74201,2174,20,N,Y,1436173608702,72553,73111
MEMMUS.txt,74202,77124,2922,20,N,Y,1436174454662,76332,76889
MEMMUS.txt,77125,79603,2478,20,N,N,-,-1,-1
MEMMUS.txt,79606,82959,3353,20,N,Y,1436174968369,81917,82485
MEMMUS.txt,82960,85368,2408,20,Y,Y,1436175572082,83734,84298
MEMMUS.txt,85369,89087,3718,20,Y,Y,1436176439600,86589,87384
MEMMUS.txt,89088,90300,1212,20,N,N,-,-1,-1
MEMMUS.txt,90301,92098,1797,20,N,N,-,-1,-1
MEMMUS.txt,92100,95112,3012,20,N,Y,1436178232441,94736,96568
MEMMUS.txt,95113,98222,3109,20,N,Y,1436178232441,94736,96568
MEMMUS.txt,98225,101487,3262,20,Y,N,-,-1,-1
MEMMUS.txt,101490,104392,2902,20,N,N,-,-1,-1
MEMMUS.txt,104393,107608,3215,20,N,N,-,-1,-1
MEMMUS.txt,107611,110505,2894,20,N,Y,1436181440816,109452,110419
MEMMUS.txt,110508,113199,2691,20,Y,N,-,-1,-1
MEMMUS.txt,113201,115548,2347,20,N,N,-,-1,-1
MEMMUS.txt,115553,119393,3840,20,N,Y,1436182498768,117674,118815
MEMMUS.txt,119394,122541,3147,20,N,Y,1436182942743,119767,120353
MEMMUS.txt,122542,125277,2735,20,N,N,-,-1,-1
MEMMUS.txt,125278,127677,2399,20,N,N,-,-1,-1
MEMMUS.txt,127679,131397,3718,20,N,N,-,-1,-1
MEMMUS.txt,131400,134403,3003,20,N,Y,1436192343938,134271,135042
MEMMUS.txt,134405,137367,2962,20,N,Y,1436192343938,134271,135042
MEMMUS.txt,137368,140634,3266,20,N,Y,1436193426140,136824,137579
MEMMUS.txt,140635,144326,3691,20,N,N,-,-1,-1
MEMMUS.txt,144329,146914,2585,20,N,N,-,-1,-1
MEMMUS.txt,146917,149702,2785,20,N,N,-,-1,-1
MEMMUS.txt,149703,152650,2947,20,N,N,-,-1,-1
MEMMUS.txt,152651,155191,2540,20,N,Y,1436194630719,153960,154457
MEMMUS.txt,155192,158297,3105,20,N,N,-,-1,-1
MEMMUS.txt,158300,161779,3479,20,N,N,-,-1,-1
MEMMUS.txt,161780,165191,3411,20,N,N,-,-1,-1
MEMMUS.txt,165192,168451,3259,20,Y,Y,1436195369775,166223,166802
MEMMUS.txt,168452,171421,2969,20,N,Y,1436195820165,167327,168540
MEMMUS.txt,171422,174681,3259,20,Y,N,-,-1,-1
MEMMUS.txt,174682,178122,3440,20,Y,N,-,-1,-1
MEMMUS.txt,178123,182550,4427,20,Y,Y,1436200836078,181418,182145
MEMMUS.txt,182551,184977,2426,20,N,Y,1436201256737,183322,184063
MEMMUS.txt,184978,187533,2555,20,N,Y,1436202482351,186272,186982
MEMMUS.txt,187536,190241,2705,20,N,N,-,-1,-1
MEMMUS.txt,190243,192427,2184,20,Y,Y,1436250955725,191454,191936
MEMMUS.txt,192430,195486,3056,20,Y,Y,1436258886793,195179,195770
MEMMUS.txt,195489,198664,3175,20,Y,Y,1436258886793,195179,195770
MEMMUS.txt,198667,201678,3011,20,N,Y,1436260597356,198665,199131
MEMMUS.txt,201679,204677,2998,20,N,Y,1436262032838,201561,202518
MEMMUS.txt,204678,207160,2482,20,N,Y,1436263043874,205904,206889
MEMMUS.txt,207161,207955,794,20,N,Y,1436263335878,206962,209396
MEMMUS.txt,207957,208427,470,20,N,Y,1436263335878,206962,209396
MEMMUS.txt,208428,209244,816,20,N,Y,1436263335878,206962,209396
MEMMUS.txt,209247,212025,2778,20,N,Y,1436263335878,206962,209396
MEMMUS.txt,212027,215179,3152,20,Y,Y,1436264049561,214305,214870
MEMMUS.txt,215179,217807,2628,20,N,N,-,-1,-1
MEMMUS.txt,217812,220982,3170,20,N,N,-,-1,-1
MEMMUS.txt,220985,223533,2548,20,Y,N,-,-1,-1
MEMMUS.txt,223534,225836,2302,20,N,Y,1436265822598,225579,226125
MEMMUS.txt,225839,228682,2843,20,N,Y,1436265822598,225579,226125
MEMMUS.txt,228685,231370,2685,20,N,Y,1436266262307,226191,228765
MEMMUS.txt,231371,234274,2903,20,N,N,-,-1,-1
MEMMUS.txt,234275,237666,3391,20,N,N,-,-1,-1
MEMMUS.txt,237667,241430,3763,20,N,Y,1436280456835,240521,241413
MEMMUS.txt,241432,244249,2817,20,N,Y,1436281042239,244109,244443
MEMMUS.txt,244250,247133,2883,20,N,Y,1436281325939,245388,246385
MEMMUS.txt,247134,250547,3413,20,Y,Y,1436281897258,250318,251929
MEMMUS.txt,250548,253833,3285,20,Y,Y,1436282192995,253074,254294
MEMMUS.txt,253834,256116,2282,20,Y,Y,1436282192995,253074,254294
MEMMUS.txt,256117,259594,3477,20,N,Y,1436282832945,258754,259560
MEMMUS.txt,259595,262130,2535,20,N,Y,1436283306101,260256,261072
MEMMUS.txt,262131,265065,2934,20,N,Y,1436284721620,262676,264766
MEMMUS.txt,265066,268080,3014,20,N,Y,1436423346848,266385,267054
MEMMUS.txt,268081,270853,2772,20,N,N,-,-1,-1
MEMMUS.txt,270856,273864,3008,20,Y,N,-,-1,-1
MEMMUS.txt,273865,276789,2924,20,N,Y,1436423891936,276321,278167
MEMMUS.txt,276790,279509,2719,20,N,Y,1436423891936,276321,278167
MEMMUS.txt,279510,282414,2904,20,N,Y,1436424974663,281505,282511
MEMMUS.txt,282415,286136,3721,20,N,Y,1436424974663,281505,282511
MEMMUS.txt,286137,289486,3349,20,N,N,-,-1,-1
MEMMUS.txt,289488,292355,2867,20,N,N,-,-1,-1
MEMMUS.txt,292358,295172,2814,20,N,N,-,-1,-1
MEMMUS.txt,295173,297225,2052,20,N,N,-,-1,-1
MEMMUS.txt,297228,299488,2260,20,N,N,-,-1,-1
MEMMUS.txt,299489,302069,2580,20,N,N,-,-1,-1
MEMMUS.txt,302070,304265,2195,20,N,Y,1436432727712,303953,304575
MEMMUS.txt,304266,306192,1926,20,N,Y,1436432727712,303953,304575
MEMMUS.txt,306193,309375,3182,20,N,N,-,-1,-1
MEMMUS.txt,309376,312703,3327,20,N,N,-,-1,-1
MEMMUS.txt,312704,316189,3485,20,N,N,-,-1,-1
MEMMUS.txt,316190,319544,3354,20,N,N,-,-1,-1
MEMMUS.txt,319545,322206,2661,20,Y,N,-,-1,-1
MEMMUS.txt,322207,325661,3454,20,N,N,-,-1,-1
MEMMUS.txt,325663,329204,3541,20,N,N,-,-1,-1
MEMMUS.txt,329205,332347,3142,20,N,Y,1436434376182,331404,332945
MEMMUS.txt,332349,334699,2350,20,N,Y,1436434595667,333552,333949
MEMMUS.txt,334700,337767,3067,20,N,Y,1436435221703,336880,337454
MEMMUS.txt,337768,339998,2230,20,N,N,-,-1,-1
MEMMUS.txt,339999,342811,2812,20,N,Y,1436435912176,340974,341737
MEMMUS.txt,342814,346314,3500,20,N,Y,1436436770716,345847,347230
MEMMUS.txt,346315,348412,2097,20,N,Y,1436436770716,345847,347230
MEMMUS.txt,348413,350903,2490,20,N,N,-,-1,-1
MEMMUS.txt,350904,353643,2739,20,Y,N,-,-1,-1
MEMMUS.txt,353644,356963,3319,20,N,N,-,-1,-1
MEMMUS.txt,356964,359847,2883,20,N,N,-,-1,-1
MEMMUS.txt,359850,362972,3122,20,N,Y,1436438560540,362307,362847
MEMMUS.txt,362973,365663,2690,20,Y,N,-,-1,-1
MEMMUS.txt,365664,367829,2165,20,N,Y,1436438967800,366801,367625
MEMMUS.txt,367830,370777,2947,20,N,N,-,-1,-1
MEMMUS.txt,370779,373110,2331,20,N,N,-,-1,-1
MEMMUS.txt,373111,375577,2466,20,Y,N,-,-1,-1
MEMMUS.txt,375578,378247,2669,20,Y,Y,1436445421219,377558,378460
MEMMUS.txt,378248,381467,3219,20,N,Y,1436445421219,377558,378460
MEMMUS.txt,381470,384519,3049,20,Y,N,-,-1,-1
MEMMUS.txt,384520,387850,3330,20,N,N,-,-1,-1
MEMMUS.txt,387851,390850,2999,20,N,N,-,-1,-1
MEMMUS.txt,390851,394190,3339,20,Y,N,-,-1,-1
MEMMUS.txt,394191,397296,3105,20,N,N,-,-1,-1
MEMMUS.txt,397297,400224,2927,20,N,N,-,-1,-1
MEMMUS.txt,400226,402982,2756,20,N,N,-,-1,-1
MEMMUS.txt,402983,404959,1976,20,N,N,-,-1,-1
MEMMUS.txt,404961,408646,3685,20,N,Y,1436457314337,407582,409801
MEMMUS.txt,408649,411387,2738,20,N,Y,1436457314337,407582,409801
MEMMUS.txt,411388,415599,4211,20,N,N,-,-1,-1
MEMMUS.txt,415600,418573,2973,20,N,N,-,-1,-1
MEMMUS.txt,418574,420985,2411,20,N,N,-,-1,-1
MEMMUS.txt,420986,423684,2698,20,N,N,-,-1,-1
MEMMUS.txt,423685,427286,3601,20,N,N,-,-1,-1
MEMMUS.txt,427289,429766,2477,20,N,N,-,-1,-1
MEMMUS.txt,429767,433229,3462,20,N,N,-,-1,-1
MEMMUS.txt,433230,435956,2726,20,N,N,-,-1,-1
MEMMUS.txt,435961,439742,3781,20,N,Y,1436459343773,439368,440020
MEMMUS.txt,439743,441921,2178,20,N,Y,1436459343773,439368,440020
MEMMUS.txt,441922,444513,2591,20,N,Y,1436518466769,443385,444821
MEMMUS.txt,444514,447978,3464,20,N,Y,1436518466769,443385,444821
MEMMUS.txt,447979,450843,2864,20,N,Y,1436519578396,448667,449299
MEMMUS.txt,450844,453904,3060,20,N,Y,1436519953118,452615,453356
MEMMUS.txt,453905,456674,2769,20,N,N,-,-1,-1
MEMMUS.txt,456675,459256,2581,20,N,N,-,-1,-1
MEMMUS.txt,459257,462790,3533,20,N,N,-,-1,-1
MEMMUS.txt,462791,466432,3641,20,Y,N,-,-1,-1
MEMMUS.txt,466435,469530,3095,20,N,Y,1436521270492,469143,469869
MEMMUS.txt,469531,472865,3334,20,N,Y,1436521270492,469143,469869
MEMMUS.txt,472866,476599,3733,20,Y,Y,1436522398418,471475,474672
MEMMUS.txt,476602,479240,2638,20,N,N,-,-1,-1
MEMMUS.txt,479241,480224,983,20,N,N,-,-1,-1
MEMMUS.txt,480225,480540,315,20,N,N,-,-1,-1
MEMMUS.txt,480543,481064,521,20,N,N,-,-1,-1
MULIFE.txt,0,1604,1604,20,N,N,-,-1,-1
MULIFE.txt,1605,2049,444,20,N,N,-,-1,-1
MULIFE.txt,2050,2487,437,20,N,N,-,-1,-1
MULIFE.txt,2488,2923,435,20,N,N,-,-1,-1
MULIFE.txt,2924,3302,378,20,N,N,-,-1,-1
MULIFE.txt,3302,3681,379,20,N,N,-,-1,-1
MULIFE.txt,3684,4205,521,20,N,N,-,-1,-1
MULIFE.txt,4206,4734,528,20,N,N,-,-1,-1
MULIFE.txt,4735,5352,617,20,N,N,-,-1,-1
MULIFE.txt,5353,5756,403,20,N,N,-,-1,-1
MULIFE.txt,5757,6308,551,20,N,N,-,-1,-1
MULIFE.txt,6309,6910,601,20,N,N,-,-1,-1
MULIFE.txt,6911,7420,509,20,N,N,-,-1,-1
MULIFE.txt,7421,8004,583,20,N,N,-,-1,-1
MULIFE.txt,8005,8361,356,20,N,N,-,-1,-1
MULIFE.txt,8362,8920,558,20,N,N,-,-1,-1
MULIFE.txt,8921,9628,707,20,N,N,-,-1,-1
MULIFE.txt,9629,10370,741,20,N,N,-,-1,-1
MULIFE.txt,10371,10821,450,20,N,N,-,-1,-1
MULIFE.txt,10824,11131,307,20,N,N,-,-1,-1
MULIFE.txt,11132,11713,581,20,N,N,-,-1,-1
MULIFE.txt,11714,12167,453,20,N,N,-,-1,-1
MULIFE.txt,12168,12580,412,20,N,N,-,-1,-1
MULIFE.txt,12581,13228,647,20,N,N,-,-1,-1
MULIFE.txt,13229,13873,644,20,N,N,-,-1,-1
MULIFE.txt,13876,14421,545,20,N,N,-,-1,-1
MULIFE.txt,14422,14967,545,20,N,N,-,-1,-1
MULIFE.txt,14968,15501,533,20,N,N,-,-1,-1
MULIFE.txt,15502,16035,533,20,N,N,-,-1,-1
MULIFE.txt,16036,16515,479,20,N,N,-,-1,-1
MULIFE.txt,16516,17075,559,20,N,N,-,-1,-1
MULIFE.txt,17076,17557,481,20,N,N,-,-1,-1
MULIFE.txt,17558,18050,492,20,N,N,-,-1,-1
MULIFE.txt,18051,18616,565,20,N,N,-,-1,-1
MULIFE.txt,18617,19050,433,20,N,N,-,-1,-1
MULIFE.txt,19051,19540,489,20,N,N,-,-1,-1
MULIFE.txt,19541,19982,441,20,N,N,-,-1,-1
MULIFE.txt,19985,20422,437,20,N,N,-,-1,-1
MULIFE.txt,20423,21134,711,20,N,N,-,-1,-1
MULIFE.txt,21135,21657,522,20,N,N,-,-1,-1
MULIFE.txt,21658,22744,1086,20,N,N,-,-1,-1
MULIFE.txt,22745,24620,1875,20,N,N,-,-1,-1
MULIFE.txt,24623,26589,1966,20,N,N,-,-1,-1
MULIFE.txt,26590,28518,1928,20,N,N,-,-1,-1
MULIFE.txt,28519,31623,3104,20,N,N,-,-1,-1
MULIFE.txt,31624,34062,2438,20,N,Y,1437637327937,33188,35197
MULIFE.txt,34063,36468,2405,20,N,Y,1437642866570,35507,37282
MULIFE.txt,36469,38748,2279,20,Y,Y,1437642866570,35507,37282
MULIFE.txt,38749,40538,1789,20,N,Y,1437643218811,39345,39813
MULIFE.txt,40539,42598,2059,20,Y,Y,1437643552468,40385,41243
MULIFE.txt,42601,45078,2477,20,N,N,-,-1,-1
MULIFE.txt,45079,47348,2269,20,N,N,-,-1,-1
MULIFE.txt,47349,49487,2138,20,N,N,-,-1,-1
MULIFE.txt,49488,51592,2104,20,N,Y,1437644129613,50016,51209
MULIFE.txt,51593,53632,2039,20,N,N,-,-1,-1
MULIFE.txt,53633,55924,2291,20,N,Y,1437670019221,55738,57876
MULIFE.txt,55925,58401,2476,20,N,Y,1437670019221,55738,57876
MULIFE.txt,58402,60585,2183,20,N,Y,1437670482083,58835,59579
MULIFE.txt,60586,62743,2157,20,N,N,-,-1,-1
MULIFE.txt,62746,64767,2021,20,Y,Y,1437671026479,63906,64392
MULIFE.txt,64770,67852,3082,20,N,N,-,-1,-1
MULIFE.txt,67855,68995,1140,20,N,N,-,-1,-1
MULIFE.txt,68996,70970,1974,20,N,N,-,-1,-1
MULIFE.txt,70973,73006,2033,20,N,N,-,-1,-1
MULIFE.txt,73007,74878,1871,20,N,Y,1437671604320,74249,75453
MULIFE.txt,74879,77666,2787,20,N,Y,1437672056241,76209,76827
MULIFE.txt,77667,79976,2309,20,N,N,-,-1,-1
MULIFE.txt,79979,81849,1870,20,N,N,-,-1,-1
MULIFE.txt,81850,84168,2318,20,Y,Y,1437672626512,82770,83334
MULIFE.txt,84169,86472,2303,20,N,N,-,-1,-1
MULIFE.txt,86473,88792,2319,20,N,N,-,-1,-1
MULIFE.txt,88793,90438,1645,20,N,N,-,-1,-1
MULIFE.txt,90439,93044,2605,20,N,N,-,-1,-1
MULIFE.txt,93045,95707,2662,20,N,N,-,-1,-1
MULIFE.txt,95710,97957,2247,20,N,N,-,-1,-1
MULIFE.txt,97958,99776,1818,20,N,N,-,-1,-1
MULIFE.txt,99777,101316,1539,20,N,N,-,-1,-1
MULIFE.txt,101319,102963,1644,20,N,N,-,-1,-1
MULIFE.txt,102966,104840,1874,20,N,N,-,-1,-1
MULIFE.txt,104843,106108,1265,20,N,N,-,-1,-1
MULIFE.txt,106109,108191,2082,20,N,N,-,-1,-1
MULIFE.txt,108194,110241,2047,20,N,N,-,-1,-1
MULIFE.txt,110242,112262,2020,20,N,N,-,-1,-1
MULIFE.txt,112263,113847,1584,20,N,N,-,-1,-1
MULIFE.txt,113849,116213,2364,20,Y,Y,1437727565787,114231,114741
MULIFE.txt,116214,118659,2445,20,Y,Y,1437728842716,115343,116376
MULIFE.txt,118660,120397,1737,20,N,N,-,-1,-1
MULIFE.txt,120398,122418,2020,20,N,N,-,-1,-1
MULIFE.txt,122419,123500,1081,20,N,N,-,-1,-1
MULIFE.txt,123501,126111,2610,20,Y,N,-,-1,-1
MULIFE.txt,126112,128768,2656,20,N,Y,1437729941282,127304,128704
MULIFE.txt,128771,130805,2034,20,N,Y,1437730322242,128854,129770
MULIFE.txt,130806,132305,1499,20,N,N,-,-1,-1
MULIFE.txt,132306,133958,1652,20,N,N,-,-1,-1
MULIFE.txt,133959,136595,2636,20,N,N,-,-1,-1
MULIFE.txt,136596,138884,2288,20,N,Y,1437731100795,137101,140058
MULIFE.txt,138885,141942,3057,20,N,Y,1437731100795,137101,140058
MULIFE.txt,141943,143481,1538,20,N,Y,1437732462096,142028,144946
MULIFE.txt,143483,146085,2602,20,Y,Y,1437732462096,142028,144946
MULIFE.txt,146086,148412,2326,20,N,N,-,-1,-1
MULIFE.txt,148413,151142,2729,20,N,N,-,-1,-1
MULIFE.txt,151145,153387,2242,20,N,N,-,-1,-1
MULIFE.txt,153388,155155,1767,20,N,N,-,-1,-1
MULIFE.txt,155156,156515,1359,20,N,N,-,-1,-1
MULIFE.txt,156516,158647,2131,20,N,N,-,-1,-1
MULIFE.txt,158649,161114,2465,20,N,N,-,-1,-1
MULIFE.txt,161116,163232,2116,20,N,N,-,-1,-1
MULIFE.txt,163233,165539,2306,20,N,N,-,-1,-1
MULIFE.txt,165540,168048,2508,20,N,N,-,-1,-1
MULIFE.txt,168051,171319,3268,20,N,Y,1437736266658,170580,171597
MULIFE.txt,171320,173359,2039,20,N,Y,1437736266658,170580,171597
MULIFE.txt,173360,176794,3434,20,Y,N,-,-1,-1
MULIFE.txt,176797,178384,1587,20,N,N,-,-1,-1
MULIFE.txt,178385,180401,2016,20,N,N,-,-1,-1
MULIFE.txt,180404,182928,2524,20,N,N,-,-1,-1
MULIFE.txt,182930,184547,1617,20,N,N,-,-1,-1
MULIFE.txt,184548,186923,2375,20,N,N,-,-1,-1
MULIFE.txt,186925,188777,1852,20,N,Y,1437737385709,188168,190108
MULIFE.txt,188778,191563,2785,20,Y,Y,1437737385709,188168,190108
MULIFE.txt,191566,193358,1792,20,N,Y,1437737964896,191891,192160
MULIFE.txt,193359,195969,2610,20,N,N,-,-1,-1
MULIFE.txt,195970,197968,1998,20,N,N,-,-1,-1
MULIFE.txt,197969,199912,1943,20,N,N,-,-1,-1
MULIFE.txt,199915,202184,2269,20,Y,N,-,-1,-1
MULIFE.txt,202185,204398,2213,20,Y,N,-,-1,-1
MULIFE.txt,204399,206950,2551,20,N,N,-,-1,-1
MULIFE.txt,206956,209674,2718,20,N,N,-,-1,-1
MULIFE.txt,209675,211595,1920,20,N,N,-,-1,-1
MULIFE.txt,211596,213569,1973,20,N,N,-,-1,-1
MULIFE.txt,213570,215597,2027,20,N,N,-,-1,-1
MULIFE.txt,215600,217951,2351,20,N,N,-,-1,-1
MULIFE.txt,217952,219680,1728,20,N,N,-,-1,-1
MULIFE.txt,219681,221719,2038,20,N,N,-,-1,-1
MULIFE.txt,221722,224831,3109,20,N,N,-,-1,-1
MULIFE.txt,224832,226456,1624,20,N,N,-,-1,-1
MULIFE.txt,226459,228148,1689,20,N,N,-,-1,-1
MULIFE.txt,228151,231973,3822,20,N,N,-,-1,-1
MULIFE.txt,231974,234853,2879,20,N,N,-,-1,-1
MULIFE.txt,234854,237416,2562,20,N,N,-,-1,-1
MULIFE.txt,237417,239896,2479,20,N,N,-,-1,-1
MULIFE.txt,239899,241756,1857,20,N,N,-,-1,-1
MULIFE.txt,241757,244050,2293,20,N,N,-,-1,-1
MULIFE.txt,244051,246648,2597,20,N,N,-,-1,-1
MULIFE.txt,246651,249428,2777,20,N,N,-,-1,-1
MULIFE.txt,249431,252192,2761,20,N,N,-,-1,-1
MULIFE.txt,252193,255957,3764,20,N,N,-,-1,-1
MULIFE.txt,255958,258978,3020,20,N,N,-,-1,-1
MULIFE.txt,258981,260620,1639,20,N,N,-,-1,-1
MULIFE.txt,260621,262827,2206,20,N,N,-,-1,-1
MULIFE.txt,262830,265110,2280,20,N,N,-,-1,-1
MULIFE.txt,265110,268383,3273,20,N,N,-,-1,-1
MULIFE.txt,268384,270725,2341,20,N,N,-,-1,-1
MULIFE.txt,270726,272869,2143,20,Y,N,-,-1,-1
MULIFE.txt,272872,274622,1750,20,N,N,-,-1,-1
MULIFE.txt,274624,277432,2808,20,Y,Y,1437748188744,274892,276661
MULIFE.txt,277435,280303,2868,20,N,N,-,-1,-1
MULIFE.txt,280304,283208,2904,20,N,N,-,-1,-1
MULIFE.txt,283209,286305,3096,20,N,N,-,-1,-1
MULIFE.txt,286305,288589,2284,20,Y,N,-,-1,-1
MULIFE.txt,288590,291047,2457,20,N,N,-,-1,-1
MULIFE.txt,291050,294865,3815,20,N,N,-,-1,-1
MULIFE.txt,294867,297621,2754,20,N,N,-,-1,-1
MULIFE.txt,297622,300789,3167,20,N,N,-,-1,-1
MULIFE.txt,300790,302574,1784,20,N,N,-,-1,-1
MULIFE.txt,302575,305414,2839,20,Y,N,-,-1,-1
MULIFE.txt,305417,307860,2443,20,N,N,-,-1,-1
MULIFE.txt,307861,308984,1123,20,N,N,-,-1,-1
MULIFE.txt,308985,312528,3543,20,N,N,-,-1,-1
MULIFE.txt,312529,314514,1985,20,N,N,-,-1,-1
MULIFE.txt,314515,318728,4213,20,N,N,-,-1,-1
MULIFE.txt,318729,322513,3784,20,N,N,-,-1,-1
MULIFE.txt,322514,325035,2521,20,N,N,-,-1,-1
MULIFE.txt,325036,327624,2588,20,N,N,-,-1,-1
MULIFE.txt,327627,330341,2714,20,N,N,-,-1,-1
MULIFE.txt,330342,332731,2389,20,N,N,-,-1,-1
MULIFE.txt,332736,334744,2008,20,N,N,-,-1,-1
MULIFE.txt,334749,336737,1988,20,N,N,-,-1,-1
MULIFE.txt,336739,339842,3103,20,N,N,-,-1,-1
MULIFE.txt,339843,342424,2581,20,N,N,-,-1,-1
MULIFE.txt,342427,344813,2386,20,N,N,-,-1,-1
MULIFE.txt,344814,347069,2255,20,N,N,-,-1,-1
MULIFE.txt,347072,349905,2833,20,N,N,-,-1,-1
MULIFE.txt,349906,352520,2614,20,N,N,-,-1,-1
MULIFE.txt,352522,354990,2468,20,N,N,-,-1,-1
MULIFE.txt,354991,357346,2355,20,N,N,-,-1,-1
MULIFE.txt,357349,361057,3708,20,N,N,-,-1,-1
MULIFE.txt,361060,363616,2556,20,N,N,-,-1,-1
MULIFE.txt,363619,366113,2494,20,N,N,-,-1,-1
MULIFE.txt,366116,368677,2561,20,N,N,-,-1,-1
MULIFE.txt,368678,370358,1680,20,N,N,-,-1,-1
MULIFE.txt,370359,374081,3722,20,N,N,-,-1,-1
MULIFE.txt,374084,377008,2924,20,N,N,-,-1,-1
MULIFE.txt,377011,379748,2737,20,N,N,-,-1,-1
MULIFE.txt,379749,381989,2240,20,N,N,-,-1,-1
MULIFE.txt,381990,384908,2918,20,N,N,-,-1,-1
MULIFE.txt,384909,386946,2037,20,N,N,-,-1,-1
MULIFE.txt,386947,389342,2395,20,N,N,-,-1,-1
MULIFE.txt,389344,392233,2889,20,N,N,-,-1,-1
MULIFE.txt,392236,394161,1925,20,N,N,-,-1,-1
MULIFE.txt,394162,395048,886,20,N,N,-,-1,-1
MULIFE.txt,395049,395496,447,20,N,N,-,-1,-1
MULIFE.txt,395499,397922,2423,20,N,N,-,-1,-1
MULIFE.txt,397923,400891,2968,20,N,N,-,-1,-1
MULIFE.txt,400892,404629,3737,20,N,N,-,-1,-1
MULIFE.txt,404631,407052,2421,20,N,N,-,-1,-1
MULIFE.txt,407055,410210,3155,20,N,N,-,-1,-1
MULIFE.txt,410211,413886,3675,20,N,N,-,-1,-1
MULIFE.txt,413888,416427,2539,20,N,N,-,-1,-1
MULIFE.txt,416430,418726,2296,20,N,N,-,-1,-1
MULIFE.txt,418728,422685,3957,20,N,N,-,-1,-1
MULIFE.txt,422688,426509,3821,20,N,N,-,-1,-1
MULIFE.txt,426510,429819,3309,20,N,N,-,-1,-1
MULIFE.txt,429820,432532,2712,20,N,N,-,-1,-1
MULIFE.txt,432534,434478,1944,20,N,N,-,-1,-1
MULIFE.txt,434479,437380,2901,20,N,N,-,-1,-1
MULIFE.txt,437383,439681,2298,20,N,N,-,-1,-1
MULIFE.txt,439682,442213,2531,20,N,N,-,-1,-1
MULIFE.txt,442213,444258,2045,20,N,N,-,-1,-1
MULIFE.txt,444259,446692,2433,20,Y,N,-,-1,-1
MULIFE.txt,446694,449383,2689,20,Y,N,-,-1,-1
MULIFE.txt,449384,451543,2159,20,N,N,-,-1,-1
MULIFE.txt,451544,454308,2764,20,N,N,-,-1,-1
MULIFE.txt,454309,457727,3418,20,N,N,-,-1,-1
MULIFE.txt,457728,460247,2519,20,N,N,-,-1,-1
MULIFE.txt,460250,463250,3000,20,N,N,-,-1,-1
MULIFE.txt,463251,465936,2685,20,N,N,-,-1,-1
MULIFE.txt,465937,467450,1513,20,N,N,-,-1,-1
MULIFE.txt,467451,470006,2555,20,N,N,-,-1,-1
MULIFE.txt,470009,472066,2057,20,N,N,-,-1,-1
MULIFE.txt,472067,475331,3264,20,N,N,-,-1,-1
MULIFE.txt,475334,476962,1628,20,N,N,-,-1,-1
MULIFE.txt,476963,478107,1144,20,N,N,-,-1,-1
MULIFE.txt,478108,479889,1781,20,N,N,-,-1,-1
MULIFE.txt,479890,481531,1641,20,N,N,-,-1,-1
MULIFE.txt,481532,483429,1897,20,N,N,-,-1,-1
MULIFE.txt,483432,485632,2200,20,N,N,-,-1,-1
MULIFE.txt,485633,488760,3127,20,N,N,-,-1,-1
MULIFE.txt,488761,489831,1070,20,N,N,-,-1,-1
MULIFE.txt,489834,492181,2347,20,N,Y,1437819193404,491891,492364
MULIFE.txt,492182,494229,2047,20,Y,Y,1437819940135,493797,494222
MULIFE.txt,494231,495452,1221,20,N,N,-,-1,-1
MULIFE.txt,495453,497602,2149,20,N,N,-,-1,-1
MULIFE.txt,497603,499671,2068,20,N,N,-,-1,-1
MULIFE.txt,499672,501396,1724,20,N,N,-,-1,-1
MULIFE.txt,501397,504443,3046,20,Y,N,-,-1,-1
MULIFE.txt,504446,508596,4150,20,N,N,-,-1,-1
MULIFE.txt,508597,510883,2286,20,Y,Y,1437821785598,510009,510542
MULIFE.txt,510884,513280,2396,20,N,Y,1437822193958,511750,512403
MULIFE.txt,513281,515859,2578,20,N,N,-,-1,-1
MULIFE.txt,515860,520121,4261,20,Y,Y,1437822538234,517368,517636
MULIFE.txt,520122,522305,2183,20,N,Y,1437823700026,522255,523121
MULIFE.txt,522306,525706,3400,20,N,Y,1437823700026,522255,523121
MULIFE.txt,525708,528318,2610,20,N,N,-,-1,-1
MULIFE.txt,528319,531717,3398,20,N,Y,1437842085814,530652,531925
MULIFE.txt,531718,533991,2273,20,N,Y,1437842085814,530652,531925
MULIFE.txt,533992,536720,2728,20,N,N,-,-1,-1
MULIFE.txt,536721,539004,2283,20,N,N,-,-1,-1
MULIFE.txt,539005,541813,2808,20,N,N,-,-1,-1
MULIFE.txt,541814,544999,3185,20,N,N,-,-1,-1
MULIFE.txt,545002,547318,2316,20,N,Y,1437842663182,545558,546298
MULIFE.txt,547319,549013,1694,20,N,N,-,-1,-1
MULIFE.txt,549014,551354,2340,20,N,Y,1437842936274,549355,550003
MULIFE.txt,551355,553607,2252,20,N,Y,1437843377951,552763,553884
MULIFE.txt,553608,556861,3253,20,N,Y,1437843377951,552763,553884
MULIFE.txt,556862,559654,2792,20,N,N,-,-1,-1
MULIFE.txt,559656,562252,2596,20,N,N,-,-1,-1
MULIFE.txt,562255,565038,2783,20,Y,Y,1437843751491,564174,565427
MULIFE.txt,565039,568503,3464,20,N,Y,1437843751491,564174,565427
MULIFE.txt,568504,572096,3592,20,N,Y,1437844476348,567281,568945
MULIFE.txt,572099,574125,2026,20,N,N,-,-1,-1
MULIFE.txt,574126,576711,2585,20,N,N,-,-1,-1
MULIFE.txt,576714,579074,2360,20,Y,N,-,-1,-1
MULIFE.txt,579079,580384,1305,20,N,N,-,-1,-1
MULIFE.txt,580385,583394,3009,20,N,Y,1437845266061,581723,582485
MULIFE.txt,583396,586202,2806,20,N,N,-,-1,-1
MULIFE.txt,586205,588753,2548,20,N,N,-,-1,-1
MULIFE.txt,588754,591423,2669,20,N,N,-,-1,-1
MULIFE.txt,591424,594603,3179,20,N,N,-,-1,-1
MULIFE.txt,594604,598364,3760,20,Y,N,-,-1,-1
MULIFE.txt,598365,600996,2631,20,N,N,-,-1,-1
MULIFE.txt,600997,604161,3164,20,N,N,-,-1,-1
MULIFE.txt,604162,606828,2666,20,Y,N,-,-1,-1
MULIFE.txt,606831,609915,3084,20,N,N,-,-1,-1
MULIFE.txt,609918,613594,3676,20,Y,N,-,-1,-1
MULIFE.txt,613595,617308,3713,20,N,N,-,-1,-1
MULIFE.txt,617309,620681,3372,20,Y,Y,1437986157098,620366,620948
MULIFE.txt,620682,623488,2806,20,Y,Y,1437986157098,620366,620948
MULIFE.txt,623489,626414,2925,20,N,Y,1437986573396,626278,626853
MULIFE.txt,626415,629955,3540,20,N,Y,1437986573396,626278,626853
MULIFE.txt,629956,632868,2912,20,N,N,-,-1,-1
MULIFE.txt,632869,636115,3246,20,Y,Y,1437987243903,633307,634055
MULIFE.txt,636117,638861,2744,20,N,Y,1437987949897,635438,636165
MULIFE.txt,638862,642587,3725,20,Y,N,-,-1,-1
MULIFE.txt,642588,644862,2274,20,N,N,-,-1,-1
MULIFE.txt,644863,647094,2231,20,N,N,-,-1,-1
MULIFE.txt,647096,648659,1563,20,N,N,-,-1,-1
MULIFE.txt,648662,650802,2140,20,N,N,-,-1,-1
MULIFE.txt,650805,653301,2496,20,N,N,-,-1,-1
MULIFE.txt,653304,655976,2672,20,N,N,-,-1,-1
MULIFE.txt,655979,658786,2807,20,N,N,-,-1,-1
MULIFE.txt,658787,661013,2226,20,N,Y,1437988651932,659204,659887
MULIFE.txt,661014,663158,2144,20,N,Y,1437989149214,661990,662272
MULIFE.txt,663161,665996,2835,20,Y,Y,1437989518903,664383,664855
MULIFE.txt,665999,667419,1420,20,N,N,-,-1,-1
MULIFE.txt,667421,668921,1500,20,N,N,-,-1,-1
MULIFE.txt,668926,670518,1592,20,N,Y,1437990390319,668943,669389
MULIFE.txt,670521,672243,1722,20,N,N,-,-1,-1
MULIFE.txt,672244,673644,1400,20,N,N,-,-1,-1
MULIFE.txt,673645,675393,1748,20,N,N,-,-1,-1
MULIFE.txt,675394,677196,1802,20,N,N,-,-1,-1
MULIFE.txt,677199,679571,2372,20,N,N,-,-1,-1
MULIFE.txt,679574,681857,2283,20,N,N,-,-1,-1
MULIFE.txt,681858,683289,1431,20,N,N,-,-1,-1
MULIFE.txt,683292,685568,2276,20,N,N,-,-1,-1
MULIFE.txt,685571,688104,2533,20,N,N,-,-1,-1
MULIFE.txt,688105,691004,2899,20,N,N,-,-1,-1
MULIFE.txt,691007,693435,2428,20,N,Y,1437991397891,693219,694006
MULIFE.txt,693436,695143,1707,20,N,Y,1437991397891,693219,694006
MULIFE.txt,695144,696815,1671,20,N,Y,1437991665521,694564,695190
MULIFE.txt,696816,699558,2742,20,N,N,-,-1,-1
MULIFE.txt,699561,701285,1724,20,N,N,-,-1,-1
MULIFE.txt,701286,703040,1754,20,N,Y,1437991986836,701932,703111
MULIFE.txt,703041,705596,2555,20,N,Y,1437991986836,701932,703111
MULIFE.txt,705601,707936,2335,20,N,Y,1437992265363,707653,708287
MULIFE.txt,707937,709571,1634,20,N,Y,1437992265363,707653,708287
MULIFE.txt,709574,711488,1914,20,N,N,-,-1,-1
MULIFE.txt,711491,714388,2897,20,N,N,-,-1,-1
MULIFE.txt,714389,716370,1981,20,N,N,-,-1,-1
MULIFE.txt,716371,718964,2593,20,N,Y,1437992560557,718760,719849
MULIFE.txt,718965,721148,2183,20,N,Y,1437992801449,719924,720764
MULIFE.txt,721149,722916,1767,20,N,N,-,-1,-1
MULIFE.txt,722917,725386,2469,20,N,N,-,-1,-1
MULIFE.txt,725387,728135,2748,20,N,N,-,-1,-1
MULIFE.txt,728136,731172,3036,20,N,N,-,-1,-1
MULIFE.txt,731173,733607,2434,20,N,N,-,-1,-1
MULIFE.txt,733607,736017,2410,20,N,N,-,-1,-1
MULIFE.txt,736018,738016,1998,20,N,N,-,-1,-1
MULIFE.txt,738019,739921,1902,20,N,N,-,-1,-1
MULIFE.txt,739922,741839,1917,20,N,Y,1437993458963,740703,741759
MULIFE.txt,741842,743250,1408,20,N,N,-,-1,-1
MULIFE.txt,743251,745183,1932,20,N,N,-,-1,-1
MULIFE.txt,745184,748138,2954,20,N,Y,1437993739565,746751,748086
MULIFE.txt,748143,750514,2371,20,N,N,-,-1,-1
MULIFE.txt,750515,753088,2573,20,N,N,-,-1,-1
MULIFE.txt,753089,755263,2174,20,N,N,-,-1,-1
MULIFE.txt,755264,758041,2777,20,N,N,-,-1,-1
MULIFE.txt,758044,760992,2948,20,N,Y,1437994269353,759820,760565
MULIFE.txt,760993,764037,3044,20,N,N,-,-1,-1
MULIFE.txt,764040,766417,2377,20,N,N,-,-1,-1
MULIFE.txt,766420,770140,3720,20,N,N,-,-1,-1
MULIFE.txt,770141,771956,1815,20,N,Y,1438000608332,771119,771952
MULIFE.txt,771959,774318,2359,20,N,N,-,-1,-1
MULIFE.txt,774319,777034,2715,20,N,N,-,-1,-1
MULIFE.txt,777035,779369,2334,20,N,Y,1438001606981,778715,780387
MULIFE.txt,779370,781661,2291,20,N,Y,1438001606981,778715,780387
MULIFE.txt,781664,783268,1604,20,N,N,-,-1,-1
MULIFE.txt,783269,785839,2570,20,N,N,-,-1,-1
MULIFE.txt,785840,787511,1671,20,N,N,-,-1,-1
MULIFE.txt,787512,790692,3180,20,Y,N,-,-1,-1
MULIFE.txt,790693,793376,2683,20,N,N,-,-1,-1
MULIFE.txt,793377,796114,2737,20,N,N,-,-1,-1
MULIFE.txt,796117,799176,3059,20,N,N,-,-1,-1
MULIFE.txt,799179,802810,3631,20,N,N,-,-1,-1
MULIFE.txt,802812,805675,2863,20,N,N,-,-1,-1
MULIFE.txt,805676,807617,1941,20,N,N,-,-1,-1
MULIFE.txt,807618,810693,3075,20,N,N,-,-1,-1
MULIFE.txt,810694,813601,2907,20,N,N,-,-1,-1
MULIFE.txt,813602,816774,3172,20,N,N,-,-1,-1
MULIFE.txt,816775,819314,2539,20,N,N,-,-1,-1
MULIFE.txt,819317,822641,3324,20,N,N,-,-1,-1
MULIFE.txt,822642,824817,2175,20,N,N,-,-1,-1
MULIFE.txt,824818,827429,2611,20,N,N,-,-1,-1
MULIFE.txt,827430,829126,1696,20,N,N,-,-1,-1
MULIFE.txt,829127,831041,1914,20,N,N,-,-1,-1
MULIFE.txt,831042,832804,1762,20,N,N,-,-1,-1
MULIFE.txt,832805,834922,2117,20,N,N,-,-1,-1
MULIFE.txt,834923,837308,2385,20,N,N,-,-1,-1
MULIFE.txt,837309,839756,2447,20,N,N,-,-1,-1
MULIFE.txt,839757,841535,1778,20,N,N,-,-1,-1
MULIFE.txt,841536,843993,2457,20,N,N,-,-1,-1
MULIFE.txt,843994,846449,2455,20,N,N,-,-1,-1
MULIFE.txt,846452,849351,2899,20,N,N,-,-1,-1
MULIFE.txt,849354,852196,2842,20,N,N,-,-1,-1
MULIFE.txt,852197,853849,1652,20,N,N,-,-1,-1
MULIFE.txt,853850,855326,1476,20,N,N,-,-1,-1
MULIFE.txt,855327,856607,1280,20,N,N,-,-1,-1
MULIFE.txt,856608,859674,3066,20,N,N,-,-1,-1
MULIFE.txt,859677,861481,1804,20,N,N,-,-1,-1
MULIFE.txt,861482,864235,2753,20,N,N,-,-1,-1
MULIFE.txt,864236,867077,2841,20,N,N,-,-1,-1
MULIFE.txt,867078,869040,1962,20,N,N,-,-1,-1
MULIFE.txt,869043,871468,2425,20,N,N,-,-1,-1
MULIFE.txt,871469,873587,2118,20,N,N,-,-1,-1
MULIFE.txt,873590,875482,1892,20,N,N,-,-1,-1
MULIFE.txt,875483,876556,1073,20,N,N,-,-1,-1
MULIFE.txt,876557,877670,1113,20,N,N,-,-1,-1
MULIFE.txt,877673,878889,1216,20,N,N,-,-1,-1
MULIFE.txt,878890,880179,1289,20,N,N,-,-1,-1
MULIFE.txt,880180,882232,2052,20,N,N,-,-1,-1
MULIFE.txt,882233,885253,3020,20,N,N,-,-1,-1
MULIFE.txt,885256,886491,1235,20,N,N,-,-1,-1
MULIFE.txt,886494,888375,1881,20,N,N,-,-1,-1
MULIFE.txt,888378,892556,4178,20,N,N,-,-1,-1
MULIFE.txt,892564,894745,2181,20,N,Y,1438002747854,892999,894161
MULIFE.txt,894748,897502,2754,20,Y,N,-,-1,-1
MULIFE.txt,897505,899646,2141,20,N,N,-,-1,-1
MULIFE.txt,899647,902185,2538,20,N,Y,1438003564102,901839,902422
MULIFE.txt,902188,904284,2096,20,N,Y,1438003564102,901839,902422
MULIFE.txt,904285,906415,2130,20,Y,Y,1438004319285,905549,905936
MULIFE.txt,906416,908660,2244,20,N,N,-,-1,-1
MULIFE.txt,908661,911008,2347,20,N,N,-,-1,-1
MULIFE.txt,911009,912881,1872,20,N,N,-,-1,-1
MULIFE.txt,912882,914137,1255,20,N,N,-,-1,-1
MULIFE.txt,914139,916139,2000,20,N,N,-,-1,-1
MULIFE.txt,916140,918503,2363,20,N,N,-,-1,-1
MULIFE.txt,918504,920973,2469,20,N,N,-,-1,-1
MULIFE.txt,920974,923513,2539,20,N,N,-,-1,-1
MULIFE.txt,923514,927006,3492,20,N,N,-,-1,-1
MULIFE.txt,927007,930326,3319,20,Y,N,-,-1,-1
MULIFE.txt,930327,932697,2370,20,N,N,-,-1,-1
MULIFE.txt,932700,934919,2219,20,N,N,-,-1,-1
MULIFE.txt,934922,937495,2573,20,N,N,-,-1,-1
MULIFE.txt,937497,939804,2307,20,N,N,-,-1,-1
MULIFE.txt,939805,941319,1514,20,N,N,-,-1,-1
MULIFE.txt,941320,943061,1741,20,N,N,-,-1,-1
MULIFE.txt,943062,945813,2751,20,N,N,-,-1,-1
MULIFE.txt,945814,948312,2498,20,N,N,-,-1,-1
MULIFE.txt,948313,950448,2135,20,N,N,-,-1,-1
MULIFE.txt,950449,953760,3311,20,N,Y,1438005303228,953665,955052
MULIFE.txt,953761,956064,2303,20,N,Y,1438005724733,955431,957516
MULIFE.txt,956065,959644,3579,20,N,Y,1438005724733,955431,957516
MULIFE.txt,959645,962900,3255,20,Y,N,-,-1,-1
MULIFE.txt,962903,966235,3332,20,Y,N,-,-1,-1
MULIFE.txt,966236,968059,1823,20,N,N,-,-1,-1
MULIFE.txt,968061,970658,2597,20,N,N,-,-1,-1
MULIFE.txt,970659,974826,4167,20,N,Y,1438006506960,970689,974719
MULIFE.txt,974827,976746,1919,20,N,N,-,-1,-1
MULIFE.txt,976747,978350,1603,20,N,N,-,-1,-1
MULIFE.txt,978353,980866,2513,20,N,N,-,-1,-1
MULIFE.txt,980867,982607,1740,20,N,N,-,-1,-1
MULIFE.txt,982608,984369,1761,20,N,N,-,-1,-1
MULIFE.txt,984370,984865,495,20,N,N,-,-1,-1
MULIFE.txt,984866,985492,626,20,N,N,-,-1,-1
MULIFE.txt,985493,986200,707,20,N,N,-,-1,-1
MULIFE.txt,986201,986603,402,20,N,N,-,-1,-1
MULIFE.txt,986604,987090,486,20,N,N,-,-1,-1
MULIFE.txt,987092,987777,685,20,N,N,-,-1,-1
MULIFE.txt,987778,988323,545,20,N,N,-,-1,-1
MULIFE.txt,988324,988738,414,20,N,N,-,-1,-1
MULIFE.txt,988740,989100,360,20,N,N,-,-1,-1
MULIFE.txt,989101,989499,398,20,N,N,-,-1,-1
MULIFE.txt,989500,989870,370,20,N,N,-,-1,-1
MULIFE.txt,989871,990352,481,20,N,N,-,-1,-1
MULIFE.txt,990353,991090,737,20,N,N,-,-1,-1
MULIFE.txt,991091,991640,549,20,N,N,-,-1,-1
MULIFE.txt,991641,992014,373,20,N,N,-,-1,-1
MULIFE.txt,992015,992713,698,20,N,N,-,-1,-1
MULIFE.txt,992714,993047,333,20,N,N,-,-1,-1
MULIFE.txt,993048,993258,210,20,N,N,-,-1,-1
MULIFE.txt,993260,993664,404,20,N,N,-,-1,-1
MULIFE.txt,993665,994058,393,20,N,N,-,-1,-1
MULIFE.txt,994059,994305,246,20,N,N,-,-1,-1
MULIFE.txt,994306,994620,314,20,N,N,-,-1,-1
MULIFE.txt,994621,995041,420,20,N,N,-,-1,-1
MULIFE.txt,995042,995418,376,20,N,N,-,-1,-1
MULIFE.txt,995421,995790,369,20,N,N,-,-1,-1
MULIFE.txt,995793,996247,454,20,N,N,-,-1,-1
MULIFE.txt,996248,997028,780,20,N,N,-,-1,-1
MULIFE.txt,997031,997577,546,20,N,N,-,-1,-1
MULIFE.txt,997579,997955,376,20,N,N,-,-1,-1
MULIFE.txt,997956,998416,460,20,N,N,-,-1,-1
MULIFE.txt,998421,998988,567,20,N,N,-,-1,-1
MULIFE.txt,998991,999314,323,20,N,N,-,-1,-1
MULIFE.txt,999314,999768,454,20,N,N,-,-1,-1
MULIFE.txt,999768,1000278,510,20,N,N,-,-1,-1
MULIFE.txt,1000279,1000608,329,20,N,N,-,-1,-1
MULIFE.txt,1000609,1001297,688,20,N,N,-,-1,-1
MULIFE.txt,1001298,1001575,277,20,N,N,-,-1,-1
MULIFE.txt,1001576,1001956,380,20,N,N,-,-1,-1
MULIFE.txt,1001957,1002376,419,20,N,N,-,-1,-1
MULIFE.txt,1002379,1002897,518,20,N,N,-,-1,-1
MULIFE.txt,1002898,1003189,291,20,N,N,-,-1,-1
MULIFE.txt,1003190,1003456,266,20,N,N,-,-1,-1
MULIFE.txt,1003457,1004042,585,20,N,N,-,-1,-1
MULIFE.txt,1004043,1004559,516,20,N,N,-,-1,-1
MULIFE.txt,1004560,1005055,495,20,N,N,-,-1,-1
MULIFE.txt,1005056,1005682,626,20,N,N,-,-1,-1
MULIFE.txt,1005683,1006118,435,20,N,N,-,-1,-1
MULIFE.txt,1006120,1006562,442,20,N,N,-,-1,-1
MULIFE.txt,1006563,1007114,551,20,N,N,-,-1,-1
MULIFE.txt,1007114,1007621,507,20,N,N,-,-1,-1
MULIFE.txt,1007623,1008028,405,20,N,N,-,-1,-1
MULIFE.txt,1008031,1008325,294,20,N,N,-,-1,-1
MULIFE.txt,1008326,1008657,331,20,N,N,-,-1,-1
MULIFE.txt,1008658,1009478,820,20,N,N,-,-1,-1
MULIFE.txt,1009479,1009849,370,20,N,N,-,-1,-1
MULIFE.txt,1009850,1010124,274,20,N,N,-,-1,-1
MULIFE.txt,1010125,1010779,654,20,N,N,-,-1,-1
MULIFE.txt,1010780,1011079,299,20,N,N,-,-1,-1
MULIFE.txt,1011084,1011921,837,20,N,N,-,-1,-1
MULIFE.txt,1011923,1012384,461,20,N,N,-,-1,-1
MULIFE.txt,1012389,1012801,412,20,N,N,-,-1,-1
MULIFE.txt,1012802,1013667,865,20,N,N,-,-1,-1
MULIFE.txt,1013668,1014268,600,20,N,N,-,-1,-1
MULIFE.txt,1014273,1014943,670,20,N,N,-,-1,-1
MULIFE.txt,1014945,1015585,640,20,N,N,-,-1,-1
MULIFE.txt,1015586,1016126,540,20,N,N,-,-1,-1
MULIFE.txt,1016131,1016869,738,20,N,N,-,-1,-1
MULIFE.txt,1016870,1017644,774,20,N,N,-,-1,-1
MULIFE.txt,1017645,1018180,535,20,N,N,-,-1,-1
MULIFE.txt,1018181,1018854,673,20,N,N,-,-1,-1
MULIFE.txt,1018855,1019614,759,20,N,N,-,-1,-1
MULIFE.txt,1019615,1020427,812,20,N,N,-,-1,-1
MULIFE.txt,1020428,1021130,702,20,N,N,-,-1,-1
MULIFE.txt,1021132,1021759,627,20,N,N,-,-1,-1
MULIFE.txt,1021759,1022351,592,20,N,N,-,-1,-1
MULIFE.txt,1022352,1023152,800,20,N,N,-,-1,-1
MULIFE.txt,1023153,1023681,528,20,N,N,-,-1,-1
MULIFE.txt,1023684,1024169,485,20,N,N,-,-1,-1
MULIFE.txt,1024172,1024779,607,20,N,N,-,-1,-1
MULIFE.txt,1024781,1025278,497,20,N,N,-,-1,-1
MULIFE.txt,1025279,1025623,344,20,N,N,-,-1,-1
MULIFE.txt,1025624,1026165,541,20,N,N,-,-1,-1
MULIFE.txt,1026166,1026753,587,20,N,N,-,-1,-1
MULIFE.txt,1026754,1027209,455,20,N,N,-,-1,-1
MULIFE.txt,1027210,1027609,399,20,N,N,-,-1,-1
MULIFE.txt,1027610,1027958,348,20,N,N,-,-1,-1
MULIFE.txt,1027961,1028299,338,20,N,N,-,-1,-1
MULIFE.txt,1028301,1029005,704,20,N,N,-,-1,-1
MULIFE.txt,1029006,1029427,421,20,N,N,-,-1,-1
MULIFE.txt,1029428,1029703,275,20,N,N,-,-1,-1
MULIFE.txt,1029704,1030305,601,20,N,N,-,-1,-1
MULIFE.txt,1030308,1030900,592,20,N,N,-,-1,-1
MULIFE.txt,1030901,1031412,511,20,N,N,-,-1,-1
MULIFE.txt,1031413,1031802,389,20,N,N,-,-1,-1
MULIFE.txt,1031805,1032126,321,20,N,N,-,-1,-1
MULIFE.txt,1032127,1032561,434,20,N,N,-,-1,-1
MULIFE.txt,1032562,1032937,375,20,N,N,-,-1,-1
MULIFE.txt,1032938,1033517,579,20,N,N,-,-1,-1
MULIFE.txt,1033520,1033929,409,20,N,N,-,-1,-1
MULIFE.txt,1033931,1034416,485,20,N,N,-,-1,-1
MULIFE.txt,1034417,1034849,432,20,N,N,-,-1,-1
MULIFE.txt,1034850,1035338,488,20,N,N,-,-1,-1
MULIFE.txt,1035341,1035912,571,20,N,N,-,-1,-1
MULIFE.txt,1035913,1036407,494,20,N,N,-,-1,-1
MULIFE.txt,1036408,1036754,346,20,N,N,-,-1,-1
MULIFE.txt,1036755,1037035,280,20,N,N,-,-1,-1
MULIFE.txt,1037036,1037267,231,20,N,N,-,-1,-1
MULIFE.txt,1037268,1037676,408,20,N,N,-,-1,-1
MULIFE.txt,1037677,1038095,418,20,N,N,-,-1,-1
MULIFE.txt,1038096,1038568,472,20,N,N,-,-1,-1
MULIFE.txt,1038569,1039255,686,20,N,N,-,-1,-1
MULIFE.txt,1039258,1039647,389,20,N,N,-,-1,-1
MULIFE.txt,1039650,1040122,472,20,N,N,-,-1,-1
MULIFE.txt,1040123,1040366,243,20,N,N,-,-1,-1
MULIFE.txt,1040369,1040837,468,20,N,N,-,-1,-1
MULIFE.txt,1040838,1041445,607,20,N,N,-,-1,-1
MULIFE.txt,1041446,1042028,582,20,N,N,-,-1,-1
MULIFE.txt,1042031,1042372,341,20,N,N,-,-1,-1
MULIFE.txt,1042373,1042836,463,20,N,N,-,-1,-1
MULIFE.txt,1042837,1043351,514,20,N,N,-,-1,-1
MULIFE.txt,1043352,1043724,372,20,N,N,-,-1,-1
MULIFE.txt,1043726,1043984,258,20,N,N,-,-1,-1
MULIFE.txt,1043985,1044557,572,20,N,N,-,-1,-1
MULIFE.txt,1044557,1045108,551,20,N,N,-,-1,-1
MULIFE.txt,1045109,1045392,283,20,N,N,-,-1,-1
MULIFE.txt,1045395,1045759,364,20,N,N,-,-1,-1
MULIFE.txt,1045760,1046020,260,20,N,N,-,-1,-1
MULIFE.txt,1046023,1046298,275,20,N,N,-,-1,-1
MULIFE.txt,1046299,1046877,578,20,N,N,-,-1,-1
MULIFE.txt,1046878,1047190,312,20,N,N,-,-1,-1
MULIFE.txt,1047192,1047625,433,20,N,N,-,-1,-1
MULIFE.txt,1047626,1047998,372,20,N,N,-,-1,-1
MULIFE.txt,1047999,1048564,565,20,N,N,-,-1,-1
MULIFE.txt,1048565,1049045,480,20,N,N,-,-1,-1
MULIFE.txt,1049046,1049456,410,20,N,N,-,-1,-1
MULIFE.txt,1049457,1050043,586,20,N,N,-,-1,-1
MULIFE.txt,1050044,1050516,472,20,N,N,-,-1,-1
MULIFE.txt,1050517,1050938,421,20,N,N,-,-1,-1
MULIFE.txt,1050939,1051288,349,20,N,N,-,-1,-1
MULIFE.txt,1051289,1051677,388,20,N,N,-,-1,-1
MULIFE.txt,1051678,1052182,504,20,N,N,-,-1,-1
MULIFE.txt,1052183,1052423,240,20,N,N,-,-1,-1
MULIFE.txt,1052424,1052724,300,20,N,N,-,-1,-1
MULIFE.txt,1052729,1053069,340,20,N,N,-,-1,-1
MULIFE.txt,1053070,1053352,282,20,N,N,-,-1,-1
MULIFE.txt,1053353,1053719,366,20,N,N,-,-1,-1
MULIFE.txt,1053720,1054238,518,20,N,N,-,-1,-1
MULIFE.txt,1054241,1054612,371,20,N,N,-,-1,-1
MULIFE.txt,1054615,1054897,282,20,N,N,-,-1,-1
MULIFE.txt,1054898,1055425,527,20,N,N,-,-1,-1
MULIFE.txt,1055426,1055786,360,20,N,N,-,-1,-1
MULIFE.txt,1055787,1056365,578,20,N,N,-,-1,-1
MULIFE.txt,1056368,1056896,528,20,N,N,-,-1,-1
MULIFE.txt,1056897,1057286,389,20,N,N,-,-1,-1
MULIFE.txt,1057287,1057670,383,20,N,N,-,-1,-1
MULIFE.txt,1057673,1058168,495,20,N,N,-,-1,-1
MULIFE.txt,1058169,1058463,294,20,N,N,-,-1,-1
MULIFE.txt,1058464,1058743,279,20,N,N,-,-1,-1
MULIFE.txt,1058744,1058983,239,20,N,N,-,-1,-1
MULIFE.txt,1058984,1059216,232,20,N,N,-,-1,-1
MULIFE.txt,1059217,1059511,294,20,N,N,-,-1,-1
MULIFE.txt,1059512,1060035,523,20,N,N,-,-1,-1
MULIFE.txt,1060036,1060606,570,20,N,N,-,-1,-1
MULIFE.txt,1060611,1060965,354,20,N,N,-,-1,-1
MULIFE.txt,1060966,1061327,361,20,N,N,-,-1,-1
MULIFE.txt,1061328,1061661,333,20,N,N,-,-1,-1
MULIFE.txt,1061662,1062317,655,20,N,N,-,-1,-1
MULIFE.txt,1062319,1062735,416,20,N,N,-,-1,-1
MULIFE.txt,1062736,1063324,588,20,N,N,-,-1,-1
MULIFE.txt,1063327,1063725,398,20,N,N,-,-1,-1
MULIFE.txt,1063726,1064038,312,20,N,N,-,-1,-1
MULIFE.txt,1064043,1064541,498,20,N,N,-,-1,-1
MULIFE.txt,1064542,1065003,461,20,N,N,-,-1,-1
MULIFE.txt,1065006,1065742,736,20,N,N,-,-1,-1
MULIFE.txt,1065743,1066207,464,20,N,N,-,-1,-1
MULIFE.txt,1066210,1066628,418,20,N,N,-,-1,-1
MULIFE.txt,1066629,1067013,384,20,N,N,-,-1,-1
MULIFE.txt,1067014,1067424,410,20,N,N,-,-1,-1
MULIFE.txt,1067429,1067856,427,20,N,N,-,-1,-1
MULIFE.txt,1067857,1068433,576,20,N,N,-,-1,-1
MULIFE.txt,1068436,1068884,448,20,N,N,-,-1,-1
MULIFE.txt,1068887,1069387,500,20,N,N,-,-1,-1
MULIFE.txt,1069388,1070048,660,20,N,N,-,-1,-1
MULIFE.txt,1070049,1070670,621,20,N,N,-,-1,-1
MULIFE.txt,1070673,1071000,327,20,N,N,-,-1,-1
MULIFE.txt,1071002,1071567,565,20,N,N,-,-1,-1
MULIFE.txt,1071568,1072074,506,20,N,N,-,-1,-1
MULIFE.txt,1072075,1072577,502,20,N,N,-,-1,-1
MULIFE.txt,1072579,1073065,486,20,N,N,-,-1,-1
MULIFE.txt,1073068,1073769,701,20,N,N,-,-1,-1
MULIFE.txt,1073771,1074714,943,20,N,N,-,-1,-1
MULIFE.txt,1074715,1075218,503,20,N,N,-,-1,-1
MULIFE.txt,1075221,1075766,545,20,N,N,-,-1,-1
MULIFE.txt,1075767,1076379,612,20,N,N,-,-1,-1
MULIFE.txt,1076382,1077101,719,20,N,N,-,-1,-1
MULIFE.txt,1077104,1077678,574,20,N,N,-,-1,-1
MULIFE.txt,1077679,1078128,449,20,N,N,-,-1,-1
MULIFE.txt,1078129,1078575,446,20,N,N,-,-1,-1
MULIFE.txt,1078577,1078772,195,20,N,N,-,-1,-1
MULIFE.txt,1078773,1078964,191,20,N,N,-,-1,-1
MULIFE.txt,1078965,1079236,271,20,N,N,-,-1,-1
MULIFE.txt,1079237,1079553,316,20,N,N,-,-1,-1
MULIFE.txt,1079554,1079898,344,20,N,N,-,-1,-1
MULIFE.txt,1079899,1080256,357,20,N,N,-,-1,-1
MULIFE.txt,1080257,1080624,367,20,N,N,-,-1,-1
MULIFE.txt,1080625,1080848,223,20,N,N,-,-1,-1
MULIFE.txt,1080851,1081112,261,20,N,N,-,-1,-1
MULIFE.txt,1081113,1081500,387,20,N,N,-,-1,-1
MULIFE.txt,1081503,1082331,828,20,N,N,-,-1,-1
MULIFE.txt,1082332,1083047,715,20,N,N,-,-1,-1
MULIFE.txt,1083048,1083521,473,20,N,N,-,-1,-1
MULIFE.txt,1083523,1084015,492,20,N,N,-,-1,-1
MULIFE.txt,1084016,1084341,325,20,N,N,-,-1,-1
MULIFE.txt,1084342,1084881,539,20,N,N,-,-1,-1
MULIFE.txt,1084882,1085242,360,20,N,N,-,-1,-1
MULIFE.txt,1085244,1085466,222,20,N,N,-,-1,-1
MULIFE.txt,1085467,1085734,267,20,N,N,-,-1,-1
MULIFE.txt,1085735,1086212,477,20,N,N,-,-1,-1
MULIFE.txt,1086213,1086452,239,20,N,N,-,-1,-1
MULIFE.txt,1086453,1087053,600,20,N,N,-,-1,-1
MULIFE.txt,1087054,1087486,432,20,N,N,-,-1,-1
MULIFE.txt,1087487,1088027,540,20,N,N,-,-1,-1
MULIFE.txt,1088028,1088265,237,20,N,N,-,-1,-1
MULIFE.txt,1088266,1088900,634,20,N,N,-,-1,-1
MULIFE.txt,1088901,1089714,813,20,N,N,-,-1,-1
MULIFE.txt,1089717,1090198,481,20,N,N,-,-1,-1
MULIFE.txt,1090200,1090706,506,20,N,N,-,-1,-1
MULIFE.txt,1090707,1091158,451,20,N,N,-,-1,-1
MULIFE.txt,1091159,1091522,363,20,N,N,-,-1,-1
MULIFE.txt,1091523,1092143,620,20,N,N,-,-1,-1
MULIFE.txt,1092144,1092627,483,20,N,N,-,-1,-1
MULIFE.txt,1092628,1093166,538,20,N,N,-,-1,-1
MUSING.txt,0,5332,5332,20,N,N,-,-1,-1
MUSING.txt,5334,9101,3767,20,N,N,-,-1,-1
MUSING.txt,9102,13362,4260,20,Y,Y,1452197105481,12624,12995
MUSING.txt,13363,20142,6779,20,Y,Y,1452552834876,19293,19784
MUSING.txt,20143,25106,4963,20,Y,Y,1452552963937,20183,20500
MUSING.txt,25107,30171,5064,20,Y,Y,1452633925920,28052,28470
MUSING.txt,30172,35333,5161,20,Y,Y,1452636055684,32302,33666
MUSING.txt,35334,40078,4744,20,N,Y,1452636825724,38193,39614
MUSING.txt,40079,44381,4302,20,N,Y,1452637642930,39672,40424
MUSING.txt,44384,47640,3256,20,N,N,-,-1,-1
MUSING.txt,47642,51834,4192,20,N,Y,1452808243495,49009,49545
MUSING.txt,51835,56634,4799,20,Y,Y,1452810063851,53076,53440
MUSING.txt,56636,59990,3354,20,N,Y,1452811308084,57736,58274
MUSING.txt,59993,64633,4640,20,Y,Y,1453049225205,63792,64405
MUSING.txt,64635,69846,5211,20,Y,Y,1453051275841,69685,69839
MUSING.txt,69849,74686,4837,20,Y,Y,1453053339147,74161,74769
MUSING.txt,74687,79269,4582,20,N,Y,1453054180764,75925,76428
MUSING.txt,79270,84243,4973,20,N,N,-,-1,-1
MUSING.txt,84244,89578,5334,20,N,N,-,-1,-1
MUSING.txt,89579,93242,3663,20,N,N,-,-1,-1
MUSING.txt,93243,98360,5117,20,N,N,-,-1,-1
MUSING.txt,98361,102131,3770,20,N,N,-,-1,-1
MUSING.txt,102132,107009,4877,20,Y,Y,1461619406602,106559,106998
MUSING.txt,107010,110711,3701,20,Y,Y,1461619728886,107422,107922
MUSING.txt,110712,112840,2128,20,N,N,-,-1,-1
MUSING.txt,112845,116195,3350,20,N,Y,1473713496783,113607,114030
MUSING.txt,116196,119771,3575,20,N,N,-,-1,-1
MUSING.txt,119774,123455,3681,20,N,Y,1473715568245,121644,121983
MUSING.txt,123456,126366,2910,20,N,N,-,-1,-1
MUSING.txt,126371,129587,3216,20,N,Y,1483014061568,126874,127277
MUSING.txt,129588,132124,2536,20,N,N,-,-1,-1
MUSING.txt,132125,134840,2715,20,N,N,-,-1,-1
MUSING.txt,134841,137318,2477,20,N,N,-,-1,-1
MUSING.txt,137319,139306,1987,20,N,N,-,-1,-1
MUSING.txt,139307,141518,2211,20,N,Y,1483023499163,140609,141162
MUSING.txt,141519,143757,2238,20,N,N,-,-1,-1
MUSING.txt,143759,147165,3406,20,N,N,-,-1,-1
MUSING.txt,147166,150428,3262,20,Y,N,-,-1,-1
MUSING.txt,150429,153020,2591,20,N,Y,1483028149168,151984,152882
MUSING.txt,153023,155091,2068,20,N,Y,1483028673856,154833,155406
MUSING.txt,155092,157273,2181,20,N,Y,1483028673856,154833,155406
MUSING.txt,157274,160919,3645,20,N,N,-,-1,-1
MUSING.txt,160922,164486,3564,20,N,N,-,-1,-1
MUSING.txt,164489,167710,3221,20,N,N,-,-1,-1
MUSING.txt,167711,173067,5356,20,N,N,-,-1,-1
MUSING.txt,173068,177854,4786,20,Y,N,-,-1,-1
MUSING.txt,177857,184121,6264,20,N,N,-,-1,-1
MUSING.txt,184123,189894,5771,20,Y,N,-,-1,-1
MUSING.txt,189895,193046,3151,20,N,N,-,-1,-1
MUSING.txt,193049,198215,5166,20,N,N,-,-1,-1
MUSING.txt,198216,203384,5168,20,Y,N,-,-1,-1
MUSING.txt,203385,208906,5521,20,N,N,-,-1,-1
MUSING.txt,208907,213516,4609,20,Y,N,-,-1,-1
MUSING.txt,213517,216769,3252,20,Y,N,-,-1,-1
MUSING.txt,216770,221131,4361,20,N,N,-,-1,-1
MUSING.txt,221132,225905,4773,20,N,N,-,-1,-1
MUSING.txt,225906,229246,3340,20,N,N,-,-1,-1
MUSING.txt,229247,233646,4399,20,N,N,-,-1,-1
MUSING.txt,233647,236876,3229,20,N,N,-,-1,-1
MUSING.txt,236877,241555,4678,20,N,N,-,-1,-1
MUSING.txt,241558,245523,3965,20,N,N,-,-1,-1
MUSING.txt,245525,250260,4735,20,N,N,-,-1,-1
MUSING.txt,250262,256209,5947,20,N,N,-,-1,-1
MUSING.txt,256210,262395,6185,20,N,N,-,-1,-1
MUSING.txt,262396,267379,4983,20,N,N,-,-1,-1
MUSING.txt,267380,269674,2294,20,N,N,-,-1,-1
MUSING.txt,269675,271743,2068,20,N,N,-,-1,-1
MUSING.txt,271744,276537,4793,20,N,N,-,-1,-1
MUSING.txt,276538,279789,3251,20,N,N,-,-1,-1
MUSING.txt,279792,283295,3503,20,N,N,-,-1,-1
MUSING.txt,283298,288388,5090,20,N,N,-,-1,-1
MUSING.txt,288389,291991,3602,20,N,N,-,-1,-1
MUSING.txt,291992,294787,2795,20,N,N,-,-1,-1
MUSING.txt,294792,299170,4378,20,N,N,-,-1,-1
MUSING.txt,299173,304975,5802,20,Y,N,-,-1,-1
MUSING.txt,304976,308858,3882,20,N,N,-,-1,-1
MUSING.txt,308859,312100,3241,20,N,N,-,-1,-1
MUSING.txt,312101,315467,3366,20,N,N,-,-1,-1
MUSING.txt,315468,318685,3217,20,N,N,-,-1,-1
MUSING.txt,318686,323050,4364,20,N,N,-,-1,-1
MUSING.txt,323053,328225,5172,20,N,N,-,-1,-1
MUSING.txt,328226,332165,3939,20,N,N,-,-1,-1
MUSING.txt,332167,336994,4827,20,N,N,-,-1,-1
MUSING.txt,336995,340692,3697,20,N,N,-,-1,-1
MUSING.txt,340697,345365,4668,20,N,N,-,-1,-1
MUSING.txt,345366,348985,3619,20,N,N,-,-1,-1
MUSING.txt,348986,352359,3373,20,N,N,-,-1,-1
MUSING.txt,352360,356409,4049,20,Y,N,-,-1,-1
MUSING.txt,356410,360193,3783,20,N,N,-,-1,-1
MUSING.txt,360194,363329,3135,20,N,N,-,-1,-1
MUSING.txt,363330,366458,3128,20,N,N,-,-1,-1
MUSING.txt,366459,368834,2375,20,N,N,-,-1,-1
MUSING.txt,368835,372031,3196,20,Y,N,-,-1,-1
MUSING.txt,372036,374832,2796,20,N,N,-,-1,-1
MUSING.txt,374833,378231,3398,20,N,N,-,-1,-1
MUSING.txt,378232,383545,5313,20,N,N,-,-1,-1
MUSING.txt,383546,387714,4168,20,N,N,-,-1,-1
MUSING.txt,387715,392983,5268,20,N,N,-,-1,-1
MUSING.txt,392984,398899,5915,20,N,N,-,-1,-1
MUSING.txt,398900,402003,3103,20,N,N,-,-1,-1
MUSING.txt,402008,406295,4287,20,N,N,-,-1,-1
MUSING.txt,406296,410350,4054,20,N,N,-,-1,-1
MUSING.txt,410352,410939,587,20,N,N,-,-1,-1
MUSING.txt,410941,411359,418,20,N,N,-,-1,-1
MUSING.txt,411362,411900,538,20,N,N,-,-1,-1
MUSING.txt,411902,413511,1609,20,N,N,-,-1,-1
MUSING.txt,413514,416444,2930,20,N,N,-,-1,-1
MUSING.txt,416447,418925,2478,20,N,N,-,-1,-1
MUSING.txt,418926,423456,4530,20,Y,N,-,-1,-1
MUSING.txt,423457,426540,3083,20,N,N,-,-1,-1
MUSING.txt,426541,431067,4526,20,Y,N,-,-1,-1
MUSING.txt,431068,433859,2791,20,N,N,-,-1,-1
MUSING.txt,433860,437472,3612,20,N,N,-,-1,-1
MUSING.txt,437473,440722,3249,20,N,N,-,-1,-1
MUSING.txt,440725,444790,4065,20,N,N,-,-1,-1
MUSING.txt,444792,448440,3648,20,N,N,-,-1,-1
MUSING.txt,448441,452185,3744,20,N,N,-,-1,-1
MUSING.txt,452187,457052,4865,20,N,N,-,-1,-1
MUSING.txt,457053,463362,6309,20,N,N,-,-1,-1
MUSING.txt,463363,467032,3669,20,N,N,-,-1,-1
MUSING.txt,467035,471117,4082,20,N,N,-,-1,-1
MUSING.txt,471118,475878,4760,20,N,N,-,-1,-1
MUSING.txt,475879,479605,3726,20,N,N,-,-1,-1
MUSING.txt,479606,482628,3022,20,Y,N,-,-1,-1
MUSING.txt,482629,487798,5169,20,N,N,-,-1,-1
MUSING.txt,487799,491630,3831,20,N,N,-,-1,-1
MUSING.txt,491631,495994,4363,20,N,N,-,-1,-1
MUSING.txt,495995,500093,4098,20,N,N,-,-1,-1
MUSING.txt,500094,503637,3543,20,N,N,-,-1,-1
MUSING.txt,503638,508225,4587,20,N,N,-,-1,-1
MUSREM.txt,8,1107,1099,20,N,N,-,-1,-1
MUSREM.txt,1110,3533,2423,20,N,N,-,-1,-1
MUSREM.txt,3534,8068,4534,20,N,N,-,-1,-1
MUSREM.txt,8073,11056,2983,20,N,Y,1445944603888,10479,11042
MUSREM.txt,11057,14146,3089,20,Y,Y,1445946913032,11418,11636
MUSREM.txt,14147,17145,2998,20,N,Y,1445947674116,15382,15779
MUSREM.txt,17146,19915,2769,20,N,Y,1445955109644,17888,18866
MUSREM.txt,19920,23214,3294,20,Y,Y,1445955912022,23018,23382
MUSREM.txt,23215,26583,3368,20,Y,Y,1445955912022,23018,23382
MUSREM.txt,26584,29590,3006,20,N,Y,1445957251664,27927,28212
MUSREM.txt,29591,32267,2676,20,N,Y,1445957972281,31471,31861
MUSREM.txt,32268,35318,3050,20,N,Y,1445963721474,35258,35532
MUSREM.txt,35319,38154,2835,20,N,Y,1445964475278,37399,37589
MUSREM.txt,38155,41297,3142,20,N,Y,1445965566465,40802,41605
MUSREM.txt,41298,44281,2983,20,N,Y,1445965566465,40802,41605
MUSREM.txt,44282,47146,2864,20,Y,Y,1446052439741,45238,45486
MUSREM.txt,47147,50111,2964,20,N,Y,1446053757053,48262,48584
MUSREM.txt,50114,53341,3227,20,Y,Y,1446635157507,51003,51207
MUSREM.txt,53342,56861,3519,20,N,Y,1446636156055,56380,57523
MUSREM.txt,56862,59904,3042,20,N,Y,1446636156055,56380,57523
MUSREM.txt,59905,63318,3413,20,N,Y,1446637443845,60250,60839
MUSREM.txt,63319,66473,3154,20,N,Y,1446638321422,63089,63407
MUSREM.txt,66475,70046,3571,20,N,Y,1446640889918,69534,70949
MUSREM.txt,70049,73077,3028,20,N,Y,1446640889918,69534,70949
MUSREM.txt,73078,76396,3318,20,N,N,-,-1,-1
MUSREM.txt,76397,79862,3465,20,Y,N,-,-1,-1
MUSREM.txt,79863,82531,2668,20,N,Y,1446647463097,81750,82066
MUSREM.txt,82532,85572,3040,20,N,N,-,-1,-1
MUSREM.txt,85574,88729,3155,20,Y,Y,1446648222034,86772,88203
MUSREM.txt,88730,91801,3071,20,Y,Y,1446720066011,90716,91222
MUSREM.txt,91802,94597,2795,20,N,Y,1446720539477,92682,93428
MUSREM.txt,94598,96855,2257,20,N,Y,1446721440313,95396,95514
MUSREM.txt,96856,99924,3068,20,N,Y,1446722309879,97182,97409
MUSREM.txt,99925,103287,3362,20,Y,Y,1446743095300,100170,100734
MUSREM.txt,103290,107260,3970,20,N,Y,1446744408545,105127,106612
MUSREM.txt,107261,110440,3179,20,N,N,-,-1,-1
MUSREM.txt,110441,113693,3252,20,N,Y,1446744877240,111104,111542
MUSREM.txt,113694,117363,3669,20,N,N,-,-1,-1
MUSREM.txt,117366,121536,4170,20,Y,Y,1446809343172,120380,120695
MUSREM.txt,121538,124473,2935,20,N,Y,1446809771688,123931,124283
MUSREM.txt,124476,128217,3741,20,N,N,-,-1,-1
MUSREM.txt,128218,131638,3420,20,Y,N,-,-1,-1
MUSREM.txt,131643,134746,3103,20,N,N,-,-1,-1
MUSREM.txt,134747,138391,3644,20,N,Y,1446810408665,136481,136987
MUSREM.txt,138394,141604,3210,20,N,N,-,-1,-1
MUSREM.txt,141605,144488,2883,20,N,Y,1446810866600,143464,144041
MUSREM.txt,144491,147518,3027,20,N,Y,1446811837346,147380,148123
MUSREM.txt,147519,150281,2762,20,N,Y,1446811837346,147380,148123
MUSREM.txt,150282,153148,2866,20,Y,Y,1446813333984,151500,152176
MUSREM.txt,153151,156629,3478,20,Y,Y,1446813762750,154311,154910
MUSREM.txt,156630,159915,3285,20,N,Y,1446818906646,158638,159239
MUSREM.txt,159916,162272,2356,20,N,Y,1446819402984,161235,162017
MUSREM.txt,162273,164910,2637,20,N,N,-,-1,-1
MUSREM.txt,164911,168423,3512,20,N,Y,1446820062767,167097,167662
MUSREM.txt,168426,172385,3959,20,N,Y,1446820734391,170585,172593
MUSREM.txt,172386,174812,2426,20,N,Y,1446821453239,172722,173763
MUSREM.txt,174815,177920,3105,20,N,Y,1446823433860,177434,177715
MUSREM.txt,177921,180824,2903,20,N,Y,1446823931858,179105,180424
MUSREM.txt,180824,183661,2837,20,N,N,-,-1,-1
MUSREM.txt,183662,188077,4415,20,N,N,-,-1,-1
MUSREM.txt,188078,191620,3542,20,N,N,-,-1,-1
MUSREM.txt,191621,195487,3866,20,N,N,-,-1,-1
MUSREM.txt,195489,198983,3494,20,N,Y,1446824933321,197918,199597
MUSREM.txt,198985,202011,3026,20,N,Y,1447063241953,200523,201321
MUSREM.txt,202012,204462,2450,20,N,N,-,-1,-1
MUSREM.txt,204467,207226,2759,20,N,N,-,-1,-1
MUSREM.txt,207227,209394,2167,20,N,Y,1447063940500,207257,208280
MUSREM.txt,209397,212365,2968,20,N,Y,1447064379607,210331,210573
MUSREM.txt,212366,215058,2692,20,N,Y,1447065659153,213218,213654
MUSREM.txt,215059,217595,2536,20,N,Y,1448538803111,215417,216014
MUSREM.txt,217596,220119,2523,20,N,Y,1448539695891,217596,217897
MUSREM.txt,220120,222839,2719,20,N,Y,1448540487155,218969,220902
MUSREM.txt,222840,225981,3141,20,N,N,-,-1,-1
MUSREM.txt,225982,229444,3462,20,Y,N,-,-1,-1
MUSREM.txt,229447,232252,2805,20,N,N,-,-1,-1
MUSREM.txt,232253,235862,3609,20,N,N,-,-1,-1
MUSREM.txt,235863,238850,2987,20,N,N,-,-1,-1
MUSREM.txt,238851,240484,1633,20,N,Y,1448634950635,239410,239860
MUSREM.txt,240489,243701,3212,20,Y,N,-,-1,-1
MUSREM.txt,243702,247780,4078,20,Y,N,-,-1,-1
MUSREM.txt,247781,251013,3232,20,N,Y,1448635980588,250398,250825
MUSREM.txt,251014,253813,2799,20,N,N,-,-1,-1
MUSREM.txt,253814,256862,3048,20,N,Y,1448636605363,256225,257318
MUSREM.txt,256863,259738,2875,20,N,Y,1448636605363,256225,257318
MUSREM.txt,259739,262472,2733,20,N,Y,1448637339862,262368,262868
MUSREM.txt,262473,266073,3600,20,N,Y,1448637339862,262368,262868
MUSREM.txt,266074,268535,2461,20,N,Y,1448640538484,265221,266337
MUSREM.txt,268536,270863,2327,20,N,Y,1448972027684,268678,270113
MUSREM.txt,270866,273612,2746,20,N,Y,1448972712694,271727,272544
MUSREM.txt,273613,276287,2674,20,N,Y,1448973059320,274486,274617
MUSREM.txt,276288,278978,2690,20,N,Y,1448980124717,276863,277295
MUSREM.txt,278979,281723,2744,20,N,Y,1448980436772,279074,279287
MUSREM.txt,281724,284368,2644,20,N,Y,1448982281247,283638,283867
MUSREM.txt,284369,287349,2980,20,N,Y,1448988789823,287061,287381
MUSREM.txt,287350,289355,2005,20,N,Y,1448988789823,287061,287381
MUSREM.txt,289356,293246,3890,20,N,Y,1448989871144,289506,290112
MUSREM.txt,293247,296701,3454,20,Y,Y,1448991259482,294449,294734
MUSREM.txt,296702,300008,3306,20,N,N,-,-1,-1
MUSREM.txt,300009,303359,3350,20,N,N,-,-1,-1
MUSREM.txt,303359,305988,2629,20,N,N,-,-1,-1
OUSELEY.txt,0,7977,7977,20,N,N,-,-1,-1
OUSELEY.txt,7978,11884,3906,20,N,N,-,-1,-1
OUSELEY.txt,11885,14592,2707,20,N,N,-,-1,-1
OUSELEY.txt,14593,16358,1765,20,N,N,-,-1,-1
OUSELEY.txt,16360,20284,3924,20,N,N,-,-1,-1
OUSELEY.txt,20289,23987,3698,20,N,N,-,-1,-1
OUSELEY.txt,23988,26594,2606,20,N,N,-,-1,-1
OUSELEY.txt,26595,29377,2782,20,N,N,-,-1,-1
OUSELEY.txt,29380,32106,2726,20,N,N,-,-1,-1
OUSELEY.txt,32107,34856,2749,20,Y,N,-,-1,-1
OUSELEY.txt,34859,39113,4254,20,Y,N,-,-1,-1
OUSELEY.txt,39116,41391,2275,20,N,N,-,-1,-1
OUSELEY.txt,41392,44464,3072,20,N,Y,1436610229204,41646,43959
OUSELEY.txt,44465,45711,1246,20,N,N,-,-1,-1
OUSELEY.txt,45714,48116,2402,20,N,N,-,-1,-1
OUSELEY.txt,48117,50911,2794,20,N,N,-,-1,-1
OUSELEY.txt,50912,54066,3154,20,N,N,-,-1,-1
OUSELEY.txt,54068,57459,3391,20,N,N,-,-1,-1
OUSELEY.txt,57460,59714,2254,20,Y,N,-,-1,-1
OUSELEY.txt,59715,62613,2898,20,Y,N,-,-1,-1
OUSELEY.txt,62616,65739,3123,20,N,N,-,-1,-1
OUSELEY.txt,65740,69565,3825,20,N,N,-,-1,-1
OUSELEY.txt,69566,72595,3029,20,N,N,-,-1,-1
OUSELEY.txt,72596,75370,2774,20,N,N,-,-1,-1
OUSELEY.txt,75372,78862,3490,20,N,N,-,-1,-1
OUSELEY.txt,78865,81984,3119,20,N,N,-,-1,-1
OUSELEY.txt,81989,84628,2639,20,N,N,-,-1,-1
OUSELEY.txt,84629,87693,3064,20,N,N,-,-1,-1
OUSELEY.txt,87694,91112,3418,20,N,N,-,-1,-1
OUSELEY.txt,91117,94873,3756,20,N,N,-,-1,-1
OUSELEY.txt,94874,98099,3225,20,N,N,-,-1,-1
OUSELEY.txt,98100,104592,6492,20,N,N,-,-1,-1
OUSELEY.txt,104593,108082,3489,20,N,N,-,-1,-1
OUSELEY.txt,108085,109749,1664,20,N,N,-,-1,-1
OUSELEY.txt,109750,112272,2522,20,N,N,-,-1,-1
OUSELEY.txt,112273,115738,3465,20,N,N,-,-1,-1
OUSELEY.txt,115739,117182,1443,20,N,N,-,-1,-1
OUSELEY.txt,117183,118332,1149,20,N,N,-,-1,-1
OUSELEY.txt,118334,120692,2358,20,N,N,-,-1,-1
OUSELEY.txt,120693,124695,4002,20,Y,N,-,-1,-1
OUSELEY.txt,124698,127694,2996,20,N,N,-,-1,-1
OUSELEY.txt,127695,133012,5317,20,N,N,-,-1,-1
OUSELEY.txt,133013,137303,4290,20,N,N,-,-1,-1
OUSELEY.txt,137304,140135,2831,20,N,N,-,-1,-1
OUSELEY.txt,140136,143442,3306,20,N,N,-,-1,-1
OUSELEY.txt,143443,146392,2949,20,Y,N,-,-1,-1
OUSELEY.txt,146392,149910,3518,20,N,N,-,-1,-1
OUSELEY.txt,149911,153069,3158,20,N,N,-,-1,-1
OUSELEY.txt,153074,156501,3427,20,N,N,-,-1,-1
OUSELEY.txt,156504,160588,4084,20,N,N,-,-1,-1
OUSELEY.txt,160589,163684,3095,20,N,N,-,-1,-1
OUSELEY.txt,163685,166549,2864,20,N,N,-,-1,-1
OUSELEY.txt,166554,169098,2544,20,N,N,-,-1,-1
OUSELEY.txt,169103,171843,2740,20,N,N,-,-1,-1
OUSELEY.txt,171844,175237,3393,20,N,N,-,-1,-1
OUSELEY.txt,175238,178383,3145,20,N,N,-,-1,-1
OUSELEY.txt,178384,181871,3487,20,N,N,-,-1,-1
OUSELEY.txt,181874,184728,2854,20,N,N,-,-1,-1
OUSELEY.txt,184729,188607,3878,20,N,N,-,-1,-1
OUSELEY.txt,188610,190159,1549,20,N,N,-,-1,-1
OUSELEY.txt,190162,194610,4448,20,N,N,-,-1,-1
OUSELEY.txt,194611,198079,3468,20,N,N,-,-1,-1
OUSELEY.txt,198080,199790,1710,20,N,N,-,-1,-1
OUSELEY.txt,199793,204639,4846,20,N,N,-,-1,-1
OUSELEY.txt,204640,207400,2760,20,N,N,-,-1,-1
OUSELEY.txt,207401,210227,2826,20,N,N,-,-1,-1
OUSELEY.txt,210228,213120,2892,20,N,N,-,-1,-1
OUSELEY.txt,213121,216688,3567,20,N,N,-,-1,-1
OUSELEY.txt,216689,220669,3980,20,N,N,-,-1,-1
OUSELEY.txt,220670,225768,5098,20,N,N,-,-1,-1
OUSELEY.txt,225769,230308,4539,20,N,N,-,-1,-1
OUSELEY.txt,230309,233938,3629,20,N,N,-,-1,-1
OUSELEY.txt,233940,239140,5200,20,N,N,-,-1,-1
OUSELEY.txt,239141,243379,4238,20,N,N,-,-1,-1
OUSELEY.txt,243380,248069,4689,20,N,N,-,-1,-1
OUSELEY.txt,248070,252161,4091,20,N,N,-,-1,-1
OUSELEY.txt,252162,254712,2550,20,N,N,-,-1,-1
OUSELEY.txt,254713,258429,3716,20,N,N,-,-1,-1
OUSELEY.txt,258434,261936,3502,20,Y,N,-,-1,-1
OUSELEY.txt,261941,264623,2682,20,Y,N,-,-1,-1
OUSELEY.txt,264628,267618,2990,20,N,N,-,-1,-1
OUSELEY.txt,267619,270678,3059,20,N,N,-,-1,-1
OUSELEY.txt,270679,273300,2621,20,N,N,-,-1,-1
OUSELEY.txt,273301,276194,2893,20,N,N,-,-1,-1
OUSELEY.txt,276194,278746,2552,20,N,N,-,-1,-1
OUSELEY.txt,278747,281819,3072,20,Y,N,-,-1,-1
OUSELEY.txt,281820,284797,2977,20,Y,N,-,-1,-1
OUSELEY.txt,284799,285646,847,20,N,N,-,-1,-1
OUSELEY.txt,285651,286769,1118,20,N,N,-,-1,-1
OUSELEY.txt,286772,287518,746,20,N,N,-,-1,-1
OUSELEY.txt,287520,288159,639,20,N,N,-,-1,-1
OUSELEY.txt,288160,289786,1626,20,N,N,-,-1,-1
OUSELEY.txt,289786,292582,2796,20,N,N,-,-1,-1
OUSELEY.txt,292585,293487,902,20,N,N,-,-1,-1
OUSELEY.txt,293488,294276,788,20,N,N,-,-1,-1
OUSELEY.txt,294277,295369,1092,20,N,N,-,-1,-1
OUSELEY.txt,295371,295904,533,20,N,N,-,-1,-1
OUSELEY.txt,295905,296329,424,20,N,N,-,-1,-1
OUSELEY.txt,296330,296792,462,20,N,N,-,-1,-1
OUSELEY.txt,296793,298446,1653,20,N,N,-,-1,-1
OUSELEY.txt,298449,300593,2144,20,N,N,-,-1,-1
OUSELEY.txt,300594,303542,2948,20,N,N,-,-1,-1
OUSELEY.txt,303548,305204,1656,20,N,N,-,-1,-1
OUSELEY.txt,305205,307759,2554,20,N,N,-,-1,-1
OUSELEY.txt,307765,310097,2332,20,N,N,-,-1,-1
OUSELEY.txt,310100,312360,2260,20,N,N,-,-1,-1
PILGRIM.txt,0,1873,1873,20,N,N,-,-1,-1
PILGRIM.txt,1874,3998,2124,20,N,N,-,-1,-1
PILGRIM.txt,3999,7179,3180,20,Y,N,-,-1,-1
PILGRIM.txt,7180,10734,3554,20,N,N,-,-1,-1
PILGRIM.txt,10737,15542,4805,20,N,N,-,-1,-1
PILGRIM.txt,15545,20292,4747,20,N,N,-,-1,-1
PILGRIM.txt,20295,23276,2981,20,N,N,-,-1,-1
PILGRIM.txt,23279,26233,2954,20,N,N,-,-1,-1
PILGRIM.txt,26234,29828,3594,20,N,N,-,-1,-1
PILGRIM.txt,29829,32271,2442,20,N,N,-,-1,-1
PILGRIM.txt,32272,35681,3409,20,N,N,-,-1,-1
PILGRIM.txt,35683,37937,2254,20,N,N,-,-1,-1
PILGRIM.txt,37940,40501,2561,20,N,N,-,-1,-1
PILGRIM.txt,40502,42966,2464,20,N,N,-,-1,-1
PILGRIM.txt,42967,45811,2844,20,N,N,-,-1,-1
PILGRIM.txt,45812,48633,2821,20,N,N,-,-1,-1
PILGRIM.txt,48635,50805,2170,20,N,Y,1430808947621,50425,50979
PILGRIM.txt,50806,53225,2419,20,N,Y,1430808947621,50425,50979
PILGRIM.txt,53226,55873,2647,20,N,N,-,-1,-1
PILGRIM.txt,55875,58947,3072,20,N,N,-,-1,-1
PILGRIM.txt,58948,61328,2380,20,N,N,-,-1,-1
PILGRIM.txt,61331,64265,2934,20,N,N,-,-1,-1
PILGRIM.txt,64268,66599,2331,20,N,N,-,-1,-1
PILGRIM.txt,66600,68936,2336,20,N,N,-,-1,-1
PILGRIM.txt,68938,71294,2356,20,N,N,-,-1,-1
PILGRIM.txt,71295,73965,2670,20,N,N,-,-1,-1
PILGRIM.txt,73971,76317,2346,20,N,N,-,-1,-1
PILGRIM.txt,76320,79284,2964,20,N,Y,1432737524261,76323,77903
PILGRIM.txt,79285,82083,2798,20,N,N,-,-1,-1
PILGRIM.txt,82084,85002,2918,20,N,N,-,-1,-1
PILGRIM.txt,85004,87989,2985,20,Y,N,-,-1,-1
PILGRIM.txt,87990,90254,2264,20,N,N,-,-1,-1
PILGRIM.txt,90255,93451,3196,20,N,N,-,-1,-1
PILGRIM.txt,93452,96232,2780,20,N,N,-,-1,-1
PILGRIM.txt,96233,99319,3086,20,N,N,-,-1,-1
PILGRIM.txt,99320,102085,2765,20,N,N,-,-1,-1
PILGRIM.txt,102086,104318,2232,20,N,N,-,-1,-1
PILGRIM.txt,104321,106758,2437,20,N,N,-,-1,-1
PILGRIM.txt,106759,109274,2515,20,N,N,-,-1,-1
PILGRIM.txt,109275,111824,2549,20,N,N,-,-1,-1
PILGRIM.txt,111825,114898,3073,20,N,N,-,-1,-1
PILGRIM.txt,114901,117230,2329,20,N,N,-,-1,-1
PILGRIM.txt,117231,120452,3221,20,N,N,-,-1,-1
PILGRIM.txt,120457,123048,2591,20,N,N,-,-1,-1
PILGRIM.txt,123049,125148,2099,20,N,N,-,-1,-1
PILGRIM.txt,125149,127308,2159,20,N,N,-,-1,-1
PILGRIM.txt,127309,130212,2903,20,N,Y,1432747851515,129932,131402
PILGRIM.txt,130213,132205,1992,20,N,Y,1432747851515,129932,131402
PILGRIM.txt,132206,134587,2381,20,N,N,-,-1,-1
PILGRIM.txt,134588,136847,2259,20,N,Y,1432792603693,134919,135643
PILGRIM.txt,136849,139324,2475,20,N,N,-,-1,-1
PILGRIM.txt,139329,142291,2962,20,N,N,-,-1,-1
PILGRIM.txt,142292,144020,1728,20,Y,N,-,-1,-1
PILGRIM.txt,144025,147272,3247,20,Y,Y,1432795431094,146203,147710
PILGRIM.txt,147273,150282,3009,20,N,Y,1432795431094,146203,147710
PILGRIM.txt,150283,153067,2784,20,Y,N,-,-1,-1
PILGRIM.txt,153068,156143,3075,20,N,N,-,-1,-1
PILGRIM.txt,156144,158702,2558,20,N,N,-,-1,-1
PILGRIM.txt,158703,161474,2771,20,N,N,-,-1,-1
PILGRIM.txt,161475,164490,3015,20,N,N,-,-1,-1
PILGRIM.txt,164491,167223,2732,20,N,N,-,-1,-1
PILGRIM.txt,167224,169847,2623,20,N,N,-,-1,-1
PILGRIM.txt,169848,172891,3043,20,N,N,-,-1,-1
PILGRIM.txt,172892,176539,3647,20,Y,N,-,-1,-1
PILGRIM.txt,176541,179386,2845,20,N,N,-,-1,-1
PILGRIM.txt,179388,182405,3017,20,N,N,-,-1,-1
PILGRIM.txt,182408,184507,2099,20,N,N,-,-1,-1
PILGRIM.txt,184508,186832,2324,20,N,N,-,-1,-1
PILGRIM.txt,186833,188301,1468,20,N,N,-,-1,-1
PILGRIM.txt,188302,189867,1565,20,N,N,-,-1,-1
PILGRIM.txt,189868,191828,1960,20,N,N,-,-1,-1
PILGRIM.txt,191829,193984,2155,20,N,N,-,-1,-1
PILGRIM.txt,193985,196602,2617,20,N,N,-,-1,-1
PILGRIM.txt,196603,199259,2656,20,N,N,-,-1,-1
PILGRIM.txt,199260,201674,2414,20,N,N,-,-1,-1
PILGRIM.txt,201675,203985,2310,20,N,N,-,-1,-1
PILGRIM.txt,203986,206052,2066,20,N,N,-,-1,-1
PILGRIM.txt,206053,208853,2800,20,N,N,-,-1,-1
PILGRIM.txt,208854,211569,2715,20,N,N,-,-1,-1
PILGRIM.txt,211570,213836,2266,20,N,N,-,-1,-1
PILGRIM.txt,213837,216034,2197,20,N,N,-,-1,-1
PILGRIM.txt,216035,218217,2182,20,N,N,-,-1,-1
PILGRIM.txt,218218,219833,1615,20,N,N,-,-1,-1
PILGRIM.txt,219834,221661,1827,20,N,N,-,-1,-1
PILGRIM.txt,221662,224468,2806,20,N,N,-,-1,-1
PILGRIM.txt,224471,226915,2444,20,N,N,-,-1,-1
PILGRIM.txt,226916,229079,2163,20,N,Y,1432812913267,228270,230251
PILGRIM.txt,229080,232739,3659,20,N,Y,1432812913267,228270,230251
PILGRIM.txt,232742,235742,3000,20,N,N,-,-1,-1
PILGRIM.txt,235744,238296,2552,20,N,Y,1432826715274,237060,238022
PILGRIM.txt,238298,240624,2326,20,N,N,-,-1,-1
PILGRIM.txt,240629,243400,2771,20,N,N,-,-1,-1
PILGRIM.txt,243401,246021,2620,20,N,N,-,-1,-1
PILGRIM.txt,246022,248608,2586,20,N,N,-,-1,-1
PILGRIM.txt,248609,250919,2310,20,N,N,-,-1,-1
PILGRIM.txt,250920,253745,2825,20,N,N,-,-1,-1
PILGRIM.txt,253747,256579,2832,20,N,N,-,-1,-1
PILGRIM.txt,256580,259526,2946,20,N,N,-,-1,-1
PILGRIM.txt,259527,262600,3073,20,N,Y,1432830272373,259940,261638
PILGRIM.txt,262601,264137,1536,20,N,N,-,-1,-1
PILGRIM.txt,264138,266977,2839,20,N,N,-,-1,-1
PILGRIM.txt,266979,269951,2972,20,N,N,-,-1,-1
PILGRIM.txt,269954,272455,2501,20,N,N,-,-1,-1
PILGRIM.txt,272456,274894,2438,20,N,N,-,-1,-1
PILGRIM.txt,274895,278062,3167,20,N,N,-,-1,-1
PILGRIM.txt,278063,281281,3218,20,N,N,-,-1,-1
PILGRIM.txt,281284,283332,2048,20,N,N,-,-1,-1
PILGRIM.txt,283333,285738,2405,20,N,N,-,-1,-1
PILGRIM.txt,285739,288729,2990,20,N,N,-,-1,-1
PILGRIM.txt,288730,291287,2557,20,N,N,-,-1,-1
PILGRIM.txt,291288,294304,3016,20,Y,N,-,-1,-1
PILGRIM.txt,294305,296154,1849,20,N,N,-,-1,-1
PILGRIM.txt,296155,298963,2808,20,N,N,-,-1,-1
PILGRIM.txt,298966,302022,3056,20,N,N,-,-1,-1
PILGRIM.txt,302023,305115,3092,20,Y,N,-,-1,-1
PILGRIM.txt,305118,307154,2036,20,N,N,-,-1,-1
PILGRIM.txt,307155,309255,2100,20,N,Y,1432919383904,308149,309945
PILGRIM.txt,309256,311528,2272,20,N,Y,1432919383904,308149,309945
PILGRIM.txt,311529,314326,2797,20,N,N,-,-1,-1
PILGRIM.txt,314327,316786,2459,20,N,N,-,-1,-1
PILGRIM.txt,316787,319558,2771,20,N,N,-,-1,-1
PILGRIM.txt,319559,321507,1948,20,N,N,-,-1,-1
PILGRIM.txt,321508,324446,2938,20,N,N,-,-1,-1
PILGRIM.txt,324447,327412,2965,20,N,N,-,-1,-1
PILGRIM.txt,327413,330145,2732,20,N,Y,1432976483264,327834,329881
PILGRIM.txt,330146,333368,3222,20,N,N,-,-1,-1
PILGRIM.txt,333371,336841,3470,20,N,N,-,-1,-1
PILGRIM.txt,336842,340075,3233,20,N,N,-,-1,-1
PILGRIM.txt,340076,343642,3566,20,N,N,-,-1,-1
PILGRIM.txt,343647,347041,3394,20,N,N,-,-1,-1
PILGRIM.txt,347042,349852,2810,20,N,N,-,-1,-1
PILGRIM.txt,349853,352875,3022,20,Y,N,-,-1,-1
PILGRIM.txt,352876,356348,3472,20,N,N,-,-1,-1
PILGRIM.txt,356349,358813,2464,20,N,N,-,-1,-1
PILGRIM.txt,358814,361543,2729,20,N,N,-,-1,-1
PILGRIM.txt,361545,365105,3560,20,N,Y,1432978478641,361921,364422
PILGRIM.txt,365106,367699,2593,20,N,N,-,-1,-1
PILGRIM.txt,367700,370847,3147,20,N,N,-,-1,-1
PILGRIM.txt,370850,373880,3030,20,N,N,-,-1,-1
PILGRIM.txt,373881,376603,2722,20,N,N,-,-1,-1
PILGRIM.txt,376604,379185,2581,20,N,N,-,-1,-1
PILGRIM.txt,379186,382129,2943,20,N,N,-,-1,-1
PILGRIM.txt,382132,385308,3176,20,N,Y,1432979435232,384507,385447
PILGRIM.txt,385309,388391,3082,20,Y,Y,1432979435232,384507,385447
PILGRIM.txt,388392,391255,2863,20,N,N,-,-1,-1
PILGRIM.txt,391256,394032,2776,20,N,N,-,-1,-1
PILGRIM.txt,394037,396600,2563,20,N,N,-,-1,-1
PILGRIM.txt,396601,401092,4491,20,N,Y,1432980418512,399130,400458
PILGRIM.txt,401094,403482,2388,20,N,N,-,-1,-1
PILGRIM.txt,403484,406630,3146,20,N,N,-,-1,-1
PILGRIM.txt,406632,409373,2741,20,N,N,-,-1,-1
PILGRIM.txt,409376,412187,2811,20,N,Y,1432982795628,411959,413612
PILGRIM.txt,412188,415529,3341,20,Y,Y,1432982795628,411959,413612
PILGRIM.txt,415530,418935,3405,20,N,N,-,-1,-1
PILGRIM.txt,418938,421993,3055,20,N,Y,1432984504343,420736,421597
PILGRIM.txt,421994,424876,2882,20,N,N,-,-1,-1
PILGRIM.txt,424878,427689,2811,20,N,N,-,-1,-1
PILGRIM.txt,427690,430971,3281,20,N,N,-,-1,-1
PILGRIM.txt,430974,433782,2808,20,N,N,-,-1,-1
PILGRIM.txt,433784,436507,2723,20,N,N,-,-1,-1
PILGRIM.txt,436508,439011,2503,20,N,N,-,-1,-1
PILGRIM.txt,439012,441567,2555,20,N,N,-,-1,-1
PILGRIM.txt,441568,443344,1776,20,N,N,-,-1,-1
PILGRIM.txt,443345,446120,2775,20,N,N,-,-1,-1
PILGRIM.txt,446121,449026,2905,20,N,N,-,-1,-1
PILGRIM.txt,449027,451735,2708,20,N,N,-,-1,-1
PILGRIM.txt,451736,454701,2965,20,N,N,-,-1,-1
PILGRIM.txt,454702,457463,2761,20,N,Y,1433089799400,455451,455857
PILGRIM.txt,457464,459901,2437,20,N,N,-,-1,-1
PILGRIM.txt,459902,462786,2884,20,N,N,-,-1,-1
PILGRIM.txt,462789,465298,2509,20,N,N,-,-1,-1
PILGRIM.txt,465301,468070,2769,20,N,N,-,-1,-1
PILGRIM.txt,468071,470570,2499,20,N,N,-,-1,-1
PILGRIM.txt,470573,473918,3345,20,N,Y,1433091318633,471647,472306
PILGRIM.txt,473919,476941,3022,20,N,N,-,-1,-1
PILGRIM.txt,476944,481015,4071,20,N,N,-,-1,-1
PILGRIM.txt,481018,484389,3371,20,N,N,-,-1,-1
PILGRIM.txt,484390,487923,3533,20,N,N,-,-1,-1
PILGRIM.txt,487924,490903,2979,20,N,N,-,-1,-1
PILGRIM.txt,490905,493831,2926,20,N,N,-,-1,-1
PILGRIM.txt,493832,497600,3768,20,N,Y,1433092717054,496037,497172
PILGRIM.txt,497601,500991,3390,20,N,Y,1433093250202,497882,499236
PILGRIM.txt,500994,504351,3357,20,N,N,-,-1,-1
PILGRIM.txt,504352,507428,3076,20,N,N,-,-1,-1
PILGRIM.txt,507429,509877,2448,20,N,N,-,-1,-1
PILGRIM.txt,509878,512456,2578,20,Y,N,-,-1,-1
PILGRIM.txt,512459,515335,2876,20,N,N,-,-1,-1
PILGRIM.txt,515337,517664,2327,20,N,N,-,-1,-1
PILGRIM.txt,517666,520675,3009,20,N,N,-,-1,-1
PILGRIM.txt,520680,522785,2105,20,N,N,-,-1,-1
PILGRIM.txt,522786,525364,2578,20,N,N,-,-1,-1
PILGRIM.txt,525365,529256,3891,20,N,Y,1433140776828,526138,528487
PILGRIM.txt,529257,531976,2719,20,Y,N,-,-1,-1
PILGRIM.txt,531977,535158,3181,20,Y,Y,1433166467939,532258,533091
PILGRIM.txt,535159,538137,2978,20,N,N,-,-1,-1
PILGRIM.txt,538138,539561,1423,20,N,N,-,-1,-1
PILGRIM.txt,539562,542276,2714,20,N,N,-,-1,-1
PILGRIM.txt,542278,545315,3037,20,N,Y,1433167548802,544513,546084
PILGRIM.txt,545316,548618,3302,20,N,Y,1433168080595,547752,548387
PILGRIM.txt,548619,551302,2683,20,N,N,-,-1,-1
PILGRIM.txt,551305,554945,3640,20,N,N,-,-1,-1
PILGRIM.txt,554948,557996,3048,20,N,Y,1433168856414,556592,557358
PILGRIM.txt,557997,560330,2333,20,N,N,-,-1,-1
PILGRIM.txt,560331,563447,3116,20,N,N,-,-1,-1
PILGRIM.txt,563449,564933,1484,20,N,N,-,-1,-1
PILGRIM.txt,564934,566903,1969,20,N,N,-,-1,-1
PILGRIM.txt,566904,568862,1958,20,N,N,-,-1,-1
PILGRIM.txt,568864,571605,2741,20,N,N,-,-1,-1
PILGRIM.txt,571606,574063,2457,20,N,N,-,-1,-1
PILGRIM.txt,574066,577179,3113,20,N,N,-,-1,-1
PILGRIM.txt,577180,580549,3369,20,N,N,-,-1,-1
PILGRIM.txt,580549,584459,3910,20,N,N,-,-1,-1
PILGRIM.txt,584462,586255,1793,20,N,N,-,-1,-1
PILGRIM.txt,586256,588421,2165,20,N,N,-,-1,-1
PILGRIM.txt,588422,590430,2008,20,N,N,-,-1,-1
PILGRIM.txt,590433,592796,2363,20,N,N,-,-1,-1
PILGRIM.txt,592797,596125,3328,20,N,N,-,-1,-1
PILGRIM.txt,596126,600018,3892,20,N,N,-,-1,-1
PILGRIM.txt,600021,603308,3287,20,N,N,-,-1,-1
PILGRIM.txt,603311,606643,3332,20,N,N,-,-1,-1
PILGRIM.txt,606644,609417,2773,20,N,N,-,-1,-1
PILGRIM.txt,609417,609794,377,20,N,N,-,-1,-1
PILGRIM.txt,609795,610254,459,20,N,N,-,-1,-1
PILGRIM.txt,610257,610858,601,20,N,N,-,-1,-1
PILGRIM.txt,610859,615188,4329,20,N,N,-,-1,-1
PILGRIM.txt,615190,618379,3189,20,N,N,-,-1,-1
PILGRIM.txt,618380,621592,3212,20,N,N,-,-1,-1
PILGRIM.txt,621595,624427,2832,20,N,N,-,-1,-1
PILGRIM.txt,624429,627837,3408,20,N,N,-,-1,-1
PILGRIM.txt,627838,630760,2922,20,N,N,-,-1,-1
PILGRIM.txt,630761,640579,9818,20,N,N,-,-1,-1
PILGRIM.txt,640581,653558,12977,20,N,N,-,-1,-1
RECMUS.txt,0,1082,1082,20,N,N,-,-1,-1
RECMUS.txt,1083,3406,2323,20,N,N,-,-1,-1
RECMUS.txt,3411,7245,3834,20,N,N,-,-1,-1
RECMUS.txt,7248,11702,4454,20,N,N,-,-1,-1
RECMUS.txt,11705,15449,3744,20,N,N,-,-1,-1
RECMUS.txt,15452,18963,3511,20,N,N,-,-1,-1
RECMUS.txt,18966,22013,3047,20,Y,N,-,-1,-1
RECMUS.txt,22014,24696,2682,20,N,N,-,-1,-1
RECMUS.txt,24697,27238,2541,20,Y,N,-,-1,-1
RECMUS.txt,27239,29884,2645,20,N,N,-,-1,-1
RECMUS.txt,29885,32364,2479,20,Y,N,-,-1,-1
RECMUS.txt,32366,35223,2857,20,N,N,-,-1,-1
RECMUS.txt,35226,38121,2895,20,N,N,-,-1,-1
RECMUS.txt,38124,40619,2495,20,N,N,-,-1,-1
RECMUS.txt,40621,43126,2505,20,Y,N,-,-1,-1
RECMUS.txt,43127,45661,2534,20,N,N,-,-1,-1
RECMUS.txt,45662,48232,2570,20,Y,N,-,-1,-1
RECMUS.txt,48233,51305,3072,20,Y,N,-,-1,-1
RECMUS.txt,51306,53726,2420,20,N,N,-,-1,-1
RECMUS.txt,53727,56957,3230,20,N,N,-,-1,-1
RECMUS.txt,56960,59741,2781,20,N,N,-,-1,-1
RECMUS.txt,59742,60683,941,20,N,N,-,-1,-1
RECMUS.txt,60684,63159,2475,20,Y,N,-,-1,-1
RECMUS.txt,63160,66204,3044,20,Y,N,-,-1,-1
RECMUS.txt,66205,69532,3327,20,Y,Y,1426859941632,67129,67357
RECMUS.txt,69533,72559,3026,20,Y,Y,1426861072576,72354,72768
RECMUS.txt,72561,75040,2479,20,N,Y,1426861072576,72354,72768
RECMUS.txt,75041,77882,2841,20,N,Y,1426861595037,75041,75166
RECMUS.txt,77885,81018,3133,20,N,Y,1426863415047,78494,78880
RECMUS.txt,81019,83185,2166,20,N,N,-,-1,-1
RECMUS.txt,83186,85593,2407,20,N,N,-,-1,-1
RECMUS.txt,85594,87854,2260,20,Y,N,-,-1,-1
RECMUS.txt,87856,89726,1870,20,N,N,-,-1,-1
RECMUS.txt,89729,92102,2373,20,N,N,-,-1,-1
RECMUS.txt,92103,95894,3791,20,N,N,-,-1,-1
RECMUS.txt,95897,98656,2759,20,N,N,-,-1,-1
RECMUS.txt,98661,100852,2191,20,N,N,-,-1,-1
RECMUS.txt,100853,102463,1610,20,N,N,-,-1,-1
RECMUS.txt,102465,104811,2346,20,N,Y,1427479456712,102659,102787
RECMUS.txt,104814,107761,2947,20,N,N,-,-1,-1
RECMUS.txt,107764,110362,2598,20,N,N,-,-1,-1
RECMUS.txt,110363,113359,2996,20,Y,N,-,-1,-1
RECMUS.txt,113360,115031,1671,20,Y,N,-,-1,-1
RECMUS.txt,115032,115329,297,20,N,N,-,-1,-1
RECMUS.txt,115332,115776,444,20,N,N,-,-1,-1
RECMUS.txt,115779,117669,1890,20,N,N,-,-1,-1
RECMUS.txt,117670,120848,3178,20,N,N,-,-1,-1
RECMUS.txt,120851,123345,2494,20,N,N,-,-1,-1
RECMUS.txt,123346,126821,3475,20,Y,Y,1428494785912,123570,123801
RECMUS.txt,126822,129641,2819,20,Y,N,-,-1,-1
RECMUS.txt,129642,132555,2913,20,N,N,-,-1,-1
RECMUS.txt,132558,135089,2531,20,N,N,-,-1,-1
RECMUS.txt,135090,137504,2414,20,Y,N,-,-1,-1
RECMUS.txt,137509,139816,2307,20,N,Y,1429002645768,138633,138684
RECMUS.txt,139821,142688,2867,20,N,N,-,-1,-1
RECMUS.txt,142689,145166,2477,20,N,N,-,-1,-1
RECMUS.txt,145167,148686,3519,20,N,N,-,-1,-1
RECMUS.txt,148687,151831,3144,20,Y,N,-,-1,-1
RECMUS.txt,151832,154790,2958,20,N,N,-,-1,-1
RECMUS.txt,154792,157598,2806,20,Y,N,-,-1,-1
RECMUS.txt,157599,159840,2241,20,N,Y,1429102663064,159583,159924
RECMUS.txt,159841,162648,2807,20,N,Y,1429102663064,159583,159924
RECMUS.txt,162649,164462,1813,20,N,Y,1429103324122,162708,162980
RECMUS.txt,164463,165785,1322,20,N,N,-,-1,-1
RECMUS.txt,165785,168240,2455,20,N,N,-,-1,-1
RECMUS.txt,168242,170966,2724,20,N,N,-,-1,-1
RECMUS.txt,170967,172867,1900,20,N,N,-,-1,-1
RECMUS.txt,172868,175260,2392,20,N,N,-,-1,-1
RECMUS.txt,175261,177789,2528,20,Y,N,-,-1,-1
RECMUS.txt,177794,180649,2855,20,N,N,-,-1,-1
RECMUS.txt,180650,183116,2466,20,N,N,-,-1,-1
RECMUS.txt,183118,184775,1657,20,N,N,-,-1,-1
RECMUS.txt,184776,186379,1603,20,N,N,-,-1,-1
RECMUS.txt,186380,188765,2385,20,N,Y,1429532686038,188361,188583
RECMUS.txt,188766,191203,2437,20,N,N,-,-1,-1
RECMUS.txt,191204,194479,3275,20,Y,N,-,-1,-1
RECMUS.txt,194480,197645,3165,20,Y,Y,1429535538810,196482,199062
RECMUS.txt,197646,200097,2451,20,N,Y,1429535538810,196482,199062
RECMUS.txt,200098,202952,2854,20,N,N,-,-1,-1
RECMUS.txt,202953,205308,2355,20,N,N,-,-1,-1
RECMUS.txt,205313,207691,2378,20,Y,N,-,-1,-1
RECMUS.txt,207696,210669,2973,20,N,N,-,-1,-1
RECMUS.txt,210670,212575,1905,20,N,N,-,-1,-1
RECMUS.txt,212576,215341,2765,20,Y,N,-,-1,-1
RECMUS.txt,215342,218073,2731,20,N,N,-,-1,-1
RECMUS.txt,218074,221327,3253,20,N,N,-,-1,-1
RECMUS.txt,221328,223800,2472,20,N,N,-,-1,-1
RECMUS.txt,223801,226143,2342,20,N,N,-,-1,-1
RECMUS.txt,226144,227992,1848,20,N,N,-,-1,-1
RECMUS.txt,227993,231279,3286,20,N,N,-,-1,-1
RECMUS.txt,231282,233604,2322,20,N,N,-,-1,-1
RECMUS.txt,233606,236482,2876,20,N,N,-,-1,-1
RECMUS.txt,236483,238607,2124,20,N,N,-,-1,-1
RECMUS.txt,238608,240819,2211,20,N,N,-,-1,-1
RECMUS.txt,240820,243182,2362,20,N,N,-,-1,-1
RECMUS.txt,243183,246004,2821,20,N,N,-,-1,-1
RECMUS.txt,246005,248546,2541,20,N,N,-,-1,-1
RECMUS.txt,248547,251465,2918,20,N,N,-,-1,-1
RECMUS.txt,251466,253043,1577,20,N,N,-,-1,-1
RECMUS.txt,253044,255425,2381,20,N,N,-,-1,-1
RECMUS.txt,255430,257442,2012,20,N,N,-,-1,-1
RECMUS.txt,257445,259598,2153,20,N,N,-,-1,-1
RECMUS.txt,259601,261830,2229,20,Y,N,-,-1,-1
RECMUS.txt,261831,264462,2631,20,N,Y,1429610699650,262775,263040
RECMUS.txt,264463,266543,2080,20,N,N,-,-1,-1
RECMUS.txt,266544,270700,4156,20,N,N,-,-1,-1
RECMUS.txt,270701,273174,2473,20,N,N,-,-1,-1
RECMUS.txt,273175,275480,2305,20,N,N,-,-1,-1
RECMUS.txt,275481,278030,2549,20,Y,N,-,-1,-1
RECMUS.txt,278031,279851,1820,20,N,N,-,-1,-1
RECMUS.txt,279852,283677,3825,20,N,N,-,-1,-1
RECMUS.txt,283678,287258,3580,20,N,N,-,-1,-1
RECMUS.txt,287259,290221,2962,20,N,N,-,-1,-1
RECMUS.txt,290224,293681,3457,20,Y,N,-,-1,-1
RECMUS.txt,293683,296188,2505,20,N,N,-,-1,-1
RECMUS.txt,296188,299634,3446,20,N,N,-,-1,-1
RECMUS.txt,299636,301212,1576,20,N,N,-,-1,-1
RECMUS.txt,301215,303396,2181,20,N,N,-,-1,-1
RECMUS.txt,303399,305870,2471,20,N,N,-,-1,-1
RECMUS.txt,305871,309466,3595,20,N,N,-,-1,-1
RECMUS.txt,309467,312848,3381,20,Y,N,-,-1,-1
RECMUS.txt,312849,316159,3310,20,N,N,-,-1,-1
RECMUS.txt,316161,317672,1511,20,N,Y,1429618477739,317165,317427
RECMUS.txt,317673,320159,2486,20,N,N,-,-1,-1
RECMUS.txt,320161,322478,2317,20,N,N,-,-1,-1
RECMUS.txt,322479,325586,3107,20,N,N,-,-1,-1
RECMUS.txt,325587,327827,2240,20,N,Y,1429619541244,325924,326642
RECMUS.txt,327828,330372,2544,20,Y,N,-,-1,-1
RECMUS.txt,330373,332910,2537,20,Y,N,-,-1,-1
RECMUS.txt,332913,335760,2847,20,Y,N,-,-1,-1
RECMUS.txt,335763,339097,3334,20,Y,N,-,-1,-1
RECMUS.txt,339098,341199,2101,20,N,N,-,-1,-1
RECMUS.txt,341202,344649,3447,20,Y,Y,1429621761088,341740,341892
RECMUS.txt,344650,347487,2837,20,Y,N,-,-1,-1
RECMUS.txt,347488,351245,3757,20,N,N,-,-1,-1
RECMUS.txt,351246,353684,2438,20,Y,N,-,-1,-1
RECMUS.txt,353685,356186,2501,20,N,N,-,-1,-1
RECMUS.txt,356189,358391,2202,20,N,N,-,-1,-1
RECMUS.txt,358392,361557,3165,20,N,N,-,-1,-1
RECMUS.txt,361558,363722,2164,20,N,N,-,-1,-1
RECMUS.txt,363723,365796,2073,20,N,N,-,-1,-1
RECMUS.txt,365797,368614,2817,20,N,N,-,-1,-1
RECMUS.txt,368615,372466,3851,20,Y,N,-,-1,-1
RECMUS.txt,372467,375313,2846,20,Y,N,-,-1,-1
RECMUS.txt,375314,378842,3528,20,N,N,-,-1,-1
RECMUS.txt,378843,382475,3632,20,N,N,-,-1,-1
RECMUS.txt,382476,385371,2895,20,N,N,-,-1,-1
RECMUS.txt,385372,387945,2573,20,N,Y,1429703438525,385609,386315
RECMUS.txt,387946,390920,2974,20,N,Y,1429703659582,387900,389542
RECMUS.txt,390921,393572,2651,20,N,N,-,-1,-1
RECMUS.txt,393573,396650,3077,20,N,N,-,-1,-1
RECMUS.txt,396651,399535,2884,20,N,N,-,-1,-1
RECMUS.txt,399536,402953,3417,20,Y,N,-,-1,-1
RECMUS.txt,402956,405912,2956,20,N,Y,1429958746761,405220,405568
RECMUS.txt,405913,408054,2141,20,N,N,-,-1,-1
RECMUS.txt,408055,410075,2020,20,N,Y,1430061110446,409752,410058
RECMUS.txt,410076,412019,1943,20,N,Y,1430062095918,410386,410666
RECMUS.txt,412020,414537,2517,20,N,N,-,-1,-1
RECMUS.txt,414538,417304,2766,20,N,N,-,-1,-1
RECMUS.txt,417305,419968,2663,20,Y,N,-,-1,-1
RECMUS.txt,419969,422648,2679,20,N,N,-,-1,-1
RECMUS.txt,422649,425608,2959,20,N,Y,1430132370365,422842,422953
RECMUS.txt,425609,428447,2838,20,N,N,-,-1,-1
RECMUS.txt,428448,430740,2292,20,N,N,-,-1,-1
RECMUS.txt,430741,433754,3013,20,N,N,-,-1,-1
RECMUS.txt,433755,437534,3779,20,Y,N,-,-1,-1
RECMUS.txt,437539,439610,2071,20,N,N,-,-1,-1
RECMUS.txt,439611,441888,2277,20,Y,N,-,-1,-1
RECMUS.txt,441889,444863,2974,20,Y,Y,1430143421055,444786,444985
RECMUS.txt,444864,448608,3744,20,Y,Y,1430143421055,444786,444985
RECMUS.txt,448611,451219,2608,20,N,N,-,-1,-1
RECMUS.txt,451220,454273,3053,20,Y,N,-,-1,-1
RECMUS.txt,454276,457046,2770,20,Y,N,-,-1,-1
RECMUS.txt,457047,460416,3369,20,N,N,-,-1,-1
RECMUS.txt,460417,461386,969,20,N,N,-,-1,-1
RECMUS.txt,461386,461818,432,20,N,N,-,-1,-1
RECMUS.txt,461818,464502,2684,20,Y,N,-,-1,-1
RECMUS.txt,464503,468046,3543,20,N,Y,1430146867800,465338,465502
RECMUS.txt,468046,471285,3239,20,N,N,-,-1,-1
RECMUS.txt,471286,473321,2035,20,N,N,-,-1,-1
RECMUS.txt,473322,476137,2815,20,N,N,-,-1,-1
RECMUS.txt,476138,478806,2668,20,N,N,-,-1,-1
RECMUS.txt,478807,480663,1856,20,N,N,-,-1,-1
RECMUS.txt,480664,483288,2624,20,Y,N,-,-1,-1
RECMUS.txt,483289,485659,2370,20,Y,N,-,-1,-1
RECMUS.txt,485660,487463,1803,20,N,N,-,-1,-1
RECMUS.txt,487464,489010,1546,20,N,N,-,-1,-1
RECMUS.txt,489011,490717,1706,20,N,N,-,-1,-1
RECMUS.txt,490718,492677,1959,20,N,N,-,-1,-1
RECMUS.txt,492678,495867,3189,20,N,N,-,-1,-1
RECMUS.txt,495868,498937,3069,20,N,N,-,-1,-1
RECMUS.txt,498938,501493,2555,20,N,N,-,-1,-1
RECMUS.txt,501494,504797,3303,20,Y,N,-,-1,-1
RECMUS.txt,504798,507291,2493,20,N,Y,1430222777118,506387,506555
RECMUS.txt,507292,510263,2971,20,N,N,-,-1,-1
RECMUS.txt,510264,513911,3647,20,N,N,-,-1,-1
RECMUS.txt,513912,516531,2619,20,N,N,-,-1,-1
RECMUS.txt,516532,519425,2893,20,N,Y,1430310307659,517170,517520
RECMUS.txt,519426,523079,3653,20,Y,Y,1430312272173,520626,520894
RECMUS.txt,523080,526346,3266,20,N,N,-,-1,-1
RECMUS.txt,526349,529595,3246,20,N,N,-,-1,-1
RECMUS.txt,529596,533057,3461,20,Y,N,-,-1,-1
RECMUS.txt,533058,537585,4527,20,N,Y,1430813590521,534892,535075
RECMUS.txt,537588,540703,3115,20,N,N,-,-1,-1
RECMUS.txt,540704,543859,3155,20,N,Y,1430814562699,541292,541683
RECMUS.txt,543860,545888,2028,20,Y,N,-,-1,-1
RECMUS.txt,545889,548425,2536,20,N,N,-,-1,-1
RECMUS.txt,548426,552296,3870,20,Y,N,-,-1,-1
RECMUS.txt,552297,555876,3579,20,N,N,-,-1,-1
RECMUS.txt,555878,559484,3606,20,Y,N,-,-1,-1
RECMUS.txt,559484,563589,4105,20,N,N,-,-1,-1
RECMUS.txt,563591,567268,3677,20,N,N,-,-1,-1
RECMUS.txt,567269,570529,3260,20,N,N,-,-1,-1
RECMUS.txt,570530,574150,3620,20,N,N,-,-1,-1
RECMUS.txt,574151,577430,3279,20,N,N,-,-1,-1
RECMUS.txt,577431,580668,3237,20,N,N,-,-1,-1
RECMUS.txt,580669,582920,2251,20,Y,Y,1430903585194,582416,582681
RECMUS.txt,582921,585108,2187,20,N,N,-,-1,-1
RECMUS.txt,585108,587325,2217,20,N,Y,1430906475487,585907,586013
RECMUS.txt,587326,590373,3047,20,N,N,-,-1,-1
RECMUS.txt,590376,593480,3104,20,N,N,-,-1,-1
RECMUS.txt,593481,596372,2891,20,N,Y,1430917862299,593970,594073
RECMUS.txt,596374,598905,2531,20,N,N,-,-1,-1
RECMUS.txt,598906,601509,2603,20,N,Y,1430919558858,600376,600634
RECMUS.txt,601510,604116,2606,20,N,Y,1430920461435,602905,603306
RECMUS.txt,604117,605965,1848,20,N,N,-,-1,-1
RECMUS.txt,605966,608391,2425,20,N,N,-,-1,-1
RECMUS.txt,608393,610349,1956,20,N,N,-,-1,-1
RECMUS.txt,610350,612166,1816,20,Y,Y,1431164339653,610804,611223
RECMUS.txt,612167,614104,1937,20,Y,N,-,-1,-1
RECMUS.txt,614105,616263,2158,20,N,N,-,-1,-1
RECMUS.txt,616264,617473,1209,20,Y,N,-,-1,-1
RECMUS.txt,617476,620016,2540,20,N,N,-,-1,-1
RECMUS.txt,620019,623516,3497,20,N,N,-,-1,-1
RECMUS.txt,623521,625944,2423,20,Y,N,-,-1,-1
RECMUS.txt,625945,629428,3483,20,N,N,-,-1,-1
RECMUS.txt,629429,632678,3249,20,N,N,-,-1,-1
RECMUS.txt,632679,636048,3369,20,N,N,-,-1,-1
RECMUS.txt,636049,638918,2869,20,N,N,-,-1,-1
RECMUS.txt,638919,641602,2683,20,N,Y,1431361104528,639924,640273
RECMUS.txt,641603,643802,2199,20,Y,N,-,-1,-1
RECMUS.txt,643803,646305,2502,20,N,N,-,-1,-1
RECMUS.txt,646306,649818,3512,20,Y,N,-,-1,-1
RECMUS.txt,649819,653693,3874,20,Y,N,-,-1,-1
RECMUS.txt,653694,656571,2877,20,Y,N,-,-1,-1
RECMUS.txt,656571,659136,2565,20,N,N,-,-1,-1
RECMUS.txt,659137,661727,2590,20,Y,N,-,-1,-1
RECMUS.txt,661732,665009,3277,20,Y,N,-,-1,-1
RECMUS.txt,665014,667790,2776,20,N,Y,1431440815809,666612,666881
RECMUS.txt,667793,670515,2722,20,N,Y,1431445668256,668943,669143
RECMUS.txt,670515,673390,2875,20,N,N,-,-1,-1
RECMUS.txt,673391,675396,2005,20,N,N,-,-1,-1
RECMUS.txt,675397,677663,2266,20,N,N,-,-1,-1
RECMUS.txt,677666,680120,2454,20,N,N,-,-1,-1
RECMUS.txt,680121,682685,2564,20,Y,Y,1431506517034,680207,680323
RECMUS.txt,682688,685304,2616,20,N,Y,1431508066369,685259,685876
RECMUS.txt,685305,687764,2459,20,N,Y,1431508066369,685259,685876
RECMUS.txt,687766,689690,1924,20,Y,N,-,-1,-1
RECMUS.txt,689693,691948,2255,20,N,Y,1431520391464,690129,690293
RECMUS.txt,691949,694907,2958,20,Y,N,-,-1,-1
RECMUS.txt,694908,698028,3120,20,N,N,-,-1,-1
RECMUS.txt,698029,700909,2880,20,N,Y,1431686580301,699502,699758
RECMUS.txt,700910,704651,3741,20,Y,N,-,-1,-1
RECMUS.txt,704652,706328,1676,20,N,Y,1431687599525,705104,705244
RECMUS.txt,706329,708286,1957,20,N,N,-,-1,-1
RECMUS.txt,708287,711074,2787,20,N,N,-,-1,-1
RECMUS.txt,711079,714201,3122,20,N,N,-,-1,-1
RECMUS.txt,714202,717928,3726,20,N,N,-,-1,-1
RECMUS.txt,717929,720636,2707,20,N,N,-,-1,-1
RECMUS.txt,720637,723836,3199,20,N,N,-,-1,-1
RECMUS.txt,723837,727242,3405,20,N,Y,1431697022699,725354,725864
RECMUS.txt,727243,730504,3261,20,N,Y,1431697584022,729902,730181
RECMUS.txt,730507,732278,1771,20,N,N,-,-1,-1
RECMUS.txt,732280,734897,2617,20,N,Y,1431790026329,733306,733503
RECMUS.txt,734898,737441,2543,20,N,Y,1431791455244,736369,736531
RECMUS.txt,737443,740432,2989,20,N,N,-,-1,-1
RECMUS.txt,740434,743472,3038,20,N,Y,1431941266117,742610,743297
RECMUS.txt,743474,746009,2535,20,N,Y,1431941771447,744892,745049
RECMUS.txt,746010,749038,3028,20,N,N,-,-1,-1
RECMUS.txt,749039,752027,2988,20,N,Y,1431943173931,749552,750043
RECMUS.txt,752028,754575,2547,20,N,N,-,-1,-1
RECMUS.txt,754576,756820,2244,20,N,N,-,-1,-1
RECMUS.txt,756821,758719,1898,20,N,N,-,-1,-1
RECMUS.txt,758720,761842,3122,20,N,N,-,-1,-1
RECMUS.txt,761843,764567,2724,20,N,Y,1431950693551,763304,763649
RECMUS.txt,764570,766125,1555,20,N,N,-,-1,-1
RECMUS.txt,766126,768613,2487,20,N,N,-,-1,-1
RECMUS.txt,768614,771664,3050,20,Y,N,-,-1,-1
RECMUS.txt,771667,774827,3160,20,N,N,-,-1,-1
RECMUS.txt,774828,777923,3095,20,N,Y,1431952551670,775158,775489
RECMUS.txt,777924,780626,2702,20,N,N,-,-1,-1
RECMUS.txt,780631,783714,3083,20,N,Y,1431953940995,782482,782580
RECMUS.txt,783717,786321,2604,20,N,N,-,-1,-1
RECMUS.txt,786322,789299,2977,20,N,N,-,-1,-1
RECMUS.txt,789300,791895,2595,20,Y,Y,1432024843245,791416,792120
RECMUS.txt,791896,794670,2774,20,N,Y,1432024843245,791416,792120
RECMUS.txt,794673,797726,3053,20,N,Y,1432028613565,796637,797464
RECMUS.txt,797729,801222,3493,20,Y,N,-,-1,-1
RECMUS.txt,801225,804112,2887,20,Y,N,-,-1,-1
RECMUS.txt,804113,807303,3190,20,N,N,-,-1,-1
RECMUS.txt,807304,810155,2851,20,N,N,-,-1,-1
RECMUS.txt,810156,813632,3476,20,Y,Y,1432129974051,812469,812989
RECMUS.txt,813633,816951,3318,20,N,N,-,-1,-1
RECMUS.txt,816952,819708,2756,20,Y,N,-,-1,-1
RECMUS.txt,819713,822449,2736,20,N,N,-,-1,-1
RECMUS.txt,822450,825524,3074,20,N,N,-,-1,-1
RECMUS.txt,825526,827657,2131,20,N,N,-,-1,-1
RECMUS.txt,827657,830313,2656,20,N,Y,1432288594537,828067,828512
RECMUS.txt,830315,833123,2808,20,Y,Y,1432289841006,830618,830976
RECMUS.txt,833124,836421,3297,20,Y,N,-,-1,-1
RECMUS.txt,836424,839937,3513,20,Y,Y,1432374854992,839856,840598
RECMUS.txt,839938,841595,1657,20,N,Y,1432374854992,839856,840598
RECMUS.txt,841596,845592,3996,20,Y,Y,1432375899241,842288,842780
RECMUS.txt,845593,847617,2024,20,Y,N,-,-1,-1
RECMUS.txt,847618,850900,3282,20,N,N,-,-1,-1
RECMUS.txt,850905,854361,3456,20,Y,N,-,-1,-1
RECMUS.txt,854364,856872,2508,20,N,N,-,-1,-1
RECMUS.txt,856873,860173,3300,20,N,N,-,-1,-1
RECMUS.txt,860174,863576,3402,20,N,N,-,-1,-1
RECMUS.txt,863577,866880,3303,20,Y,Y,1432468347198,866650,866878
RECMUS.txt,866883,869438,2555,20,Y,N,-,-1,-1
RECMUS.txt,869439,871658,2219,20,N,N,-,-1,-1
RECMUS.txt,871660,874254,2594,20,Y,Y,1432486376679,873579,873808
RECMUS.txt,874255,877219,2964,20,Y,Y,1432487662435,875600,875831
RECMUS.txt,877220,880090,2870,20,N,N,-,-1,-1
RECMUS.txt,880091,882800,2709,20,Y,N,-,-1,-1
RECMUS.txt,882802,885606,2804,20,N,N,-,-1,-1
RECMUS.txt,885611,886887,1276,20,N,N,-,-1,-1
RECMUS.txt,886890,889734,2844,20,N,Y,1432546852411,887723,888158
RECMUS.txt,889735,892258,2523,20,N,N,-,-1,-1
RECMUS.txt,892259,895573,3314,20,N,N,-,-1,-1
RECMUS.txt,895574,899380,3806,20,Y,N,-,-1,-1
RECMUS.txt,899381,901824,2443,20,N,N,-,-1,-1
RECMUS.txt,901825,904639,2814,20,Y,N,-,-1,-1
RECMUS.txt,904640,907931,3291,20,Y,N,-,-1,-1
RECMUS.txt,907934,911527,3593,20,Y,N,-,-1,-1
RECMUS.txt,911528,915802,4274,20,Y,Y,1432552116295,913989,914217
RECMUS.txt,915804,919386,3582,20,Y,N,-,-1,-1
RECMUS.txt,919387,923294,3907,20,N,N,-,-1,-1
RECMUS.txt,923295,927183,3888,20,Y,Y,1432554740755,925747,926238
RECMUS.txt,927184,930224,3040,20,Y,N,-,-1,-1
RECMUS.txt,930225,932295,2070,20,Y,N,-,-1,-1
RECMUS.txt,932300,934773,2473,20,N,N,-,-1,-1
RECMUS.txt,934776,935243,467,20,N,N,-,-1,-1
RECMUS.txt,935245,935774,529,20,N,N,-,-1,-1
RECMUS.txt,935775,936285,510,20,N,N,-,-1,-1
RECMUS.txt,936286,936453,167,20,N,N,-,-1,-1
RECMUS.txt,936457,936874,417,20,N,N,-,-1,-1
RECMUS.txt,936875,937394,519,20,N,N,-,-1,-1
RECMUS.txt,937395,938045,650,20,N,N,-,-1,-1
RECMUS.txt,938046,938657,611,20,N,N,-,-1,-1
RECMUS.txt,938659,939401,742,20,N,N,-,-1,-1
RECMUS.txt,939402,940065,663,20,N,N,-,-1,-1
RECMUS.txt,940066,940779,713,20,N,N,-,-1,-1
RECMUS.txt,940780,941253,473,20,N,N,-,-1,-1
RECMUS.txt,941257,941410,153,20,N,N,-,-1,-1
RECMUS.txt,941414,941686,272,20,N,N,-,-1,-1
RECMUS.txt,941687,942248,561,20,N,N,-,-1,-1
RECMUS.txt,942249,942651,402,20,N,N,-,-1,-1
RECMUS.txt,942652,943122,470,20,N,N,-,-1,-1
RECMUS.txt,943125,943604,479,20,N,N,-,-1,-1
RECMUS.txt,943605,944069,464,20,N,N,-,-1,-1
RECMUS.txt,944070,944822,752,20,N,N,-,-1,-1
RECMUS.txt,944823,945251,428,20,N,N,-,-1,-1
RECMUS.txt,945254,946084,830,20,N,N,-,-1,-1
RECMUS.txt,946085,946535,450,20,N,N,-,-1,-1
RECMUS.txt,946536,947127,591,20,N,N,-,-1,-1
RECMUS.txt,947128,947699,571,20,N,N,-,-1,-1
RECMUS.txt,947700,948212,512,20,N,N,-,-1,-1
RECMUS.txt,948215,948664,449,20,N,N,-,-1,-1
RECMUS.txt,948665,949183,518,20,N,N,-,-1,-1
RECMUS.txt,949184,949608,424,20,N,N,-,-1,-1
RECMUS.txt,949609,950204,595,20,N,N,-,-1,-1
RECMUS.txt,950207,950861,654,20,N,N,-,-1,-1
RECMUS.txt,950862,951402,540,20,N,N,-,-1,-1
RECMUS.txt,951405,951906,501,20,N,N,-,-1,-1
RECMUS.txt,951907,952351,444,20,N,N,-,-1,-1
RECMUS.txt,952352,952870,518,20,N,N,-,-1,-1
RECMUS.txt,952873,953334,461,20,N,N,-,-1,-1
RECMUS.txt,953335,953829,494,20,N,N,-,-1,-1
RECMUS.txt,953831,954226,395,20,N,N,-,-1,-1
RECMUS.txt,954228,954671,443,20,N,N,-,-1,-1
RECMUS.txt,954673,955092,419,20,N,N,-,-1,-1
RECMUS.txt,955095,955629,534,20,N,N,-,-1,-1
RECMUS.txt,955632,956187,555,20,N,N,-,-1,-1
RECMUS.txt,956189,956713,524,20,N,N,-,-1,-1
RECMUS.txt,956716,957178,462,20,N,N,-,-1,-1
RECMUS.txt,957179,957613,434,20,N,N,-,-1,-1
RECMUS.txt,957615,958099,484,20,N,N,-,-1,-1
RECMUS.txt,958101,958530,429,20,N,N,-,-1,-1
RECMUS.txt,958532,958999,467,20,N,N,-,-1,-1
RECMUS.txt,959002,959468,466,20,N,N,-,-1,-1
RECMUS.txt,959470,959887,417,20,N,N,-,-1,-1
RECMUS.txt,959889,960297,408,20,N,N,-,-1,-1
RECMUS.txt,960299,960697,398,20,N,N,-,-1,-1
RECMUS.txt,960699,961132,433,20,N,N,-,-1,-1
RECMUS.txt,961134,961779,645,20,N,N,-,-1,-1
RECMUS.txt,961780,962246,466,20,N,N,-,-1,-1
RECMUS.txt,962249,962716,467,20,N,N,-,-1,-1
RECMUS.txt,962719,963185,466,20,N,N,-,-1,-1
RECMUS.txt,963188,963565,377,20,N,N,-,-1,-1
RECMUS.txt,963567,963969,402,20,N,N,-,-1,-1
RECMUS.txt,963972,964431,459,20,N,N,-,-1,-1
RECMUS.txt,964434,964913,479,20,N,N,-,-1,-1
RECMUS.txt,964915,965330,415,20,N,N,-,-1,-1
RECMUS.txt,965332,965859,527,20,N,N,-,-1,-1
RECMUS.txt,965864,966348,484,20,N,N,-,-1,-1
RECMUS.txt,966350,966818,468,20,N,N,-,-1,-1
RECMUS.txt,966820,967276,456,20,N,N,-,-1,-1
RECMUS.txt,967281,967714,433,20,N,N,-,-1,-1
RECOLL.txt,0,2793,2793,20,N,N,-,-1,-1
RECOLL.txt,2794,5446,2652,20,N,N,-,-1,-1
RECOLL.txt,5449,9517,4068,20,N,N,-,-1,-1
RECOLL.txt,9518,15432,5914,20,N,N,-,-1,-1
RECOLL.txt,15434,18430,2996,20,N,Y,1448997318962,17781,18305
RECOLL.txt,18431,21357,2926,20,N,N,-,-1,-1
RECOLL.txt,21358,24416,3058,20,N,N,-,-1,-1
RECOLL.txt,24419,27967,3548,20,N,N,-,-1,-1
RECOLL.txt,27968,30151,2183,20,N,N,-,-1,-1
RECOLL.txt,30152,32080,1928,20,Y,Y,1449564497346,31421,33114
RECOLL.txt,32081,35045,2964,20,Y,Y,1449564002703,34459,35028
RECOLL.txt,35048,38229,3181,20,N,Y,1449564936771,35046,35717
RECOLL.txt,38231,40906,2675,20,Y,Y,1449565481530,39801,40627
RECOLL.txt,40908,43276,2368,20,N,N,-,-1,-1
RECOLL.txt,43277,45225,1948,20,N,N,-,-1,-1
RECOLL.txt,45226,48216,2990,20,Y,Y,1449566012674,47822,49423
RECOLL.txt,48217,50623,2406,20,N,Y,1449566012674,47822,49423
RECOLL.txt,50624,53697,3073,20,Y,Y,1449566376755,51356,52539
RECOLL.txt,53702,56476,2774,20,N,Y,1449566781717,52623,55207
RECOLL.txt,56477,59273,2796,20,N,Y,1449567312089,57825,59193
RECOLL.txt,59274,61681,2407,20,N,N,-,-1,-1
RECOLL.txt,61684,64847,3163,20,N,Y,1449604006516,63836,64388
RECOLL.txt,64848,66690,1842,20,Y,Y,1449604885298,64679,65628
RECOLL.txt,66693,68701,2008,20,Y,Y,1449605311607,66740,67367
RECOLL.txt,68702,71020,2318,20,Y,Y,1449605831232,69255,71638
RECOLL.txt,71021,72488,1467,20,Y,Y,1449606203855,71875,72052
RECOLL.txt,72489,73189,700,20,N,N,-,-1,-1
RECOLL.txt,73190,75493,2303,20,N,Y,1449606753172,75354,75839
RECOLL.txt,75494,77973,2479,20,Y,Y,1449606753172,75354,75839
RECOLL.txt,77975,80859,2884,20,N,N,-,-1,-1
RECOLL.txt,80861,83661,2800,20,Y,Y,1450194336026,81036,82029
RECOLL.txt,83662,85940,2278,20,Y,Y,1450194991609,83440,83936
RECOLL.txt,85941,89069,3128,20,Y,Y,1450195763304,85744,87933
RECOLL.txt,89070,90972,1902,20,Y,Y,1450196241886,89386,90252
RECOLL.txt,90973,91305,332,20,N,N,-,-1,-1
RECOLL.txt,91306,93684,2378,20,Y,Y,1450196550118,92044,92813
RECOLL.txt,93689,96686,2997,20,N,N,-,-1,-1
RECOLL.txt,96687,99383,2696,20,N,Y,1450197272502,97289,98405
RECOLL.txt,99384,102440,3056,20,Y,Y,1450198228374,101899,104222
RECOLL.txt,102441,105525,3084,20,Y,Y,1450198228374,101899,104222
RECOLL.txt,105526,107766,2240,20,Y,Y,1450198899921,107006,107437
RECOLL.txt,107769,110152,2383,20,Y,Y,1450209381136,108935,109356
RECOLL.txt,110153,113168,3015,20,Y,Y,1450210289855,109766,110720
RECOLL.txt,113169,116562,3393,20,Y,Y,1450211094623,115807,116651
RECOLL.txt,116563,119146,2583,20,Y,Y,1450212524850,116654,117006
RECOLL.txt,119147,121327,2180,20,N,Y,1450213154792,119938,120294
RECOLL.txt,121328,123744,2416,20,N,Y,1450214856877,122255,122760
RECOLL.txt,123747,124710,963,20,N,N,-,-1,-1
RECOLL.txt,124711,127300,2589,20,N,Y,1450215357428,125505,126500
RECOLL.txt,127303,130166,2863,20,N,Y,1450215778344,128744,129064
RECOLL.txt,130167,133429,3262,20,N,Y,1450217142535,132155,132920
RECOLL.txt,133432,136221,2789,20,Y,N,-,-1,-1
RECOLL.txt,136222,138869,2647,20,Y,Y,1450265940821,137499,138662
RECOLL.txt,138872,141258,2386,20,Y,N,-,-1,-1
RECOLL.txt,141261,143409,2148,20,N,N,-,-1,-1
RECOLL.txt,143410,146494,3084,20,N,N,-,-1,-1
RECOLL.txt,146495,148848,2353,20,N,N,-,-1,-1
RECOLL.txt,148851,151340,2489,20,N,Y,1450266255219,149476,150064
RECOLL.txt,151341,154217,2876,20,N,N,-,-1,-1
RECOLL.txt,154218,156945,2727,20,N,Y,1450266659853,155779,156351
RECOLL.txt,156946,159566,2620,20,Y,Y,1450267181437,158411,159424
RECOLL.txt,159567,162425,2858,20,Y,Y,1450267451569,160340,162732
RECOLL.txt,162426,165379,2953,20,N,Y,1450268185046,162966,163418
RECOLL.txt,165380,168016,2636,20,N,N,-,-1,-1
RECOLL.txt,168019,170646,2627,20,N,Y,1450268978542,169359,170509
RECOLL.txt,170649,173058,2409,20,N,N,-,-1,-1
RECOLL.txt,173061,176075,3014,20,Y,Y,1450269524213,175141,176459
RECOLL.txt,176076,179171,3095,20,N,Y,1450272604542,176533,177646
RECOLL.txt,179172,180923,1751,20,Y,Y,1450273026631,178707,180918
RECOLL.txt,180926,183665,2739,20,N,Y,1450273354749,181694,182351
RECOLL.txt,183668,186278,2610,20,Y,Y,1450273729052,184450,185295
RECOLL.txt,186279,188628,2349,20,N,N,-,-1,-1
RECOLL.txt,188629,191253,2624,20,N,Y,1450274247305,190587,191139
RECOLL.txt,191256,194177,2921,20,N,Y,1450274641828,192265,194302
RECOLL.txt,194178,195992,1814,20,N,Y,1450274641828,192265,194302
RECOLL.txt,195993,198682,2689,20,N,Y,1450276878994,198569,198873
RECOLL.txt,198683,201106,2423,20,N,Y,1450276878994,198569,198873
RECOLL.txt,201107,203529,2422,20,N,Y,1450278260874,201966,203744
RECOLL.txt,203530,205969,2439,20,N,Y,1450278260874,201966,203744
RECOLL.txt,205972,208577,2605,20,N,Y,1450278992417,207433,208043
RECOLL.txt,208582,210600,2018,20,N,N,-,-1,-1
RECOLL.txt,210603,212934,2331,20,Y,N,-,-1,-1
RECOLL.txt,212935,216275,3340,20,N,N,-,-1,-1
RECOLL.txt,216277,219510,3233,20,N,Y,1450279453888,217252,218068
RECOLL.txt,219511,223226,3715,20,N,Y,1450279955242,219797,222549
RECOLL.txt,223229,224835,1606,20,N,N,-,-1,-1
RECOLL.txt,224838,227190,2352,20,N,N,-,-1,-1
RECOLL.txt,227191,229898,2707,20,N,N,-,-1,-1
RECOLL.txt,229899,232655,2756,20,N,N,-,-1,-1
RECOLL.txt,232656,235952,3296,20,N,N,-,-1,-1
RECOLL.txt,235953,238667,2714,20,Y,N,-,-1,-1
RECOLL.txt,238669,241569,2900,20,N,Y,1450280673034,241380,241838
RECOLL.txt,241570,244846,3276,20,Y,Y,1450280673034,241380,241838
RECOLL.txt,244847,246876,2029,20,N,Y,1450281212744,242862,245207
RECOLL.txt,246877,247389,512,20,Y,N,-,-1,-1
RECOLL.txt,247392,248982,1590,20,N,Y,1450281669613,248365,249575
RECOLL.txt,248983,251677,2694,20,Y,Y,1450281669613,248365,249575
RECOLL.txt,251680,255113,3433,20,N,Y,1450282101282,251678,252272
RECOLL.txt,255114,258034,2920,20,Y,Y,1449243316327,255345,255936
RECOLL.txt,258035,260201,2166,20,Y,Y,1449477805345,258325,259491
RECOLL.txt,260202,263349,3147,20,N,N,-,-1,-1
RECOLL.txt,263351,265662,2311,20,N,Y,1449478274965,265280,265790
RECOLL.txt,265663,267802,2139,20,N,Y,1449478274965,265280,265790
RECOLL.txt,267803,270585,2782,20,N,N,-,-1,-1
RECOLL.txt,270586,273199,2613,20,N,Y,1449478691795,272071,273405
RECOLL.txt,273200,276815,3615,20,N,Y,1449478691795,272071,273405
RECOLL.txt,276816,280688,3872,20,N,Y,1449478940431,277862,278041
RECOLL.txt,280691,283754,3063,20,N,N,-,-1,-1
RECOLL.txt,283756,285785,2029,20,N,N,-,-1,-1
RECOLL.txt,285786,288666,2880,20,N,Y,1449479515559,287879,288347
RECOLL.txt,288669,290698,2029,20,N,Y,1449479980197,289681,290130
RECOLL.txt,290703,293247,2544,20,N,N,-,-1,-1
RECOLL.txt,293248,295705,2457,20,N,Y,1449480291305,294170,295182
RECOLL.txt,295706,297775,2069,20,N,Y,1449480881121,297386,298052
RECOLL.txt,297776,300134,2358,20,N,Y,1449480881121,297386,298052
RECOLL.txt,300135,303020,2885,20,N,Y,1450284116337,300339,301692
RECOLL.txt,303021,305548,2527,20,N,N,-,-1,-1
RECOLL.txt,305551,308232,2681,20,N,Y,1450350186677,307230,309481
RECOLL.txt,308233,310728,2495,20,Y,Y,1450350186677,307230,309481
RECOLL.txt,310729,313198,2469,20,N,Y,1450350675404,309528,311486
RECOLL.txt,313199,315904,2705,20,N,N,-,-1,-1
RECOLL.txt,315905,318353,2448,20,N,Y,1450350993349,315954,316737
RECOLL.txt,318354,321780,3426,20,N,Y,1450351323826,319770,320896
RECOLL.txt,321781,324770,2989,20,Y,N,-,-1,-1
RECOLL.txt,324771,327869,3098,20,N,N,-,-1,-1
RECOLL.txt,327869,331908,4039,20,N,N,-,-1,-1
RECOLL.txt,331909,334451,2542,20,N,N,-,-1,-1
RECOLL.txt,334454,337654,3200,20,Y,N,-,-1,-1
REMKEL1.txt,3,1808,1805,20,N,N,-,-1,-1
REMKEL1.txt,1809,2579,770,20,N,N,-,-1,-1
REMKEL1.txt,2582,3682,1100,20,N,N,-,-1,-1
REMKEL1.txt,3683,4532,849,20,N,N,-,-1,-1
REMKEL1.txt,4533,5241,708,20,N,N,-,-1,-1
REMKEL1.txt,5242,6128,886,20,N,N,-,-1,-1
REMKEL1.txt,6131,6943,812,20,N,N,-,-1,-1
REMKEL1.txt,6944,7836,892,20,N,N,-,-1,-1
REMKEL1.txt,7837,8523,686,20,N,N,-,-1,-1
REMKEL1.txt,8525,9502,977,20,N,N,-,-1,-1
REMKEL1.txt,9503,10537,1034,20,N,N,-,-1,-1
REMKEL1.txt,10540,11629,1089,20,N,N,-,-1,-1
REMKEL1.txt,11630,12605,975,20,N,N,-,-1,-1
REMKEL1.txt,12606,13293,687,20,N,N,-,-1,-1
REMKEL1.txt,13295,14043,748,20,N,N,-,-1,-1
REMKEL1.txt,14044,15026,982,20,N,N,-,-1,-1
REMKEL1.txt,15028,15883,855,20,N,N,-,-1,-1
REMKEL1.txt,15884,16620,736,20,N,N,-,-1,-1
REMKEL1.txt,16623,19835,3212,20,N,N,-,-1,-1
REMKEL1.txt,19836,22648,2812,20,N,N,-,-1,-1
REMKEL1.txt,22651,27036,4385,20,N,N,-,-1,-1
REMKEL1.txt,27037,29837,2800,20,N,N,-,-1,-1
REMKEL1.txt,29840,33699,3859,20,Y,N,-,-1,-1
REMKEL1.txt,33700,37436,3736,20,N,N,-,-1,-1
REMKEL1.txt,37439,40326,2887,20,N,N,-,-1,-1
REMKEL1.txt,40327,42440,2113,20,N,N,-,-1,-1
REMKEL1.txt,42443,45084,2641,20,N,N,-,-1,-1
REMKEL1.txt,45085,47498,2413,20,N,N,-,-1,-1
REMKEL1.txt,47501,51802,4301,20,N,Y,1427373119628,50476,51323
REMKEL1.txt,51805,55260,3455,20,N,Y,1427373691557,54475,55337
REMKEL1.txt,55261,58193,2932,20,Y,Y,1427373691557,54475,55337
REMKEL1.txt,58196,61666,3470,20,N,N,-,-1,-1
REMKEL1.txt,61667,64746,3079,20,N,N,-,-1,-1
REMKEL1.txt,64747,67976,3229,20,N,N,-,-1,-1
REMKEL1.txt,67977,71360,3383,20,N,N,-,-1,-1
REMKEL1.txt,71361,74510,3149,20,N,Y,1427375995210,73781,74572
REMKEL1.txt,74511,77688,3177,20,N,Y,1427376630476,75869,76825
REMKEL1.txt,77689,80760,3071,20,N,Y,1427377322048,80447,80948
REMKEL1.txt,80763,83002,2239,20,N,Y,1427377322048,80447,80948
REMKEL1.txt,83003,84696,1693,20,N,Y,1427459918395,84645,85149
REMKEL1.txt,84697,87235,2538,20,N,Y,1427459918395,84645,85149
REMKEL1.txt,87236,91558,4322,20,N,N,-,-1,-1
REMKEL1.txt,91561,93900,2339,20,N,N,-,-1,-1
REMKEL1.txt,93901,96790,2889,20,N,N,-,-1,-1
REMKEL1.txt,96791,100220,3429,20,N,Y,1427462513930,98050,98577
REMKEL1.txt,100221,103709,3488,20,N,Y,1428065655005,103366,109009
REMKEL1.txt,103710,107038,3328,20,N,Y,1428065655005,103366,109009
REMKEL1.txt,107041,110719,3678,20,N,Y,1428065655005,103366,109009
REMKEL1.txt,110720,113589,2869,20,N,N,-,-1,-1
REMKEL1.txt,113590,116704,3114,20,N,Y,1428139555093,114267,115295
REMKEL1.txt,116705,119677,2972,20,N,Y,1428140980187,119629,120812
REMKEL1.txt,119678,121486,1808,20,N,Y,1428140980187,119629,120812
REMKEL1.txt,121487,124527,3040,20,N,N,-,-1,-1
REMKEL1.txt,124530,128061,3531,20,N,Y,1428142329788,124908,125971
REMKEL1.txt,128062,130846,2784,20,N,N,-,-1,-1
REMKEL1.txt,130847,134682,3835,20,N,N,-,-1,-1
REMKEL1.txt,134685,137732,3047,20,N,N,-,-1,-1
REMKEL1.txt,137733,140688,2955,20,N,N,-,-1,-1
REMKEL1.txt,140689,144247,3558,20,N,Y,1428143866274,142277,143444
REMKEL1.txt,144250,147160,2910,20,N,N,-,-1,-1
REMKEL1.txt,147161,150052,2891,20,N,N,-,-1,-1
REMKEL1.txt,150053,153159,3106,20,N,Y,1428145340599,152563,152962
REMKEL1.txt,153161,155518,2357,20,N,N,-,-1,-1
REMKEL1.txt,155519,158644,3125,20,N,N,-,-1,-1
REMKEL1.txt,158645,161902,3257,20,N,N,-,-1,-1
REMKEL1.txt,161903,164962,3059,20,N,Y,1428156251387,163375,165208
REMKEL1.txt,164963,167759,2796,20,N,Y,1428164866689,166001,167438
REMKEL1.txt,167761,170840,3079,20,N,Y,1428166121742,169838,170346
REMKEL1.txt,170842,173922,3080,20,N,Y,1428167038498,170602,172231
REMKEL1.txt,173923,177299,3376,20,N,N,-,-1,-1
REMKEL1.txt,177300,179787,2487,20,N,N,-,-1,-1
REMKEL1.txt,179788,182333,2545,20,N,N,-,-1,-1
REMKEL1.txt,182334,185788,3454,20,N,N,-,-1,-1
REMKEL1.txt,185790,188191,2401,20,N,Y,1429179224952,186363,187163
REMKEL1.txt,188192,191178,2986,20,N,N,-,-1,-1
REMKEL1.txt,191179,193894,2715,20,Y,Y,1429180740975,192464,193718
REMKEL1.txt,193895,197838,3943,20,N,N,-,-1,-1
REMKEL1.txt,197839,201329,3490,20,N,N,-,-1,-1
REMKEL1.txt,201332,204769,3437,20,N,N,-,-1,-1
REMKEL1.txt,204770,208760,3990,20,N,Y,1429183348411,208524,209310
REMKEL1.txt,208761,211791,3030,20,N,Y,1429183348411,208524,209310
REMKEL1.txt,211794,214932,3138,20,N,Y,1429184555165,213619,214284
REMKEL1.txt,214933,217875,2942,20,N,N,-,-1,-1
REMKEL1.txt,217876,220774,2898,20,N,N,-,-1,-1
REMKEL1.txt,220775,223360,2585,20,N,Y,1429478561003,223319,224140
REMKEL1.txt,223362,226110,2748,20,N,Y,1429478561003,223319,224140
REMKEL1.txt,226111,228233,2122,20,N,N,-,-1,-1
REMKEL1.txt,228236,233659,5423,20,N,N,-,-1,-1
REMKEL1.txt,233662,237428,3766,20,N,N,-,-1,-1
REMKEL1.txt,237430,241208,3778,20,N,N,-,-1,-1
REMKEL1.txt,241209,244494,3285,20,Y,Y,1429702947558,242053,243400
REMKEL1.txt,244495,248579,4084,20,N,Y,1429703626688,244429,245446
REMKEL1.txt,248582,253133,4551,20,N,N,-,-1,-1
REMKEL1.txt,253134,257068,3934,20,N,Y,1430585951765,253480,254126
REMKEL1.txt,257069,261777,4708,20,N,Y,1430588560920,259596,260149
REMKEL1.txt,261778,265125,3347,20,N,N,-,-1,-1
REMKEL1.txt,265126,268854,3728,20,N,N,-,-1,-1
REMKEL1.txt,268855,271739,2884,20,N,N,-,-1,-1
REMKEL1.txt,271742,275513,3771,20,N,N,-,-1,-1
REMKEL1.txt,275514,280661,5147,20,N,Y,1430593986926,275535,275764
REMKEL1.txt,280662,284255,3593,20,N,Y,1430594989217,280917,281849
REMKEL1.txt,284258,287287,3029,20,N,N,-,-1,-1
REMKEL1.txt,287288,289962,2674,20,N,N,-,-1,-1
REMKEL1.txt,289963,292880,2917,20,N,N,-,-1,-1
REMKEL1.txt,292883,295674,2791,20,N,N,-,-1,-1
REMKEL1.txt,295675,298978,3303,20,N,N,-,-1,-1
REMKEL1.txt,298979,302068,3089,20,N,N,-,-1,-1
REMKEL1.txt,302069,305823,3754,20,N,N,-,-1,-1
REMKEL1.txt,305824,309656,3832,20,N,N,-,-1,-1
REMKEL1.txt,309658,312720,3062,20,N,N,-,-1,-1
REMKEL1.txt,312721,315819,3098,20,N,N,-,-1,-1
REMKEL1.txt,315824,318982,3158,20,N,N,-,-1,-1
REMKEL1.txt,318983,322120,3137,20,N,Y,1430747238328,321121,323743
REMKEL1.txt,322121,324295,2174,20,N,Y,1430747238328,321121,323743
REMKEL1.txt,324298,326695,2397,20,N,Y,1430749600786,325904,327946
REMKEL1.txt,326696,329304,2608,20,N,Y,1430749600786,325904,327946
REMKEL1.txt,329306,332258,2952,20,Y,Y,1430751146450,332109,333778
REMKEL1.txt,332263,335952,3689,20,N,Y,1430751146450,332109,333778
REMKEL1.txt,335953,339880,3927,20,N,N,-,-1,-1
REMKEL1.txt,339881,344045,4164,20,N,Y,1430753605807,341769,342306
REMKEL1.txt,344046,346878,2832,20,N,N,-,-1,-1
REMKEL1.txt,346879,349506,2627,20,N,Y,1430927911131,348654,350235
REMKEL1.txt,349507,352654,3147,20,N,Y,1430927911131,348654,350235
REMKEL1.txt,352654,355350,2696,20,N,N,-,-1,-1
REMKEL1.txt,355353,357815,2462,20,N,N,-,-1,-1
REMKEL1.txt,357818,360636,2818,20,N,N,-,-1,-1
REMKEL1.txt,360639,364062,3423,20,N,Y,1431600860056,363201,364042
REMKEL1.txt,364065,367206,3141,20,N,N,-,-1,-1
REMKEL1.txt,367211,370403,3192,20,Y,Y,1431602703832,369125,369571
REMKEL1.txt,370404,373335,2931,20,N,N,-,-1,-1
REMKEL1.txt,373336,375892,2556,20,N,N,-,-1,-1
REMKEL1.txt,375893,379912,4019,20,N,N,-,-1,-1
REMKEL1.txt,379913,382530,2617,20,N,N,-,-1,-1
REMKEL1.txt,382531,384746,2215,20,N,N,-,-1,-1
REMKEL1.txt,384749,387121,2372,20,N,N,-,-1,-1
REMKEL1.txt,387122,390316,3194,20,N,N,-,-1,-1
REMKEL1.txt,390317,393687,3370,20,N,N,-,-1,-1
REMKEL1.txt,393690,396981,3291,20,N,N,-,-1,-1
REMKEL1.txt,396982,400895,3913,20,N,Y,1431611462110,399892,400362
REMKEL1.txt,400896,404368,3472,20,N,N,-,-1,-1
REMKEL1.txt,404369,408911,4542,20,N,Y,1431613303057,404779,405342
REMKEL1.txt,408913,413784,4871,20,Y,Y,1431615187175,412407,415852
REMKEL1.txt,413785,416954,3169,20,N,Y,1431615187175,412407,415852
REMKEL1.txt,416957,421465,4508,20,N,N,-,-1,-1
REMKEL1.txt,421466,424302,2836,20,N,Y,1432056176787,423095,424004
REMKEL1.txt,424303,428166,3863,20,N,N,-,-1,-1
REMKEL1.txt,428171,430901,2730,20,N,Y,1432060885983,429653,430653
REMKEL1.txt,430902,434688,3786,20,N,Y,1432137873706,431575,434541
REMKEL1.txt,434689,439068,4379,20,N,Y,1432138360719,435276,437675
REMKEL1.txt,439070,441318,2248,20,N,Y,1432138782679,440486,440948
REMKEL1.txt,441319,445634,4315,20,N,Y,1432138943360,440957,441390
REMKEL1.txt,445635,449582,3947,20,N,Y,1432140652765,444022,446180
REMKEL1.txt,449585,453725,4140,20,N,Y,1434304562715,449617,451671
REMKEL1.txt,453726,455935,2209,20,N,N,-,-1,-1
REMKEL1.txt,455936,458890,2954,20,N,Y,1435164506717,458656,459229
REMKEL1.txt,458891,459740,849,20,N,Y,1435164969620,459343,460812
REMKEL1.txt,459743,461972,2229,20,N,Y,1435164969620,459343,460812
REMKEL1.txt,461974,464829,2855,20,N,Y,1435165913179,460834,463218
REMKEL1.txt,464830,468613,3783,20,N,Y,1435246956861,465116,468674
REMKEL1.txt,468614,471832,3218,20,N,Y,1435246956861,465116,468674
REMKEL1.txt,471833,473793,1960,20,N,N,-,-1,-1
REMKEL1.txt,473794,477116,3322,20,Y,Y,1435248772832,474122,475026
REMKEL1.txt,477117,481102,3985,20,N,Y,1435249587702,477567,478661
REMKEL1.txt,481103,484370,3267,20,N,N,-,-1,-1
REMKEL1.txt,484371,487036,2665,20,N,N,-,-1,-1
REMKEL1.txt,487037,490643,3606,20,N,Y,1435312884754,489937,490626
REMKEL1.txt,490646,494324,3678,20,N,N,-,-1,-1
REMKEL1.txt,494325,497281,2956,20,N,N,-,-1,-1
REMKEL1.txt,497282,500813,3531,20,N,Y,1435314166443,498844,500332
REMKEL2.txt,0,923,923,20,N,N,-,-1,-1
REMKEL2.txt,925,1833,908,20,N,N,-,-1,-1
REMKEL2.txt,1834,2929,1095,20,N,N,-,-1,-1
REMKEL2.txt,2930,3860,930,20,N,N,-,-1,-1
REMKEL2.txt,3861,4542,681,20,N,N,-,-1,-1
REMKEL2.txt,4544,5423,879,20,N,N,-,-1,-1
REMKEL2.txt,5424,6199,775,20,N,N,-,-1,-1
REMKEL2.txt,6200,7063,863,20,N,N,-,-1,-1
REMKEL2.txt,7064,7856,792,20,N,N,-,-1,-1
REMKEL2.txt,7857,8596,739,20,N,N,-,-1,-1
REMKEL2.txt,8599,9427,828,20,N,N,-,-1,-1
REMKEL2.txt,9428,10168,740,20,N,N,-,-1,-1
REMKEL2.txt,10169,10817,648,20,N,N,-,-1,-1
REMKEL2.txt,10818,11636,818,20,N,N,-,-1,-1
REMKEL2.txt,11637,12754,1117,20,N,N,-,-1,-1
REMKEL2.txt,12755,15129,2374,20,N,Y,1435355555620,14479,15098
REMKEL2.txt,15130,19364,4234,20,N,Y,1435357682797,15132,15608
REMKEL2.txt,19367,23083,3716,20,N,Y,1435769270470,19677,20071
REMKEL2.txt,23084,26727,3643,20,N,Y,1435771053245,23433,25540
REMKEL2.txt,26728,29545,2817,20,N,Y,1435782599159,27378,29050
REMKEL2.txt,29548,31872,2324,20,N,Y,1435783099009,31525,31867
REMKEL2.txt,31875,35592,3717,20,N,Y,1435784346015,31918,33454
REMKEL2.txt,35595,38979,3384,20,N,N,-,-1,-1
REMKEL2.txt,38980,43957,4977,20,N,Y,1435857399186,41984,42949
REMKEL2.txt,43958,47673,3715,20,N,N,-,-1,-1
REMKEL2.txt,47675,51556,3881,20,N,N,-,-1,-1
REMKEL2.txt,51557,54715,3158,20,N,Y,1435858450692,53412,54290
REMKEL2.txt,54717,57938,3221,20,N,Y,1435862440580,57258,58200
REMKEL2.txt,57939,60815,2876,20,N,Y,1435862440580,57258,58200
REMKEL2.txt,60816,63568,2752,20,N,Y,1435863114996,60692,60989
REMKEL2.txt,63569,67447,3878,20,N,N,-,-1,-1
REMKEL2.txt,67450,70293,2843,20,N,N,-,-1,-1
REMKEL2.txt,70298,74056,3758,20,N,N,-,-1,-1
REMKEL2.txt,74057,76585,2528,20,N,N,-,-1,-1
REMKEL2.txt,76586,78903,2317,20,N,N,-,-1,-1
REMKEL2.txt,78905,81552,2647,20,N,Y,1435865160115,81233,81988
REMKEL2.txt,81554,85287,3733,20,N,Y,1435865160115,81233,81988
REMKEL2.txt,85289,89804,4515,20,N,Y,1435865766643,87290,87654
REMKEL2.txt,89806,93089,3283,20,N,N,-,-1,-1
REMKEL2.txt,93090,96174,3084,20,N,N,-,-1,-1
REMKEL2.txt,96177,98935,2758,20,N,Y,1436126047679,97988,98333
REMKEL2.txt,98937,102387,3450,20,N,Y,1436126680550,100972,101605
REMKEL2.txt,102388,104680,2292,20,N,Y,1436293470468,103834,104024
REMKEL2.txt,104681,106943,2262,20,N,Y,1436293974870,105377,105629
REMKEL2.txt,106946,109779,2833,20,Y,N,-,-1,-1
REMKEL2.txt,109782,112790,3008,20,N,Y,1436298400992,111204,111685
REMKEL2.txt,112795,115913,3118,20,N,Y,1436298772179,111746,112985
REMKEL2.txt,115914,118984,3070,20,N,Y,1436352919472,117021,119063
REMKEL2.txt,118985,120873,1888,20,N,Y,1436352919472,117021,119063
REMKEL2.txt,120876,123184,2308,20,N,Y,1436472126635,121874,122900
REMKEL2.txt,123185,126782,3597,20,N,N,-,-1,-1
REMKEL2.txt,126785,130988,4203,20,N,N,-,-1,-1
REMKEL2.txt,130991,134956,3965,20,N,Y,1436813469893,134408,134846
REMKEL2.txt,134958,137843,2885,20,N,N,-,-1,-1
REMKEL2.txt,137846,141177,3331,20,N,N,-,-1,-1
REMKEL2.txt,141178,144143,2965,20,N,N,-,-1,-1
REMKEL2.txt,144144,147210,3066,20,N,N,-,-1,-1
REMKEL2.txt,147211,150938,3727,20,N,N,-,-1,-1
REMKEL2.txt,150939,153857,2918,20,N,N,-,-1,-1
REMKEL2.txt,153858,156865,3007,20,N,N,-,-1,-1
REMKEL2.txt,156866,160305,3439,20,N,N,-,-1,-1
REMKEL2.txt,160310,163674,3364,20,Y,N,-,-1,-1
REMKEL2.txt,163677,168230,4553,20,N,N,-,-1,-1
REMKEL2.txt,168231,172005,3774,20,N,Y,1436888170573,169972,170218
REMKEL2.txt,172006,175856,3850,20,N,N,-,-1,-1
REMKEL2.txt,175857,178813,2956,20,N,N,-,-1,-1
REMKEL2.txt,178814,181088,2274,20,N,N,-,-1,-1
REMKEL2.txt,181089,184574,3485,20,N,Y,1436889057877,184044,184421
REMKEL2.txt,184576,188032,3456,20,N,N,-,-1,-1
REMKEL2.txt,188033,190422,2389,20,N,N,-,-1,-1
REMKEL2.txt,190425,193753,3328,20,N,N,-,-1,-1
REMKEL2.txt,193754,196743,2989,20,Y,N,-,-1,-1
REMKEL2.txt,196744,200519,3775,20,N,N,-,-1,-1
REMKEL2.txt,200520,204244,3724,20,N,N,-,-1,-1
REMKEL2.txt,204247,207053,2806,20,N,Y,1436892204871,206775,207267
REMKEL2.txt,207053,211310,4257,20,N,Y,1436892204871,206775,207267
REMKEL2.txt,211311,216329,5018,20,N,N,-,-1,-1
REMKEL2.txt,216330,219745,3415,20,N,N,-,-1,-1
REMKEL2.txt,219746,223559,3813,20,N,N,-,-1,-1
REMKEL2.txt,223562,225954,2392,20,N,N,-,-1,-1
REMKEL2.txt,225955,228777,2822,20,N,N,-,-1,-1
REMKEL2.txt,228778,231661,2883,20,N,Y,1436953347952,230164,230508
REMKEL2.txt,231664,234546,2882,20,N,Y,1436954082750,233291,233734
REMKEL2.txt,234549,237963,3414,20,N,N,-,-1,-1
REMKEL2.txt,237964,240674,2710,20,Y,N,-,-1,-1
REMKEL2.txt,240675,242783,2108,20,N,Y,1436990194671,241135,241539
REMKEL2.txt,242784,245743,2959,20,N,Y,1437162662523,242944,243494
REMKEL2.txt,245745,249030,3285,20,N,N,-,-1,-1
REMKEL2.txt,249031,251339,2308,20,N,N,-,-1,-1
REMKEL2.txt,251340,254532,3192,20,N,Y,1437230370982,253380,254066
REMKEL2.txt,254533,257956,3423,20,N,N,-,-1,-1
REMKEL2.txt,257957,261753,3796,20,N,N,-,-1,-1
REMKEL2.txt,261754,264945,3191,20,N,Y,1437239750517,263268,263763
REMKEL2.txt,264946,267514,2568,20,N,Y,1437246845677,264808,265284
REMKEL2.txt,267515,270503,2988,20,N,Y,1437248020573,269635,269983
REMKEL2.txt,270506,273069,2563,20,N,N,-,-1,-1
REMKEL2.txt,273072,276249,3177,20,N,N,-,-1,-1
REMKEL2.txt,276251,279864,3613,20,N,N,-,-1,-1
REMKEL2.txt,279865,283315,3450,20,N,N,-,-1,-1
REMKEL2.txt,283317,286001,2684,20,N,N,-,-1,-1
REMKEL2.txt,286002,289352,3350,20,N,Y,1437304627219,286832,287509
REMKEL2.txt,289353,292705,3352,20,N,Y,1437307314987,292427,293858
REMKEL2.txt,292706,295256,2550,20,N,Y,1437307314987,292427,293858
REMKEL2.txt,295261,298087,2826,20,N,Y,1437308845347,295831,296335
REMKEL2.txt,298088,301339,3251,20,N,N,-,-1,-1
REMKEL2.txt,301342,304046,2704,20,N,Y,1437326732408,303180,303407
REMKEL2.txt,304048,306843,2795,20,N,N,-,-1,-1
REMKEL2.txt,306845,309744,2899,20,N,N,-,-1,-1
REMKEL2.txt,309746,312400,2654,20,N,Y,1437328064404,312197,312391
REMKEL2.txt,312403,314954,2551,20,N,N,-,-1,-1
REMKEL2.txt,314957,318927,3970,20,N,N,-,-1,-1
REMKEL2.txt,318930,321505,2575,20,N,N,-,-1,-1
REMKEL2.txt,321507,323927,2420,20,N,N,-,-1,-1
REMKEL2.txt,323932,326907,2975,20,N,N,-,-1,-1
REMKEL2.txt,326910,329263,2353,20,Y,Y,1437329475190,328720,329175
REMKEL2.txt,329264,332437,3173,20,N,Y,1437329990944,330563,331008
REMKEL2.txt,332438,335043,2605,20,N,Y,1437330221492,332568,334983
REMKEL2.txt,335046,337856,2810,20,N,Y,1437406606228,336576,337981
REMKEL2.txt,337859,340003,2144,20,N,Y,1437406606228,336576,337981
REMKEL2.txt,340004,343238,3234,20,N,Y,1437407180880,341111,341253
REMKEL2.txt,343241,346465,3224,20,N,Y,1437408733806,343263,344199
REMKEL2.txt,346466,349449,2983,20,N,N,-,-1,-1
REMKEL2.txt,349450,352395,2945,20,N,Y,1437411366462,350764,351452
REMKEL2.txt,352396,356975,4579,20,N,Y,1437415954991,352776,353698
REMKEL2.txt,356976,361073,4097,20,N,N,-,-1,-1
REMKEL2.txt,361074,364716,3642,20,N,Y,1437428195505,364284,364459
REMKEL2.txt,364718,367304,2586,20,N,N,-,-1,-1
REMKEL2.txt,367305,371074,3769,20,N,Y,1437429287876,369796,370314
REMKEL2.txt,371075,373647,2572,20,N,Y,1437429758375,371960,372645
REMKEL2.txt,373648,375940,2292,20,N,N,-,-1,-1
REMKEL2.txt,375941,377842,1901,20,N,N,-,-1,-1
REMKEL2.txt,377845,380585,2740,20,N,Y,1437430915650,378465,378654
REMKEL2.txt,380586,383813,3227,20,Y,Y,1437497691523,379511,381383
REMKEL2.txt,383816,387400,3584,20,N,N,-,-1,-1
REMKEL2.txt,387401,389425,2024,20,N,Y,1437499592999,387747,388053
REMKEL2.txt,389428,392367,2939,20,N,Y,1437557985724,390983,391293
REMKEL2.txt,392368,396328,3960,20,N,Y,1437558718321,393945,394737
REMKEL2.txt,396333,400221,3888,20,N,Y,1438688689316,397692,398374
REMKEL2.txt,400224,403517,3293,20,N,N,-,-1,-1
REMKEL2.txt,403518,405039,1521,20,N,Y,1438689541013,403594,405079
REMKEL2.txt,405040,408395,3355,20,N,Y,1438689541013,403594,405079
REMKEL2.txt,408398,410897,2499,20,N,N,-,-1,-1
REMKEL2.txt,410900,414071,3171,20,N,N,-,-1,-1
REMKEL2.txt,414072,416891,2819,20,N,N,-,-1,-1
REMKEL2.txt,416896,420785,3889,20,N,Y,1438707390329,418837,419955
REMKEL2.txt,420788,424332,3544,20,N,Y,1438708497019,423911,424226
REMKEL2.txt,424335,427382,3047,20,N,N,-,-1,-1
REMKEL2.txt,427383,430894,3511,20,N,N,-,-1,-1
REMKEL2.txt,430895,435418,4523,20,N,N,-,-1,-1
REMKEL2.txt,435421,440345,4924,20,N,N,-,-1,-1
REMKEL2.txt,440346,443701,3355,20,N,N,-,-1,-1
REMKEL2.txt,443702,446520,2818,20,N,N,-,-1,-1
REMKEL2.txt,446521,449261,2740,20,N,N,-,-1,-1
REMKEL2.txt,449262,452623,3361,20,N,N,-,-1,-1
REMKEL2.txt,452626,454373,1747,20,N,Y,1438711328776,453254,453945
REMKEL2.txt,454374,455042,668,20,N,N,-,-1,-1
REMKEL2.txt,455043,455505,462,20,N,N,-,-1,-1
REMKEL2.txt,455506,456065,559,20,N,N,-,-1,-1
REMKEL2.txt,456068,456451,383,20,N,N,-,-1,-1
REMKEL2.txt,456454,457204,750,20,N,N,-,-1,-1
REMKEL2.txt,457205,457674,469,20,N,N,-,-1,-1
REMKEL2.txt,457675,461280,3605,20,N,N,-,-1,-1
REMKEL2.txt,461282,464571,3289,20,N,Y,1438857102755,461608,465337
REMKEL2.txt,464574,468883,4309,20,N,Y,1438857102755,461608,465337
REMKEL2.txt,468884,472486,3602,20,N,N,-,-1,-1
REMKEL2.txt,472488,475088,2600,20,N,N,-,-1,-1
REMKEL2.txt,475089,476904,1815,20,N,N,-,-1,-1
REMKEL2.txt,476906,477931,1025,20,N,N,-,-1,-1
REMKEL2.txt,477932,479873,1941,20,N,N,-,-1,-1
REMKEL2.txt,479874,481136,1262,20,N,N,-,-1,-1
REMKEL2.txt,481139,484298,3159,20,N,N,-,-1,-1
REMKEL2.txt,484299,486927,2628,20,N,N,-,-1,-1
REMKEL2.txt,486929,489003,2074,20,N,N,-,-1,-1
REMKEL2.txt,489004,490933,1929,20,N,N,-,-1,-1
REMKEL2.txt,490934,493238,2304,20,N,N,-,-1,-1
REMKEL2.txt,493239,496149,2910,20,N,N,-,-1,-1
REMKEL2.txt,496150,498614,2464,20,N,N,-,-1,-1
REMKEL2.txt,498615,500272,1657,20,N,N,-,-1,-1
REMKEL2.txt,500273,501282,1009,20,N,N,-,-1,-1
REMKEL2.txt,501283,502103,820,20,N,N,-,-1,-1
REMKEL2.txt,502104,502795,691,20,N,N,-,-1,-1
REMKEL2.txt,502796,504713,1917,20,N,N,-,-1,-1
REMKEL2.txt,504716,506977,2261,20,N,N,-,-1,-1
REMKEL2.txt,506978,508375,1397,20,N,N,-,-1,-1
REMKEL2.txt,508377,509684,1307,20,N,N,-,-1,-1
REMKEL2.txt,509685,510870,1185,20,N,N,-,-1,-1
REMKEL2.txt,510871,513342,2471,20,N,N,-,-1,-1
REMKEL2.txt,513343,515145,1802,20,N,N,-,-1,-1
REMKEL2.txt,515146,516539,1393,20,N,N,-,-1,-1
REMKEL2.txt,516541,517721,1180,20,N,N,-,-1,-1
REMKEL2.txt,517722,518974,1252,20,N,N,-,-1,-1
REOPER.txt,0,2690,2690,20,N,N,-,-1,-1
REOPER.txt,2691,9358,6667,20,N,N,-,-1,-1
REOPER.txt,9361,17298,7937,20,N,N,-,-1,-1
REOPER.txt,17301,22625,5324,20,N,N,-,-1,-1
REOPER.txt,22626,26961,4335,20,N,N,-,-1,-1
REOPER.txt,26964,30945,3981,20,N,N,-,-1,-1
REOPER.txt,30946,34991,4045,20,N,N,-,-1,-1
REOPER.txt,34992,39329,4337,20,N,N,-,-1,-1
REOPER.txt,39330,43121,3791,20,N,N,-,-1,-1
REOPER.txt,43122,46756,3634,20,N,N,-,-1,-1
REOPER.txt,46757,50179,3422,20,N,N,-,-1,-1
REOPER.txt,50180,51855,1675,20,N,N,-,-1,-1
REOPER.txt,51857,54267,2410,20,N,N,-,-1,-1
REOPER.txt,54268,59379,5111,20,N,N,-,-1,-1
REOPER.txt,59382,62570,3188,20,N,N,-,-1,-1
REOPER.txt,62573,65913,3340,20,N,N,-,-1,-1
REOPER.txt,65914,69561,3647,20,N,N,-,-1,-1
REOPER.txt,69563,72906,3343,20,N,N,-,-1,-1
REOPER.txt,72907,77124,4217,20,N,N,-,-1,-1
REOPER.txt,77125,81314,4189,20,N,N,-,-1,-1
REOPER.txt,81317,84710,3393,20,N,N,-,-1,-1
REOPER.txt,84713,87142,2429,20,N,Y,1438607512684,86513,88081
REOPER.txt,87143,90288,3145,20,N,Y,1438607512684,86513,88081
REOPER.txt,90291,93986,3695,20,N,Y,1438607969604,92585,93513
REOPER.txt,93987,97225,3238,20,N,Y,1438608430250,93743,94780
REOPER.txt,97226,99999,2773,20,N,Y,1438609131672,98413,101156
REOPER.txt,100000,103230,3230,20,N,Y,1438609131672,98413,101156
REOPER.txt,103231,105782,2551,20,N,N,-,-1,-1
REOPER.txt,105783,108663,2880,20,N,Y,1438610692536,108268,109736
REOPER.txt,108664,111575,2911,20,N,Y,1438610692536,108268,109736
REOPER.txt,111576,114694,3118,20,N,N,-,-1,-1
REOPER.txt,114695,118242,3547,20,N,Y,1438611798217,114785,115820
REOPER.txt,118244,121250,3006,20,N,N,-,-1,-1
REOPER.txt,121251,124841,3590,20,N,N,-,-1,-1
REOPER.txt,124843,127270,2427,20,N,N,-,-1,-1
REOPER.txt,127271,130859,3588,20,N,N,-,-1,-1
REOPER.txt,130862,134415,3553,20,N,N,-,-1,-1
REOPER.txt,134418,137602,3184,20,N,Y,1438612728607,134463,135433
REOPER.txt,137605,140235,2630,20,N,Y,1438613292607,137557,139183
REOPER.txt,140238,143270,3032,20,N,Y,1438613865632,142946,144271
REOPER.txt,143271,146038,2767,20,N,Y,1438613865632,142946,144271
REOPER.txt,146039,150132,4093,20,N,N,-,-1,-1
REOPER.txt,150135,153255,3120,20,N,N,-,-1,-1
REOPER.txt,153258,156557,3299,20,N,Y,1438614732055,155289,156104
REOPER.txt,156558,160289,3731,20,N,N,-,-1,-1
REOPER.txt,160292,162852,2560,20,N,N,-,-1,-1
REOPER.txt,162853,165828,2975,20,N,N,-,-1,-1
REOPER.txt,165829,168690,2861,20,N,Y,1438615349115,168230,169109
REOPER.txt,168691,171187,2496,20,N,Y,1438615690871,169126,169616
REOPER.txt,171188,173786,2598,20,N,N,-,-1,-1
REOPER.txt,173789,178122,4333,20,N,Y,1438616740544,177666,179189
REOPER.txt,178123,181050,2927,20,N,Y,1438617107509,180955,181678
REOPER.txt,181052,184358,3306,20,N,Y,1438617107509,180955,181678
REOPER.txt,184359,187432,3073,20,N,N,-,-1,-1
REOPER.txt,187433,190419,2986,20,N,N,-,-1,-1
REOPER.txt,190420,193126,2706,20,N,N,-,-1,-1
REOPER.txt,193127,194563,1436,20,N,N,-,-1,-1
REOPER.txt,194564,195413,849,20,N,N,-,-1,-1
REOPER.txt,195416,196522,1106,20,N,N,-,-1,-1
REOPER.txt,196523,199073,2550,20,N,N,-,-1,-1
REOPER.txt,199076,202153,3077,20,N,Y,1438678160825,201557,202648
REOPER.txt,202154,205256,3102,20,N,Y,1438678872682,204536,204996
REOPER.txt,205257,208470,3213,20,N,Y,1438679318783,205023,206296
REOPER.txt,208471,211778,3307,20,N,N,-,-1,-1
REOPER.txt,211780,214572,2792,20,N,N,-,-1,-1
REOPER.txt,214573,217485,2912,20,N,N,-,-1,-1
REOPER.txt,217486,220775,3289,20,N,N,-,-1,-1
REOPER.txt,220776,223770,2994,20,N,N,-,-1,-1
REOPER.txt,223771,226785,3014,20,N,N,-,-1,-1
REOPER.txt,226786,228655,1869,20,N,N,-,-1,-1
REOPER.txt,228656,231203,2547,20,N,Y,1438680128352,229816,231640
REOPER.txt,231206,235477,4271,20,N,Y,1438680128352,229816,231640
REOPER.txt,235478,240372,4894,20,N,Y,1438680995516,235335,237205
REOPER.txt,240373,244453,4080,20,N,N,-,-1,-1
REOPER.txt,244454,248809,4355,20,N,N,-,-1,-1
REOPER.txt,248810,253521,4711,20,N,N,-,-1,-1
REOPER.txt,253522,258318,4796,20,N,N,-,-1,-1
REOPER.txt,258321,261066,2745,20,N,N,-,-1,-1
REOPER.txt,261067,263189,2122,20,N,N,-,-1,-1
REOPER.txt,263190,265816,2626,20,Y,N,-,-1,-1
REOPER.txt,265817,268923,3106,20,N,N,-,-1,-1
REOPER.txt,268924,272396,3472,20,N,N,-,-1,-1
REOPER.txt,272397,276327,3930,20,N,Y,1438682217043,275162,278631
REOPER.txt,276328,279839,3511,20,N,Y,1438682217043,275162,278631
REOPER.txt,279840,282398,2558,20,N,Y,1438685164472,280335,281058
REOPER.txt,282400,285008,2608,20,N,Y,1438685960938,284054,284833
REOPER.txt,285009,287709,2700,20,N,N,-,-1,-1
REOPER.txt,287712,290760,3048,20,N,N,-,-1,-1
REOPER.txt,290763,294481,3718,20,N,N,-,-1,-1
REOPER.txt,294482,298462,3980,20,N,N,-,-1,-1
REOPER.txt,298465,302091,3626,20,N,N,-,-1,-1
REOPER.txt,302094,305350,3256,20,N,N,-,-1,-1
REOPER.txt,305351,309657,4306,20,N,N,-,-1,-1
REOPER.txt,309658,313683,4025,20,N,N,-,-1,-1
REOPER.txt,313684,318409,4725,20,N,N,-,-1,-1
REOPER.txt,318410,322748,4338,20,N,N,-,-1,-1
REOPER.txt,322750,325941,3191,20,N,Y,1438686868625,325508,327523
REOPER.txt,325942,328207,2265,20,N,Y,1438686868625,325508,327523
REOPER.txt,328208,332338,4130,20,N,Y,1438687348398,330268,331286
REOPER.txt,332339,336044,3705,20,N,N,-,-1,-1
REOPER.txt,336045,338631,2586,20,N,N,-,-1,-1
REOPER.txt,338632,341145,2513,20,N,Y,1438687949932,339086,339844
REOPER.txt,341146,342973,1827,20,N,N,-,-1,-1
REOPER.txt,342974,345319,2345,20,N,N,-,-1,-1
REOPER.txt,345320,348216,2896,20,N,Y,1438703676425,346475,348599
REOPER.txt,348217,351441,3224,20,N,Y,1438703676425,346475,348599
REOPER.txt,351442,354524,3082,20,N,Y,1438704734352,354115,355438
REOPER.txt,354526,358117,3591,20,N,Y,1438705014163,355515,357095
REOPER.txt,358118,360977,2859,20,N,Y,1438705728692,359763,361602
REOPER.txt,360978,363605,2627,20,N,Y,1438706068692,361693,362653
REOPER.txt,363608,367173,3565,20,N,N,-,-1,-1
REOPER.txt,367174,370476,3302,20,N,N,-,-1,-1
REOPER.txt,370477,373298,2821,20,N,N,-,-1,-1
REOPER.txt,373299,375774,2475,20,N,N,-,-1,-1
REOPER.txt,375777,378531,2754,20,N,N,-,-1,-1
REOPER.txt,378532,381844,3312,20,N,N,-,-1,-1
REOPER.txt,381845,384764,2919,20,N,Y,1438706551121,383929,384620
REOPER.txt,384765,387634,2869,20,N,N,-,-1,-1
REOPER.txt,387635,390329,2694,20,N,N,-,-1,-1
REOPER.txt,390330,393972,3642,20,Y,N,-,-1,-1
REOPER.txt,393975,397412,3437,20,N,Y,1438707526102,395204,399120
REOPER.txt,397413,400234,2821,20,N,Y,1438707526102,395204,399120
REOPER.txt,400236,402502,2266,20,N,Y,1438763811355,400311,402065
REOPER.txt,402503,405010,2507,20,N,N,-,-1,-1
REOPER.txt,405011,408794,3783,20,N,Y,1438764333941,406033,406469
REOPER.txt,408795,411917,3122,20,N,Y,1438765478053,411548,412139
REOPER.txt,411918,415370,3452,20,N,Y,1438765478053,411548,412139
REOPER.txt,415371,419583,4212,20,N,Y,1438767795308,417699,419098
REOPER.txt,419586,423007,3421,20,N,Y,1438768079697,419611,420712
REOPER.txt,423008,426554,3546,20,N,N,-,-1,-1
REOPER.txt,426555,430342,3787,20,N,N,-,-1,-1
REOPER.txt,430343,433395,3052,20,N,N,-,-1,-1
REOPER.txt,433396,436926,3530,20,N,N,-,-1,-1
REOPER.txt,436927,440693,3766,20,N,Y,1438769202218,438794,441102
REOPER.txt,440696,443178,2482,20,N,Y,1438769202218,438794,441102
REOPER.txt,443183,444319,1136,20,N,N,-,-1,-1
REOPER.txt,444320,445847,1527,20,N,N,-,-1,-1
REOPER.txt,445848,448654,2806,20,Y,N,-,-1,-1
REOPER.txt,448657,451956,3299,20,N,Y,1438769699545,450302,451135
REOPER.txt,451957,454059,2102,20,N,Y,1438770629803,453971,456097
REOPER.txt,454060,457045,2985,20,N,Y,1438771010421,456188,458240
REOPER.txt,457048,460135,3087,20,N,Y,1438771010421,456188,458240
REOPER.txt,460137,463879,3742,20,N,Y,1438771823978,462479,463275
REOPER.txt,463880,467644,3764,20,N,N,-,-1,-1
REOPER.txt,467645,469744,2099,20,N,N,-,-1,-1
REOPER.txt,469745,472744,2999,20,N,N,-,-1,-1
REOPER.txt,472745,475425,2680,20,N,Y,1438778151735,473810,477429
REOPER.txt,475426,477579,2153,20,N,Y,1438778151735,473810,477429
REOPER.txt,477580,480385,2805,20,Y,Y,1438778406473,477978,478874
REOPER.txt,480386,482405,2019,20,N,Y,1438778739733,480167,480764
REOPER.txt,482408,485092,2684,20,N,N,-,-1,-1
REOPER.txt,485094,488619,3525,20,N,N,-,-1,-1
REOPER.txt,488620,491270,2650,20,N,N,-,-1,-1
REOPER.txt,491273,495507,4234,20,N,N,-,-1,-1
REOPER.txt,495508,499150,3642,20,N,N,-,-1,-1
REOPER.txt,499152,502287,3135,20,N,N,-,-1,-1
REOPER.txt,502288,506035,3747,20,N,Y,1438779843654,505464,507513
REOPER.txt,506036,509397,3361,20,N,Y,1438779843654,505464,507513
REOPER.txt,509398,512069,2671,20,N,Y,1438780706972,510534,511384
REOPER.txt,512070,514931,2861,20,N,Y,1438781426985,512557,514085
REOPER.txt,514932,518333,3401,20,N,N,-,-1,-1
REOPER.txt,518336,521475,3139,20,N,N,-,-1,-1
REOPER.txt,521476,523335,1859,20,N,Y,1438782478949,521766,525299
REOPER.txt,523338,526443,3105,20,N,Y,1438782478949,521766,525299
REOPER.txt,526444,529820,3376,20,N,Y,1438783041826,526732,528338
REOPER.txt,529821,532285,2464,20,N,Y,1438783543267,530789,532585
REOPER.txt,532286,534875,2589,20,N,Y,1438784312899,533121,535184
REOPER.txt,534876,537609,2733,20,N,Y,1438784652063,535262,536596
REOPER.txt,537610,540784,3174,20,N,N,-,-1,-1
REOPER.txt,540786,543560,2774,20,N,N,-,-1,-1
REOPER.txt,543563,546558,2995,20,N,N,-,-1,-1
REOPER.txt,546559,549432,2873,20,N,N,-,-1,-1
REOPER.txt,549433,552904,3471,20,N,N,-,-1,-1
REOPER.txt,552905,555621,2716,20,N,N,-,-1,-1
REOPER.txt,555623,559259,3636,20,N,N,-,-1,-1
REOPER.txt,559260,562611,3351,20,N,N,-,-1,-1
REOPER.txt,562613,565733,3120,20,N,N,-,-1,-1
REOPER.txt,565734,568811,3077,20,N,N,-,-1,-1
REOPER.txt,568812,572229,3417,20,Y,N,-,-1,-1
REOPER.txt,572232,575451,3219,20,N,N,-,-1,-1
REOPER.txt,575454,578678,3224,20,N,N,-,-1,-1
REOPER.txt,578679,582732,4053,20,N,N,-,-1,-1
REOPER.txt,582735,585339,2604,20,Y,N,-,-1,-1
REOPER.txt,585340,587502,2162,20,N,N,-,-1,-1
REOPER.txt,587503,590131,2628,20,Y,N,-,-1,-1
REOPER.txt,590133,593522,3389,20,Y,N,-,-1,-1
REOPER.txt,593523,597256,3733,20,N,N,-,-1,-1
REOPER.txt,597257,600641,3384,20,N,N,-,-1,-1
REOPER.txt,600642,604374,3732,20,N,N,-,-1,-1
REOPER.txt,604375,607797,3422,20,N,N,-,-1,-1
REOPER.txt,607798,610907,3109,20,N,N,-,-1,-1
REOPER.txt,610908,614068,3160,20,N,N,-,-1,-1
REOPER.txt,614069,616859,2790,20,N,N,-,-1,-1
REOPER.txt,616860,620695,3835,20,N,N,-,-1,-1
REOPER.txt,620697,624208,3511,20,N,N,-,-1,-1
REOPER.txt,624209,627269,3060,20,N,N,-,-1,-1
REOPER.txt,627270,630163,2893,20,N,N,-,-1,-1
REOPER.txt,630166,632781,2615,20,N,N,-,-1,-1
REOPER.txt,632782,635977,3195,20,N,N,-,-1,-1
REOPER.txt,635978,639506,3528,20,N,N,-,-1,-1
REOPER.txt,639509,643036,3527,20,Y,N,-,-1,-1
REOPER.txt,643036,646600,3564,20,N,N,-,-1,-1
REOPER.txt,646601,651291,4690,20,N,N,-,-1,-1
REOPER.txt,651292,653889,2597,20,N,N,-,-1,-1
REOPER.txt,653892,657149,3257,20,N,N,-,-1,-1
REOPER.txt,657151,660483,3332,20,N,N,-,-1,-1
REOPER.txt,660486,663305,2819,20,N,N,-,-1,-1
REOPER.txt,663306,667464,4158,20,N,N,-,-1,-1
REOPER.txt,667465,671003,3538,20,N,N,-,-1,-1
REOPER.txt,671004,673073,2069,20,N,N,-,-1,-1
REOPER.txt,673074,675858,2784,20,N,N,-,-1,-1
REOPER.txt,675861,678012,2151,20,N,N,-,-1,-1
REOPER.txt,678013,681174,3161,20,N,N,-,-1,-1
REOPER.txt,681175,684065,2890,20,N,N,-,-1,-1
REOPER.txt,684067,687340,3273,20,N,N,-,-1,-1
REOPER.txt,687341,689970,2629,20,N,N,-,-1,-1
REOPER.txt,689971,693258,3287,20,N,N,-,-1,-1
REOPER.txt,693261,695239,1978,20,N,N,-,-1,-1
REOPER.txt,695240,696981,1741,20,N,N,-,-1,-1
REOPER.txt,696984,699385,2401,20,N,N,-,-1,-1
REOPER.txt,699386,702094,2708,20,N,N,-,-1,-1
REOPER.txt,702095,705144,3049,20,N,N,-,-1,-1
REOPER.txt,705145,707967,2822,20,N,N,-,-1,-1
REOPER.txt,707968,710902,2934,20,N,N,-,-1,-1
REOPER.txt,710903,712796,1893,20,N,N,-,-1,-1
REOPER.txt,712797,715158,2361,20,N,N,-,-1,-1
REOPER.txt,715159,717836,2677,20,N,N,-,-1,-1
REOPER.txt,717839,720847,3008,20,N,N,-,-1,-1
REOPER.txt,720849,724784,3935,20,N,N,-,-1,-1
REOPER.txt,724785,727565,2780,20,N,N,-,-1,-1
REOPER.txt,727568,730155,2587,20,N,N,-,-1,-1
REOPER.txt,730155,732336,2181,20,N,N,-,-1,-1
REOPER.txt,732338,735361,3023,20,N,N,-,-1,-1
REOPER.txt,735366,739153,3787,20,N,N,-,-1,-1
REOPER.txt,739154,742027,2873,20,N,N,-,-1,-1
REOPER.txt,742028,745408,3380,20,N,N,-,-1,-1
REOPER.txt,745409,747595,2186,20,N,N,-,-1,-1
REOPER.txt,747597,751344,3747,20,N,N,-,-1,-1
REOPER.txt,751345,754887,3542,20,N,N,-,-1,-1
REOPER.txt,754888,757392,2504,20,N,N,-,-1,-1
REOPER.txt,757393,760135,2742,20,N,N,-,-1,-1
REOPER.txt,760136,763276,3140,20,N,N,-,-1,-1
REOPER.txt,763277,766505,3228,20,N,N,-,-1,-1
REOPER.txt,766506,769827,3321,20,N,N,-,-1,-1
REOPER.txt,769828,771987,2159,20,N,N,-,-1,-1
REOPER.txt,771988,774636,2648,20,N,N,-,-1,-1
REOPER.txt,774637,777972,3335,20,N,N,-,-1,-1
REOPER.txt,777973,779961,1988,20,N,N,-,-1,-1
REOPER.txt,779962,782687,2725,20,N,N,-,-1,-1
REOPER.txt,782688,785357,2669,20,N,N,-,-1,-1
REOPER.txt,785358,787408,2050,20,N,N,-,-1,-1
REOPER.txt,787409,791390,3981,20,N,N,-,-1,-1
REOPER.txt,791393,794206,2813,20,N,N,-,-1,-1
REOPER.txt,794207,796969,2762,20,N,N,-,-1,-1
REOPER.txt,796969,800838,3869,20,N,N,-,-1,-1
REOPER.txt,800839,803782,2943,20,N,N,-,-1,-1
REOPER.txt,803783,806010,2227,20,N,N,-,-1,-1
REOPER.txt,806011,808419,2408,20,N,N,-,-1,-1
REOPER.txt,808420,812054,3634,20,N,N,-,-1,-1
REOPER.txt,812055,814587,2532,20,N,N,-,-1,-1
REOPER.txt,814588,817831,3243,20,N,N,-,-1,-1
REOPER.txt,817836,820695,2859,20,N,N,-,-1,-1
REOPER.txt,820696,823561,2865,20,N,N,-,-1,-1
REOPER.txt,823562,827582,4020,20,N,N,-,-1,-1
THIRTY.txt,1,5988,5987,20,Y,N,-,-1,-1
THIRTY.txt,5989,10867,4878,20,N,N,-,-1,-1
THIRTY.txt,10868,14866,3998,20,Y,N,-,-1,-1
THIRTY.txt,14867,18320,3453,20,Y,Y,1438157398793,16921,17950
THIRTY.txt,18321,22054,3733,20,N,Y,1438159538620,18153,19649
THIRTY.txt,22057,25360,3303,20,N,N,-,-1,-1
THIRTY.txt,25362,27743,2381,20,N,N,-,-1,-1
THIRTY.txt,27745,31031,3286,20,N,Y,1438160199087,28565,29351
THIRTY.txt,31032,33867,2835,20,N,Y,1438161785448,31562,32150
THIRTY.txt,33870,37641,3771,20,N,Y,1438162296864,32161,34110
THIRTY.txt,37642,40860,3218,20,N,Y,1438162931556,40152,41509
THIRTY.txt,40861,43788,2927,20,N,Y,1438163419525,41973,43188
THIRTY.txt,43789,46762,2973,20,N,Y,1438165222216,44881,46194
THIRTY.txt,46763,49400,2637,20,N,N,-,-1,-1
THIRTY.txt,49401,52233,2832,20,N,N,-,-1,-1
THIRTY.txt,52236,55498,3262,20,N,Y,1438165920566,55062,56456
THIRTY.txt,55503,58100,2597,20,N,Y,1438165920566,55062,56456
THIRTY.txt,58101,61482,3381,20,N,Y,1438166902193,59219,61464
THIRTY.txt,61483,64964,3481,20,Y,Y,1438167435224,61729,62292
THIRTY.txt,64965,68084,3119,20,N,N,-,-1,-1
THIRTY.txt,68085,70933,2848,20,N,N,-,-1,-1
THIRTY.txt,70936,75056,4120,20,Y,Y,1438169169141,74247,75379
THIRTY.txt,75057,78743,3686,20,Y,Y,1438169169141,74247,75379
THIRTY.txt,78744,81249,2505,20,N,N,-,-1,-1
THIRTY.txt,81252,84094,2842,20,N,Y,1438170164484,82295,83217
THIRTY.txt,84095,88114,4019,20,Y,N,-,-1,-1
THIRTY.txt,88117,90459,2342,20,N,N,-,-1,-1
THIRTY.txt,90461,92903,2442,20,N,Y,1438189723317,92178,95121
THIRTY.txt,92906,95593,2687,20,N,Y,1438189723317,92178,95121
THIRTY.txt,95594,97925,2331,20,N,N,-,-1,-1
THIRTY.txt,97927,101395,3468,20,N,N,-,-1,-1
THIRTY.txt,101395,104082,2687,20,Y,Y,1438190510320,101962,103008
THIRTY.txt,104083,107095,3012,20,N,Y,1438191374996,103260,104214
THIRTY.txt,107096,110302,3206,20,N,Y,1438246777986,107205,109556
THIRTY.txt,110303,114197,3894,20,N,N,-,-1,-1
THIRTY.txt,114198,116656,2458,20,N,Y,1438247270881,115104,115832
THIRTY.txt,116657,119843,3186,20,N,Y,1438247916111,118197,118881
THIRTY.txt,119844,123134,3290,20,N,Y,1438248640511,119038,120318
THIRTY.txt,123135,126775,3640,20,N,Y,1438249161833,123571,124012
THIRTY.txt,126778,130034,3256,20,N,N,-,-1,-1
THIRTY.txt,130035,132927,2892,20,N,N,-,-1,-1
THIRTY.txt,132928,136023,3095,20,N,N,-,-1,-1
THIRTY.txt,136025,136525,500,20,N,N,-,-1,-1
THIRTY.txt,136525,136785,260,20,N,N,-,-1,-1
THIRTY.txt,136787,137092,305,20,N,N,-,-1,-1
THIRTY.txt,137092,140293,3201,20,Y,N,-,-1,-1
THIRTY.txt,140294,143630,3336,20,N,N,-,-1,-1
THIRTY.txt,143630,146744,3114,20,N,Y,1438250592994,145798,147831
THIRTY.txt,146745,151050,4305,20,N,Y,1438250592994,145798,147831
THIRTY.txt,151053,154244,3191,20,N,Y,1438251442654,151139,153995
THIRTY.txt,154247,157395,3148,20,N,Y,1438251999106,154831,155580
THIRTY.txt,157396,160863,3467,20,N,N,-,-1,-1
THIRTY.txt,160864,163696,2832,20,N,N,-,-1,-1
THIRTY.txt,163697,166232,2535,20,N,N,-,-1,-1
THIRTY.txt,166235,169036,2801,20,N,Y,1438252600776,166233,167088
THIRTY.txt,169036,172927,3891,20,Y,Y,1438253344818,172096,173864
THIRTY.txt,172928,175205,2277,20,N,Y,1438253717853,174584,175030
THIRTY.txt,175208,178843,3635,20,N,Y,1438260340275,178702,179144
THIRTY.txt,178844,182419,3575,20,N,Y,1438260662836,180296,180671
THIRTY.txt,182420,185528,3108,20,N,Y,1438261222496,182454,183438
THIRTY.txt,185529,187674,2145,20,Y,N,-,-1,-1
THIRTY.txt,187674,190263,2589,20,N,N,-,-1,-1
THIRTY.txt,190264,192226,1962,20,N,N,-,-1,-1
THIRTY.txt,192227,194694,2467,20,Y,N,-,-1,-1
THIRTY.txt,194695,196697,2002,20,N,N,-,-1,-1
THIRTY.txt,196697,200233,3536,20,Y,N,-,-1,-1
THIRTY.txt,200234,202806,2572,20,N,Y,1438261922656,202060,202369
THIRTY.txt,202808,205057,2249,20,N,Y,1438262221763,203293,203654
THIRTY.txt,205060,208075,3015,20,Y,N,-,-1,-1
THIRTY.txt,208076,211837,3761,20,N,Y,1438262649189,209904,210317
THIRTY.txt,211840,214841,3001,20,N,Y,1438263571731,212203,213237
THIRTY.txt,214842,218099,3257,20,N,Y,1438264301777,214763,216915
THIRTY.txt,218100,221511,3411,20,Y,Y,1438265344157,220057,220486
THIRTY.txt,221514,224636,3122,20,N,N,-,-1,-1
THIRTY.txt,224639,227769,3130,20,N,N,-,-1,-1
THIRTY.txt,227771,230711,2940,20,N,Y,1438266059280,228002,229500
THIRTY.txt,230712,232819,2107,20,N,N,-,-1,-1
THIRTY.txt,232820,235830,3010,20,N,N,-,-1,-1
THIRTY.txt,235831,238632,2801,20,N,N,-,-1,-1
THIRTY.txt,238633,240992,2359,20,N,N,-,-1,-1
THIRTY.txt,240993,243284,2291,20,N,N,-,-1,-1
THIRTY.txt,243285,246497,3212,20,N,N,-,-1,-1
THIRTY.txt,246500,248779,2279,20,N,N,-,-1,-1
THIRTY.txt,248780,250901,2121,20,N,N,-,-1,-1
THIRTY.txt,250904,253923,3019,20,N,Y,1438423300058,250954,251876
THIRTY.txt,253924,257467,3543,20,N,Y,1438423663362,256945,257426
THIRTY.txt,257468,261204,3736,20,N,Y,1438424184434,260766,262372
THIRTY.txt,261206,263382,2176,20,N,Y,1438424184434,260766,262372
THIRTY.txt,263383,265503,2120,20,N,N,-,-1,-1
THIRTY.txt,265504,268213,2709,20,N,N,-,-1,-1
THIRTY.txt,268218,271318,3100,20,N,N,-,-1,-1
THIRTY.txt,271320,275130,3810,20,N,Y,1438425910414,274750,276774
THIRTY.txt,275131,278408,3277,20,N,Y,1438426336365,278251,279327
THIRTY.txt,278409,281174,2765,20,N,Y,1438426336365,278251,279327
THIRTY.txt,281177,284834,3657,20,N,Y,1438426775375,281224,282800
THIRTY.txt,284835,287313,2478,20,N,Y,1438427296305,286896,287713
THIRTY.txt,287316,289886,2570,20,N,Y,1438427296305,286896,287713
THIRTY.txt,289887,292845,2958,20,N,N,-,-1,-1
THIRTY.txt,292847,295067,2220,20,N,N,-,-1,-1
THIRTY.txt,295068,298465,3397,20,N,N,-,-1,-1
THIRTY.txt,298466,301643,3177,20,N,Y,1438427933753,301337,301636
THIRTY.txt,301644,305061,3417,20,N,Y,1438428449081,302448,305774
THIRTY.txt,305062,307910,2848,20,N,Y,1438436113840,305935,306928
THIRTY.txt,307911,311090,3179,20,N,N,-,-1,-1
THIRTY.txt,311093,313668,2575,20,N,N,-,-1,-1
THIRTY.txt,313669,317130,3461,20,N,Y,1438437740936,316545,317774
THIRTY.txt,317131,320699,3568,20,N,Y,1438437740936,316545,317774
THIRTY.txt,320702,323962,3260,20,N,N,-,-1,-1
THIRTY.txt,323963,326681,2718,20,N,Y,1438438506460,326211,326819
THIRTY.txt,326682,329900,3218,20,N,Y,1438438506460,326211,326819
THIRTY.txt,329901,332983,3082,20,N,Y,1438442848699,330488,331687
THIRTY.txt,332984,335620,2636,20,N,Y,1438443458585,334890,335870
THIRTY.txt,335621,338418,2797,20,N,Y,1438443458585,334890,335870
THIRTY.txt,338419,342076,3657,20,N,Y,1438444169457,339222,340309
THIRTY.txt,342077,345419,3342,20,N,Y,1438444885260,343875,346542
THIRTY.txt,345420,348614,3194,20,N,Y,1438445991237,347950,348352
THIRTY.txt,348614,352026,3412,20,N,Y,1438446807342,351574,353976
THIRTY.txt,352027,354253,2226,20,N,Y,1438446807342,351574,353976
THIRTY.txt,354253,358473,4220,20,N,N,-,-1,-1
THIRTY.txt,358475,361320,2845,20,N,N,-,-1,-1
THIRTY.txt,361323,364207,2884,20,Y,N,-,-1,-1
THIRTY.txt,364208,366463,2255,20,N,N,-,-1,-1
THIRTY.txt,366464,369373,2909,20,N,N,-,-1,-1
THIRTY.txt,369376,373094,3718,20,N,Y,1438448043481,372740,373741
THIRTY.txt,373095,375954,2859,20,N,Y,1438448043481,372740,373741
THIRTY.txt,375959,379058,3099,20,N,N,-,-1,-1
THIRTY.txt,379059,382080,3021,20,N,N,-,-1,-1
THIRTY.txt,382081,384708,2627,20,N,N,-,-1,-1
THIRTY.txt,384709,387802,3093,20,N,N,-,-1,-1
THIRTY.txt,387804,391009,3205,20,N,N,-,-1,-1
THIRTY.txt,391012,393289,2277,20,N,Y,1438520691591,392603,394020
THIRTY.txt,393294,396613,3319,20,N,Y,1438521743713,395976,397187
THIRTY.txt,396613,399748,3135,20,N,Y,1438521743713,395976,397187
THIRTY.txt,399749,401805,2056,20,Y,Y,1438522453832,399958,400307
THIRTY.txt,401806,404916,3110,20,N,N,-,-1,-1
THIRTY.txt,404918,408007,3089,20,N,Y,1438523309595,407082,408026
THIRTY.txt,408008,409982,1974,20,N,Y,1438523309595,407082,408026
THIRTY.txt,409985,413539,3554,20,N,Y,1438524170239,412054,412585
THIRTY.txt,413540,417004,3464,20,N,Y,1438524762496,413657,414319
THIRTY.txt,417009,419631,2622,20,N,Y,1438525236574,419169,419622
THIRTY.txt,419632,422707,3075,20,N,Y,1438525660625,420215,421606
THIRTY.txt,422707,426255,3548,20,N,N,-,-1,-1
THIRTY.txt,426256,430111,3855,20,N,Y,1438526435174,427361,428109
THIRTY.txt,430112,434462,4350,20,N,N,-,-1,-1
THIRTY.txt,434463,438227,3764,20,N,Y,1438527042090,435881,437111
THIRTY.txt,438229,441510,3281,20,Y,Y,1438532103693,439032,440498
THIRTY.txt,441511,444784,3273,20,N,N,-,-1,-1
THIRTY.txt,444785,447076,2291,20,N,Y,1438532730981,446979,448516
THIRTY.txt,447077,450616,3539,20,N,Y,1438533206356,448586,449872
THIRTY.txt,450617,453310,2693,20,N,N,-,-1,-1
THIRTY.txt,453313,456352,3039,20,N,N,-,-1,-1
THIRTY.txt,456353,461041,4688,20,Y,Y,1438533757046,457288,458186
THIRTY.txt,461042,464828,3786,20,N,Y,1438534266920,463977,464515
THIRTY.txt,464833,468440,3607,20,N,N,-,-1,-1
THIRTY.txt,468441,471717,3276,20,N,N,-,-1,-1
THIRTY.txt,471720,475069,3349,20,Y,Y,1438589777282,472848,474072
THIRTY.txt,475070,478102,3032,20,Y,Y,1438590330949,474159,475584
THIRTY.txt,478104,480476,2372,20,N,Y,1438591228595,478885,480708
THIRTY.txt,480479,484336,3857,20,N,Y,1438592214311,484044,484590
THIRTY.txt,484337,487907,3570,20,N,Y,1438592530594,484631,485560
THIRTY.txt,487908,490868,2960,20,Y,Y,1438592996577,488903,489682
THIRTY.txt,490869,493671,2802,20,N,Y,1438593512176,489782,492138
THIRTY.txt,493672,497168,3496,20,N,N,-,-1,-1
THIRTY.txt,497169,500873,3704,20,Y,Y,1438594174047,498899,500136
THIRTY.txt,500874,505073,4199,20,N,Y,1438596375620,500735,501901
THIRTY.txt,505076,508290,3214,20,N,Y,1438596889671,505129,506172
THIRTY.txt,508291,512170,3879,20,Y,Y,1438597622333,511659,513933
THIRTY.txt,512173,515284,3111,20,N,Y,1438597622333,511659,513933
THIRTY.txt,515285,518342,3057,20,N,N,-,-1,-1
THIRTY.txt,518344,521635,3291,20,N,Y,1438598288957,519286,519820
THIRTY.txt,521636,525929,4293,20,Y,Y,1438598938260,522322,523335
THIRTY.txt,525930,527895,1965,20,N,Y,1438599418291,525144,526021
THIRTY.txt,527896,531108,3212,20,N,Y,1438599831167,529511,530072
THIRTY.txt,531109,533916,2807,20,N,N,-,-1,-1
THIRTY.txt,533917,538675,4758,20,N,Y,1438600198307,534335,534790
THIRTY.txt,538676,545939,7263,20,N,N,-,-1,-1
THIRTY.txt,545940,575368,29428,20,N,N,-,-1,-1
TWOMEN.txt,2,4697,4695,20,N,N,-,-1,-1
TWOMEN.txt,4698,5784,1086,20,N,N,-,-1,-1
TWOMEN.txt,5785,8865,3080,20,N,N,-,-1,-1
TWOMEN.txt,8867,12850,3983,20,N,Y,1433438168945,10115,10944
TWOMEN.txt,12851,16923,4072,20,N,N,-,-1,-1
TWOMEN.txt,16924,20202,3278,20,N,N,-,-1,-1
TWOMEN.txt,20204,22550,2346,20,N,N,-,-1,-1
TWOMEN.txt,22551,24257,1706,20,N,N,-,-1,-1
TWOMEN.txt,24258,25601,1343,20,N,N,-,-1,-1
TWOMEN.txt,25602,28734,3132,20,N,N,-,-1,-1
TWOMEN.txt,28735,30397,1662,20,N,N,-,-1,-1
TWOMEN.txt,30400,31127,727,20,N,N,-,-1,-1
TWOMEN.txt,31129,32022,893,20,N,N,-,-1,-1
TWOMEN.txt,32027,33995,1968,20,N,N,-,-1,-1
TWOMEN.txt,33998,35014,1016,20,N,N,-,-1,-1
TWOMEN.txt,35016,36003,987,20,N,N,-,-1,-1
TWOMEN.txt,36005,37140,1135,20,N,N,-,-1,-1
TWOMEN.txt,37142,38158,1016,20,N,N,-,-1,-1
TWOMEN.txt,38160,40974,2814,20,N,N,-,-1,-1
TWOMEN.txt,40976,42244,1268,20,N,N,-,-1,-1
TWOMEN.txt,42246,43880,1634,20,N,N,-,-1,-1
TWOMEN.txt,43883,47210,3327,20,N,N,-,-1,-1
TWOMEN.txt,47212,49825,2613,20,N,N,-,-1,-1
TWOMEN.txt,49827,50652,825,20,N,N,-,-1,-1
TWOMEN.txt,50653,53349,2696,20,N,N,-,-1,-1
TWOMEN.txt,53354,58347,4993,20,N,N,-,-1,-1
TWOMEN.txt,58348,60778,2430,20,N,N,-,-1,-1
TWOMEN.txt,60780,61838,1058,20,N,N,-,-1,-1
TWOMEN.txt,61840,64639,2799,20,N,N,-,-1,-1
TWOMEN.txt,64640,66997,2357,20,N,N,-,-1,-1
TWOMEN.txt,66998,68840,1842,20,N,N,-,-1,-1
TWOMEN.txt,68841,72365,3524,20,N,Y,1435165746603,69147,70419
TWOMEN.txt,72366,74838,2472,20,N,N,-,-1,-1
TWOMEN.txt,74839,76575,1736,20,N,N,-,-1,-1
TWOMEN.txt,76578,78313,1735,20,N,N,-,-1,-1
TWOMEN.txt,78314,80799,2485,20,N,N,-,-1,-1
TWOMEN.txt,80800,82680,1880,20,N,N,-,-1,-1
TWOMEN.txt,82685,84961,2276,20,N,N,-,-1,-1
TWOMEN.txt,84963,86872,1909,20,N,N,-,-1,-1
TWOMEN.txt,86874,88929,2055,20,N,N,-,-1,-1
TWOMEN.txt,88932,90139,1207,20,N,N,-,-1,-1
TWOMEN.txt,90140,91950,1810,20,N,N,-,-1,-1
TWOMEN.txt,91951,93846,1895,20,N,N,-,-1,-1
TWOMEN.txt,93847,95289,1442,20,N,N,-,-1,-1
TWOMEN.txt,95291,97820,2529,20,N,N,-,-1,-1
TWOMEN.txt,97821,99728,1907,20,N,N,-,-1,-1
TWOMEN.txt,99729,101954,2225,20,N,N,-,-1,-1
TWOMEN.txt,101956,103773,1817,20,N,N,-,-1,-1
TWOMEN.txt,103775,107006,3231,20,N,N,-,-1,-1
TWOMEN.txt,107007,110162,3155,20,N,N,-,-1,-1
TWOMEN.txt,110164,112125,1961,20,N,N,-,-1,-1
TWOMEN.txt,112127,114112,1985,20,N,N,-,-1,-1
TWOMEN.txt,114113,116732,2619,20,N,N,-,-1,-1
TWOMEN.txt,116734,119401,2667,20,N,N,-,-1,-1
TWOMEN.txt,119402,122735,3333,20,N,Y,1435248397073,122627,123247
TWOMEN.txt,122736,125629,2893,20,N,Y,1435251420562,125574,126313
TWOMEN.txt,125630,127594,1964,20,N,Y,1435251420562,125574,126313
TWOMEN.txt,127595,129978,2383,20,N,N,-,-1,-1
TWOMEN.txt,129979,131806,1827,20,N,N,-,-1,-1
TWOMEN.txt,131806,135648,3842,20,N,N,-,-1,-1
TWOMEN.txt,135649,137964,2315,20,N,N,-,-1,-1
TWOMEN.txt,137965,139599,1634,20,N,N,-,-1,-1
TWOMEN.txt,139601,140891,1290,20,N,N,-,-1,-1
TWOMEN.txt,140892,142093,1201,20,N,N,-,-1,-1
TWOMEN.txt,142096,143803,1707,20,N,N,-,-1,-1
TWOMEN.txt,143805,145311,1506,20,N,Y,1435252280553,144644,145005
TWOMEN.txt,145313,146636,1323,20,N,N,-,-1,-1
TWOMEN.txt,146637,147932,1295,20,N,N,-,-1,-1
TWOMEN.txt,147934,149342,1408,20,N,N,-,-1,-1
TWOMEN.txt,149343,150472,1129,20,N,N,-,-1,-1
TWOMEN.txt,150474,151978,1504,20,N,N,-,-1,-1
TWOMEN.txt,151979,153132,1153,20,N,N,-,-1,-1
TWOMEN.txt,153135,154349,1214,20,N,N,-,-1,-1
TWOMEN.txt,154351,155992,1641,20,N,N,-,-1,-1
TWOMEN.txt,155993,157515,1522,20,N,N,-,-1,-1
TWOMEN.txt,157517,159502,1985,20,N,N,-,-1,-1
TWOMEN.txt,159504,161523,2019,20,N,Y,1435252717170,159519,160234
TWOMEN.txt,161526,163358,1832,20,N,N,-,-1,-1
TWOMEN.txt,163359,165114,1755,20,N,N,-,-1,-1
TWOMEN.txt,165116,166052,936,20,N,N,-,-1,-1
TWOMEN.txt,166054,167875,1821,20,N,N,-,-1,-1
TWOMEN.txt,167876,169646,1770,20,N,N,-,-1,-1
TWOMEN.txt,169648,171466,1818,20,N,N,-,-1,-1
TWOMEN.txt,171468,173212,1744,20,N,N,-,-1,-1
TWOMEN.txt,173214,174736,1522,20,N,N,-,-1,-1
TWOMEN.txt,174737,177037,2300,20,N,N,-,-1,-1
TWOMEN.txt,177038,179474,2436,20,N,N,-,-1,-1
TWOMEN.txt,179476,181261,1785,20,N,N,-,-1,-1
TWOMEN.txt,181261,183820,2559,20,N,N,-,-1,-1
TWOMEN.txt,183821,185791,1970,20,N,N,-,-1,-1
TWOMEN.txt,185793,188057,2264,20,N,N,-,-1,-1
TWOMEN.txt,188060,190253,2193,20,N,N,-,-1,-1
TWOMEN.txt,190256,192414,2158,20,N,N,-,-1,-1
TWOMEN.txt,192416,194287,1871,20,N,N,-,-1,-1
TWOMEN.txt,194289,194808,519,20,N,N,-,-1,-1
TWOMEN.txt,194811,196502,1691,20,N,N,-,-1,-1
TWOMEN.txt,196503,198476,1973,20,N,N,-,-1,-1
TWOMEN.txt,198476,199645,1169,20,N,N,-,-1,-1
TWOMEN.txt,199646,201260,1614,20,N,Y,1435559512755,200724,201031
TWOMEN.txt,201262,202755,1493,20,N,N,-,-1,-1
TWOMEN.txt,202756,204797,2041,20,N,N,-,-1,-1
TWOMEN.txt,204798,205969,1171,20,N,N,-,-1,-1
TWOMEN.txt,205974,207214,1240,20,N,N,-,-1,-1
TWOMEN.txt,207217,209089,1872,20,N,N,-,-1,-1
TWOMEN.txt,209090,211207,2117,20,N,N,-,-1,-1
TWOMEN.txt,211207,213987,2780,20,N,N,-,-1,-1
TWOMEN.txt,213988,215952,1964,20,N,N,-,-1,-1
TWOMEN.txt,215953,218484,2531,20,N,N,-,-1,-1
TWOMEN.txt,218485,220752,2267,20,N,N,-,-1,-1
TWOMEN.txt,220753,222739,1986,20,N,N,-,-1,-1
TWOMEN.txt,222740,224420,1680,20,N,Y,1435560377740,223014,223315
TWOMEN.txt,224425,225753,1328,20,N,N,-,-1,-1
TWOMEN.txt,225754,227455,1701,20,N,N,-,-1,-1
TWOMEN.txt,227456,228970,1514,20,N,N,-,-1,-1
TWOMEN.txt,228972,230464,1492,20,N,N,-,-1,-1
TWOMEN.txt,230466,232336,1870,20,N,N,-,-1,-1
TWOMEN.txt,232338,233104,766,20,N,N,-,-1,-1
TWOMEN.txt,233105,234555,1450,20,N,N,-,-1,-1
TWOMEN.txt,234557,235542,985,20,N,N,-,-1,-1
TWOMEN.txt,235543,237373,1830,20,N,Y,1435569753505,236911,237277
TWOMEN.txt,237375,239099,1724,20,N,N,-,-1,-1
TWOMEN.txt,239100,241223,2123,20,N,N,-,-1,-1
TWOMEN.txt,241225,242985,1760,20,N,Y,1435570787049,242195,242945
TWOMEN.txt,242986,244424,1438,20,N,N,-,-1,-1
TWOMEN.txt,244426,246160,1734,20,N,N,-,-1,-1
TWOMEN.txt,246162,247870,1708,20,N,N,-,-1,-1
TWOMEN.txt,247871,250785,2914,20,N,N,-,-1,-1
TWOMEN.txt,250786,252853,2067,20,N,N,-,-1,-1
TWOMEN.txt,252855,254661,1806,20,N,N,-,-1,-1
TWOMEN.txt,254661,256393,1732,20,N,N,-,-1,-1
TWOMEN.txt,256394,258586,2192,20,N,N,-,-1,-1
TWOMEN.txt,258588,260745,2157,20,N,N,-,-1,-1
TWOMEN.txt,260750,262974,2224,20,N,N,-,-1,-1
TWOMEN.txt,262975,264675,1700,20,N,N,-,-1,-1
TWOMEN.txt,264676,266796,2120,20,N,N,-,-1,-1
TWOMEN.txt,266798,268930,2132,20,N,N,-,-1,-1
TWOMEN.txt,268931,271015,2084,20,N,N,-,-1,-1
TWOMEN.txt,271016,273573,2557,20,N,N,-,-1,-1
TWOMEN.txt,273575,275501,1926,20,N,N,-,-1,-1
TWOMEN.txt,275502,277809,2307,20,N,N,-,-1,-1
TWOMEN.txt,277810,279829,2019,20,N,N,-,-1,-1
TWOMEN.txt,279830,281495,1665,20,N,N,-,-1,-1
TWOMEN.txt,281496,283543,2047,20,N,N,-,-1,-1
TWOMEN.txt,283544,284477,933,20,N,N,-,-1,-1
TWOMEN.txt,284478,286471,1993,20,N,N,-,-1,-1
TWOMEN.txt,286476,288803,2327,20,N,N,-,-1,-1
TWOMEN.txt,288803,290884,2081,20,N,N,-,-1,-1
TWOMEN.txt,290885,293828,2943,20,N,N,-,-1,-1
TWOMEN.txt,293830,295607,1777,20,N,N,-,-1,-1
TWOMEN.txt,295609,297678,2069,20,N,N,-,-1,-1
TWOMEN.txt,297680,299594,1914,20,N,N,-,-1,-1
TWOMEN.txt,299595,301869,2274,20,N,N,-,-1,-1
TWOMEN.txt,301870,303688,1818,20,N,N,-,-1,-1
TWOMEN.txt,303690,305652,1962,20,N,N,-,-1,-1
TWOMEN.txt,305653,308076,2423,20,N,N,-,-1,-1
TWOMEN.txt,308080,310620,2540,20,N,N,-,-1,-1
TWOMEN.txt,310621,311531,910,20,N,N,-,-1,-1
TWOMEN.txt,311532,313377,1845,20,N,N,-,-1,-1
TWOMEN.txt,313378,315326,1948,20,N,N,-,-1,-1
TWOMEN.txt,315327,318116,2789,20,N,N,-,-1,-1
TWOMEN.txt,318117,319922,1805,20,N,N,-,-1,-1
TWOMEN.txt,319924,321783,1859,20,N,N,-,-1,-1
TWOMEN.txt,321784,323432,1648,20,N,N,-,-1,-1
TWOMEN.txt,323433,325118,1685,20,N,N,-,-1,-1
TWOMEN.txt,325120,326740,1620,20,N,N,-,-1,-1
TWOMEN.txt,326745,328482,1737,20,N,N,-,-1,-1
TWOMEN.txt,328483,330554,2071,20,N,N,-,-1,-1
TWOMEN.txt,330555,333278,2723,20,N,N,-,-1,-1
TWOMEN.txt,333281,334677,1396,20,N,N,-,-1,-1
TWOMEN.txt,334678,337020,2342,20,N,N,-,-1,-1
TWOMEN.txt,337021,338413,1392,20,N,N,-,-1,-1
TWOMEN.txt,338414,340028,1614,20,N,N,-,-1,-1
TWOMEN.txt,340029,340975,946,20,N,N,-,-1,-1
TWOMEN.txt,340978,342088,1110,20,N,N,-,-1,-1
TWOMEN.txt,342089,343680,1591,20,N,N,-,-1,-1
TWOMEN.txt,343681,344437,756,20,N,N,-,-1,-1
TWOMEN.txt,344439,346026,1587,20,N,N,-,-1,-1
TWOMEN.txt,346028,348211,2183,20,N,N,-,-1,-1
TWOMEN.txt,348211,349780,1569,20,N,N,-,-1,-1
TWOMEN.txt,349782,350936,1154,20,N,N,-,-1,-1
TWOMEN.txt,350937,352332,1395,20,N,N,-,-1,-1
TWOMEN.txt,352332,353840,1508,20,N,N,-,-1,-1
TWOMEN.txt,353840,355739,1899,20,N,N,-,-1,-1
TWOMEN.txt,355740,357029,1289,20,N,N,-,-1,-1
TWOMEN.txt,357034,358381,1347,20,N,N,-,-1,-1
TWOMEN.txt,358383,360315,1932,20,N,N,-,-1,-1
TWOMEN.txt,360316,362082,1766,20,N,N,-,-1,-1
TWOMEN.txt,362087,364087,2000,20,N,N,-,-1,-1
TWOMEN.txt,364088,364930,842,20,N,N,-,-1,-1
TWOMEN.txt,364931,366377,1446,20,N,N,-,-1,-1
TWOMEN.txt,366378,367886,1508,20,N,N,-,-1,-1
TWOMEN.txt,367888,369592,1704,20,N,N,-,-1,-1
TWOMEN.txt,369595,370550,955,20,N,N,-,-1,-1
TWOMEN.txt,370551,371935,1384,20,N,N,-,-1,-1
TWOMEN.txt,371936,373575,1639,20,N,N,-,-1,-1
TWOMEN.txt,373576,375253,1677,20,N,N,-,-1,-1
TWOMEN.txt,375255,377411,2156,20,N,N,-,-1,-1
TWOMEN.txt,377412,379111,1699,20,N,N,-,-1,-1
TWOMEN.txt,379113,380600,1487,20,N,N,-,-1,-1
TWOMEN.txt,380602,383075,2473,20,N,Y,1435574979068,381547,381864
TWOMEN.txt,383076,385183,2107,20,N,N,-,-1,-1
TWOMEN.txt,385184,386537,1353,20,N,N,-,-1,-1
TWOMEN.txt,386539,388750,2211,20,N,N,-,-1,-1
TWOMEN.txt,388751,391048,2297,20,N,N,-,-1,-1
TWOMEN.txt,391051,392829,1778,20,N,N,-,-1,-1
TWOMEN.txt,392830,394120,1290,20,N,N,-,-1,-1
TWOMEN.txt,394121,395401,1280,20,N,N,-,-1,-1
TWOMEN.txt,395402,397657,2255,20,N,N,-,-1,-1
TWOMEN.txt,397658,398946,1288,20,N,N,-,-1,-1
TWOMEN.txt,398946,400395,1449,20,N,N,-,-1,-1
TWOMEN.txt,400397,402352,1955,20,N,N,-,-1,-1
TWOMEN.txt,402354,404535,2181,20,N,N,-,-1,-1
TWOMEN.txt,404536,406974,2438,20,N,N,-,-1,-1
TWOMEN.txt,406975,408550,1575,20,N,N,-,-1,-1
TWOMEN.txt,408552,410059,1507,20,N,N,-,-1,-1
TWOMEN.txt,410062,410966,904,20,N,N,-,-1,-1
TWOMEN.txt,410967,412864,1897,20,N,N,-,-1,-1
TWOMEN.txt,412867,415645,2778,20,N,N,-,-1,-1
TWOMEN.txt,415646,417447,1801,20,N,N,-,-1,-1
TWOMEN.txt,417448,418773,1325,20,N,N,-,-1,-1
TWOMEN.txt,418775,420995,2220,20,N,N,-,-1,-1
TWOMEN.txt,420997,423103,2106,20,N,N,-,-1,-1
TWOMEN.txt,423104,425463,2359,20,N,N,-,-1,-1
TWOMEN.txt,425464,427658,2194,20,N,N,-,-1,-1
TWOMEN.txt,427659,429709,2050,20,N,N,-,-1,-1
TWOMEN.txt,429710,432271,2561,20,N,N,-,-1,-1
TWOMEN.txt,432272,435150,2878,20,N,N,-,-1,-1
TWOMEN.txt,435151,437333,2182,20,N,N,-,-1,-1
TWOMEN.txt,437334,439897,2563,20,N,N,-,-1,-1
TWOMEN.txt,439898,441841,1943,20,N,N,-,-1,-1
TWOMEN.txt,441842,444316,2474,20,N,Y,1435577123675,444026,444632
TWOMEN.txt,444317,446077,1760,20,N,Y,1435577123675,444026,444632
TWOMEN.txt,446078,447705,1627,20,N,N,-,-1,-1
TWOMEN.txt,447707,450112,2405,20,N,N,-,-1,-1
TWOMEN.txt,450114,451848,1734,20,N,N,-,-1,-1
TWOMEN.txt,451848,453345,1497,20,N,N,-,-1,-1
TWOMEN.txt,453347,455346,1999,20,N,N,-,-1,-1
TWOMEN.txt,455347,457418,2071,20,N,N,-,-1,-1
TWOMEN.txt,457419,459186,1767,20,N,N,-,-1,-1
TWOMEN.txt,459187,462086,2899,20,N,N,-,-1,-1
TWOMEN.txt,462087,464442,2355,20,N,N,-,-1,-1
TWOMEN.txt,464443,466564,2121,20,N,N,-,-1,-1
TWOMEN.txt,466565,469356,2791,20,N,N,-,-1,-1
TWOMEN.txt,469357,470515,1158,20,N,N,-,-1,-1
TWOMEN.txt,470516,474017,3501,20,N,N,-,-1,-1
TWOMEN.txt,474017,476567,2550,20,N,N,-,-1,-1
TWOMEN.txt,476569,478526,1957,20,N,N,-,-1,-1
TWOMEN.txt,478527,479945,1418,20,N,N,-,-1,-1
TWOMEN.txt,479947,481736,1789,20,N,N,-,-1,-1
TWOMEN.txt,481736,483441,1705,20,N,N,-,-1,-1
TWOMEN.txt,483442,485365,1923,20,N,N,-,-1,-1
TWOMEN.txt,485366,488249,2883,20,N,N,-,-1,-1
TWOMEN.txt,488254,490280,2026,20,N,N,-,-1,-1
TWOMEN.txt,490281,493702,3421,20,N,N,-,-1,-1
WESLEY.txt,1,9161,9160,20,N,N,-,-1,-1
WESLEY.txt,9162,15087,5925,20,N,N,-,-1,-1
WESLEY.txt,15088,18249,3161,20,N,N,-,-1,-1
WESLEY.txt,18250,20832,2582,20,N,N,-,-1,-1
WESLEY.txt,20833,23027,2194,20,N,N,-,-1,-1
WESLEY.txt,23028,26608,3580,20,N,N,-,-1,-1
WESLEY.txt,26609,29636,3027,20,N,N,-,-1,-1
WESLEY.txt,29637,32192,2555,20,N,N,-,-1,-1
WESLEY.txt,32193,35212,3019,20,N,N,-,-1,-1
WESLEY.txt,35213,37810,2597,20,N,N,-,-1,-1
WESLEY.txt,37811,40591,2780,20,N,N,-,-1,-1
WESLEY.txt,40592,42938,2346,20,N,N,-,-1,-1
WESLEY.txt,42939,45312,2373,20,N,N,-,-1,-1
WESLEY.txt,45314,47975,2661,20,N,N,-,-1,-1
WESLEY.txt,47976,50588,2612,20,N,N,-,-1,-1
WESLEY.txt,50589,52903,2314,20,N,N,-,-1,-1
WESLEY.txt,52904,55157,2253,20,N,N,-,-1,-1
WESLEY.txt,55158,58189,3031,20,N,N,-,-1,-1
WESLEY.txt,58190,61808,3618,20,N,N,-,-1,-1
WESLEY.txt,61809,63529,1720,20,N,N,-,-1,-1
WESLEY.txt,63530,64994,1464,20,N,N,-,-1,-1
WESLEY.txt,64994,66495,1501,20,N,N,-,-1,-1
WESLEY.txt,66496,68186,1690,20,N,N,-,-1,-1
WESLEY.txt,68187,69538,1351,20,N,N,-,-1,-1
WESLEY.txt,69540,71025,1485,20,N,N,-,-1,-1
WESLEY.txt,71026,74225,3199,20,N,N,-,-1,-1
WESLEY.txt,74226,75919,1693,20,N,N,-,-1,-1
WESLEY.txt,75920,77302,1382,20,N,N,-,-1,-1
WESLEY.txt,77303,79751,2448,20,N,N,-,-1,-1
WESLEY.txt,79752,82710,2958,20,N,N,-,-1,-1
WESLEY.txt,82711,85161,2450,20,N,N,-,-1,-1
WESLEY.txt,85162,86823,1661,20,N,N,-,-1,-1
WESLEY.txt,86824,88937,2113,20,N,N,-,-1,-1
WESLEY.txt,88938,91167,2229,20,N,N,-,-1,-1
WESLEY.txt,91168,92803,1635,20,N,N,-,-1,-1
WESLEY.txt,92804,95503,2699,20,N,N,-,-1,-1
WESLEY.txt,95504,98151,2647,20,N,N,-,-1,-1
WESLEY.txt,98152,100786,2634,20,N,N,-,-1,-1
WESLEY.txt,100787,102423,1636,20,N,N,-,-1,-1
WESLEY.txt,102424,104277,1853,20,N,N,-,-1,-1
WESLEY.txt,104278,105570,1292,20,N,N,-,-1,-1
WESLEY.txt,105571,108287,2716,20,N,N,-,-1,-1
WESLEY.txt,108288,110118,1830,20,N,N,-,-1,-1
WESLEY.txt,110120,111624,1504,20,N,N,-,-1,-1
WESLEY.txt,111625,113517,1892,20,N,N,-,-1,-1
WESLEY.txt,113518,115129,1611,20,N,N,-,-1,-1
WESLEY.txt,115130,116930,1800,20,N,N,-,-1,-1
WESLEY.txt,116931,119305,2374,20,N,N,-,-1,-1
WESLEY.txt,119306,121674,2368,20,N,N,-,-1,-1
WESLEY.txt,121675,123770,2095,20,N,N,-,-1,-1
WESLEY.txt,123771,126000,2229,20,N,N,-,-1,-1
WESLEY.txt,126001,127652,1651,20,N,N,-,-1,-1
WESLEY.txt,127653,129980,2327,20,N,N,-,-1,-1
WESLEY.txt,129981,131906,1925,20,N,N,-,-1,-1
WESLEY.txt,131907,133498,1591,20,N,N,-,-1,-1
WESLEY.txt,133498,136010,2512,20,N,N,-,-1,-1
WESLEY.txt,136010,138501,2491,20,N,N,-,-1,-1
WESLEY.txt,138502,141771,3269,20,N,N,-,-1,-1
WESLEY.txt,141772,144834,3062,20,N,N,-,-1,-1
WESLEY.txt,144835,146402,1567,20,N,N,-,-1,-1
WESLEY.txt,146403,149158,2755,20,N,N,-,-1,-1
WESLEY.txt,149159,151729,2570,20,N,N,-,-1,-1
WESLEY.txt,151730,153526,1796,20,N,N,-,-1,-1
WESLEY.txt,153526,155529,2003,20,N,N,-,-1,-1
WESLEY.txt,155530,157851,2321,20,N,N,-,-1,-1
WESLEY.txt,157852,160357,2505,20,N,N,-,-1,-1
WESLEY.txt,160358,162320,1962,20,N,N,-,-1,-1
WESLEY.txt,162321,164751,2430,20,N,N,-,-1,-1
WESLEY.txt,164752,165998,1246,20,N,N,-,-1,-1
WESLEY.txt,165999,166623,624,20,N,N,-,-1,-1
WESLEY.txt,166624,167870,1246,20,N,N,-,-1,-1
WESLEY.txt,167871,169553,1682,20,N,N,-,-1,-1
WESLEY.txt,169554,171097,1543,20,N,N,-,-1,-1
WESLEY.txt,171098,173347,2249,20,N,N,-,-1,-1
WESLEY.txt,173348,175534,2186,20,N,N,-,-1,-1
WESLEY.txt,175535,177553,2018,20,N,N,-,-1,-1
WESLEY.txt,177554,179741,2187,20,N,N,-,-1,-1
WESLEY.txt,179742,181418,1676,20,N,N,-,-1,-1
WESLEY.txt,181419,183603,2184,20,N,N,-,-1,-1
WESLEY.txt,183604,185486,1882,20,N,N,-,-1,-1
WESLEY.txt,185487,187356,1869,20,N,N,-,-1,-1
WESLEY.txt,187357,189683,2326,20,N,N,-,-1,-1
WESLEY.txt,189683,191326,1643,20,N,N,-,-1,-1
WESLEY.txt,191327,193582,2255,20,N,N,-,-1,-1
WESLEY.txt,193583,196631,3048,20,N,N,-,-1,-1
WESLEY.txt,196631,198633,2002,20,N,N,-,-1,-1
WESLEY.txt,198634,200927,2293,20,N,N,-,-1,-1
WESLEY.txt,200928,202536,1608,20,N,N,-,-1,-1
WESLEY.txt,202537,204687,2150,20,N,N,-,-1,-1
WESLEY.txt,204688,206831,2143,20,N,N,-,-1,-1
WESLEY.txt,206832,210331,3499,20,N,N,-,-1,-1
WESLEY.txt,210332,212620,2288,20,N,N,-,-1,-1
WESLEY.txt,212621,215281,2660,20,N,N,-,-1,-1
WESLEY.txt,215282,218794,3512,20,N,N,-,-1,-1
WESLEY.txt,218795,222446,3651,20,N,N,-,-1,-1
WESLEY.txt,222447,225886,3439,20,N,N,-,-1,-1
WESLEY.txt,225887,228294,2407,20,N,N,-,-1,-1
WESLEY.txt,228295,230284,1989,20,N,N,-,-1,-1
WESLEY.txt,230285,232061,1776,20,N,N,-,-1,-1
WESLEY.txt,232062,233381,1319,20,N,N,-,-1,-1
WESLEY.txt,233382,235558,2176,20,N,N,-,-1,-1
WESLEY.txt,235560,237661,2101,20,N,N,-,-1,-1
WESLEY.txt,237662,239610,1948,20,N,N,-,-1,-1
WESLEY.txt,239611,241643,2032,20,N,N,-,-1,-1
WESLEY.txt,241644,243752,2108,20,N,Y,1432378713402,242169,242662
WESLEY.txt,243753,245576,1823,20,N,N,-,-1,-1
WESLEY.txt,245577,248018,2441,20,N,Y,1432379217690,245991,246965
WESLEY.txt,248019,249897,1878,20,N,N,-,-1,-1
WESLEY.txt,249898,251703,1805,20,N,N,-,-1,-1
WESLEY.txt,251704,253217,1513,20,N,N,-,-1,-1
WESLEY.txt,253218,255163,1945,20,N,N,-,-1,-1
WESLEY.txt,255164,257988,2824,20,N,N,-,-1,-1
WESLEY.txt,257989,260594,2605,20,N,N,-,-1,-1
WESLEY.txt,260595,263579,2984,20,N,N,-,-1,-1
WESLEY.txt,263580,265949,2369,20,N,N,-,-1,-1
WESLEY.txt,265950,267766,1816,20,N,N,-,-1,-1
WESLEY.txt,267766,269557,1791,20,N,N,-,-1,-1
WESLEY.txt,269558,271861,2303,20,N,N,-,-1,-1
WESLEY.txt,271862,273960,2098,20,N,N,-,-1,-1
WESLEY.txt,273961,275547,1586,20,N,N,-,-1,-1
WESLEY.txt,275547,277718,2171,20,N,N,-,-1,-1
WESLEY.txt,277719,279089,1370,20,N,N,-,-1,-1
WESLEY.txt,279090,281187,2097,20,N,N,-,-1,-1
WESLEY.txt,281188,282498,1310,20,N,N,-,-1,-1
WESLEY.txt,282499,283898,1399,20,N,N,-,-1,-1
WESLEY.txt,283899,286173,2274,20,N,N,-,-1,-1
WESLEY.txt,286174,288511,2337,20,N,N,-,-1,-1
WESLEY.txt,288511,290178,1667,20,N,N,-,-1,-1
WESLEY.txt,290178,291771,1593,20,N,N,-,-1,-1
WESLEY.txt,291772,294041,2269,20,N,N,-,-1,-1
WESLEY.txt,294042,296054,2012,20,N,N,-,-1,-1
WESLEY.txt,296055,298550,2495,20,N,N,-,-1,-1
WESLEY.txt,298551,300974,2423,20,N,N,-,-1,-1
WESLEY.txt,300975,303220,2245,20,N,N,-,-1,-1
WESLEY.txt,303221,304754,1533,20,N,N,-,-1,-1
WESLEY.txt,304755,306451,1696,20,N,N,-,-1,-1
WESLEY.txt,306452,308406,1954,20,N,N,-,-1,-1
WESLEY.txt,308406,310197,1791,20,N,N,-,-1,-1
WESLEY.txt,310197,311969,1772,20,N,N,-,-1,-1
WESLEY.txt,311970,313725,1755,20,N,N,-,-1,-1
WESLEY.txt,313725,315181,1456,20,N,N,-,-1,-1
WESLEY.txt,315183,317389,2206,20,N,Y,1433324150625,315900,316317
WESLEY.txt,317390,319210,1820,20,N,N,-,-1,-1
WESLEY.txt,319211,321509,2298,20,N,N,-,-1,-1
WESLEY.txt,321510,323285,1775,20,N,N,-,-1,-1
WESLEY.txt,323285,325406,2121,20,N,N,-,-1,-1
WESLEY.txt,325407,327103,1696,20,N,N,-,-1,-1
WESLEY.txt,327104,328800,1696,20,N,N,-,-1,-1
WESLEY.txt,328800,330388,1588,20,N,N,-,-1,-1
WESLEY.txt,330389,334000,3611,20,N,N,-,-1,-1
WESLEY.txt,334001,336166,2165,20,N,N,-,-1,-1
WESLEY.txt,336167,338424,2257,20,N,N,-,-1,-1
WESLEY.txt,338425,340027,1602,20,N,N,-,-1,-1
WESLEY.txt,340027,341370,1343,20,N,N,-,-1,-1
WESLEY.txt,341371,343265,1894,20,N,N,-,-1,-1
WESLEY.txt,343267,344911,1644,20,N,N,-,-1,-1
WESLEY.txt,344912,346491,1579,20,N,N,-,-1,-1
WESLEY.txt,346492,348719,2227,20,N,N,-,-1,-1
WESLEY.txt,348720,350331,1611,20,N,N,-,-1,-1
WESLEY.txt,350332,352259,1927,20,N,N,-,-1,-1
WESLEY.txt,352260,354194,1934,20,N,N,-,-1,-1
WESLEY.txt,354195,356047,1852,20,N,N,-,-1,-1
WESLEY.txt,356048,357990,1942,20,N,N,-,-1,-1
WESLEY.txt,357990,359782,1792,20,N,N,-,-1,-1
WESLEY.txt,359782,362021,2239,20,N,N,-,-1,-1
WESLEY.txt,362022,364161,2139,20,N,N,-,-1,-1
WESLEY.txt,364162,365970,1808,20,N,N,-,-1,-1
WESLEY.txt,365971,367532,1561,20,N,Y,1435058414135,367148,369648
WESLEY.txt,367534,369982,2448,20,N,Y,1435058414135,367148,369648
WESLEY.txt,369983,372272,2289,20,N,N,-,-1,-1
WESLEY.txt,372273,374178,1905,20,N,N,-,-1,-1
WESLEY.txt,374179,376293,2114,20,N,N,-,-1,-1
WESLEY.txt,376294,378372,2078,20,N,N,-,-1,-1
WESLEY.txt,378373,380256,1883,20,N,N,-,-1,-1
WESLEY.txt,380257,381665,1408,20,N,N,-,-1,-1
WESLEY.txt,381666,382986,1320,20,N,N,-,-1,-1
WESLEY.txt,382986,384516,1530,20,N,N,-,-1,-1
WESLEY.txt,384517,386503,1986,20,N,N,-,-1,-1
WESLEY.txt,386504,388703,2199,20,N,N,-,-1,-1
WESLEY.txt,388704,390521,1817,20,N,N,-,-1,-1
WESLEY.txt,390522,392339,1817,20,N,N,-,-1,-1
WESLEY.txt,392340,394300,1960,20,N,N,-,-1,-1
WESLEY.txt,394300,396579,2279,20,N,N,-,-1,-1
WESLEY.txt,396580,398305,1725,20,N,N,-,-1,-1
WESLEY.txt,398306,400248,1942,20,N,N,-,-1,-1
WESLEY.txt,400249,402125,1876,20,N,N,-,-1,-1
WESLEY.txt,402126,403598,1472,20,N,N,-,-1,-1
WESLEY.txt,403599,405437,1838,20,N,N,-,-1,-1
WESLEY.txt,405438,407127,1689,20,N,N,-,-1,-1
WESLEY.txt,407129,409309,2180,20,N,N,-,-1,-1
WESLEY.txt,409309,411272,1963,20,N,N,-,-1,-1
WESLEY.txt,411273,413654,2381,20,N,N,-,-1,-1
WESLEY.txt,413655,415436,1781,20,N,N,-,-1,-1
WESLEY.txt,415437,417817,2380,20,N,N,-,-1,-1
WESLEY.txt,417818,420030,2212,20,N,N,-,-1,-1
WESLEY.txt,420031,421663,1632,20,N,N,-,-1,-1
WESLEY.txt,421664,423498,1834,20,N,N,-,-1,-1
WESLEY.txt,423499,424898,1399,20,N,N,-,-1,-1
WESLEY.txt,424899,426851,1952,20,N,N,-,-1,-1
WESLEY.txt,426852,428111,1259,20,N,N,-,-1,-1
WESLEY.txt,428112,429686,1574,20,N,N,-,-1,-1
WESLEY.txt,429687,432024,2337,20,N,N,-,-1,-1
WESLEY.txt,432025,434254,2229,20,N,N,-,-1,-1
WESLEY.txt,434255,436016,1761,20,N,N,-,-1,-1
WESLEY.txt,436016,438359,2343,20,N,N,-,-1,-1
WESLEY.txt,438360,440291,1931,20,N,N,-,-1,-1
WESLEY.txt,440292,441737,1445,20,N,N,-,-1,-1
WESLEY.txt,441738,443324,1586,20,N,N,-,-1,-1
WESLEY.txt,443324,445319,1995,20,N,N,-,-1,-1
WESLEY.txt,445320,446775,1455,20,N,N,-,-1,-1
WESLEY.txt,446776,448417,1641,20,N,N,-,-1,-1
WESLEY.txt,448418,450278,1860,20,N,N,-,-1,-1
WESLEY.txt,450280,452327,2047,20,N,N,-,-1,-1
WESLEY.txt,452328,454789,2461,20,N,N,-,-1,-1
WESLEY.txt,454790,456371,1581,20,N,N,-,-1,-1
WESLEY.txt,456371,458237,1866,20,N,N,-,-1,-1
WESLEY.txt,458238,459877,1639,20,N,N,-,-1,-1
WESLEY.txt,459877,462453,2576,20,N,N,-,-1,-1
WESLEY.txt,462454,464392,1938,20,N,N,-,-1,-1
WESLEY.txt,464393,466352,1959,20,N,N,-,-1,-1
WESLEY.txt,466353,468351,1998,20,N,N,-,-1,-1
WESLEY.txt,468352,470089,1737,20,N,N,-,-1,-1
WESLEY.txt,470090,472020,1930,20,N,N,-,-1,-1
WESLEY.txt,472021,473613,1592,20,N,N,-,-1,-1
WESLEY.txt,473614,475957,2343,20,N,N,-,-1,-1
WESLEY.txt,475957,477906,1949,20,N,N,-,-1,-1
WESLEY.txt,477907,479764,1857,20,N,N,-,-1,-1
WESLEY.txt,479765,481861,2096,20,N,Y,1435062319127,480703,480943
WESLEY.txt,481862,483849,1987,20,N,N,-,-1,-1
WESLEY.txt,483850,485985,2135,20,N,N,-,-1,-1
WESLEY.txt,485986,488041,2055,20,N,N,-,-1,-1
WESLEY.txt,488042,489685,1643,20,N,N,-,-1,-1
WESLEY.txt,489686,491564,1878,20,N,N,-,-1,-1
WESLEY.txt,491565,493348,1783,20,N,N,-,-1,-1
WESLEY.txt,493349,495752,2403,20,N,Y,1435062617921,494000,496406
WESLEY.txt,495753,497026,1273,20,N,Y,1435062617921,494000,496406
WESLEY.txt,497027,499382,2355,20,N,N,-,-1,-1
WESLEY.txt,499382,500794,1412,20,N,N,-,-1,-1
WESLEY.txt,500794,503068,2274,20,N,N,-,-1,-1
WESLEY.txt,503069,505591,2522,20,N,N,-,-1,-1
WESLEY.txt,505592,507765,2173,20,N,N,-,-1,-1
WESLEY.txt,507766,510017,2251,20,N,N,-,-1,-1
WESLEY.txt,510018,511908,1890,20,N,N,-,-1,-1
WESLEY.txt,511909,513757,1848,20,N,N,-,-1,-1
WESLEY.txt,513758,515628,1870,20,N,N,-,-1,-1
WESLEY.txt,515629,517600,1971,20,N,N,-,-1,-1
WESLEY.txt,517601,519721,2120,20,N,N,-,-1,-1
WESLEY.txt,519722,521431,1709,20,N,N,-,-1,-1
WESLEY.txt,521432,523289,1857,20,N,N,-,-1,-1
WESLEY.txt,523290,525370,2080,20,N,N,-,-1,-1
WESLEY.txt,525371,527210,1839,20,N,N,-,-1,-1
WESLEY.txt,527211,529117,1906,20,N,N,-,-1,-1
WESLEY.txt,529118,531147,2029,20,N,N,-,-1,-1
WESLEY.txt,531148,533252,2104,20,N,N,-,-1,-1
WESLEY.txt,533253,535323,2070,20,N,N,-,-1,-1
WESLEY.txt,535324,536961,1637,20,N,Y,1435063028928,536935,537559
WESLEY.txt,536961,538614,1653,20,N,Y,1435063028928,536935,537559
WESLEY.txt,538615,540889,2274,20,N,N,-,-1,-1
WESLEY.txt,540890,543340,2450,20,N,N,-,-1,-1
WESLEY.txt,543341,545672,2331,20,N,N,-,-1,-1
WESLEY.txt,545673,547572,1899,20,N,N,-,-1,-1
WESLEY.txt,547573,549306,1733,20,N,N,-,-1,-1
WESLEY.txt,549307,551176,1869,20,N,N,-,-1,-1
WESLEY.txt,551177,553233,2056,20,N,N,-,-1,-1
WESLEY.txt,553234,555431,2197,20,N,N,-,-1,-1
WESLEY.txt,555432,557254,1822,20,N,N,-,-1,-1
WESLEY.txt,557255,559037,1782,20,N,N,-,-1,-1
WESLEY.txt,559038,560846,1808,20,N,Y,1435063804274,560047,562154
WESLEY.txt,560847,562807,1960,20,N,Y,1435063804274,560047,562154
WESLEY.txt,562808,565584,2776,20,N,N,-,-1,-1
WESLEY.txt,565585,567283,1698,20,N,N,-,-1,-1
WESLEY.txt,567283,569046,1763,20,N,N,-,-1,-1
WESLEY.txt,569047,570467,1420,20,N,N,-,-1,-1
WESLEY.txt,570468,571998,1530,20,N,N,-,-1,-1
WESLEY.txt,571999,574201,2202,20,N,N,-,-1,-1
WESLEY.txt,574202,576154,1952,20,N,N,-,-1,-1
WESLEY.txt,576155,578091,1936,20,N,N,-,-1,-1
WESLEY.txt,578092,579824,1732,20,N,N,-,-1,-1
WESLEY.txt,579825,581236,1411,20,N,N,-,-1,-1
WESLEY.txt,581236,583505,2269,20,N,N,-,-1,-1
WESLEY.txt,583506,585603,2097,20,N,N,-,-1,-1
WESLEY.txt,585604,587553,1949,20,N,N,-,-1,-1
WESLEY.txt,587554,589603,2049,20,N,N,-,-1,-1
WESLEY.txt,589604,591030,1426,20,N,N,-,-1,-1
WESLEY.txt,591031,593324,2293,20,N,N,-,-1,-1
WESLEY.txt,593325,595629,2304,20,N,N,-,-1,-1
WESLEY.txt,595629,597957,2328,20,N,N,-,-1,-1
WESLEY.txt,597958,600075,2117,20,N,N,-,-1,-1
WESLEY.txt,600076,601818,1742,20,N,N,-,-1,-1
WESLEY.txt,601819,603752,1933,20,N,N,-,-1,-1
WESLEY.txt,603752,605193,1441,20,N,N,-,-1,-1
WESLEY.txt,605194,607959,2765,20,N,N,-,-1,-1
WESLEY.txt,607960,609915,1955,20,N,N,-,-1,-1
WESLEY.txt,609916,611680,1764,20,N,N,-,-1,-1
WESLEY.txt,611681,613365,1684,20,N,N,-,-1,-1
WESLEY.txt,613366,615164,1798,20,N,N,-,-1,-1
WESLEY.txt,615165,617030,1865,20,N,N,-,-1,-1
WESLEY.txt,617031,619105,2074,20,N,N,-,-1,-1
WESLEY.txt,619106,621392,2286,20,N,N,-,-1,-1
WESLEY.txt,621393,623481,2088,20,N,N,-,-1,-1
WESLEY.txt,623482,625193,1711,20,N,N,-,-1,-1
WESLEY.txt,625194,626732,1538,20,N,N,-,-1,-1
WESLEY.txt,626733,628178,1445,20,N,N,-,-1,-1
WESLEY.txt,628179,629952,1773,20,N,N,-,-1,-1
WESLEY.txt,629953,631708,1755,20,N,N,-,-1,-1
WESLEY.txt,631709,633907,2198,20,N,N,-,-1,-1
WESLEY.txt,633907,636032,2125,20,N,N,-,-1,-1
WESLEY.txt,636033,637491,1458,20,N,N,-,-1,-1
WESLEY.txt,637492,639251,1759,20,N,N,-,-1,-1
WESLEY.txt,639252,640623,1371,20,N,N,-,-1,-1
WESLEY.txt,640624,642158,1534,20,N,N,-,-1,-1
WESLEY.txt,642159,644220,2061,20,N,N,-,-1,-1
WESLEY.txt,644221,645690,1469,20,N,N,-,-1,-1
WESLEY.txt,645691,647059,1368,20,N,N,-,-1,-1
WESLEY.txt,647060,648947,1887,20,N,N,-,-1,-1
WESLEY.txt,648948,650722,1774,20,N,N,-,-1,-1
WESLEY.txt,650723,652923,2200,20,N,N,-,-1,-1
WESLEY.txt,652924,654701,1777,20,N,N,-,-1,-1
WESLEY.txt,654702,656499,1797,20,N,N,-,-1,-1
WESLEY.txt,656500,658265,1765,20,N,N,-,-1,-1
WESLEY.txt,658266,660267,2001,20,N,N,-,-1,-1
WESLEY.txt,660268,661709,1441,20,N,N,-,-1,-1
WESLEY.txt,661710,663513,1803,20,N,N,-,-1,-1
WESLEY.txt,663514,665303,1789,20,N,N,-,-1,-1
WESLEY.txt,665304,666842,1538,20,N,N,-,-1,-1
WESLEY.txt,666843,668640,1797,20,N,N,-,-1,-1
WESLEY.txt,668641,670632,1991,20,N,N,-,-1,-1
WESLEY.txt,670633,672568,1935,20,N,N,-,-1,-1
WESLEY.txt,672569,674380,1811,20,N,N,-,-1,-1
WESLEY.txt,674381,675908,1527,20,N,N,-,-1,-1
WESLEY.txt,675909,677735,1826,20,N,N,-,-1,-1
WESLEY.txt,677736,679281,1545,20,N,N,-,-1,-1
WESLEY.txt,679282,680783,1501,20,N,N,-,-1,-1
WESLEY.txt,680784,683049,2265,20,N,N,-,-1,-1
WESLEY.txt,683050,684753,1703,20,N,N,-,-1,-1
WESLEY.txt,684754,686339,1585,20,N,N,-,-1,-1
WESLEY.txt,686340,688045,1705,20,N,N,-,-1,-1
WESLEY.txt,688045,689661,1616,20,N,N,-,-1,-1
WESLEY.txt,689662,691294,1632,20,N,N,-,-1,-1
WESLEY.txt,691295,692808,1513,20,N,N,-,-1,-1
WESLEY.txt,692809,695003,2194,20,N,N,-,-1,-1
WESLEY.txt,695004,696579,1575,20,N,N,-,-1,-1
WESLEY.txt,696580,698674,2094,20,N,N,-,-1,-1
WESLEY.txt,698675,700174,1499,20,N,N,-,-1,-1
WESLEY.txt,700175,701797,1622,20,N,N,-,-1,-1
WESLEY.txt,701798,704166,2368,20,N,N,-,-1,-1
WESLEY.txt,704167,706136,1969,20,N,N,-,-1,-1
WESLEY.txt,706137,707455,1318,20,N,N,-,-1,-1
WESLEY.txt,707456,710393,2937,20,N,N,-,-1,-1
WESLEY.txt,710394,711815,1421,20,N,N,-,-1,-1
WESLEY.txt,711816,713627,1811,20,N,N,-,-1,-1
WESLEY.txt,713628,716130,2502,20,N,N,-,-1,-1
WESLEY.txt,716130,718082,1952,20,N,N,-,-1,-1
WESLEY.txt,718083,719830,1747,20,N,N,-,-1,-1
WESLEY.txt,719831,721499,1668,20,N,N,-,-1,-1
WESLEY.txt,721500,723072,1572,20,N,N,-,-1,-1
WESLEY.txt,723073,725339,2266,20,N,N,-,-1,-1
WESLEY.txt,725340,727241,1901,20,N,N,-,-1,-1
WESLEY.txt,727241,729169,1928,20,N,N,-,-1,-1
WESLEY.txt,729170,730859,1689,20,N,N,-,-1,-1
WESLEY.txt,730860,732425,1565,20,N,N,-,-1,-1
WESLEY.txt,732425,734576,2151,20,N,N,-,-1,-1
WESLEY.txt,734577,736609,2032,20,N,N,-,-1,-1
WESLEY.txt,736610,738595,1985,20,N,N,-,-1,-1
WESLEY.txt,738596,740790,2194,20,N,N,-,-1,-1
WESLEY.txt,740791,742353,1562,20,N,N,-,-1,-1
WESLEY.txt,742354,744290,1936,20,N,N,-,-1,-1
WESLEY.txt,744291,745905,1614,20,N,N,-,-1,-1
WESLEY.txt,745906,748556,2650,20,N,N,-,-1,-1
WESLEY.txt,748557,751302,2745,20,N,N,-,-1,-1
WESLEY.txt,751303,752869,1566,20,N,N,-,-1,-1
WESLEY.txt,752870,755160,2290,20,N,N,-,-1,-1
WESLEY.txt,755161,756670,1509,20,N,N,-,-1,-1
WESLEY.txt,756671,758885,2214,20,N,N,-,-1,-1
WESLEY.txt,758886,760315,1429,20,N,N,-,-1,-1
WESLEY.txt,760316,762246,1930,20,N,N,-,-1,-1
WESLEY.txt,762247,764222,1975,20,N,N,-,-1,-1
WESLEY.txt,764223,765778,1555,20,N,N,-,-1,-1
WESLEY.txt,765779,767437,1658,20,N,N,-,-1,-1
WESLEY.txt,767438,768929,1491,20,N,N,-,-1,-1
WESLEY.txt,768930,771031,2101,20,N,N,-,-1,-1
WESLEY.txt,771032,773249,2217,20,N,N,-,-1,-1
WESLEY.txt,773250,774765,1515,20,N,N,-,-1,-1
WESLEY.txt,774766,776527,1761,20,N,N,-,-1,-1
WESLEY.txt,776528,778456,1928,20,N,N,-,-1,-1
WESLEY.txt,778457,779715,1258,20,N,N,-,-1,-1
WESLEY.txt,779716,781112,1396,20,N,N,-,-1,-1
WESLEY.txt,781113,783017,1904,20,N,N,-,-1,-1
WESLEY.txt,783018,784692,1674,20,N,N,-,-1,-1
WESLEY.txt,784693,786802,2109,20,N,N,-,-1,-1
WESLEY.txt,786803,788566,1763,20,N,N,-,-1,-1
WESLEY.txt,788567,790600,2033,20,N,N,-,-1,-1
WESLEY.txt,790601,791731,1130,20,N,N,-,-1,-1
WESLEY.txt,791732,793716,1984,20,N,N,-,-1,-1
WESLEY.txt,793717,795509,1792,20,N,N,-,-1,-1
WESLEY.txt,795510,797259,1749,20,N,N,-,-1,-1
WESLEY.txt,797260,799133,1873,20,N,N,-,-1,-1
WESLEY.txt,799134,800730,1596,20,N,N,-,-1,-1
WESLEY.txt,800731,802550,1819,20,N,N,-,-1,-1
WESLEY.txt,802551,803772,1221,20,N,N,-,-1,-1
WESLEY.txt,803773,805321,1548,20,N,N,-,-1,-1
WESLEY.txt,805321,806922,1601,20,N,N,-,-1,-1
WESLEY.txt,806923,808364,1441,20,N,N,-,-1,-1
WESLEY.txt,808364,810646,2282,20,N,N,-,-1,-1
WESLEY.txt,810647,812364,1717,20,N,N,-,-1,-1
WESLEY.txt,812365,814754,2389,20,N,N,-,-1,-1
WESLEY.txt,814754,816777,2023,20,N,N,-,-1,-1
WESLEY.txt,816778,818652,1874,20,N,N,-,-1,-1
WESLEY.txt,818653,820417,1764,20,N,N,-,-1,-1
WESLEY.txt,820418,822263,1845,20,N,N,-,-1,-1
WESLEY.txt,822264,823770,1506,20,N,N,-,-1,-1
WESLEY.txt,823771,825614,1843,20,N,N,-,-1,-1
WESLEY.txt,825614,828164,2550,20,N,N,-,-1,-1
WESLEY.txt,828165,829766,1601,20,N,N,-,-1,-1
WESLEY.txt,829767,831523,1756,20,N,N,-,-1,-1
WESLEY.txt,831523,833402,1879,20,N,N,-,-1,-1
WESLEY.txt,833403,834838,1435,20,N,N,-,-1,-1
WESLEY.txt,834839,836820,1981,20,N,N,-,-1,-1
WESLEY.txt,836820,838692,1872,20,N,N,-,-1,-1
WESLEY.txt,838693,840468,1775,20,N,N,-,-1,-1
WESLEY.txt,840468,842080,1612,20,N,N,-,-1,-1
WESLEY.txt,842081,843480,1399,20,N,N,-,-1,-1
WESLEY.txt,843481,845313,1832,20,N,N,-,-1,-1
WESLEY.txt,845314,846931,1617,20,N,N,-,-1,-1
WESLEY.txt,846932,849091,2159,20,N,N,-,-1,-1
WESLEY.txt,849092,851373,2281,20,N,N,-,-1,-1
WESLEY.txt,851374,853239,1865,20,N,N,-,-1,-1
WESLEY.txt,853240,855206,1966,20,N,N,-,-1,-1
WESLEY.txt,855207,856818,1611,20,N,N,-,-1,-1
WESLEY.txt,856819,858904,2085,20,N,N,-,-1,-1
WESLEY.txt,858905,861044,2139,20,N,N,-,-1,-1
WESLEY.txt,861045,863083,2038,20,N,N,-,-1,-1
WESLEY.txt,863084,865033,1949,20,N,N,-,-1,-1
WESLEY.txt,865034,867117,2083,20,N,N,-,-1,-1
WESLEY.txt,867117,868898,1781,20,N,N,-,-1,-1
WESLEY.txt,868899,870611,1712,20,N,N,-,-1,-1
WESLEY.txt,870612,872208,1596,20,N,N,-,-1,-1
WESLEY.txt,872209,875295,3086,20,N,N,-,-1,-1
WESLEY.txt,875295,876653,1358,20,N,N,-,-1,-1
WESLEY.txt,876654,878175,1521,20,N,N,-,-1,-1
WESLEY.txt,878175,879397,1222,20,N,N,-,-1,-1
WESLEY.txt,879398,881221,1823,20,N,N,-,-1,-1
WESLEY.txt,881222,882736,1514,20,N,N,-,-1,-1
WESLEY.txt,882736,884509,1773,20,N,N,-,-1,-1
WESLEY.txt,884510,886931,2421,20,N,N,-,-1,-1
WESLEY.txt,886932,890635,3703,20,N,N,-,-1,-1
WESLEY.txt,890636,894981,4345,20,N,N,-,-1,-1
